On ne doute point que le Poëte Fouſſard ne ſuë à groſſes goutes pour donner icy quelque mot d’auis à ſon ordinaire;	On ne doute point que le Poète Foussard ne sue à grosses goutes pour donner ici quelque mot d'avis à son ordinaire;
c’eſt auſſi où ie l’attens, afin de me ſeruir de ſes propres armes pour le combattre & pour le vaincre, comme ie m’en ſuis déja ſeruy en vne fauſſe Lettre qu’il a écrite à vn Amy ſupoſé ſur le Sujet du petit Poëte Oronte, laquelle m’eſt heureuſement tombée entre les mains;	c'est aussi où tu l'attends, afin de me servir de ses propres armes pour le combattre et pour le vaincre, comme toute m’en suis déjà servi en une fausse Lettre qu'il a écrite à un Ami suposé sur le Sujet du petit Poète Oronte, laquelle m'est heureusement tombée entre les mains;
& pourueu que la médiſance qui luy eſt naturelle ne ſoit point de la partie, on luy permet d’vſer de replique, car en ce cas il n’a qu’à ſe preparer à joüer encore vn Perſonnage tout neuf dans la Comedie qui me reſté à faire, où i’eſtime qu’il n’aura pas mauuaiſe grace à repreſenter vn Capitan, apres auoir ſi bien fait le Poëte en celle cy.	et pourvu que la médisance qui lui est naturelle ne soit point de la partie, on lui permet d'user de répare, car en ce cas il n'a qu'à se préparer à jouer encore un Personnage tout neuf dans la Comédie qui me resté à faire, où j'estime qu'il n'aura pas mauvaise grâce à représenter un Capitan, après avoir si bien fait le Poète en celle cy.
Vn plus temeraire oſeroit peut-eſtre dire que le Ciel a trauaillé de concert auec moy, en me ſuſcitant l’occaſion de cette Lettre qui eſtoit abſolument neceſſaire à mon ſujet, & qui m’a eſté liurée par ſon plus fidele Amy & ſon bon Confident;	Un plus téméraire oserait peut-être dire que le Ciel a travaillé de concert avec moi, en me suscitant l'occasion de cette Lettre qui était absolument nécessaire à mon sujet, et qui m'a été livrée par son plus fidèle Ami et son bon Confident;
car qui pourroit imaginer qu’vn buroirr cchois qui ne m’auoit iamais veu, me ſoit venu trouuer à Paris au retour d’vn Voyage d’Italie, pour me bailler cette Lettre, qu’il auoit pris la peine de porter ſi loin?	car qui pourrait imaginer qu'un buroir crois qui ne m'avait jamais vu, me soit venu trouver à Paris au retour d'un Voyage d'Italie, pour me bailler cette Lettre, qu'il avait pris la peine de porter si loin?
mais tellement vſée & déchirée, que ce fut à moy vn eſpece de miracle de l’auoir pû lire.	mais tellement usée et déchirée, que ce fut à moi un espèce de miracle de l'avoir pu lire.
Le reſpect que i’ay pour ce grand Autheur ne me permet pas de rien ſupprimer de ſes Ouurages, & i’auois reſolu de la mettre au bout de ce Liure;	Le respect que j'ai pour ce grand Auteur ne me permet pas de rien supprimer de ses Ouvrages, et j'avais résolu de la mettre au bout de ce Livre;
mais ayant appris que depuis peu’il en auoit fait liberalité à tout le monde, il a ſi bien ſceu me preuenir en ce deſſein, qu’il m’en a luy-meſme épargné la peine.	mais ayant appris que depuis peu'il en avait fait libéralité à tout le monde, il a si bien su me prévenir en ce dessein, qu'il m'en a lui-même épargné la peine.
Ie ſupplie donc tres-humblement tous ceux qui ont leu cette Lettre, de la relire auec attention d’en conſiderer le ſpirituel, s’il y en a, & de la confronter en ſuite auec la ſeconde Scene de cette Piece;	Je supplie donc très-humblement tous ceux qui ont lu cette Lettre, de la relire a attention d'en considérer le spirituel, s'il y en a, et de la confronter en suite auecpré seconde Scène de cette Pièce;
ils verront que c’eſt vne verſion toute pure & conforme à cette belle Lettre, tout autant que la rigueur de la Poëſie ſe peut accommoder auec la Proſe.	ils verront que c'est une version toute pure et conforme à cette belle Lettre, tout autant que la rigueur de la Poésie se peut accommoder avec la Prose.
CELIMENE, Fille de Pauline.	CELIMENE, Fille de Pauline.
LES COPPIEVX DE LA FLECHE, LES BARONS FLECHOIS.	LES COPIEUX DE LA FLÈCHE, LES BARONS FLECHOIS.
CSMEDIT.	CSMEDIT.
ACTE VNIO – E.	ACTE VNIO „ E.
SCENGPADAIIDICE.	SCENGPADAIDICE.
CLEANDRE, CLIDAMIS, entrent ſeparément par les deux coins du Theatre.	CLEANDRE, CLIDAMIS, entrent séparément par les deux coins du Théâtre.
M CLEAND RE.	M MLEAND RE.
Brier vous, endanns, eſt-ce vous que ie voy?	Brier vous, endanns, est-ce vous que ie cy?
Ne m’abuſay-je point?	Ne m'abusai-je point?
CLIDAMIS en luy donnant ſa main.	CLIDAMIS en était donnant sa main.
Non, Cleandre, c’eſt moy	Non, Cléandre, c'est moi
CLEANDRE.	CLÉANDRE.
Depuis vne heure &plus, en tous lieux ie te cherche, Et ieſuis bien rauy de te voir à la Fleche.	Depuis une heure etplus, en tous lieux on te cherche, Et iesuis bien ravi de te voir à la Flèche.
Tu viens done lous feuoir:	Tu viens donce lous feuoir:
CLIDAMIS.	CLIDAMIS.
Ie ne m’en puis laſſer.	Je ne m'en puis lasser.
CLEANDRE.	CLÉANDRE.
On m’a bien dit auſſi qu’on t’auoit veu paſſer;	On m'a bien dit aussi qu'on t'avait vu passer;
Et depuis ce moment i’ay fait cent tours de Ville Pour te rencontrer, mais.	Et depuis ce moment j'ai fait cent tours de Ville Pour te rencontrer, mais.
CLIDAMIS.	CLIDAMIS.
Ta peine eſt inutile, Tu n’auois qu’à venir tout droit, pour le certain, En mon Hoſtellerie.	Ta peine est inutile, Tu n'avais qu'à venir tout droit, pour le certain, En mon Hôtellerie.
CLEANDRE.	CLÉANDRE.
4.	4.
CLIDAMIS.	CLIDAMIS.
C'ert a Sailit Martin.	C'ert a Sailit Martin.
CLEANDRE.	CLÉANDRE.
Loge-tu toûjours la?	Loge-tu toujours la?
CLIDAMIS.	CLIDAMIS.
Toûjouts chez Robiniere, feny doudelereprens	Toujouts chez Robinière, feni doudelereprens
CLEANDRE.	CLÉANDRE.
Sa Femme eſt vn peu ficre;	Sa Femme est un peu ficre;
Mais tu peux la charmer par de l’argent comptant.	Mais tu peux la charmer par de l'argent comptant.
CLIDAMIS.	CLIDAMIS.
Quoy qu'ircirroſt, Amy, i’en ſuis aſſez content:	Quoi qu'ircirrôt, Ami, j'en suis assez content:
Et pour en mieux ſortir, ie te donne parole, Que i’y ſacrifiray plutoſt quelque Piſtolle, I’entens, de ſur-écot pour traiter mes Amis;	Et pour en mieux sortir, je te donne parole, Que j'y sacrifirai plutôt quelque Pistole, J'entends, de sur-écot pour traiter mes Amis;
Autrement.	Autrement.
CLEANDRE.	CLÉANDRE.
I’entens bien:	J'entends bien:
mais mon cher Clidamis, Ie crains auec raiſon, que ton humeur affable Ne ſe laſſe à la fin de nous preſter ta table, Car tu nous as déja traité plus de vingt fois.	mais mon cher Clidamis, Je crains avec raison, que ton humeur affable Ne se lasse à la fin de nous prêter ta table, Car tu nous as déjà traité plus de vingt fois.
CLIDAMIS.	CLIDAMIS.
C’eſt mõ plus grãd plaifir, ce ſont tous mes ſouhaits;	C'est momme plus grands plaisir, ce sont tous mes souhaits;
Et ſans la ſotte humeur de vos Barons Critiques, Qui font les Eſprits forts, & les grands Politiques, (Quoy qu’on puiſſe à bon droict les apeller des Sots) I’aurois continué tres-ſouuent nos écots:	Et sans la sotte humeur de vos Barons Critiques, Qui font les Esprits forts, et les grands Politiques, (Quoi qu'on puisse à bon droit les appeler des Sots) J'aurais continué très-souuent nos écots:
Mais à toujours donner, & ſamais ne rien prendre, Ma liberalité commence de ſe rendre.	Mais à toujours donner, et samais ne rien prendre, Ma libéralité commence de se rendre.
CLEANDRE.	CLÉANDRE.
Tu connois mal encor l’eſprit de nos Flechois, Ils ſont mieux entendus, plus ruſez, plus matois, Et plus intereſſez encor que tu ne penſes.	Tu connais mal encor l'esprit de nos Fléchais, Ils sont mieux entendus, plus rusés, plus matois, Et plus intéressez encor que tu ne penses.
Tel ſouuent qui te vient faire des reuerences, Qui t’aſſeure en jurant, qu’il te voudroit ſeruir, Eſt vn Homme apoſté, qui cherche à te trahir;	Tel souvent qui te vient faire des révérences, Qui t'assure en jurant, qu'il te voudrait servir, Est un Homme aposté, qui cherche à te trahir;
Dans ſon deſſein caché, s’il te rend quelqu’office, C’eſt pour.	Dans son dessein caché, s'il te rend quelqu'office, C'est pour.
CLIDAMIS.	CLIDAMIS.
Ah!	Ah!
ie t’entens;	Il t'entends;
pauureté n’eſt pas vice:	pauvreté n'est pas vice:
Mais il en faut vſer en vrais Cœurs genereux.	Mais il en faut user en vrais Cœurs généreux.
CLEANDRE.	CLÉANDRE.
La generoſité ne loge pas chez eux;	La générosité ne loge pas chez eux;
Et ſi l’on leur reproche vne filouterie, Ils diſent hautement que c’eſt galanterie:	Et si l'on leur reproche une filouterie, Ils disent hautement que c'est galanterie:
Comme ils ſont tous Parens, tous Amis, tous Filous, Du luenete derin, elt rouurage de tous.	Comme ils sont tous Parents, tous Amis, tous Filous, Du luenete deryn, Delt rouvrage de tous.
Chacun au Carrefour entreprend & s’applique, Pour mettre à qui mieux mieux ce métier en pratiCLIDAMIS.	Chacun au Carrefour entreprend et s'applique, Pour mettre à qui mieux mieux ce métier en pratiCLIDAMIS.
que.	que.
Mais ils déuroient rougir, de paſſer pour fripons.	Mais ils devraient rougir, de passer pour fripons.
CLEANDRE.	CLÉANDRE.
N’importe, c’eſt ainſi que viuent nos Barons;	N'importe, c'est ainsi que vivent nos Barons;
Et ce n’eſt pas encor la moindre de leurs taches.	Et ce n'est pas encor la moindre de leurs taches.
A ij	À ij
CLIDAMIS.	CLIDAMIS.
Q ue peut-on dire encor contr eux?	 Que peut-on dire encor contr eux?
CLEANDRE.	CLÉANDRE.
C’eſt qu’ils ſont lâches, A tel poinct, que cela me fait preſque enrager, Iuſqu’à ſe mettre vingt contre vn pauure Etranger, Encor le veulent-ils auoir à l’auantage;	C'est qu'ils sont lâches, A tel point, que cela me fait presque enrager, Jusqu'à se mettre vingt contre un pauvre Étranger, Encore le veulent-ils avoir à l'avantage;
Et pour y reüſſir, tout eſt mis en vſage:	Et pour y réussir, tout est mis en usage:
Les Maiſtres, les Valets, & tous les Ecoliers, Et nos Barons Flechois, & les Feſſe-cahiers, Se liguent par enſemble, & font des embuſcades;	Les Maîtres, les Valets, et tous les Écoliers, Et nos Barons Fléchais, et les Fesse-cahiers, Se liguent par ensemble, et font des embuscades;
Pour vne lâcheté, tous ſe font Camarades:	Pour ra lâcheté, tous se font Camarades:
C’eſt vn Monſtre à ſept teſtes, vn Hydre renaiſſant, Eir attaquer en feur, e eſc en attaquer cent;	C'est un Monstre à sept têtes, un Hydre renaissant, Eir attaquer en seur, é ç en attaquer cent;
Et lors qu’ils ont donné deux mille coups d’Epées, La brigue ſe diſſipe, & reprend les briſées.	Et lors qu'ils ont donné deux mille coups d'Épées, La brigue se dissipe, et reprend les brisées.
CLIDAMIS.	CLIDAMIS.
De ces indignitez ie prens peu de ſoucy.	De ces indignités après prends peu de souci.
CLEANDRE.	CLÉANDRE.
Tu ne ſçais pas encor comme on en vſe icy;	Tu ne sais pas encor comme on en use ici;
Mais on uit que le teps aprentt beaucoup de choſes!	Mais on uit que le teps après beaucoup de choses!
Tu verras tous les jours telles metamorphoſes, Que tu ſeras contraint d’auoüer à ton tour, Que tu n’en vis iamais de ſemblables à la Cour.	Tu verras tous les jours telles métamorphoses, Que tu seras contraint d'auoüer à ton tour, Que tu n'en vis jamais de semblables à la Cour.
CLIDAMIS.	CLIDAMIS.
aace ancouro contus, le me pulo riencomprendre.	aace ancouro contus, le me pulo riencomprendre.
CLEANDRE.	CLÉANDRE.
Veux-tu bien m’écouter?	Veux-tu bien m'écouter?
CLIDAMIS.	CLIDAMIS.
Oüy.	Oui.
CLEANDRE.	CLÉANDRE.
Ie vay donc t’apprendre D’étranges veritez, & qui, comme ie croy, Ne ſont juſqu’à preſent ignorées que de toy:	Je vais donc t'apprendre D'étranges vérités, et qui, comme tu crois, Ne sont jusqu'à présent ignorées que de toi:
N’as-tu pas ouy parier des coppieux de la Fleche?	N'as-tu pas ouï parier des coppieux de la Flèche?
CLIDAMIS.	CLIDAMIS.
C’eſt faire à leur honneur vne effroyable breche, Et ſi tu perſeuere à m’en apprendre tant, I’auray lieu de te croire à la fin médiſant, Et ie ſoupçonnerois quelque Serpent ſous l’herbe.	C'est faire à leur honneur une effroyable brèche, Et si tu persuère à m'en apprendre tant, J'aurai lieu de te croire à la fin médisant, Et ie soupçonnerois quelque Serpent sous l'herbe.
CLEANDRE.	CLÉANDRE.
cecy, depuis ſongtenips, par tout pane en Prouerbe, Et ie ne te dis rien qui ne ſoit approuué.	ceci, depuis songtenips, par tout pane en Prouerbe, Et toujours ne te dis rien qui ne soit approuvé.
GLIDAMIS.	GLIDAMIS.
Soit Baron, ſoit Marquis, ſoit vn Comte trouué, Comte, Baron, Marquis, ou Fable que tu forges, Ie veux bien.	Soit Baron, soit Marquis, soit un Comte trouvé, Comte, Baron, Marquis, ou Fable que tu forges, Je veux bien.
CLEANDRE.	CLÉANDRE.
Reuiens-tu des Païs d’Allobroges, Diſciple mécreant du Protecteur d’icy?	Reviens-tu des Pays d'Allobroges, Disciple mécreant du Protecteur d'ici?
Pourquoy t’opiniâtrer auant d’eſtre éclaircy?	Pourquoi t'opiniâtrer avant d'être éclairci?
Pourquoy ne veux-tu pas que ie te faſſe entendre?	Pourquoi ne veux-tu pas que sans te fasse entendre?
Et pourquoy.	Et pourquoi.
* S.	* S.
Thomas Parroiße de la Fleche.	Thomas Parroise de la Flèche.
DERE AA SA RC.	DERE AA SA RC.
C’eſt aſſez, parle ſans plus attendre, Ie te preſte ſilence, & te jure ma foy, Que tu ne ſeras plus interrompu par moy.	C'est assez, parle sans plus attendre, Je te prête silence, et te jure ma foi, Que tu ne seras plus interrompu par moi.
CLEANDRE.	CLÉANDRE.
Sçache, qu’en cette gueuſe & miſerable Ville, L’Homme le plus parfait paſſe pour mal-habile;	Sache, qu'en cette gueuse et misérable Ville, L'Homme le plus parfait passe pour malhabile;
Que tous les Gens d’eſprit, & les plus éclairez, Par nos Barons Flechois ſont icy cenſurez:	Que tous les Gens d'esprit, et les plus éclairez, Par nos Barons Flechais sont ici censés:
Fuſſe le plus poly, le mieux mis, le plus leſte, Le plus ſelon la mode, on luy rendra ſon reſte.	Fusse le plus poli, le mieux mis, le plus leste, Le plus selon la mode, on était rendra son reste.
Porte-t’on Bas vnis, porte-t’on grands Canons, On n’eſt pas aſſuré de plaire à nos Barons:	Porte-t-on Bas unis, porte-t-on grands Canons, On n'est pas assuré de plaire à nos Barons:
Si l’on va ſans façon, ils diſent que c’eſt feinte;	Si l'on va sans façon, ils disent que c'est feinte;
Si l’on marche biẽ droit, c’eſt par trop de cõtrainte.	Si l'on marche bien droit, c'est par trop de comtrainte.
Qu’on cache ſes defauts, qu’on eſt eſtropié, Quoy que tu faſſe enfin, tu te verras coppié;	Qu'on cache ses défauts, qu'on est estropié, Quoi que tu fasse enfin, tu te verras coppié;
Et dans deux jours au plus, ils feront ie t’aſſure, De tes vices inconnus, vne juſte peinture;	Et dans deux jours au plus, ils feront venir t'assure, De tes vices inconnus, une juste peinture;
Car nous auons icy (mais ſans l’auoir cherché).	Car nous avons ici (mais sans l'avoir cherché).
Vn Peintre clairvoyant, à qui rien n’eſt caché, Aminte le ſubtil, de qui la veine plate Infecte le Païs (ie te veux dire éclate.	Un Peintre clairvoyant, à qui rien n'est caché, Aminte le subtil, de qui la veine plate Infecte le Pays (ie te veux dire éclate.
Penſe-tu que ce ſoit vn Poëte d’Auribus, Ou quelque ma lotru Profeſſeur de Bibus?	Penses-tu que ce soit un Poète d'Ouribus, Ou quelque ma lotru Professeur de Bibus?
Il ne cede à pas-vn, c’eſt vn Corneille en herbe, Il ſurpaſſe Ronſard, Boyer, Quinault, Malherbe;	Il ne cède à pas-même, c'est un Corneille en herbe, Il surpasse Ronsard, Boyer, Quinault, Malherbe;
Ses écrits valent mieux qu’vn Ragouſt plein de ſel, Bref, c’eſt vn vray Pedan, vn Homme vniuerſel, Qui ſçait également la Proſe & la Satyre, Qui ſçait parler par cœur, lire, imprimer, écrire, Et qui force de lire, & faire des écrits, Renferme en ſon Eſprit tous les plus beaux Eſprits:	Ses écrits valent mieux qu'un Ragoût plein de sel, Bref, c'est un vrai Pedan, un Homme universel, Qui sait également la Prose et la Satyre, Qui sait parler par cœur, lire, imprimer, écrire, Et qui force de lire, et faire des écrits, Renferme en son Esprit tous les plus beaux Esprits:
Sa conuerſation, & ſa douceur extréme, Poliroit ſur le champ l’inciuilité méme;	Sa conversation, et sa douceur extrême, Polirait sur le champ l'incivilité même;
C’eſt vn Braue acheué, bref vn Hétos du temps, Qui feroit au beſoin peur aux petits Enfans;	C'est un Brave achevé, bref un Hétos du temps, Qui ferait au besoin peur aux petits Enfants;
Et le croy lui ma loy, tantneit redoucable, S’il eſtoit en humeur, qu’il feroit peur au Diable.	Et le crois -lui ma loi, tantneit redoucable, S'il était en humeur, qu'il ferait peur au Diable.
Voila du digne Aminte vn Crayon imparfait, Reſte à toy d’en juger, par, ce qu’il n’a pas fait.	Voilà du digne Aminte un Crayon imparfait, Reste à toi d'en juger, par, ce qu'il n'a pas fait.
CLIDAMIS.	CLIDAMIS.
La curioſité me porte à le connoiſtre, Et voir ce grand Autheur, mais ie n’oſe paroiſtre Deuant ce Goliath, en ſçauoir ſi profond.	La curiosité me porte à le connaître, Et voir ce grand Auteur, mais rien n'ose paraître Deuant ce Goliath, en sçauoir si profond.
CLEANDRE, Ton interruption me trouble & me confond;	CLEANDRE, Ton interruption me trouble et me confond;
N’en peux-tu pas juger deſſus cette Coppie?	N'en peux-tu pas juger dessus cette Coppie?
CLIDAMIS.	CLIDAMIS.
le n’ay pas comine toy, lidée naute & hardie.	le n'ai pas comine toi, lidée naute et hardie.
CLEANDRE.	CLÉANDRE.
Puis donc que tu ne peux conceuoir bien ou mal, Ie te le feray voir en propre Original.	Puis donc que tu ne peux concevoir bien ou mal, Je te le ferai voir en propre Original.
Ie l’apperçoy deje, done, e voila qui paſſe, Il vient droit deuers nous.	Je l'aperçois deje, done, é voilà qui passe, Il vient droit devers nous.
CETDAMTOC.	CETDAMTOC.
Par où?	Par où?
CEEANDRE.	CEANDRE.
Par la Ruë baſſe.	Par la Rue basse.
CLIDAMIS.	CLIDAMIS.
Lequel eſt-ce des deux?	Lequel est-ce des deux?
ie ne le connois point.	On ne le connais point.
CLEANDRE.	CLÉANDRE.
C’eſt celuy qui des deux rẽplit mieux sõ pourpoint;	C'est celui qui des deux renplit mieux s pourpoint;
Ce gros Ventripotens, Nouriſton de Minerue, Dont l’Eſprit trop enflé, faitque preſqu’il en creue:	Ce gros Ventripotens, Nouriston de Minerve, Dont l'Esprit trop enflé, faitque presqu'il en crève:
Il s’approche de nous.	Il s'approche de nous.
CLIDAMIS.	CLIDAMIS.
Ie commence à le voir:	Je commence à le voir:
C’eſt donc ce haudrier, garfij de frairge, noir?	C'est donc ce haudrier, garfij de frairge, noir?
Celuy qui me paroiſt des deux le plus vieil d’âge, A tient ferme ſon rang, il prend ſon auantage Sur le haut du paué.	Celui qui me paraît des deux le plus vieil d'âge, A tient ferme son rang, il prend son avantage Sur le haut du pavé.
CLEANDRE bas.	CLÉANDRE bas.
Oüy, c’eſt luy, juſtement.	Oui, c'est ainsi, justement.
GLIDAMIS.	GLIDAMIS.
La peſte!	La peste!
il a la mine & le port d’vn Flamand;	il a la mine et le port d'une Flamand;
Il va baiſſant le nez comme vn Porc qui ſe carre:	Il va baissant le nez comme un Porc qui se carre:
Sa garniture auſſi me paroiſt bien bizarre;	Sa garniture aussi me paraît bien bizarre;
O Dieux!	Ô Dieux!
quelle couleur celle de ſon habit!	quelle couleur celle de son habit!
Il n’a point de Perruque, il eſt tout interdit;	Il n'a point de Perruque, il est tout interdit;
Il reſſemble à.	Il ressemble à.
ma foy, ie ne puis dire comme.	ma foi, Seigneur ne puis dire comme.
On diroit, à le voir, qu’il n’a iamais veu d’Homme, Tant pour me cõtempler, il ouure ſes grands yeux:	On dirait, à le voir, qu'il n'a jamais vu d'Homme, Tant pour me cõtempler, il ouvre ses grands yeux:
Mais, dis-moy, n’eſt-ilpoint du nõbre des Coppieux?	Mais, dis-moi, n'est-ilpoint du nombre des Coppieux?
Et lon Comite auſſi, quel eſt-il?	Et lon Comite aussi, quel est-il?
CLEANDRE.	CLÉANDRE.
Nicodeme.	Nicodeme.
Mais parlant de Coppieux, tu le deuiens toy-méme;	Mais parlant de Coppieux, tu le deviens toi-même;
Tu viens, ſans y penſer, de faire vn tel Portrait, Q’on pourent teniger en Coppleux tres-parfait:	Tu viens, sans y penser, de faire un tel Portrait, QU'on pour teniger en Coppleux très-parfait:
Dans ton ébauchement tu m’as beaucoup fait rire.	Dans ton ébauchement tu m'as beaucoup fait rire.
CLIDAMIS.	CLIDAMIS.
C’eſt peut-eſtre que l’air d’icy que l’on reſpire, Rend naturellement tous les Hommes Coppieux:	C'est peut-être que l'air d'ici que l'on respire, Rend naturellement tous les Hommes Coppieux:
Mais blâmeras-tu point mon deſir curieux?	Mais blâmeras-tu point mon désir curieux?
Et ne ſçauray-je point quel eſt ce Perſonnage, hous montte noren le nez de foh vnage;	Et ne saurai-je point quel est ce Personnage, hous montte noren le nez de foh age;
Ils ſont enſeuelis dans vn long entretien Qu’ils ne peuuent quitter.	Ils sont ensevelis dans un long entretien Qu'ils ne peuvent quitter.
CLEANDRE.	CLÉANDRE.
C’eſt Saint Roch, & ſon Chien;	C'est Saint Roch, et son Chien;
Et iamais on n’a veu Gens hiois mreparables.	Et jamais on n'a vu Gens hiais méparables.
CLI DAMIS.	CLI DAMIS.
Ces grandes vnions ſont fort conſiderables:	Ces grandes unions sont fort considérables:
Mais Nicodeme eſt-il vn Homme de renom?	Mais Nicode est-il un Homme de renom?
CLEANDRE.	CLÉANDRE.
Aminte eſt ſatisfait, qu’il réponde, oüy, non, Dans la neceſſité, ſelon qu’il luy demande, Ou ſelon que la Piece eſt plus courte, ou plusgrande;	Aminte est satisfait, qu'il réponde, oui, non, Dans la nécessité, selon qu'il lui demande, Ou selon que la Pièce est plus courte, ou plusgrande;
Car tu n’ignore pas qu’Anmite eſt l’Orâteur, Que l’Auditeur eſt l’autre, & ſon Admirateur.	Car tu n'ignore pas qu'Anmite est l'Orâteur, Que l'Auditeur est l'autre, et son Admirateur.
CLIDAMIS.	CLIDAMIS.
Pourquoy ce nom d’Aminte?	Pourquoi ce nom d'Aminte?
il me choque l’oreille, Eſt-ce luy qui l’a pris?	il me choque l'oreille, Est-ce un qui l'a pris?
CLEANDRE.	CLÉANDRE.
Ce n’eſt pas ſans merueille, Et c’eſt par là qu’on voit qu’il a bon jugement.	Ce n'est pas sans merveille, Et c'est par là qu'on voit qu'il a bon jugement.
Peut-on en inuenter vn qui ſoit plus charmant?	Peut-on en inventer un qui soit plus charmant?
Faut-il pas aſſortir les noms à la perſonne?	Faut-il pas assortir les noms à la personne?
Vois-tu pas qu’il auoit l’intention tres-bonne?	Vois-tu pas qu'il avait l'intention très-bonne?
Qu’vn Homme cõme luy, qui n’a rien du commun, Ne doit pas prendre vn nom difficile, importun, Trop rude à prononcer?	Qu'un Homme comme commun, qui n'a rien du commun, Ne doit pas prendre un nom difficile, importun, Trop rude à prononcer?
luy que l’affaire touche, Pouroit peut-eſtre vn jour ſe déboiter la bouche;	Ce que l'affaire touche, Pourait peut-être un jour se déboiter la bouche;
Ale trop repeter, ſe rompre le goſier?	Ale trop répéter, se rompre le gosier?
ſier, Ila beaucoup mieux fait d’en predrevn moins groſPeut-eſtre qu’vn moins doux luy eut dõné la Goute.	sier, Ila beaucoup mieux fait d'en predrevn moins grosPeut-être qu'un moins doux luitaît dõné la Goute.
CLIDAMIS.	CLIDAMIS.
Retirons-nous d’icy, crainte qu’il nous écoute.	Retirons-nous d'ici, crainte qu'il nous écoute.
CLEANDRE.	CLÉANDRE.
Tudis vray, Clidamis, tirons-nous a lecart, Du diuertiſſement nous aurons noſtre part.	Tudis vrai, Clidamis, tirons-nous a lecart, Du divertissement nous aurons notre part.
SCENE II.	SCÈNE II.
AMINTE, NICODEME, CLEANDRE, CLIDAMIS cachez.	AMINTE, NICODÈME, CLEANDRE, CLIDAMIS cachez.
AMINTE.	AMINTE.
I Paris a l’honneur de voir naiſtre des Hommes, ODes Eſprits releuez dans le Siecle où nous sõmes;	I Paris a l'honneur de voir naître des Hommes, ODes Esprits relevez dans le Siècle où nous sommes;
Nous pouuons dire auſſi qu’il produit des Badauts Confits dans l’ignorance, & bouffis de defauts:	Nous pouvons dire aussi qu'il produit des Badauts Confits dans l'ignorance, et bouffis de défauts:
Tel eſt le ſentiment qu’on peut auoir d’Oronte, Dont la plume & le nom me font rougir de honte:	Tel est le sentiment qu'on peut avoir d'Oronte, Dont la plume et le nom me font rougir de honte:
Ce jeune Rimailleur, par vn crime nouueau, S’eſt temerairement fait relier en Veau:	Ce jeune Rimailleur, par un crime nouveau, S'est témérairement fait relier en Veau:
Il a crû, s’érigeant en Poëte fort celebre, Que la Satyre eſtoit vne Oraiſon funebre;	Il a cru, s'érigeant en Poète fort célèbre, Que la Satire était une Oraison funèbre;
Et s’eſt imaginé qu’il excelloit dans l’Art, Que le grand Apollon communique à Fouſſard, On dit (& ie le ſçay) que la noble Poëſie Eſt vn Feu tout Diuin, ou Celeſte Folie, Qui rauit les Eſprits, qui captiue les ſens, Et qui traiſne apres ſoy des plaiſirs rauiſſans:	Et s'est imaginé qu'il excellait dans l'Art, Que le grand Apollon communique à Foussard, On dit ( ie le sais) que la noble Poësie Est un Feu tout Divin, ou Celeste Folie, Qui ravit les Esprits, qui captive les sens, Et qui traîne après soi des plaisirs ravissants:
Mais la ſienne n’a rien de ce Feu magnanime Qui remplit la vertu d’vn Poëte, qui l’anime, Et qui luy fait gouſter vn Nectar plein de miel Qui le conduit à pied, juſqu’au cinquiéme Ciel.	Mais la sienne n'a rien de ce Feu magnanime Qui remplit la vertu d'un Poète, qui l'anime, Et qui avait fait goûter un Nectar plein de miel Qui le conduit à pied, jusqu'au cinquième Ciel.
Auſſi ie n’apperçoy dans ſes Burleſques nulles, Que des injures baſſes, ou ſaillies ridicules, Qui font voir à regret qu’vn Nouice inſolent Ne ſçauroit offenſer vn braue Homme, vn Galant;	Aussi ici n'aperçois dans ses Burlesques nulles, Que des injures basses, ou saillies ridicules, Qui font voir à regret qu'un Novice insolent Ne saurait offenser un brave Homme, un Galant;
Car il faudroit auoir vn Eſprit ſans chemiſe, Pour ſe ſentir piqué de ſa ſotte ſottiſe:	Car il faudrait avoir un Esprit sans chemise, Pour se sentir piqué de sa sotte sottise:
Il faudroit meſme auoir indigence d’Eſprit, Pour jetter de hon œil les yeux ſur ſon Ecrit.	Il faudrait même avoir indigence d'Esprit, Pour jeter de hon œil les yeux sur son Écrit.
Il a pourtant voulu que tout le Monde croye, Que ſes Vers déchirez eſtoient des Vers à ſoye;	Il a pourtant voulu que tout le Monde croie, Que ses Vers déchirés étaient des Vers à soie;
I'en ay leu quelques-vns auec tant de dégouſt, Que ie les ay trouuez ſans pointe & ſans ragouſt:	J'en ai lu quelques-mêmes était tant de dégoût, Que tu les ai trouvés sans pointe et sans ragoût:
Ce qui m’a fait courir d’vne ardeur nompareille, Aux œuures du Diuin & du Sage Corneille, Comme au vray Lenitif, au vray Contrepoiſon, Afin de réintegrer en mon Chef ma raiſon:	Ce qui m'a fait courir d'une ardeur nompareille, Aux œuvres du Divin et du Sage Corneille, Comme au vrai Lénitif, au vrai Contrepoison, Afin de réintegrer en mon Chef ma raison:
I’ay tres-bien reconnu par ſa boufonnerie, Qu’il ignoroit encor la fine raillerie;	J'ai très-bien reconnu par sa boufonnerie, Qu'il ignorait encor la fine raillerie;
Et que ſi ce Nouice (Icar audacieux) Eût eu beaucoup d’Eſprit, qu’il ſeroit dangereux, Qu’il écriuoit malgré Minerue & la Nature, Sans pratiquer des Vers la regle & la meſure;	Et que si ce Novice (Icar audacieux) Eût eu beaucoup d'Esprit, qu'il serait dangereux, Qu'il écrivait malgré Minerve et la Nature, Sans pratiquer des Vers la règle et la mesure;
Et que ſa jalouſie a profeſſer cet Art, L’auoit ſollicité de ſuiure vn Ve au Foußard.	Et que sa jalousie a professer cet Art, L'avait sollicité de suivre un Ve au Foussard.
I’ay ſans doute obſerué.	J'ai sans doute observé.
ie le dis à ma honte) Vn ſilence muet ſur ces defauts d’Oronte, Et i’ay fait par pitié qu’aucun Poëte n’a pas Crié, qu’Oronte auoit les oreilles à Midas.	Les le dis à ma honte) Un silence muet sur ces défauts d'Oronte, Et j'ai fait par pitié qu'aucun Poète n'a pas Crié, qu'Oronte avait les oreilles à Midas.
Quoy!	Quoi!
pouuoit-on, Meſſieurs, l’obliger dauantage, Qu’en luy donnant l’auis de deuenir plus ſage?	pouvait-on, Messieurs, l'obliger davantage, Qu'en apprendre donnant l'avis de devenir plus sage?
Car le ſoin que ie prens de donner des auis, Fait que bons & mauuais, aucuns ne ſont ſuiuis.	Car le soin que personne prends de donner des avis, Fait que bons et mauvais, aucuns ne sont suivis.
Il déuroit s’enfermer dans vne Nuit profonde, Plutoſt que de chercher le jour & le grand Monde;	Il devrait s'enfermer dans une Nuit profonde, Plutôt que de chercher le jour et le grand Monde;
Et s’il auoit encor vn reſte de pudeur, Il deuroit à mes Vers faire vn peu plus d’honneur, Il deuroit ſuprimer ſa Rime criminelle, Reſpecter mes Ecrits d’vn hommage fidelle;	Et s'il avait encor un reste de pudeur, Il devrait à mes Vers faire un peu plus d'honneur, Il devrait suprimer sa Rime criminelle, Respecter mes Écrits d'un hommage fidèle;
Mais l’inſolent qu’il eſt, par ſes indignes traits, S’attaque, & contredit a mes riches Portraits:	Mais l'insolent qu'il est, par ses indignes traits, S'attaque, et contredit à mes riches Portraits:
Ne ſçait-il pas encor que ma verve excellente Eſt d’vne qualité copieuſe, abondante?	Ne sait-il pas encor que ma verve excellente Est d'une qualité copieuse, abondante?
que le me purs vanter a terjour qu teu jourd’huy, Que, ſans comparaiſon, ie vaux bien mieux que luy?	que le me purs vanter a terjour qu' ein jourd'hui, Que, sans comparaison, quelque vaux bien mieux que lui?
CLIDAMIS à part.	CLIDAMIS à part.
O le plaiſant Faquin!	Ô le plaisant Faquin!
bon Dieu, comme il raiſonne!	bon Dieu, comme il raisonne!
AMTNIE.	AMTNIE.
Nonobſtant tout cela, ma bonté luy pardonne;	Nonobstant tout cela, ma bonté Seigneur pardonne;
Et priuatiuement, par vn Dogme inoüy, Ie le veux conſeruer & combler d’honneur.	Et privativement, par un Dogme inoüy, Je le veux conserver et combler d'honneur.
NICODEME.	NICODÈME.
Oüy.	Oui.
AMINTE.	AMINTE.
Mais ſous condition qu’il fera ſes excuſes Au Diumn Apollon, à ſes Sœurs les neuf Muſes;	Mais sous condition qu'il fera ses excuses Au Diumn Apollon, à ses Sœurs les neuf Muses;
Qu’il aura du paſſé le repentir tres-bon, Et qu’il ne fera plus delormais le fat.	Qu'il aura du passé le repentir très-bon, Et qu'il ne fera plus délormais le fat.
NICODEME.	NICODÈME.
Nòn.	Nenn.
AMINTE.	AMINTE.
Car il eſt à propos, pour la faute commiſe, De garder vn peu l’ordre auec ces Gens d’Egliſes Ie crains ſon itiie aiſe, burierque, & réjoüy;	Car il est à propos, pour la faute commise, De garder un peu l'ordre avec ces Gens d'Églises Je crains son itiie aise, burierque, et réjoui;
S’il m’alloit inſulter, ie ſerois perdu.	S'il m'allait insulter, on serais perdu.
NTCODEME.	NTCODEME.
Oüy.	Oui.
AMINTE.	AMINTE.
Vne humeur pacifique eſt bien plus à la mode;	Une humeur pacifique est bien plus à la mode;
Vn Homme de Palais fouuent nous incommode, Sa plume eſt pire encor que le bruit d’vn Canon;	Un Homme de Palais fassent nous incommode, Sa plume est pire encor que le bruit d'un Canon;
Vn Aduocat en teſte, eſt vn Diable,	Un Aduocat en tête, est un Diable,
NICODEME.	NICODÈME.
Oüy, non.	Oui, non.
CLIDAMIS à part.	CLIDAMIS à part.
O Dieun.	Ô Dieun.
que fon ancours ent rempiy de vetille!	que son ancours ent rempii de ville!
Voyons-le de plus pres:	Voyons-le de plus près:
i’enrage, ie petille, Du deſir empreſſé que i’ay de l’aborder:	j'enrage, votre petille, Du désir empressé que j'ai de l'aborder:
Tais-ſuy ton compliment.	Tais-lui ton compliment.
11 C114 CLEANDRE bas.	11 C1114 CLEANDRE bas.
Ie ne puis m’hazarder;	Je ne puis m'hasarder;
Il n’eſt pas encor temps de faire noſtre approche,	Il n'est pas encor temps de faire notre approche,
CLIDAMIS.	CLIDAMIS.
Sortons, ie voy qu’il tire vn papier de ſa poche.	Sortons, Seigneur vois qu'il tire un papier de sa poche.
SCENE III.	SCÈNE III.
ihlemouy omin iMlo, MINTE, NICODEME.	ihlémoui omin iMlo, MINTE, NICODÈME.
CLEANDRE.	CLÉANDRE.
Minte, ie ſçay bien que c’eſt infirmité, ADe s’approcher de vous ſans l’auoir merité;	Minte, Madame sais bien que c'est infirmité, ADe s'approcher de vous sans l'avoir mérité;
Que pour le meriter, il ſuadron enre vil Tomime Remply du Dieu Bacchus, ennemy de la Pomme:	Que pour le mériter, il suadron enre vil Tomime Rempli du Dieu Bacchus, ennemi de la Pomme:
Cet hõneur eſt ſi grãd, qu’il doit m’eſtre biẽ doux.	Cet honneur est si grand, qu'il doit m'être bien doux.
AMINTE.	AMINTE.
Soyez le bien trouué, ie m’en allois chez vous, Pour vous offrir encor vne Piece nouuelle Il luy Que ie fis hyer au roi toueture d la enandene dône Sur vn tres-beau Sujet profitable & plaiſant, vn paVn petit mot d’auis fait pour vn Médiſant:	Soyez le bien trouvé, Seigneur m'en allais chez vous, Pour vous offrir encor un Pièce nouvelle Il m Que ie fis hier au rois touéture d la en dône Sur un très-beau Sujet profitable et plaisant, un paUn petit mot d'avis fait pour un Médisant:
Auant que de le lire, apprenez-en la cauſe.	Avant que de le lire, apprenez-en la cause.
pier.	pier.
CLEANDRE.	CLÉANDRE.
Traittez-vous ce Sujet en Vers, ou bien en Proſe?	Traittez-vous ce Sujet en Vers, ou bien en Prose?
Car l’on eſt grandement amoureux de vos Vers;	Car l'on est grandement amoureux de vos Vers;
Pour en attraper vn, faut courir l’Vniuers.	Pour en attraper un, faut courir l'Univers.
Vous auez le renom d’eſtre excellent Copiſte.	Vous avez le renom d'être excellent Copiste.
Mais qu’elt-ce tout cela:	Mais qu'ellet-ce tout cela:
juites Dieux!	juites Dieux!
quelle Liſte?	quelle Liste?
Auez-vous entrepris de nous en accabler?	Avez-vous entrepris de nous en accabler?
SAminte tire de ſa poche vne quantité de ſes œuures,	SAminte tire de sa poche une quantité de ses œuvres,
Non, non.	Non, non.
AMINTE.	AMINTE.
CLEANDRE.	CLÉANDRE.
La quantité me fait déja trembler, Et voila bien pour moy pour vn mois de lecture;	La quantité me fait déjà trembler, Et voilà bien pour moi pour un mois de lecture;
Ie n’ay pas comme vous ce grand don de Nature, Car l’on ſçait quevous eſtes (& i’en ſuis tres-certain) De ce que vous liſez, l’Autheur, ou l’Ecriuain.	Je n'ai pas comme vous ce grand don de Nature, Car l'on sait quevous êtes (1 j'en suis très-certain) De ce que vous lisez, l'Auteur, ou l'Écrivain.
AMINTE.	AMINTE.
Si vous me refuſiez, vous ſeriez peu traitable:	Si vous me refusiez, vous seriez pu traitable:
Non, non, ne craignez pas que ſi peu vous accable;	Non, non, ne craignez pas que si peu vous accable;
vn braue comme vous ne manque pas d’Amiis, Vous en diſtriburez quelques-vns.	un brave comme vous ne manque pas d'Amiis, Vous en distriburez quelques-uns.
CLEANDRE bas.	CLÉANDRE bas.
Clidamis, vois tu le procedé de ce fou Perſonnage?	Clidamis, vois tu le procédé de ce fou Personnage?
haut.	haut.
Si tu t’en veux charger, faiſons-en le partage, Aminte eſt liberal, il en donne à foiſon.	Si tu t'en veux charger, faisons-en le partage, Aminte est libéral, il en donne à foison.
CLIDAMIS.	CLIDAMIS.
Te les oſter des mains, ie n’aurois pas raiſon, I’aime mieux m’en paſſer.	Te les ôter des mains, je n'aurais pas raison, J'aime mieux m'en passer.
AMINTE à Cleandre.	AMINTE à Clandre.
Non, non, gardez les voſtres;	Non, non, gardez les vôtres;
Si Monſieur en deſire, il en reſte encor d’autres, Il en donne tout autant à Clidamis.	Si Monsieur en désire, il en reste encor d'autres, Il en donne tout autant à Clidamis.
Et ie ſens en auoir quelque douzaine icy, Et chez mon Imprimeur, chez mon Libraire auſſy, Car i’en fais de chacun tirer pluſieurs centaines.	Et petit sens en avoir quelque douzaine ici, Et chez mon Imprimeur, chez mon Libraire aussi, Car j'en fais de chacun tirer plusieurs centaines.
Il ſort auec Nicodeme.	Il sort avec Nicodeme.
CLEANDRE.	CLÉANDRE.
C’eſt auſſi pour cela qu’il les donne à douzaines, Qu’il fournit de papier la ville & les rauxbourgs;	C'est aussi pour cela qu'il les donne à douzaines, Qu'il fournit de papier la ville et les rauxbourgs;
Cela nous eſt commun, il en fait tous les jours;	Cela nous est commun, il en fait tous les jours;
Et ie croy, ſur ma foy, que ſans ſon miniſtere, Chacun auec ſes doigts torcheroit ſon derriere:	Et ie au, sur ma foi, que sans son ministère, Chacun avec ses doigts torcherait son derrière:
Mais pour nousvoir chommer, il eſt trop obligeant.	Mais pour nousvoir chommer, il est trop obligeant.
CLIDAMIS.	CLIDAMIS.
Comment donc, tout cela ne couſte pointd’argent?	Comment donc, tout cela ne coûte pointd’argent?
CLEANDRE.	CLÉANDRE.
D’argẽt!	D'argent!
te moque-tu?	te moque-tu?
Voit-onquelqu’vn en France Plus large par le dos?	Voit-onquelqu'Hô en France Plus large par le dos?
Il fait cette dépenſe Luy ſeul il entretient, quand il eſt en humeur, Libraire, & Porte-colle, & le Maiſtre Imprimeur.	Il fait cette dépense Lui seul il entretient, quand il est en humeur, Libraire, et Porte-colle, et le Maître Imprimeur.
CLIDAMIS.	CLIDAMIS.
Sõ depart bruſque & prõpt hors de noſtre preſence, Nous apprend qu’il eſt fou juſqu’à l’extrauagance:	Somme départ brusque et prompt hors de notre présence, Nous apprend qu'il est fou jusqu'à l'extravagance:
Il en eſt plus de trente aux Petites-Maiſons Qui nous auroient fait voir autrement leurs talons.	Il en est plus de trente aux Petites-Maisons Qui nous auraient fait voir autrement leurs talons.
Mais pour ne point paſſer tout à fait pour Beliſtres, De tous ces beaux larcins voyõs au moins les titres.	Mais pour ne point passer tout à fait pour Bélistres, De tous ces beaux larcins voyõs au moins les titres.
Voicy donc comme à toy, l’Auis au Médiſant.	Voici donc comme à toi, l'Auis au Médisant.
CLEANDND Sans doute que l’Auis ſera fort rauiſſant:	CLÉANDND Sans doute que l'Auis sera fort ravissant:
Mais paſſe outre.	Mais passe outre.
CLIDAMIS.	CLIDAMIS.
Voicy, ie penſe, vne Elegie contre faflrenian, aucc l’Apologie Du Langage poly que l’on parle à la Couf	Voici, Seigneur pense, une Élégie contre faflenian, aucc l'Apologie Du Langage poli que l'on parle à la Couf
CLEANDRE.	CLÉANDRE.
Qu’eſt-ce qui ſuit apres?	Qu'est-ce qui suit après?
CLIDAMIS.	CLIDAMIS.
Vne Piece d’amour, e tipour la belle Iris vne autre Apologie.	Une Pièce d'amour, eu tipour la belle Iris un autre Apologie.
CLEANDRE bas.	CLÉANDRE bas.
Il hous viendra peut-cire encer vne megie.	Il hous viendra peut-cire encer une mégie.
CLIDAMIS.	CLIDAMIS.
Non, non, ce ſont des Vers ſur la mort de l’Infant.	Non, non, ce sont des Vers sur la mort de l'Infant.
CLEANDRE.	CLÉANDRE.
Que nous vient-il apres?	Que nous vient-il après?
CLI DAMIS.	CLI DAMIS.
C’eſt vn Amour naiſſant, Qu’il appelle autrement, l’Amour de Sympathie.	C'est un Amour naissant, Qu'il appelle autrement, l'Amour de Sympathie.
CLEANDRE à part.	CLÉANDRE à part.
Vne Table iamais ne fut mieux aſſortie.	Une Table jamais ne fut mieux assortie.
Acheue donc.	Achève donc.
CLIDAMIS.	CLIDAMIS.
Voicy quelque Ouurage Diuin;	Voici quelque Ouvrage Divin;
Vn Poëme compure lur foitre granld Dauphin, Qu’il a fait ſur le champ au jour de ſa naiſſance.	Un Poème compure lur faitre granld Dauphin, Qu'il a fait sur le champ au jour de sa naissance.
CLEANDRE.	CLÉANDRE.
Ce jour eit glorieux pour toute noſtre France:	Ce jour eit glorieux pour toute notre France:
Mais pourſuis, qu’eſt-ce là?	Mais poursuis, qu'est-ce là?
CLIDAMIS.	CLIDAMIS.
Geia, e cie mi Portrait, Où ie ſuis aſſeuré qu’il n’y manque aucun trait, Puis que c’eſt le Portrait de la belle Lucie.	Géjà, est cie mi Portrait, Où je suis assuré qu'il n'y manque aucun trait, Puis que c'est le Portrait de la belle Lucie.
CLEANDRE.	CLÉANDRE.
le n’ay ramais rien veu de plus plat en ma vie;	le n'ai ramais rien vu de plus plat en ma vie;
Tourne, & tu trouueras ſon accompliſſement;	Tourne, et tu trouveras son accomplissement;
Ie veux eſtre berné coninie virfat, la le nient.	Je veux être berné coninie virfat, la le nient.
CLIDAMIS.	CLIDAMIS.
Tu dis vray, le voiey.	Tu dis vrai, le voiei.
mais ceit perdre mes peines Laiſſons cela.	mais ceit perdre mes peines Laissons cela.
CLEANDRE.	CLÉANDRE.
Non, non, qu’eſt-ce apres?	Non, non, qu'est-ce après?
CLIDAMIS.	CLIDAMIS.
Des Etreines Qu’il preſente à la meſme:	Des Étreines Qu'il presente à la même:
En ſuite eſt vn Echo;	En suite est un Écho;
La rime-eſt difficile;	La rime-est difficile;
à moins que dire écot, On ne la peut trouuer;	à moins que dire écot, On ne la peut trouver;
mais c’eſt trop d’vne lettre.	mais c'est trop d'une lettre.
CLEANDRE.	CLÉANDRE.
Dans vn coup de beſoin cela ſe peut permettre, Vne lettre eſt trop peu pour captiuer les gens.	Dans un coup de besoin cela se peut permettre, Une lettre est trop peu pour captiver les gens.
Qu’eſt-ce qui ſuit?	Qu'est-ce qui suit?
CLIDAMIS.	CLIDAMIS.
Ce ſont les diuertiſſemens De la meſme, le croy;	Ce sont les divertissements De la même, le crois;
la Dalle & la outalle.	la Dalle et la outalle.
CLEANDRE.	CLÉANDRE.
C’eſt icy juſtement que le Poëte s’égare, Tant il eſt abſorbé dans les comparaiſons:	C'est ici justement que le Poète s'égare, Tant il est absorbé dans les comparaisons:
Mais c’eſt trop diſcourir, viſte, à d’autres, paſſons.	Mais c'est trop discourir, vite, à d'autres, passons.
Que reſte-t’il encor?	Que reste-t-il encor?
CLIDAMIS.	CLIDAMIS.
D’vne Fille maſquée.	D'une Fille masquée.
Vlle Galanterie	Vlle Galanterie
CLEANDRE.	CLÉANDRE.
Ho ho, c’eſt pour Lucie.	Ho ho, c'est pour Lucie.
CLIDAMIS.	CLIDAMIS.
Cette Belle, ſans doute, eſt vne rareté.	Cette Belle, sans doute, est une rareté.
CLEINDRE.	CLEINDRE.
Perſonne n’oſe icy conteſter ſa beauté:	Personne n'ose ici contester sa beauté:
Hors elle aſſurément, pas-vne ne s’en pique.	Hors elle assurément, pas-vne ne s'en pique.
CLIDAMS.	CLIDAMS.
Voicy bien des Portraits;	Voici bien des Portraits;
Le Portrait d’Angelique, Le Portrait d’Amarante, Vranie.	Le Portrait d'Angélique, Le Portrait d'Amarante, Vranie.
CLEANDRE.	CLÉANDRE.
Ers eiſcor, Peut-eſtre verrons-nous le Portrait de Medor.	Ers eiscor, Peut-être verrons-nous le Portrait de Médor.
CLIDAMIS.	CLIDAMIS.
Sont-ce des veritez, des feintes, ou des Farces?	Sont-ce des vérités, des feintes, ou des Farces?
CLEANDRE.	CLÉANDRE.
imeremient que c’eſt le Portrait des trois Graces, Chef-d’œuure de ſon crû, qu’il eſtime ſans pair.	imèremient que c'est le Portrait des trois Grâces, Chef-d'œuvre de son crû, qu'il estime sans pair.
Maſs Il’as-tu point pane le lableau de iEMIer?	Mass Il'as-tu point pane le lableau de jEMIer?
CLIDAMIS.	CLIDAMIS.
Ie ne croy pas, à moins.	Je ne crois pas, à moins.
CLEANDRE.	CLÉANDRE.
Regarde, ie t’en prie.	Regarde, Madame t'en prie.
CLIDAMIS.	CLIDAMIS.
C’eſt vnPoëme acheué;	C'est vnPoëme achevé;
Les beaux faits de l’Hõgrie, B iij.	Les beaux faits de l'Hõgrie, B ij.
bas.	bas.
N’y trouueray-je pointiquelques petits Poulets	N'y trouverai-je pointiquelques petits Poulets
CLEANDRE.	CLÉANDRE.
Il a pillé cecy ſur Monſieur Deſmarets, Au Poëme de Clouis, ou la France Chreſtienne:	Il a pillé ceci sur Monsieur Démarets, Au Poème de Clouis, ou la France Chrétienne:
Toutefois il proteſte & jure qu’elle eſt ſienne;	Toutefois il proteste et jure qu'elle est sienne;
Mais vn vol ſi public, qui pouroit l’endurer?	Mais un vol si public, qui pourrait l'endurer?
CLIDAMIS.	CLIDAMIS.
On le pouroit bien croiré, a force d’en jurer;	On le pourrait bien croiré, a force d'en jurer;
Et les plus grãds Autheurs ſont ſujets aux reproches	Et les plus grands Auteurs sont sujets aux reproches
CLEANDRE.	CLÉANDRE.
fiifijy rourone toeus deux ces papiers dãs nos poches Qu’il en ſoit l’Inuenteur, qu’il en ſoit le Pédan, Nous en volla lourmis pour le moms pour vn an,	fiifichi rourone tous deux ces papiers dans nos poches Qu'il en soit l'Inuenteur, qu'il en soit le Pédan, Nous en volla lourmis pour le moments pour un an,
CLIDAMIS.	CLIDAMIS.
Mais tous ces Imprimez luy couſtent la Piſtole.	Mais tous ces Imprimez lui coûtent la Pistole.
CLEANDRE.	CLÉANDRE.
Il eſt ſi glorieux de ce que ſon Nom vole,  qu’il ſoit reputé pour vn Maiſtre ignorant Qu’il y met ſans regret ſa peine & ſon argent.	Il est si glorieux de ce que son Nom vole, qu'il soit réputé pour un Maître ignorant Qu'il y met sans regret sa peine et son argent.
CLIDAMITO.	CLIDAMITO.
Il a donc des moyens autant & plus que trente.	Il a donc des moyens autant et plus que trente.
CLEAND EE.	CLÉAND CE.
Ie croy qu’il peut auoir deux cens liures de rente.	Je crois qu'il peut avoir deux cens livres de rente.
CLIDAMIS.	CLIDAMIS.
Ce n’eſt pas là le bien d’vn chetif Poſtillon.	Ce n'est pas là le bien d'un chétif Postillon.
CLEANDRE.	CLÉANDRE.
On dit aum qu’il vend flon apres fmion, Et qu’il s’en braue apres, ſi-toſt qu’il a faitſomme.	On dit aum qu'il vend flon après fmion, Et qu'il s'en brave après, si-tôt -il a faitsomme.
CLIDAMIS.	CLIDAMIS.
Mais ne m’as-tu pas dit qu’il eſtoit Gentilhomme Qu’il eſtoit le Parent de voſtre Gouuerneur?	Mais ne m'as-tu pas dit qu'il était Gentilhomme Qu'il était le Parent de votre Gouverneur?
CLEANDRE par exclamation.	CLÉANDRE par exclamation.
De noſtre Gouuerneur!	De notre Gouverneur!
il n’a pas cet honneur.	il n'a pas cet honneur.
Gentilhomme!	Gentilhomme!
qui luy?	qui notre?
c’eſt donc que tu te raille?	c'est donc que tu te raille?
De toute eternité ſa Mere eſt à la Taille:	De toute éternité sa Mère est à la Taille:
Apprens qu’en cette Ville il n’en eſt pas vn ſeul, Tout eſt examiné, purgé comme vn Linçeul.	Apprends qu'en cette Ville il n'en est pas un seul, Tout est examiné, purgé comme un Lineul.
CLIDAMIS.	CLIDAMIS.
Vos Barons toutefois ſe piquent de Nobleſſe.	Vos Barons toutefois se piquent de Noblesse.
CLEANDRE.	CLÉANDRE.
Permets que ie te quitte, vne affaire me preſſe;	Permets que ainsi te quitte, une affaire me presse;
Auſſi bien i’apperçoy deux de nos fiers Barons:	Aussi bien j'aperçois deux de nos fiers Barons:
Déſigne-moy l’endroit où nous nous trouuerons, Au Ieu de Paume, au Mail, au Billard, dans la Ruës Car ma peine en cela ne peut eſtre perduë, Et le luis prerc d aner par tout ou eu voudros,	Désigne-moi l'endroit où nous nous trouverons, Au Ieu de Paume, au Mail, au Billard, dans la Rues Car ma peine en cela ne peut être perdue, Et le luis prerc d aner par tout ou eu voudros,
CLIDAMIS.	CLIDAMIS.
Arouuons-nous en ces lieux, & ruyons l’embarras.	Arouvons-nous en ces lieux, et ruions l'embarras.
CLEANDRE.	CLÉANDRE.
Dãs vne heure au plus tard, on m’y verra t’attendre.	Dans quelque heure au plus tard, on m'y verra t'attendre.
CLIDAMIE.	CLIDAMIE.
le ne hlairqueruy paole premier a m’y rendre.	le ne hlairquer Paole premier a m'y rendre.
SCENE IV.	SCÈNE IV.
IOVVALII, IOLLANDRE.	JOUVALII, JOLANDRE.
IOVVELIN.	JOUVELIN.
yAron, n’as-tu point veu ce nouuel Inconnu D Qui depuis ce matin en ces lieux eſt venu?	yAron, n'as-tu point vu ce nouvel Inconnu D Qui depuis ce matin en ces lieux est venu?
POLEANDRE.	POLEANDRE.
Ie ne le connois point, Iouuelin, ou ie meure.	Je ne le connais point, Jouvelin, ou ainsi meure.
OVVELIN.	OUVELIN.
C’eſt celuy-là qui vient de ſortir toute à l’heure, Cleãdre eſt auec luy.	C'est celui-là qui vient de sortir toute à l'heure, Cleãdre est auec avec.
Maisquoy!	Maisquoy!
toûjours Bourgeois Toûjours en meſme état?	toujours Bourgeois Toujours en même état?
Pour vn Baron Fléchois I’ay pitié de te voir en ce deſordre extréme.	Pour un Baron Fléchois J'ai pitié de te voir en ce désordre extrême.
POLEANDRE.	POLEANDRE.
Iouuelin, n’eſt-ce pas ton vray Nom de Baptéme;	Jouvelin, n'est-ce pas ton vrai Nom de Baptéme;
Dequoy t’auiſes-tu maintenant d’en changer, Et depuis quand cela?	Dequoy t'avises-tu maintenant d'en changer, Et depuis quand cela?
IOVVELIN.	JOUVELIN.
Tu me fais enrager;	Tu me fais enrager;
Ie ſuis tres-bon Baron.	Je suis très-bon Baron.
POLEANDRE.	POLEANDRE.
Baron, toy?	Baron, toi?
ie le nie:	ie Le nie:
Où Diable aurois ta done perene ta Baronnie?	Où Diable aurais ta done pérène ta Baronnie?
IOVVELIN.	JOUVELIN.
Sçais-tu pas que ie ſuis le Baron des Eſſars?	Sais-tu pas que ici suis le Baron des Essars?
POLEANDRE.	POLEANDRE.
Ce Titre t’eſt venu ſans peine & ſans hazars;	Ce Titre t'est venu sans peine et sans hasards;
Ie ſçay que les Eſſars eſt vne Métairie.	Je sais que les Essars est une Métairie.
IOVVELIN.	JOUVELIN.
As-tu donc réſolu de me mettre en furie?	As-tu donc résolu de me mettre en furie?
Baron, quoy qu'hen font, appelle-Hioy barone:	Baron, quoi qu'hen font, appelle-Hioi barone:
POLEANDRE.	POLEANDRE.
Il faut donc t’appeller le Baron Potiron, Venu dans vne nuit.	Il faut donc t'appeler le Baron Potiron, Venu dans une nuit.
IOVVELIN.	JOUVELIN.
Ah!	Ah!
ie créue de rage;	Ne crève de rage;
Défais-toy, ſi tu peux, de ce groſſier langage, Appelle-moy Baron, morbleu, Baron tout cour:	Défais-toi, si tu peux, de ce grossier langage, Appelle-moi Baron, morbleu, Baron tout cour:
Sçache qu’il n’en eſt point de mieux fait à la Cour.	Sache qu'il n'en est point de mieux fait à la Cour.
POLEANDRE.	POLEANDRE.
Ta Nobleſſe pourtant, & la mienne, ſont minces.	Ta Noblesse pourtant, et la mienne, sont minces.
Qui voudroit éplucher icy dans nos Prouinces Tous les Vſurpateurs du Titre d’Ecuyers, Le nombre ſeroit grand des Nobles Roturiers:	Qui voudrait éplucher ici dans nos Provinces Tous les Vsurpateurs du Titre d'Écuyers, Le nombre serait grand des Nobles Roturiers:
Nous ſommes fortement menacez de la Taille;	Nous sommes fortement menacés de la Taille;
Et Monſieur l’Intendant doit purger la Canaille Par vn ordre abſolu qu’il a receu du Roy.	Et Monsieur l'Intendant doit purger la Canaille Par un ordre absolu qu'il a reçu du Roi.
IOVVELIN.	JOUVELIN.
Cela nous eſt à cœur, mais plus à moy, qu’à toy.	Cela nous est à cœur, mais plus à moi, qu'à toi.
Depuisquatre ou cinq ans noꝰ eſtiõs hors des Rolles;	Depuisquatre ou cinq ans nô estiõs hors des Les;
Mais la l’axe nous va courter queiques Piſtolles, Et celle de mon Pere eſt de dix-huit cens francs.	Mais la l'axe nous va courter queiques Pistoles, Et celle de mon Père est de dix-huit cens francs.
POLEANDRE.	POLEANDRE.
En effet, on ne voit par tout que des Sergens Qui battent tour à tour le Fer à la Campagne.	En effet, on ne voit par tout que des Sergents Qui battent tour à tour le Fer à la Campagne.
IOVVELIN.	JOUVELIN.
On voit par-cy, par-la, quelqu’vn qui s’en épargne:	On voit par-cy, par-la, quelqu'un qui s'en épargne:
Le Cominis mra pourtant promns, que velontiers Il feroit ſes efforts pour en rabatre vn tiers;	Le Cominis mra pourtant promns, que velontiers Il ferait ses efforts pour en rabatre un tiers;
Ainſi de dix-huit cens, ne reſteroit que douze.	Ainsi de dix-huit cents, ne resterait que douze.
POLEANDRE à part.	POLEANDRE à part.
Six cẽs frãcs pour ton Pere, autant pour ſon Epouſe.	Six cẽs francs pour ton Père, autant pour son Épouse.
POVVHDIN.	POUVHDIN.
Cela ne conuient guere à nous autres Barons;	Cela ne convient guère à nous autres Barons;
Mais peut-eſtre en payant, que nous en ſorrirons;	Mais peut-être en payant, que nous en sorrirons;
Dans trois jours au plus tard mopere en fera quitte.	Dans trois jours au plus tard mopère en fera quitte.
POLEANDRE.	POLEANDRE.
Mais lesquatre-vingts frãcs qu’il faut payer enſuite, Qui les payra pour luy?	Mais lesquatre-vingts francs qu'il faut payer ensuite, Qui les payra pour venir?
TovvusrRe Comment, quatre-vingts francs?	TovvusrRe Comment, quatre-vingts francs?
POLEANDRE.	POLEANDRE.
Oüy, oüy, quatre-vingt frãcs qu’il payra tous les ans;	Oui, oui, quatre-vingt frans qu'il payra tous les ans;
I’ay le Rolle chez nous, ie ſçay ce qui ſe paſſe.	J'ai le Rolle chez nous, on sais ce qui se passe.
IOVVELIN.	JOUVELIN.
A te dire le vray, ce Tribut m’embaraſſe:	À te dire le vrai, ce Tribut m'embarrasse:
C’eſt le Diable d’Enfer, le traiſtte Belzebut, Qui nous a de tout temps fait payer ce Tributs Sans cela nous ſerions des Roys dans la Prouince Le Fils d’vn Preſident paſſeroit pour vn Prince;	C'est le Diable d'Enfer, le traistte Belsebut, Qui nous a de tout temps fait payer ce Tributs Sans cela nous serions des Rois dans la Province Le Fils d'un President passerait pour un Prince;
Ie n’aurois iamais crû qu’on s’en fut pris à nous	Je n'aurais jamais cru qu'on s'en fut pris à nous
POLEANDRE.	POLEANDRE.
*Il ſe ſâchepec Mais dois-tu pour ſi peu témoigner ton courroux?	*Il se sâchepec Mais dois-tu pour si peu témoigner ton courroux?
FONVEENTO.	FONVENTO.
Ie ne le puis ſouffrir;	Je ne le puis souffrir;
teſtebleu, i’en enrage.	têtebleu, j'en enrage.
POLEANDRE.	POLEANDRE.
Il faut bien, malgré toy, que tu cede à l’orage Qualid ie Sortſous coiibat de toute là rigueur, Il faut caller la voile.	Il faut bien, malgré toi, que tu cède à l'orage Qualid à Sortsous coiibat de toute là rigueur, Il faut caller la voile.
IOVVELIN.	JOUVELIN.
Ah!	Ah!
morbleu, i’ay du cœur, Ie ne puis endurer qu’on nous mette à la Taille.	morbleu, j'ai du cœur, Je ne puis endurer qu'on nous mette à la Taille.
POLEANDRE.	POLEANDRE.
Pour donc t’en exempter, il faut que tu t’en aille Au plutoſt à Paris voir Meſſieurs du Conſeil.	Pour donc t'en exempter, il faut que tu t'en aille Au plutôt à Paris voir Messieurs du Conseil.
PeevsERie Il fait encor trop froid;	PevsERie Il fait encor trop froid;
ie veux que le Soleil Auparauant cela monte lur l Hemiſphere, Puis ie termineray cette mauuaiſe affaire.	Les veux que le Soleil Auparavant cela monte lur l' Emisphère, Puis ie terminerai cette mauvaise affaire.
POLEANDRE.	POLEANDRE.
Mais dans ſix mois, peut-eſtre, on n’en receura plus	Mais dans six mois, peut-être, on n'en recevra plus
IOVVELIN.	JOUVELIN.
I'aimerois mieux cẽt ois marcher les deuxpieds nus Que de me voir ainſi croupir dans la Roture.	J'aimerais mieux content ois marcher les deuxpieds nus Que de me voir ainsi croupir dans la Roture.
Quoi!	Quoi!
le moindre Bourgeoispouroit mefaire injure, A moy qui ſuis icy le Fils du Preſident?	le moindre Bourgeoispourait mefaire injure, À moi qui suis ici le Fils du Président?
POLEANDRE le tirant par ſon juſte-à-corps.	POLEANDRE le tirant par son juste-à-corps.
Mais écoute raiſon, ne t’emporte pas tant;	Mais écoute raison, ne t'emporte pas tant;
Dans ce petit Reſſort on ſçait bien qui nous ſõmes, Et nous ne pouuõs point paſſer pour Gentilshõmes:	Dans ce petit Ressort on sait bien qui nous sommes, Et nous ne pouuõs point passer pour Gentilshommes:
C’eſt vn abus, Baron;	C'est un abus, Baron;
Baron, c’eſt vn abus.	Baron, c'est un abus.
IOVVELIN.	JOUVELIN.
duis que c’eſt vn abus, ie n’en parle donc plus, Et ie veux tout à coup éteindre mon courage.	duis que c'est un abus, Seigneur n'en parle donc plus, Et tu veux tout à coup éteindre mon courage.
Mais à propos, parlons vn peu du Perſonnage, De ce nouueau venu, ie le trouue mal fait.	Mais à propos, parlons un peu du Personnage, De ce nouveau venu, Seigneur le trouve mal fait.
POLEANDRE.	POLEANDRE.
Mal fait, dis-tu, mal fait?	Mal fait, dis-tu, mal fait?
IOVVELIN.	JOUVELIN.
Oüy, mal fait tout à fait.	Oui, mal fait tout à fait.
POLEANDRE en le prenant par le bout du nez.	POLEANDRE en le prenant par le bout du nez.
En verité, dis-moy, n’as-tu point la berluë?	En vérité, dis-moi, n'as-tu point la berlue?
OVVELIN.	OUVELIN.
Ie n’ay pas comme toy l’ame ſotte & bouruë;	Je n'ai pas comme toi l'âme sotte et bourue;
l’en ſçay fort blen juger, le voy ée que le voy.	l'en sais fort blen juger, le vois ée que le vois.
POLEANDRE.	POLEANDRE.
le ne remarque en luy rien qui loit fial fait, moy.	le ne remarque en cet rien qui loit sial fait, moi.
IOVVELIN.	JOUVELIN.
Tu ne t’y connois pas, ma foy, tu me fais rire.	Tu ne t'y connais pas, ma foi, tu me fais rire.
POLEANDRE.	POLEANDRE.
Y trouue-tu, dis moy, quelque choſe à redire?	Y trouve-tu, dis -moi, quelque chose à redire?
TOVVEEIIS.	TOUVEIIS.
C’eſt qu’il n’a point d’Eſprit.	C'est qu'il n'a point d'Esprit.
POLEANDRE.	POLEANDRE.
Le connois-tu?	Le connais-tu?
IOVVELIN.	JOUVELIN.
Non pas:	Non pas:
Mais à le voir marcher, ie voy qu’il n’en a pas.	Mais à le voir marcher, ie vois qu'il n'en a pas.
Si tu ne m’en veux croire, apprens-le de Cleandre.	Si tu ne m'en veux croire, apprends-le de Clandre.
POLEANDRE.	POLEANDRE.
Ton Seruiteur, adieu.	Ton Serviteur, adieu.
IOVVELIN.	JOUVELIN.
Adien donc, Poleandre.	Adien donc, Polandre.
Mais écoute, à propos, ie te veux dire vn mot.	Mais écoute, à propos, Seigneur te veux dire un mot.
En le retenant par lebras,	En le retenant par lebras,
POLEANDRE.	POLEANDRE.
Ie ſuis trop ennuyé d’entretenir vn Sot;	Je suis trop ennuyé d'entretenir un Sot;
Toni Eiplt maſ timbre fait que ie me retire.	Toni Eiplt mas timbre fait que Ne me retire.
IOVVELIN.	JOUVELIN.
Ie raiſonne fort bien;	Je raisonne fort bien;
c’eſt que ie te veux dire, Ie te veux dire, dis-je, amprtirient ion defaut:	c'est que Seigneur te veux dire, Je te veux dire, dis-je, amprétirient ion défaut:
On m’a dit qu’il eſtoit de Paris, ce Badaut.	On m'a dit qu'il était de Paris, ce Badaut.
POLEANDRE.	POLEANDRE.
Moii pauure foquelm, que ta ſottiſe eſt grandel Pour eſtre de Paris?	Moii pauvre foquelm, que ta sottise est grandel Pour été de Paris?
IOVVELIN.	JOUVELIN.
Ne ſçais-tu que cela?	Ne sçais-tu que cela?
O la belle demande!	Ô la belle demande!
POLEANDRE.	POLEANDRE.
boiis Dieux, le fot Lourdaut!	boiis Dieux, le sot Lourdaut!
IOVVELIN.	JOUVELIN.
Puis qu’il eſt de Paris, faut bien qu’il ſoit Badaut.	Puis qu'il est de Paris, faut bien qu'il soit Badaut.
POLEANDRE.	POLEANDRE.
As-tu perdu l’Eſprit?	As-tu perdu l'Esprit?
ſeras-tu toûjours Beſte?	seras-tu toujours Bête?
N’as-tu point cette nuit couché le cul nu teſte?	N'as-tu point cette nuit couché le cul nu tête?
Ton debile Cerueau fenit bieirreuapoie.	Ton débile Cerveau fenit bieirreuapoie.
On dit vray, qu’on ſe doit défier d’vn poil doré.	On dit vrai, qu'on se doit défier d'un poil doré.
IOVVELIN.	JOUVELIN.
Qu en veux-tu dire, toy?	Qu en veux-tu dire, toi?
ma Perruque eſt bien blõde	ma Perruque est bien blombe
POLEANDRE.	POLEANDRE.
Oüy, ie ſçaybiẽ qu’elle eſt duplus beau blõd du mõde Mais ta teſte eſt bien fole, & tu ne le ſçais pas.	Oui, Seigneur sçaybiẽ qu'elle est duplus beau blo du mbide Mais ta tête est bien sole, et tu ne le sais pas.
ROVVECENV.	ROUVECENV.
Eſt-ce pour me choquer, Baron, dis-moy?	Est-ce pour me choquer, Baron, dis-moi?
POLEANDRE.	POLEANDRE.
Non pas;	Non pas;
Mais pour te corriger de ton ſot badinage.	Mais pour te corriger de ton sot badinage.
TOVVELIN.	TOUVELIN.
Le Fils d’vn Preſident doit-il eſtre plus ſage.	Le Fils d'un Président doit-il être plus sage.
Ne me diras-tu point par où s’en eſt allé.	Ne me diras-tu point par où s'en est allé.
Voudrois-tu bien me faire vn plaiſir ſignalé?	Voudrais-tu bien me faire un plaisir signalé?
POLEANDRE.	POLEANDRE.
Oüyda, de tout mon cœur, ſi la c'hoſe eſt poſſible.	Ouida, de tout mon cœur, si la c'hose est possible.
IOVVELIN.	JOUVELIN.
Eit ce que le lourrarte, ll i ert rien de penible.	Éit ce que le lourrarte, l' y jert rien de pénible.
N’as-tu point des Amis quelque part à Paris?	N'as-tu point des Amis quelque part à Paris?
POLEAND RE en ſoûriant.	POLEAND RE en souriant.
Oüy, i’en ay quelques-vns.	Oui, j'en ai quelques-mêmes.
IOVVELIN.	JOUVELIN.
Pourquoy ris-tu?	Pourquoi ris-tu?
le uhlne leo, De ta iſmphelte, leris de ta beſtlle.	le hlune leo, De ta ismphelte, léris de ta bétlle.
Ie ris	Je ris
IOVVELIN.	JOUVELIN.
Sçais-tu bien que ce ris, Baron, me ſcandaliſe?	Sais-tu bien que ce ris, Baron, me scandalise?
POLEANDRE.	POLEANDRE.
Souffre que ie te quitte, ou dis ce que tu veux.	Souffre que ie te quitte, ou dis ce que tu veux.
RONVBEIIVO Ie voudrois bien ſçauoir (mais dãs vn jour ou deux) L’état, la qualité de l’Amy de Cleandre;	RONVBEIVO Je voudrais bien savoir (mais dans un jour ou deux) L'état, la qualité de l'Ami de Cléandre;
Si c’eſt vn Gentilhomme, ou.	Si c'est un Gentilhomme, ou.
POLEANDRE.	POLEANDRE.
Va te faire penure;	Va te faire penure;
Va chercher vn Courier (Eſprit fait à rebours) Qui s’en aille à Paris, & retourne en deux jours.	Va chercher un Courier (Esprit fait à rebours) Qui s'en aille à Paris, et retourne en deux jours.
à part.	à part.
O Dieux.	Ô Dieux.
qu'vil fot Eiprit eſt facheux à combatre.	qu'une sot Éiprit est fâcheux à combattre.
IOVVELIN.	JOUVELIN.
Si ce n’eſt pas aſſez de deux jours, prens-en quatre;	Si ce n'est pas assez de deux jours, prends-en quatre;
Ecris-en à quelqu’vn.	Écris-en à quelqu'une.
POLEANDRE.	POLEANDRE.
Bon, voicy du relais.	Bon, voici du relais.
SCENE V.	SCÈNE V.
IOVVELIN, LE COMTE DY BELAIR, LE BARON TESTE-BOEVF.	JOUVELIN, LE COMTE DY BELAIR, LE BARON TESTE-BOUS.
IOVVELIN.	JOUVELIN.
A AIT.	A AIT.
Comte.	Comte.
LE COMTE.	LE COMTE.
Ah!	Ah!
cher Baron.	cher Baron.
IOVVELIN.	JOUVELIN.
Grand Dieu, que i’ay de joye!	Grand Dieu, que j'ai de joie!
approchestoy de moy, ioure que le te voye.	approchestoy de moi, joure que le te voie.
Cet habit te ſied bien.	Cet habit te sied bien.
LE COMIE.	LE COMIE.
C’eſt vn habit tout neuf.	C'est un habit tout neuf.
TO VVELIN.	TO VVELIN.
Il eſt beau;	Il est beau;
Qu’en dis-tu, Baron Teſte de Bœuf?	Qu'en dis-tu, Baron Tête de Bœuf?
LE PIINOR Que me demande-tu?	LE PINOR Que me demande-tu?
ie n’en veux point répondre.	Le n'en veux point répondre.
LE COMTE.	LE COMTE.
Morbleu, ie l’ay payé C’eſt dõc pour me confondre, Ou bien pour me brauer, que tu dis à mon nez.	Morbleu, Seigneur l'ai payé C'est do pour me confondre, Ou bien pour me braver, que tu dis à mon nez.
IOVVELIN.	JOUVELIN.
Le Baron n’en a point qui ne ſoient retournez;	Le Baron n'en a point qui ne soient retournez;
Il luy faut pardonner.	Il lui faut pardonner.
LE BARON.	LE BARON.
Ie te demande excuſe.	Je te demande excuse.
IOVVELIN.	JOUVELIN.
Ce Baron en ces lieux paſſe pour vne Buſe:	Ce Baron en ces lieux passe pour une Buse:
Parlons de ton habit.	Parlons de ton habit.
dm d o a leo Il mon tre aſſez bel air.	dm d ô a leo Il mon tre assez bel air.
IOVVELIN.	JOUVELIN.
Sans doute, on te prẽdroit pour quelque Duc & Pair:	Sans doute, on te prendrait pour quelque Duc et Pair:
Ta Garniture auſſi n’a pas mauuaiſe mine, Ce vert auec le bleu, vient bien quand il domine.	Ta Garniture aussi n'a pas mauvaise mine, Ce vert avec le bleu, vient bien quand il domine.
Voila comme on connoiſt les Enfans ſans ſoucy.	Voilà comme on connaît les Enfants sans souci.
Qu’eſt-ce qui te l’a fait?	Qu'est-ce qui te l'a fait?
* Luy frapant ſur l’épaule.	* Lui frappant sur l'épaule.
LE COMTE.	LE COMTE.
Ie l’ay fait faire icy, En moins de quinze jours, auec aſſez de peine.	Je l'ai fait faire ici, En moins de quinze jours, avec assez de peine.
TOVVELINN.	TOUVELINN.
On te verra tantoſt briller chez Liſimene;	On te verra tantôt briller chez Lisimène;
Et Caſſandre te va regarder de bon œil.	Et Cassandre te va regarder de bon œil.
LE COMTE.	LE COMTE.
4101 21 Tu m’auoüras qu’il eſt bienplus guayqu’vn de deüil.	4101 21 Tu m'auoüras qu'il est bienplus guiequ'un de deuil.
TOVVELIN, Le deüil n’eſt pas toûjours ce qui nous deſeſpere, Et tu le porterois volontiers de ton Frere:	TOUVELIN, Le deuil n'est pas toujours ce qui nous désespère, Et tu le porterais volontiers de ton Frère:
Ce mal ne ſer oit pas pour toy trop affligeant.	Ce mal ne ser ait pas pour toi trop affligeant.
LE COMTE.	LE COMTE.
I'en auro is plus de biens, i’en aurois plus d’argent;	J'en auro is plus de biens, j'en aurais plus d'argent;
Si i’en au ois beaucoup, ie n’en ſerois pas chiche.	Si j'en au ais beaucoup, je n'en serais pas chiche.
OVVELIN.	OUVELIN.
La mort de ton Aiſné te feroit bientoſt riche.	La mort de ton Aîné te ferait bientôt riche.
Ne donnerois-tu pas, dis-moy, de tout ton cœur, Ton Cadet, & l’Aiſné, pour n’auoir point de Sœur?	Ne donnerais-tu pas, dis-moi, de tout ton cœur, Ton Cadet, et l'Aisné, pour n'avoir point de Sœur?
Si cela t’arriuoit.	Si cela t'arrivait.
LE COMTE.	LE COMTE.
Ie croy que tu deuine.	Je crois que tu devine.
IOVVELIN.	JOUVELIN.
On te verroit bientoſt courir à la Voiſine.	On te verrait bientôt courir à la Voisine.
Parlant d’elle, à propos, la gouuerne-tu bien?	Parlant d'elle, à propos, la gouverne-tu bien?
Tu n’en bouge, ie croy.	Tu n'en bouge, ie crois.
LE COMTE.	LE COMTE.
Ma foy, ie n’en ſçay rien;	Ma foi, Seigneur n'en sais rien;
Tãtoſt bien, tãtoſt mal, ſeulemẽt pour m’aprendre Gur in ele tlarune de farprenure Cailandre;	Tantôt bien, tantôt mal, seulement pour m'apprendre Gur in éle tlarune de farprenure Cailandre;
Elle eſt toûjours au guet le ſoir & le matin.	Elle est toujours au guet le soir et le matin.
TOVVELIN.	TOUVELIN.
doco dro jois pluo Mi, dfais ed ires qu'vil Matin.	doco dro jais pluo Mi, disais ed ires qu'il Matin.
LE COMTE.	LE COMTE.
Pour en venir à bout, i’ay tout mis en vſage.	Pour en venir à bout, j'ai tout mis en usage.
TOVVELIN.	TOUVELIN.
Ie ſçay bien mieux que toy prendre mon auantage Et par la ie connois que tu n’es qu’Ecolier.	Je sais bien mieux que toi prendre mon avantage Et par la vôtre connais que tu n'es qu'Écolier.
LEGOMTE.	LÉGOMTE.
Mais comment fais-tu, toy?	Mais comment fais-tu, toi?
TOVVELINV.	TOUVELINV.
Ie me cole au Pilier.	Je me cole au Pilier.
LE COMTE.	LE COMTE.
Mais à quel endroit donc?	Mais à quel endroit donc?
IOVVELIN.	JOUVELIN.
litt eiier de l'Egliſe;	litt éjier de l'Église;
C’eſt là que ie la vois, alors qu’elle eſt aſſiſe, (Dis que ie ne ſuis pas ſon plus cher Fauory;	C'est là que venir la vois, alors qu'elle est assise, (Dis que personne ne suis pas son plus cher Favori;
Puis pour la voir ſortir, ie vais au Pilory, Vis à vis le Carcan.	Puis pour la voir sortir, ie vais au Pilori, Vis à vis le Carcan.
LE BARON à part.	LE BARON à part.
C’eſt vne bonne Place;	C'est assez bonne Place;
C’eſt là qu’on voit ſouuẽt faire aux Gens la grimace.	C'est là qu'on voit souvent faire aux Gens la grimace.
LE COMTE.	LE COMTE.
Ie n’auois pas encor trouué l’inuention, Comme toy, de la voir.	Je n'avais pas encor trouvé l'invention, Comme toi, de la voir.
IOVVELIN.	JOUVELIN.
C’eſt que ta paſſion Te fait le plus ſouuent raiſonner en aueugle.	C'est que ta passion Te fait le plus souvent raisonner en aveugle.
LE COMTE au Baron paion, il faut icy, pour rimer, que tu beugle;	LE COMTE au Baron paion, il faut ici, pour rimer, que tu beugle;
Car vn Poëte, ſans toy, ne pouroit pas rimer.	Car un Poète, sans toi, ne pourrait pas rimer.
LE BARON.	LE BARON.
Ce n’eſt pas vn meſtier pour me faire eſtimer;	Ce n'est pas un métier pour me faire estimer;
Et iamais ie n’ay fait des Vers, ny de lu Proſe.	Et jamais ici n'ai fait des Vers, ni de lu Prose.
IOVVELIN.	JOUVELIN.
Si tu n’en as point fait, ie n’en ſuis pas la cauſe.	Si tu n'en as point fait, une n'en suis pas la cause.
LE COMTE.	LE COMTE.
Tu n’en as pas l’elprit, gros Bliſtre, gros Cheual.	Tu n'en as pas l'elprit, gros Blistre, gros Cheval.
Apropos, Iouuelin, nous auons ce ſoir Bal;	Appropos, Jouvelin, nous avons ce soir Bal;
Tu peux ſur les huit heures, apres ſouper, t’y rendre.	Tu peux sur les huit heures, après souper, t'y rendre.
IOVVELIN.	JOUVELIN.
Lei y Fans fas encis en quernea.	Li y Fans sas encis en quernea.
LE COMTE.	LE COMTE.
Chez Caſſandre:	Chez Cassandre:
lodelet eſt icy, nous auons trois Violons.	lodèlet est ici, nous avons trois Violons.
1-	1-
IOVVELIN.	JOUVELIN.
Ie vay tout de ce pas prendre mes hauts talons, Pour paroiltre plusgrau.	Je vais tout de ce pas prendre mes hauts talons, Pour paraître plusgrav.
Des violos, qurtes donne?	Des violos, qurtes donne?
C’eſt moy.	C'est moi.
LE COMTE.	LE COMTE.
IOVVELIN.	JOUVELIN.
Tout le monde en eſt-il?	Tout le monde en est-il?
LE COMTE.	LE COMTE.
Preſque perſonne:	Presque personne:
Caſſandre, & ſa Cloris, qui tous deux l’ont permis, M’ont dit de n’en parler qu’à mes meilleurs Amis.	Cassandre, et sa Cloris, qui tous deux l'ont permis, M'ont dit de n'en parler qu'à mes meilleurs Amis.
C.	Ç.
iij Si tu veux m’obliger, tiens la choſe ſecrette, Car tu ſçais que la Fleche eſt vne vraye Gazette, Et que Caſſandre haït les Gens comme la mort, Qui vont par-cy, par-là, faire quelque raport:	ij à tu veux m'obliger, tiens la chose secrète, Car tu sais que la Flèche est quelque vraie Gazette, Et que Cassandre haït les Gens comme la mort, Qui vont par-cy, là-là, faire quelque rapport:
Sa reputation pouroit eſtre perduë, Or par fotora quelqu’vn m’écoutoit dans la ruë;	Sa réputation pourrait avoir perdue, Or par fotora quelqu'un m'écoutait dans la rue;
Elle eſt coppieuſement jalouſe de l’honneur.	Elle est coppieusement jalouse de l'honneur.
IOVVELIN.	JOUVELIN.
Ne crains rien de ma part, ie ſuis ſon Seruiteur, Et de ſa Fille auſſi.	Ne crains rien de ma part, ie suis son Serviteur, Et de sa Fille aussi.
Mais vn certain Viſage N’en eſt-il point prié?	Mais un certain Visage N'en est-il point prié?
LE COMTE.	LE COMTE.
Quel eſt ce Perſonnage?	Quel est ce Personnage?
IOVVELIN.	JOUVELIN.
C ent vn nouueau venu qui loge à Saint Martin, Cleandre eſt ſon Amy:	Ç ent în nouueau venu qui loge à Saint Martin, Cléandre est son Ami:
ie l’ay veu ce matin;	Il l'ai vu ce matin;
Ils ſont allez tous deux, ie croy, diſner enſemble.	Ils sont allés tous deux, je crois, dîner ensemble.
Mais en parlant de luy, me ſemble que tu tremble.	Mais en parlant de belle, me semble que tu tremble.
Rey dma l la Moy?	Rei dma l la Moi?
ie ne le crains pas, c’eſt vn Homme mal fait.	Ne ne le crains pas, c'est un Homme mal fait.
LE COMTE.	LE COMTE.
Iantoſt au Carrefour l’on m’a fait ſon Portrait.	Iantost au Carrefour l'on m'a fait son Portrait.
LE BARON.	LE BARON.
Il faut certes, qu’il ſoit bien ferré, ie t’aſſure, S’il peut de nos Barons éuiter la cenſure.	Il faut certes, qu'il soit bien ferré, je t'assure, S'il peut de nos Barons éviter la censure.
LE COMTE.	LE COMTE.
S’il y vient, tel qu’il ſoit, enfin nous le verrons.	S'il y vient, tel qu'il soit, enfin nous le verrons.
Pour moy, ie ſuis toûjours du coſté des Barons;	Pour moi, Seigneur suis toujours du côté des Barons;
On dit qu’il eſt bien fait, mais ie ne le puis croire.	On dit qu'il est bien fait, mais ainsi ne le puis croire.
IOVVELIN.	JOUVELIN.
Poleandre tantoſt ſoutenoit le contraire;	Poleandre tantôt soutenait le contraire;
Et ſur le diferend que nous auions tous deux, Nous voulions nous oſter la barbe & les cheueux.	Et sur le dierend que nous avions tous deux, Nous voulions nous ôter la barbe et les cheveux.
LE BARON.	LE BARON.
pour vn Baron Fechois, Poleandre eſt bien lâche.	pour un Baron Féchais, Polandre est bien lâche.
LE COMTE.	LE COMTE.
Ie ne ſuis point Baron, & c’eſt ce qui m’en fâche;	Je ne suis point Baron, et c'est ce qui m'en fâche;
Mais ie pouray peut-eſtre vn jour le deuenir.	Mais ici pourrai peut-être un jour le devenir.
IOVVEL IN au comte, bas.	JOUVEL IN au compte, bas.
Tiens, tiens, voicy Cleandre, & ſon Amy, venir;	Tiens, tiens, voici Clandre, et son Ami, venir;
Cedons leur le paué, ie les voy qui s’auancent.	Cédons leur le pavé, ie les vois qui s'avancent.
Le Comte & Iouuelin font des pas de Balet en s’en allant.	Le Comte et Jouvelin font des pas de Ballet en s'en allant.
91	91
SOENEV Ie CLIDAMIS, CLEANDRE.	SONEU Je CLIDAMIS, CLEANDRE.
CLIDAMTS.	CLIDAMTS.
unrdit a les voir tous deua marcher, qu’ils Q danſent	unrdit a les voir tous deva marcher, qu'ils Q dansent
CLEANDRE.	CLÉANDRE.
Ils peuuent bien danſer, ils ont le Bal ce ſoir.	Ils peuvent bien danser, ils ont le Bal ce soir.
CLIDAMIS.	CLIDAMIS.
Y pourions-nous aller?	Y pourrions-nous aller?
ne ſçaurois-je le voir?	ne saurais-je le voir?
Le Bal eſt vn plaifir le plus doux de la vie.	Le Bal est un plaisir le plus doux de la vie.
CLEANDRE.	CLÉANDRE.
le feray le requis, pour plalre à ton enure.	le ferai le requis, pour plalre à ton envre.
CLIDAMIS.	CLIDAMIS.
De grace, explique-moy qui ſont ces trois Barons Qui viennent de paſſer?	De grâce, explique-moi qui sont ces trois Barons Qui viennent de passer?
ils ſont bien fanfarons;	ils sont bien fanfarons;
Ce n’eſt pas la, ie croy, le Baron Nicodeme.	Ce n'est pas la, ie crois, le Baron Nicodeme.
CLEANDRE.	CLÉANDRE.
Amy, quand ie déurois parler contre moy-méme,, Ie veux t’en informer.	Ami, quand tu devrais parler contre moi-même, Je veux t'en informer.
Ce premi er que tu vois Eſt le Coq du Village, & des Barons Flechois, Glorieux comme vn Paon, par tout inſuportable, Hautain, ambitieux, & jaloux comme vn Diab le:	Ce premi er que tu vois Est le Coq du Village, et des Barons Fléchais, Glorieux comme un Paon, par tout insuportable, Hautain, ambitieux, et jaloux comme un Diab le:
Bref, il ſuffit qu’il ſoit le Fils du Preſident, Pour te dire en vn mot que c’eſt vn impudent, Vn Breteur fanfaron qui fait par tout le Maiſtre.	Bref, il suffit qu'il soit le Fils du Président, Pour te dire en un mot que c'est un impudent, Un Breteur fanfaron qui fait par tout le Maître.
CLIDAMIS.	CLIDAMIS.
Son geſte & ſa façon le font aſſez connaiſtre.	Son geste et sa façon le font assez connaître.
Le ſecond, quel eſt-il?	Le second, quel est-il?
dis-moy.	dis-moi.
CLEANDRE.	CLÉANDRE.
C’eſt vn Manceau, Vn ſoûpirant d’amour qui fait fort bien le Veau, Car on le voit toûjours aux pieds de nos Donzelles;	C'est un Manceau, Un soupirant d'amour qui fait fort bien le Veau, Car on le voit toujours aux pieds de nos Donzelles;
Il ſeroit bien fâché qu’vn autre approcha d’elles, Il s’y tient tout fiché, toûjours le nez en l’air;	Il serait bien fâché qu'un autre approcha d'elles, Il s'y tient tout fiché, toujours le nez en l'air;
Auſſi le nomme-t’on le Comte du Bel-Air.	Aussi le nomme-t-on le Compte du Bel-Air.
ODIDIMIS.	ODIDIMIS.
Se pique-t’il auſſi de brauoure & d’adreſſe?	Se pique-t-il aussi de bravoure et d'adresse?
CIEANDNE.	CIEANDNE.
Eſt-il vn ſeul Manceau qui ſoit d’vne autre eſpece?	Est-il un seul Manceau qui soit d'une autre espèce?
CLIDAMIS.	CLIDAMIS.
Et l’autre, quel eſt-il?	Et l'autre, quel est-il?
CLEANDRE.	CLÉANDRE.
Ceit vil Oniginal Qui porte vn nez tout propre à mettre au Carnaual, nii Daron iort blen fait pour tirer la Charrue.	Ceit vil Oniginal Qui porte un nez tout propre à mettre au Carnaval, nii Daron jort blen fait pour tirer la Charrue.
CLIDAMIS.	CLIDAMIS.
Mais a-t’il de l'Eſprit?	Mais a-t-il de l'Esprit?
CLEANDRE.	CLÉANDRE.
Tout autant qu’vne Gruë.	Tout autant qu'une Grue.
CLIDAMIS.	CLIDAMIS.
Ainſi donc, vos Barons ſont de ſots Courtiſans.	Ainsi donc, vos Barons sont de sots Courtisans.
CLEANDRE.	CLÉANDRE.
Dis plutoſt qu’ils ſont tous Ruſtiques & Paiſans.	Dis plutôt qu'ils sont tous Rustiques et Paysants.
CLI DAMIS.	CLI DAMIS.
Poleandre pourtant me ſemble eſtre hors de Page.	Poleandre pourtant me semble être hors de Page.
CLEANDRE.	CLÉANDRE.
Poleandre eſt le ſeul qui peut paſſer pour ſage:	Poleandre est le seul qui peut passer pour sage:
Tous les autres ſe font que des cdlaniers, Que des Coureurs de nuit, de vrais Cuiſiniers.	Tous les autres se font que des cédaniers, Que des Coureurs de nuit, de vrais Cuisiniers.
CLIDAMIS.	CLIDAMIS.
Quoy!	Quoi!
la Ieuneſſe icy vit dans la nonchalance?	la Jeunesse ici vit dans la nonchalance?
Ie croyois rencontrer en ces lieux l’abondance, Serenades, Feſtins, Ieux, Plaiſirs, Triolets, Grandes colations, concerts, Dallles;	Je croyais rencontrer en ces lieux l'abondance, Serénades, Festins, Ieux, Plaisirs, Triolets, Grandes colations, concerts, Dallles;
balets, Et tout ce que l’Amour (à la gloire des Dames) Pour auoir des faueurs, inſpire aux belles Ames.	ballets, Et tout ce que l'Amour (à la gloire des Dames) Pour avoir des faveurs, inspire aux belles Âmes.
CLEANDRE.	CLÉANDRE.
C’eſt en vain t’emporter en diſcours ſuperflus, Ailleurs bon:	C'est en vain t'emporter en discours superflus, Ailleurs bon:
mais icy, le temps paſſé n’eſt plus:	mais ici, le temps passé n'est plus:
Il eſt vray qu’autrefois vne Illuſtre Nobleſſe, Pour paroiſtre en ces lieux, faiſoit ample largeſſe:	Il est vrai qu'autrefois une Illustre Noblesse, Pour paraître en ces lieux, faisait ample largesse:
Ce n’eſtoit chaque jour (outre les penſions) Que liberalitez, que des profuſions:	Ce n'était chaque jour (outre les pensions) Que libéralités, que des profusions:
Dans ce tẽps, qui n’eſt plus, la dépenſe eſtoit prõpte, Chaque Habitant d’icy faiſoit fort bien ſon cõpte;	Dans ce temps, qui n'est plus, la dépense était prête, Chaque Habitant d'ici faisait fort bien son compte;
C’eſt par là que pluſieurs ſout deuenus aiſez, Q les Darons Plechois re font Daromlez;	C'est par là que plusieurs sout devenus aisés, Q les Darons Plechais re ont Daromlez;
Et pluſieurs, ſans cela, de ces Barons inſignes, Seroient ſur nos Coſteaux à trauailler aux Vignes;	Et plusieurs, sans cela, de ces Barons insignes, Seraient sur nos Costeaux à travailler aux Vignes;
Car il eſt pour conſtant, que nos plus fiers Barons Sont Fils, ou Petits-Fils, iſſus de Vignerons.	Car il est pour constant, que nos plus fiers Barons Sont Fils, ou Petits-Fils, issus de Vignerons.
CLIDAMIS.	CLIDAMIS.
Quoy!	Quoi!
les plus hauts hupez des Barons de la Fleche, Vos Coppieux, ſont ſortis de la Serpe & la Beſche?	les plus hauts hupés des Barons de la Flèche, Vos Coppieux, sont sortis de la Serpe et la Besche?
Certes, ie les croyois Nobles comme le Roy:	Certes, Seigneur les croyais Nobles comme le Roi:
Mlais c’eſt peut-eſtre auſſi que tu te ris de moy,	Mlais c'est peut-être aussi que tu te ris de moi,
CLEANDRE.	CLÉANDRE.
Iout ce que ie te dis, eſt la verité méme.	Jout ce que Seigneur te dis, est la vérité même.
CLIDAMIS.	CLIDAMIS.
Ma foy i’en ſuis rauy, ma joye en eſt extréme, I'en feray mon profit:	Ma foi j'en suis ravi, ma joie en est extrême, J'en ferai mon profit:
mais changeons de propo Et laiſſons pour vn temps les Barons en repos.	mais changeons de propo Et laissons pour un temps les Barons en repos.
Ie connois trop à quoy ton amitié m’engage;	Je connais trop à quoi ton amitié m'engage;
Te deguiſer mon cœur, c’eſt te faire vn outrage:	Te déguiser mon cœur, c'est te faire un outrage:
Croirois-tu, cher Amy, que re ſuis amoureux?	Croirais-tu, cher Ami, que ré suis amoureux?
CLEANDRE.	CLÉANDRE.
Amoureux!	Amoureux!
depuis quand?	depuis quand?
CLIDAMIS.	CLIDAMIS.
Depuis vne heure, ou deux.	Depuis une heure, ou deux.
De qui donc?	De qui donc?
CLEANDRE.	CLÉANDRE.
CLIDAMIS.	CLIDAMIS.
Ie ne ſçay.	Je ne sais.
CLEANDRE.	CLÉANDRE.
La plaiſante auanture!	La plaisante aventure!
Mais pour t'en éclaircir, fais-moy donc la peinture De celle dont les traits (par vn ſecret pouuoir Ont pû ſi promptement te vaincre & t’émouuoir?	Mais pour t'en éclaircir, fais-moi donc la peinture De celle dont les traits (par un secret pouvoir Ont pu si promptement te vaincre et t'émouuoir?
Pour découurir qui c’eſt, en vain ie reſve & cherche Plus i’applique mes ſoins aux beautez de la Fleche Moins ie trouue en ce poinct mon Eſprit ſatisfait;	Pour découvrir qui c'est, en vain encore rêve et cherche Plus j'applique mes soins aux beautés de la Fleche Moins ie trouve en ce point mon Esprit satisfait;
Car nous n’auons icy rien qui vaille en effet, (Amoins que ce ne ſoit l’aimable Lyſimene) Car pour Amarillis, Clorinde, Celimene, Roxelane, Daphné, Berenice, Cloris, Mauricette, Argenie, Arthuſiane, Iris, Angelique, Amaranthe, Acariſe, Vranie, Telamire, Ameſtris, Climene, Parthenie, Et cent autres encor que ie ne puis nommer, Ne font pas des beautez dignes de te charmer.	Car nous n'avons ici rien qui vaille en effet, (Amoins que ce ne soit l'aimable Lysiméné) Car pour Amarillis, Clorinde, Celimène, Roxélane, Daphné, Berenice, Cloris, Mauricette, Argénie, Arthusiane, Iris, Angélique, Amaranthe, Acarise, Vranie, Telamire, Amêtris, Climène, Parthie, Et cent autres encor que ieans puis nommer, Ne font pas des beautés dignes de te charmer.
CLIDAMIS.	CLIDAMIS.
De toutes celles là, ie n’en connois aucune;	De toutes celles -là, je n'en connais aucune;
Mais celle-cy n’eſt pas vne Beauté commune;	Mais celle-cy n'est pas une Beauté commune;
L’inuincible pouuoir de ſes charmes puiſſans, Excite dans moirecur le trouble que ie ſens;	L'invincible pouvoir de ses charmes puissants, Excite dans moirecur le trouble que ielieux;
Pour te la peindre, en vain mon ame s’éuertuë.	Pour te la peindre, en vain mon âme s'évertue.
CLEANDRE.	CLÉANDRE.
Mais où l’as-tu pû voir?	Mais où l'as-tu pu voir?
CLIDAMIS.	CLIDAMIS.
Elle eſtoit dans la Ruë, Au moment que tous deux nous ſommes ſeparez:	Elle était dans la Rue, Au moment que tous deux nous sommes séparés:
D’abord que ie l’ay veu, tous mes ſens égarez, Et mes yeux attachez ſur cet objet aimable, M’ont forcé d’auoüer qu’elle eſt incomparable, Qu’elle eſt ſans contredit le chefd’œuure des Cieux:	D'abord que venir l'ai vu, tous mes sens égarés, Et mes yeux attachés sur cet objet aimable, M'ont forcé d'avouer qu'elle est incomparable, Qu'elle est sans contredit le chefd'œuvre des Cieux:
Tout autant que i’ay pû, ie l’ay ſuiuy des yeux;	Tout autant que j'ai pu, Seigneur l'ai suivi des yeux;
Lors que coupant chemin au bas de l’autre Ruë, l’ay perdu tout erpon, en la pertant de veuë, Et ie n’ay reſſenty (Iuge de ma douleur) Qu’vn triſte deſeſpoir qui m’a ſaiſi le cœur.	Lors que coupant chemin au bas de l'autre Rue, l'ai perdu tout erpon, en la pertant de vue, Et grands n'ai ressenti (Iuge de ma douleur) Qu'un triste désespoir qui m'a saisi le cœur.
Cleandre, cependant, elle m’eſt inconnuë.	Clépandre, cependant, elle m'est inconnue.
CLEANDRE.	CLÉANDRE.
Amy, conſoles-toy, tu ne l’as point perduë, Et ie me trompe fort, ou dés ce meſmè ſoir, Auant le Bal finy, tu pouras la reuoir:	Ami, consoles-toi, tu ne l'as point perdue, Et je me trompe fort, ou dès ce mesmè soir, Avant le Bal fini, tu as la revoir:
Prens juſqu’a ce temps-là ma foy pour aſſurance.	Prends jusqu'a ce temps-là ma foi pour assurance.
CLIDAMIS.	CLIDAMIS.
Ce moment tarde trop à mon impatience:	Ce moment tarde trop à mon impatience:
Mais pourtant, ſi i’en croy ton fidelle rapport, Tous les Barons Flechois ſe diuertiſſent fort:	Mais pourtant, si j'en crois ton fidèle rapport, Tous les Barons Fléchais se divertissent fort:
Le Bal, & le Billard, le Vin, la bonne chere, Sont pour eux des plaiſirs.	Le Bal, et le Billard, le Vin, la bonne chère, Sont pour eux des plaisirs.
CLEANDRE.	CLÉANDRE.
Qui ne leur couſtent guere.	Qui ne leur coûtent guère.
Dés qu’il arriue icy quelque idiot d’Etranger, Ils ſont fort aſſurez de bien boire & manger:	Dès qu'il arrive ici quelque idiot d'Étranger, Ils sont fort assurés de bien boire et manger:
Tant qu’il a de l’argent, chacun luy fait careſſe;	Tant qu'il a de l'argent, chacun Elle fait caresse;
N’en a-t’il plus, chacun l’abandonne & le laiſſe, Noſtre Poëte, ſur tous, ſçait ſi bien ce meſtier, Qu’il courtiſe à deſſein juſqu au moindre Ecoliers Il a ſi bien appris d’enfiler des razades, Qu’apres ſix pots de Vin, il fait encor gambades;	N'en a-t-il plus, chacun l'abandonne et le laisse, Notre Poète, sur tous, sçait si bien ce métier, Qu'il courtise à dessein jusqu' à moindre Écoliers Il a si bien appris d'enfiler des rasades, Qu'après six pots de Vin, il fait encor gambades;
Et ie ſuis aſſuré que dans vn ſeul repas, Quatorte prirtes, & plus, ne le ſaouleroient pas.	Et ie suis assuré que dans un seul repas, Quatorte prirtes, et plus, ne le saouleraient pas.
Enfin nous n’auons point de goſier dans la Feche Plus prompt à deuorer, ny de langue ſi ſeche.	Enfin nous n'avons point de gosier dans la Fèche Plus prompt à dévorer, était de langue si seche.
Cleandre?	Clandre?
CLIDAMIS.	CLIDAMIS.
CLEANDRE.	CLÉANDRE.
Que veux-tu?	Que veux-tu?
CLIDAMIS.	CLIDAMIS.
Nve mie dirasueu pas Qui ſont ces Dames-là que i’apperçoy la-bas?	Nve mie dirasvu pas Qui sont ces Dames-là que j'aperçois la-bas?
Ou donc?	Ou donc?
CLEANDRE.	CLÉANDRE.
CLIDAMIS.	CLIDAMIS.
Iette les yeux juſqu’au bout de la Ville:	Jette les yeux jusqu'au bout de la Ville:
C’eſt, ſi ie ne me trompe, vne Mere & ſa Fille, Ie les ay veu ſortir de ce petit Conuent.	C'est, si personne ne me trompe, une Mère et sa Fille, Je les ai vu sortir de ce petit Convent.
CLEANDRL.	CLÉANDRL.
Ne peux-tu deuiner qui c’eſt?	Ne peux-tu deviner qui c'est?
CLIDAMIS.	CLIDAMIS.
Dy-moy comment Ie pourois diſcerner des Dames ſous le maſque?	Dis-moi comment Je pourrais discerner des Dames sous le masque?
CLEANDRE.	CLÉANDRE.
N’en peux-tu pas juger auxcouſeurs de ce Baſque Qui les luie pas apas:	N'en peux-tu pas juger auxcouseurs de ce Basque Qui les luie pas appas:
CLIDAMIS.	CLIDAMIS.
A quoy bon m’en ſoucier?	À quoi bon m'en soucier?
Pour deuiner qui c’eſt, faudroit eſtre Sorcier.	Pour deviner qui c'est, faudrait être Sorcier.
Comment les nomme-tu?	Comment les nomme-tu?
CBENRDRES.	CBENRDRES.
Pauline, & Celimene.	Pauline, et Celimène.
CLIDAMIS.	CLIDAMIS.
Ie voudrois que ce fut l’aimable Lyſimene:	Je voudrais que ce fut l'aimable Lysimène:
Mais peux-tu ſur vn poinct contenter mon deſir?	Mais peux-tu sur un point contenter mon désir?
Tâche à les aborder.	Tâche à les aborder.
CLEANDRE.	CLÉANDRE.
Si c’eſt pour ton plaiſir, Il n’eſt rien que pour toy volontiers ie ne faſſe, Quanid iiemme ie deurois encourir leur diſgrace.	Si c'est pour ton plaisir, Il n'est rien que pour toi volontiers personne ne fasse, Quanid iiemme ie ju encourir leur disgrâce.
Suy-moy donc de bien pres.	Sui-moi donc de bien pres.
Mais il faut t’auertir Qu’vn tel deſir ſouuent nous force au repentir.	Mais il faut t'avertir Qu'un tel désir souvent nous force au repentir.
CLIDAMIS.	CLIDAMIS.
On ne ſe repent point, quand on voit vne Belle, A moins qu’elle ne ſoit ou farouche, ou cruelle:	On ne se repent point, quand on voit une Belle, À moins qu'elle ne soit ou farouche, ou cruelle:
Contente ſeulement mon eſprit ſoucieux, Et me dis quelle elle eſt.	Contente seulement mon esprit soucieux, Et me dis quelle elle est.
CLEANDRE bas.	CLÉANDRE bas.
Conſultes-en te syeux.	Consultes-en te syeux.
SCENE VII.	SCÈNE VII.
CLEANDRE, PAVLINE.	CLEANDRE, PAULINE.
CLIDAMIS, CELIMENE.	CLIDAMIS, CÉLIMENE.
CLEANDRE.	CLÉANDRE.
Ans doute que le Sort eſt pour moy bien propice OPuis que l’occaſion de vous rendre ſeruice Se preſente aujourd’huy, quoy qu’il ſoit déja tard, Madame, & ie m’en ſens redeuable au hazards Mais pour combler mon cœur d’vne parfaite joye, Et rendre grace au Ciel du bonheur qu’il m’enuoy Permettez que ie puiſſe, en vous donnant la mainVous aider à marcher le reſte du chemin.	Ans doute que le Sort est pour moi bien propice OPuis que l'occasion de vous rendre service Se présente aujourd'hui, quoi qu’il soit déjà tard, Madame, et ainsi m'en sens redevable au hasards Mais pour combler mon cœur d'une parfaite joie, Et rendre grâce au Ciel du bonheur qu'il m'envoi Permettez que je puisse, en vous donnant la mainUous aider à marcher le reste du chemin.
PAVLINE.	PAULINE.
On me l’auoit bien dit, que l’aimable Cleandre S’offroit de ſi bõ cœur qu’on ne peut s’en defendre Il oblige toûjours, & ſa ciuilité.	On me l'avait bien dit, que l'aimable Clandre S'offrait de si bien cœur qu'on ne peut s'en défendre Il oblige toujours, et sa civilité.
CLEANDRE auec vne profonde reuerence, Ie ſçay ce que l’on doit à voſtre qualité, Madame, & ce n’eſt là que la moindre étincelle Par où ie puis prouuer le brazier de mon zele.	CLEANDRE avec une profonde révérence, Je sais ce que l'on doit à votre qualité, Madame, et ce n'est là que la moindre étincelle Par où je puis prouver le brasier de mon zèle.
PAVLINE.	PAULINE.
Ie ſuis bien obligée, Cleandre, à ce grand feu.	Je suis bien obligée, Clandre, à ce grand feu.
CLEANDRE auec vne autre reuerence.	CLÉANDRE avec une autre révérence.
Ie ne vous dis rien là qui ne ſoit encor peu;	Je ne vous dis rien là qui ne soit encor peu;
Ie ſouffrirois pour vous le martyre à mon aiſe;	Je souffrirais pour vous le martyre à mon aise;
Vous pouuez m’éprouuer, Madame.	Vous pouvez m'éprouver, Madame.
PAVLINE.	PAULINE.
11 Dieu ne plaiſe:	11 Dieu ne plaise:
A moins que de paſſer tout à fait pour vn Traître, Madame, les bontez que m’auez fait paraître.	À moins que de passer tout à fait pour un Traître, Madame, les bontés que m'avez fait paraître.
CLEANDRE auec ſes reuerences.	CLÉANDRE avec ses révérences.
Ie ne puis oublier, Mais ne ſçauray-je point quel eſt ce Caualier Que ie vois auec vous:	Je ne puis oublier, Mais ne saurai-je point quel est ce Cavalier Que personne était vois vous:
PAVLINE.	PAULINE.
le voudrois bien ſçauoir quel eſt la qualite De celuy qui.	le voudrais bien savoir quel est la qualité De celui qui.
CLEANDRE l’interrompant auec vne reuerence.	CLÉANDRE l'interrompant avec une révérence.
Vrayment, ie n’ay pas meriré, anuuumle, e ne cloy pas le Meiiter encore, L’honneur que ie reçois.	Vraiment, je n'ai pas mériré, anuuumle, eu ne cloi pas le Mejiter encore, L'honneur que sans reçois.
Ie ſerois bien pecore, 9T Ic.	Je serais bien pécore, 9T Ic.
PAVLINE.	PAULINE.
Mais répondez à ce que ie vous dis?	Mais répondez à ce que ici vous dis?
CLEANDRE.	CLÉANDRE.
Que iamais ie ne puiſſe entrer en Paradis;	Que jamais ici ne puisse entrer en Paradis;
Que le courroux du Ciel, le foudre, & la tempeſte, ruiiie deuant vos yeux toniber deſſus ma teſte;	Que le courroux du Ciel, le foudre, et la tempête, ruiviie devant vos yeux toniber dessus ma tête;
Que ie ſois deuoré par vn Tygre inhumain, Plutoſt que de manquer à vous donner la main.	Que quelque sois dévoré par un Tigre inhumain, Plutôt que de manquer à vous donner la main.
Vous ſçauez que iamais cela ne ſe refuſe.	Vous savez que jamais cela ne se refuse.
PAVLINE.	PAULINE.
Non, Monſieur, demeurez.	Non, Monsieur, demeurez.
CLEANDRE continuë ſes reuerences.	CLÉANDRE continue ses révérences.
Ie ſçay conme on en vſe, Madame;	Je sais nomme on en use, Madame;
Permettez.	Permettez.
I’iray bien ſeule.	J'irai bien seule.
PAVLINE.	PAULINE.
Il n’en eſt pas beſoin,	Il n'en est pas besoin,
CLEANDRE auec vne reuerence.	CLÉANDRE avec une révérence.
Mais.	Mais.
D ij	D ij
PAVLINE.	PAULINE.
Mais ie ne vay pas loin.	Mais ici ne vais pas loin.
CLEANDRE toûjours auec ſes reuerences.	CLÉANDRE toujours avec ses révérences.
Mais pourtant vous ſçauez combien ie vous réuere Et que ie ſuis tout preſt.	Mais pourtant vous savez combien ces vous révère Et que je suis tout prêt.
PAVLINE bas.	PAULINE bas.
paut.	paut.
Ani.	Ani.
Dieu, quene miſere!	Dieu, quène misère!
Non, Monſieur, demeurez, car ie ne le veux pas.	Non, Monsieur, demeurez, car On ne le veux pas.
CLEANDRE.	CLÉANDRE.
Mais pourquoy.	Mais pourquoi.
PAVLINE.	PAULINE.
Mais enfin, c’eſt qu’il ne me plaiſt pas Elle ſort en colere auec Celimene.	Mais enfin, c'est qu'il ne me plaît pas Elle sort en colère avec Celimène.
CLEANDRE.	CLÉANDRE.
Puis que vous le voulez, ie n’ay rien à vous dire, Madame.	Puis que vous le voulez, votre n'ai rien à vous dire, Madame.
CLIDAMIS apres qu’elles ſont ſorties.	CLIDAMIS après qu'elles sont sorties.
Par ma foy, tu m’as beaucoup fait rire, Et ie n’aurois pas crû, qu’apres ton compliment, Tu vouluſſe à nos jeux enairger i bruſquement:	Par ma foi, tu m'as beaucoup fait rire, Et ici n'aurais pas crû, qu'après ton compliment, Tu voulusse à nos jeux enairger jusqu' brusquement:
Il eſt aiſé de voir que ſon humeur eſt prompte.	Il est aisé de voir que son humeur est prompte.
CLEANDRE.	CLÉANDRE.
Elle s’eſt retirée auec ſa courte honte.	Elle s'est retirée avec sa courte honte.
CLIDAMTS.	CLIDAMTS.
En effet;	En effet;
& ie voy qu’elle en a du ſoucy:	et ici vois qu'elle en a du souci:
Mais quel ſujet as-tu de la traitter ainſy?	Mais quel sujet as-tu de la traiter ainsi?
Our le iaoirorde en tunit d'en penetier ia cauſe.	Our le jaoirorde en tunit d'en penetier ja cause.
CLEANDRE.	CLÉANDRE.
ortu veux m’oblrger, raſſonnons d’autre choſe.	ortu veux m'oblrger, rassonnons d'autre chose.
As-tu de Celimene obſerué la beauté?	As-tu de Celimène observé la beauté?
Qu’en dis-tu?	Qu'en dis-tu?
parle donc dans la ſincerité?	parle donc dans la sincérité?
CLIDAMIS.	CLIDAMIS.
Cleandre, aſſûrément qu’elle n’eſt pas trop belle.	Clandre, assurément qu'elle n'est pas trop belle.
CLEANDRE.	CLÉANDRE.
Peſte ſoit du Baron, qui me rompt la ceruelle.	Peste soit du Baron, qui me rompt la cervelle.
SEPINDRE.	SÉPINDRE.
Baron, ie t’entens bien hurler plus haut qu’vn Loup;	Baron, Seigneur t'entends bien hurler plus haut qu'un Loup;
Ie ne ſuis point Baron, change donc de chapitre.	Je ne suis point Baron, change donc de chapitre.
IOVVELIN.	JOUVELIN.
Hé!	Hé!
voudrois-tu, Baron, renoncer à ton titre?	voudrais-tu, Baron, renoncer à ton titre?
On l’eſt bien malgré ſoy, lors que l’on eſt Fléchois, Le nom de la Maiſon eſt bon pour vn Bourgeois.	On l'est bien malgré soi, lors que l'on est Fléchais, Le nom de la Maison est bon pour un Bourgeois.
Quoy!	Quoi!
tuvoudrois, Baron, aujourd’huy t’en defẽdre?	tuvoudrais, Baron, aujourd'hui t'en défendre?
CLEANDRE releuont ies cheueux de ſa perruque.	CLÉANDRE relevont je cheueux de sa perruque.
Ouvas-tun poudre?	Ouvas-tun poudre?
IOVVELIN.	JOUVELIN.
Chez Madame Caſſandré;	Chez Madame Cassandré;
Le Comte du Bel-Air, ce ſoir, y donne Bal.	Le Comte du Bel-Air, ce soir, y donne Bal.
CLEANDRE.	CLÉANDRE.
Quel eſt ce Comte?	Quel est ce Comte?
AOVVBEIN C’eſt le Cadet Aſdrubal.	AOVVBEIN C'est le Cadet Asdrubal.
Mais à propos, dis-moy, tu connois bien Oronte?	Mais à propos, dis-moi, tu connais bien Oronte?
CLEANDRE.	CLÉANDRE.
Oüy, ie le connois bien.	Oui, Seigneur le connais bien.
IOVVELIN.	JOUVELIN.
Il faut que ie te conte D 12j Vh adiſſable tour rait à ce fot badaur.	Il faut que Seigneur te conte D 12j Vh adissable tour rait à ce sot badaur.
CLEANDRE à part.	CLÉANDRE à part.
Auec vn tour pareil, on fait ſouuent le ſaut.	Avec un tour pareil, on fait souvent le saut.
IOVVELIN.	JOUVELIN.
Point du tout, ce n’eſt là qu’vne galanterie.	Point du tout, ce n'est là qu'une galanterie.
SEEAIEdE vos.	SEEAIEdE vos.
Qui conduit au Gibet.	Qui conduit au Gibet.
IGVVELIN.	IGUVELIN.
Ecoute, ie te prie, Tu vas creuer de rire:	Écoute, Seigneur te prie, Tu vas crèver de rire:
Enfin c’eſt Pain benis.	Enfin c'est Pain bénis.
Quand vn peut attraper vn Badaut de Paris.	Quand un peut attraper un Badaut de Paris.
Tu ſçauras qu’il eſtoit dans ſa Chambre en affaire Auec vn Debiteur, & Monſieur le Notaire;	Tu sçauras qu'il était dans sa Chambre en affaire Avec un Débiteur, et Monsieur le Notaire;
Lors qu’on vit ſon épée en repos ſur ſon lit, Et luy fort occupé pour faire vn mot d’écrit.	Lors qu'on vit son épée en repos sur son lit, Et lui fort occupé pour faire un mot d'écrit.
Ie croy qu’il écriuoit.	Je crois qu'il écrivait.
juſtement vne Lettre.	justement une Lettre.
Ma foy i’en ris encor, & ne m’en puis remettre) Lors qu’vn de nos Barons ſe gliſſe adroitement, Se ſaiſit de l’épée, & ſort incontinent:	Ma foi j'en ris encor, et ne m'en puis remettre) Lors qu'un de nos Barons se glisse adroitement, Se saisit de l'épée, et sort incontinent:
Nous eſtiõs dãs la Court trois ou quatre à l’attendre.	Nous estiõs dans la Court trois ou quatre à l'attendre.
CLEANDRE à part à Clidamis.	CLEANDRE à part à Clidamis.
C’eſt de cette façon qu’vn Homme ſe fait pendre.	C'est de cette façon qu'un Homme se fait pendre.
à lou.	à lou.
Mais tu ne nous dis point quel en fut le Voleur.	Mais tu ne nous dis point quel en fut le Voleur.
Peux-tu pas à ſon nom bailler quelque couleur, ne fans hous le nomier, dhe conmie Il s’appelle?	Peux-tu pas à son nom bailler quelque couleur, ne fans hous le nomier, dhe conmie Il s'appelle?
IOVVELIN.	JOUVELIN.
Ce fut ce grand Vaurien de la Roche-vaudelle, Tresexperimenté dans les tours du Gaſcon;	Ce fut ce grand Vaurien de la Roche-vaudelle, Tresexperimenté dans les tours du Gascon;
Il n’en manque iamais.	Il n'en manque jamais.
CLEANDRE à part.	CLÉANDRE à part.
C’eſt vn vaillant Fripon!	C'est un vaillant Fripon!
Mercure le ſubtil, auec ſa main fourchuë, Ne ſe peut pas vanter de racon prascroenuce	Mercure le subtil, avec sa main fourchue, Ne se peut pas vanter de racon prascroenuce
IOVVELIN.	JOUVELIN.
Heureuſement ſorty, ſans eſtre découuert;	Heureusement sorti, sans être découvert;
Amis, dit-il tout bas, i’ay veu ſon coffre ouuert;	Amis, dit-il tout bas, j'ai vu son coffre ouvert;
Ie croy qu’il peut auoir pres de deux cens Piſtolles:	Je crois qu'il peut avoir pres de deux cens Pistoles:
Il fallut opiner entre nous autres Drolles, Chacun s’en defendoit;	Il fallut opiner entre nous autres Drolles, Chacun s'en défendait;
tirons leurdis-je au Sort:	tirons leurdis-je au Sort:
Mais ce fut temps perdu;	Mais ce fut temps perdu;
car Oronte d’abord S’en eſtant apperceu, fait grand bruit, & menace;	car Oronte d'abord S'en étant aperçu, fait grand bruit, et menace;
Et nous l’épée au poing, fuyons de bonne grace.	Et nous l'épée au poing, fuyons de bonne grâce.
CLEANDNE bas a Cudamis.	CLEANDNE bas a Cudamis.
Hé bien, que t’ay-je dit de nos lâches Barons?	Hé bien, que t'ai-je dit de nos lâches Barons?
IOVVELIN.	JOUVELIN.
Il peſte, il nous maudit, nous appelle Fripons;	Il peste, il nous maudit, nous appelle Fripons;
Mais nous au Cabaret, cependant qu’il s’étrangle;	Mais nous au Cabaret, cependant qu'il s'étrangle;
Nous fûmes bien ſurpris de n’auoir pas ſa ſangle;	Nous fûmes bien surpris de n'avoir pas sa sangle;
Cette ſangle d’argent, riche & belle à rauir.	Cette sangle d'argent, riche et belle à ravir.
Demy deſeſperez de ne la point tenir.	Demi désespérez de ne la point tenir.
Car il en auoit mis vne autre fort méchante.	Car il en avait mis quelque autre fort méchante.
Pourtant chacun de nous mange, rit, boit, & chante, Et nous druertimons coumie de vrais Galants.	Pourtant chacun de nous mange, rit, boit, et chante, Et nous druertimons coumie de vrais Galants.
Vn de noſtre complot auoit ſurpris ſes gands, Vne heure ou deux deuant, comme il eſtoit à table.	Un de notre complot avait surpris ses gants, Une heure ou deux devant, comme il était à table.
Voila de noſtre fait le recit veritable.	Voilà de notre fait le récit véritable.
CLEANDRE.	CLÉANDRE.
Mais n’en craignes tous pome les firrormations?	Mais n'en craignes tous pome les firrormations?
IOVVELIN.	JOUVELIN.
Quoy!	Quoi!
nous autres Barons, nous nous en ſoucirions?	nous autres Barons, nous nous en soucirions?
CLEANDRE.	CLÉANDRE.
On m’a dit qu’il auoit informé de l’affaire.	On m'a dit qu'il avait informé de l'affaire.
IOVVELIN.	JOUVELIN.
Au Fils d’vn Preſident, hé!	Au Fils d'un President, hé!
que pouroit-il faire?	que pourrait-il faire?
Nous autres jeunes gens ſommes au deſſus des Loix, Cleandre, & ce n’eſt là que nos moindres exploits.	Nous autres jeunes gens sommes au dessus des Lois, Cléandre, et ce n'est là que nos moindres exploits.
Nous reſolumes donc, parlant de cette épées Que pas-vn n’auoüroit qu’elle eût eſté frippée, Et nous le ſoûtiendrons juſqu’au dernier ſoûpir.	Nous résolûmes donc, parlant de cette épées Que pas-un n'auoüroit qu'elle eût été fripée, Et nous le soutiendrons jusqu'au dernier soupir.
CLEANDRE.	CLÉANDRE.
C’eſt peu de dérober, il faut encor mentir.	C'est peu de dérober, il faut encor mentir.
fevvBEne.	fevBEne.
As-tu quelque intereſt en cette Cauſe à prendre?	As-tu quelque intérêt en cette Causse à prendre?
CLEANDNE.	CLÉANDNE.
Oüy, i’yprẽs l’intereſt qu’vn braue Hõme doitprẽdre,	Oui, j'yprends l'intérêt qu'un brave Homme doitprẽdre,
IOVVELIN.	JOUVELIN.
Ie le diray par tout, ſi tu prens ſon party.	Je le dirai par tout, si tu prends son parti.
CLEANDRE.	CLÉANDRE.
Et le te donneray par tout le dementy.	Et le te donnerai par tout le démenti.
IOVVELIN.	JOUVELIN.
Ne t’emporte donc pas modere ton courage,	Ne t'emporte donc pas modère ton courage,
Et toy, doreſnauant, tâche à deuenir ſage, tine te plus méler auec tous ces Fripons.	Et toi, dorénavant, tâche à devenir sage, tine te plus mêler avec tous ces Fripons.
IOVVELIN.	JOUVELIN.
Ie me retire, adieu, pour joindre nos Barons;	Je me retire, adieu, pour joindre nos Barons;
N’y veux-tu pas v nir?	N'y veux-tu pas v nir?
CLEANDRE.	CLÉANDRE.
En quel lieu?	En quel lieu?
OEDHIDRE.	OÉDHIDRE.
Ie ne me riſque pas à m’aller faire pendre, L’on pouroit m’enroller au nombre des Fripons;	Je ne me risque pas à m'aller faire pendre, L'on pourrait m'enrôler au nombre des Fripons;
Mais pourquoy monte-tun'naut fur tes talons?	Mais pourquoi monte-tun'naut ur tes talons?
Voila le bel effet d’vne teſte troublée.	Voilà le bel effet d'une tête troublée.
IOVVELIN.	JOUVELIN.
C’eſt pour paroiſtre grand deuant cette aſſemblée:	C'est pour paraître grand devant cette assemblée:
Menes y Clidamis, & viens quant & quant moy.	Mènes y Clidamis, et viens quant et quant moi.
CLEANDRE.	CLÉANDRE.
Prens toûjours le deuant, nous hons bien tans toy.	Prends toujours le devant, nous hons bien tans toi.
CLTDAMIS.	CLTDAMIS.
C’eſt l’ennemy juré de la mélancolie.	C'est l'ennemi juré de la mélancolie.
CLEANDRE.	CLÉANDRE.
Parce qu’il eſt icy le Fils du Preſident, Il ſe croit tout permis.	Parce qu'il est ici le Fils du Président, Il se croit tout permis.
CLIDAMIS.	CLIDAMIS.
Il a beaucoup de vent, Et ie me trompe fort, ou ſa teſte eſt frappée.	Il a beaucoup de vent, Et ie me trompe fort, ou sa tête est frappée.
CLEANDRE.	CLÉANDRE.
mais as tu remarque ron uneours ſur l’épée, Son deſordre d’eſprit, ſon geſte, ſa façon.	mais as tu remarque ron uneours sur l'épée, Son désordre d'esprit, son geste, sa façon.
CLIDAMTS.	CLIDAMTS.
Il a fait ce recit ſans rime, ny raiſon.	Il a fait ce récit sans rime, Seigneur raison.
CLEANDRE.	CLÉANDRE.
Il n’en a point du tout.	Il n'en a point du tout.
CLIDAMIS.	CLIDAMIS.
C’eſt qu’elle eſt endormie:	C'est qu'elle est endormie:
I’ay longtemps obſerué ſa phyſionomie, I’ay medité ſon front, l’ay confuite les yeux, Son nez, ſa bouche auſſy, ſes ſourcis orgueilleux, Son col court, ſou parler, & toute ſa figure, Et ie croy qu’à peu pres i’en ferois la peinture.	J'ai longtemps observé sa physionomie, J'ai médité son front, l'ai confuite les yeux, Son nez, sa bouche aussi, ses sourcis orgueilleux, Son col court, sou parler, et toute sa figure, Et ainsi crois qu'à peu pres j'en ferais la peinture.
Reſte à ſçauoir ſon nom.	Reste à savoir son nom.
CLEANDRE.	CLÉANDRE.
Son nom, c’eſt Iouuelin.	Son nom, c'est Jouvelin.
CLIDAMIS.	CLIDAMIS.
Son col court nous dênote vn Eſprit fort malin, Son front marque ſur luy ie ne ſçay quoy de rude Qui me fait ſoupçonner qu’il n’a pas grand étude Sa bouche me fait voir vn trou large & fendu, Qui me rend tres-certain qu’il eſt vn grand goulu Son parler dit aſſez qu’il a mauuaiſe grace;	Son col court nous dênote un Esprit fort malin, Son front marque sur notre nôtre ne sais quoi de rude Qui me fait soupçonner qu'il n'a pas grand étude Sa bouche me fait voir un trou large et fendu, Qui me rend très -certain qu'il est un grand goulu Son parler dit assez qu'il a mauvaise grâce;
Son nez témoigne auſſi qu’il a beaucoup d’audave Ses ſourcils montrent trop comme il eſt éfronté;	Son nez témoigne aussi qu'il a beaucoup d'audave Ses sourcils montrent trop comme il est éfronté;
Et ſes yeux nous font voir qu’il n’a rien d’arreſté:	Et ses yeux nous font voir qu'il n'a rien d'arrêté:
Sa taille, ſon maintien, & toute ſa figure, Diſent par tout qu’il eſt vn Sot en mignâture.	Sa taille, son maintien, et toute sa figure, Disent par tout qu'il est un Sot en mignâture.
CLEANDRE.	CLÉANDRE.
O Dieux:	Ô Dieux:
quene coppre.	quène coppre.
oacacenent Portrait!	oacacenent Portrait!
Je te proteſte, Amy, qu’il n’y manque aucun trait, Et que dans ce Miroir il ſe verroit ſans peine.	Je te proteste, Ami, qu'il n'y manque aucun trait, Et que dans ce Miroir il se verrait sans peine.
CLIDAMIS.	CLIDAMIS.
Voudrois-tu me mener juſque chez Lyſimene?	Voudrais-tu me mener jusque chez Lysimène?
Mes Violons ſont icy, qui m’attendent la-bas;	Mes Violons sont ici, qui m'attendent la-bas;
Tout le monde eſt entré.	Tout le monde est entré.
CLEANDRE.	CLÉANDRE.
Marchons tout de ce pas, Nous n’auons pas beſoin d’vne plus grande eſcorte Entre hardiment, ſi-toſt qu’on t’ouurira la porte;	Marchons tout de ce pas, Nous n'avons pas besoin d'une plus grande escorte Entre hardiment, sitôt qu'on t'ouvrira la porte;
Et ſans te rebuter du Comte, & des Barons, Pour les faire enrager, fais paſſer tes Violons.	Et sans te rebuter du Comte, et des Barons, Pour les faire enrager, fais passer tes Violons.
SCENE X.	SCÈNE X.
CLEANDRE, AMINTE,NICODEME.	CLÉANDRE, AMINTE,NICODEME.
CLEIRDNE.	CLEIRDNE.
ALlez-vous, braue Aminte, à voſtre promenade?	ALlez-vous, brave Aminte, à votre promenade?
AMINTE.	AMINTE.
Ie vay me diuertir auec mon Camarade, Faire vn tour dans le Mail apres noſtre ſoupé:	Je vais me divertir avec mon Camarade, Faire un tour dans le Mail après nôtre soupé:
C’eſt là que mon Eſprit ſe ſent deſ-occupé Du ridicule Eſprit des Barons de la Fleche:	C'est là que mon Esprit se sent des-occupé Du ridicule Esprit des Barons de la Flèche:
C’eſt là qu’auec plaiſir ie fais vne recherche Des plus beaux ſentimẽs des plus graues Autheurs;	C'est là qu'avec plaisir ie fais une recherche Des plus beaux sentiments des plus graves Auteurs;
Que ie voy s’ils ſont vrais, ou s ils ſont finpoſteurs:	Que ici vois s'ils sont vrais, ou s' ils sont finposteurs:
Si les nouueaux n’ont point dérobé ſur les autres, Ie remonte à la ſource, & vay juſqu’aux Apôtres.	Si les nouveaux n'ont point dérobé sur les autres, Je remonte à la source, et vais jusqu'aux Apôtres.
CLEANDRE.	CLÉANDRE.
Ce trauail eſt bien fort pour vous, & bien tuant.	Ce travail est bien fort pour vous, et bien tuant.
AMINTE.	AMINTE.
Ie veux vous raconter l’hiſtoire d’vn Geant, Du temps du Roy Iorob, commandant les Armées, Qui défit en ſix mois plus de trois cens Pigmées, Mais il faudroit auoir beaucoup d’attention.	Je veux vous raconter l'histoire d'Homme Géant, Du temps du Roi Jorob, commandant les Armées, Qui défit en six mois plus de trois cens Pigmées, Mais il faudrait avoir beaucoup d'attention.
CLEANDRE.	CLÉANDRE.
Remettez à demain la Prédication.	Remettez à demain la Prédication.
N’allez-vous point ce ſoir au Bal?	N'allez-vous point ce soir au Bal?
AMINTE.	AMINTE.
Oû?	Ou?
CLEANDRE.	CLÉANDRE.
Chez Caſſandre;	Chez Cassandre;
C'eſt le beau rendez-vous où chacun ſe doit rendre;	C'est le beau rendez-vous où chacun se doit rendre;
Le Comte du Bel-Air y fait rage des pieds, Et les autres Barons que l’on en a priez.	Le Comte du Bel-Air y fait rage des pieds, Et les autres Barons que l'on en a priés.
AMINTE.	AMINTE.
Depuis ſix mois, & plus, ie n’entre plus chez elle, Elles n’ont pas compris la grandeur de mon zele.	Depuis six mois, et plus, je n'entre plus chez elle, Elles n'ont pas compris la grandeur de mon zèle.
Ne leur ay-je pas fait des bienfaits aſſez grands, Comme Etreines, Portraits, Echos, Billets galants Lettres, Accompliſſemens, Stances, Galanteries, Dont elles n’ont ſouuent fait que des railleries?	Ne leur ai-je pas fait des bienfaits assez grands, Comme Etreines, Portraits, Échos, Billets galants Lettres, Accomplissements, Stances, Galanteries, Dont elles n'ont souvent fait que des railleries?
Et ſans m’en auoir fait aucun remerciment, Ie n’en ay pas receu le moindre compliment.	Et sans m'en avoir fait aucun remerciment, Je n'en ai pas reçu le moindre compliment.
Eſt-ce la comme on doit recõnoiſtre les Hommes?	Est-ce la comme on doit reconnaître les Hommes?
mes, C’eſt vn cõmun malheur dãs le Siecle où nous ſom	mes, C'est un commun malheur dans le Siècle où nous som
Mais vous ne quittez pas tout à fait ce bel Art?	Mais vous ne quittez pas tout à fait ce bel Art?
AMINIE.	AMINIE.
Si ie l’abandonnois, ie ſerois bien camard:	Si ici l'abandonnais, ie serais bien camard:
Pour vn Moyne perdu, quoy!	Pour un Moine perdu, quoi!
l’Abbaye fond-elle?	l'Abbaye fond-elle?
CLEANDRE.	CLÉANDRE.
C’eſt à dire en vn mot, que vous vous raillez d’elle;	C'est à dire en un mot, que vous vous raillez d'elle;
C’eſt fort bien fait à vous, & vous auez raiſon.	C'est fort bien fait à vous, et vous avez raison.
AMINTE.	AMINTE.
Enfin, ie ne veux plus rentrer dans la Maiſon;	Enfin, Seigneur ne veux plus rentrer dans la Maison;
Et ne la voyant plus, nous ſerons quitte à quitte:	Et ne la voyant plus, nous serons quitte à quitte:
On ne ſe moque pas d’vn Homme de merite, Ie ſçay comme on doit viure, & toutes ces façons.	On ne se moque pas d'autre Homme de mérite, Je sais comme on doit vivre, et toutes ces façons.
CLEANDRE.	CLÉANDRE.
Ie vous conſeille auſſi d’en faire des Chanſons:	Je vous conseille aussi d'en faire des Chansons:
Mais pourquoy ramez-vous à volle Dedlcace Imprimer voſtre nom?	Mais pourquoi ramés-vous à volle Dédlcace Imprimer votre nom?
AMINTE.	AMINTE.
C’eſtoit la bonne grace, Pour leur faire plaiſir, & non point autrement.	C'était la bonne grâce, Pour leur faire plaisir, et non point autrement.
CIEANDRE à part.	CIEANDRE à part.
Dieu, pardonne à celuy lequel de nous deux ment.	Dieu, pardonne à celui lequel de nous deux ment.
AMINTE eſt ſi troublé de cette réponſe, qu’il ſort en diſant.	AMINTE est si troublé de cette réponse, qu'il sort en disant.
ene puis plus reſter en voſtre compagnie.	ene puis plus rester en votre compagnie.
CLEANDRE.	CLÉANDRE.
muone, ieruiteul à voltre paronnie.	muone, ieruiteul à voltre paronnie.
SCENE XI.	SCÈNE XI.
CLEANDRE ſeul.	CLEANDRE seul.
Vi mieux que luy ſçauroit s’eſquiuer à propos!	Vi mieux que Seigneur sçauroit s'esquiuer à propos!
ZPour vn Homme ventru, voyez qu’il eſt diſpos:	ZPour un Homme ventru, voyez qu'il est dispos:
Il ne conſulte point d’enfiler la venelle;	Il ne consulte point d'enfiler la venelle;
Vn mot de verité luy tourne la ceruelle:	Un mot de vérité lui tourne la cervelle:
Dés qu’on penſe parler de ſes galimatias D'inphiriez, il vous.	Dès qu'on pense parler de ses galimatias D'inphiriez, il vous.
mais il reuient ſur ſes pas.	mais il revient sur ses pas.
**8:	**8:
1S*SSSS.	1S*SS.
SETS	SETS
SCENE XII.	SCÈNE XII.
CLEANDRE, AMINTE, & NICODEME, rentreut ſur le Theatre.	CLEANDRE, AMINTE, et NICODÈME, rentreut sur le Théâtre.
CLEANDRE.	CLÉANDRE.
vîte?	vite?
E' bien, Seigneur Aminte, où courez-vous ſi IIIl n’eſtpas l’heure encor de cherchervôtre gîte;	ELLE bien, Seigneur Aminte, où courez-vous si IIIl n'estpas l'heure encor de cherchervotre gîte;
Auez-vous déja fait voſtre tour dans le Mail?	Avez-vous déjà fait votre tour dans le Mail?
C’eſt eſtre bon Pieton.	C'est être bon Piéton.
11 AMINTE.	11 AMINTE.
Ie viens ſous ce Portail, Pour vous communiquer encor vne autre Piece.	Je viens sous ce Portail, Pour vous communiquer encor un autre Pièce.
C’eſt le Portique du Carrefour de la Fleche.	C'est le Portique du Carrefour de la Flèche.
CLEANDRE.	CLÉANDRE.
En Proſe, ou bien en Vers?	En Prose, ou bien en Vers?
AMINTE.	AMINTE.
Sur qui n’y penſe pas.	Sur qui n'y pense pas.
Vnique en ſon eſpece,	Unique en son espèce,
CLLATDE.	CLLATDE.
Sur qui?	Sur qui?
AMINIE.	AMINIE.
Sur vn Cornard.	Sur un Cornard.
CLEANDRE.	CLÉANDRE.
Le titre en eſt boufon, riſible, & goguenard, Et bien imaginé.	Le titre en est boufon, risible, et goguenard, Et bien imaginé.
AMINTE.	AMINTE.
N’eſt-il pas vray?	N'est-il pas vrai?
CLEANDRE.	CLÉANDRE.
I’auouë Que ce pauure Cornard fait ſottement la mouë:	J'avoue Que ce pauvre Cornard fait sottement la moue:
Sans doute, il ſe plaindra que vous le traittez mal (Mais tout vous eſt permis en temps de Carnaual.	Sans doute, il se plaindra que vous le traitez mal (Mais tout vous est permis en temps de Carnaval.
Vn Eſprit tel que vous ne ſouffre point de bornes.	Un Esprit tel que vous ne souffre point de bornes.
Comomen mous ceſuy qui larenbien des Cornes?	Comomen mous cesui qui larenbien des Cornes?
Il luy plante les Cornes ſur la teſte auec ſes doigt;	Il avait plante les Cornes sur la tête avec ses doigt;
Qui ſçait ſi noblement faire gerler vir flont?	Qui naît si noblement faire gerler vir flont?
en riant.	en riant.
C’eſt vous peut-eſtre.	C'est vous peut-être.
AMINTE.	AMINTE.
Moy?	Moi?
me faire vn tel affront?	me faire un tel affront?
CLE Il IVEAeRe.	CLÉ Il IVEARRe.
Hé!	Hé!
quand cela ſeroit, pourquoy vous en defendré L’affront n’eſt pas pour vous.	quand cela serait, pourquoi vous en défendré L'affront n'est pas pour vous.
AMINTE.	AMINTE.
Tle pous jar donc, Cleandre?	Tle pous jar donc, Cléandre?
CLEANDRE.	CLÉANDRE.
Pour qu dõc?	Pour qu donc?
Hé vraymẽt c’eſt pour le malheureur	Hé vraiment c'est pour le malheureur
AMINTE.	AMINTE.
Ie croyois, par ma foy, qu’il fut pour tous les deux.	Je croyais, par ma foi, qu'il fut pour tous les deux.
CLEANDRE en riant.	CLÉANDRE en riant.
Comment pour tous les deux?	Comment pour tous les deux?
à part.	à part.
Il eſt bon, ſur mon ame.	Il est bon, sur mon âme.
Côme l’entẽdez vous?	Côme l'entendez -vous?
pour l’Hõme & pour la Fẽme?	pour l'Homme et pour la Femme?
AMINTE.	AMINTE.
Ie ne dis pas cela;	Je ne dis pas cela;
Ie dis que le Mary Faltage cet ahront adce le Tauory .	Je dis que le Mari Falthage cet ahront adce le Tavori .
C’eſt comme ie l’entend.	C'est comme tu l'entend.
CLEANDRE à part.	CLÉANDRE à part.
Fort bien;	Fort bien;
tout ainſi comme.	tout ainsi comme.
Il luy tourne ſon chapeau.	Il te tourne son chapeau.
Qui t’en a tant appris?	Qui t'en a tant appris?
En verité, pauure Homme, Pour eſtre ſi ſçauant, faut eſtre Rimailleur.	En vérité, pauvre Homme, Pour être si savant, faut être Rimailleur.
AMINTE.	AMINTE.
Adieu, Cleandre, adieu, ne fais point le Railleur.	Adieu, Cléandre, adieu, ne fais point le Railleur.
CLEANDRE en le montrant au doigt.	CLÉANDRE en le montrant au doigt.
Adieu donc.	Adieu donc.
Qui voudra s’inſtruire en Cocuage, N'a qu’à l’aller trouuer.	Qui voudra s'instruire en Cocuage, N'a qu'à l'aller trouver.
Voila le Perſonnage.	Voilà le Personnage.
SCENE DERNIERE.	SCÈNE DERNIÈRE.
CLEANDRE, OEADAMIS tentre a grands pas & à grand bruit.	CLEANDRE, ŒEADAMIS tentre a grands pas et à grand bruit.
CLEANDRE.	CLÉANDRE.
COmment donc, Clidamis, quoy!	COmment donc, Clidamis, quoi!
déja de retour?	déjà de retour?
CLIDAMIS.	CLIDAMIS.
C’eſt pour te raconter vn aſſez plaiſant tour.	C'est pour te raconter un assez plaisant tour.
CLEANDRE.	CLÉANDRE.
Le Bal eſt -il finy?	Le Bal est -il fini?
E ij	E ij
CLIDAMIS.	CLIDAMIS.
Non, mais l’on a fait tréuës	Non, mais l'on a fait tréuës
CLEANDRE.	CLÉANDRE.
Ie ne te comprens point.	Je ne te comprends point.
NNE IE IA doo Il commence, & s’acheue,	NNE IE IA do Il commence, et s'achève,
CEEANDNE.	CEANDNE.
Ie penetre encor moins à ce diſcours obſcur.	Je pénètre encor moins à ce discours obscur.
CLIDAMIS.	CLIDAMIS.
Sçache que mes Violons rangezcontre le mur, Tout eſtoit diſpoſé de la meilleure ſorte, Quand ie m’auiſe enfin de frapper à la porte:	Sache que mes Violons rangéscontre le mur, Tout estoit disposé de la meilleure sorte, Quand mille m'avise enfin de frapper à la porte:
I’auois déja frappé, que l’on ne m’ouuroit pas;	J'avais déjà frappé, que l'on ne m'ouvrait pas;
Ie heurte d’abondant, & frappe à tour de bras.	Je heurte d'abondant, et frappe à tour de bras.
Alors vient le petit Laquais, qui me demande Qui va là?	Alors vient le petit Laquais, qui me demande Qui va là?
Ie dis, moy?	Je dis, moi?
La trouppe eſt-elle grande, Me dit-il?	La troupe est-elle grande, Me dit-il?
Non, non, dis-je, & nous sõmes fort peu.	Non, non, dis-je, et nous sont fort peu.
Le Laquais nous voyant, deuint lors tout en feu.	Le Laquais nous voyant, devint lors tout en feu.
Ie pouſſe plus auant, & i’entre dans la Salle, (Suiuy, comme tu ſçais, de mes Violons de balle) Lors qu’vn de vos Barons, le Comte du Bel-Air, Auec ſon habit neuf, faiſant le Duc & Pair, Me voyant arriué, quitte auſſi-toſt la dance, Et d’vn air inſolent vers moy marche & s’auance.	Je pousse plus avant, et j'entre dans la Salle, (Sui, comme tu sais, de mes Violons de balle) Lors qu'un de vos Barons, le Comte du Bel-Air, Avec son habit neuf, faisant le Duc et Pair, Me voyant arrivé, quitte aussitte a dance, La d'un air insolent vers moi marche et s'avance.
Sçauez-vous, me dit-il, que nous ſommes Barons?	Savez-vous, me dit-il, que nous sommes Barons?
Qui vous fait amener icy de tels Violons?	Qui vous fait amener ici de tels Violons?
Et ne ſçauez-vous pas que nous auons les noſtres?	Et ne savez-vous pas que nous avons les nôtres?
Les miens ſont auſſi bons, luy dis-je, que les voſtres, Eſt-ce pour nous brauer, répondit-il?	Les miens sont aussi bons, lui dis-je, que les vôtres, Est-ce pour nous braver, répondit-il?
Non pas, Luy dis-je doucement.	Non pas, Lui dis-je doucement.
Les tiens ne joüront pas.	Les tiens ne joueront pas.
Dit-il inſolemment.	Dit-il insolemment.
Si ie ne leur commande, Luy répondis-je alors:	Si ici ne leur commande, Lui répondis-je alors:
Mais vne de la bande, La plus belle ie croy, remarquant l’air hautain Du Comte, vient à moy, qui me donne la maint	Mais une de la bande, La plus belle je crois, remarquant l'air hautain Du Comte, vient à moi, qui me donne la maint
Cela ſe paſſe ainſi.	Cela se passe ainsi.
Mais, Cleandre, il m’importe De te dire en deux mots, comment, de quelle ſorte Tout eſtoit diſpoſé dans ce petit Ballet.	Mais, Cléandre, il m'importe De te dire en deux mots, comment, de quelle sorte Tout était disposé dans ce petit Ballet.
D’abord ie reconnus l’illuſtre Iodelet, Et deux autres Violons, que le Comte peu ſage Sans doute auoit mandé tout exprés du Village, Pour diuertir Caſſandre, & les Barons Flechois:	D'abord homme reconnus l'illustre Iodelet, Et deux autres Violons, que le Comte peu sage Sans doute avait mandé tout exprès du Village, Pour divertir Cassandre, et les Barons Fléchais:
Ce pauure Comte eſtoit reduit preſque aux abois, Car tu n’ignore pas combien il geſticule, Et comment en danſant ſon air eſt ridicule.	Ce pauvre Comte était réduit presque aux abois, Car tu n'ignore pas combien il gesticule, Et comment en dans son air est ridicule.
Les Donzelles auſſi, pour plaire à leurs Amans, Auoient étudié de nouueaux ornemens:	Les Donzelles aussi, pour plaire à leurs Amants, Avaient étudié de nouueaux ornements:
I'en vis quatre, ie croy, entr’autres Lyſimene, Fort proprement veſtue à la Bohemienne:	J'en vis quatre, je crois, entr'autres Lysimene, Fort proprement vue à la Bohémienne:
Chacune auoit ſon maſque, & les crins à l’enuers, Et ceintes par le corps d’écharpes en trauers;	Chacune avait son masque, et les crins à l'envers, Et ceintes par le corps d'écharpes en travers;
Telles (comme autrefois on voyoit les Bergeres Errantes par les Bois, les Prez, & les Fougeres, La gorge découuerte, & les cheueux épars, Capables d’amolir la fierté du Dieu Mars.	Telles (comme autrefois on voyait les Bergères Errantes par les Bois, les Préparées, et les Fougères, La gorge découverte, et les cheveux épars, Capables d'amolir la fierté du Dieu Mars.
La choſe en cet état, ie danſe ma Courante, D’vne façon pour moy beaucoup indiferente;	La chose en cet état, ie danse ma Courante, D'une façon pour moi beaucoup indiférente;
Car me ſentant piqué contre ces ſots Barons, Ie donnois, bien que mal, la regle à mes talons.	Car me sentant piqué contre ces sots Barons, Je donnais, bien que mal, la règle à mes talons.
Apres auoir danſé, ie remene en ſa place Celle qui m’auoit pris;	Après avoir dansé, ie remène en sa place Celle qui m'avait pris;
mais vne autre diſgrace Me ſuruient en danſant pour la ſeconde fois.	mais une autre disgrâce Me survient en dansant pour la seconde fois.
I’entens à mes coſtez tous les Barons Flechois Qui vouloient hautement que i’oſtaſſe l’épée, (Penſans peut-eſtre entr’eux en faire vne lippée.	J'entends à mes côtés tous les Barons Flechais Qui voulaient hautement que j'ôtasse l'épée, (Pendants peut-être entr'eux en faire une lippée.
Le Comte, & Iouuelin, enragez de me voir, Par leur tranſport jaloux marquoient leur deſeſpoir;	Le Comte, et Jouvelin, enragez de me voir, Par leur transport jaloux marquaient leur désespoir;
Et peut-eſtre déja, par ce lâche artifice, Auoient conjointement medité leur malice, Pour (ayant diſpoſé quelques ſecrets Valets) Me faire adroitement tomber dans leurs filets, Ie tins ferme longtemps, & par ma reſiſtance I’apperceu mes Barons qui perdoient contenance, (Accoûtumez d’vſer en ces déguiſemens D’vn pretexte d’honneur pour excroquer les gens, Et diſoient (pour couurir leur attente trompée) Qu’ils n’auoient lamais veu danier auet repée.	Et peut-être déjà, par ce lâche artifice, Avaient conjointement médité leur malice, Pour (ayant disposé quelques secrets Valets) Me faire adroitement tomber dans leurs filets, Je tins ferme longtemps, et par ma résistance J'aperçu mes Barons qui perdaient contenance, (Accoutumez d'user en ces déguisements D'un prétexte d'honneur pour excroquer les gens, Et disaient (pour couvrir leur attente trompée) Qu'ils n'avaient lamais vu danier au repée.
Mais, Cleandre, tu ſçais que ce n’eſt qu’vn Couteau	Mais, Cléandre, tu sais que ce n'est qu'un Couteau
Regarde.	Regarde.
CLEANDRE.	CLÉANDRE.
Ie le vois, & le trouue fort beau:	Je le vois, et le trouve fort beau:
Mais cõme as-tu dõc fait d’en ſortir chauſſés nettes?	Mais comme as-tu donner fait d'en sortir chaussés nettes?
Car nos Barons Flechois ne portent que des Brettes Dont iis le feruent bien quad lis iont vinigt cõtre vn Et qu’ils ont aualé beaucoup de Vin commun:	Car nos Barons Flechais ne portent que des Brettes Dont jis le fervent bien quad lis jont vinigt montre un Et qu'ils ont avalé beaucoup de Vin commun:
C’eſt le charme attirant.	C'est le charme attirant.
CLIDAMIS.	CLIDAMIS.
Qu’vn braue Homme déteſte.	Qu'un brave Homme déteste.
Ecoute ſeulement, & tu ſçauras le reſte.	Écoute seulement, et tu sauras le reste.
Ces Barons eſtoient donc campez autour de moy, Penſans par leur grand bruit me donner de l’éfroy, Mais ie ne faiſois pas ſemblant de les entendre:	Ces Barons étaient donc campés autour de moi, Pensants par leur grand bruit me donner de l'éfroi, Mais ie ne faisais pas semblant de les entendre:
Il m’a fallu ceder toutefois, & me rendre;	Il m'a fallu céder toutefois, et me rendre;
Et tu peux croire, Amy (ſans que ie ſois ſuſpect) Que ce fut beaucoup moins lâcheté, que reſpect.	Et tu peux croire, Ami (sants que deux sois suspect) Que ce fut beaucoup moins lâcheté, que respect.
Leur ayant donc cedé, chacun d’eux ſe contente, Et moy paiſiblement i’acheue ma Courante:	Leur ayant donc cédé, chacun d'eux se contente, Et moi paisiblement j'achève ma Courante:
Mais le Comte enragé reuient ſur frais nouueaux, Qui s’approchant de moy, releuant ſes nazeaux, Cherchoit encor vn coup à me faire incartade.	Mais le Comte enragé revient sur frais nouveaux, Qui s'approchant de moi, relevant ses naseaux, Cherchait encor un coup à me faire incartade.
Moy déja fatigué de cette Maſcarade, Vers Caſſandre ie cours (qui me voit arpenter) Aſſiſe en ſon Fauteüil comme la Reyne Eſther:	Moi déjà fatigué de cette Mascarade, Vers Cassandre ie cours (qui me voit arpenter) Assise en son Fauteueil comme la Reine Éther:
Auec ciuilité ie m’approche aupres d’elle, Luy dis ce que c’eſtoit, l’auanture nouuelle;	Avec civilité homme m'approche auprès d'elle, Lui dis ce que c'était, l'aventure nouvelle;
Que les Barons Flechois parloient bien hautement;	Que les Barons Fléchais parlaient bien hautement;
Qu’ils en vſoient chez elle vn peu trop librement;	Qu'ils en usaient chez elle un peu trop librement;
Que i’eſtois étonné qu’vne telle jeuneſſe La traittoit en Seruante, & non pas en Maiſtreſſe, De voir qu’en ſon logis vn petit Ecolier Faiſoit inſolemment le brauache & le fier;	Que j'étais étonné qu'une telle jeunesse La traitait en Servante, et non pas en Maîtresse, De voir qu'en son logis un petit Écollier Faisait insolemment le bravache et le fier;
Que l’on ne vit iamais vne telle impudence.	Que l'on ne vit jamais une telle impudence.
Elle écoutoit auec aſſez de patience, Lors que m’interrompant, d’vn ton de voix altier, Me dit, On fait cela dans le particulier.	Elle écoutait a assez de patience, Lors que m'interrompant, d'un ton de voix altier, Me dit, On fait cela dans le particulier.
Apres vne réponſe & ſi claire & ſi nette, I’ay délogé de là ſans tambour ny trompette.	Après une réponse et si claire et si nette, J'ai délogé de là sans tambour homme trompette.
Ainſi donc, cher Amy, ie viens pour te reuoir.	Ainsi donc, cher Ami, ie viens pour te revoir.
CLEANDRE.	CLÉANDRE.
Au Diable les Barons, i’en ſuis au deſeſpoir;	Au Diable les Barons, j'en suis au désespoir;
Au Diable ſoit le Comte, auec ſa jalouſie.	Au Diable soit le Comte, avec sa jalousie.
CLIDAMIS Ie me ris de cela, c’eſt vne fantaiſie;	CLIDAMIS Je me ris de cela, c'est un fantaisie;
Et le plus grand malheur qui m’en peut ſuruenir, C’eſt de n’y plus aller, & de m’en abſtenir.	Et le plus grand malheur qui m'en peut survenir, C'est de n'y plus aller, et de m'en abstenir.
De ce mal alfethent mon erpnit le contoie;	De ce mal alfethent mon erpnit le contoie;
Car par la i’ay ſujet de tenir ma parole, De rendre les Barons Flechois humiliez, Et par tout faire voir tous les Coppieux coppiez.	Car par la j'ai sujet de tenir ma parole, De rendre les Barons Flechais humiliés, Et par tout faire voir tous les Coppieux coppiez.
FIN.	FIN.
E Lecteur doit eſtre auerty que le mot de Coppieux Lſi ſouuent repeté en cette Comedie, ne ſe doit prononcer qu’auec deux ſyllabes, & en ce ſens la prononciation en aura beaucoup plus de force;	E Lecteur doit être averti que le mot de Coppieux Lsi souvent répété en cette Comédie, ne se doit prononcer qu'avec deux syllabes, et en ce sens la prononciation en aura beaucoup plus de force;
au lieu que ſe l’on le prononçoit auec trois ſyllabes, l’expreſſion en ſeroit foible & languiſſante.	au lieu que se l'on le prononçoit avec trois syllabes, l'expression en serait faible et languissante.
Cela luy ſeruira encor pour luy montrer la diference qu’il y a entre le mot de Coppieux qui ſignifie vn Homme qui coppie les actions d’autruy, & le mot de Copieux qui fignifie abondant.	Cela était servira encor pour lui montrer la diérence qu'il y a entre le mot de Coppieux qui signifie un Homme qui coppie les actions d'autrui, et le mot de Copieux qui fignifie abondant.
Regiſtré ſur le Liure de la Communauté, le 15.	Registré sur le Livre de la Communauté, le 15.
Octobre 1665.	Octobre 1665.
ſuiuant l’Arreſt de la Cour de Parle	suivant l'Arrest de la Cour de Parle
