Arius Qu hate de soube	Arius Qu ate de soube
M.	M.
DC.	DC.
XCIV.	XCIV.
LA NYMPHE de la Seine.	LA NYMPHE de la Seine.
AYADES.	AYADES.
Troupe de A DIEUX DES EAUX.	Troupe de A DIEUX DES EAUX.
DRIADES.	DRYADES.
ACIEURS DU PROLOGUE.	ÀCIEURS PU PROLOGUE.
Roupe de Jeux & de Plaiſirs qui entrent en deſordre.	Roupe de Jeux et de Plaisirs qui entrent en désordre.
g Q MRCOEISCEOR Le Theâtre repreſente un Boccage & dans le fond une agreable Prairie arroſée par la Riviere de Seine.	g GU MRCOEISCEOR Le Théâtre représente un Boccage et dans le fond une agréable Prairie arrosée par la Rivière de Seine.
2	2
SCENE PREMIERE.	SCÈNE PREMIÈRE.
Troupe de Jeux & de Plaiſirs qui entrent en deſordre.	Troupe de Jeux et de Plaisirs qui entrent en désordre.
LE CHOEUR.	LE CHOEUR.
Uyons, fuyons une Guerre ſanglante, Eloignons-nous des malheureux Climats Où Mars fait regner l’epouvante;	Uyons, fuyons une Guerre sanglante, Éloignons-nous des malheureux Climats ù Mars fait régner l'épouvante;
Fuyons, fuyons une Guerre ſanglante, Eloignons-nous des malheureux Climats Où l’on ne voit que de cruels combats	Fuyons, fuyons une Guerre sanglante, Éloignons-nous des malheureux Climats ù l'on ne voit que de cruels combats
A ij	À ij
Mais, Ciel!	Mais, Ciel!
où le deſtin a-t’il ſçeu nous conduire?	où le destin a-t-il sçeu nous conduire?
Sommes-nous arrivez dans le ſéjour des Dieux?	Sommes-nous arrivez dans le séjour des Dieux?
Où dans le vaſte Empire Du Heros triomphant que l’Univers admire?	Où dans le vaste Empire Du Héros triomphant que l'Univers admire?
On ne voit rien icy qui n’enchante les yeux.	On ne voit rien ici qui n'enchante les yeux.
PLAISIR.	PLAISIR.
Le bruit affreux des Armes Nous a chaſſé de mille endroits divers:	Le bruit affreux des Armes Nous a chassé de mille endroits divers:
Pour éviter ces funeſtes allarmes On nous verroit voler au bout de l’Univers.	Pour éviter ces funestes alarmes On nous verrait voler au bout de l'Univers.
PLAISIR.	PLAISIR.
Ces brillantes fleurs, ces feüillages, Des Oyſeaux les tendres ramages Semblent nous annoncer que la Paix & l'Amour Regnent dans ce beau ſéjour.	Ces brillantes fleurs, ces feuillages, Des Oiseaux les tendres ramages Semblent nous annoncer que la Paix et l'Amour Regnent dans ce beau séjour.
La Nymphe de la Seine ſort de ſes Eaux.	La Nymphe de la Seine sort de ses Eaux.
SCENE SECONDE.	SCÈNE SECONDE.
LA NYMPHE DE LA SEINE.	LA NYMPHE DE LA SEINE.
Troupe de Nayades & de Dieux des Eaux.	Troupe de Nayades et de Dieux des Eaux.
Troupe de Driades.	Troupe de Driades.
La Nymphe de la Seine.	La Nymphe de la Seine.
Ornez icy voſtre courſe incertaine, T)C’harmans Plaiſirs, aimables Jeux;	Ornez ici votre course incertaine, T)C'harmand Plaisirs, aimables Jeux;
Rien ne peut vous troubler ſur les bords de la Seine, Demeurez à jamais dans cét aZile heureux.	Rien ne peut vous troubler sur les bords de la Seine, Demeurez à jamais dans cet aSile heureux.
La Nymphe de la Seine & un Dieu des Eaux.	La Nymphe de la Seine et un Dieu des Eaux.
Sous les auguſtes loix du Vainqueur de la Terre, JoüiſſeZ d’un ſort plein d’attraits;	Sous les augustes lois du Vainqueur de la Terre, Jouissez d'un sort plein d'attraits;
Les fureurs de la Guerre, Doivent bien-tôt céder aux douceurs de la Paix.	Les fureurs de la Guerre, Doivent bientôt céder aux douceurs de la Paix.
La Nymphe de la Seine.	La Nymphe de la Seine.
La force, la valleur, le ſecret, la prudence, Sont avec ce grand Roy toûjours d’intelligence;	La force, la valeur, le secret, la prudence, Sont avec ce grand Roi toujours d'intelligence;
Quand la prudence & le ſecret Ont conduit une grande affaire, La valleur ne tarde guere D’en executer le projet.	Quand la prudence et le secret Ont conduit une grande affaire, La valeur ne tarde guère D'en exécuter le projet.
Un Dieu.	Un Dieu.
des Eaux.	des Eaux.
Lorſqu’il remet le ſoin de ſa vengeance A ſon auguſte Fils, le bonheur de la France;	Lorsqu'il remet le soin de sa vengeance À son auguste Fils, le bonheur de la France;
C’est moins pour prendre du repos, 2 pen jarlsjalre;	C'est moins pour prendre du repos, 2 pen arlsjalre;
L’ardeur noble & guerriere De ce jeune Heros.	L'ardeur noble et guerrière De ce jeune Héros.
Chœur de Driades & de Divinitez des Eaux.	Chœur de Driades et de Divinités des Eaux.
Sous les auguſtes totx du painqueur de la Terre;	Sous les augustes totx du painqueur de la Terre;
Jouiſſez d’un ſort plein d’attraits;	Jouissez d'un sort plein d'attraits;
Les fureurs de la Guerre Doivent bien-tôt céder aux douceurs de la Paix.	Les fureurs de la Guerre Doivent bientôt céder aux douceurs de la Paix.
Deux Driades.	Deux Driades.
Tout rit dans ce boccage, Tout répond à nos vœux.	Tout rit dans ce bocage, Tout répond à nos vœux.
Le cnœur.	Le cnœur.
Tout rit dans ce boccage, Tout répond à nos vœux.	Tout rit dans ce bocage, Tout répond à nos vœux.
Deux Driades.	Deux Driades.
Le cœur le plus ſauvage T devient amoureux.	Le cœur le plus sauvage T devient amoureux.
Le Chœur.	Le Chœur.
Tout rit dans ce boccage, Tout répond à nos vœux.	Tout rit dans ce bocage, Tout répond à nos vœux.
Deux Driades.	Deux Driades.
Quand l’amour nous engage C’eſt pour nous rendre heureux.	Quand l'amour nous engage C'est pour nous rendre heureux.
Le Chœur.	Le Chœur.
Tout rit dans ce boccage, Tout repond à nos vœux.	Tout rit dans ce bocage, Tout répond à nos vœux.
Deux Driades.	Deux Driades.
Etoignez, de l’Orage Et des Combats affreux, Nous avons en partage Les Plaiſirs & les Jeux.	Étoignez, de l'Orage Et des Combats affreux, Nous avons en partage Les Plaisirs et les Jeux.
Le *Chœur.	Le *Chœur.
Tout rit dans ce boccage Tout répond à nos vœux.	Tout rit dans ce bocage Tout répond à nos vœux.
UNE NAYADE.	UNE NAÏADE.
Les plaiſirs ſuivent les peines Dans un tendre engagement, Les plaiſirs ſuivent les peines Quand on aime conſtament.	Les plaisirs suivent les peines Dans un tendre engagement, Les plaisirs suivent les peines Quand on aime constament.
Ne briſeZ jamais vos chaînes Vous aurez, un ſort charmant.	Ne brisez jamais vos chaînes Vous aurez, un sort charmant.
Les plaiſirs ſuivent les peines Dans un tendre engagement, Les plaiſirs ſuivent les peines Quand on aime conſtament.	Les plaisirs suivent les peines Dans un tendre engagement, Les plaisirs suivent les peines Quand on aime constament.
Aupres dcs prus tnhumaines On trouve un heureux moment.	Auprès dus prus thumaines On trouve un heureux moment.
Les plaiſirs ſuivent les peines Dans un tendre engagement, Les plaiſirs ſuivent les peines Quand on aime conſtament.	Les plaisirs suivent les peines Dans un tendre engagement, Les plaisirs suivent les peines Quand on aime constament.
DEUX NAYADES.	DEUX NAÏADES.
Dans l’amoureux Empire Le plaiſir eſt ſans égal;	Dans l'amoureux Empire Le plaisir est sans égal;
Mais un retour fatal Fait ſouvent qu’on ſoûpire:	Mais un retour fatal Fait souvent qu'on soupire:
De l’amour on ne peut dire Trop de bien ny trop de mal	De l'amour on ne peut dire Trop de bien apprendre trop de mal
Sous les auguſtes loix du Vaiuqueur de la Terre Jouiſſons d’un fort plein d’attraits, Les fureurs de la Guerre Doivent bien-tôt ceder aux douceurs de la Paix.	Sous les augustes lois du Vaiuqueur de la Terre Jouissons d'un fort plein d'attraits, Les fureurs de la Guère Doivent bientôt céder aux douceurs de la Paix.
FIN DU PROLOGUE.	FIN DU PROLOGUE.
ACTEURE 4 DE LA TRAGEDIE.	ACTEURE 4 DE LA TRAGÉDIE.
O D IRGE’, Fille du Soleil, veuve du Roy de Sarmates & grande Magicienne, amoureuſe d’Uliſſe.	Ô D RGE', Fille du Soleil, veuve du Roi de Sarmates et grande Magicienne, amoureuse d'Ulisse.
ASTERIE, Nymphe de la Cour de Circé.	ASTÉRIE, Nymphe de la Cour de Circé.
ULISSE, Roy d’Itaque, Amant d’Eolie.	ULISSE, Roi d'Itaque, Amant d'Éolie.
ELPHENOR, Prince Grec, amoureux d’Aſterie.	ÉLPHÉNOR, Prince Grec, amoureux d'Asterie.
POLITE, Prince Grec, amy d’Uliſſe, & Amant dAſterie.	POLITE, Prince Grec, ami d'Ulisse, et Amant dAsterie.
Troupe de Guerriers Grecs, amis d'Uliſſe.	Troupe de Guerriers Grecs, amis d'Ulisse.
Troupe d’Amans fortunez.	Troupe d'Amands fortunés.
Cd’Amantes heureuſes.	Cd'Amantes heureuses.
	
Le Grand Prêtre du Temple de l’Amour.	Le Grand Prêtre du Temple de l'Amour.
L’AMOUR.	L'AMOUR.
EOLIE Nymphe, Fille d'Eole Reine de Lipare, Amante d’Uliſſe.	ÉLIE Nymphe, Fille d'Eole Reine de Lipare, Amante d'Ulisse.
Troupe de Vents Aquilons qui paroiſſent en l’air.	Troupe de Vents Aquilons qui paraissent en l'air.
MINERVE.	MINERVE.
PHÆBETOR.	PHÉBETOR.
PHANTASE.	PHANTASE.
S Troupe Songes.	 Soupe Songes.
de Songes agreables.	de Songes agréables.
C de Songes funeſtes.	Ç de Songes funestes.
L’Ombre d’ELPHENOR.	L'Ombre d'ELPHÉNOR.
I 1 Quutit Etmvns qui trcvent un Tombeau.	I 1 Quutit Etmencs qui trèvent un Tombeau.
Les trois EUMENIDES.	Les trois EUMENIDES.
Troupe de Demons transformez, en Nymphes.	Troupe de Démons transformés, en Nymphes.
MERCURE.	MERCURE.
AQUILON.	AQUILON.
Troupe de Vents.	Troupe de Vents.
Troupe de Nereïdes.	Troupe de Nereïdes.
de Tritons.	de Tritons.
Troupe de Demons armez de feux.	Troupe de Demons armés de feux.
La Scene eſt dans l’Iſle d’Æa.	La Scène est dans l'Isle d'E.
L Mde N.	 Lde N.
TRAGEDIE.	TRAGÉDIE.
MMMEMEMAVIIEIIT.	MMMEMEMAVIIEIIT.
Le Theâtre repreſente une Avenuë, & dans l’éloignement, la façade du Palais de Circé.	Le Théâtre représente une Avenue, et dans l'éloignement, la façade du Palais de Circé.
SCENE PREMIERE.	SCÈNE PREMIÈRE.
CIRCE', ASTERIE.	CIRCE', ASTÉRIE.
V S CIRCE'.	V S CIRCE'.
QH!	QUH!
que l’Amour auroit de charmes, 2 Lors qu’il unit de tendres cœurs, S’il finiſſoit pour jamais leurs allarmes:	que l'Amour aurait de charmes, 2 Lors qu'il unit de tendres cœurs, S'il finissait pour jamais leurs alarmes:
Ah!	Ah!
que l’Amour auroit de charmes, Lors qu’il unit de tendres cœurs S’il ne leur cauſoit plus que de douces langueurs;	que l'Amour aurait de charmes, Lors qu'il unit de tendres cœurs S'il ne leur causait plus que de douces langueurs;
Mais, helas!	Mais, hélas!
ce cruel nous fait ſentir ſes peines Au milieu des plaiſirs;	ce cruel nous fait sentir ses peines Au milieu des plaisirs;
Et pius it fait atmer jes chaines, Plus il coûte de ſoins, de pleurs & de ſoûpirs.	Et pius it fait atmer jes chaines, Plus il coûte de soins, de pleurs et de soupirs.
ASTERIE.	ASTÉRIE.
Vous ſerez toûjours jeune & belle, AimeZ, aimez avec tranquilité:	Vous serez toujours jeune et belle, Aimez, aimez avec tranquillité:
porre cubar en uimant uoitxtetire ugite s Comme le cœur d’une Mortelle, Vous ſereZ toûjours jeune & belle;	porre cubar en uimant uaitxtetire ugite s Comme le cœur d'une Mortelle, Vous serez toujours jeune et belle;
Aimez, aimez avec tranquilité.	Aimez, aimez avec tranquillité.
GE'.	GE'.
J'aime Uliſſe, & je dois croire Qu'il eſt ſenſible à ma langueur;	J'aime Ulisse, et je dois croire Qu'il est sensible à ma langueur;
Mais, helas!	Mais, hélas!
je crains que la Gloire, Malgré mon tendre amour, ne m’arrache ſon cœur, Une ſecrette jalouſie Vient encor m’allarmer;	je crains que la Gloire, Malgré mon tendre amour, ne m'arrache son cœur, Une secrète jalousie Vient encor m'alarmer;
Uliſſe avant que de m’aimer A ſoüpiré pour Eolie:	Ulisse avant que de m'aimer A soüpiré pour Éolie:
L'Amour ſçût long-tems l’arrêter A la Cour d’Eole ſon Pere, Pour retourner en Grece, il falut la quitter;	L'Amour sçût longtemps l'arrêter À la Cour d'Éole son Père, Pour retourner en Grèce, il fallut la quitter;
Mais le cruel Amour à mon repos contraire, Plûtôt que les Vents furieux, L’a fait aborder en ces lieux.	Mais le cruel Amour à mon repos contraire, Plutôt que les Vents furieux, L'a fait aborder en ces lieux.
Ah!	Ah!
je rougis de ma foibleſſe, Le voir, l’aimer, luy montrer ma tendreſſe, Ne fut pour moy qu’un même instant;	je rougis de ma faiblesse, Le voir, l'aimer, notre montrer ma tendresse, Ne fut pour moi qu'un même instant;
Il me promit un cœur tendre & conſtant, Mais peut-être que dans ſon ame Il conſerve l’ardeur de ſa premiere flâme;	Il me promit un cœur tendre et constant, Mais peut-être que dans son âme Il conserve l'ardeur de sa première flamme;
Peut-être enfin pour m’échaper, L’Ingrat veut me tromper.	Peut-être enfin pour m'échapper, L'Ingrat veut me tromper.
ASTERIE.	ASTÉRIE.
Vous ne pouvez ſans injustice Douter du cœur de l’amoureux Uliſſe, Ny du pouvoir de vos yeux;	Vous ne pouvez sans injustice Douter du cœur de l'amoureux Ulisse, Ni du pouvoir de vos yeux;
De ouo pronmono negunuio tomn pu jo uefendre, Sans le ſecours de vôtre art merveilleux, Vous l’avez contraint de ſe rendre.	De ouo pronmono negunuio tomn pu jo œuefendre, Sans le secours de votre art merveilleux, Vous l'avez contraint de se rendre.
Tout vous rit avec luy dans ces aimables lieux.	Tout vous rit avec beau dans ces aimables lieux.
IRCE'.	JRCE.
Ecoûte de mes maux l’entiere confidence:	Écoute de mes maux l'entière confidence:
Ses Guerriers en ſecret le preſſent de partir, On vient de m'en avertir;	Ses Guerriers en secret le pressent de partir, On vient de m'en avertir;
Rien n’est égal à leur impatience, Ils reprochent ſouvent à ce fameux Heros Qu’il les fait trop languir dans un honteux repos.	Rien n'est égal à leur impatience, Ils reprochent souvent à ce fameux Héros Qu'il les fait trop languir dans un honteux repos.
ASTERIE.	ASTÉRIE.
Croyez-vous cet avis ſincere?	Croyez-vous cet avis sincère?
CIRCE'.	CIRCE'.
L’amoureux Elphenor n’a pû voir ſans effroy Qu te fauuroit s'etoigner de toy, Il m’a découvert ce miſtere.	L'amoureux Elphénor n'a pu voir sans effroi Qu te fauvrait s'étoigner de toi, Il m'a découvert ce mystère.
ASTERIE & CIRCE'.	ASTÉRIE et CIRCE'.
Pour les Amans les plus heureux, Amour ta rigueur est extrême, Le plaiſir de ſe voir aimé de ce qu’on aime, N’exempte pas des ſoins fâcheux:	Pour les Amants les plus heureux, Amour ta rigueur est extrême, Le plaisir de se voir aimé de ce qu'on aime, N'exempte pas des soins fâcheux:
2 ouononoEhimus vos pouomeureux, Amour ta rigueur eſt extréme.	2 ouononoEhimus vos pouomeureux, Amour ta rigueur est extrême.
CIRCE.	CIRCE.
Il paroït ce Heros charmant!	Il paraît ce Héros charmant!
Ho FENTes Il ne ſçauroit ſans vous paſſer un ſeul moment.	Ho FENTes Il ne saurait sans vous passer un seul moment.
SCENE SECONDE.	SCÈNE SECONDE.
CIRCE’, ULISSE, ASTERIE.	CIRCE', ULISSE, ASTÉRIE.
I IRCE’.	I JRCE'.
Rince vous connoiſſez juſqu’où va ma tendreſſe, Elle n’a que trop éclaté;	Rince vous connaissez jusqu'où va ma tendresse, Elle n'a que trop éclaté;
J’aurois pris ſoin de cacher ma foibleſſe, Si j’avois écoûté ma gloire & ma fierté:	J'aurais pris soin de cacher ma faiblesse, Si j'avais écouté ma gloire et ma fierté:
Mais Mais lors qu’on peut aimer autant que je vous aime, Du ſeul Amour on connoît le pouvoir.	Mais Mais lors qu'on peut aimer autant que je vous aime, Du seul Amour on connaît le pouvoir.
Et l’on n’écoute plus ny raiſon ny devoir;	Et l'on n'écoute plus ni raison était devoir;
Helas, il s'en faut bien que vous n’aimieZ de même!	Hélas, il s'en faut bien que vous n'aimiez de même!
ULISSE.	ULISSE.
Quel reproche cruel pour mon cœur amoureux!	Quel reproche cruel pour mon cœur amoureux!
L'Amour luy fait ſentir tout ce qu’il a de feux;	L'Amour Seigneur fait sentir tout ce qu'il a de feux;
Et chaque jour vôtre aimable preſence En augmente la violence!	Et chaque jour votre aimable présence En augmente la violence!
4 OLISSECCINCE.	4 OLISECCINCE.
Non il n’est point d’Amant puiſſe aimer ſoit aimé Tplus tendrement.	Non il n'est point d'Amant puisse aimer soit aimé Tplus tendrement.
CIRCE’.	CIRCE'.
Si vous m’aimez faut-il me taire.	Si vous m'aimez faut-il me taire.
Que de cruels amis vous preſſent de partir, Faloit-il m’en faire un miſtere Si vôtre cœur n’y pouvoit conſentir?	Que de cruels amis vous pressent de partir, Falait-il m'en faire un mystère Si votre cœur n'y pouvait consentir?
Il faut qu’en vôtre preſence Ces-ſuperbes Guerriers éprouvent mon courroux, Dans ce bois chacun d’eux s’avance;	Il faut qu'en votre présence Ces-superbes Guerriers éprouvent mon courroux, Dans ce bois chacun d'eux s'avance;
Ils-penſent n’y trouver que vous.	Ils-pensent n'y trouver que vous.
ULISSE.	ULISSE.
Je ne ſuis occupé que du ſoin de vous plaire, Hélas!	Je ne suis occupé que du soin de vous plaire, Hélas!
pourquoy faut-il dans ce funeſte jour Voir briller vos beaux yeux du feu de la Colere?	pourquoi faut-il dans ce funeste jour Voir briller vos beaux yeux du feu de la Colère?
Ils ne devroient briller que des feux de l’Amour.	Ils ne devraient briller que des feux de l'Amour.
S CENE TROISIE’ME.	 SENE -THROISIE'ME.
ELPHENOR, POLITE, Troupe de Guerriers Grecs amis d’Uliſſe, CIRCE’, ULISSE, ASTERIE.	ELPHENOR, POLITE, Troupe de Guerriers Grecs amis d'Ulisse, CIRCE' ULISSE, ASTÉRIE.
Eprouvez malheureux ſi je ſçai me vanger;	Éprouvez malheureux si je sais me venger;
Transformez-vous en des Monſtres horribles, Et ſervez d’exemples terribles A qui m’oſe outrager.	Transformés-vous en des Monstres horribles, Et servez d'exemples terribles A qui m'ose outrager.
CIRCE' aux Grecs.	CIRCE' aux Grecs.
T.	T.
Oſtre amitié s’intereſſe V A la gloire de ce Heros;	Ostre amitié s'intéresse V A la gloire de ce Héros;
Il vous paroît que ma tendreſſe Le fait languir dans un honteux repos, y ente& cons to preſfen ete rerournor en Grece ?	Il vous paraît que ma tendresse Le fait languir dans un honteux repos, y ente cons presfen été rerournor en Grece .
Polite & les autres Grecs, à la reſerve d’Elphenor, ſont changez en pluſieurs ſortes de Monſtres.	Polite et les autres Grecs, à la réserve d'Élphénor, sont changez en plusieurs sortes de Monstres.
ASTERIE.	ASTÉRIE.
O Dieux, quel ſort épouvantable!	Ô Dieux, quel sort épouvantable!
ULISSE.	ULISSE.
Ciel, quel excés de rigueur!	Ciel, quel excès de rigueur!
Belle Reine en ma faveur, Faites ceſſer.	Belle Reine en ma faveur, Faites cesser.
3	3
IRCE'.	JRCE.
Non, non, je ſuis inexorable, Allez Monstres affreux, cachez-vous pour jamais Au fonds de ces foreſts.	Non, non, je suis inexorable, Allez Monstres affreux, cachez-vous pour jamais Au fond de ces forêts.
Circé à Uliſſe.	Circé à Ulisse.
Prince ne craigneZ rien la crainte eſt inutile, Des jeux & des plaiſirs voyez, le doux azile.	Prince ne craignez rien la crainte est inutile, Des jeux et des plaisirs voyez, le doux asile.
ChangeZ-vous triſtes lieux En un ſejour délicieux:	ChangeZ-vous tristes lieux En un séjour délicieux:
Et vous que l’Amour enchaîne, VeneZ, veneZ Amans heureux, Chantez vos plaiſirs amoureux Et le pouvoir de vôtre Reine.	Et vous que l'Amour enchaîne, VeneZ, venez Amants heureux, Chantez vos plaisirs amoureux Et le pouvoir de votre Reine.
Le Theâtre change & repreſente un Jardin remply de Jaſſemins & d’Orangers, qui forment des allées à perte de vûë, on voit des caſcades dans l’éloignement.	Le Theâtre change et représente un Jardin rempli de Jassemins et d'Orangers, qui forment des allées à perte de vue, on voit des cascades dans l'éloignement.
SCENE QUATRIE’ME.	SCÈNE QUATRIE'ME.
CIRCE', ULISSE, ASTERIE, ELPHENOR, Troupe d’Amans fortunez & d’Amantes heureuſes.	CIRCE', ULISSE, ASTÉRIE, ÉLPHENOR, Troupe d'Amants fortuné et d'Amantes heureuses.
Un Amant fortûné.	Un Amant fortûné.
E nos plaiſirs que l’Echo retentiſſe, E Pour les chanter qu'avec nous tout s'uniſſe	E nos plaisirs que l'Écho retentisse, E Pour les chanter qu'avec nous tout s'unisse
LE CHOEUR.	LE CHOEUR.
De nos plaiſirs que l’Echo retentiſſe, Pour les chanter qu’avec nous tout s’uniſſe.	De nos plaisirs que l'Écho retentisse, Pour les chanter qu'avec nous tout s'unisse.
L’Amant fortuné.	L'Amant fortuné.
Que les Oiſeaux De ce charmant boccage, Au bruit des Eaux, Joignent leur doux ramage Loin des Jaloux, Sans crainte & ſans envie De nôtre vie, Tous les momens ſont doux.	Que les Oiseaux De ce charmant bocage, Au bruit des Eaux, Joignent leur doux ramage Loin des Jaloux, Sans crainte et sans envie De notre vie, Tous les moments sont doux.
LE CHOEUR.	LE CHOEUR.
De nos plaiſirs que l’Echo retentiſſe, Pour les chanter qu’avec nous tout s’uniſſe,	De nos plaisirs que l'Écho retentisse, Pour les chanter qu'avec nous tout s'unisse,
L’Amant fortuné.	L'Amant fortuné.
Par ſon pouvoir Nôtre aimable Déeſſe Fait toûjours dans nos Champs Regner le doux Printemps, Et la jeuneſſe Nous ſuit ſans ceſſe, Avec les jeux, les ris & la tendreſſe.	Par son pouvoir Notre aimable Déesse Fait toujours dans nos Champs Règner le doux Printemps, Et la jeunesse Nous suit sans cesse, Avec les jeux, les ris et la tendresse.
LE CHOEUR.	LE CHOEUR.
De nos plaiſirs que l’Echo retentiſſe, Pour les chanter qu’avec nous tout s’uniſſe.	De nos plaisirs que l'Écho retentisse, Pour les chanter qu'avec nous tout s'unisse.
L’Amant fortuné.	L'Amant fortuné.
1a Dans ces beaux lieux l'Amour eſt ſans allarmes, Il ne fait voir que ce qu’il a de charmes.	1a Dans ces beaux lieux l'Amour est sans alarmes, Il ne fait voir que ce qu'il a de charmes.
LE CHOEUR.	LE CHOEUR.
Dans ces beaux lieux l’Amour est ſans allarmes, Il ne fait voir que ce qu’il a de charmes.	Dans ces beaux lieux l'Amour est sans alarmes, Il ne fait voir que ce qu'il a de charmes.
l Amant fortuné.	l Amant fortuné.
D’aimables traits Ce Dieu bleſſe nôtre ame, Et l’on veut à jamais Sentir ſa flâme;	D'aimables traits Ce Dieu blesse notre âme, Et l'on veut à jamais Sentir sa flamme;
Il ſçait charmer Le cœur le plus ſevere, Et qui ſçait bien aimer Eſt ſeur de plaire.	Il sait charmer Le cœur le plus sévère, Et qui sait bien aimer Est sûr de plaire.
LE CHOEUR.	LE CHOEUR.
Bans ces beaux tieux tAmour eſt ſans allarmes.	Bans ces beaux tieux tAmour est sans alarmes.
Il ne fait voir que ce qu’il a de charmes.	Il ne fait voir que ce qu'il a de charmes.
L’Amant fortuné.	L'Amant fortuné.
Loin de nos hois Trop ſevere Sageße, Donnez, vos Loix A la triſte Vieilleſſe, D'ans le bel aage N’eſt-on pas ſage 3 Lors qu’on fait des Plaiſirs un bon uſage.	Loin de nos hois Trop sévère Sage, Donnez, vos Lois A la triste Vieillesse, D'ans le bel aage N'est-on pas sage 3 Lors qu'on fait des Plaisirs un bon usage.
LE CHOEUR.	LE CHOEUR.
Dans ces beaux lieux l' Amour eſt ſans allarmes, Il ne fait voir que ce qu’il a de charmes.	Dans ces beaux lieux l' Amour est sans alarmes, Il ne fait voir que ce qu'il a de charmes.
Les Amans fortunez ſe retirent, Circé ſort avec Uliſſe, Aſterie la veut ſuivre, mais Elphenor la retient.	Les Amants fortunés se retirent, Circé sort avec Ulisse, Asterie la veut suivre, mais Élphenor la retient.
SCENE CINQUIE’ME.	SCÈNE CINQUIE'ME.
ASTERIE, ELPHENOR,	ASTÉRIE, ÉLPHENOR,
ELPHENOR.	ÉLPHENOR.
T Ous verray-je toûjours inſenſible & cruelle?	 TÔ verrai-je toujours insensible et cruelle?
V Tout parle icy d’aimer, aimeZ à vôtre tour, Du moins pour un moment écoûtez mon amour, Ne deſesperez pas l’Amant le plus ſidele.	V Vite parle ici d'aimer, aimez à votre tour, Du moins pour un moment écoutez mon amour, Ne désespérez pas l'Amant le plus sièle.
ASTERIE.	ASTÉRIE.
Je fais ma felicité D’une douce tranquilité, N'espereZ pas de me voir jamais tendre?	Je fais ma félicité D'une douce tranquillité, N'espérez pas de me voir jamais tendre?
Mon cœur eſt épouvanté Des ſoins que l’Amour fait prendre.	Mon cœur est épouvanté Des soins que l'Amour fait prendre.
ELPHENOR.	ÉLPHENOR.
Quand on eſt ſans amour la vie eſt ſans appas, En aimant tout plait, tout enchante, C’eſt lors qu'un Amant ne plait pas Que l’Amour épouvante.	Quand on est sans amour la vie est sans appas, En aimant tout plaît, tout enchante, C'est lors qu'un Amant ne plaît pas Que l'Amour épouvante.
ASTERIE.	ASTÉRIE.
De vos amis le funeſte malheur Devroit occuper vôtre cœur.	De vos amis le funeste malheur Devrait occuper votre cœur.
ELPHENOR.	ÉLPHENOR.
Quand l’Amour eſt extrême La plus tendre amitté ne ſe fait point ſentir, Charmante Nymphe je vous aime, Tous vos mepris ne ſçauroient me guerir:	Quand l'Amour est extrême La plus tendre amitté ne se fait point sentir, Charmante Nymphe je vous aime, Tous vos mépris ne sauraient me guérir:
BRIY poule Moubbben Moy ente;	BRIY poule Mouben Moi ente;
Ingrate, helas!	Ingrate, hélas!
Que n’oublieray-je pas?	Que n'oublierai-je pas?
ASTERIE.	ASTÉRIE.
Non je ne ſçaurois plus me taire, Vous les avez trahis ces malheureux amis:	Non je ne saurais plus me taire, Vous les avez trahis ces malheureux amis:
Ah!	Ah!
je rougis de colere Ne oorr que vAntom nrus fonmis Un cœur qui mépriſe la gloire, Je ne veux point regner dans ce perfide cœur, Je perdray juſqu’à la mémoire, Qu’il ait jamais ſenty pour moy la moindre ardeur.	je rougis de colère Ne oorr que vAntom nrus -fonmis Un cœur qui méprise la gloire, Je ne veux point régner dans ce perfide cœur, Je perdrai jusqu'à la mémoire, Qu'il ait jamais senti pour moi la moindre ardeur.
Elle ſort.	Elle sort.
ELPHENOR.	ÉLPHENOR.
Arrêtez Nymphe impitoyable Pour voir punir un cœur que vous trouvez, coupable.	Arrêtez Nymphe impitoyable Pour voir punir un cœur que vous trouvez, coupable.
SCENE	SCÈNE
I ’Inhumaine me fuit, rien ne peut l’attendrir, Un affreux deſespoir s’empare de mon ame:	I J'Inhumaine me fuit, rien ne peut l'attendrir, Un affreux désespoir s'empare de mon âme:
Esteignons dans mon ſang une fatale flâme, La ſeule mort peut m'en guerir.	Éteignons dans mon sang une fatale flamme, La seule mort peut m'en guérir.
L’ingrate, quel courroux m’a-t-elle fait paroître!	L'ingrate, quel courroux m'a-t-elle fait paraître!
iel!	jel!
quel mépris injurieux!	quel mépris injurieux!
Si je ſuis un perfide, un traître, On ne doit de mon crime accuſer que ſes yeux.	Si je suis un perfide, un traître, On ne doit de mon crime accuser que ses yeux.
Le violent amour dont je brûle pour elle M’a fait découvrir un ſecret, J’aurois eſté l’amy le plus diſcret, Si j’étois un Amant moins tendre & moins fidele.	Le violent amour dont je brûle pour elle M'a fait découvrir un secret, J'aurais été l'ami le plus discret, Si j'étais un Amant moins tendre et moins fidèle.
Mais un ſoupçon jaloux augmente mon tourment, A regret je penêtré un funeſte miſtere;	Mais un soupçon jaloux augmente mon tourment, À regret je pénétré un funeste mystère;
N’en doutons plus, la perte d’un Amant Dè l’ingrate Aſterie a cauſé la colere.	N'en doutons plus, la perte d'un Amant Dées l'ingrate Asterie a causé la colère.
Puiſſe-t-il, ce Rival, mille fois trop heureux, Eſtre toujours un Monſtre affreux.	Puisse-t-il, ce Rival, mille fois trop heureux, Être toujours un Monstre affreux.
Allons employer l’artifice, Pour empêcher qu'Uliſſe N’obtienne de Circé grace pour ſes amis;	Allons employer l'artifice, Pour empêcher qu'Ulisse N'obtienne de Circé grâce pour ses amis;
On me hait, on m’outrage Suivons les transports de ma ra Aux cœurs deſesperez tout doit être permis.	On me hait, on m'outrage Suivons les transports de ma ra Aux cœurs désespérez tout doit être permis.
Fin du premier Acte.	Fin du premier Acte.
AOA DESIN Le Theâtre change & repreſente le Temple de l’Amour, ſoûtenu par des CoroHrhies de ivarbie ornices de Couronnes de Mirthe;	ÀOA DESIN Le Théâtre change et représente le Temple de l'Amour, soutenu par des CoroHrhies de jarbie ornices de Couronnes de Mirthe;
on voit dans le fonds la figure de ce Dieu, au milieu de la Jeuneſſe & de la Beauté.	on voit dans le fonds la figure de ce Dieu, au milieu de la Jeunesse et de la Beauté.
SCENE PREMIERE.	SCÈNE PREMIÈRE.
ASTERIE ſeule.	ASTÉRIE seule.
H!	H!
c’est trop retenir mes pleurs, Donnons un libre cours à mes vives douleurs:	c'est trop retenir mes pleurs, Donnons un libre cours à mes vives douleurs:
Je ſuis ſeule en ces lieux, je puis ſans me contraindre, Soüpirer & me lplaindre;	Je suis seule en ces lieux, je puis sans me contraindre, Soupirer et me laindre;
D i L’inhumaine Circé, par un enchantement Le plus épouvantable, Me cache mon Amant Sous une figure effroyable;	D y L'inhumaine Circé, par un enchantement Le plus épouvantable, Me cache mon Amant Sous une figure effroyable;
Mais je dois craindre encore un plus cruel mal-heur, Peut-eſtre en le changeant, elle a changé ſon cœur.	Mais je dois craindre encore un plus cruel malheur, Peut-être en le changeant, elle a changé son cœur.
Amour, qui vois couler mes larmes, Viens finir mes allarmes, Rends-moy l’Objet qui m’a charmé, Et fais qu’il aime antant qu’il eſt aimé.	Amour, qui vois couler mes larmes, Viens finir mes alarmes, Rends-moi l'Objet qui m'a charmé, Et fais qu'il aime antant qu'il est aimé.
C liffe (Oretit evvee lez Rleses s Amour fais que ce Prince appuiſè l’Inhumaine, Qu'elle rompe le charme affreux, Qui m’enleve Polite & le rend malheureux.	Ç liffe (Oretit evvee lez Rles s Our fais que ce Prince appuisè l'Inhumaine, Qu'elle rompe le charme affreux, Qui m'enlève Polite et le rend malheureux.
SCENE SECONDE.	SCÈNE SECONDE.
ULISSE, CIRCE’.	ULISSE, CIRCE'.
CIRCE’.	CIRCE'.
Uoy vous n’avez, rien à me dire?	Où vous n'avez, rien à me dire?
Vous révez, voſtre cœur ſoupire, Vous n’aveZ plus l’empreſſement D’un veritable Amant;	Vous révez, votre cœur soupire, Vous n'avez plus l'empressement D'un véritable Amant;
Quoy vous n’avez rien à me dire?	Quoi vous n'avez rien à me dire?
Quand je vous quitte un ſeul moment, Je ſouffre un cruel tourment Lors que je vous revoy, mon plaiſir eſt extreme:	Quand je vous quitte un seul moment, Je souffre un cruel tourment Lors que je vous revoi, mon plaisir est extrême:
Pourquoy ſi vous m’aimez, n’eſtes vous pas demême?	Pourquoi si vous m'aimez, n'êtes -vous pas demême?
ULISSE.	ULISSE.
La Conqueſte de voſtre cœur Fait mon plaiſir & ma gloire, Mais, hélâs!	La Conquête de votre cœur Fait mon plaisir et ma gloire, Mais, hélâs!
le pourroit-on croire?	le pourrait-on croire?
Un noir chagrin vient troubler la douceur D'un ſi parfait hon-heur.	Un noir chagrin vient troubler la douceur D'un si parfait hon-heur.
CIRCE’.	CIRCE'.
C’eſt trop allarmer ma tendreſſe, Parlez, tout ſuivra vos deſirs, Vous ſeul pouveZ cauſer ma joye & ma triſteſſe, Et de vous rendre heureux je fais tous mes plaiſirs:	C'est trop alarmer ma tendresse, Parlez, tout suivra vos désirs, Vous seul pouvez causer ma joie et ma tristesse, Et de vous rendre heureux je fais tous mes plaisirs:
JLTSSE.	JLTSE.
Si vous m’aimez charmante Reine, Deſarmez voſtre couroux, En faveur de ces nœuds que l’amour fit pour nous Rendez moy mes Amis, vous finirez, ma peine.	Si vous m'aimez charmante Reine, Désarmés votre courroux, En faveur de ces nœuds que l'amour fit pour nous Rendez moi mes Amis, vous finirez, ma peine.
IRCE’.	JRCE.
O Dieux!	Ô Dieux!
que me demandez-vous ?	que me demandez-vous ?
Eſt-ce là d’un Amant ce que l’on doit attendre ?	Est-ce là d'un Amant ce que l'on doit attendre ?
Faut-il que des Amis l’occupent chaque jour?	Faut-il que des Amis l'occupent chaque jour?
Tout ce qu’on donne aux ſoins d’une amitié trop tendré,	Tout ce qu'on donne aux soins d'une amitié trop tendré,
On le dérobe à l’Amour.	On le dérobe à l'Amour.
Circe pour toy toute de flame Devroit ſeule occuper ton ame.	Circe pour toi toute de flamme Devrait seule occuper ton âme.
ULISSE.	ULISSE.
Pour vous mon cœur brûle de mille feux Et vous brillez de mille charmes, Pour quoy ces Guerriers fameux Vous cauſent-ils tant d’allarmes?	Pour vous mon cœur brûle de mille feux Et vous brillez de mille charmes, Pour quoi ces Guerriers fameux Vous causent-ils tant d'alarmes?
Mon Amour & voſtre beauté Vous ſont garens de ma fidelité.	Mon Amour et votre beauté Vous sont garents de ma fidélité.
IRCE’.	JRCE.
pois te bomte;	pois te bomte;
n paur bous ſatisfaire, Pour ces Guerriers je me laiſſe attendrir;	n' aur bous satisfaire, Pour ces Guerriers je me laisse attendrir;
Vous déſarmeZ ma colere, Et je ſçay mieux aimer, que je ne ſçay haïr.	Vous désarmeZ ma colère, Et je sais mieux aimer, que je ne sais haïr.
Vous triompheZ de ma vangeance Ce triomphe pour vous doit avoir mille attraits.	Vous triompheZ de ma vengeance Ce triomphe pour vous doit avoir mille attraits.
JLISSE.	JLISSE.
Belle Reine, croyeZ que ma reconnoiſſance Fera durer à jamais Mon Amour & ma conſtance,	Belle Reine, crois que ma reconnaissance Fera durer à jamais Mon Amour et ma constance,
CIRCE' & ULISSE.	CIRCE' et ULISSE.
Deſir de ſe vanger, inutile fureur, Cedez, cedeZ à l’amoureuſe ardeur.	Désir de se venger, inutile fureur, Cédez, cédés à l'amoureuse ardeur.
Vos tranſports cauſent trop de peine, Un tendre Amour doit occuper un cœur Sans y laiſſer de place pour la haine.	Vos transports causent trop de peine, Un tendre Amour doit occuper un cœur Sans y laisser de place pour la haine.
Deſir de ſe vanger, inutile fureur, Cedez, cedeZ à l’amoureuſe ardeur.	Désir de se venger, inutile fureur, Cédez, cédés à l'amoureuse ardeur.
CIRCE' Vos Guerriers vont bien-teſt paroiſtre, Preparez-vous au plaiſir de les voir, Je vais rompre mon charme, & vous allez connoître Mon Amour & mon pouvoir.	CIRCE' Os Guerriers vont bientest paraître, Préparez-vous au plaisir de les voir, Je vais rompre mon charme, et vous allez connaître Mon Amour et mon pouvoir.
SCENE TROISIEME.	SCÈNE -TROISIÈME.
ULISSE ſeul.	ULISSE seul.
Audra t’il toüjours me contraind e?	Audra -t-il tendre me contraind ?
TAh!	TAh!
que mon ſort à de rigueur!	que mon sort à de rigueur!
Je ne ſens pour Circé qu’une extreme froideur, Et je me vois reduit à feindre Pour cette Reine une amoureuſe ardeur:	Je ne sens pour Circé qu'une extrême froideur, Et je me vois réduit à feindre Pour cette Reine une amoureuse ardeur:
Retenu dans ſa Cour, ſon Art me l’a fait craindre;	Retenu dans sa Cour, son Art me l'a fait craindre;
Ah!	Ah!
que mon ſort a de rigueur!	que mon sort a de rigueur!
Faudra t’il toujours me contraindig?	Faudra -t-il toujours me contraindig?
Quel horrible tourment!	Quel horrible tourment!
Quel affreux enchantement!	Quel affreux enchantement!
Je ſuis loin d’Eolie, & ce n’eſt pas la gloire Qui cauſe mon éloignement;	Je suis loin d'Éolie, et ce n'est pas la gloire Qui cause mon éloignement;
Juste Ciel!	Juste Ciel!
le pourroit-on croire?	le pourrait-on croire?
Amour, tu peux changer mon destin rigoureux Et me faire un plaiſir de ce qui fait ma peine, La flâme de Circé m’importune, me gêne, Cuis paſſer jes deſtrs, fes tranpperts amoureusx Dans le cœur de ce que j'aime;	Amour, tu peux changer mon destin rigoureux Et me faire un plaisir de ce qui fait ma peine, La flamme de Circé m'importune, me gêne, Cuis passer jes détrs, fes tranperts amoureus Dans le cœur de ce que j'aime;
Il ne ſçauroit brûler de trop de feux Sυ εην ουηω υυpvο τepοιυυe tο tιtυιο bortteuy extréme.	Il ne saurait brûler de trop de feux S ουηω υυpvο τepοιυυe tιtυιο bortteuy m.
SEDMSOMTRIEME.	SEDMSOMTRIEME.
ULISSE, ELPHENOR.	ULISSE, ÉLPHENOR.
SEOIE Cavez-vous, Elphenor, quel eſt noſtre bon-heur?	SEOIE Cavez-vous, Elphénor, quel est notre bonheur?
Circé nous rend nos Grecs.	Circé nous rend nos Grecs.
ELPHENOR.	ÉLPHENOR.
OCier:	OCier:
esteil poſible?	esteil posible?
Elle paroiſſoit inflexible.	Elle paraissait inflexible.
ULISSE.	ULISSE.
C’est à l’Amour qu’on doit cette faveur.	C'est à l'Amour qu'on doit cette faveur.
Mais Mais quel chagrin vient te ſurprendre!	Mais Mais quel chagrin vient te surprendre!
Dis-moy qui peut te rendre Interdit & réveur?	Dis-moi qui peut te rendre Interdit et réveur?
ELPHENOR.	ÉLPHENOR.
Il faut vous l’avoüer, je ne puis m’en deffendre, De la fiere Aſterie en vain je ſuis charmé, En vain par mille ſoins j’eſperois de luy plaire, Un autre en eſt aimé, Tout me le dit, ſes mépris, ſa colere.	Il faut vous l'avouer, je ne puis m'en défendre, De la fête Asterie en vain je suis charmé, En vain par mille soins j'espérais de lui plaire, Un autre en est aimé, Tout me le dit, ses mépris, sa colère.
Je ne ſçay pas encor quel est l’heureux Vainqueur Qui m'a ferme le chemin de ſon cœur;	Je ne sais pas encor quel est l'heureux Vainqueur Qui m'a ferme le chemin de son cœur;
Deſeſperé, confus, dans ma douleur extréme Tous les Grecs me ſont des Rivaux, Pour les faire perir, j’inventerois moy-même Des ſuplices nouveaux.	Désespérais, confus, dans ma douleur extrême Tous les Grecs me sont des Rivaux, Pour les faire périr, j'inventerais moi-même Des suplices nouveaux.
ULISSE.	ULISSE.
Quand il en peut coûter la gloire & l’innocence On doït n’aimer pas tant, ou bien ceſſer d’aimer, C’eſt ſe laiſſer enflammer Avec trop de violence, Quand il en peut coüter la gloire & l’innocence.	Quand il en peut coûter la gloire et l'innocence On doït n'aimer pas tant, ou bien cesser d'aimer, C'est se laisser enflammer Avec trop de violence, Quand il en peut coûter la gloire et l'innocence.
Mais la Reine & les Grecs s’avancent dans ces lieux, Contraignez-vous.	Mais la Reine et les Grecs s'avancent dans ces lieux, Contraignez-vous.
.	.
.	.
ELPHENOR.	ÉLPHENOR.
Je vois l’inhumaine Aſterie, La joye éclatte dans ſes yeux, Qu'elle rage pour moy, grands Dieux!	Je vois l'inhumaine Asterie, La joie éclatte dans ses yeux, Qu'elle rage pour moi, grands Dieux!
Il faut en m’éloignant, cacher ma jalouſie.	Il faut en m'éloignant, cacher ma jalousie.
SCENE CINQUIE'ME, CIRCE', ULISSE, ASTERIE, POLITE, TROUPPE de Grecs.	SCÈNE CINQUIE-ME, CIRCE', ULISSE, ASTÉRIE, POLITE, TROUPE de Grecs.
CIR CE'aux Grecs.	CIR CE'aux Grecs.
y Endez hommage à l’Amour, Et rendez grace au genereux Uliſſe, Par les vœux éclatans d’un pompeux Sacrifice Qu'on faſſe retentir cet aimable ſéjour;	y Endez hommage à l'Amour, Et rendez grâce au généreux Ulisse, Par les vœux éclatants d'un pompeux Sacrifice Qu'on fasse retentir cet aimable séjour;
Rendez hommage à l’Amour Et rendez gracé au genereux Uliſſe.	Rendez hommage à l'Amour Et rendez grâces au généreux Ulisse.
CHOEUR de Grecs.	CHOEUR de Grecs.
Rendons hommage à l Amour, Et rendons grace au genereux Uliſſe.	Rendons hommage à l Our, Et rendons grâce au généreux Ulisse.
SCENE SIXIEME.	SCÈNE SIXIÈME.
Le grand Prêtre du Temple de l’Amour.	Le grand Prêtre du Temple de l'Amour.
Trouppe de taymphes qui celefvent le Temple de l’Amour.	Troupe de taimphes qui celefvent le Temple de l'Amour.
CIRCE', ULISSE, ASTERIE, POLITE, Trouppe de Guerriers Grecs.	CIRCE', ULISSE, ASTÉRIE, POLITE, Troupe de Guerriers Grecs.
LE GRAND PRESTRE aux Grecs.	LE GRAND PRÊTRE aux Grecs.
PprocheZ-vous, heureux Mortels, TVous n’avez pas beſoin de ſanglantes Victimes Pour effacer vos crimes, Par vos tendres ſoupirs encenfeZ nos Autels, Vôtre cœur est la ſeule offrande Que l’Amour vous demande.	Pprochez-vous, heureux Mortels, TUous n'avez pas besoin de sanglantes Victimes Pour effacer vos crimes, Par vos tendres soupirs encens nos Autels, Votre cœur est la seule offrande Que l'Amour vous demande.
E ij	E ij
LE CHOEUR.	LE CHOEUR.
L’Amour a triomphé des Heros & des Dieux, Il étend ſon Empire Juſque dans les Cieux:	L'Amour a triomphé des Héros et des Dieux, Il étend son Empire Jusque dans les Cieux:
L’Amour a triomphé des Heros & des Dieux, Il étend ſon Empire Sur tout ce qui reſpire.	L'Amour a triomphé des Héros et des Dieux, Il étend son Empire Sur tout ce qui respire.
DEUX GUERRIERS.	DEUX GUERRIERS.
AAnbour, Dtew ues ria & des jeux, Dieu de l’aimable Jeuneſſe Et de la douce tendreſſe;	AAnbour, Dette œues ria et des jeux, Dieu de l'aimable Jeunesse Et de la douce tendresse;
Amour Dieu des ris & des jeux, SoyeZ favorable à nos vœux.	Amour Dieu des ris et des jeux, SoyeZ favorable à nos vœux.
LE CHOEUR.	LE CHOEUR.
Amour, Dieu des Ris & des Jeux, SoyeZ favorable à nos vœux.	Amour, Dieu des Ris et des Jeux, SoyeZ favorable à nos vœux.
SCENE SEPTIE’ME.	SCÈNE SEPTIE'ME.
L’AMOUR ſur un Nuage.	L'AMOUR sur un Nuage.
Acteurs de la Scene precedente.	Acteurs de la Scène précédente.
J L’AMOUR aux Grecs.	 J'AMOUR aux Grecs.
E reçois vôtre hommage, il eſt tendre & ſincere Je rendray votre ſort charmant, Ne perdeZ pas un moment, SoupireZ, ne ſongez qu’à plaire, C’eſt une aſſors grmuc uſfonre.	E reçois votre hommage, il est tendre et sincère Je rendrai votre sort charmant, Ne perdez pas un moment, Soupirez, ne songez qu'à plaire, C'est une assors grimuc usfonre.
Pour toy, Circé, j'aime à voir ton ardeur, J'augmenteray la tendreſſe d’Uliſſe;	Pour toi, Circé, j'aime à voir ton ardeur, J'augmenterai la tendresse d'Ulisse;
Avant la fin du jour, tu connoîtras ſon cœur Et tu verras ſi je te ſuis propice.	Avant la fin du jour, tu connaîtras son cœur Et tu verras si je te suis propice.
L’Amour diſparoiſt.	L'Amour disparaît.
CHOEUR de Grecs.	CHOEUR de Grecs.
Amour, puiſſiez-vous à jamais Nous faire un ſort plein d’attraits, Uliſſe a finy nos peines, De ce Heros comblez tous les deſirs;	Amour, puissiez-vous à jamais Nous faire un sort plein d'attraits, Ulisse a fini nos peines, De ce Héros comblés tous les désirs;
Faites durer ſes plaiſirs aaiimit que aureront ſes chaî̈nes;	Faites durer ses plaisirs aimit que aureront ses chaînes;
Amour, puiſſiez-vous à jamais Nous faire un ſort pleïn' d’attraits.	Amour, puissiez-vous à jamais Nous faire un sort plein' attraits.
SCENE HUITIE’ME.	SCÈNE HUITIE'ME.
ASTERIE, POLITE	ASTÉRIE, POLITE
POLITE.	POLITE.
Nfin, nous n’avons plus de témoins que l'Amour.	Nfin, nous n'avons plus de témoins que l'Amour.
M’est-il permis d’abandonner mon ame Aux tranſports de ma flame?	M'est-il permis d'abandonner mon âme Aux transports de ma flamme?
Belle Nymphe, eſtes-vous ſenſible à mon retour?	Belle Nymphe, êtes-vous sensible à mon retour?
Je vous vois, ma joye eſt extrême, Rien-ne manque à mes deſirs;	Je vous vois, ma joie est extrême, Rien-ne manque à mes désirs;
Ah!	Ah!
ſi vous n’aimez pas ſi tendrement que j’aime, Que vous perdez de doux plaiſirs!	si vous n'aimez pas si tendrement que j'aime, Que vous perdez de doux plaisirs!
ASTERIE.	ASTÉRIE.
Vôtre retour a pour moy mille charmes, Que ne puis-je exprimer les mortelles allarmes Que m’a cauſé vôtre malheur!	Votre retour a pour moi mille charmes, Que ne puis-je exprimer les mortelles alarmes Que m'a causé votre malheur!
Ah!	Ah!
j’en fremis encor d’horreur!	j'en frémis encor d'horreur!
Mais, helas!	Mais, hélas!
c'eſt en vain que je veux entreprendre De vous exprimer mon tourment, On n'a ſenty que foiblement Les maux qu’on peut faire comprendre.	c'est en vain que je veux entreprendre De vous exprimer mon tourment, On n'a senti que faiblement Les maux qu'on peut faire comprendre.
ASTERIE & POLITE.	ASTÉRIE et POLITE.
AAmomt, que tes prutſtrs font Aune?	AMompt, que tes prutstrs font Ane?
Aprés un cruel martire, Se voir, s’aimer, & ſe le dire, Eſt un bonheur à faire des jaloux;	Après un cruel martyre, Se voir, s'aimer, et se le dire, Est un bonheur à faire des jaloux;
Amour, que tes plaiſirs ſont doux!	Amour, que tes plaisirs sont doux!
POLITE.	POLITE.
Fuyons un lieu, belle Aſterie, Cu regne la barbarie;	Fuyons un lieu, belle Astérie, Cu règne la barbarie;
La Grece à nos amours offre un azile heureuix:	La Grèce à nos amours offre un asile heureuix:
L’Hymen nous untra des plus aimables nœuds.	L'Hymen nous untra des plus aimables nœuds.
CE ASTERIE & POLITE.	CE ASTÉRIE et POLITE.
Quel bonheur ſi l’Hymen nous lie!	Quel bonheur si l'Hymen nous lie!
C’eſt ma plus chere envie;	C'est ma plus chère envie;
De l’Hymen les nœuds ſont charmans, Lorſqu'ils ſont faits par le Dieu des Amans.	De l'Hymen les nœuds sont charmants, Lorsqu'ils sont faits par le Dieu des Amants.
Fin du ſecond Acte.	Fin du second Acte.
ACTE	ACTE
LECIE ATY Le Theâtre change & repreſente une ſolitude.	LECIE ATY Le Théâtre change et représente une solitude.
SCENE PREMIERE.	SCÈNE PREMIÈRE.
EOLIE ſeule.	ÉOLIE seule.
Eſirs, tranſports, cruelle impatience, JAb!	Étirs, transports, cruelle impatience, JAb!
laiſſeZ-moy du moins reſpirer un moment;	laissez-moi du moins respirer un moment;
Souffrez qu’une douce eſperance Flate mon amoureux tourment:	Souffrez qu'une douce espérance Flate mon amoureux tourment:
Deſirs, tranſports, cruelle impatience, Ah!	Désirs, transports, cruelle impatience, Ah!
laiſſez-moy du moins reſpirer un moment.	laissez-moi du moins respirer un moment.
Mais rien ne peut flater l’ennuy qui me devore, Je pers le Heros que j’adore, La Renommée a fait ſçavoir En mille endroits ſon funeſte naufrage;	Mais rien ne peut flatter l'ennui qui me dévore, Je perd le Héros que j'adore, La Renommée a fait savoir En mille endroits son funeste naufrage;
Malheureuſe Eolie!	Malheureuse Éolie!
en faut-il davantagé, Pour chaſſer de ton cœur un inutile eſpoir?	en faut-il davantagé, Pour chasser de ton cœur un inutile espoir?
Ciel!	Ciel!
Uliſſe n’eſt plus;	Ulisse n'est plus;
mais, que j’ay de foibleſſe!	mais, que j'ai de faiblesse!
Lorſque je m’abandonne au tourment qui me preſſe!	Lorsque je m'abandonne au tourment qui me presse!
Je pers des momens precieux;	Je perds des moments précieux;
Pour m’éclaircir du ſort d’Uliſſe, Allons trouver Circé, Je ne puis faire mieux, Allons, je tremble, o Dieux!	Pour m'éclaircir du sort d'Ulisse, Allons trouver Circé, Je ne puis faire mieux, Allons, je tremble, ô Dieux!
Je ſens redoubler mon ſuplice.	Je sens redoubler mon suplice.
C’eſt aux Enfers que j’ay récours;	C'est aux Enfers que j'ai récours;
Non, non, je ne veux point de cet affreux ſecours.	Non, non, je ne veux point de cet affreux secours.
Aquilons, vôtre violence N’a que trop ſervy mon ardeur, Vous m’avez fait paſſer dans ces lieux pleins d’horreur, Où doit fremir la timide innocence;	Aquilons, votre violence N'a que trop servi mon ardeur, Vous m'avez fait passer dans ces lieux pleins d'horreur, Où doit frémir la timide innocence;
Venez, venez malgre l’Amour, Eloignez,-moy de cet affreux ſéjour.	Venez, venez malgré l'Amour, Éloignez,-moi de cet affreux séjour.
Les Aquilons paroiſſent environnez de nuages;	Les Aquilons paraissent environnés de nuages;
SCENE SECONDE.	SCÈNE SECONDE.
MINERVE, EOLIE.	MINERVE, EOLIE.
MINERVE ſur ſon Char.	MINERVE sur son Char.
L n’est pas temps de paroîtré, Aquilons demeurez, dans un proſond repos;	 L'est pas temps de paroîtré, Aquilons demeurez, dans un prosond repos;
Nymphe, ne craignez rien, je vous feray connoître Que Minerve eſt toûjours favorable aux Heros.	Nymphe, ne craignez rien, je vous ferai connaître Que Minerve est toujours favorable aux Héros.
Uliſſe est échapé d’une affreuſe tempête, Mais l’amour de Circé le rétient dans ces lieux;	Ulisse est échappé d'une affreuse tempête, Mais l'amour de Circé le rétient dans ces lieux;
Cette funeſte conquête Borne de ce Heros les exploits glorieux.	Cette funeste conquête Borne de ce Héros les exploits glorieux.
Le ſommeil l’a ſurpris dans ce lieu ſolitaire, Je vais l’épouvanter par des ſonges affreux Pour luy faire quitter un lieu ſi dangereux;	Le sommeil l'a surpris dans ce lieu solitaire, Je vais l'épouvanter par des songes affreux Pour lui faire quitter un lieu si dangereux;
Sa gloire vous eſt chere, Montrez-vous à ſes yeux, je feray dans ce jour Triompher votre amour.	Sa gloire vous est chère, Montrez-vous à ses yeux, je ferai dans ce jour Triompher votre amour.
Le fond du Theâtre s’ouvre & laiſſe voir Uliſſe endormy dans un lieu remply de rochers & d’arbres, qui conſervent encore qterqde figuse d’hommes;	Le fond du Théâtre s'ouvre et laisse voir Ulisse endormi dans un lieu rempli de rochers et d'arbres, qui conservent encore qterque figuse d'hommes;
ce ſont autant de malheureux Amans que Circé a métamorphoſez quand	ce sont autant de malheureux Amants que Circé a métamorphosez quand
elle a ceſſé de les aimer.	elle a cessé de les aimer.
SCENE TROISIE’ME.	SCÈNE -TROISIE'ME.
ULISSE endormy, PHOEBETOR, PITMIV TISE, TrOupe de ſonges agreables, Troupe de ſonges funeſtes;	ULISSE endormi, PHOEBETOR, PITMIV TISE, TrOupe de songes agréables, Troupe de songes funestes;
EOLIE dans un endroit où elle ne peut être vûë.	ÉLIE dans un endroit où elle ne peut être vue.
Un ſonge agreable.	Un songe agréable.
H!	H!
que le ſommeil eſt charmant LE Poiiquit eſe tranquite;	que le sommeil est charmant LE Poiquit eze tranquite;
Mais il eſt difficile De dormir tranquilement Quand on eſt Amant.	Mais il est difficile De dormir tranquillement Quand on est Amant.
PHANTASE.	PHANTASE.
Le jommmett avet tons fes charmes Ne peut calmer les ſecrettes allarmes Que font naître les amours;	Le jommémet auet tons fes charmes Ne peut calmer les secrètes alarmes Que font naître les amours;
Dans le cœur d’un Amant l'Amour veille toûjours, Au milieu du repos meme On eſt agité quand on aime.	Dans le cœur d'un Amant l'Amour veille toujours, Au milieu du repos me On est agité quand on aime.
PHOEBETOR, PHANTASE, un ſonge agreable.	PHOEBETOR, PHANTASE, un songe agréable.
Le ſommeil a mille douceurs, Il endort quelquefois une douleur profonde;	Le sommeil a mille douceurs, Il endort quelquefois une douleur profonde;
Mais l’Amour cauſe des langueurs Al Mes Mromrs 3 Il faudroit le bannir pour le rẽpos du Monde.	Mais l'Amour cause des langueurs Al Mes Mroms 3 Il faudrait le bannir pour le rẽpos du Monde.
PHOEBETOR.	PHOEBETOR.
Vliſſe, il faut quitter ces funeſtes Climats, L’Amour montre à tes yeux tout ce qu’il a d’appas, Mais il te cache une peine cruelle;	Vlisse, il faut quitter ces funestes Climats, L'Amour montre à tes yeux tout ce qu'il a d'appas, Mais il te cache une peine cruelle;
Puy puui fainuis jes ommemvodangereux, Crains le pouvoir d’une Reine infidéle, Crains le deſtin affreux De ces malheureux.	Puis pu fainuis jes ommemodangereux, Crains le pouvoir d'une Reine infidèle, Crains le destin affreux De ces malheureux.
CHOEUR de Songes affreux.	CHOEUR de Songes affreux.
Une epouvantable Mort, Finira ton triſte ſort Si tu ne pars en diligence;	Une épouvantable Mort, Finira ton triste sort Si tu ne pars en diligence;
Crains tout d’un funeſte amour, La Mer n’a pas tant d’inconſtance, Que la fille du Dieu du jour.	Crains tout d'un funeste amour, La Mer n'a pas tant d'inconstance, Que la fille du Dieu du jour.
Ori On e reue bongs affreux.	Ori On rue bongs affreux.
Tous les momens ſont perilleux Dans ces lieux, Fuy ſans tarder davantage;	Tous les moments sont périlleux Dans ces lieux, Fui sans tarder davantage;
La Mer n’a point d’Ecueils plus dangereux Que ce rivage, Où ta Gloire a déja fait naufrage.	La Mer n'a point d'Écueils plus dangereux Que ce rivage, Où ta Gloire a déjà fait naufrage.
Les Songes diſparoiſſent, Uliſſe s’éveille.	Les Songes disparaissent, Ulisse s'éveille.
SCENE QUATRIE'ME.	SCÈNE QUATRIE'ME.
OETSDE, EOETE dalis tn endroit où elle ne peut eſtre veuë.	ÔETSDE, EOTE dalis tn endroit où elle ne peut être vue.
ULISSE.	ULISSE.
Ciell ô juſte Ciel!	Ciell ô juste Ciel!
j’implore ton ſecours.	j'implore ton secours.
LEnfer s’arme contre mes jours;	LEnfer s'arme contre mes jours;
Mais, non, ce n’eſt qu’une chimere vaine Quoy par un Songe, Uliſſe est-il épouvanté!	Mais, non, ce n'est qu'une chimère vaine Quoi par un Songe, Ulisse est-il épouvanté!
Eolie paroiſt.	Éolie paraît.
Que voie-je?	Que voie-je?
n’eſt-ce point quelque Divinité Qui vient ponr adoucir ma peine?	n'est-ce point quelque Divinité Qui vient ponr adoucir ma peine?
Eſt-ce vous, Eolie, en croiray-je mes yeux?	Est-ce vous, Éolie, en croirai-je mes yeux?
Eſt-ce vous, Nymphe trop charmante?	Est-ce vous, Nymphe trop charmante?
EOLIE.	ÉOLIE.
Ingrat, vous rougiſſeZ, c’eſt contre voſtre attente Que je vous trouve dans ces lieux, Vous ne pouvez me voir ſans un trouble agreable Lorſque vous m’aimieZtendrement :	Ingrat, vous rougissez, c'est contre votre attente Que je vous trouve dans ces lieux, Vous ne pouvez me voir sans un trouble agréable Lorsque vous m'aimieZtendrement :
Pour mon cœur amoureux, quel horrible tourment De voir dans vos regards, l’embarras d’un Coupable Qui veut cacher ſon changement!	Pour mon cœur amoureux, quel horrible tourment De voir dans vos regards, l'embarras d'un Coupable Qui veut cacher son changement!
Quand le bruit de voſtre naufrage Me fait pour vous chercher, oublier mon devoir;	Quand le bruit de votre naufrage Me fait pour vous chercher, oublier mon devoir;
Lorſqu’il me fait ſentir un affreux deſespoir Vous eſtes dans ces lieux à l’abry de l’orage Occupé d’un laſche Amour:	Lorsqu'il me fait sentir un affreux désespoir Vous êtes dans ces lieux à l'abri de l'orage Occupé d'un lâche Amour:
Qui l’eût jamais pensé!	Qui l'eût jamais pensé!
Dieux qui l’auroit pû croire!	Dieux qui l'aurait pu croire!
Qu'en aimant un Heros, je pleurerois un jour, La perte de ſon cœur, & celle de ſa Gloire.	Qu'en aimant un Héros, je pleurerais un jour, La perte de son cœur, et celle de sa Gloire.
ULISSE.	ULISSE.
Tout vous parlera contre moy, Si vous en croyeZ l’apparence;	Tout vous parlera contre moi, Si vous en croisez l'apparence;
Mais belle Nymphe, écouteZ ma défenſe.	Mais belle Nymphe, écoutez ma défense.
EOLIE.	ÉOLIE.
Non, non, n’ajoûte pas la feinte à l’inconſtance, Ton crime eſt aßsez, grand de me manquer de foy, Connois-tu bien l’Objet que ton cœur me prefere?	Non, non, n'ajoute pas la feinte à l'inconstance, Ton crime est assez, grand de me manquer de foi, Connais-tu bien l'Objet que ton cœur me préfère?
T peux-tu ſonger ſans effroy?	 peux-tu songer sans effroi?
Une Reine barbare tnconſtante e legere, Une parjure enfin plus perfide que toy.	Une Reine barbare tnconstante é légère, Une parjure enfin plus perfide que toi.
Son Epoux en a fait une épreuve cruelle, Elle immola ce Prince malheureux A de coupables feux;	Son Époux en a fait une épreuve cruelle, Elle immola ce Prince malheureux A de coupables feux;
Tu periras auſſi pour elle, On n’eſt point innocent quand ſon volage cœur Brûle d’une nouvelle ardeur.	Tu périras aussi pour elle, On n'est point innocent quand son volage cœur Brûle d'une nouvelle ardeur.
ULISSE.	ULISSE.
C’eſt trop me ſoupçonner d’une indigne foibleſſe, Les attraits de Circé, ne m’ont point enchanté;	C'est trop me soupçonner d'une indigne faiblesse, Les attraits de Circé, ne m'ont point enchanté;
Si la Vertu ne ſoûtient la Beauté, On ne ſçauroit m’inspirer de tendreſſe.	Si la Vertu ne soutient la Beauté, On ne saurait m'inspirer de tendresse.
Mon cœur a fait un beau choix;	Mon cœur a fait un beau choix;
fadoré l Aimable Bolie, On me verra perdre la vie, Plûtôt que de paſſer ſous de nouvelles Loix.	fadoré l Aimable Bolie, On me verra perdre la vie, Plutôt que de passer sous de nouvelles Lois.
EOLIE.	ÉOLIE.
Tout mon bon-heur dépend de vous trouver fidelle, Que ne puis-je vous croire, helas!	Tout mon bonheur dépend de vous trouver fidèle, Que ne puis-je vous croire, hélas!
Mais Circé vous aime, elle eſt belle, Vous voyez chaque jour ſes dangereux appas, Non, non, ſi vous ne l’aimiez pas, Non, vous n’auriez ſongé qu’à vous éloigner d’elle.	Mais Circé vous aime, elle est belle, Vous voyez chaque jour ses dangereux appas, Non, non, si vous ne l'aimiez pas, Non, vous n'auriez songé qu'à vous éloigner d'elle.
ULISSE Si mon cœur eſt inconstant, Puiſſe le Ciel dans cet inſtant Faire tomber ſur moy la Foudre;	ULISSE Si mon cœur est inconstant, Puisse le Ciel dans cet instant Faire tomber sur moi la Foudre;
Puiſſe-t’il me reduire en poudre, S mon cœur est inconſtant.	Puisse-t-il me réduire en poudre, S mon ç est inconstant.
EOLIE.	ÉOLIE.
EOLIE.	ÉOLIE.
Que vos Sermens ont de puiſſance!	Que vos Serments ont de puissance!
Ils calment la violence De mes tranſports jaloux, Mon cœur eſt déja plein de l’eſpoir le plus doux;	Ils calment la violence De mes transports jaloux, Mon cœur est déjà plein de l'espoir le plus doux;
Que vos Sermens ont de puiſſance!	Que vos Serments ont de puissance!
EOLIE &ULISSE.	ÉLIE ETULISSE.
Quand on aime tendrement, Le dépit & la colere Ne durent guere;	Quand on aime tendrement, Le dépit et la colère Ne durent guère;
Quand on aime tendrement, Le dépit & la colere Ont un retour charmant;	Quand on aime tendrement, Le dépit et la colère Ont un retour charmant;
Un Amour extreme S’irrite aiſement, Mais il s’apaiſe de même.	Un Amour extrême S'irrite aisément, Mais il s'apaise de même.
ULISSE.	ULISSE.
Elphenor m’eſt ſuſpect, il s’avance en ces lieux, Dérobons nous à ſes yeux.	Élphénor m'est suspect, il s'avance en ces lieux, Dérobons nous à ses yeux.
SCENE CINQUIE’ME.	SCÈNE CINQUIE'ME.
I ELPHENOR ſeul.	I ILPHENOR seul.
E luy ſuis ſuſpect, l’Infidelle, Je ne l’ay que trop-entendu, Tout m’apprend ſa flamme nouvelle, Si je parle, il eſt perdu.	E tu suis suspect, l'Infidèle, Je ne l'ai que trop-entendu, Tout m'apprend sa flamme nouvelle, Si je parle, il est perdu.
Pourquoy le ménager, j’ay beſoin de la Reine?	Pourquoi le ménager, j'ai besoin de la Reine?
Découvrons-luy ſes volages amours;	Découvrons-lui ses volages amours;
Quand le cruel a ſçu ma peine, Ml’a-t-il offert quelque ſecours?	Quand le cruel a su ma peine, Ml'a-t-il offert quelque secours?
A mes brûlans deſirs Aſterie eſt contraire, L’ingrate me deſeshere;	À mes brûlants désirs Astérie est contraire, L'ingrate me déseshère;
A tous momens ſon injufie froideur, En augmentant ma rage augmente mon ardeur;	À tous moments son injufie froideur, En augmentant ma rage augmente mon ardeur;
De cette Nymphe cruelle Circé peut regler le ſort, Il faut par mes dete tuy ſotro coimon zele, Taſchons de l’obtenir d’elle, Faiſons un dernier effort.	De cette Nymphe cruelle Circé peut régler le sort, Il faut par mes déte tui sotro coimon zèle, Tâchons de l'obtenir d'elle, Faisons un dernier effort.
le voulois ne devoir qu'à ma ſeule tendreſſe Un bonheur ſi charmant, C’eſt pour un malheureux trop de délicateſſe, Pourvu que je l’obtienne il n’importe comment.	le voulais ne devoir qu'à ma seule tendresse Un bonheur si charmant, C'est pour un malheureux trop de délicatesse, Pourvu que je l'obtienne il n'importe comment.
SODIIDHHEME.	SODIIDHÉME.
CIRCE', ELPHENOR.	CIRCE', ELPHÉNOR.
CIRCE'.	CIRCE'.
N quel endroit Uliſſe a-t-il tourné ſes pas?	N quel endroit Ulisse a-t-il tourné ses pas?
Je vous croyois tous deux dans cette ſolitude;	Je vous croyais tous deux dans cette solitude;
Tout languit avec moy quand je ne le vois pas Rien ne peut égaler ma triſte inquietude.	Tout languit avec moi quand je ne le vois pas Rien ne peut égaler ma triste inquiétude.
Que fait-il, ce charmant Heros?	Que fait-il, ce charmant Héros?
Peut-être dans le temps qu’il trouble mon repos, Il occupe ſon ame De ſes vaſtes projets oppoſez à ma flâme.	Peut-être dans le temps qu'il trouble mon repos, Il occupe son âme De ses vastes projets opposez à ma flamme.
ELPHENOR.	ÉLPHENOR.
Quand on a tant d’amour avec tant de beauté, Charmante Reine on peut croire Que ce n’eſt que pour la gloire Qu’un Heros pourroit faire une infidélité;	Quand on a tant d'amour avec tant de beauté, Charmante Reine on peut croire Que ce n'est que pour la gloire Qu'un Héros pourrait faire une infidélité;
Mais, helas!	Mais, hélas!
c’eſt en vain que l’on est tendre & belle, Pour arrêter un cœur fait pour être infidéle.	c'est en vain que l'on est tendre et belle, Pour arrêter un cœur fait pour être infidèle.
CIRCE', Dieux!	CIRCE', Dieux!
que me dites-vous?	que me dites-vous?
Que je ſens de tranſports jaloux!	Que je sens de transports jaloux!
Quelques nouveaux attraits charmeroient-ils Uliſſe?	Quelques nouveaux attraits charmeraient-ils Ulisse?
Parlez, ne craignez, point d’augmenter mon ſupplice.	Parlez, ne craignez, point d'augmenter mon supplice.
ELPHENOR.	ÉLPHENOR.
Dans ce paiſible ſéjour J'ay ſurpris ce Prince volage, Qui parloit d’amour A la Nymphe qui l’engage;	Dans ce paisible séjour J'ai surpris ce Prince volage, Qui parlait d'amour À la Nymphe qui l'engage;
ſ’ay voulu pour la voir détourner ce feüillage, Mais ils m’ont apperceu, dans le même moment Je les ay vû diſparoître Sans avoir pù la connoître,	s'ai voulu pour la voir détourner ce feuillage, Mais ils m'ont aperçu, dans le même moment Je les ai vu disparaître Sans avoir pu la connaître,
CIRCE’.	CIRCE'.
Quel horrible tourment!	Quel horrible tourment!
SCENE SEPTIE’ME.	SCÈNE SEPTIE'ME.
ASTERIE, CIRCE’, ELPHENOR.	ASTÉRIE, CIRCE', ÉLPHENOR.
IRCE’.	JRCE.
Pprochez-vous, chere Aſterie, TA Apprenez que je ſuis trabie.	Prochez-vous, chère Astérie, TA Apprenez que je suis trabie.
Uliſſe eſt inconſtant, Ma peine est ſans égale;	Ulisse est inconstant, Ma peine est sans égale;
Si je pouvois du moins connoître ma Rivale Mon cœur jaloux ne ſouffriroit pas tant, D’une cruelle vangeance Je pourrois goüter la douceur:	Si je pouvais du moins connaître ma Rivale Mon cœur jaloux ne souffrirait pas tant, D'une cruelle vengeance Je pourrais goûter la douceur:
Elphenor, ſecondez ma juſte impatience Obſervez, cêt Amant trompeur, DécouvreZ, s’il ſe peut, qui m’enleve ſon cœur.	Elphénor, secondez ma juste impatience Observez, cet Amant trompeur, Découvrez, s'il se peut, qui m'enlève son cœur.
Des ſoins que vous prendrez, voyeZ la recompenſe, Il faut que cette Nymphe en vous donnant ſa M’acquitte enfin de ce que je vous doyz Source de France Je vais de ma douleur cacher la violence, Faites tous deux vôtre devoir Peur detouorir ce que je veux ſçavoir.	Des soins que vous prendrez, voyez la récompense, Il faut que cette Nymphe en vous donnant sa M'acquitte enfin de ce que je vous dois Source de France Je vais de ma douleur cacher la violence, Faites tous deux vôtre devoir Peur détouorir ce que je veux savoir.
SEENE IIOTTIE’ME.	SENE IIOTTTIE'ME.
ASTERIE, ELPHENOR.	ASTÉRIE, ÉLPHENOR.
2 ELPHENOR.	2 ELPHENOR.
E puis vous atre enſn que je vous aime, La Reine vous accorde à l’ardeur de mes feux;	E puis vous âtre ensn que je vous aime, La Reine vous accorde à l'ardeur de mes feux;
Mais je ſerois mille fois plus heureux, Si je tenois mon bon-heur de vous-même.	Mais je serais mille fois plus heureux, Si je tenais mon bonheur de vous-même.
ASTERIE.	ASTÉRIE.
Non, non, je ne ſçaurbis vous engager ma foy, La chaine de l’Hymen me paroist trop peſante, Si le nom d’Amant m’épouvante, Le nom d’Epoux me fait trembler d’effroy.	Non, non, je ne saurbis vous engager ma foi, La chaine de l'Hymen me paraît trop pesante, Si le nom d'Amant m'épouvante, Lé nom d'Époux me fait trembler d'effroi.
ELPHENOR.	ÉLPHENOR.
Ingrate, vous aimez, je connois vos allarmes, Vous avez de la peine a retenir vos larmes;	Ingrate, vous aimez, je connais vos alarmes, Vous avez de la peine a retenir vos larmes;
C’eſt pour vous conſerver pour un heureux Vainqueur Que vous avez tant de rigueur.	C'est pour vous conserver pour un heureux Vainqueur Que vous avez tant de rigueur.
Vous voyez ſans pitié, mon deſeſpoir extrême, Cruelle, j’en feray de même, Je n’écoute plus rien que mes tranſports jaleux;	Vous voyez sans pitié, mon désespoir extrême, Cruelle, j'en ferai de même, Je n'écoute plus rien que mes transports jaleux;
Vôtre reſiſtance eſt vaine, Il faut obeyr à la Reine Qui veut que je ſois vôtre Epoux.	Votre résistance est vaine, Il faut obéir à la Reine Qui veut que je sois votre Époux.
AS TERIE.	AS TRIE.
Quoy je ſerois le Prix d’un Trinte êpouvantable?	Quoi je serais le Prix d'un Trinte épouvantable?
Perfide, ne t’en flatte pas, Que là Reine impitoyable Par tes avis me livre au plus cruel trépas;	Perfide, ne t'en flatte pas, Que là Reine impitoyable Par tes avis me livre au plus cruel trépas;
Dis-luy mes ſentimens, va couronner ton Crime Par un Crime nouveau, De ta fureur que je ſois la Victime, Plûtõt que ton Hymen, je choiſis le Tombeaus	Dis-lui mes sentiments, va couronner ton Crime Par un Crime nouveau, De ta fureur que je sois la Victime, Plûtõt que ton Hymen, je choisis le Tombeaus
BCRNE NECVIEME.	BCRNE NECVIEME.
ELPHENOR ſeul.	ELPHENOR seul.
’En est trop, barbare inhumaine, Je vais te délivrer d’un Objet plein d’horreur, Pour contenter tes mépris et ta haine, Je m’abandonne a toute ma fureur.	J'En est trop, barbare inhumaine, Je vais te délivrer d'un Objet plein d'horreur, Pour contenter tes mépris et ta haine, Je m'abandonne a toute ma fureur.
Il ſe perce de ſon Poignard.	Il se perce de son Poignard.
Vien trop cruelle Aſterie, fe ſens que je Vais mourir Vien donner à tes yeux le funeſte plaiſir, De me voir perdre la vie.	Viens trop cruelle Astérie, se sens que je Vais mourir Viens donner à tes yeux le funeste plaisir, De me voir perdre la vie.
Il tombe mort.	Il tombe mort.
Fin du troiſiéme Acte.	Fin du troisième Acte.
ACTE	ACTE
LRCAE A Le Theâtre change, & repreſente	LRCAE A Le Théâtre change, et représente
un Bois.	un Bois.
oSooda ccecons cocotn	oSoda cècecons cocotn
SCENE PREMIERE.	SCÈNE PREMIÈRE.
CIRCE', ULISSE.	CIRCE', ULISSE.
S CU VYVGU CIRCE'.	SU CV YUGU CIRCE'.
Nfin il est donc vray qu'Elphenor ne vit plus;	Nfin il est donc vrai qu'Élphénor ne vit plus;
Mais les déguiſemens te ſeront ſuperflus, Ie ſçay ton ardeur nouvelle, Ce Prince t’a ſurpris dans ce funeſte jour Avec l’Objet de ton Amour, Tu viens de l’en punir par une mort cruelle, Perfide, je ſçauray te punir à mon tour.	Mais les déguisements te seront superflus, Je sais ton ardeur nouvelle, Ce Prince t'a surpris dans ce funeste jour Avec l'Objet de ton Amour, Tu viens de l'en punir par une mort cruelle, Perfide, je saurai te punir à mon tour.
ULISSE.	ULISSE.
Dieux!	Dieux!
quel injuſtice effroyable!	quel injustice effroyable!
Du trépas d’Elphenor vous me croyez, coupable, Et vous me ſoupçonneZ de vous manquer de foy?	Du trépas d'Élphénor vous me croyez, coupable, Et vous me soupçonnez de vous manquer de foi?
ouy nae lin binve& puo;	oui nae lin binveet pu;
umnumnaine, Ou le cruel Amour que vous avez pour moy A tous les effets de la haine.	umnumnaine, Ou le cruel Amour que vous avez pour moi À tous les effets de la haine.
CIRCE'.	CIRCE'.
En vain tu veux cacher ton infidelité, Inconſtant, je vois dans ton ame, Tu n’as plus de témoin de ta nouvelle flâme, Tu crois estre en ſeureté;	En vain tu veux cacher ton infidélité, Inconstant, je vois dans ton âme, Tu n'as plus de témoin de ta nouvelle flamme, Tu crois être en sûreté;
Mais de l’infernale Rive, Je ſçauray rapeller ſon ombre fugitive, Mal-heureux, tremble d’effroy, Je ſçauray l’a contrainure à découvrir ton crime, Et plus j’ay d’Amour pour toy, Plus tu dois redouter la fureur qui m’anime.	Mais de l'infernale Rive, Je saurai rappeler son ombre fugitive, Malheureux, tremble d'effroi, Je saurai l'a contrainure à découvrir ton crime, Et plus j'ai d'Amour pour toi, Plus tu dois redouter la fureur qui m'anime.
ULISSE.	ULISSE.
Je vois que ma preſence aigrit vostre couroux, Ie m'éloigne de vous.	Je vois que ma présence aigrit votre courroux, Je m'éloigne de vous.
Uliſſe ſort.	Ulisse sort.
SCENE DEUXIE’ME.	SCÈNE DEUXIE'ME.
CIRCE’ ſeule.	CIRCE seule.
Etire-toy, l’Enfer ſçaura m’inſtruire, Sombres Marais du Stix, Cocite, Phlegeton, Impitoyable Alecton, Dieu tenebreux du vaſte Empire Qui s’étendra toûjours ſur tout ce qui reſpire, ServeZ mes jaloux tranſports;	Etire-toi, l'Enfer sçaura m'instruire, Sombres Marais du Stix, Cocite, Phlégeton, Impitoyable Alecton, Dieu ténébreux du vaste Empire Qui s'étendra toujours sur tout ce qui respire, Servez mes jaloux transports;
Que d’Elphenor l’ombre ſanglante Pour un moment quitte vos triſtes Bors, Qu'elle répande icy l’horreur & l’épouvante.	Que d'Élphénor l'ombre sanglante Pour un moment quitte vos tristes Bors, Qu'elle répande ici l'horreur et l'épouvante.
Demons, que vous tardez à remplir mon eſpoir!	Demons, que vous tardez à remplir mon espoir!
Demons, Demons, redoutez, mon pouvoir, Ie vais ouvrir vos Cavernes affreuſes, J'y feray penetrer le Soleil qui nous luit, Ie chaſſeray le ſilence & la nuit De vos demeures tenebreuſes;	Demons, Demons, redoutez, mon pouvoir, Je vais ouvrir vos Cavernes affreuses, J'y ferai pénétrer le Soleil qui nous luit, Je chasserai le silence et la nuit De vos demeures ténébreuses;
Haſtez-vous, haſtez-vous, tarderez-vous encore D’envoyer l’Ombre d’Elphenor!	Hâtez-vous, hâtez-vous, tarderez-vous encore D'envoyer l'Ombre d'Élphenor!
Il s’éleve une groſſe Vapeur dans le fond du Theâtre, on en voit ſortir l’Ombre d’Elphenor.	Il s'élève une grosse Vapeur dans le fond du Théâtre, on en voit sortir l'Ombre d'Élphénor.
SSET TROISIE’ME.	SSET TROISIE'ME.
L’Ombre d’ELPHENOR, CIRCE'.	L'Ombre d'ELPHÉNOR, CIRCE.
CIRCE'.	CIRCE'.
T len me découvrir ma Rivale, Et m’éclaircir de ton funeſte ſort;	 len me découvrir ma Rivale, Et m'éclaircir de ton funeste sort;
fe jure d’exercer ſur l’auteur de ta mort, La vangeance la plus fatale.	se jure d'exercer sur l'auteur de ta mort, La vengeance la plus fatale.
Quatre Demons élevent un Tombeau dans le fonds du Theâtre.	Quatre Demons élèvent un Tombeau dans le fond de Théâtre.
Voy ce Tombeau, je veux que pour jamais Tes manes ſoient en paix.	Vois ce Tombeau, je veux que pour jamais Tes mânes soient en paix.
L'OMBRE.	L'OMBRE.
Uliſſe eſt infidéle, Je ne t’apprendray rien de plus, Les ſoins de me vanger te ſeroient ſuperflus, Laiſſe-moy retomber dans la nuit éternelle.	Oui est infidèle, Je ne t'apprendrai rien de plus, Les soins de me venger te seraient superflus, Laisse-moi retomber dans la nuit éternelle.
L’Ombre diſparoît.	L'Ombre disparaît.
SCENEE OATRIEME.	SCÈNE OATRIEME.
CIRCE' ſeule.	CIRCE seule.
Liſſe eſt infidéle, TVangeons nôtre amour irrité Par une affreuſe crisauté.	Lisse est infidèle, TVangeons notre amour irrité Par une affreuse crisauté.
Eumenides impitoyables, Ceſſez de tourmenter de malheureux coupables, Venez, venez-inventer des tourmens Pour le plus ingrat dés Amans.	Eumenides impitoyables, Cessez de tourmenter de malheureux coupables, Venez, venez-inventer des tourments Pour le plus ingrat dès Amants.
Que tout l’Enfer contraigne un traître qui m'outrage, A ſe livrer dans ce moment A mon juſte reßentiment.	Que tout l'Enfer contraigne un traître qui m'outrage, À se livrer dans ce moment A mon juste ressentiment.
SCENE CINQUIE’ME.	SCÈNE CINQUIE'ME.
CIRCE’, ULISSE pourſuivy par la Fureur & ſa ſuite, les trois EUMENIDES.	CIRCE', ULISSE poursuivi par la Fureur et sa suite, les trois EMENIDES.
T Les trois EUMENIDES.	T Les trois EMUENIDES.
Uniſſons un Amant volage, Brulons ſon perfide cœur De tous les feux de la ragè;	Unissons un Amant volage, Brulons son perfide cœur De tous les feux de la ragète;
Puniſſons un Amant volage, Enflâmons ſon perfide cœur D’une éternelle fureur.	Punissons un Amant volage, Enflammons son perfide cœur D'une éternelle fureur.
Uliſſe à Circé.	Ulisse à Circé.
Tu me rens la vie odieuſe, Mais les chemins des Enfers Soni toujours ouverts Pour une ame genereuſe.	Tu me rends la vie odieuse, Mais les chemins des Enfers Soni toujours ouverts Pour une âme généreuse.
Uliſſe furieux tire ſon épée pour ſe tuer.	Oui furieux tire son épée pour se tuer.
CIRCE’, aux Eumenides.	CIRCE', aux Eumenides.
DeſarmeZ ce furieux, Prenez ſoin de ſes jours, faites durer ſa peine Pour Chorenter ma baine.	Désarmés ce furieux, Prenez soin de ses jours, faites durer sa peine Pour Chorenter ma baine.
Allez, éloignez de mes yeux Cet Objet odieux.	Allez, éloignez de mes yeux Cet Objet odieux.
Les Euménides emmennent Uliſſe aprés l’avoir deſarmé.	Les Euménides emmennent Ulisse après l'avoir désarmé.
SCENE SIXIE’ME.	SCÈNE SIXIE'ME.
CIRCE' ſeule.	CIRCE seule.
AlmeZ vôtre violence, Tranſports impetueux n’agiteZ plus mon cœur, N'ay-je pas ſatisfait ma jalouſe fureur Par une affreuſe vangeance?	Almez votre violence, Transports impétueux n'agitez plus mon cœur, N'ai-je pas satisfait ma jalouse fureur Par une affreuse vengeance?
Tranſports impetueux n’agitez plus mon cœur, CalmeZ vôtre violence.	Transports impétueux n'agitez plus mon cœur, Calmez votre violence.
Que dis-je, malheureuſe?	Que dis-je, malheureuse?
Est-ce là me vanger?	Est-ce là me venger?
Quand le cruel Amour m’oblige à partager Toutes les peines d’un coupable Qui me paroît toûjours aimable, Maibturenje, est-te me vanger?	Quand le cruel Amour m'oblige à partager Toutes les peines d'un coupable Qui me paraît toujours aimable, Maibturenje, est-te me venger?
SUENE SET PYEME.	SUENE ST PYEME.
CIRCE’, EOLIE ſans ſe voir.	CIRCE', EOLIE sans se voir.
EOLIE.	ÉOLIE.
Ignore les détours de ce bois ſolitaire, Je tremble à chaque pas que l’Amour me fait faire Pour chercher mon Amant;	Ignore les détours de ce bois solitaire, Je tremble à chaque pas que l'Amour me fait faire Pour chercher mon Amant;
Bien que j’aime tendrement, Mon cœur eſt toûjours timide;	Bien que j'aime toujours, Mon cœur est toujours timide;
Hélas!	Hélas!
on s’egare aiſément Quand on n’a que l’Amour pour guide:	on s'égare aisément Quand on n'a que l'Amour pour guide:
Uliſſe n’eſt pas en ces lieux, Cherchons plus loin ſous ce feüillage.	Ulisse n'est pas en ces lieux, Cherchons plus loin sous ce feuillage.
RCE’.	RÉÉ.
Qu’ay-je entendu?	Qu'ai-je entendu?
c’eſt ma Rivalle, O Dieux?	c'est ma Rivale, Ô Dieux?
Arrétons-là dans ce Boccage Par quelques doux enchantemens.	Arrétons-là dans ce Boccage Par quelques doux enchantements.
Taiſez-vous, jaloux mouvemens, Je pretends la punir du plus cruel ſupplice, Mais c’est en preſence d’Uliſſe.	Taisez-vous, jaloux mouvements, Je prétends la punir du plus cruel supplice, Mais c'est en présence d'Ulisse.
Venez, Demons, empruntez les attraits Des Nymphes de ces Forests, Je vais trouver mon Volage;	Venez, Demons, empruntez les attraits Des Nymphes de ces Forêts, Je vais trouver mon Volage;
Anomanves dr Donue epunsouuſe jes ſoupirs Par les plus touchans plaiſirs, L ile en fentira da Canrage.	Anomanves dr Donue épunsouuse jes soupirs Par les plus touchants plaisirs, L ane en sentira da Canrage.
La horrevle doutem 22 Ie Fapmm ponouoi.	La horrevle doute 22 Je Fapmand ponouoi.
Circé ſort.	Circé sort.
Le Tombeau que les Demons avoient élevé, eſt caché par des Arbres.	Le Tombeau que les Demons avaient élevé, est caché par des Arbres.
SCENE SIXIE’ME.	SCÈNE SIXIE'ME.
EOLIE ſcule.	ÉLIE scule.
Omens où je dois voir l’Objet de ma M tendreſſe, Ah!	Oments où je dois voir l'Objet de ma M tendresse, Ah!
que vous tardez à venir;	que vous tardez à venir;
De doux eſpoir qui vient m’entretenir Ne peut diſſiper ma triſteſſe,	De doux espoir qui vient m'entretenir Ne peut dissiper ma tristesse,
Ah?	Ah?
Ah!	Ah!
que vous tardeZ à venir Momens où je dois voir l’Objet de ma tendreſſe!	que vous tardez à venir Moments où je dois voir l'Objet de ma tendresse!
SCENE SEPTIE'ME.	SCÈNE SEPTIE'ME.
EOLIE.	ÉOLIE.
Troupe de Demons transformez en Nymphes.	Troupe de Démons transformés en Nymphes.
1 LE CHOEUR.	1 LE CHOEUR.
miez prendre part à nos jeux, Vous que l’Amour a ſçeu rendre ſenſibles, Il va combler tous vos veux Dans ces retraittes paiſibles.	miez prendre part à nos jeux, Vous que l'Amour a su rendre sensibles, Il va combler tous vos veux Dans ces retraites paisibles.
CRE AEMELIE.	CRE AMÉLIE.
Qui craint de reſſentir d’amoureuſes langueurs Doit s’éloigner de nos Boccages, L’Amour est caché ſous les fleurs, Et ſous les ſompres jeuillages.	Qui craint de ressentir d'amoureuses langueurs Doit s'éloigner de nos Boccages, L'Amour est caché sous les fleurs, Et sous les sompres jeuillages.
UNE NYMPHE.	UNE NYMPHE.
L’Amour coûte des pleurs, Il cauſe des allarmes;	L'Amour coûte des pleurs, Il cause des alarmes;
Mais pour goûter tout ce qu’il a de charmes;	Mais pour goûter tout ce qu'il a de charmes;
Il faut avoir éprouvé ſes rigueurs.	Il faut avoir éprouvé ses rigueurs.
LE CHOEUR.	LE CHOEUR.
Aimez, aimez, jeunes cœurs, L’Amour a mille douceurs;	Aimez, aimez, jeunes cœurs, L'Amour a mille douceurs;
Si d’un cœur fidele & tendre, Il fait languir les deſirs, D’un bien qu’il a trop fait attendre Il redouble les plaiſirs.	Si d'un cœur fidèle et tendre, Il fait languir les désirs, D'un bien qu'il a trop fait attendre Il redouble les plaisirs.
SCENE HUITIE'ME.	SCÈNE HUITIE'ME.
MERCURE deſcend du Ciel, EOLIE, Demons transformez en Nymphes.	MERCURE descend du Ciel, EOLIE, Demons transformés en Nymphes.
MERCURE tenant la Fleur de Moly.	MERCURE tenant la Fleur de Moly.
Uy loin d’icy, Troupe odieuſe, TTu prepare d’affreux tourmens A ceux qui ſont ſeduits par tes enchantemens.	Dis loin d'ici, Troupe odieuse, TTu prépare d'affreux tourments À ceux qui sont séduits par tes enchantements.
A Eolie.	A Éolie.
Les Demons diſparoiſſent.	Les Demons disparaissent.
Prenez cette Fleur merveilleuſe Qui rompt le charme le plus fort, Allez changer le triſte ſort Du Heros qui vous aime, Il eſt dans un perit extrême.	Prenez cette Fleur merveilleuse Qui rompt le charme le plus fort, Allez changer le triste sort Du Héros qui vous aime, Il est dans un périt extrême.
Venez le mettre en liberté Venez goûter la douceur ſans égalle De braver en ſeureté La cruauté De vôtre jalouſe Rivalle.	Venez le mettre en liberté Venez goûter la douceur sans égale De braver en sûreté La cruauté De votre jalouse Rivalle.
Fin du quatriéme Acte.	Fin du quatrième Acte.
LE 1 Le Phieatre change & leprefente d’un côſté, des Rochers, de l’autre, un Bois, & dans le fonds un Port de Mer.	LE 1 Le Phieatre change et leprefente d'un côte, des Rochers, de l'autre, un Bois, et dans le fond un Port de Mer.
SCENE PREMIERE.	SCÈNE PREMIÈRE.
POLITE, ASTERIE.	POLITE, ASTÉRIE.
P 9 Pre POLITE.	 9 Pré POLITE.
Nfin le juste Ciel a comblé nos deſirs, Uliſſe eſt délivré par la Nymphe Eolie;	Nfin le juste Ciel a comblé nos désirs, Ulisse est délivré par la Nymphe Éolie;
Bien-tôt loin de ces lieux nous braverons l’Envie, Rien ne pourra troubler nos innocens plaiſirs.	Bientôt loin de ces lieux nous braverons l'Envie, Rien ne pourra troubler nos innocents plaisirs.
ASTERIE & POLITE.	ASTÉRIE et POLITE.
Que ma joye est extrême!	Que ma joie est extrême!
Que mon cœur en eſt enchanté!	Que mon cœur en est enchanté!
Quoy!	Quoi!
je pourray vous dire en liberté Tout ce qu’on ſent de tendre quand on aime?	je pourrai vous dire en liberté Tout ce qu'on sent de tendre quand on aime?
Que mon cœur en eſt enchanté!	Que mon cœur en est enchanté!
Que ma joye eſt exirême!	Que ma joie est exirme!
Feslema.	Feslema.
It jaut pour notre emvarquemensRaſſembler nos Grecs promptement	It jaut pour notre emvarquementsRassembler nos Grecs promptement
SCENE SECONDE.	SCÈNE SECONDE.
Eolie tient la fleur de Moly.	Éolie tient la fleur de Moly.
ULISSE’, EOLIE.	ULISE', EOLIE.
ULISSE.	ULISSE.
Ue ne vous dois-je pas, adorable Eolie?	Que ne vous dois-je pas, adorable Éolie?
PVous aveZ pris ſoin de ma vie;	PUis avez pris soin de ma vie;
Vous avez chaſſé de mon cœur, Le deſeſpoir, la rage & la fureur:	Vous avez chassé de mon cœur, Le désespoir, la rage et la fureur:
Du tendre amour qui m'entnante Je ſens redoubler les feux;	Du tendre amour qui m'entnante Je sens redoubler les feux;
Que vous eſtes charmante!	Que vous êtes charmante!
Que je ſuis amoureux.	Que je suis amoureux.
EOLIE.	ÉOLIE.
J'ay crû vôtre perte certaine, Un funeſte éloignement Eſt la ſource de ma peine;	J'ai cru votre perte certaine, Un funeste éloignement Est la source de ma peine;
Ah!	Ah!
ne m’expoſez, plus à ce cruel tourment.	ne m'exposez, plus à ce cruel tourment.
Quand on eſt tendre & fidele.	Quand on est tendre et fidèle.
Qu’une longue abſence eſt cruelle!	Qu'une longue absence est cruelle!
Qu'elle coûte de ſoüpirs;	Qu'elle coûte de soupirs;
Qu’elle dérobe de plaiſirs!	Qu'elle dérobe de plaisirs!
Quand on eſt tendre & fidele!	Quand on est tendre et fidèle!
EOLIE & ULISSE.	ÉLIE et ULISSE.
Ne nous quittons jamais, payons-nous des douceurs Que l’abſence & la jalouſie Ont fait perdre à nos tendres cœurs;	Ne nous quittons jamais, payons-nous des douceurs Que l'absence et la jalousie Ont fait perdre à nos tendres cœurs;
Les delices de la vie, Les plaiſirs les plus charmans, Ne ſont que pour les vrais Amans.	Les délices de la vie, Les plaisirs les plus charmants, Ne sont que pour les vrais Amants.
EOLIE.	ÉOLIE.
Puis-je me flater que vôtre ame N’a rien ſenty pour de nouveaux appas?	Puis-je me flatter que votre âme N'a rien senti pour de nouveaux appas?
ULTOOH Vous m’offenſez ſi vous ne croyeZ pas, Que je brûle pour vous d’une conſtante flame.	ULTOH Vous m'offensez si vous ne croisez pas, Que je brûle pour vous d'une constante flamme.
EOLIE.	ÉOLIE.
Je veux encor douter de vôtre foy, Pour avoir le plaiſir de vous entendre dire, Que ce n'eſt que pour moy Que vôtre cœur ſoûpire.	Je veux encor douter de votre foi, Pour avoir le plaisir de vous entendre dire, Que ce n'est que pour moi Que votre cœur soupire.
ULISSE.	ULISSE.
Vous m’attachez avec de trop beaux nœuds, Pour craindre mon inconſtance;	Vous m'attachez avec de trop beaux nœuds, Pour craindre mon inconstance;
Un foible Amour s’éteint aisément par l’abſence;	Un faible Amour s'éteint aisément par l'absence;
Mais d’un cœur bien amoureux L’abſence augmente les feux.	Mais d'un cœur bien amoureux L'absence augmente les feux.
EOLIE& ULISSE.	ÉLIEF ULISSE.
P ous matmes, ſe vous aime, Que noſtre ſort est doux!	 Pous matmes, se vous aime, Que notre sort est doux!
Goutons le plaiſir extrême De nous dire cent fois en dépit des jaloux, Vous m’aimez, je vous aime.	Goutons le plaisir extrême De nous dire cent fois en dépit des jaloux, Vous m'aimez, je vous aime.
EOLIE.	ÉOLIE.
Favoriſez nos veux, Divinitez des Eaux, Vents furieux qui regnez ſur les Ondes Ne nous expoſez pas à des perils nouveaux, Demeurez enchaineZ dans vos Grottes proſondes.	Favorisez nos veux, Divinités des Eaux, Vents furieux qui régnez sur les Ondes Ne nous exposez pas à des périls nouveaux, Demeurez enchinés dans vos Grottes prosondes.
AQUILON & les autres yents viemient aſſeurer Eolie, qu’ils luy ſeront favorables.	AQUILON et les autres yents viemient assurer Éolie, qu'ils lui seront favorables.
Une Troupe de Nereïdes & de Tritons, ſort de la Mer & ſe joint à eux.	Une Troupe de Nereïdes et de Tritons, sort de la Mer et se joint à eux.
SCENE TROISIE’ME.	SCÈNE -TROISIE'ME.
AQUILON.	AQUILON.
Troupe de Vents, Troupe de Nereides & de Tritons, ULISSE, EOLIE.	Troupe de Vents, Troupe de Nereides et de Tritons, ULISSE, EOLIE.
M AQUILON.	M AQUILON.
E la fille d'Eole, il faut combler les veux, Ets pents tes pius tmperueux Ne ſortent deſclavage Que pour venir luy rendre hommage, On verra ſur les flots regner un calme heureux.	E la fille d'Éole, il faut combler les veux, Ets pents tes pius tmperueux Ne sortent déclavage Que pour venir venir rendre hommage, On verra sur les flots régner un calme heureux.
CHOEUR d’Aquilons.	CHOEUR d'Aquilons.
De la fille d’Eole, il faut combler les veux, Les Vents les plus impétueux Ne ſortent d’eſclavage Que pour venir luy rendre hommage.	De la fille d'Éole, il faut combler les veux, Les Vents les plus impétueux Ne sortent d'esclavage Que pour venir lui rendre hommage.
, On verra ſur les flots regner un calme heureux.	, On Ça sur les flots régner un calme heureux.
UNE NEREIDE.	UNE NÉRÉIDE.
EmbarqueZ-vous, ne craignez plus l’Orage, Vous aurez un ſort charmant, Rien ne plaiſt davantage Dans le bel aage Qu’un embarquement Avec un fidele Amant.	EmbarqueZ-vous, ne craignez plus l'Orage, Vous aurez un sort charmant, Rien ne plaît davantage Dans le bel aage Qu'un embarquement Avec un fidèle Amant.
ViveZ heureux, AimeZ vos chaines, L'Amour aprés vos peines Coinbte toos veue , Vivez heureux.	Vivez heureux, Aimez vos chaines, L'Amour après vos peines Cointe tos vue , Vivez heureux.
LE CHOEUR.	LE CHOEUR.
Tendres cœurs, rien ne peut vous nuire, L’Amour prend ſoin de vous conduire;	Tendres cœurs, rien ne peut vous nuire, L'Amour prend soin de vous conduire;
Il embarque avec vous, Les ris, les jeux, les plaifirs tes plus doux.	Il embarque avec vous, Les ris, les jeux, les plaisirs tes plus doux.
SCENE QUATRIE'ME.	SCÈNE QUATRIE'ME.
ULISSE, EOLIE, ASTERIE, POLITE, Troupe de Vents, Troupe de Nereïdes:	ULISSE, EOLIE, ASTÉRIE, POLITE, Troupe de Vents, Troupe de Nereïdes:
Troupe de Tritons, Aquilon.	Troupe de Tritons, Aquilon.
N POLITE.	 NOLITE.
Os Grecs ſont ruſſemoteZ, partons en diligence;	Os Grecs sont russemoteZ, partons en diligence;
VeneZ, Prince, venez, on n’attend plus que vous, Circé dans ces lieux s’avance.	VeneZ, Prince, venez, on n'attend plus que vous, Circé dans ces lieux s'avance.
ULISSE.	ULISSE.
ULISSE.	ULISSE.
Eloignons-nous.	Éloignons-nous.
ULISSE, EOLIE, ASTERIE, POLITE capproeriene du Pore, ies Fvererdes & les Tritons les ſuivent.	ULISSE, EOLIE, ASTÉRIE, POLITE capproeriene du Pore, jes Férerdes et les Tritons les suivent.
SCENE CINQUIE’ME.	SCÈNE CINQUIE'ME.
ULISSE, EOLIE, ASTERIE, POLITE, & les NEREIDES dans le fonds du Theâtre, CIRCE’ ſans les voir.	ULISSE, EOLIE, ASTÉRIE, POLITE, et les NÉRÉIDES dans le fond , Théâtre, CICE' sans les voir.
CIRCE'.	CIRCE'.
Rage!	Rage!
ô douleur mortelle!	ô douleur mortelle!
J Je cherche en vain mon infidéle;	 Je cherche en vain mon infidèle;
Ah!	Ah!
l’Enfer me trahit, je n’en ſçaurois douter,	l'Enfer me trahit, je n'en sçaurois douter,
Elle les apperçoit.	Elle les aperçoit.
Uliſſe, ô Dieux!	Ulisse, ô Dieux!
que vois-je?	que vois-je?
ô diſgrace fatale!	ô disgrâce fatale!
Il fuit avec ma Rivale, Le traître.	Il fuit avec ma Rivale, Le traître.
Il faut l’arrêter.	Il faut l'arrêter.
Demons, Demons, quittez vos Cavernes proſondes, Sortez, volez, volez avec d’horribles feux;	Demons, Demons, quittez vos Cavernes prosondes, Sortez, volés, volés avec d'horribles feux;
Embraſez au milieu des Ondes Les Vaiſſeaux de ces Malheureux.	Embrasez au milieu des Ondes Les Vaisseaux de ces Malheureux.
Il paroît pluſieurs Demons en l’air & ſur la Terre;	Il paraît plusieurs Demons en l'air et sur la Terre;
ils ſont armez de feux, & veulent aller brûler les Vaiſſeaux d’Uliſſe, mais ils ſont arrétez par la vertu du Moly.	ils sont armés de feux, et veulent aller brûler les Vaisseaux d'Ulisse, mais ils sont arrêtés par la vertu du Moly.
SCENE SIXIE’ME.	SCÈNE SIXIE'ME.
DETSOE, LOLID, ASTERIE, POLITE, Troupe de Nereïdes & de Tritons dans le fonds du Theâtre;	DETSOE, LOLID, ASTÉRIE, POLITE, Troupe de Nereïdes et de Tritons dans le fonds du Théâtre;
CIRCE’, Troupe de Demons armez de feux.	CIRCE', Troupe de Demons armés de feux.
CHOEUR de Demons.	CHOEUR de Demons.
Ne Divine Puiſſance S’oppoſe à nôtre violence, Et ſemble nous donner des fers, Nous ne ſçaurions aborder ce rivage Pour exercer nôtre rage, Retournons dans les Enfers.	Ne Divine Puissance S'oppose à notre violence, Et semble nous donner des fers, Nous ne saurions aborder ce rivage Pour exercer notre rage, Retournons dans les Enfers.
Les Demons s’abîment.	Les Demons s'abîment.
ULISSE, EOLIE, ASTERIE & POLITE montent ſur leurs Vaiſſeaux, qui s’éloignent peu à peu du rivage;	ULISSE, EOLIE, ASTÉRIE et POLITE montent sur leurs Vaisseaux, qui s'éloignent peu à peu du rivage;
Les Nereïdes & les Tritons ſe plongent dans la Mer.	Les Nereïdes et les Tritons se plongent dans la Mer.
SCENE SEPTIEME ET DERNIERE.	SCÈNE SEPTIÈME ET DERNIÈRE.
A CIRCE' ſeule.	À CIRCE' seule.
H!	H!
quelle rigueur extrême!	quelle rigueur extrême!
Dieux cruels, infuſtes Dieux:	Dieux cruels, infustes Dieux:
DeveZ-vous employer vôtre pouvoir ſuprême Pour m’empêcher d’arrêter dans ces lieux Un volage que j'aime?	Devez-vous employer votre pouvoir suprême Pour m'empêcher d'arrêter dans ces lieux Un volage que j'aime?
Eſt-ce pour les perfides cœurs Que vous reſerveZ vos faveurs?	Est-ce pour les perfides cœurs Que vous réservez vos faveurs?
Je ne me connois plus moy-même, Uliſſe m’abandonne, il me manque de foy, Juſques dans les Enfers tout est changé pour moy.	Je ne me connais plus moi-même, Ulisse m'abandonne, il me manque de foi, Jusques dans les Enfers tout est changé pour moi.
Demeure, ingrat, ne crains pas ma vangeance, Mon cœur encor plus tendre qu’irrité Trouve ton infidelité Moins cruelle que ton abſence.	Demeure, ingrat, ne crains pas ma vengeance, Mon cœur encor plus tendre qu'irrité Trouve ton infidélité Moins cruelle que ton absence.
Traître, rien n’arrête tes pas, Du moins ſi la pitié ne te ramene pas Que la cruauté te ramene, Revien pour jouir de ma peine;	Traître, rien n'arrête tes pas, Du moins si la pitié ne te ramène pas Que la cruauté te ramène, Revien pour jouir de ma peine;
Vien me voir ſuccomber à ma vive douleur.	Viens me voir succomber à ma vive douleur.
C’eſt toy, cruel Amour, qui cauſes mon malheur, Ta funeſte colere Contre le Soleil mon Pere Tombe toüjours ſur mon cœur;	C'est toi, cruel Amour, qui causes mon malheur, Ta funeste colère Contre le Soleil mon Père Tombe toujours sur mon cœur;
C’en est fait, je n’ay plus pour toy que de l’horreur.	C'en est fait, je n'ai plus pour toi que de l'horreur.
C’eſt trop gémir.	C'est trop gémir.
Allons la plainte eſt vaine, e vais dans oe funeſte jour Briſer les Autels de l’Amour, Je n’en veux deſormais élever qu’à la Haine.	Allons la plainte est vaine, e ais dans oe funeste jour Briser les Autels de l'Amour, Je n'en veux désormais élever qu'à la Haine.
Puiſqu'Uliſſe a changé, que tout change en ces lieux, Que le Giel en courroux s’arme contre la Terre, Que tous les Elemens ſe declarent la guerre, Servez arbres, rochers, mes tranſports furieux, Precipitez-vous dans l’Onde, En un affreux cahos changez ce triſte bord, RendeZ pour jamais ce Port Inacceſſible a tout le Monde.	Puisqu'Ulisse a changé, que tout change en ces lieux, Que le Giel en courroux s'arme contre la Terre, Que tous les Éléments se déclarent la guerre, Servez arbres, rochers, mes transports furieux, Precipités-vous dans l'Onde, En un affreux cahos changez ce triste bord, RendeZ pour jamais ce Port Inaccessible à tout le Monde.
On entend un grand bruit de Tonnerre, les Rochers & les Arbres ſont renverſez, & comblent le Port;	On entend un grand bruit de Tonnerre, les Rochers et les Arbres sont renversés, et comblent le Port;
Il paroit à leur place des Gouffres qui vomiſſent des flames.	Il parait à leur place des Gouffres qui vomissent des flammes.
