ARGVMENT SVR L’EMETIQVE PREPARE.	ARGUMENT SUR L'ÉMÉTIQUE PRÉPARE.
S YANT veu le dixiéme du mois dernier vn Arreſt af fiché pour authoriſer l’Emetique apres les mauvais effets qu’il a produits iuſqu’à preſent;	 SYANT vu le dixième du mois dernier un Arrest a fiché pour autoriser l'Emetique après les mauvais effets qu'il a produits jusqu'à présent;
Ie fais plaindre Caron de l’excez de ſon travail à paſſer les Ombres au double de ſon ordinaire.	Je fais plaindre Caron de l'excès de son travail à passer les Ombres au double de son ordinaire.
Radamante & Eacus Iuges de Plutton recoivent ſes plaintes, & ſur la depoſition de quelques Ombres qui ſe plaignent de l’Antimoine, on prend reſolution d’en parler a Plutton, pour y apporter quelque remede:	Radamante et Eacus Juges de Pluton reçoivent ses plaintes, et sur la déposition de quelques Ombres qui se plaignent de l'Antimoine, on prend résolution d'en parler à Pluton, pour y apporter quelque remède:
Cependant vn Me decin paſſe le fleuve & meine l’Ant moine avec luy, Radamante ſait procez à l’vne & à l’autre, & les fa reufermer.	Cependant un Me décin se le fleuve et mène l'Ant moine avec lui, Radamante sait procès à l'une et à l'autre, et les fa revermer.
L'Antimoine eſtant vne eſpece, plomb dont Saturne eſt le Pere chesles Chimiſtes, eſt reclamé par Mer cure qui a quelque affinité au avec l’vn & l’autre, on refuſe ches Plutton de le luy remettre entre le mains, à cauſe de ſes deſordres Saturne dans l’impatience de revoin ſon fils paſſe procuration à Momus, pour le reclamer de ſa part, Momus arrivant chez Plutton rencontre Mercure ſur ſon départ qui luy témoigne qu’il n’a pû rien obtenir pour la liberté de ſon petit couſin, & qu’à moins que le conſeil d’enhaut n’en ordonne, Plutton n’eſt pas dans la volonté de le relâcher:	L'Antimoine étant une espèce, plombé de Saturne est le Père chez Chimistes, est réclamé par Mer cure qui a quelque affinité au avec l'amour et l'autre, on refuse chez Pluton de le lui remettre entre le mains, à cause de ses désordres Saturne dans l'impatience de revoin son fils passe procuration à Momus, pour le reclamer de sa part, Momus arrivant chez Pluton rencontre Mercure sur son départ qui avait témoigne qu'il n'a pu rien obtenir pour la liberté de son petit cousin, et qu'à moins que le conseil enhaut en ordonne, Plutton es pasdans la ute de leur,
il retourne aux Cieux porter cette uouvelle, où Saturne preſente requeſte à lupiter pour obliger Themis d'y faire vne deſcente:	il retourne aux Cieux porter cette ouvelle, où Saturne présente requête à lupiter pour obliger Themis d'y faire une descente:
Themis ſe tranſporte ſur les lieux, & apres avoir oüy les raiſons de part & d’autre par l’iuterrogation de l’Antimoine, & par les accuſations rapportées par Radamante luge des lieux, tant du iom d’Hipocrate qui eu a fait ſa le claration à Plutton en preſence de mercure, que des autres Medecins aujoura nuyi neitar couſideré l’Enetique eſt remis en liberté, ſauf à ſe donner de garde de ceux qui le meteut en employ.	Themis se transporte sur les lieux, et après avoir oui les raisons de part et d'autre par l'iuterrogation de l'Antimoine, et par les accusations rapportées par Radamante luge des lieux, tant du jom d'Hypocrate qui eu a fait sa le claration à Pluton en présence de mercure, que des autres Médecins aujoura nuymi neitar cousidéré l'Enetique est remis en liberté, sauf à se donner de garde de ceux qui le meteut en emploi.
ACTEVRR.	ACTEUR.
PLVTTON Dieu des Enfers.	PLUTON Dieu des Enfers.
RADAMANTE Iuge.	RADAMANTE Juge.
EACVS autre luge.	EACUS autre luge.
CARON Notonnier.	CARON Notonnier.
THEMYS Déeſſe de la juſtice.	THEMIS Déesse de la justice.
MERCVRE Interprette des Dieux.	MERCURE Interprète des Dieux.
MOMVS Procureur de Saturne.	MOMUS Procureur de Saturne.
ANTIMOIN PVRIFIE SVR LA SELLETTE.	ANTIMOIN PURIFIE SUR LA SELLETTE.
E επεεπυ δ Dει	 επεεπυ Dει
ACTE PREMIER.	ACTE PREMIER.
CARON ſeul avec vn Aviron.	CARON seul avec un Aviron.
M H!	M M!
le maudit meſtier, ie ne ſuis plu moy-meſme, Ie ſuis las à mourir, & ie me vois tou blême;	le maudit métier, Seigneur ne suis plu moi-même, Je suis las à mourir, et quelque me vois tou blême;
Me voila tout défait, tout défait me voila, D’où diable, encore vn coup me vient tout!	Me voilà tout défait, tout défait me voilà, D'où diable, encore un coup me vient tout!
mal là.	mal là.
Iuge des antres noirs, Eacus, Radamante, Que l’eſprit de Plutton à iamais vous tourmente Si vous ne ſoulagez voſtre pauvre Caron	Juge des antres noirs, Eacus, Radamante, Que l'esprit de Pluton à jamais vous tourmente Si vous ne soulagez votre pauvre Caron
Il vous plantera là, la Barque & l’Aviron.	Il vous plantera là, la Barque et l'Aviron.
RADAMANTE.	RADAMANTE.
D’où vient l’emportement de ce pauvre bon hor	D'où vient l'emportement de ce pauvre bon hor
CARON.	CARON.
Plus vn cheval eſt bon, tant plus grande eſt ſomme, Enfin ie ne peux plus eſtre voſtre Nocher, Ie vay chez les mortels m’eriger en cocher;	Plus un cheval est bon, tant plus grande est somme, Enfin ie ne peux plus être votre Nocher, Je vais chez les mortels m'ériger en cocher;
Mes chevaux pour le moins traîneront le carreſ Et ie ne ſeray plus la miſerable roſſe, A paſſer iour & nuict ſans fin & ſans repos Les eſclaves ſurpris de Madame Atropos, Pour gaigner en vn iour peut-eſtre vingt piſtoles RADAMANTE.	Mes chevaux pour le moins traîneront le carres Et ici ne serai plus la misérable rosse, A passer jour et nuit sans fin et sans repos Les esclaves surpris de Madame Atropos, Pour gagner en un jour peut-être vingt pistoles RADAMANTE.
Explique-nous Caron en deux ou trois parolu Qui te fait murmurer apres vn ſi long-temps, Ton travail aujourd’huy doit eſtre vn paſſetemps On poutroit excuſer les plaintes d’vn Novice;	Explique-nous Caron en deux ou trois parol Qui te fait murmurer apres si long-temps, Ton travail aujourd’ doit être passetemps On poutroit excuser les plaintes Novice;
Mais entendre vn vieux loup, rompu dans l’erercice Se plaindre ſans ſujet!	Mais entendre un vieux loup, rompu dans l'érercice Se plaindre sans sujet!
CARON.	CARON.
Sans ſujet, dites-vousi Ie voudrois vous y voir, vous n’eſtes pas ſi fous;	Sans sujet, dites-vouzy Je voudrais vous y voir, vous n'êtes pas si fous;
Depuis trois mois en ça, dix Barques, toutes neuves N’auroient pas pû ſervir vn tas de ieunes veuves, Qui vous ont envoyé tous leurs anciens maris, Dont on voit la pluſpart ſe dire de Paris;	Depuis trois mois en ça, dix Barques, toutes neuves N'auraient pas pu servir un tas de jeunes veuves, Qui vous ont envoyé tous leurs anciens maris, Dont on voit la plupart se dire de Paris;
Il ſemble qu’en ce lieu, la famine & la peſte Faſſent à qui pis pis, & joüent de leur reſte.	Il semble qu'en ce lieu, la famine et la peste Fassent à qui pis pis, et jouent de leur reste.
RADAMANTE.	RADAMANTE.
Caron, faut obeïr aux Arreſts du deſtin.	Caron, faut obéir aux Arrêts du destin.
CARON Faut ma foy que ce Dieu ſoit à quelque feſtin, Du qu’il ſoit endormy, car vn ſi grand carnage, Ne peut par ſes decrets ſubſiſter davantage;	CARON Faut ma foi que ce Dieu soit à quelque festin, Du qu'il soit endormi, car un si grand carnage, Ne peut par ses décrets subsister davantage;
vois, & ie prévois que la mortalité ient encor de plus loin que la fatalité:	vois, et ici prévois que la mortalité jent encor de plus loin que la fatalité:
faut que par dépit pour achever ma Barque, uelque ieune apprentif par ordre de la Parque it parmy les mortels inventé de nouveau uelque Diachilum qui leur fait paſſer l’eau.	faut que par dépit pour achever ma Barque, uelque jeune apprentis par ordre de la Parque it parmi les mortels inventé de nouveau uelque Diachilum qui leur fait passer l'eau.
VN OMBRE appelle.	UN OMBRE appelle.
don, Caida.	don, Caida.
CARON continuant.	CARON continuant.
Pour moy ie vous dis ma penſée.	Pour moi ici vous dis ma pensée.
L’OMBRE appelle.	L'OMBRE appelle.
ion Cuon.	ion Cuon.
CARON ripond par dépit.	CARON ripond par dépit.
Caron, Caron, Ombre incenſée, 'n moment de Rpus, attemmoy ſi tu veux.	Caron, Caron, Ombre incensée, 'n moment de Répus, attemoi si tu veux.
RADAMANTE.	RADAMANTE.
Caron, les faut paſſer.	Caron, les faut passer.
CARON.	CARON.
Ie fais ce que ie peux, Et quand ie dirois plus ce n’eſt point vn menſonge.	Je fais ce que ici peux, Et quand ici dirais plus ce n'est point un mensonge.
Tmois Ombres arrivent.	Tmais Ombres arrivent.
CARON eſtonne Comment diable ſans moy, ne voila pas mon ſange?	CARON étonne Comment diable sans moi, ne voilà pas mon sange?
e voyois en rêvant, ce me ſemble.	e voyais en rêvant, ce me semble.
la nuict, es Ombres qui paſſoient ſourdement, & ſans bruit, trainte de me payer.	la nuit, es Ombres qui passaient sourdement, et sans bruit, trainte de me payer.
retournez au plus viſte, ù le fleuve Lethé ſera le dernier giſte, u ie vay vous plonger à grands coups d’Aviron.	retournez au plus vite, ù le fleuve Léthé sera le dernier gîte, ie vay vous plonger grands coups Aviron.
0 RADAMANTE.	0 RADAMANTE.
Tout beau, tout beau, Nocher, arreſte vn peu Caron.	Tout beau, tout beau, Nocher, arrête un peu Caron.
CARON parlant aux Ombres.	CARON parlant aux Ombres.
Qui vous a donc paſſez?	Qui vous a donc passez?
LESOMBRES.	LESOMBRES.
Nous-meſmes ſans rien dire, Ayans la Barque au port, chacun de nous l’aus Et d’vn ſeul Aviron abandounant ce bord Nous ſommes doucement arrivez dans ce port.	Nous-mêmes sans rien dire, Ayants la Barque au port, chacun de nous l'aus Et d'un seul Aviron abandounant ce bord Nous sommes doucement arrivés dans ce port.
CARON.	CARON.
Montrez-moy les talons, retournez au rivage Il en eſt chez Caron pour ſon droict de naulag Comme deſſus vn pont qu’on a déja paſſé, Eſtant au Tourniquet vn homme eſt terraſſé, Et renvoyé d’abord, s’il n’a là ſon affaire Pour graiſſer en paſſant la patte du Corſaire:	Montrez-moi les talons, retournez au rivage Il en est chez Caron pour son droit de naulag Comme dessus un pont qu'on a déjà passé, Étant au Tourniquet un homme est terrassé, Et renvoyé d'abord, s'il n'a là son affaire Pour graisser en passant la patte du Corsaire:
Vn Obolle n’eſt rien, mais ſur la quantité Cela me garde vn peu de la neceſſité.	Un Obolle n'est rien, mais sur la quantité Cela me garde un peu de la nécessité.
RADAMANTE parlant aux Ombres.	RADAMANTE parlant aux Ombres.
Ombres, de quel pays, quel employ, de que e;	Ombres, de quel pays, quel emploi, de que l;
OMBRE.	OMBRE.
De Paris partiſan.	De Paris partisan.
CARON.	CARON.
N’en dis pas davantage, Partiſan?	N'en dis pas davantage, Partisan?
Ah voleur, tu quittes ce ſejour Pour venir m’excroquer, & piller à mon tour :	Ah voleur, tu quittes ce séjour Pour venir m'excroquer, et piller à mon tour :
Ie ne m’eſtonne plus, ſi pour ſauver l’obolle Tu t’es embarqué ſeul, eſprit de Monopolle, N’ayant plus à gaigner dans ton pays natal Tu viens nous exiger quelque party fatal?	Je ne m'étonne plus, si pour sauver l'obolle Tu t'es embarqué seul, esprit de Monopolle, N'ayant plus à gagner dans ton pays natal Tu viens nous exiger quelque parti fatal?
Ne veux-tu pas donner ton Placet à la parque pour mettre quelque impoſt, ſur le Styx, ſur mi B ique, L’eau n’eſt point trouble aſſez pous prendre le poiſſons, L ais chez Plutton l’on n’a veu des oyſons.	Ne veux-tu pas donner ton Placet à la parque pour mettre quelque impôt, sur le Styx, sur mi B ique, L'eau n'est point trouble assez pous prendre le poussons, L ais chez Pluton l'on n'a vu des oisons.
RADAMANTE.	RADAMANTE.
D’où vient que les mortels ſortent de voſtre Ville, t venir à milliers dans ce noir domicille?	D'où vient que les mortels sortent de votre Ville, t venir à milliers dans ce noir domicille?
ous n’avons iamais veu tant d’Ombres à la fois.	ous n'avons jamais vu tant d'Ombres à la fois.
OMBRES.	OMBRES.
Vn remede approuvé depuis deux ou trois mois riomphe châque iour, culbutant pêle mêle, eûnes, vieux, grands, petits auſſi drus que la grêle;	Un remède approuvé depuis deux ou trois mois riomphe châque jour, culbutant pêle mêle, eunes, vieux, grands, petits aussi drus que la grêle;
algré tout ce débry que i’ay veu de mes yeux 'ay ſuivy le torrent qui roule dans ces lieux, t ie ſens dans mon corps le beau remue-ménage Jue peut produire ailleurs l’effort de ce breuvage;	algré tout ce débri que j'ai vu de mes yeux ' ais suivi le torrent qui roule dans ces lieux, t H sens dans mon corps le beau remue-ménage Jue peut produire ailleurs l'effort de ce breuvage;
lon Medecin fameux qui me traittoit d’amy, Autresfois de ce ſuc l’implacable ennemy, Me vint dire chez moy, qu’ayant changé la doſe Ce remede aujourd’huy n’eſtoit plus méme choſe, Qu’on en pouvoit vſer ſuivant leglement D’vn Arreſt ſolemnel en Cour de parlement,	Lon Médecin fameux qui me traitait d'ami, Autrefois de ce suc l'implacable ennemi, Me vint dire chez moi, qu'ayant changé la dose Ce remède aujourd'hui n'était plus même chose, Qu'on en pouvait user suivant léglement D'autre Arrêt solennel en Cour de parlement,
CARON.	CARON.
Quand on meurt par Arreſt on n’a plus rien à dire;	Quand on meurt par Arrêt on n'a plus rien à dire;
Ca, me faut de l’argent, voicy le mot pour rire, Allons viſte, au pluſtot, ou bien faut repaſſer.	Ça, me faut de l'argent, voici le mot pour rire, Allons vite, au plustôt, ou bien faut repasser.
RADAMANTE.	RADAMANTE.
Ombres, payez Caron pour vous débarraſſer, Caron, Caron, Caron.	Ombres, payez Caron pour vous débarrasser, Caron, Caron, Caron.
Ils le payent, on appelle.	Ils le paient, on appelle.
0	0
RADAMANTE.	RADAMANTE.
Ah !	Ah !
voila bien du monde.	voilà bien du monde.
OMBRE.	OMBRE.
Le Styx verra dans peu, couvrir toute ſon ond La moitié des mortels va paſſer devers vous Catoi, Calon, Ciron, On appelle encure,	Le Styx verra dans peu, couvrir toute son ond La moitié des mortels va passer devers vous Caton, Calon, Ciron, On appelle encure,
CARON lovant les yeux.	CARON lovant les yeux.
On y va, on y va.	On y va, on y va.
Ayez pitié de nous,	Ayez pitié de nous,
RADAMANTE.	RADAMANTE.
De ce poiſon fatal.	De ce poison fatal.
elle eſt donc la pretique	elle est donc la prétique
OMBRES.	OMBRES.
On l’appelle Emetique, Ou pluſtoſt Antimoine, avec vn peu de vin, C’eſt là pour tous les maux le remede divin.	On l'appelle Emetique, Ou plutôt Antimoine, avec un peu de vin, C'est là pour tous les maux le remède divin.
EACVS.	EACUS.
raſſez au premier rang, & faites place à d’autres.	rassez au premier rang, et faites place à d'autres.
Elles rentrent.	Elles rentrent.
RADAMANTE Enfin, ſi les mortels paſſent parmy les noſtres, Nous n’avons pas de lieu pour tant de Citoyens Nous faut avec Plutton chercher quelques moyens Pour accroiſtre au plûtoſt les lieux de ſon Empire.	RADAMANTE Enfin, si les mortels passent parmi les nôtres, Nous n'avons pas de lieu pour tant de Citoyens Nous faut avec Pluton chercher quelques moyens Pour croître au plûtost les lieux de son Empire.
EACVS.	EACUS.
Cela ne ſert de rien, quand nous irons luy dire, Il faudra quelque temps pour en venit à bout Que faire cependant ſi l’on nous paſſe tout.	Cela ne sert de rien, quand nous irons lui dire, Il faudra quelque temps pour en venit à bout Que faire cependant si l'on nous passe tout.
RADAMANTE.	RADAMANTE.
Faut arreſter le cours de ce vin Emetique, Deffendant ſans appel de le mettre en pratique oins pour quelque temp	Faut arrêter le cours de ce vin Emétique, Défendant sans appel de le mettre en pratique oins pour quelque tempête
BACVS.	BACUS.
C’eſt tres-bien raiſonnet.	C'est très-bien raisonnet.
CARON auic vn Medecin, le petit Antimoine.	CARON avic un Médecin, le petit Antimoine.
Voicy d’autres paſſans, vous plait-il d’orAundes elque place où les mettre?	Voici d'autres passants, vous plaît-il d'orAundes élque place où les mettre?
RADAMANTE.	RADAMANTE.
Avez-vous quelques grades, quelques qualitez?	Avez-vous quelques grades, quelques qualités?
LE MEDECIN.	LE MÉDECIN.
Ie gueris les malades, quelque Medecin iamais ſe ſignala n peue laul vous mentir, dite que le voila	Je guéris les malades, quelque Médecin jamais se signala n peue laul vous mentir, dite que le voilà
CARON.	CARON.
Triailleur, Charlattan, Batteleur, Empirique, l’es-tu point des ſuppoſts de ce vin Emetique?	Triailleur, Charlattan, Batteleur, Empirique, l'es-tu point des suppôts de ce vin Emetique?
LE MEDECIN montrant l'Antimoine.	LE MÉDECIN montrant l'Antimoine.
Le voila ce remede infaillible & Divin.	Le voilà ce remède infaillible et Divin.
CARON levant ſon Aviron.	CARON levant son Aviron.
Ah!	Ah!
Bourteau ſors d’icy, retourne avec ton vin, Tu viens nous amener cette maudite peſte our nous faire crever en joüant de ton reſte.	Bourteau sors d'ici, retourne avec ton vin, Tu viens nous amener cette maudite peste our nous faire crever en joüant de ton reste.
RADAMANTE.	RADAMANTE.
A quoy bon appotter ce remede en ces lieux?	À quoi bon appotter ce remède en ces lieux?
LE MEDECIN.	LE MÉDECIN.
C’eſt vn fils de Saturne, vn threſor precieur.	C'est un fils de Saturne, un trésor priceur.
CARON regardant l’An timoine.	CARON regardant l'An timoine.
Fils de Saturne helas!	Fils de Saturne hélas!
reſſemblant à to pere, Petit fils de putain, tu ne vaux ma foy guere, Ne faut pas demander qui nous fait paſſe l’eau.	ressemblant à to père, Petit fils de put, tu ne vaux ma foi guère, Ne faut pas demander qui nous fait passe l'eau.
RADAMANTE.	RADAMANTE.
Saturne a donc produit ce remede nouveau Ennemy comme il eſt de toute la nature Son fils ſuit à ſon tour la meſme tablature.	Saturne a donc produit ce remède nouveau Ennemi comme il est de toute la nature Son fils suit à son tour la même tablature.
LE MEDECIN.	LE MÉDECIN.
Ah!	Ah!
Meſſieurs, ie vois bien qu’on ne connoit pas.	Messieurs, Seigneur vois bien qu'on ne connaît pas.
Il ne ſçait ce que c’eſt de mort ny de trépas;	Il ne sait ce que c'est de mort ni de trépas;
Au contraire, c’eſt luy qui conſerve la vie.	Au contraire, c'est venir qui conserve la vie.
CARON.	CARON.
Si iamais il l’a fait, c’eſt contre ſon envie, Il ne ſeroit pas fils de ſon pere autrement;	Si jamais il l'a fait, c'est contre son envie, Il ne serait pas fils de son père autrement;
Meſſieurs, faut enfermer ce drolle eſtroir tement, Avec ſon Antimoine & toute ſa ſequelle.	Messieurs, faut enfermer ce drolle étroir tement, Avec son Antimoine et toute sa séquelle.
RADAMANTE.	RADAMANTE.
Nous faut auparavant le mertre ſur la Selle, N’eſtant pas vn mortel, mais vn enfant de Cieux, Il pourroit nous cauſer du deſordre en ce hieux.	Nous faut auparavant le mertre sur la Selle, N'étant pas un mortel, mais un enfant de Cieux, Il pourrait nous causer du désordre en ce hieux.
CARON.	CARON.
S’il ne tient qu’à cela ſa ſauce eſt bientôs faite, Ie vay dans mon batteau vous querir n Sellette, Nous le faut éloigner de Madame Atropos, eloger à part pour avoir du repos.	S'il ne tient qu'à cela sa sauce est bientô te, Je vais dans mon batteau vous quérir nôtre Sellette, Nous le faut éloigner de Madame Tropos, eloger à part pour avoir du repos.
LE MEDECIN.	LE MÉDECIN.
Traitcer en criminel, vn Dieu de cette ſorte!	Traitcer en criminel, un Dieu de cette sorte!
telaſchez-le, Meſſieurs, faites ouvrir la porte:	telâchez-le, Messieurs, faites ouvrir la porte:
tue dira-t’on de luy, s’il retourne iamai?	tue dira-t-on de Seigneur, s'il retourne jamai?
RADAMANTE.	RADAMANTE.
Puis qu’il eſt chez Plutton, c’eſt à nous deſormais De voir ce qu’il a fait, & d’en faire iuſtice.	Puis qu'il est chez Pluton, c'est à nous désormais De voir ce qu'il a fait, et d'en faire justice.
CARON apportant la sellette.	CARON apportant la sellette.
A bas pauvre innocent tout fourré de malice.	À bas pauvre innocent tout fourré de malice.
LE MEDECIN Ecraſez-moy plutoſt que de le voir ainſi.	LE MÉDECIN Écrasez-moi plutôt que de le voir ainsi.
CARON.	CARON.
Bon, bon, cela va bien, vrayment nous y voicy, Monſieur le Medecin, à barbe d’eſcoupette, S’erige en Advocat, comme ſa gueule petté, La fiévre le va prendre en perdant ſon procez, Luy faut de l’Antimoine en ce premier accez.	Bon, bon, cela va bien, vraiment nous y voici, Monsieur le Médecin, à barbe d'escoupette, S'érige en Avocat, comme sa gueule peté, La fièvre le va prendre en perdant son procès, Lui faut de l'Antimoine en ce premier accès.
RADAMANTE.	RADAMANTE.
Tourquoy donc l’amener?	Tourquoi donc l'amener?
LE MEDECIN.	LE MÉDECIN.
C’eſtoit pour promenade.	C'était pour promenade.
CARONMonſieur l’amene icy pour en faire parade, N’ayant plus rien à faire en ce païs d’en haut, Il vient voir ſi pour luy nous n’avons rien è chaud.	CARONMonsieur l'amène ici pour en faire parade, N'ayant plus rien à faire en ce pays d'en haut, Il vient voir si pour lui nous n'avons rien è chaud.
Caron, Caron.	Caron, Caron.
On appelle,	On appelle,
CARON i'en allant.	CARON j'en allant.
Toûjours ſans fin.	Toujours sans fin.
RADAMANTE.	RADAMANTE.
Entrez & prenez place, Parmy les Triailleurs & gens de populace, Gardez-vous d’approcher de ces grands Medecins, Vous, qui pour purgatifs ordonnez des venins.	Entrez et prenez place, Parmi les Triailleurs et gens de populace, Gardez-vous d'approcher de ces grands Médecins, Vous, qui pour purgatifs ordonnez des venins.
LE MEDECIN.	LE MÉDECIN.
Eſtant Docteur fourré, comme d’abus i’ap pelle De cet iniuſte Arreſt.	Étant Docteur fourré, comme d'abus j'ap pelle De cet injuste Arrêt.
RADAMANTE.	RADAMANTE.
Vous eſtes vn rebelle, Gardez qu’en repaſſant le fait de point et point, Ie ne vous faſſe ailleurs dégraiſſer le pourpoint :	Vous êtes un rebelle, Gardez qu'en repassant le fait de point et point, Je ne vous fasse ailleurs dégraisser le pourpoint :
On vous met dans le rang des Medecins perfides;	On vous met dans le rang des Médecins perfides;
Mais peut-eſtre on poutra vous joindre aur homicides.	Mais peut-être on poutra vous joindre aur homicides.
LE MEDECIN.	LE MÉDECIN.
Ayant ſuivy toûjours Hipocrate & Galien.	Ayant suivi toujours Hypocrate et Galien.
EACVS.	EACUS.
Eux-meſmes vous diront que vous ne valez rien.	Eux-mêmes vous diront que vous ne valez rien.
CARON avic vne vieillequi ne marche qu’à peins.	CARON avic une vieillequi ne marche qu'à peins.
LA VIEILLE Ah!	LA VIEILLE Ah!
Meſſieurs, les Bourreaux m’ont abrege ma vie, Ces maudits Medecins me l’ont enfin ravie Ie me portois fort bien, i’aurois vécu cent ans.	Messieurs, les Bourreaux m'ont abrège ma vie, Ces maudits Médecins me l'ont enfin ravie Je me portais fort bien, j'aurais vécu cent ans.
CARON.	CARON.
C’eſt de la moitié trop au profit des enfans.	C'est de la moitié trop au profit des enfants.
RADAMANTE.	RADAMANTE.
Quel âge avez-vous donc?	Quel âge avez-vous donc?
LA VIEILLE.	LA VIEILLE.
Ie ſuis dans l’an neuſviéme, Elle touſſe.	Je suis dans l'an neusvième, Elle tousse.
Avec quatre-vingt dix.	Avec quatre-vingt dix.
RADAMANTE.	RADAMANTE.
Falloit voir le centitme, Vous avez bien raiſon, l’on vous a fait grand tort.	Fallait voir le centitme, Vous avez bien raison, l'on vous a fait grand tort.
CARON.	CARON.
Elle vient preſenter ſa requeſte à la mort, neſſe.	Elle vient présenter sa requête à la mort, nesse.
EACVS.	EACUS.
D'où venoit voſtre mal?	D'où venait votre mal?
LA VIEILLE.	LA VIEILLE.
Quittant le laict d’Aneſſe Ie creus mon Medecin, qui ie ne ſçay comment M’obligea de dietter, & vivre ſobrement:	Quittant le lait d'Anesse Je crus mon Médecin, qui était ne sais comment M'obligea de dietter, et vivre sobrement:
Ce que ie fis, helas!	Ce que ici fis, hélas!
Vn grand mal de poitrine Le mit en peu de temps au bout de ſa doctrine.	Un grand mal de poitrine Le mit en peu de temps au bout de sa doctrine.
La conſulte ſe fit avec tout leur ſabat lis conclurent enfin pour ſortir de debat Qque l’Autimoine eſtoit l’infaillible remede:	La consulte se fit avec tout leur sabat lis conclurent enfin pour sortir de bat Qque l'Autimoine était l'infaillible remède:
Entendant ce poiſon, ie crie à l’ayde, à l’ayde, Sortez d’icy Bourreaux, car ie n’en prendrar pas :	Entendant ce poison, ie crie à l'aide, à l'aide, Sortez d'ici Bourreaux, car je n'en prendrar pas :
Pout machiner ma perte, & me mettre icy bar Ils changerent d’avis m’ordonnant autre choſe.	Pout machiner ma perte, et me mettre ici bar Ils changèrent d'avis m'ordonnant autre chose.
Deux grains de Stibion, ſelon la meſme doſe.	Deux grains de Stibion, selon la même dose.
Que ie pourrois moy-meſme infuſer dans le vin Puis que i’avois horreut du remede divin.	Que était pourrais moi-même infuser dans le vin Puis que j'avais horreut du remède divin.
Ie pris ce Stibion, gros comme trois graint d’orge, Et de ma propre main ie me coupay la gorge.	Je pris ce Stibion, gros comme trois graint d'orge, Et de ma propre main ie me coupai la gorge.
La freneſie la prend u ſe tourmentant.	La frénésie la prend se tourmentant.
Il ne fut pas plûtoſt, la, la, la, plus, plus, plus, Non d’a, ie n’iray pas, non, non, non, plus, plus plus.	Il ne fut pas plutôt, la, la, la, plus, plus, plus, Non d'a, Seigneur n'irai pas, non, non, non, plus, plus plus.
CARON.	CARON.
Fort bien, Vieille, fort bien, avec voſtu Antidote, Ie vois ſans deviner que chez vous on radotte, Paſſez donc, s’il vous plaiſt, treve de l’opion.	Fort bien, Vieille, fort bien, avec vos Antidote, Je vois sans deviner que chez vous on radotte, Passez donc, s'il vous plaît, trouve de l'opion.
EACVS.	EACUS.
Autre nouveau venin appellé Stibion, Les mortels à preſent n’ayment que le de fordre.	Autre nouveau venin appelé Stibion, Les mortels à présent n'aiment que le de fordre.
LE MEDECIN.	LE MÉDECIN.
Antimoine & Stiby ſont tous deux d’vn meſme ordre, Ce n’eſt qu’vn purgatif ſous deux noms difſerends.	Antimoine et Stibi sont tous deux d'H mesme ordre, Ce n'est qu'un purgatif sous deux noms diserends.
LA VIEILLE.	LA VIEILLE.
Te voila donc Bourreau, c’eſt donc toy q i’entens,	Te voilà donc Bourreau, c'est donc toi q j'entends,
m’en vay t’eſtrangler.	m'en vais t'étrangler.
Elle court ſur le Medecin,6 Caren la retient.	Elle court sur le Médecin,6 Caren la retient.
EACVS.	EACUS.
Tout beau, maudites Ombres, Apprehendez Plutton, quoy dans ces palaiſombies ?	Tout beau, maudites Ombres, Appréhendez Pluton, quoi dans ces palaisombies ?
Vous voulez vous vanger, & méme devant nous, L’eau du flruue Le thé n’opere point ſur vous, Puis qu’on doit ſur ces bords n’avoir plus de ſnei.	Vous voulez -vous venger, et même devant nous, L'eau du flruue Le thé n'opère point sur vous, Puis qu'on doit sur ces bords n'avoir plus de seine.
CARON.	CARON.
Dans ces lieux comme ailleurs, on ne peut faire boire Vn Aſne, s’il n’a ſoif:	Dans ces lieux comme ailleurs, on ne peut faire boire Un Âne, s'il n'a soif:
celle-cy n’a rien pris, Et c’eſt ce qui luy fait rappeller ſes eſprits;	celle-cy n'a rien pris, Et c'est ce qui lui fait rappeler ses esprits;
Allons, retournons boire, afin qu’on ſe repoſe	Allons, retournons boire, afin qu'on se repose
EACVS.	EACUS.
Allez, retoumnez boire avant toute autre choſe, Parlant au Medecin.	Allez, retoumnez boire avant toute autre chose, Parlant au Médecin.
Et vous, ſon Medecin, comme vn empoiſonneur.	Et vous, son Médecin, comme un empoisonneur.
Noſtre Arreſt vous eſt doux.	Notre Arrêt vous est doux.
LE MEDECIN.	LE MÉDECIN.
Meſſieurs, pour mon honneur, I’ayme mieux à iamais ooffrir comme Tantalle Que d’eſtre Medecin en Troupe Theatralle.	Messieurs, pour mon honneur, J'aime mieux à jamais offrir comme Tantèle Que d'être Médecin en Troupe Théatrale.
EACVS.	EACUS.
Retirez-vous d’icy, contraignez le, Caron	Retirez-vous d'ici, contraignez le, Caron
CARON.	CARON.
Ma foy vous paſſerez ou bien cét Aviron.	Ma foi vous passerez ou bien cet Aviron.
EACVS.	EACUS.
Ce rebelle homicide évitant la potence Veut encore appeller d’vne douce ſentence:	Ce rebelle homicide évitant la potence Veut encore appeler d'une douce sentence:
Qu’il ſoit mis pour vn temps au canton des Bourreaux	Qu'il soit mis pour un temps au canton des Bourreaux
LA VIEILLE.	LA VIEILLE.
Qu’il le merite bien, bon, bon.	Qu'il le mérite bien, bon, bon.
GARON la prenant.	GARON la prenant.
Afin de vous purger.	Afin de vous purger.
Allons aux eaux.	Allons aux eaux.
EACVS.	EACUS.
Aimant d’eſtre vangée, Prés des vindicatifs, qu’elle ſoit donc rangée, Sans paſſer par icy.	Aimant d'être vengée, Près des vindicatifs, qu'elle soit donc rangée, Sans passer par ici.
LA VIEILLE Irommeillant.	LA VIEILLE Irommeillant.
Guion, guion, guion.	Guion, guion, guion.
CARON.	CARON.
Guion, guion, guion, Faut en paſſer par là, voulez-vous de l’oignon, Pour pleurer à voſtre aiſe.	Guion, guion, guion, Faut en passer par là, voulez-vous de l'oignon, Pour pleurer à votre aise.
RADAMANTE parlant à l'Antimeine.	RADAMANTE parlant à l'Antimeine.
Et vous noſtre Emetique, Où vous placerons-nous, petit faux politique, Tirant à coups perdu ſans regarder commentVous vous laſſerez tout, on voit en vn moment Cent Ombres chez Caron, & ſur le bord de l’onde Se plaindre de vos coups qui dépeuplent le monde.	Et vous notre Emétique, Où vous placerons-nous, petit faux politique, Tirant à coups perdu sans regarder commentUous vous lasserez tout, on voit en un moment Cent Ombres chez Caron, et sur le bord de l'onde Se plaindre de vos coups qui dépeuplent le monde.
D’où vous vient cette audace, exerçant cét employ?	D'où vous vient cette audace, exerçant cet emploi?
Avez-vous quelque droit pour donner vne loy?	Avez-vous quelque droit pour donner une loi?
Eſtes-vous vn commis du party de la Parque?	Êtes-vous un commis du parti de la Parque?
CARON r'entre.	CARON rentre.
Meſſieurs, ie ne puis plus me ſervir de ma Barque, I'ay veu la Vieille & moy près de couler à fond, Faut faite, s’il vous plaiſt, comme les autres POIIt  Si l’on n’a pas de quoy m’en fournir vne neuve, Pour la ranetaſſer donnez-moy quelque trêve.	Messieurs, Madame ne puis plus me servir de ma Barque, J'ai vu la Vieille et moi près de couler à fond, Faut faite, s'il vous plaît, comme les autres POIIt Si l'on n'a pas de quoi m'en fournir une neuve, Pour la ranétasser donnez-moi quelque trêve.
RADAMANTE.	RADAMANTE.
Retenant l’Antimoine en ces lieux pour iamais, Curonte poue drepoſer deſorma s:	Retenant l'Antimoine en ces lieux pour jamais, Curonte poue dreposer désorma s:
Tu peux dés à preſent ne paſſer plus perſonne, Pour la recalfeutrer.	Tu peux dès à présent ne passer plus personne, Pour la recalfeutrer.
CARON.	CARON.
Voſtre penſée eſt bonne;	Votre pensée est bonne;
Car ſi vous relaſchiez ce petit Minnidon, Ma foy, ie laiſſerois la Barque à l’abandon.	Car si vous relâchiez ce petit Minnidon, Ma foi, tu laisserais la Barque à l'abandon.
RADAMANTE.	RADAMANTE.
De demeuter icy c’eſt ſon moindre ſupplice, Il faut ſçavoir de plus s’il a quelque complice, Qui pût à ſon abſence aller deſſus ſes pas, Et livret apr s luy les mortels au trépas:	De demeuter ici c'est son moindre supplice, Il faut savoir de plus s'il a quelque complice, Qui pût à son absence aller dessus ses pas, Et livret après si luy les mortels au trépas:
N’avez-vous point en haut la ſſe quelque Confrere?	N'avez-vous point en haut la sse quelque Confre?
qui ſoit de meſme humeur que Monſieur vôtre pere?	qui soit de même humeur que Monsieur votre père?
Répondez.	Répondez.
quoy vous, vous, quoy vous ne dites rien, Et vous hôchez la teſte:	quoi vous, vous, quoi vous ne dites rien, Et vous hôchez la tête:
ha!	ha!
ie reconnois bien Voſtre petit eſprit dans cette humeur rebelle.	Ne reconnais bien Votre petit esprit dans cette humeur rebelle.
CARON.	CARON.
Vrayment vrayment, vrayment, vous me la baillez belle, Mettez-moy dans vn trou pour iamais ce mutin.	Vraiment vraiment, vraiment, vous me la baillez belle, Mettez-moi dans un trou pour jamais ce mutin.
RADAMANTE.	RADAMANTE.
Faudroit auparavant conſulter ce deſtin, Car comm’il eſt iſſu de la celeſte race Peut-eſtre que Plutton luy donneroit ſa grace, Le iugeant comme vn muet.	Faudrait auparavant consulter ce destin, Car comm'il est issu de la céleste race Peut-être que Pluton ici donnerait sa grâce, Le jugeant comme un muet.
CARON.	CARON.
Iugez, iugez touſiours, qu’il ſoit mis dans les ſers, gardez-vous de ſa tours, s’il n’eſt fait priſonnier, il peut à tire d’aiſle Retourner par delà ſans prendre ma Naſſelle;	Jugez, jugez toujours, qu'il soit mis dans les sers, gardez-vous de sa tours, s'il n'est fait prisonnier, il peut à tire d'aile Retourner par delà sans prendre ma Nasselle;
Tous ces Dieux & demy ne valẽt pas trois blans Ie n’ay rien de leur peau, ſont mes paſſevolans.	Tous ces Dieux et demi ne valent pas trois blants Je n'ai rien de leur peau, sont mes passevolants.
Caron, Caron.	Caron, Caron.
On appelle.	On appelle.
CARON.	CARON.
Ceux-là pourront bien faire vn giſle, Car vn vaiſſeau rompu, n’eſt pas refait ſi viſte.	Ceux-là pourront bien faire un gîle, Car un vaisseau rompu, n'est pas refait si viste.
RADAMANTE.	RADAMANTE.
Va donc y travailler.	Va donc y travailler.
CARON.	CARON.
I’y vay Meſſieurs, ſur tous, Si ce drole s’en fuit, il va me mettre à bout, Ie renonce au meſtier.	J'y vais Messieurs, sur tous, Si ce drôle s'en fuit, il va me mettre à bout, Je renonce au métier.
Vous pouvez, s’il vous plaiſt, ambuler à voſtte aiſe, Cal le bag dieprite ſie vay y travailler.	Vous pouvez, s'il vous plaît, ambuler à vostte aise, Cal le bag dieprite sièie vais y travailler.
Parlant au luge en s’en allant.	Parlant au luge en s'en allant.
Gardez que ce Pinon n’aille funerailler.	Gardez que ce Pinon n'aille funérailler.
Il rentre & revient.	Il rentre et revient.
l’eſt là tout mon ſoucy, ie vous le recommande.	l'est là tout mon souci, je vous le recommande.
RADAMANTE.	RADAMANTE.
Pour ne pas debouter Caron de ſa demande, Nous le faut condamner, ainſi que de raiſon, A garder cependant vne eſtroitte priſon.	Pour ne pas débouter Caron de sa demande, Nous le faut condamner, ainsi que de raison, A garder cependant une étroite prison.
Caron coigne derriere le Theatre, tra vaillant à ſon Bag.	Caron coigne derrière le Théâtre, tra vaillant à son Bag.
Et Plutton informé de toute ſa conduitte Pourra bien empeſcher qu’il ne prenne la fuitte, Luy donnant ſeure garde, apres commodement Nous pourtons proceder aux fins de iugement.	Et Pluton informé de toute sa conduite Pourra bien empêcher qu'il ne prenne la fuite, Lui donnant sûre garde, après commodément Nous pourtons procéder aux fins de jugement.
Il rentre, & Caron revient d'vn coſté, & Mereurs apres lay couvert d'vn creſpe en Ombre.	Il rentre, et Caron revient d'un côté, et Mereurs après lay couvert d'un crêpe en Ombre.
Fin du premier Acte.	Fin du premier Acte.
ACTE II.	ACTE II.
CARON.	CARON.
A foy Meſſieurs, voyez, ma pochette eſt Mr gués, Mon argent eſt perdu, me faut avoir du cloud Perſonne ne répond, la peſte, ie ſuis fou, Tout le monde eſt party.	À foi Messieurs, voyez, ma pochette est Mr guz, Mon argent est perdu, me faut avoir du cloud Personne ne répond, la peste, Seigneur est fou, Tout le monde est parti.
MERCVRE taſtonnant.	MERCURE tâtonnant.
Où ſuis-ie donc bon homme Ie ne voy goutteicy.	Où suis-je donc bon homme Je ne vois goutteici.
CARON.	CARON.
Voila tout ainſi comme Ce chien de Partiſan, qui paſſe ſans payer.	Voilà tout ainsi comme Ce chien de Partisan, qui passe sans payer.
MERCVRE.	MERCURE.
Ie viens à petit bruit pour ne pas t’effrayer, Es-tu le Nautonnier de la cruelle Parque?	Je viens à petit bruit pour ne pas t'effrayer, Es-tu le Nautonnier de la cruelle Parque?
CARON.	CARON.
Oüy, Monſieur, ie le ſuis, & Nautonnier ſans Barque:	Oui, Monsieur, Madame le suis, et Nautonnier sans Barque:
Vn ieune jouvenceau, fils de pere incertain ue ie pourrois quaſi nommer fils de putain, M’a fait depuis trois mois plus faire l'exet- cice qu’en dix ans tous entiers.	Un jeune jouvenceau, fils de père incertain ue ie jais quasi nommer fils de putain, M'a fait depuis trois mois plus faire l'exét- ce qu'en dix ans tous entiers.
MERCVRE.	MERCURE.
Pour te rendre iuſtice, -je ſçavoir ſon nom, ie le feray punir?	Pour te rendre justice, -je savoir son nom, où le ferai punir?
CARON.	CARON.
On n’en parlera plus, ie m’en vay rajeunir, n Medecin fourré pour guerir tout le monde ous a livré par coips, ce petit chef de fronde ui giſt dans nos priſons pour vne bonne fois.	On n'en parlera plus, ie m'en vais rajeunir, n Édecin fourré pour guérir tout le monde ous à livré par coips, ce petit chef de fronde ui gît dans nos prisons pour une bonne fois.
MERCVRE.	MERCURE.
duu nom.	du nom.
CARON.	CARON.
C’eſt l’Antimoine.	C'est l'Antimoine.
MERCVRE.	MERCURE.
Hé!	Hé!
bon homme, tu crois Que cét enfant des Dieux, conduit dans l’innocence, Demeurera chez vous ſans appel de ſentence?	bon homme, tu crois Que cet enfant des Dieux, conduit dans l'innocence, Demeurera chez vous sans appel de sentence?
os luges ſeulement ont droit ſur les humains, Que le deſtin fatal leur livre entre les mains;	os luges seulement ont droit sur les humains, Que le destin fatal leur livre entre les mains;
Mals d’arreſter vn Dieu ſans ordie, & par contrainte, eſt aſſez attenter?	Mals d'arrêter un Dieu sans ordie, et par contrainte, est assez attenter?
CARON.	CARON.
Oſes-tu bien ſans crainte ſonſieur, qui que tu ſois, nous menaſſer icy?	Oses-tu bien sans crainte sonsieur, qui que tu sois, nous menacer ici?
fais le Rodomont, ie rodomonte auſſi, te dis en vn mot que parlant de la ſorte e feray paſſer par la petite porte loger avec luy.	fais le Rodomont, votre rodomonte aussi, te dis en un mot que parlant de la sorte e ferai passer par la petite porte loger avec lui.
MERCVRE.	MERCURE.
Caron, tut es mépris, Enviſage-moy bien, rapelle tes eſprits, Tu me prens pour vn autre.	Caron, tut es mépris, Envisage-moi bien, rappelle tes esprits, Tu me prends pour un autre.
CARON Ah non, ſans me méprendre Ie te connois fort bien;	CARON Ah non, sans me méprendre Je te connais fort bien;
ce que ie viens d’entendre Sent fort ſon Medecin, qui court le Stibion.	ce que ici viens d'entendre Sent fort son Médecin, qui court le Stibion.
Depuis que nous avons ce fameux champion, Nous voyons venir drud ſes mouches à la rûche Gayes comme porteurs d’eau, qui n’ont nylſceas ny cruche.	Depuis que nous avons ce fameux champion, Nous voyons venir drud ses mouches à la ruche Gayes comme porteurs d'eau, qui n'ont nylsceasrit cruche.
Faute de Scibion ils meurent tous de faim.	Faute de Scibion ils meurent tous de faim.
MERCVRE.	MERCURE.
Ie ne raiſonne plus, ça donne-moy la main Pour marcher dans ces lieux, ie ne peux m conduire Ne voyant que broüillards.	Je ne raisonne plus, ça donne-moi la main Pour marcher dans ces lieux, ie ne je ne peux Ne voyant que broüillards.
CARON ſe reculant oſte ſon bonnet.	CARON se reculant ôte son bonnet.
Vous n’avez rien qu’à dire Monſieur, où logez-vous, on vous le portera?	Vous n'avez rien qu'à dire Monsieur, où logez-vous, on vous le portera?
Il n’eſt ma foy pas ſot, il s’apprivoiſera Ce beſon ſort du nid, & dans ſon humeu niaiſe Il luy faut des valêts pour marcher à ſon aiſe:	Il n'est ma foi pas sot, il s'apprivoisera Ce beson sort du nid, et dans son humeu ni Il a faut des valêts pour marcher à son aise:
Vous falloit en partant, Monſieur le Medecin, Prendre en croupe avec vous quelqu’autre Car rabin, Qui portant vos faiſſeaux n’ayant plus voſtr mule, Il euſt fait faire place avec vne ſpatule, Et vous auriez au nez pû ſuivre gravement Voſtre Maſſe à Bedeau.	Vous fallait en partant, Monsieur le Médecin, Prendre en croupe avec vous quelqu'autre Car rabin, Qui portant vos faisseaux n'ayant plus vostr mule, Il eût fait faire place avec une spatule, Et vous au au nez pu suivre gravement Votre Masse à Bedeau.
L’eſtuy du lavement.	L'est du lavement.
MERCE	MERCE
MERCVRE.	MERCURE.
Allons ſans diſcourir, il eſt temps de ſe taire, Conduis-moy ieuiement.	Allons sans discourir, il est temps de se taire, Conduis-moi jeuiement.
CARON ſe recule & leve l'Aviron.	CARON se recule et leve 'Aviron.
Et va te faire faire Des conducteurs ailleurs, commande à tes valets.	Et va te faire faire Des conducteurs ailleurs, commande à tes valets.
MERCVRE le prend au collet.	MERCURE le prend au collet.
Ie ne viens pas icy pour danſer des Ballets, Marche.	Je ne viens pas ici pour danser des Ballets, Marche.
CARON crieAu voleur Plutton, Eacus, Radamante, A moy, ie ſuis perdu, la rage me tourmente, Volme pauvie Noener vatuer à la fin, Eſtant entre les mains de ce faux Medecin.	CARON crieAu voleur Pluton, Eacus, Radamante, À moi, sans suis perdu, la rage me tourmente, Volme pauvie Noener vatuer à la fin, Étant entre les mains de ce faux Médecin.
On appeule.	On appeule.
PLVTTON arriue, & Caron paroit immobils comme vne ſtatuë.	PLUTON arrive, et Caron parait immobils comme une statue.
Ayant eu pour partage Ces lleux inhabitez, ſans nul autre advantage, Mes ainez en repos contentent leurs deſirs, Et moy dans l’embartas éloigné des plaiſirs ſe redouble mes ſoins pour eſtablit quelqu’ordre, Et plus ie vais avant, & plus i'ay de deſordre:	Ayant eu pour partage Ces louleux inhabités, sans nul autre avantage, Mes aîné en repos contentent leurs désirs, Et moi dans l'embartas éloigné des plaisirs se redouble mes soins pour établit quelqu'ordre, Et plus jour vais avant, et plus j'ai de désordre:
Mes freres cependant gardent les doux objets, Et i’ay tout le rebut de leurs maudits ſujets;	Mes frères cependant gardent les doux objets, Et j'ai tout le rebut de leurs maudits sujets;
Ils tirent de leur peau leurs plaiſirs & delices, Et ſous vn calme faux les crimes & les vices, Courent de toutes parts pour eſtre moins vnis, It pour vn qu’on eſteint mille ſont impunis.	Ils tirent de leur peau leurs plaisirs et délices, Et sous un calme faux les crimes et les vices, Courent de toutes parts pour être moins unis, It pour un qu'on éteint mille sont impunis.
On appells.	On appels.
C iij Coron, Caron, Caron.	Ç iij Oron, Caron, Caron.
PLVTTON.	PLUTON.
Notonnier on t’appelle D'où vient que ce vieillard a quitté ſa naſſelle?	Notonnier on t'appelle D'où vient que ce vieillard a quitté sa nasselle?
Vn de la ſuitte de Plutton reIl eſt donc immobile, il ne nous répond rien, Parle Donc.	Un de la suite de Pluton rel est donc immobile, il ne nous répond rien, Parle Donc.
Plutton le touchant de ſon Sceptre.	Pluton le touchant de son Sceptre.
CAR ON ſe réveillant.	CAR ON se réveillant.
Ah!	Ah!
grand Roy, ce pauvre Galeries Pour s’eſtre declaré d’Antimoine heretique De prude en vn moment eſt venu frenetique.	grand Roi, ce pauvre Galeries Pour s'être déclaré d'Antimoine hérétique De prude en un moment est venu frénétique.
LVTTON.	LUTON.
Que dis-tu, parle mieux, car ie ne t’entend pas.	Que dis-tu, parle mieux, car ainsi ne t'entend pas.
CARON.	CARON.
Ce Bourreau ne pouvant me reduire au trépas, M’a ietté dans le nez quelque poudre aſſez fine, Et ſans ſçavoir comment, i’auray pris medecine.	Ce Bourreau ne pouvant me réduire au trépas, M'a jeté dans le nez quelque poudre assez fine, Et sans savoir comment, j'aurai pris médecine.
PLVTTON parlant à Mer cure inconnu.	PLUTON parlant à Mer cure inconnu.
Comment, dans mon Palais atraquer mon pouvoir?	Comment, dans mon Palais atraquer mon pouvoir?
Ah!	Ah!
Medecin fatal, en faiſant mon devoir, Comme vn autre Ixion tu ſeras ſur la rouë, Allons, prenez-le-moy.	Medecin fatal, en faisant mon devoir, Comme un autre Ixion tu seras sur la roue, Allons, prenez-le-moi.
MERCVRE à part.	MERCURE à part.
Quelque foux qui s’y ioué, Allons, découvrons nous, paroiſſons, il eſt temps, le n’aymerois pas trop ce joly paſſe-temps, oſtant ſon voile & prenant ſon Calucée.	Quelque foux qui s'y joué, Allons, découvrons nous, paraissons, il est temps, le n'aimerais pas trop ce joli passetemps, ôtant son voile et prenant son Calucée.
Gond Roy des antres noirs	Gond Roi des antres noirs
PLVTTON.	PLUTON.
Quoy voir icy Mercure.	Quoi voir ici Mercure.
CARON.	CARON.
Ah!	Ah!
le ruſé demon.	le rusé démon.
MERCVRE.	MERCURE.
L’iniuſte procedure Que l’on exerce icy contre vn ieune innocent M’empeſchoit de paroiſtre en mon habit decent, rainte qu’eſtant connu parent de cét eſclave On ne le fiſt cacher an muay de quelque cave, t qu’on nous dit après, que nous demandezvous?	L'injuste procédure Que l'on exerce ici contre un jeune innocent M'empêchait de paraître en mon habit décent, rainte qu'étant connu parent de cet esclave On ne le fît cher an muai de quelque cave, t 'on nous dit après, que nous demandezvous?
lous ne l’avons point veu	lous ne l'avons point vu
PLVTTON.	PLUTON.
Voſtre parent chez nous?	Votre parent chez nous?
MERCVRE.	MERCURE.
6 Oüy, grand Roy, l’Antimoine a Saturne pour Perc, ie viens de ſa part vous expoſer l’affaire, it obtenir de vous ſa iulle liberté.	6 Oui, grand Roi, l'Antimoine a Saturne pour Perc, sans viens de sa part vous exposer l'affaire, it obtenir de vous sa julle liberté.
CARON.	CARON.
Mereure devient bon, il a bien concerté vec les Medecins, n’aymant que les perſides,  chef de grands voleurs il paſſe aux homicides.	Mereure devient bon, il a bien concerté vec les Médecins, n'aimant que les persides, chef de grands voleurs il passe aux homicides.
7 PLVTTON.	7 PLUTTON.
L’on m’a déja parlé de ce pecit mutin renverſe luy ſeul les forces du deſtin, Il met impunément tout le monde par terre, Et fait à petit bruit vne ſanglante guerre, Saturne eſtant fort loin ne bleſſe qu’à demy;	L'on m'a déjà parlé de ce pécit mutin renverse lui même les forces du destin, Il met impunément tout le monde par terre, Et fait à petit bruit un sanglante guerre, Saturne étant fort loin ne blesse qu'à demi;
Mais pour achever tout, ce cruel ennemy.	Mais pour achever tout, ce cruel ennemi.
Couvert du vieux manteau du bon pere Sileine Prend le monde au collet, & leur fait perdi haleine, Il vous les pouſſe à bout, & par haut & p bas, Sous vne ſanté feinte, on les meine au trépas.	Couvert du vieux manteau du bon père Sileine Prend le monde au collet, et leur fait perdi haleine, Il vous les pousse à bout, et par haut et p as, Sous une santé feinte, on les mène au trépas.
Iupiter cependant, & tous tant que nous ſom mes, Nous perdons nos Eſtats, ſi nous perdons le hommes.	Jupiter cependant, et tous tant que nous som mes, Nous perdons nos États, si nous perdons le hommes.
Nous voyons chaque iour deſerter nos Autels, Et nous n’en aurons plus n’ayant plus de moi tels, Pour avoir des toiſons il faut conſerver l’oüaille Et ſi l’on veut des paux faut prendre la racaille,	Nous voyons chaque jour déserter nos Autels, Et nous n'en aurons plus n'ayant plus de moi tels, Pour avoir des toisons il faut conserver l'aille Et si l'on veut des paux faut prendre la racaille,
CARON.	CARON.
Mercure entendez-vous.	Mercure entendez-vous.
MERCVRE.	MERCURE.
Sans paroitre interde Si l’on veut m’écouter, tout ce qu’on voa dit Paroiſtra comme il eſt, c'eſt à dire vn me ſonge:	Sans paraître interde Si l'on veut m'écouter, tout ce qu'on voa dit Paraîtra comme il est, c'est à dire un me songe:
Des cœurs envenimez que la vengeance rong Trouvent toujours dequoy pouſſer vn aut à bout, Et pour ſe bien vanger, on fait argent tout.	Des cœurs envenimez que la vengeance rong Trouvent toujours dequoy pousser un aut à bout, Et pour se bien venger, on fait argent tout.
Ie me viens d’informer en paſſantaux écol ue certains Medecins ont trouvé cent bricoles Parmy leuts differends, & par bonne raiſon ay veu que la pluſpart n’en font point vn poiſon, I paroit en public, i’ay veu ſes privileges.	Je me viens d'informer en passantaux écol ue certains Médecins ont trouvé cent bricoles Parmi luts différends, et par bonne raison ai vu que la plupart n'en font point un poison, I parait en public, j'ai vu ses privilèges.
PLVTTON Ceux donc qui par faveur feroient des ſor tileges, Doivent paſſer pour bons, quoyque toûjours mauvais?	PLUTON Ceux donc qui par faveur feraient des sor tilèges, Doivent passer pour bons, quoique toujours mauvais?
6 Caron, Caron, Caron.	6 Caron, Caron, Caron.
On appelle.	On appelle.
1	1
CARON.	CARON.
C.	Ç.
a, ça, ça, ie m’en vais, Mais à propos, grand Roy, le débiis de ma Naſſe, Empeſche deſormais qu’aucune Ombre ne paſſe.	a, ça, ça, Seigneur m'en vais, Mais à propos, grand Roi, le débiis de ma Nasse, Empêche désormais qu'aucune Ombre ne passe.
PLVTTON.	PLUTON.
Hé, tu demeures-là.	Hé, tu demeures-là.
CARON.	CARON.
Ie ne peux travailles, Si du coffre d’épargne on ne me fait baiſler Quelque ſomme d’argent pour la remettre en ordre.	Je ne peux travailles, Si du coffre d'épargne on ne me fait baisler Quelque somme d'argent pour la remettre en ordre.
PLVTTON.	PLUTON.
Ie ne prux faire vn pas ſans voir quelque deſordre;	Je ne prux faire un pas sans voir quelque désordre;
Quoy, tu n’as pas d’argent pour avoir quelques cloux!	Quoi, tu n'as pas d'argent pour avoir quelques cloux!
CARON monεrant ſa poche I’en avois, il eſt vray, mais vous voy les tious Par où tout s’eſt coulé du profond de n pochet	CARON monεrant sa poche J'en avais, il est vrai, mais vous vois les tious Par où tout s'est coulé du profond de n ochet
PLVTTON.	PLUTON.
Caron nous cache là quelque anguille roche, Dis plûtoſt que Caron cherche à ſe repoſer, Et plutton pourroit bien peut eſtre diſpoſer De ce droit pour vn autre.	Caron nous cache là quelque anguille roche, Dis plutôt que Caron cherche à se reposer, Et pluton pourrait bien peut être disposer De ce droit pour un autre.
CARON.	CARON.
’Et pour ma recompenſ Voila donc mon brevet?	’Et pour ma recompens Voila donc mon brevet?
Ah!	Ah!
la belle ſentence Quelle iniuſtice, ô Dieux!	la belle sentence Quelle injustice, ô Dieux!
quoy, le grand Ro Plutton Ne redouteroit pas quelque grand dira-t’on?	quoi, le grand Ro Pluton Ne redouterait pas quelque grand dira-t-on?
Apres avoir moy ſeul exercé vingt offices, Mener les criminels aux lieux de leurs ſupplices, Paſſer & repaſſer le ſleuve à ous momens, Faire l’introducteur, & l’homme aux conplimens, 1 Eſtre Huiſſier au Parquet, Advocat, Secretaire, Greffier accuſateur, & ie me pourrois taire?	Après avoir moi seul exercé vingt offices, Mener les criminels aux lieux de leurs supplices, Passer et repasser le slève à ous moments, Faire l'introducteur, et l'homme aux conpliments, 1 Estre Huissier au Parquet, Aduocat, Secrétaire, Greffier accuser, et Seigneur me pourrais taire?
Quoy, dans l’âge où ie ſuis apres vn ſi lon temps, Non, ie n’en feray rien, le joly paſſetemps.	Quoi, dans l'âge où tu suis après un si lon temps, Non, ie j'en ferai rien, le joli passetemps.
PLVTTGN.	PLUTTGN.
De tous ces beaux emplois, le droit de bat telage.	De tous ces beaux emplois, le droit de bat telage.
117	117
MERCVRE.	MERCURE.
La iuſtice eſt icy comme dans vn village, In ſeul Baillif fait tout.	La justice est ici comme dans un village, In seul Baillif fait tout.
01 LVTON.	01 LUTON.
22 Suffit pout vn vieillard, puoy donc.	22 Suffit pout un vieillard, puoi donc.
l’on fait chez moy comme dans Vaugirard ?	l'on fait chez moi comme dans Vaugirard ?
2 uoy, dans mon Paclement, pour rendre la iuHice C1 16IR Va ſeul homme fait tout?	2 oi, dans mon Paclement, pour rendre la juHice C1 16IR Va seul homme fait tout?
Caron, ton avarice.	Caron, ton avarice.
’auſe tout ce deſordre:	Çàuse tout ce désordre:
où peut-on avoit mis es Huiſſiers, les Creffiers, Advocats & comar rouvez-moy Radamante, & qu’il vienne ſur I'heure, D ue Caron cependant retourne en ſa demeure, hclomene plarder maffes d’autruy, qu’il mette en eſtat ſa Naſſelle aujourd’huy.	où peut-on avait mis es Huissiers, les Creffiers, Advocats et comar rouvez-moi Radamante, et qu'il vienne sur J'heure, D' ue Don cependant retourne en sa demeure, hclomene plarder maffes d'autrui, qu'il mette en état sa Nasselle aujourd'hui.
MERCVRE.	MERCURE.
Vous eſtes mal ſeruy.	Vous êtes mal servi.
10	10
PLVTTON.	PLUTON.
1 Ie n’y ſçaurois que faire, n ne peut eſtablir aucun ordre en ces lieux, ctoyois que mes gens s’en acquitteroient mieux, es ayant retranchez & de nombre & de gages, deſſein d’arreſter leur grand libertinage;	1 Je n'y saurais que faire, n' a peut établir aucun ordre en ces lieux, ctoyais que mes gens s'en acquitteraient mieux, es ayant retranchés et de nombre et de gages, dessein d'arrêter leur grand libertinage;
pin de les rappeller à faire leur devoir.	pin de les rappeler à faire leur devoir.
jacun ſe divertit, & de tout ſon pouvoir.	jacun se divertit, et de tout son pouvoir.
ſtant le bois du feu, c’eſt le mettre à l’extreme ;	stant le bois du feu, c'est le mettre à l'extrême ;
ais pour petit qu’il ſoit, il eſt toûjours le meſme	ais pour petit qu'il soit, il est toujours le même
Radamante arrive.	Radamante arrive.
PLVTTON.	PLUTON.
Ie vois tout en deſordre, d’ou vient qu battellier Fait paſſer ce Palais comme ſon attellier?	Je vois tout en désordre, d'ou vient qu' attellier Fait passer ce Palais comme son attellier?
Vn ruſtre, vn Matelot qui ne ſçauroit pas lire, Se dit eſtre Advocat en cét illuſtre Empire:	Un rustre, un Matelot qui ne saurait pas lire, Se dit être Advocat en cet illustre Empire:
C’eſt ſe mocquer de moy, la moitié de me gens Ne ſont que Procureurs, Advocats ou Sergens, Greffiers, Solliciteurs, cent mille de leur ſorte Si ie n’en avois mis la pluſpait à la porte Tout mon Royaume enfin n’euſt eſté procez.	C'est se moquer de moi, la moitié de me gens Ne sont que Procureurs, Adocats ou Sergents, Greffiers, Solliciteurs, cent mille de leur sorte Si tu n'en avais mis la pluspait à la porte Tout mon Royaume enfin n'eût été procès.
RADAMANTE.	RADAMANTE.
En peu de mots, grand Roy, vous ſçaurti ce que c’eſt;	En peu de mots, grand Roi, vous saurti ce que c'est;
Depuis deux ou trois mois que le vin Eme tique:	Depuis deux ou trois mois que le vin Eme tique:
Nous a fait dans ces lieux redoubler la pra tique, D’vne Chambre au Conſeil nons en avons fat trois, Afin d’examiner tant de monde à la fois;	Nous a fait dans ces lieux redoubler la pra tique, D'une Chambre au Conseil nons en avons fat trois, Afin d'examiner tant de monde à la fois;
A moins de reſtablir les charges que l’on caſſe, Faudra pour quelque temps qu’aucun mortel ne paſſe;	À moins de rétablir les charges que l'on casse, Faudra pour quelque temps qu'aucun mortel ne passe;
Car nous ne ſçaurions ſeuls en venir bien bout.	Car nous ne saurions seuls en venir bien bout.
PLVTTON.	PLUTON.
Ce petit Mirmidon euſt enfin gâté tout.	Ce petit Mirmidon eût enfin gâté tout.
RADAMANTE.	RADAMANTE.
Quoy qu’il ſoit priſonnier par l’effort de ſe charmes Malgré tous vos ſoldats, vos gardes, vos gensd’armes, I court icy par tout, les ayant mis à bas.	Quo qu’il soit prisonnier par l'effort de se charmes Malgré tous vos soldats, vos gardes, vos gensd'armes, I court ici par tout, les ayant mis à bas.
PLVTTON.	PLUTON.
Faites le moy venir, allez-y de ce pasveux le voir de prés pour en faire iuſtice.	Faites le moi venir, allez-y de ce pasveux le voir de près pour en faire justice.
MERCVRE.	MERCURE.
De croire qu’vn enfant, quoyque plein de malice, uiſſe ainſi ſurmonrer tant de ſoldats armez.	De croire qu'un enfant, quoique plein de malice, uisse ainsi surmonrer tant de soldats armés.
PLVTTON.	PLUTON.
Il l’a fait ſans combat puis qu’il les a charmez.	Il l'a fait sans combat puis qu'il les a charmez.
On ameine le Medecin qui avoit amené l’Antimoine.	On âmeine le Médecin qui avait amené l'Antimoine.
EACVS.	EACUS.
Grand Roy, voicy l’autheur de la mutinerie, 'oicy le Medecin de l’antimoinerie, ui par vn iuſte Arreſt, comme vn homme de ſang, evoit près des cruels garder le premier rang.	Grand Roi, voici l'auteur de la mutinerie, ' oici le Médecin de l'antimoinerie, ui par un juste Arrêt, comme un homme de sang, euait près des cruels garder le premier rang.
ans reſpecter vos loix il eſt d’intelligence lyec le Stibyon, & comme par vengeance la font les vagabonds ſans garder leur détroit.	ans respecter vos lois il est d'intelligence liec le Stibyon, et comme par vengeance la font les vagabonds sans garder leur détroit.
PLVTTON.	PLUTON.
Il faut à ſes dépens le loger à l’étroit, t tiouver cependant quelque nouveau ſupplice, our payer l’intereſt de ſa noire malice:	Il faut à ses dépens le loger à l'étroit, t tiouver cependant quelque nouveau supplice, our payer l'intérêt de sa noire malice:
purquoy nous amener du poiſon icy bas?	purquoy nous amener du poison ici bas?
LE MEDÉCIN Voulant prouver ainſi que ce n’en eſtoit pas, Vos luges animez m’ont fait vne querelle, Et iugé malgré moy comme ennemy rebelle;	LE MEDÉCIN Voulant prouver ainsi que ce n'en était pas, Vos luges animés m'ont fait une querelle, Et jugé malgré moi comme ennemi rebelle;
I’ay reſiſté d’abord pour mon rang de Docteus Qui ne peut compatir avec celuy d’Acteur:	J'ai résisté d'abord pour mon rang de Docteus Qui ne peut compatir avec celui d'Acteur:
On me fait ſans raiſon paſſer pour Empirique, Ayant pris le party du Divin Emetique, D’vn enfant innoc̈ent, d’vn remede à tou maux,0 Et pour recompenſer nos penibles travaux On nous punit tous deux, n’eſt-ce pas contre l’ordre?	On me fait sans raison passer pour Empirique, Ayant pris le parti du Divin Émetique, D'un enfant innocent, d'une remède à tou maux,0 Et pour récompenser nos pénibles travaux On nous punit tous deux, n'est-ce pas contre l'ordre?
2	2
PLVTTON.	PLUTON.
Non, c’eſt vous faire grace apres vn ta deſordre.	Non, c'est vous faire grâce après un ta désordre.
On amene l’Antimoine lié & garrotil Plutton ſe ſied, Mercure à coſté di luy, & Eacus ſe tiont débout pus faire le recuſateur.	On amène l'Antimoine lié et garrotil Pluton se sied, Mercure à côté dieau, et Éacus se tiont débout pus faire le recusateur.
Voila noſtre mutio, quoy petit champignon, Vous venez donc chez moy faire le compagnon Vous culbuttez mes gens ſans redouter leu Maiſtre, Ho, ho, ho, ie vois bien qu’il faut faire nroiſtre Quel eſt noſtre pouvoir, parlez donc, s’il vou plaiſt?	Voilà votre mutio, quoi petit champignon, Vous venez donc chez moi faire le compagnon Vous culbutés mes gens sans redouter le Maître, Ho, Ho, ho, Seigneur vois bien qu'il faut faire naître Quel est notre pouvoir, parlez donc, s'il vou plaît?
Il hoche la teſte.	Il hoche la tête.
MERCVRE.	MERCURE.
1 La, la, petit couſin ne fais point le benaiſt, Eſtant pris & repris, pour ſortir faut répondre.	1 La, la, petit cousin ne fais point le benaist, Étant pris et repris, pour sortir faut répondre.
Il hoche la teſte encore,	Il hoche la tête encore,
L EACVS.	 LACUS.
Nous avons des témoins qui le pouriont cofondre P.	Nous avons des témoins qui le pourriont cofondre P.
Par les maux qu'n a faits	Par les maux qu'n a faits
LE MEDECIN.	LE MÉDECIN.
Iamois il n’en a fait, Et ſi l’on doit iuger la rauſe par l’effet, Ne faiſant que du bien, ſon eſſence eſt fort bonne.	Jamais il n'en a fait, Et si l'on doit juger la rausse par l'effet, Ne faisant que du bien, son essence est fort bonne.
1 A	1 A
112 EACVS.	112 ÉCUS.
Parmy vos Medecins on ne trouve perſonne Qui diſe qu’il ſoit bon, niſi par accident.	Parmi vos Médecins on ne trouve personne Qui dise qu'il soit bon, nis par accident.
LE MEDECIN.	LE MÉDECIN.
S’il eſt entre les mains d’vn Medecin prudent, oyant reduit par art en l’eſtat qu’il doit eſtre on en peut au beſoin faire des coups de Maiſtre.	S'il est entre les mains d'état Médecin prudent, oyant réduit par art en l'état qu'il doit être on en peut au besoin faire des coups de Maître.
EACVS.	EACUS.
On n’en a que trop fait au profit d’Atropos.	On n'en a que trop fait au profit d'Atroppos.
LE MEDECIN.	LE MÉDECIN.
Pour ne pas m’eſloigner, il faut à ce propos, echercher ſes Autheuis, & qu’elle eſt ſa nature, Le divin Hipocrate en a fait la peinture, Lors qu’il nous l’a preſcrit pour le Miſereré Marcobe dit de luy qu’il n’a iamais erré:	Pour ne pas m'éloigner, il faut à ce propos, echercher ses Autheuis, et qu'elle est sa nature, Le divin Hipocrate en a fait la peinture, Lors qu'il nous l'a prescrit pour le Miséreré Marcobe dit de belle qu'il n'a jamais erré:
Donc s’il s’en eſt ſervy ſuivant ſa diſcipline, On le doit prendre auſſi comme Décritipline, oubs le nom de Stiby ſurnommé Tetragon, it d’vn peu d’arſenic le plus fin d’Aragon, eur ſoulſre, vn peu de ſel, Mereure Metallique, e tout mis en quarré guerit de la colique, non pas d’aujourd’huy, mais depuis deux mille ans  i Galien le met apres parmy les Aſtringeans Pour les yeux fiſtulez, & pour les vieur ceres.	Donc s'il s'en est servi suivant sa discipline, On le doit prendre aussi comme Décritipline, oubs le nom de Stibi surnommé Tetragon, it d'un peu d'arsenic le plus fin d'Aragon, eur soulsre, un peu de sel, Mère Metallique, tout mis en quarré guérit de la colique, non pas d'aujourd'hui, mais depuis deux mille ans y Jalien le met après parmi les Astringeans Pour les yeux fîtulez, et pour les vieur ceres.
EACVS.	EACUS.
Le ſeul nom d’Arſenic gaſtera vos ffaires, Et vous ne pouvez plus prouver ſans embains Qu’on pût guerir vn homme avec la me aux rats.	Le seul nom d'Arsenic gâtera vos saires, Et vous ne pouvez plus prouver sans embains Qu'on pût guérir un homme avec la me aux rats.
LE MEDECIN.	LE MÉDECIN.
Il n’eſt plus mort aux rats eſtant dans, phiole, Si nous en rapportors à ce ſçavant Mathiolle.	Il n'est plus mort aux rats étant dans, phiole, Si nous en rapportors à ce savant Mathiolle.
C’eſt, dit ce grand Autheur, c’eſt là la m de Dieu.	C'est, dit ce grand Auteur, c'est là la m de Dieu.
EACVS.	EACUS.
C’eſt donc lors qu’Attila fit poſſer en u lieu La moitié des mortels.	C'est donc lors qu'Attila fit posser en u lieu La moitié des mortels.
LE MEDECIN.	LE MÉDECIN.
Le grand'diſcorde Sous le nom de Steimy.	Le grand'discorde Sous le nom de Steimi.
EACVS.	EACUS.
Vous eſles vn perfide, Et vos diſcours trompeurs ſont ſans difficulté Contre voſtre Factum, puis que la faculté L’a proclamé veuin, & ſous ce fameux tiltre Il a paru ſeize ans couché dans le Regiſtre, Et l’on veut aujourd’huy ſans le changor e rien, Que ce qui fut vn mal devienne vn tres grand bien :	Vous éles un perfide, Et vos discours trompeurs sont sans difficulté Contre votre Factum, puis que la faculté L'a proclamé veuin, et sous ce fameux titre Il a paru seize ans couché dans le Registre, Et l'on veut aujourd'hui sans le changor e rien, Que ce qui fut un mal devienne un très grand bien :
Milgté ce d'ſtinguo preterté d’ignorance n découvre d’abord l’inepte difference, omme ſi le Statut contraire à celuy-cy ’ad reſſoit pour lors aux Medecins auſſi.	Milgté ce d'stinguo préterté d'ignorance n découvre d'abord l'inepte différence, omme si le Statut contraire à celui-cy ad ressait pour lors aux Médecins aussi.
PLVTTON.	PLUTON.
Il luy faut confionter ſon grand Maiſtre Hipocratte, u’on le faſſe venir	Il a faut confionter son grand Maître Hypocratte, on le fasse venir
MERCVRE.	MERCURE.
Il eſt pris par la patte, ce grand Medecin n’eſt pas de ſon advis, on Couſin Stibyon par forme de devis tes-nous quelque choſe!	Il est pris par la patte, ce grand Médecin n'est pas de son avis, on Cousin Stibyon par forme de devis tes-nous quelque chose!
avez-vous donc envie e demures icy rla Maman vous convie, voſtre bon Papa de tevenir chez vous Il hoche la teſte.	avez-vous donc envie est demures ici ra Maman vous convie, votre bon Papa de tevenir chez vous Il hoche la tête.
ame ſi vous voulez toûjours faire les fous, vay vous laiſſer là, t nez voyez la lettre ue m’on Onele m’eſcrit Il la repouſſe.	âme si vous voulez toujours faire les fous, vais vous laisser là, tnez voyez la lettre écrit Il la One m'écrit Il la repousse.
PLVTTON.	PLUTON.
Ca, nous le faut remettre, faut faire enfermer & garder ſeurement, r'on ne pourra pas le dompter autrement.	Ça, nous le faut remettre, faut faire enfermer et garder sûrement, ron ne pourra pas le dompter autrement.
EACVS.	EACUS.
Vos gardes periront, tous ceux de ſentinellent le crane vuide, chacun eſt ſans ſervelle les a tous perdus.	Vos gardes périront, tous ceux de sentinellent le crane vid, chacun est sans servelle les a tous perdus.
PLVTTON.	PLUTON.
Que faire donc de luy?	Que faire donc de soins?
toyant relâché, pour paſſer ſon ennuy va me broüiller tout s’il retourne ſur terre.	toyant relâché, pour passer son ennui va me brouiller tout s'il retourne sur terre.
Il recommencera toûjours la meſme guerre, s’il n’oſte de ſon corps tout le maudit venin Parlant à Hipocrace qui arrive, Nous ſommes ſur le ſujet du remede benin, Que vous avez trouvé ſoubs le nom d’Eme dique.	Il recommencera toujours la même guerre, s'il n'ôte de son corps tout le maudit venin Parlant à Hypocrace qui arrive, Nous sommes sur le sujet du remède bénin, Que vous avez trouvé sous le nom d'Eme dique.
110	110
HIPOCRATTE.	HIPOCRATTE.
Aphoriſme Grec expliqué en François	Aphorisme Grec expliqué en Français
pour l'entindre.	pour l'entindre.
Ie tuë en purgeant trop viſte, & ce qui artis tout à coup eſt ennemy de la nature, mais t qui ſe fait peu à peu eſt plus aſſeuré.	Je tuë en purgeant trop vite, et ce qui artis tout à coup est ennemi de la nature, mais t qui se fait peu à peu est plus assuré.
Mercatarſi apoctinè garte pole efiridion, te fuût polemion, gar de olipon aſgalís.	Mercatarsi apoctinè garte pôle éfiridion, te fût polemion, gar de olipon asgalís.
MERCVRE.	MERCURE.
Voila parler aſſez, en termes de pratique,	Voilà parler assez, en termes de pratique,
PLVTTON.	PLUTON.
Ne nous arreſtons point aux termes de voſtre ait.	Ne nous arrêtons point aux termes de votre ait.
141 1 Mais en diſ-ours communs découvrez nous ſan fard, Si vous auez vſé de ce preſent remede, Comme chez les Gaulois, depuis peu l’on s’et 70	141 1 Mais en dis-ours communs découvrez nous san fard, Si vous avez usé de ce présent remède, Comme chez les Gaulais, depuis peu l'on s'et 70
HIPOCRATTE.	HIPOCRATTE.
Non iamais, tant s’en faut, on voit dans mes eſcrits.	Non jamais, tant s'en faut, on voit dans mes écrits.
Qu’eſtant vn pur venin ie l’oſte & le proſcrits, Si ie me ſuis ſervy dars certaines coliques De Bithume, de ſel, & d’eſprits mettalliques, I’ay toûjours pris du laict qui l’a rendu benin, N’oſant pas comme on fait l’irriter par le vin:	Qu'étant un pur venin ie l'ôte et le proscrits, Si ie me suis servi dars certaines coliques De Bithume, de sel, et d'esprits mettalliques, J'ai toujours pris du lait qui l'a rendu bénin, N'osant pas comme on fait l'irriter par le vin:
Dans vn mal violent ſurprenant la nature, ay lâché quelquefois, non pas à l’avanture, lais à des hommes forts & ſurpris tout à coup, i pareil deffenſeur, comme vn chien vers le loup :	Dans un mal violent surprenant la nature, ai lâché quelquefois, non pas à l'aventure, lais à des hommes forts et surpris tout à coup, y pareil défenseur, comme un chien vers le loup :
3 our va malade au lict vn peu foible & debileuy donnant du Stiby pour provoquer ſa bile, ’eſt faire ſuffoquer la mêche du flambeau, t coucher iuſtement la victime au tombeau.	3 our va malade au lit un peu faible et débileui donnant du Stibi pour provoquer sa bile, 'est faire suffoquer la mêche du flambeau, t coucher justement la victime au tombeau.
PLVTTON.	PLUTON.
Cela joint aux efforts nous le fait bien connoiſtre.	Cela joint aux efforts nous le fait bien connaître.
LE MEDECIN à genoux.	LE MÉDECIN à genoux.
Ah!	Ah!
divin Hipocratte, ah!	divin Hypocratte, ah!
pardon, mon cher Maiſtre, e vous expliquez plus, laiſſez-le comme il eſt, ur le texte ambigu nous aurons noſtre Arreſt ;	pardon, mon cher Maître, e vous expliquez plus, laissez-le comme il est, ur le texte ambigu nous aurons nôtre Arrest ;
21 lis ſi vous l’expliquez, ſans doute que la gloſe ra des Medecins quelque Metamorphoſe, ſeront Triailleurs, oſtant leurs differends.	21 lis si vous l'expliquez, sans doute que la glose ra des Médecins quelque Métamorphose, seront Triailleurs, ôtant leurs différends.
HIPOCRATTE.	HIPOCRATTE.
L’on rencontre en tous lieux d’inſignes ignorans, le plus grand Docteur de voſtre Medecine riteroit trente ans d’avoir la diſcipline, n’eſt pas à l’écolle à vous rendre parfaits;	L'on rencontre en tous lieux d'insignes ignorants, le plus grand Docteur de votre Médecine riterait trente ans d'avoir la discipline, n'est pas à l'école à vous rendre parfaits;
s faut paſſer vingt ans pour en voir les eft riſquer ſur des chiens, u non pas ſur dehommes temedes douteux.	s faut passer vingt ans pour en voir les est risquer sur des chiens, u non pas sur dehommes temèdes douteux.
LE MEDECIN.	LE MÉDECIN.
Dans le ſiecle où nous ſommes Si l’on ne riſquoit rien faudroit mourit à faim.	Dans le siècle où nous sommes Si l'on ne risquait rien faudrait mourit à faim.
HIPOCRATTE.	HIPOCRATTE.
Ah!	Ah!
Medecin fatal, Empirique inhumain.	Medecin fatal, Empirique inhumain.
Quoy tu ne croirois pas avoir aſſez de vie, Si d’vn cœur criminel tu ne l’avois ravie?	Quoi tu ne croirais pas avoir assez de vie, Si d'un cœur criminel tu ne l'avais ravie?
Ne te reclame plus d’eſtre mon ſectateur.	Ne te réclame plus d'être mon sectateur.
PLVTTON.	PLUTON.
Qu’on renferme à iamais ce maudit in poſteur, Et qu’on invente auſſi quelques nouveaux ſe plices Pour puair avec luy tous les futurs complices	Qu'on renferme à jamais ce maudit in posteur, Et qu'on invente aussi quelques nouveaux se pliées Pour puair avec lui tous les futurs complices
Parlant à Mercure.	Parlant à Mercure.
Mercure vous voyez que ſans difficulté Faut tenir le Stiby loin de la faculté;	Mercure vous voyez que sans difficulté Faut tenir le Stibi loin de la faculté;
A moias qu’vn Dieu par corps luy-melæ ne réponde, Des maux qu’il peut cauſer à ſon retour monde, Ie vais le retenir priſonnier en ces lieux	À moias qu'un Dieu par corps Seigneur-melæ ne réponde, Des maux qu'il peut causer à son retour monde, Je vais le retenir prisonnier en ces lieux
MERCVRE.	MERCURE.
Ie n’en répondray pas, ie m’en retournen cieux.	Je n'en répondrai pas, Seigneur m'en retournén cieux.
PLVTTON.	PLUTON.
Trouver Monſieur ſon Pere, & vous pourrez dire que ie retiens ſon fils.	Trouver Monsieur son Père, et vous pourrez dire que ie retiens son fils.
MERCVRE.	MERCURE.
Le voila qui ſoûpir Ade dieu petit Couſin.	Le voilà qui soupir Ade dieu petit Cousin.
PLVTTON.	PLUTON.
Rentrons, & fuivez nous xendant caution qui réponde pour vous Do pourra chez Plutton élire domicille.	Rentrons, et suivez nous xendant caution qui réponde pour vous Do pourra chez Pluton élire domicille.
MERCVRE.	MERCURE.
Bottons-nous pour partir, il nous faut faire gille.	Bottons-nous pour partir, il nous faut faire gille.
Fin du ſecond Atte	Fin du second Atte
ACTE III.	ACTE III.
D MOMVS entre en tâtonnan, & tombe.	 DOMUS entre en tâtonnan, et tombe.
H le chien de pays, i'ay le nez fuA afe	H le chien de pays, j'ai le nez fuA afe
MER CVRE.	MER CURE.
Viens-tu chercher icy les droits de trépaſſe	Viens-tu chercher ici les droits de trépasse
MOMVS à terre.	MOMUS à terre.
Ie tentends, eſt-ce toy?	Je tentends, est-ce toi?
la main, la mais, Mercure.	la main, la mais, Mercure.
1	1
MERCVRE le relevant.	MERCURE le relevant.
Trouves- tu chez plutton que la terre ſoit dure?	Trouves- tu chez pluton que la terre soit dure?
As-tu Maiſtre à danſer, tu ne ſautes pas mal,	As-tu Maître à danser, tu ne sautes pas mal,
MOMVS.	MOMUS.
Dans ces lieux rabotteux le plus fort animal Broncheroit ſans manquer à l’éclat des tenebres que fais-tu ſi long-temps dans ces priſons funebres?	Dans ces lieux rabotteux le plus fort animal Broncherait sans manquer à l'éclat des ténèbres que fais-tu si longtemps dans ces prisons funèbres?
Le ſoleil eſt ſi las de conduire ſon char, qu’il peſte dans les cieux contre ce vieux Penar:	Le soleil est si las de conduire son char, qu'il peste dans les cieux contre ce vieux Pénar:
Faut partir au plûtoſt.	Faut partir au plûtost.
MERCVRE.	MERCURE.
Saturne le bou Pere ira du bout des dents n’ayant pû faire afillle*2 on fils eſt retenu, peu s’en faut qu’aujourd’huy- ne ſois demeuré priſonnier avec luy, a vouloit m’obliger de luy ſervir de pleige.	Saturne le bou Père ira du bout des dents n'ayant pu faire afillle*2 on fils est retenu, peu s'en faut qu'aujourd'hu- ne sois demeuré prisonnier avec lui, a voulait m'obliger de Se servir de pleige.
MOMVS.	MOMUS.
On t'autoit fait icy comme on fait au College, n tépondant, payant, avec vn certain joüet u Tauron denrt pour quelques coups de foüet.	On t'autait fait ici comme on fait au Collège, n tépondant, payant, avec un certain jet Auron denrt pour quelques coups de foncet.
a a ea	a a ea
MERCVRE.	MERCURE.
Ie me tire du pair, enfia m’en volla quitte, e n’y r’entreray plus, ſi ce n’eſt à la ſuitte De Madame Themys;	Je me tire du pair, enfia m'en volla quitte, e 'y rentrerai plus, si ce n'est à la suitte De Madame Thémis;
car ſans elle en ces lieux amais noſtre Couſin ne reverra les Cieux	car sans elle en ces lieux amais notre Cousin ne reverra les Cieux
MOMVS.	MOMUS.
1 I’ay procuration, peut-eſtre qu’en ta place utton en ma faveur accordera ſa grace.	1 J'ai procuration, peut-être qu'en ta place uton en ma faveur accordera sa grâce.
0 MERCVRE.	0 MERE.
Ce ſont des pas perdus, i’ay fait tout mon pouvoir, itton le tient luy-meſme.	Ce sont des pas perdus, j'ai fait tout mon pouvoir, itton le tient Seigneur-même.
MOMVS.	MOMUS.
quoy, ie ne pourrois voir tre petit fanfan?	quoi, Seigneur ne pourrais voir tre petit sansan?
MERCVRE.	MERCURE.
Ie me ſauve au plus viſte, Le lu ye de ces lieux va apptendre ſon giſte, Fais luy voir ton eſcrit, il te per nettra tout, Et ie vais chez Themys pouſſer l’aff ire à bout	Je me sauve au plus vite, Le lu ie de ces lieux va aptendre son gîte, Fais lui voir ton écrit, il te per nettra tout, Et personne vais chez Themys pousser l'as re à bout
RADAMANTE à Momus.	RADAMANTE à Momus.
Apres vous, mortels.	Après -vous, mortels.
MOMVS Dans ces demeures ſombres Chacun eſt déguiſé, tout paſſe pour des Ombres, Ie ne ſuis point mortel, Monſieur, regardermoy.	MOMUS Dans ces demeures sombres Chacun est déguisé, tout passe pour des Ombres, Je ne suis point mortel, Monsieur, regardermoi.
RADAMANTE.	RADAMANTE.
On n’entre point icy ſans vous dire pourquoy, qui vous a donc paſſé?	On n'entre point ici sans vous dire pourquoi, qui vous a donc passé?
MOMVS.	MOMUS.
Moy-meſme, & ſans Naſſilles I’ay nazé tout veſtu pour conſerver mes aiſles, Eſtant ſur voſtrs bord tout couvert de rubis, Ie me ſuis mis au vent pour ſeicher mes habits, Enfin donc me voila de la part de Saturne, qui vous baiſe les mains penſif & taciturne, Il marche à reculons, il ne ſçuit ce qu’il fait, Si ſon fils ne revient il ſera fous parfait.	Moi-même, et sans Nassilles J'ai nazé tout vêtu pour conserver mes ailes, Estant sur vostrs bord tout couvert de rubis, Je me suis mis au vent pour seicher mes habits, Enfin donc me voilà de la part de Saturne, qui vous baise les mains pensif et taciturne, Il marche à reculons, il ne sûres ce qu'il fait, Si son fils ne revient il sera fous parfait.
RADAMANTE.	RADAMANTE.
Voyons voſtre pouvoir, s’il eſt comme il doit eſtre.	Voyons votre pouvoir, s'il est comme il doit être.
MOMVS.	MOMUS.
La lecture, Monſieur, vous va faire connoi tre,	La lecture, Monsieur, vous va faire connais tre,
Que ie ſuis Procureur par procuration, Et non pas en effet, ny de vacation;	Que ie suis Procureur par procuration, Et non pas en effet, ni de vacation;
Il lit ſa procuration.	Il lit sa procuration.
Eſcoutez, s’il vous plaiſt.	Écoutez, s'il vous plaît.
Pardevant les Notaires, cætera, Momus agent de mes affaires, Et cætera, fera pour me tirer d’émoy, ?	Pardevant les Notaires, cætera, Momus agent de mes affaires, Et cætera, fera pour me tirer d'émoi, ?
cætera pour luy, par luy comme par moy!	cætera pour lui, par lui comme par moi!
t cætera, délois comme à preſent i’eſpere i’il doit payant les frais rendre le fils au pere, t extera.	t cætera, délois comme à présent j'espère j'il doit payant les frais rendre le fils au père, t extera.
RADAMANTE.	RADAMANTE.
Momus, tout cela ne dit rien	Momus, tout cela ne dit rien
MOMVS.	MOMUS.
Vous ne l’entendez-pas, & moy ie m’entens bien, eſt qu’il faut en payant me rendre l’Emet que.	Vous ne l'entendez-pas, et moi -moi m'entends bien, est qu'il faut en payant me rendre l'Emet que.
RADAMANTE.	RADAMANTE.
Cet écrit ſuranné ſent ſon ſtile Gotique, lous ne recevons plus tous ces, & cætera.	Cet écrit suranné sent son style Gotique, lous ne recevons plus tous ces, et cætera.
MOMVS.	MOMUS.
Donnez-moy quelque agent on e contentera, Chez lupiter, Monſieur, tous nos hommes d’affaires 1 ont de ce temps jadis, & nos pauvres Notaires e peuvent en cent ans rencontrer vn ſeul Clerc, out paſſe par deça, chez nous on voit trop clair;	Donnez-moi quelque agent on e contentera, Chez lupiter, Monsieur, tous nos hommes d'affaires 1 ont de ce temps jadis, et nos pauvres Notaires est peuvent en cent ans rencontrer un seul Clerc, out passe par deça, chez nous on voit trop clair;
e iout chez les fupiers gaſte la marchandiſe.	 eût chez les fupiers gâte la marchandise.
RADA	RADA
RADAMANTE.	RADAMANTE.
Cét eſcrit de Gaulois ne peut eſtre de miſe, C’eſt pourquoy vous pouvez retourner ſur ve pas.	Cet écrit de Gaulois ne peut être de mise, C'est pourquoi vous pouvez retourner sur ve pas.
MOMVS.	MOMUS.
Et noſtre priſonnier ne le verray-je pas?	Et notre prisonnier ne le verrai-je pas?
RADAMANTE.	RADAMANTE.
Vous luy pouvez parler, paſſez vers le Coucierge.	Vous y pouvez parler, passez vers le Coucierge.
MOMVS entrant.	MOMUS entrant.
Ie crois qu’il eſt logé dans vne triſte Auberge.	Je crois qu'il est logé dans une triste Auberge.
CARON entre avec vn Me decin Ombre.	CARON entre avec un Me décin Ombre.
Tout le malheur me ſuit, ayant remis ma bag, Ce vieux porte-guignon nous a fait faire erag Tout mon mal depuis peu vient de la Meds cine, C’eſt là quelque ſupoſt, il en a bien la mine.	Tout le malheur me suit, ayant remis ma bag, Ce vieux porte-guignon nous a fait faire érag Tout mon mal depuis peu vient de la Méds ciné, C'est là quelque suppôt, il en a bien la mine.
LE MEDECIN.	LE MÉDECIN.
Ie le ſuis en effet	Je le suis en effet
CARON.	CARON.
Ah!	Ah!
ſi ie l’avois ſçeu, Monſieur le Medecin, vous auriez ma foy beu Tout voſtre chien de ſou, ie vous aurois fa mettre Dans vn ſacq à charbon avec vn mot de lettre, Vn Serpent.	si ici l'avais su, Monsieur le Médecin, vous auriez ma foi beû Tout votre chien de sou, enfin vous aurais fa mettre Dans un sacq à charbon avec un mot de lettre, Un Serpent.
va Diagon, accompagné d' Et dans cét appareil Thetis vous eſtoit hoq.	va Diagon, accompagné d' Et dans cet appareil Thétis vous était hoq.
LEMEDECIN.	LEMEDECIN.
Ce chaſtiment n’eſt dû qu’aux cruels parricides.	Ce châtiment n'est dû qu'aux cruels parricides.
M	M
2 CARON.	2 CARON.
Que meritez-vous donc, celuy de Canicides.	Que méritez-vous donc, celui de Canicides.
RADAMANTE.	RADAMANTE.
1 Sçavez-vous ce que c’eſt que le Stiby nouveau ?	1 Savez-vous ce que c'est que le Stibi nouveau ?
LE MEDECIN.	LE MÉDECIN.
tombeau, ne ſetois pas là, s’il eſtoit ſur la terre, pour vn de nos Chefs qui nous livre la guerre, nn’en oſe parler ayant eſté ſouſtrait;	tombeau, ne sétais pas là, s'il était sur la terre, pour un de nos Chefs qui nous livre la guerre, n'en ose parler ayant été soustrait;
ſais nous le contraindrons d’en faire vn extraict :	sais nous le contraindrons d'en faire un extrait :
oicy noſtre Factum preſenté ſur Requeſtes, i nous fera bien-toſt remonter ſur nos beſtes.	oici notre Factum présenté sur Requêtes, jusqu' nous fera bientôt remonter sur nos bêtes.
RADAMANTE prend le Factum Mii dl & le lit.	RADAMANTE prend le Factum Mi dl et le lit.
Quoy Themys, aujourd’huy dans voſtre faculté?	Quoi Themys, aujourd'hui dans votre faculté?
e n’eſt pas là ſon fait, cette difficulté partenoit plûtoſt au Corps de Medecine.	eu n'est pas là son fait, cette difficulté partenait plutôt au Corps de Médecine.
LE MEDECIN.	LE MÉDECIN.
Il eſt vray, mais pluſieurs coupant cette racine ous coupant le goſier comme ce perdulcis, ui decide le faict en ſix cens ving-ſix En cestemmes:	Il est vrai, mais plusieurs coupant cette racine ous coupant le gosier comme ce perdulcis, ui décide le fait en six cents ving-six En cettemêmes:
Sunt qui temerè in morbis contumacibus tria quatuer grana Antimonij praparati uſurpant cum aliquo liquœe, quod varios humοres ſine delectu & cum magna corporis perturbatione vtrinque dejicits ſed horrenda quà independent ſimptomata, id tanquam venenum pernicioſum fugiendum eſſe hortantur.	Sunt qui temerè in morbis contacibus tria quatuer grana Antimonijpraparati usurpant cum aliquo liquœe, quod varios humres sine délectu et cum magna corporis perturbatione vtrinque déjicits zed horrenda quà indépendent simptata, id anquam venenum perniciosum fugiendum esse hortantur.
Et plus bas :	Et plus bas :
Antimonium non modo hypercatarſi enecat, ſes ſubſtantiam ventriculi & inteſtinerum contumasi Adheſu exulcerat & perfodit, atque poſt immodicas vomitiones & dejectiones cruentas cum ſrs quenti animi deliquio interimit.	Antimonium non modo hypercatarsi enecat, ses substantiam ventriculi et intestinerum contasi Adhesu exerçât et perfit, atque post immodicas vomitiones et dejectiones cruentas cum srs quenti animi deliquio interimit.
RADAMANTE.	RADAMANTE.
Ne faut pas autre choſe.	Ne faut pas autre chose.
Pour vous çondamner tous	Pour vous çondamner tous
LE MEDECIN.	LE MÉDECIN.
Faut entendre la gloſe, Le tous eſt contre nous, ie vay vous l’expliquer	Faut entendre la glose, Le tous est contre nous, Elle vais vous l'expliquer
CARON.	CARON.
Apres les contredits, il faudra repliquer, Demeurons là deſſus.	Après les contredits, il faudra répliquer, Demeurons là -dessus.
RADAMANTE cependant lit ba le Factum.	RADAMANTE cependant lit ba le Factum.
MOMVS ſort en renachant.	MOMUS sort en renachant.
Peſte le ſot Royaume.	Peste le sot Royaume.
Tout eſt noir comme vn four dans ce grand iet de Paume, Ou gemiſt à taſtons, on crie à grince dents.	Tout est noir comme un four dans ce grand jet de Paume, Ou gémît à tâtons, on crie à grince dents.
Mercure arrive.	Mercure arrive.
MOMVS.	MOMUS.
Mercure, ah cher amy!	Mercure, ah cher ami!
n’entre pas là dedans Ah le pauvre habitacle!	n'entre pas là -dedans Ah le pauvre habitacle!
Ah perte ſans ſeconde Ie n’ay veu par tout là que riches, que grant -onde I Iupin pius joly n’amaſſe parmy nous que des gueux, des poüilleux, des Critiques, des foux :	Ah perte sans seconde Je n'ai vu par tout là que riches, que grant -onde I Iupin pius joli n'amasse parmi nous que des gueux, des pouilleux, des Critiques, des foux :
uoy, Plutton le cadet aura toute l’elite, logera ſi mal tant d’hommes de merite?	Çuoi, Pluton le cadet aura toute l'élite, logera si mal tant d'hommes de mérite?
upites le ſçaura, l’ordre eſt bouleverſé, t voila iuſtement le monde renverſé.	upites le saura, l'ordre est bouleversé, t voilà justement le monde renversé.
MERCVRE Iupiter prend plaiſir dans les Metamorphoſes, I ſe ſert du neant pour les plus belles choſes, es grands hommes du temps qui s’eſtiment parfaits nt élevez trop haut pour luy ſervir d’objets.	MERCURE Iupiter prend plaisir dans les Métamorphoses, I se sert du néant pour les plus belles choses, es grands hommes du temps qui s'estiment parfaits nut élevez trop haut pour lui servir d'objets.
Tuemys amve.	Tuémis amue.
MOMVS.	MOMUS.
Voicy venir Themys.	Voici venir Thémis.
MERCVRE.	MERCURE.
our le petit Stiby.	our le petit Stibi.
Iupin a donné l’ordre	Jupin a donné l'ordre
MOMVS.	MOMUS.
C’eſt du ſil à retordre pur Monſieur le Bailly.	C'est du sil à retordre pur Monsieur le Bailly.
Ile Factum.	Ile Factum.
Monſieur tous vos eſprits eront interinez, moy meſme i’y ſouſcrits, ous plaiſt-il cependant que Themys prenne place.	Monsieur tous vos esprits eront intérinez, mo même j'y souscrits, ous plaît-il cependant que Thémis prenne place.
MERCVRE.	MERCURE.
Voyons cét harangueur, ’il aura bonne grace.	Voyons cet harangueur, 'il aura bonne grâce.
RADAMANTE.	RADAMANTE.
Reyne de l’équité, par ces mots il appert.	Reine de l'équité, par ces mots il appert.
MOMVS.	MOMUS.
Bailly de Vaugirard, nous voila pris ſan verd, Soufflez-le, s’il vous plaiſt, ſa memoire eſt la bilNous allons proceder ſur Requeſte civile, Vous voila devoyé, devoyé vous voila.	Bailly de Vaugirard, nous voilà pris san verd, Soufflez-le, s'il vous plaît, sa mémoire est la bilNous allons procéder sur Requête civile, Vous voila devoyé, devoyé vous voilà.
MERCVRE.	MERCURE.
Il a réponſe à tout hormis à qui-va-là?	Il a réponse à tout hormis à qui-va-là?
Monſieur, remett 2-vous, & nous quittez l ſiege, Themis ſe ſied avec Mereure di coſté, & M mus de l’auire.	Monsieur, remett 2-vous, et nous quittez l iège, Themis se sied avec Mèreure di ôté, et M us de l'avire.
RADAMANTE.	RADAMANTE.
Le petit Stibyon ſeroit ſorty ſoubs pleige.	Le petit Stibyon serait sorti sous pleige.
THEMYS.	THEMIS.
Pourquoy le condamner ſans avoir des tes moins?	Pourquoi le condamner sans avoir des tes moins?
MERCVRE.	MERCURE.
Pourquoy le tetient-on toûjours ſur, & tan moins, N’eſtant pas condamné d’Arreſt contradictoin Il doit eſtre pour ſoy caution iuratoire.	Pourquoi le tetient-on toujours sur, et tan moins, N'étant pas condamné d'Arrest contradictoin Il doit être pour soi caution juratoire.
MOMVS.	MOMUS.
Nous entendons l’eſtecq.	Nous entendons l'estecq.
THEMYS.	THEMIS.
Qu’on le faſſe venir.	Qu'on le fasse venir.
RADAMANTE.	RADAMANTE.
Meſſieurs, permettez-moy de vous entre tenir, Des accuſations.	Messieurs, permettez-moi de vous entre tenir, Des accusations.
& preuves convainquantes.	et preuves convainquantes.
MOMVS Parlez, ſi vous pouvez RADA	MOMUS Parlez, si vous pouvez RADA
RADAMANTE.	RADAMANTE.
Ses fautes delinquantes.	Ses fautes délinquantes.
MERCVRE.	MERCURE.
Bon, voicy de bons mots.	Bon, voici de bons mots.
RADAMANTE.	RADAMANTE.
Eſtant chez les mortels, L’ont fait mettre à couvert pour garder vos aue 135	Étant chez les mortels, L'ont fait mettre à couvert pour garder vos aue 135
THEMYS.	THEMIS.
Lors qu’il ſera venu vous nous direz le reſte.	Lors qu'il sera venu vous nous direz le reste.
LE MEDECIN.	LE MÉDECIN.
Grande Reyne Themys devant vous ie proteſte, ue tout ce que i’ay dit dans mon objection, dle prejudiciera contre le Stibyon, Ve pretendant par là tirer à conſequence,	Grande Reyne Themys devant vous ie proteste, ue tout ce que ay dit dans mon objection, de Reine contre le Stibyon, De prétendant vous pô tirer p conséquence,
MERCVRE.	MERCURE.
Autre Advocat pour nous.	Autre Advocat pour nous.
MOMVS.	MOMUS.
Mootrez voſtæ eloquence,, Et ſi ie peux icy preſider à mon tour, oy de vieux Piocureur vous reverrez le iour.	Modérez vostæ éloquence, Et si ici peux ici présider à mon tour, oi de vieux Piocureur vous reverrez le jour.
THEMYS parlant à Radamante.	THEMIS parlant à Radamante.
Pourſuivez maintenant, voicy voſtre coupable.	Poursuivez maintenant, voici votre coupable.
CARON r’entre en tremblant.	CARON rentre en tremblant.
On le va délivrer, me voila miſerable, vay rompre le bag, & nargue des humains,	On le va délivrer, me voilà misérable, vais rompre le bag, et nargue des humains,
RADAMANTE.	RADAMANTE.
Depuis qu’vn Medecin l’a mis entre vos mains Mille & mille mortels qui là couchez par terte Se plaignent icy bas de ſa cruelle guerre, En mépriſant les loix qu’on obſerve chez nous Il force nos cachors, & rend nos gardes fous.	Depuis qu'un Medecin l'a mis entre vos mains Mille et mille mortels qui là couchés par terte Se plaignent ici bas de sa cruelle guerre, En méprisant les lois qu'on observe chez nous Il force nos cachors, et rend nos gardes fous.
MOMVS Les petites maiſons n’en ſeront pas moitpleines	MOMUS Les petites maisons n'en seront pas moitèleines
RADAMANTE.	RADAMANTE.
Bellone aux champs de Mars, ouvrant cer mille veines, N'a pas fait en dix ans, ce qu’il fait en deu mois, Vn milier de témoins vont paroiſtre à la fois, Si vous le deſirez pour preuve de mon dire.	Belone aux champs de Mars, ouvrant cer mille veines, N'a pas fait en dix ans, ce qu'il fait en de vais, Un milier de témoins vont paraître à la fois, Si vous le désirez pour preuve de mon dire.
THEMYS.	THEMIS.
Quoy donc, petit morveux, iuſques dans eu Empire, Sans avoir nul adveu, ſans reſpect de ma loy, Vous diſpoſez du ſort qui n’appartient qu’à moi Quoy, ne ſçavez-vous pas dans le ſiecle u nous ſommnes, Que ſeul & ſans ſecond ie diſpoſe des hommes Ayant droit ſur leurs biens.	Quoi donc, petit morveux, jusqu' appartie Empire, Sans avoir nul aveu, sans respect de ma loi, Vous disposez du sort qui n'appartient qu'à moi Quoi, ne savez-vous pas dans le siècle nous sommnes, Que seul et sans second ie dispose des hommes Ayant droit sur leurs biens.
MOMVS.	MOMUS.
Dans ces difficultez, Ceux de la Faculté ſeront ſans facultez.	Dans ces difficultés, Ceux de la Faculté seront sans facultés.
THEMYS.	THEMIS.
Parlez, & répondez.	Parlez, et répondez.
MERCVRE.	MERCURE.
Il eſt temps de paroiſtre, Allons petit Couſin, faut ſe faire connoiſtre, Expoſe-nous ton fait.	Il est temps de paraître, Allons petit Cousin, faut se faire connaître, Expose-nous ton fait.
MOMVS.	MOMUS.
Allons petit marmot, toila bien du can can, pour nous joſer vn mot	Allons petit marmot, toilà bien du can can, pour nous joser un mot
L’ANTTMOINE.	L'ANTTMOINE.
STANCES.	STANCES.
Quoy qu’Eſculap ſoit mon iuge Et mon interprette benin, Paſſant icy pour pur venin, rnemys uon eide mon refuge :	Quo qu’Esculap soit mon juge Et mon interprète bénin, Passant ici pour pur venin, rémiz uon eide mon refuge :
Accuſe comme criminel Digne d’vn ſupplice eternel.	Accuse comme criminel Digne d'un supplice éternel.
Ie ſuis coupable ſans offence, Et ſi i’ay mis quelqu’va à bout, I’eſtois contraint & ſans deffence Les ſeuls Medecins ont fait tout.	Je suis coupable sans offense, Et si j'ai mis quelqu'une à bout, J'étais contraint et sans défense Les seuls Médecins ont fait tout.
Les mortels laſſez du carnagé Eſtoient avares de leur ſang, Lors qu’on m’eſleva dans ce ranp Pour faire le meſme ravage, En ſaignant l’on affoibliſſoit, Et par apres on languiſſoit Ce qui maintenoit les fourrures, Mais moy je fais en vae fois Ce que vingt & trente picqures Ne ſçauroient pas faire en vn mois.	Les mortels lassez du carnagé Étaient avares de leur sang, Lors qu'on m'éleva dans ce ranp Pour faire le même ravage, En saignant l'on affaiblissait, Et par après on languissait Ce qui maintenait les fourres, Mais moi je fais en vae fois Ce que vingt et trente piqûres Ne sauraient pas faire en un mois.
Malgté moy ie ſuis leur complice Apres mille & mille détours, On me met au feu trente iours Et ie reſiſte à ce ſupplice;	Malgé moi -même suis leur complice Après mille et mille détours, On me met au feu trente jours Et il résiste à ce supplice;
Ie deviens paſle & ſafrané Rouge pourprin, demy tané.	Je deviens pâle et safrané Rouge pourprin, demi tané.
Lors on enyvre ma colere Pour me fiire devenir fou, Apres le feu de reverbere On me met au vin iuſqu’au cou.	Lors on enivre ma colère Pour me fiire devenir fou, Après le feu de réverbère On me met au vin jusqu'au cou.
Dans cét eſtat ſuivant leur ordre Châque corps devient ma priſon, Et pour ſortir de garniſon Ie fais ſouvent bien du deſordre, Si toſt que i’ay cuvé mon vin Ie croy trouver le Medecin Et me vanger de ſon outrage;	Dans cet état suivant leur ordre Châque corps devient ma prison, Et pour sortir de garnison Je fais souvent bientôt du désordre, Si tôt que j'ai cuvé mon vin Je crois trouver le Médecin Et me venger de son outrage;
Mais n’y prenant pas garde aſſez Celuy qui me retient en cage Paye pour eux les pots caſſez.	Mais n'y prenant pas garde assez Celui qui me retient en cage Paye pour eux les pots cassés.
Eſtant dans le ſein de ma mere Ie cherche à me ioindre aux metaux, Et non pas avec des bruttaux Pour eſtre touſiours en colere;	Étant dans le sein de ma mère Je cherche à me joindre aux métaux, Et non pas avec des brutaux Pour être toujours en colère;
Des Chimiſtes ie ſuis le Dieu Tenant iuſtement le milieu Entre le metail & la mine, Et ie faits contre tous les corps Ce que feroit vne machine Contre vne Ville & ſes dehors.	Des Chimistes fois suis le Dieu Tenant justement le milieu Entre le métail et la mine, Et ie forts contre tous les corps Ce que ferait une machine Contre une Ville et ses dehors.
Toutes les plantes de la terte Sont pour conſerver l’animal, Mais les mettaux cauſent ſon mal Et luy livrent toûjours la guerte;	Toutes les plantes de la terte Sont pour conserver l'animal, Mais les mettaux causent son mal Et lui livrent toujours la guerte;
Le Medecin trop negligeant qui n’a pour ſon bur que l’argent Laiſſe les plantes aux Bourriſques, pour aenger nes travaux prend comme les Empiriques i remede pour tous les maux.	Le Medecin trop négligeant qui n'a pour son bur que l'argent Laisse les plantes aux Bourrisques, pour aenger nés travaux prend comme les Empiriques y mède pour tous les maux.
MERCVRE.	MERCURE.
Aga, qui l’auroit ereu, voyez ce perit drolle,	Aga, qui l'aurait eu, voyez ce périt dolle,
MOMVS.	MOMUS.
Il parle comm’il faut, il ſç it fort bien ſon rolle	Il parle comm'il faut, il sa it fort bien son rolle
RADAMANTE.	RADAMANTE.
Et nos ſoldats perdus qui produit cet effet?	Et nos soldats perdus qui produit cet effet?
L’ANTIMOINE.	L'ANTIMOINE.
Vos ſoldats alterez voyans d’abord leur fait, Ont uetroene pour eux mes plus groſſes bouteilles, Et beuvant de ce vin qui va iuſqu’aux oreilles, s ſe ſont ajuſtez, eux-meſmes ay int pris Chez moy fort proprement du vin à iuſte prix.	Vos soldats altérez voyant d'abord leur fait, Ont uetroène pour eux mes plus grosses bouteilles, Et buvant de ce vin qui va jusqu'aux oreilles, s se sont ajustez, eux-mêmes ai int pris Chez moi fort proprement du vin à juste prix.
MERCVRE.	MERCURE.
Ils s’en porteront mieux ayant doublé la doſe.	Ils s'en porteront mieux ayant doublé la dose.
THEMYS parlant à Radamante.	THEMIS parlant à Radamante.
Tout voſtre proceder n’eſt donc pas autre choſe du mal entendu.	Tout votre procéder n'est donc pas autre chose du mal entendu.
RADAMANTE.	RADAMANTE.
Penſez à vos ſujets.	Pensez à vos sujets.
MERCVRE.	MERCURE.
Pour reparer le tort de ces rudes effets Venus m’a dérobé l’infaillible remede, qui rameine en ſanté tous ceux qui vont en Suede;	Pour réparer le tort de ces rudes effets Venus m'a dérobé l'infaillible remède, qui ramène en santé tous ceux qui vont en Suède;
Par ce ſubtil moyen, pour quinze reprouvez I'echange en meſme temps quarante enfar trouvez	Par ce subtil moyen, pour quinze réprouvez J'échange en même temps quarante enfar trouvez
MOMVS.	MOMUS.
Si les vieux ne pattoient lors qu’on a plu de guerte, Faudroit que lupiter fiſt encore vne terte Pour loger les petits.	Si les vieux ne pattaient lors qu'on a plu de guerte, Faudrait que lupiter fît encore une terte Pour loger les petits.
THEMYS.	THEMIS.
Par Arieſt deciſif, Nous avons declaré que tout autre abuſif, Sera declaré nul, cependant l’Emetique Remis en liberté ſauf appel de Critique, Pour ne s’en pas ſervir, permettant aux plus fis De ſe contregarder de tous les Medecins.	Par Ariest décisif, Nous avons déclaré que tout autre abusif, Sera déclaré nul, cependant l'Emetique Remis en liberté sauf appel de Critique, Pour ne s'en pas servir, permettant aux plus fis De se contregarder de tous les Médecins.
MERCVRE.	MERCURE.
Le voila toiſé net, & mis en bonne forme, Nous le faut au plûtoſt faire afficher ſou l’orme, Tous les Stibyoniens, h bebunt intentum,	Le voilà toisé net, et mis en bonne forme, Nous le faut au plûtost faire afficher sou l'orme, Tous les Stibyoniens, h bebunt intentum,
MOMVS.	MOMUS.
Nous avons gain de cauſe, & point de R tentum.	Nous avons gain de cause, et point de R entum.
Pindant que hacun ſe retin.	Pindant que hacun se retin.
MOMVS.	MOMUS.
Vive, vive Themys pour mettre la police, L’on a remede à tout, lors qu’on eſt en iuſtice, Voicy le Stiby pur ſans charbon & ſans bois Pour eſtre interrogé ſeulement vne fois;	Vive, vive Thémis pour mettre la police, L'on a remède à tout, lors qu'on est en justice, Voici le Stibi pur sans charbon et sans bois Pour chang interrogé seulement une fois;
Tous ceux qu’on nomme faux ſauniers, fauſſe monnoyé, Et les plus faux témoins avant qu’on les renvoje,	Tous ceux qu'on nomme faux sauniers, fausse monnoyé, Et les plus faux témoins avant qu'on les renvoje,
exiennent tous fort bons aſſis dans le bracart, toſt qu’on leur promet leur perit fait à part.	exiennent tous fort bons assis dans le bracart, tôt qu'on leur promet leur périt fait à part.
s voila tous de poids ſans manquer d’vne obolle, ſouvent ſans témoins on iuge à leurs paroles:	s voilà tous de poids sans manquer d'une obolle, souvent sans témoins on juge à leurs paroles:
n ieune marié qui n’eſt ſot qu’à demy, rouvant à ſon retour ſa femme & ſon amy, ur eſtre ſot parfait auſſi-toſt ſe va plaindre, pai vn bel Arreſt il s’acheve de peindre:	 neune marié qui n'est sot qu'à demi, rouvant à son retour sa femme et son ami, ur être sot parfait aussitôt se va plaindre, pai un bel Arrêt il s'achève de peindre:
n Aſne oſtant ſon baſt, pour quelque illuſtre employ, ra par vn Arreſt vn Docteur de la loy.	 Asne ôtant son bât, pour quelque illustre emploi, ra par un Arrêt un Docteur de la loi.
nſſi pour avoir tout ne faut point d’autre etole.	nssi pour avoir tout ne faut point d'autre étole.
ue de bien demêler trois brins de protocole;	Que de bien demêler trois brins de protocole;
uerterpeite;	Juerterpèite;
rammue avec tous leurs accez, e font pas tant d’effect qu’vn bon petit procez	rammue avec tous leurs accès, e ont pas tant d'effet qu'un bon petit procès
D FIN.	D FIN.
