A PARIS Par CHRISTOPHE BALLARD, ſeul Imprimeur du Roy-pour la Muſique, ruë Saint Jean de Beauvais, au Mont Parnaſſe.	À PARIS Par CHRISTOPHE BALLARD, seul Imprimeur du Roi-pour la Musique, rue Saint Jean de Beauvais, au Mont Parnasse.
M.	M.
DC.	DC.
L'XXX.	L'XXX.
Par exprés Commandement de Sa Majeſté,	Par exprès Commandement de Sa Majesté,
AC TEVRS TYTRDEOGVE.	AC TEURS TYTRDEOGUE.
A Paix.	À Paix.
Mademoiſelle Ferdinand la cadete.	Mademoiselle Ferdinand la cadète.
L e a La Felicité, l’Abondance, les Ieux & les Plaiſirs.	 L' à La Félicité, l'Abondance, les Ieux et les Plaisirs.
Jeux & Plaiſirs dançans.	Jeux et Plaisirs dançans.
Meſſieurs Favier l’aiſné, l’Eſtang l'aiſné, l’Eſtang cadet, Faüre, Boutteville, Magny, Germain, & Favier le cadet.	Messieurs Favier l'aîné, l'Estang l'aîné, l'Étang cadet, Faüre, Boutteville, Magny, Germain, et Favier le cadet.
La Diſcorde.	La Discorde.
Monſieur de Pulvigny.	Monsieur de Pulvigni.
SVITE DE LA DISCORDE.	SVITE DE LA DISCORDE.
La Ialouſie, la Haine, le Depit, la Rage, le Deſeſpoir, les Chagrins, & c	La Jalousie, la Haine, le Dépit, la Rage, le Désespoir, les Chagrins, et ç
Meſſieurs Bony, Beaumont, Fernon l’aiſné, Perchot, Aubert, Fernon cadet, Lavernet, la Foreſt, Tiphaine & David.	Messieurs Boni, Beaumont, Fernon l'aîné, Perchot, Aubert, Fernon cadet, Lavernet, la Forêt, Tiphaine et David.
Suivants de la Diſcorde dançans.	Suivant de la Discorde dançans.
Monſieur de Beauchamp ſeul.	Monsieur de Beauchamp seul.
Meſſieurs Noblet, Joubert, pecour & Dumirail.	Messieurs Noblet, Joubert, pécour et Dumirail.
La Victoire.	La Victoire.
Mademoiſelle Ferdinand l’aiſnée.	Mademoiselle Ferdinand l'aînée.
SVITE DE LA VICTOIRE.	SVITE DE LA VICTOIRE.
Troupe de Victoires & de Heros.	Troupe de Victoires et de Héros.
Meſdemoiſelles de la Prée, Doremius, & Pieſche.	Mesdemoiselles de la Prée, Doremius, et Pièche.
Mrs de la Grille, Poyadon, Gillet, Rebel, Develois, lacquart, Beaumont fils, Gaye fils, & le petit Fernon.	Mrs de la Grille, Poyadon, Gillet, Rebel, Develois, lacart, Beaumont fils, Gaie fils, et le petit Fernon.
TEUEOGVE.	TEUEOGUE.
LE THEATRE REPRESENTE l’Antre de nla Ulcorde, on y voit la Paix enchaînée:	LE -THÉÂTRE REPRÉSENTE l'Antre de nla Ulcorde, on y voit la Paix enchaînée:
la Felicité, l’Abondance, les Jeux & les Plaiſirs y accompagnent la Paix, & ſont enchaînez comme elle.	la Félicité, l'Abondance, les Jeux et les Plaisirs y accompagnent la Paix, et sont enchaînés comme elle.
Q LA PAIX.	Q LA PAIX.
EROS, dont la Valeur estonne l'Vnivers, Ah!	EROS, dont la Valeur étonne l'Univers, Ah!
quand briſerez-vous nos fers?	quand briserez-vous nos fers?
La Diſcorde nous tient icy ſous ſa puiſſance;	La Discorde nous tient ici sous sa puissance;
La Barbare ſe plaiſt à voir couler nos pleurs;	La Barbare se plaît à voir couler nos pleurs;
SoyeZ touché de nos malheurs, Vous eſtes dans nos maux noſtre unique eſperance;	SoyeZ touché de nos malheurs, Vous êtes dans nos maux notre unique espérance;
Heros, dont la Valeur eſtonne l’Vnivers, Ah quand briſereZ-vous nos fers!	Héros, dont la Valeur étonne l'Univers, Ah quand briserez-vous nos fers!
La Suite de la Paix repete ces deux derniers Vers.	La Suite de la Paix répète ces deux derniers Vers.
La Haine, la Rage, les Chagrins, la Ialouſie, le Dépit, le Deſepoir, & toute la ſuite de la Diſcorde, temoignent les douceurs qu’ils trouvent dans l’eſclavage où ils ont reduit la Paix.	La Haine, la Rage, les Chagrins, la Jalousie, le Dépit, le Désépoir, et toute la suite de la Discorde, témoignent les douceurs qu'ils trouvent dans l'esclavage où ils ont réduit la Paix.
LA DISCORDE.	LA DISCORDE.
Soûpirez, triſte Paix, malheureuſe Captive, Gemiſſez, & n’esperez-pas Qu’un Heros que j’engage en de nouveaux Combats Eſcoute voſtre voix plaintive.	Soupirez, triste Paix, malheureuse Captive, Gémissez, et n'espérez-pas Qu'un Héros que j'engage en de nouveaux Combats Écoute votre voix plaintive.
Plus il moiſſonne de Lauriers, Plus j’offre de matiere à ſes travaux guerriers.	Plus il moissonne de Lauriers, Plus j'offre de matière à ses travaux guerriers.
I’anime les Vaincus d’une nouvelle audace;	J'anime les Vaincus d'une nouvelle audace;
I'oppoſe à la vive chaleur De ſon indomptable Valeur Mille Fleuves profonds, cent Montagnes de glace.	J'oppose à la vive chaleur De son indomptable Valeur Mille Fleuves profonds, cent Montagnes de glace.
La Victoire empreßée à conduire ſes pas Se prepare à voler aux plus lointains Climas;	La Victoire empressée à conduire ses pas Se prépare à voler aux plus lointains Climas;
Plus il la ſuit, plus il la trouve belle;	Plus il la suit, plus il la trouve belle;
Il oublie aisément pour elle La Paix & ſes plus doux appas.	Il oublie aisément pour elle La Paix et ses plus doux appas.
LAPAIX & ſa ſuite.	LAPAIX et sa suite.
O rigueurs inhumaines!	Ô rigueurs inhumaines!
Faut-il ne voir jamais finir le triſte cours De nos malheurs, & de nos peines?	Faut-il ne voir jamais finir le triste cours De nos malheurs, et de nos peines?
LA DISCORDE & ſa ſuite.	LA DISCORDE et sa suite.
Vos plaintes ſeront vaines	Vos plaintes seront vaines
LA PAIX & ſa ſuite.	LA PAIX et sa suite.
Quel tourment de languir toûjours 1* Sous de cruelles chaînes!	Quel tourment de languir toujours 1* Sous de cruelles chaînes!
LA DISCORDE & ſa ſuite.	LA DISCORDE et sa suite.
Vos plaintes ſeront vaines N’eſperez jamais de ſecours.	Vos plaintes seront vaines N'espérez jamais de secours.
On entend un bruit de Trompettes & de Tymbales.	On entend un bruit de Trompettes et de Tymbales.
LA DISCORDE.	LA DISCORDE.
Ce bruit que la Victoire en ces lieux fait entendre.	Ce bruit que la Victoire en ces lieux fait entendre.
Ml atoeriit qu'eue yva deſcendre.	Ml atériit qu'eue iva descendre.
Quel plaiſir de luy faire voir Mon Ennemie au deſeſpoir!	Quel plaisir de Rome faire voir Mon Ennemie au désespoir!
La Victoire deſcend, elle eſt accompagnée d’un grand nombre de Victoires, & de Heros.	La Victoire descend, elle est accompagnée d'un grand nombre de Victoires, et de Héros.
LA VICTOIRE.	LA VICTOIRE.
Venez aimable Paix, le Vainqueur vous appelle, La Victoire devient voſtre guide fidelle;	Venez aimable Paix, le Vainqueur vous appelle, La Victoire devient votre guide fidèle;
VeneZ dans un heureux ſejour.	VeneZ dans un heureux séjour.
Vous, Diſcorde affreuſe & cruelle, Portez ſes fers à vostre tour.	Vous, Discorde affreuse et cruelle, Portez ses fers à votre tour.
LA VICTOIRE & ſa ſuite.	LA VICTOIRE et sa suite.
Venez, aimable Paix, le Vainqueur vous appelle.	Venez, aimable Paix, le Vainqueur vous appelle.
La Suite' de la Victoire deſchaîne la Paix & les	La Suite de la Victoire déchaîne la Paix et les
Divmitez qui l'accompagnent, & enchaîne la Diſcorde & ſa ſuite.	Divmitez qui l'accompagnent, et enchaîne la Discorde et sa suite.
LA PAIX & ſa ſuite.	LA PAIX et sa suite.
Ah!	Ah!
quel bon-heur charmant!	quel bonheur charmant!
LA DISCORDE & ſa ſuite.	LA DISCORDE et sa suite.
Ab!	Ab!
quel affreux tourment!	quel affreux tourment!
LA DISCORDE enchaînée.	LA DISCORDE enchaînée.
Orgueilleuſé Victoire, eſt-ce à toy d’entreprendre De mettre la Diſcorde aux fers?	Orgueilleusé Victoire, est-ce à toi d'entreprendre De mettre la Discorde aux fers?
Aa quets nonmeurs fans moy peuastu jamais pretendre?	Aa quets nonmeurs fans moi peuastu jamais prétendre?
LA VICTOIRE.	LA VICTOIRE.
Ah!	Ah!
qu’il eſt beau de rendre La Paix à l’Vnivers.	qu'il est beau de rendre La Paix à l'Univers.
LA DISCORDE.	LA DISCORDE.
Tes ſoins pour le Vainqueur pouvoient plus loin s’eſtendre?	Tes soins pour le Vainqueur pouvaient plus loin s'étendre?
Que ne conduiſois-tu le Heros que tu ſers, Où cent Lauriers nouveaux luy ſont encore offerts?	Que ne conduisais-tu le Héros que tu sers, Où cent Lauriers nouveaux lui sont encore offerts?
La Gloire au bout du Monde auroit eſté l’attendre.	La Gloire au bout du Monde aurait été l'attendre.
LA VICTOIRE.	LA VICTOIRE.
Ah!	Ah!
qu’il eſt beau de rendre La Paix à l’Vnivers.	qu'il est beau de rendre La Paix à l'Univers.
Apres avoir vaincu mille Peuples divers, Quand on ne voit plus rien qui puiſſe ſe deffendre, Ah!	Après avoir vaincu mille Peuples divers, Quand on ne voit plus rien qui puisse se défendre, Ah!
qu’il eſt beau de rendre La Paix à l’Vnivers.	qu'il est beau de rendre La Paix à l'Univers.
La Suite de la Victoire & la Suite de la Paix, repetent ces derniers Vers.	La Suite de la Victoire et la Suite de la Paix, répètes ces derniers Vers.
2	2
LA DISCORDE.	LA DISCORDE.
OT cruel eſclavage!	OT cruel esclavage!
Ie ne verray donc plus de ſang & de carnage?	Je ne verrai donc plus de sang et de carnage?
Ah!	Ah!
pour mon deſeſpoir faut-il que le Vainqueur Ait triomphé de ſon courage?	pour mon désespoir faut-il que le Vainqueur Ait triomphé de son courage?
Faut-il qu’il ne laiſſe à ma rage Rien à devorer que mon cœur?	Faut-il qu'il ne laisse à ma rage Rien à dévorer que mon cœur?
OI cruel eſclavage!	ÔI cruel esclavage!
La ſuite de la Diſcorde repere ce dernier Vers.	La suite de la Discorde répère ce dernier Vers.
LA VICTOIRE.	LA VICTOIRE.
Au fond d’un Gouffre plein d’horreur, Que ſous des Fers peſants la Diſcorde gemiſſe.	Au fond d'un Gouffre plein d'horreur, Que sous des Fers pesants la Discorde gémisse.
Partagez ſon ſupplice Vous qui-partageZ ſa fureur.	Partagez son supplice Vous qui-partageZ sa fureur.
Et vous triſte Sejour, changeZ, que tout reſſente Le pouvoir plein d’appas de la Paix triomphante.	Et vous triste Séjour, changez, que tout ressente Le pouvoir plein d'appas de la Paix triomphante.
La Diſcorde & ſa ſuite s’abiſment dans des Gouffres qui s’ouvrene ious lours pas, & l’affreuſe Retraite de la biſcorde ſe change en un Palais agreable.	La Discorde et sa suite s'abîment dans des Gouffres qui s'ouvrène jous lours pas, et l'affreuse Retraite de la biscorde se change en un Palais agréable.
LA PAIX & ſa ſuite.	LA PAIX et sa suite.
Ah quel bonheur charmant!	Ah quel bonheur charmant!
LA DISCORDE & ſa ſuite en s’abiſmant.	LA DISCORDE et sa suite en s'abîmant.
Ah!	Ah!
quel affreux tourment!	quel affreux tourment!
LA VICTOIRE & LA PAIX.	LA VICTOIRE et LA PAIX.
Le Vainqueur eſt comblé de gloire, On doit l’admirer à jamais:	Le Vainqueur est comblé de gloire, On doit l'admirer à jamais:
La Suite de la Victoire & la Suite de la Paix repetent ces quatle vers, La Suite de la Paix témoigne ſa joye en dançant & en chantant.	La Suite de la Victoire et la Suite de la Paix répètent ces quatle vers, La Suite de la Paix témoigne sa joie en dançant et en chant.
La Felicité & l’Abondance chantent enſemble.	La Félicité et l'Abondance chantent ensemble.
Il est temps que l’Amour nous enchaîne, Il ſçait vaincre les plus fiers Vainqueurs.	Il est temps que l'Amour nous enchaîne, Il sait vaincre les plus fiers Vainqueurs.
Rendons-nous, la fuite eſt vaine, Ce Dieu charme tous les Cœurs:	Rendons-nous, la fuite est vaine, Ce Dieu charme tous les Cœurs:
Jl n’a point de bien ſans peine, Mais peut-on trop payer ſes douceurs.	Il n'a point de bien sans peine, Mais peut-on trop payer ses douceurs.
82 Dans les fers qu’Amour veut que l’on prenne, Tout eſt doux iuſqu’aux peus triſtes pleurs.	82 Dans les fers qu'Amour veut que l'on prenne, Tout est doux jusqu'aux pus tristes pleurs.
Rendons-nous, la fuite est vaine, Ce Dieu charme tous les Cœurs, &c.	Rendons-nous, la fuite est vaine, Ce Dieu charme tous les Cœurs, etc.
LA PAIX.	LA PAIX.
On a quitté les armes, Voicy le temps heureux Des Plaiſirs pleins de charmes, Voicy le temps heureux Des Plaiſirs & des leux.	On a quitté les armes, Voici le temps heureux Des Plaisirs pleins de charmes, Voici le temps heureux Des Plaisirs et des leux.
On ne verſera plus de larmes, Tous les cœurs ſeront ſans allarmes;	On ne versera plus de larmes, Tous les cœurs seront sans alarmes;
Et ſi l’on craint encor des tourments rigoureux Ce ſera ſeulement dans l’Empire amoureux.	Et si l'on craint encor des tourments rigoureux Ce sera seulement dans l'Empire amoureux.
On a quitté les armes Voicy le temps heureux Des Plaiſirs pleins de charmes, Voicy le temps heureux Des Plaiſirs & des Ieux.	On a quitté les armes Voici le temps heureux Des Plaisirs pleins de charmes, Voici le temps heureux Des Plaisirs et des Jeux.
Le Chœur repete ces derniers Vers.	Le Chœur répète ces derniers Vers.
ILA FELICITE’.	ILA FELICITE'.
Que l'Amour eſt doux à ſuivre!	Que l'Amour est doux à suivre!
Quel plaiſir de s’enflammer!	Quel plaisir de s'enflammer!
Vn jeune Cœur ne commence de vivre Que du moment qu’il commence d’aimer.	Un jeune Cœur ne commence de vivre Que du moment qu'il commence d'aimer.
Malheureux qui ſe delivre D’un tourment qui ſçait charmer.	Malheureux qui se délivre D'un tourment qui sait charmer.
On reconnoiſt que l’on ceſſe de vivre 2 En meſme temps que l’on ceſſe d’aimer.	On reconnaît que l'on cesse de vivre 2 En même temps que l'on cesse d'aimer.
940	940
LE CHOEUR.	LE CHOEUR.
On a quitté les armes Voicy le temps heureux Des Plaiſirs pleins de charmes, Voicy le temps heureux Des Plaiſirs & des Jeux.	On a quitté les armes Voici le temps heureux Des Plaisirs pleins de charmes, Voici le temps heureux Des Plaisirs et des Jeux.
MERCURE, Monſieur Langeais.	MERCURE, Monsieur Langeais.
PROSERPINE, Fille de Iupiter & de Ceres.	PROSERPINE, Fille de Jupiter et de Ceres.
Mademoiſelle Ferdinand l’aiſnée.	Mademoiselle Ferdinand l'aînée.
TROVIDue TOmphes.	TROUIDue TOmphes.
PicOVPEue Dieux des Bois.	PicOUPEue Dieux des Bois.
TROVPE d’Hahitans de Sicile.	TROUPE d'Hahitants de Sicile.
PLUTON, Dieu des Enfers.	PLUTON, Dieu des Enfers.
Monſieur Gaye.	Monsieur Gaie.
ASCALAPHE, Fiis an Picuve Acheron, & confident de Pluton.	ÀSCALAPHE, Fiis an Picuve Acheron, et confident de Pluton.
Monſieur Morel.	Monsieur Morel.
a.	a.
1.	1.
TROVPE de Divinitez infernales.	TROUPE de Divinités infernales.
TROVPE de Suivans de Cerés.	TROUPE de Suivants de Cerès.
IPITER.	IPITER.
Monſieur Godoneſche.	Monsieur Godonesche.
L’AMOUR, L’HYMENE’E, VENUS, PALLAS, APOLLON & HMEE EI.	L'AMOUR, L'HYMENE’-E, VENUS, PALLAS, APOLLON et HME EI.
TROVPE de Divinitez Celeſtes.	TROUPE de Divinités Clestes.
TROVPE de Divinitez de la Suite de Pluton:	TROUPE de Divinités de la Suite de Pluton:
VERTUMNE, FLORE & POMONE.	VERTUMNE, FLORE et POMONE.
TROVPE de DiviniteZ de la Terre.	TROUPE de Divinitez de la Terre.
HRO	HRO
PROSERPINE TRAGEDIE.	PROSERPINE -TRAGÉDIE.
ACTE PREMIER Le Theatre reprerente le Palais de Ceres.	ACTE PREMIER Le Théâtre réprerente le Palais de Ceres.
SCENE PREMIERE, CERES, CYANE’, CRINISE.	SCÈNE PREMIÈRE, CERES, CYANE', CRINISE.
CERES.	CERES.
OVSTONS dans ces aimables lieux Les douceurs d’une paix charmante.	OUSTONS dans ces aimables lieux Les douceurs d'une paix charmante.
Les ſuperbes Geants armeZ contre les Dieux Ne nous donnent plus d’eſpouvante:	Les superbes Geants armés contre les Dieux Ne nous donnent plus d'épouvante:
Ils ſont enſevelis ſous la maſſe peſante Des Monts qu’ils entaſſoient pour attaquer les Cieux Nous avons veu tomber leur Chef audacieux Sous une Montagne brulante;	Ils sont ensevelis sous la masse pesante Des Monts qu'ils entassaient pour attaquer les Cieux Nous avons vu tomber leur Chef audacieux Sous une Montagne brûlante;
Iupiter la contraint de vomir à nos yeux Les reſtes enflameZ de ſa rage mourante, Iupiter eſt victorieux, Et tout cede à l’effort de ſa main foudroyante.	Jupiter la contraint de vomir à nos yeux Les restes enflamés de sa rage mourante, Jupiter est victorieux, Et tout cède à l'effort de sa main foudroyante.
Gouſtons dans ces aimables lieux Dεο oomcοmrο eomo puue charmante.	Goûtons dans ces aimables lieux Doù oomcοmrο eomo puue charmante.
CERES, CYANE', & CRINISE.	CERES, CYANE, et CRINISE.
Gouſtons dans ces aimables lieux Les douceurs d’une païx charmante.	Goûtons dans ces aimables lieux Les douceurs d'une paix charmante.
CERES.	CERES.
Prenez ſoin d’aſſembler tout ces qui ſuit mes loix;	Prenez soin d'assembler tout ces qui suit mes lois;
Honnorons le vainqueur d’une commune voix.	Honorons le vainqueur d'une commune voix.
CERES, CYANE', & CRINISE.	CERES, CYANE, et CRINISE.
Honnorons le Vainqueur d’une commune voix.	Honorons le Vainqueur d'une commune voix.
Cyané & Criniſe vont de deux coſtez differents appeller les Divinitez & les peuples de la Sicilo, pour venir enſemble celebrer la victoire de Iupiter:	Cyané et Crinise vont de deux côtés différents appeler les Divinités et les peuples de la Sicilo, pour venir ensemble célébrer la victoire de Jupiter:
SCENE SECONDE.	SCÈNE SECONDE.
Ivereure deicend du Ciel.	Juvereure deicend du Ciel.
DicOvien, OuICES.	DicOvien, OuICES.
ERES.	ÈRES.
Ercure, quet deſſein toous fait icy deſcendee?	Ercure, quet dessein toous fait ici descende?
AVL MERCURE.	AUL MERCURE.
Iupiter prés de vous m’ordonne de me rendre.	Jupiter près de vous m'ordonne de me rendre.
CERES.	CERES.
Non, non, à vos diſcours je n’oſe adjoûter foy, faplrer apres ja dletetre, Songe à tenir en paix l’Univers ſous ſa loy;	Non, non, à vos discours je n'ose ajouter foi, fapérer après ja dletetre, Songe à tenir en paix l'Univers sous sa loi;
Il eſt trop occupé de ſa nouvelle gloire, Eh!	Il est trop occupé de sa nouvelle gloire, Eh!
le moyen de croire Qu’il ſonge encore à moy?	le moyen de croire Qu'il songe encore à moi?
MERCURE.	MERCURE.
Dans les ſoins les plus grands dont ſon ame eſt remplis Il ſe ſouvient toüjours que vous l’avez, charmé;	Dans les soins les plus grands dont son âme est remplis Il se souvient toujours que vous l'avez, charmé;
Il eſt mal-aisé qu’on oublie Ce qu’on a tendrement aimé, 13 Il admire les dons que vous venez de faire En cent climats divers, L’abondante Sicile heureuſe de vous plaire De vos riches moiſſons voit tous ſes champs couverts,	Il est malaisé qu'on oublie Ce qu'on a tendrement aimé, 13 Il admire les dons que vous venez de faire En cent climats divers, L'abondante Sicile heureuse de vous plaire De vos riches moissons voit tous ses champs couverts,
A i Mais la Mere des Dieux ſe plaint que la Phrygie Quelle a toûjours cherie, Ne ſe reſſente pas de vos ſoins bien-faiſants;	À y Mais la Mère des Dieux se plaint que la Phrygie Quelle a toujours chérie, Ne se ressente pas de vos soins bienfaisants;
Et c’est Iupiter qui vous prie E y porttr vos uroins preſents.	Et c'est Iupiter qui vous prie E y portr vos ouvroins présents.
Quelle gloire de voir qu’un Dieu ſi grand implore Vostre favorable ſecours!	Quelle gloire de voir qu'un Dieu si grand implore Votre favorable secours!
CERES.	CERES.
Peut-estre qu’il m’estime encore, Mais il m’avoit promis qu’il m’aimeroit toûjours.	Peut-être qu'il m'estime encore, Mais il m'avait promis qu'il m'aimerait toujours.
L’amour qui pour luy m’anime Devient plus fort chaque jour, Est-ce aſſeZ d’un peu d’eſtime Pour le prix de tant d’amour.	L'amour qui pour venir m'anime Devient plus fort chaque jour, Est-ce assez d'un peu d'estime Pour le prix de tant d'amour.
MERCURE.	MERCURE.
Il ſent l’ardeur qu’un tendre amour inſpire.	Il sent l'ardeur qu'un tendre amour inspire.
Avec plaiſir il ſe laiſſe enflamer;	Avec plaisir il se laisse enflammer;
Mais un amant chargé d’une grand Empire N’a pas toûjours le temps de bien aimer.	Mais un amant chargé d'une grand Empire N'a pas toujours le temps de bien aimer.
CERES.	CERES.
Quand de ſon cœur je devins ſouveraine N’avoit-il pas le Monde à gouverner, Et ne trouvoit-il pas ſans peine Du temps de reſte à me donner.	Quand de son cœur je devins souveraine N'avait-il pas le Monde à gouverner, Et ne trouvait-il pas sans peine Du temps de reste à me donner.
Ie l’ay veu ſous mes Loix ce Dieu ſi redoutable.	Je l'ai vu sous mes Lois ce Dieu si redoutable.
Ie l’ay veu plein d’empreſſement;	Je l'ai vu plein d'empressement;
Ah!	Ah!
qu'il feroit aimable, S’il-aimoit conſtamment!	qu'il ferait aimable, S'il-aimait constamment!
MENOVRE.	MENOURE.
Son amour craint de trop paraiſtre, Dans le Ciel on l’obſerve avec des yeux jaloux.	Son amour craint de trop paraître, Dans le Ciel on l'observe avec des yeux jaloux.
ERES.	ÈRES.
De quels Dieux n’est-il pas le Maiſtre?	De quels Dieux n'est-il pas le Maître?
Ne les fait-il pas trembler tous?	Ne les fait-il pas trembler tous?
Que vous l’excuſez mal quand mon amour l’accuſe;	Que vous l'excusez mal quand mon amour l'accuse;
S’il pouvoit avoir quelque excuſe, Mon cœur la trouveroit mille fois mieux que vous.	S'il pouvait avoir quelque excuse, Mon cœur la trouverait mille fois mieux que vous.
AlleZ, à ſes deſirs il faut que je reſponde.	Allez, à ses désirs il faut que je réponde.
Ie quitte une paix profonde, Qui m’offre icy mille appas:	Je quitte une paix profonde, Qui m'offre ici mille appas:
Que ne quitteroit-t’on pas Pour plaire au Maiſtre du Monde?	Que ne quitterait-t-on pas Pour plaire au Maître du Monde?
Mercure repete ces deux derniers Vers avec Ceres, & s’envole pour aller au Ciel retrouver Iupiter.	Mercure répète ces deux derniers Vers avec Ceres, et s'envole pour aller au Ciel retrouver Jupiter.
SCENE TROISIESME.	SCÈNE -TROISIÈME.
ARETHVSE, CERES.	ARÊTHÉSE, CERES.
ERES.	ÈRES.
A Phrygie a veſoin de mes dons precieux, TEt je laiſſe avec vous Proſerpine en ces lieux, I'ay peine à la quitter, cette Fille ſi chere.	À Phrygie a vesoin de mes dons précieux, TEt je laisse avec vous Proserpine en ces lieux, J'ai peine à la quitter, cette Fille si chère.
ARETHUSE.	ARETHUSE.
Ie quisuuno un bioue nne rCimpne eſtrangere, Ie viens vous conjurer de m’en laiſſer partir.	Je quisuuno un bioue nne rImpne étrangère, Je viens vous conjurer de m'en laisser partir.
CERES.	CERES.
Non, Arethuſe, non, je n’y puis conſentir.	Non, Arethuse, non, je n'y puis consentir.
ARETHUSE.	ARETHUSE.
Alphée à mon repos a declaré la guerre:	Alphée à mon repos a déclaré la guerre:
Diane propice à m'es vœux, En vain pour me cacher à ce Fleuve amoureux, Fit ouvrir le ſein de la Terre:	Diane propice à m'es vœux, En vain pour me cacher à ce Fleuve amoureux, Fit ouvrir le sein de la Terre:
Il n’eſt point de détours dans l’ombre des Enfers Que ſon amour n’ait découverts:	Il n'est point de détours dans l'ombre des Enfers Que son amour n'ait découverts:
Je l’ay trouvé par tout, & ſous des Mers profondes I’ay veu ſes flots brûlants ſnivre mes froides ondes;	Je l'ai trouvé par tout, et sous des Mers profondes J'ai vu ses flots brûlants snivre mes froides ondes;
Ie veux le fuïr encore au bout de l’Univers.	Je veux le fuir encore au bout de l'Univers.
CERES.	CERES.
Les ſoins d’un amour extreſme Devroient moins vout allarmer:	Les soins d'un amour extrême Devraient moins vout alarmer:
Vous craignez trop qu’on vous aime, Ne craigneZ vous point d’aimer?	Vous craignez trop qu'on vous aime, Ne craignez -vous point d'aimer?
Vous rougiſſez, Arethuſe;	Vous rougissez, Arethuse;
Voſtre rougeur vous accuſe.	Votre rougeur vous accuse.
Il' est aiſé de voir dans ce trouble fatal De perto ou vramour um ces toux vous expoſé.	Il est aisé de voir dans ce trouble fatal De perto ou vramour um ces toux vous exposé.
ARETHUSE.	ARETHUSE.
Le dangertux Amour?	Le dangertux Amour?
que je luy veux de mal Du trouble qu’il me cauſe!	que je te veux de mal Du trouble qu'il me cause!
CERES.	CERES.
Avec Alphée icy je veux vous arreſter.	Avec Alphée ici je veux vous arrêter.
ARETHVSE.	ARETHÉS.
Eh!	Eh!
de grace, aideZ-moy plutoſt à l'eviter.	de grâce, aidez-moi plutôt à l'éviter.
Ie crains enfin qu’il ne m’engage, Et ſa conſtance me fait peur:	Je crains enfin qu'il ne m'engage, Et sa constance me fait peur:
Non, ſi je le vois davantage, Ie ne reſpons plus de mon cœur.	Non, si je le vois davantage, Je ne répons plus de mon cœur.
CERES.	CERES.
Aimez ſans vous contraindre, AimeZ à voſtre tour.	Aimez sans vous contraindre, Aimez à votre tour.
l'eſt déja reſſentir l’amour Que de commencer à le craindre.	l'est déjà ressentir l'amour Que de commencer à le craindre.
Arethuſe chante ces deux derniers Vers avecceres.	Arethuse chante ces deux derniers Vers aveccères.
CERES.	CERES.
Demeurez, avec elle en un lieu ſi charmant.	Demeurez, avec elle en un lieu si charmant.
Pour fuïr l’Amour qui vous appelle Ne cherchez plus de vains détours:	Pour fuir l'Amour qui vous appelle Ne cherchez plus de vains détours:
Aimez, un Amant fidelle, On n’en trouve pas toüjours	Aimez, un Amant fidèle, On n'en trouve pas toujours
Ceres va voir Proſerpine avant que de partir pour aller en Phrygie.	Ceres va voir Proserpine avant que de partir pour aller en Phrygie.
SCENE QVATRIESME	SCÈNE QUATRIÈME
ARETHVSE ſeule.	ARETHÉSE seule.
JAine Fierté, foible Rigueur, V Que vous aveZ peu de puiſſance Contre l’Amour & la Constance!	JAine Fierté, faible Rigueur, V Que vous avez peu de puissance Contre l'Amour et la Constance!
Vaine Fïerté, foible Rigueur, Ah!	Vaine Fïerté, faible Rigueur, Ah!
que vous gardez mal mon cœur!	que vous gardez mal mon cœur!
En vain, par vos conſeils je me fais violence:	En vain, par vos conseils je me fais violence:
Ie combats vainement une douce langueur:	Je combats vainement une douce langueur:
Helas!	Hélas!
vous m’engagez à faire reſiſtance, Et vous me laiſſeZ ſans deffence, Au pouvoir de l’Amour vainqueur?	vous m'engagez à faire résistance, Et vous me laissez sans défense, Au pouvoir de l'Amour vainqueur?
Vaine Fierté, foible Rigueur, Que vous avez peu de puiſſance	Vaine Fierté, faible Rigueur, Que vous avez peu de puissance
Contre	Contre
Contre l’Amour & la Conſtance;	Contre l'Amour et la Constance;
Vaine Fierté, foible Rigueur, Ah!	Vaine Fierté, faible Rigueur, Ah!
que vous gardeZ mal mon cœur!	que vous gardez mal mon cœur!
Ie vois Alphée, ô Dieux!	Je vois Alphée, ô Dieux!
où ſera mon aſile!	où sera mon asile!
Mon cœur eſt dé ja charmé, Et ma fuite eſt inutile;	Mon cœur est de ja charmé, Et ma fuite est inutile;
Helas!	Hélas!
qu’il eſt difficile De fuïr un Amant aimé!	qu'il est difficile De fuir un Amant aimé!
Il aproche, je tremble.	Il approche, je tremble.
Ab faut-il qu’il joüiſſe Du trouble honteux où je ſuis?	Ab faut-il qu'il jouisse Du trouble honteux où je suis?
Pardonne, Amour, ſi jele fuis, I'en reſſens un cruel ſuplice;	Pardonne, Amour, si jele fuis, J'en ressens un cruel supplice;
Mais n'importe, je veux l'eviter ſi je puis.	Mais n'importe, je veux l'éviter si je puis.
SCENE CINQUIESME.	SCÈNE CINQUIÈME.
ALPHE’E, ARETHVSE.	ALPHÉE, ARETHUSE.
ALPHE’E.	ALPHÉE.
AI Rreſtez, Nymphe trop ſevere, Ne fuyez plus d’une courſe legere Les ſoins trop empreſſeZ de mon cœur amoureux;	AI Rrêtez, Nymphe trop sévère, Ne fuyez plus d'une course légère Les soins trop empressez de mon cœur amoureux;
N’ayez, plus contre moy ny chagrin ny colere, I’ay reſolu de ne vous plus déplaire, Et je vais eſtouffer mon amour malheureux.	N'ayez, plus contre moiblé chagrin ni colère, J'ai résolu de ne vous plus déplaire, Et je vais étouffer mon amour malheureux.
Alphée.	Alphée.
ARETHUSE.	ARETHUSE.
ALPHE’E Alphée enfin vous arreste, inhumaine, Mais vous vous arreſtez pour voir briſer ſa chaîne.	ÀLPHÉTE Alphée enfin vous arrête, inhumaine, Mais vous vous arrêtez pour voir briser sa chaîne.
C’en eſt fait, mes fers ſont rompus.	C'en est fait, mes fers sont rompus.
Alphée, eſt-il bien vray?	Alphée, est-il bien vrai?
USE.	USE.
ALPHE’E.	ALPHÉE.
N'en doutez point, Cruelle, Ie le reprens ce Cœur trop tendre & trop fidelle, Ce Cœur trop rebutté par de cruels refus.	N'en doutez point, Cruelle, Je le reprends ce Cœur trop tendre et trop fidèle, Ce Cœur trop rebuté par de cruels refus.
ARETHUSE.	ARETHUSE.
Alphée, eſt-il bien vray que vous ne m’aimiez plus?	Alphée, est-il bien vrai que vous ne m'aimiez plus?
ALPHE’E.	ALPHÉE.
Ingrate il eſt trop vray, mon Cœur rompt avec peine Des nœuds qu’il a trouvé ſi beaux;	Ingrate il est trop vrai, mon Cœur rompt avec peine Des nœuds qu'il a trouvé si beaux;
Mais de peur qu’il ne les reprenne Ie le veux engager en des liens nouveaux:	Mais de peur qu'il ne les reprenne Je le veux engager en des liens nouveaux:
I’ay veu l’aimable Proſerpine:	J'ai vu l'aimable Proserpine:
On connoit à l’éclat de ſa beauté divine Que am tau pie des Dieux elle a receu le jour.	On connaît à l'éclat de sa beauté divine Que am au pie des Dieux elle a reçu le jour.
RendeZ luy grace, C’eſt elle qui vous débaraſſe De mon facheux amour.	Rende lez grâce, C'est elle qui vous débarrasse De mon fâcheux amour.
ARETHUSE.	ARETHUSE.
Si proferpine est belle, Son Cœur eſt fier & rigoureux:	Si proserpine est belle, Son Cœur est fier et rigoureux:
Voſtre chaine nouvelle Ne vous rendra pas plus he ureux.	Votre chaine nouvelle Ne vous rendra pas plus hé ureux.
ALPHE’E.	ALPHÉE.
N'importe je veux bien ſouffrir ſous ſon empire.	N'importe je veux bien souffrir sous son empire.
Vous ne m'avez déja que trop accoustumé Au rigoureux martire D’aimer ſans estre aimé.	Vous ne m'avez déjà que trop accoutumé Au rigoureux martyre D'aimer sans ç aimé.
Proſerpine vous aime, & foſe aù moins pretendre Que vous me ſervirez, dans cet engagement.	Proserpine vous aime, et fose aù moins prétendre Que vous me servirez, dans cet engagement.
Vous ſçavez, ſi mon Cœur eſt tendre, Vous avez éprouvé s’il aime conſtamment.	Vous savez, si mon Cœur est tendre, Vous avez éprouvé s'il aime constamment.
ARETHUSE voulant fuir Alphée qui la ſuit.	ARETHUSE voulant fuir Alphée qui la suit.
Non je ne veux jamais entendre Parler ny d’amour ny d’amant.	Non je ne veux jamais entendre Parler ici d'amour ni d'amant.
me jurorte-vous ſans ceſſe?	me jurorte-vous sans cesse?
ALPHE’E.	ALPHÉE.
Me fuirez-vous toûjours?	Me fuirez-vous toujours?
L’ingrate Arethuſe me laiſſe Sans espoir de ſecours?	L'ingrate Arethuse me laisse Sans espoir de secours?
C’est un feu nouveau qui me preſſe.	C'est un feu nouveau qui me presse.
ARETHUSE.	ARETHUSE.
Me ſuiurez-vous ſans ceſſe?	Me suivrez-vous sans cesse?
ALPHE’E.	ALPHÉE.
Me fuirez-vous toujours?	Me fuirez-vous toujours?
SCENE SIXIESME.	SCÈNE SIXIÈME.
PROSERPINE, ALPHE’E, ARETHVSE, CYANE' CRINISE, Troupes de Divinitez & de Peuples de Sicile.	PROSERPINE, ALPHÉTE, ARETHUSE, CYANE' INISE, Troupes de Divinités et de Peuples de Sicile.
Six Divinitez des Bois chantantes.	Six Divinités des Bois chantes.
Meſſieurs, Gingant, Bernard, Frizon, le Cointre;	Messieurs, Gingant, Bernard, Frison, le Cointre;
Godoneſche, & Pulvigny.	Godonesche, et Pulvigni.
Six Divinitez des Eaus chantantes.	Six Divinités des Eaus chantes.
Meſſieurs, Tiphaine, Dávid, Duhamel, Perchot, Gaye fils, & Aubert.	Messieurs, Tiphaine, Dévid, Duhamel, Perchot, Gaie fils, et Aubert.
Meſſieurs, Fernon cadet, Rebel, Poyadon, la Foreſt, Moreau, & Lavernet.	Messieurs, Fernon cadet, Rebel, Poyadon, la Forêt, Moreau, et Lavernet.
Vn Conducteur de la Feſte dangant.	Un Conducteur de la Fête dangant.
Monſieur Favier l’aiſné.	Monsieur Favier l'aîné.
Six Habitans de Sicile dançants.	Six Habitants de Sicile dançants.
Meſſieurs, Faüre, Magny, Pecourt, Leſtang cadet, Germain & Dumirail.	Messieurs, Faüre, Magny, Pécourt, Létang cadet, Germain et Dumirail.
PROSERPINE.	PROSERPINE.
Eres va nous oſter ſa divine preſence, ( Ces lieux vont perdre leurs attraits, Ceres, ſavorable Ceres, Faités ceſſer bientoſt vostre cruelle abſence, C’eres, favorable Ceres lesnie Si,	Eres va nous ôter sa divine présence, ( Ces lieux vont perdre leurs attraits, Ceres, savorable Ceres, Faités cesser bientôt vôtre cruelle absence, C'ères, favorable Ceres lesnie Si,
Le Chœur repete ces derniers Vers.	Le Chœur répète ces derniers Vers.
SCENE SEPTIESME.	SCÈNE SEPTIÈME.
CERES, PROSERPINE, ALPHE’E, ARETHVSE, CYANE' CRINISE, Troupes de Divinſeon ce die reuples.	CERES, PROSERPINE, ALPHÉE, ARETHUSE, CYANE' CRINIS, Troupes de Divinseon ce die reuples.
CERES ſur ſon Char tiré par des Dragons aiſlez.	CERES sur son Char tiré par des Dragons aislez.
JOus qui voulez, pour moy ſignaler vostre zele Ne troublez, point la paix de cet heureux ſejour, Ie preſſe mon depart pour haſter mon retour;	JOus qui voulez, pour moi signaler votre zèle Ne troublez, point la paix de cet heureux séjour, Je presse mon départ pour hâter mon retour;
Accompagnez ma Fille avec un ſoin fidelle.	Accompagnés ma Fille avec un soin fidèle.
Changez vos triſtes chants en de charmants concerts;	Changez vos tristes chants en de charmants concerts;
Que j’entende en partant dans le milieu des airs Eſclater la gloire nouvelle Du plus grand Dieu de l’Vnivers.	Que j'entende en partant dans le milieu des airs Esclater la gloire nouvelle Du plus grand Dieu de l'Univers.
Ceres fait partir ſon Char volant.	Ceres fait partir son Char volant.
SCENE HUITIESME.	SCÈNE HUITIÈME.
PROSERPINE, ALPHEE, ARETHVSE, CYANE' CRINISE, Troupe de Divinitez, Troupe de Peuples.	PROSERPINE, ALPHÉE, ARETHUSE, CYANE' INISE, Troupe de Divinités, Troupe de Peuples.
PROSERPINE & le Chœur.	PROSERPINE et le Chœur.
Elebrons la victoire Du plus puiſſant des Dieux.	Élébrons la victoire Du plus puissant des Dieux.
Qu'un Trophée eternel conſerve la memoire D'un Triomphe ſi glorieux.	Qu'un Trophée éternel conserve la mémoire D'un Triomphe si glorieux.
Celebrons la victoire Du plus puiſſant des Dieux;	Célébrons la victoire Du plus puissant des Dieux;
Faiſons retentir juſqu’aux Cieux Le bruit éclattant de ſa gloire:	Faisons retentir jusqu'aux Cieux Le bruit éclattant de sa gloire:
Celebrons la victoire Dn pias payu ds Bix	Célébrons la victoire Den pias payu ds Bix
On dance autour d’un Trophée qu’on eſleve à l’honneur de Iupiter, & que l’on forme du débris des armes monſtrueuſes des Geans vaincus.	On dance autour d'un Trophée qu'on élève à l'honneur de Jupiter, et que l'on forme du débris des armes monstrueuses des Géants vaincus.
Sur la fin de cette Feſte on entend un tremblement de terre qui fait tomber une partie du Palais de Ceres.	Sur la fin de cette Fête on entend un tremblement de terre qui fait tomber une partie du Palais de Ceres.
PROSERPINE & LE CHOEVR.	PROSERPINE et LE CHOEUR.
Ce Palais va tomber;	Ce Palais va tomber;
& Dieux!	et Dieux!
la Terre s’ouvre!	la Terre s'ouvre!
Quels tremblements affreux!	Quels tremblements affreux!
L’Enfer decouvre Ses Gouſfres tenebreux.	L'Enfer découvre Ses Gouffres ténébreux.
mpinen tuner te Momnuure, Renverſez par de nouveaux coups.	minen tuner te Momnuure, Renversez par de nouveaux coups.
Le Chef audacieux des Enfans de la Terre:	Le Chef audacieux des Enfants de la Terre:
Il veut ſe relever pour s’armer contre vous, Achevez, d’étoufer la guerre.	Il veut se relever pour s'armer contre vous, Achevez, d'étouffer la guerre.
Iupiter:	Jupiter:
lancez le Tonnere.	lancez le Tonnere.
Le Tonnere tombe ſur le Mont Ætna, qui paroiſt dans l’eſloignement;	Le Tonnere tombe sur le Mont Hanna, qui paraît dans l'éloignement;
& ce coup acheve	et ce coup achève
ACTE	ACTE
ACTE SECOND.	ACTE SECOND.
SCENE PREMIERE.	SCÈNE PREMIÈRE.
Le Theatre change, & repreſente les Jardins de Ceres.	Le Theatre change, et représente les Jardins de Ceres.
& 2 RINISE.	et 2 RINISE.
Vpiter a dompté les Geants pour jamais.	Viter a dompté les Géants pour jamais.
Ce beau ſe jour brille de nouveaux charmes, Tout y reßent le retour de la Paix:	Ce beau se jour brille de nouveaux charmes, Tout y ressent le retour de la Paix:
Ah!	Ah!
que le repos a d’attraits Apres de mortelles allarmes.	que le repos a d'attraits Après de mortelles alarmes.
ALPHE’E.	ALPHÉE.
4 La Paix dans ces beaux lieux m’offre en vain mille appas, L’Amour en rend pour moy la douceur invtile;	4 La Paix dans ces beaux lieux m'offre en vain mille appas, L'Amour en rend pour moi la douceur invtyle;
Cruel Amour, helas!	Cruel Amour, hélas!
Que me ſert-il de voir tout le monde tranquille Si mon cœur ne l’eſt pas?	Que me sert-il de voir tout le monde tranquille Si mon cœur ne l'est pas?
2 Vous changez, vous quittez, une Nymphe inhumaine.	2 Vous changez, vous quittez, une Nymphe inhumaine.
Voſtre cœur ne riſque rien A choiſir une autre chaine, C’eſt toûjours un bien De changer de peine.	Votre cœur ne risque rien A choisir une autre chaine, C'est toujours un bien De changer de peine.
ALPHE’E.	ALPHÉE.
Heureux qui peut eſtre inconſtant!	Heureux qui peut être inconstant!
Rebutté des rigueurs d’vne haine éternelle, I'ay voulu la quitter cette Beauté cruelle, Et j’eſprouve qu’en la quittant Mon cœur est encor moins content.	Rebuté des rigueurs d'une haine éternelle, J'ai voulu la quitter cette Beauté cruelle, Et j'éprouve qu'en la quittant Mon cœur est encor moins content.
I’ay feint de reſſentir une flamme nouvelle, I’ay fait voir à ſes yeux un dépit éclatant;	J'ai feint de ressentir une flamme nouvelle, J'ai fait voir à ses yeux un dépit éclatant;
Mais helas!	Mais hélas!
dans le meſme inſtant Ie brûlois en ſecret, je languiſſois pour elle, Et je ne l’aimay jamais tant.	dans le même instant Je brûlais en secret, je languissais pour elle, Et je ne l'aimai jamais tant.
Qu’il couſte cher d’estre fidelle!	Qu'il coûte cher d'être fidèle!
Heureux qui peut eſtre inconstant!	Heureux qui peut être inconstant!
Criniſe & Alphée repettent enſemble ces deux derniers Vers.	Crinise et Alphée répettent ensemble ces deux derniers Vers.
Quelqu'vn vient, gardez le ſilence.	Quelqu'un vient, gardez le silence.
ALPHE’E.	ALPHÉE.
C'eſt Aſcalaphe qui s’avance Pour quelque ſoin preſſant il quitte les Enfers- Il n’a de mon amour que trop de connoïſſance, Quaurte poras porto mimome uomes fers?	C'est Ascalaphe qui s'avance Pour quelque soin pressant il quitte les Enfers- Il n'a de mon amour que trop de connaissance, Quaurte poras porto mimome omes fers?
SCENE DEUXIESME.	SCÈNE DEUXIÈME.
ASCALAPHE, ALPHE’E.	ÀSCALAPHE, ALPHÉE.
ALPHE’E.	ALPHÉE.
T Enez goûter icy le doux air qu’on reſpire,	T' Unez goûter ici le doux air qu'on respire,
ASCALAPHE.	ÀSCALAPHÉE.
Ie dois ſuivre le Dieu de l'Infernal Empire.	Je dois suivre le Dieu de l'Infernal Empire.
26.	26.
La Terre par ſes tremblements Vient d’ébranler les fondements De nos demeures ſombres:	La Terre par ses tremblements Vient d'ébranler les fondements De nos demeures sombres:
Pluton a' voulu voir ſi la clarté des Cieux Ne s’ouvre point de paſſage en ces lieux Pour aller aux Enfers effaroucher les Ombres.	Pluton a voulu voir si la clarté des Cieux Ne s'ouvre point de passage en ces lieux Pour aller aux Enfers effaroucher les Ombres.
Il mè permet de voir Arethuſe un moment.	Il mète permet de voir Arethuse un moment.
ALPHE’E.	ALPHÉE.
D’où vous vient tant d’empreſſement?	D'où vous vient tant d'empressement?
ASCALAPHE.	ÀSCALAPHÉE.
Ie l’ay veuë aux Enfers;	Je l'ai vue aux Enfers;
que je la trouvois belle!	que je la trouvais belle!
C i	Ç y
ALPHE’E.	ALPHÉE.
L'Ingrate me füoit, elle est toûjours cruelle,	L'Ingrate me fueait, elle est toujours cruelle,
ASCALAPHE.	ÀSCALAPHÉE.
Ses cruauteZ pour vous ſes ſoins pour fuïr vos pas Ont encore à mes yeux augmenté ſes appas.	Ses cruauté pour vous ses soins pour fuir vos pas Ont encore à mes yeux augmenté ses appas.
ALPHE’E.	ALPHÉE.
1Les flammes amoureuſes.	1Les flammes amoureuses.
Deſcendent-elles juſqu’à vous?	Descendent-elles jusqu'à vous?
L’Amour veut un ſejour plus doux Que vos demeures tenebreuſes.	L'Amour veut un séjour plus doux Que vos demeures ténébreuses.
ASCALAPHE.	ÀSCALAPHÉE.
L’Astre brillant qui vous luit Finit ſon cours dans les ondes, Il ne peut percer la nuit De nos demeures profondes;	L'Astre brillant qui vous luit Finit son cours dans les ondes, Il ne peut percer la nuit De nos demeures profondes;
Alais il Reſt point de jejour Impenetrable à l’Amour.	Alais il Rest point de jejour Impénétrable à l'Amour.
E.	E.
Qu'eſpereZ-vous d’une ame ſi ſevere?	Qu'espérez-vous d'une âme si sévère?
Mon amour ne peut l’émouvoir.	Mon amour ne peut l'émouvoir.
ASCALAPHE.	ÀSCALAPHÉE.
Vn autre pourra le ſçavoir.	Un autre pourra le savoir.
ALPHE’E.	ALPHÉE.
Sçaurez-vous de ſon cœur vaincre la reſiſtance?	Saurez-vous de son cœur vaincre la résistance?
Eſt-ce aux Enfers qu’on apprend ce ſecret?	Est-ce aux Enfers qu'on apprend ce secret?
ASCALAPHE.	ÀSCALAPHÉE.
On aprend aux Enfers à garder le, ſilence, Et l’on y ſoait estre diſcret;	On apprendre aux Enfers à garder le, silence, Et l'on y soait être discret;
La Nymphe que je cherche avec ſoin vous évite, Lour ta trouotr, it fuut que je vous quitte.	La Nymphe que je cherche avec soin vous évite, Lour ta trouotr, it fut que je vous quitte.
SCENE TROISIESME.	SCÈNE -TROISIÈME.
ALPHE’E ſeul.	ÀLPHÉE seul.
Mants qui n’eſtesspoint jaloux, A Que voſtre ſort eſt doux!	Mans qui n'estesspoint jaloux, À Que votre sort est doux!
L’Amour m’a fait gémir ſous une dure chaîne;	L'Amour m'a fait gémir sous une dure chaîne;
Mais quand je me plaignois de ſes funeſtes coups Ie ne connoiſſois pas le plus cruel de tous.	Mais quand je me plaignais de ses funestes coups Je ne connaissais pas le plus cruel de tous.
Vn autre aime Arethuſe & ne craint point ſa haine;	Un autre aime Arethuse et ne craint point sa haine;
Et je voy ſur moy ſeul tomber tout ſon courroux:	Et je vois sur moi seul tomber tout son courroux:
C’estoit peu du malheur d’aimer une inhumaine, Le bonheur d’un Rival a redoublé ma peine.	C'était peu du malheur d'aimer une inhumaine, Lé heur d'un Rival a redoublé ma peine.
Amants qui n’eſtes point jaloux, Que voſtre ſort eſt doux!	Amants qui n'êtes point jaloux, Que votre sort est doux!
SCENE QVATTRIE'ME.	SCÈNE QUTTRIE'ME.
ALPHE’E, ARETHVSE.	ALPHÉE, ARETHUSE.
ALP HE’E.	ALP HÉL'E.
Ngrate, eſcoutez-moy, je ne veux plus me plain4 dre, Ie ne vous diray rien qui vous puiſſe allarmer.	Négrate, écoutez-moi, je ne veux plus me plain4 dre, Je ne vous dirai rien qui vous puisse alarmer.
ARETHUSE.	ARETHUSE.
Vous ceßez de m'aimer, Ie ceſſe de vous craindré.	Vous cessez de m'aimer, Je cesse de vous craindré.
ALPHE’E.	ALPHÉE.
Aſcalaphe vous cherche icy, Bien-tost vous le verreZ paraistre;	Ascaphe vous cherche ici, Bientôt vous le verrez paraître;
Arethuſe, peut-eſtre, Vous le cherchez auſſi.	Arethuse, peut-être, Vous le cherchez aussi.
lepε GE ARET HVSE.	lep GE ARET HUSE.
L’aimable Proſerpine en voſtre ame a fait naiſtre.	L'aimable Proserpine en votre âme a fait naître.
Vne nouvelle ardeur;	Une nouvelle ardeur;
Si vous ne m’aimeZ plus, que vous ſert de connaiſtre Le ſecret de mon cœur?	Si vous ne m'aimez plus, que vous sert de connaître Le secret de mon cœur?
ALRHE’E.	ÀLRHÉE.
Faut-il que vostre Cœur à l’Amour moins rebelle Recompenſe un Amant ſans eſprouver ſa foy?	Faut-il que votre Cœur à l'Amour moins rebelle Récompense un Amant sans éprouver sa foi?
Si ce bien eust eſté le prix du plus fidele, Ah!	Si ce bien eût été le prix du plus fidèle, Ah!
vous ſçaveZ, Cruelle, Qu'il n'eſtoit du qu'à moy.	vous savez, Cruelle, Qu'il n'était du qu'à moi.
2 JSE.	2 JÉ.
Voſtre nouvelle chaîne est ſi belle & ſi forte!	Votre nouvelle chaîne est si belle et si forte!
Pourquoy ſonger encore à des liens rompus.	Pourquoi songer encore à des liens rompus.
Que vous importe Qu'un autre emporte Vn prix qui ne vous touche plus?	Que vous importe Qu'un autre emporte Un prix qui ne vous touche plus?
I E Vous aveZ fuy les ſoins de mon amour extreſme, Vous m’aveZ oſt ſreut eſpoir:	I Y Vous avez fui les soins de mon amour extrême, Vous m'avez ost sut espoir:
Si je diſois que pe'tvous aime, 2 Vous m’oſterieZ encor le plaiſir de vous voir.	Si je disais que pe'tvous aime, 2 Vous m'ôteriez encor le plaisir de vous voir.
ARETHUSE & ALPHE’E.	ARETHUSE et ALPHÉTHÉE.
Ceſt vne CC’eſt un autre que moy qui regne dans voſtre ame:	Cest une CC'est un autre que moi qui règne dans votre âme:
Vous trouvez d’autres nœuds plus doux:	Vous trouvez d'autres nœuds plus doux:
En vain je veux cacher ma flâme, Mon amour paroiſt trop dans mes tranſports jaloux;	En vain je veux cacher ma flamme, Mon amour paraît trop dans mes transports jaloux;
Non, je ne puis aimer que vous.	Non, je ne puis aimer que vous.
SCENE CINQVIESME.	SCÈNE CINQUIÈME.
ASCALAPHE, ARE THVSE, ALPHEE	ÀSCALAPHE, ARE THUSE, ALPHÉE
ADIVDLs.	ADIVDLs.
St-il vray que mon cœur ſoit en voſtre puiſſance.	St-il vrai que mon cœur soit en votre puissance.
ASCALAPHE.	ÀSCALAPHÉE.
Ie vous aime ſans eſperance;	Je vous aime sans espérance;
I'ay voulu ſoulager mon mal Par le chagrin de mon Rival.	J'ai voulu soulager mon mal Par le chagrin de mon Rival.
Dans les Enfers;	Dans les Enfers;
c’eſt ainſi qu’on en uſe:	c'est ainsi qu'on en use:
Mes maux n’ont pû trouver d’autre adouciſſement.	Mes maux n'ont pu trouver d'autre adoucissement.
Pardonnez-moy, belle Ahreije, Ie ne ſuis pas le ſeul qui ſe vante en aimant De poſſeder un Cœur qu’on luy refuſe.	Pardonnez-moi, belle Ahreije, Je ne suis pas le seul qui se vante en aimant De posséder un Cœur qu'on mille refuse.
Mais Alphée aujourd’huy n’eſt plus tant rebutté?	Mais Alphée aujourd'hui n'est plus tant rebuté?
Vous ne fuyez plus ſa preſence?	Vous ne fuyez plus sa présence?
ARETHVSE.	ARETHÉS.
Pour punir voſtre vanité Ie veux que vous voyez triompher ſa conſtance.	Pour punir votre vanité Je veux que vous voyez triompher sa constance.
ASCALAPHE.	ÀSCALAPHÉE.
En luy donnant la preference, Vous me rendeZ la liberté.	En avait donnant la préférence, Vous me rendez la liberté.
Le dépit qui me poſſede Me guerira promptement, Pous en fattes mon tourment, Et j’en feray mon remede.	Le dépit qui me possède Me guérira promptement, Pous en fattes mon tourment, Et j'en ferai mon remède.
ALPHEE & ARETHVSE.	ALPHÉE et ARETHUSE.
Pour eſtre heureux, il faut qu’on aime bien.	Pour être heureux, il faut qu'on aime bien.
ASCALAPHE.	ÀSCALAPHÉE.
Tont estre neuemse te fomit eeetoi muime rien.	Tont être névemse te fomit eeetoi muime rien.
Mais Pluton va bien-toſt rentrer dans ſon Empire:	Mais Pluton va bientôt rentrer dans son Empire:
Il paſſe en ces lieux, il admire Les charmes d’vn fejour ſi doux.	Il passe en ces lieux, il admire Les charmes d'un séjour si doux.
SCENE SIXIESME.	SCÈNE SIXIÈME.
PLVTON, ARETHVSE, ASCALAPHE, ALPHE’E.	PLUTON, ARETHUSE, ASCALAPHE, ALPHÉE.
EmeureZ Arethuſe, Alphée eſloignez-vous.	Emeurez Arethuse, Alphée éloignez-vous.
Alphée ſe retire, & Pluton continuë à parler.	Alphée se retire, et Pluton continue à parler.
Les efforts d’un Geant qu’on croyoit accablé Ont fait encor frémir le Ciel, la Terre, & l’Onde.	Les efforts d'un Geant qu'on croyait accablé Ont fait encor frémir le Ciel, la Terre, et l'Onde.
Mon Empire s’en eſt troublé;	Mon Empire s'en est troublé;
Juſqu’au centre du Monde Mon Troſne en a tremblé.	Jusqu'au centre du Monde Mon Trône en a tremblé.
L’affreux Typhœe avec ſa vaine rage Trébuche enfin dans des gouffres Jans fonds.	L'affreux Typhœe avec sa vaine rage Trébuche enfin dans des gouffres Jans fonds.
L'éclat du jour ne s’ouvre aucun paſſage Pour penetrer les Royaumes profonds Qui me ſont eſcheus en partage.	L'éclat du jour ne s'ouvre aucun passage Pour pénétrer les Royaumes profonds Qui me sont échus en partage.
Le Ciel ne craindra plus que ſes ſiers Ennemis Se relevent jamais de leur chûte mortelle, Et du monde esbranté par leur fureur rebelle Les fondemens ſont raffermis:	Le Ciel ne craindra plus que ses siers Ennemis Se relèvent jamais de leur chute mortelle, Et du monde esbranté par leur fureur rebelle Les fondements sont raffermis:
Je puis faire goüter tne puue cointue Aux Peuples ſoûterrains que le Sort m’a ſoûmis.	Je puis faire goûter tune peuve cointue Aux Peuples souterrains que le Sort m'a soumis.
Mais par vos ſoins puis-je voir Proſerpine Avant que de quitter cét aimable ſejour?	Mais par vos soins puis-je voir Proserpine Avant que de quitter cet aimable séjour?
ARETHUSE.	ARETHUSE.
Cette fiere Beauté s’obſtine A fuïr les Amants & l’Amour.	Cette fière Beauté s'obstine A fuir les Amants et l'Amour.
Dans l’innocent repos de cette ſolitude Elle évite les Dieux De la Terre & des Cieux:	Dans l'innocent repos de cette solitude Elle évite les Dieux De la Terre et des Cieux:
IugeZ de ſon inquietude Si le Dieu des Enfers paroiſſoit à ſes yeux.	Jugez de son inquiétude Si le Dieu des Enfers paraissait à ses yeux.
Caché ſous cét eſpais feüillage Vous pourriez la voir un moment.	Caché sous cet épais feuillage Vous pourriez la voir un moment.
Allez, il ſuffira que vostre ſoin l’engage A venir dans ce lieu charmant, Et ſi je puis la voir il n’importe comment.	Allez, il suffira que votre soin l'engage À venir dans ce lieu charmant, Et si je puis la voir il n'importe comment.
I 2 LE SETTIESM E LVTON, ASCALAPHE.	I 2 LE SETTIESM E VTON, ASCALAPHE.
ALAPHE, Ay peine a contecotr avu toient te trouble extreſme Où le Cœur de Pluton ſemble s’abandonner.	ÀLAPHE, Ai peine a contecout avu taient te trouble extrême Où le Cœur de Pluton semble s'abandonner.
ON.	ON.
Tu peux t’en estonner, I'en ſuis ſurpris moy-meſme I’ay trouvé Proſerpine en viſitant ces lieux.	Tu peux t'en étonner, J'en suis surpris moi-même J'ai trouvé Proserpine en visitant ces lieux.
Les pleurs couloient de ſes beaux yeux:	Les pleurs coulaient de ses beaux yeux:
Elle fuyoit, interdite, & tremblante;	Elle fuyait, interdite, et tremblante;
Pour implorer l’aſſiſtance des Dieux Elle tournoit ſes regards vers les Cieux:	Pour implorer l'assistance des Dieux Elle tournait ses regards vers les Cieux:
Sa douleur & ſon eſpouvante Rendoient encor ſa beauté plüs touchante.	Sa douleur et son épouvante Rendaient encor sa beauté plus touchante.
Les accens plaintifs de ſa voix Ont eſmeu mon cœur inflexible;	Les accens plaintifs de sa voix Ont ému mon cœur inflexible;
Qu'un Cœur fier eſt troublé quand il devient ſenſible Pour la premiere fois!	Qu'un Cœur fier est troublé quand il devient sensible Pour la première fois!
ASCALAPHE.	ÀSCALAPHÉE.
Contre l’Amour quel cœur peut ſe deffendre?	Contre l'Amour quel cœur peut se défendre?
Le temps d’aymer n’eſt pas connu, Il faut l’attendre;	Le temps d'aimer n'est pas connu, Il faut l'attendre;
Quand ce temps fatal est venu, Il faut ſe rendre.	Quand ce temps fatal est venu, Il faut se rendre.
Contre l’Amour quel cœur peut ſe deffendre?	Contre l'Amour quel cœur peut se défendre?
D ij	D ij
UTON.	UTON.
De ce Dieu ſi puiſſant je meſpriſois les feux, I'eſprouve enfin ſa vengeance cruelle.	De ce Dieu si puissant je méprisais les feux, J'éprouve enfin sa vengeance cruelle.
Ie l’ay veu ce Dieu dangereux, Il ſuivoit Proſerpine, il voloit aprés elle.	Je l'ai vu ce Dieu dangereux, Il suivait Proserpine, il volait après elle.
ay veu de ſa fatale main Partir un trait de flamme, J'ay voulu l’éviter en vain, Le toup a penetre juſqu'au fonu de mon ame.	ai vu de sa fatale main Partir un trait de flamme, J'ai voulu l'éviter en vain, Le toup à pénètre jusqu'au fonu de mon âme.
ASCALAPHE.	ÀSCALAPHÉE.
L'Amour a ſurmonté le Maiſtre des Enfers;	L'Amour a surmonté le Maître des Enfers;
fl n’a plus rien à vaincre aprés cette victoire.	fl 'a plus rien à vaincre après cette victoire.
PLUTON & ASCALAPHE.	PLUTON et ASCALAPHÉE.
L'Amour comblé d gloire Triomphe de tout l’Vnivers.	L'Amour comblé d gloire Triomphe de tout l'Univers.
PROSERPINE & ſes Nymphes.	PROSERPINE et ses Nymphes.
Es beaux jours & la Paix ESont revenus enſemble.	Es beaux jours et la Paix ESont revenus ensemble.
J N.	 J.
La Troupe des Nymphes s’aſſemble, Retirons-nous ſous ce feüillage eſpais.	La Troupe des Nymphes s'assemble, Retirons-nous sous ce feuillage épais.
Pluton & Aſcalaphe ſe retirent & ſe cachent, & Proſerpine & ſes Nymphes s’avancent en dançant & en chantant.	Pluton et Ascalaphe se retirent et se cachent, et Proserpine et ses Nymphes s'avancent en dançant et en chant.
Les beaux jours & là Paix Sont revenus enſemble.	Les beaux jours et là Paix Sont revenus ensemble.
On ne voit plus de cœur qui tremble, Tout rit dans ces lieux pleins d’attraits.	On ne voit plus de cœur qui tremble, Tout rit dans ces lieux pleins d'attraits.
Les beaux jours & la Paix Sont revenus enſemble.	Les beaux jours et la Paix Sont revenus ensemble.
proſerpine & ſes Nymphes continüent leurs Dances & leurs chants.	proserpine et ses Nymphes continuent leurs Dances et leurs chants.
PROSERPINE.	PROSERPINE.
Belles fleurs, charmant ombrage Il ne faut aimer que vous.	Belles fleurs, charmant ombrage Il ne faut aimer que vous.
LECHOEVR.	LECHOUR.
On ne trouve rien de doux Quand on eſt dans l’eſclavage.	On ne trouve rien de doux Quand on est dans l'esclavage.
ROSERPINE.	ROSERPINE.
Belles fleurs, charmant ombrage Jl ne faut aimer que vous.	Belles fleurs, charmant ombrage Il ne faut aimer que vous.
LE CHOEUR.	LE CHOEUR.
Les Amants n’ont en partage Que langueurs, que ſoins jaloux.	Les Amants n'ont en partage Que langueurs, que soins jaloux.
ROSERPINE.	ROSERPINE.
Belles fleurs, charmant ombrage Il ne faut aimer que vous.	Belles fleurs, charmant ombrage Il ne faut aimer que vous.
IOEUR.	JOUR.
Beues fieurs charmant ombrage, Il ne faut aimer que vous.	Bues sieurs charmant ombrage, Il ne faut aimer que vous.
oa	oa
PROSERPINE.	PROSERPINE.
Quand un Cœur eſt trop ſenſible, Rien ne peut le rendre heureux.	Quand un Cœur est trop sensible, Rien ne peut le rendre heureux.
LE CHOEUR.	LE CHOEUR.
Dans les plus aimables nœuds On n’a point de bien paiſible.	Dans les plus aimables nœuds On n'a point de bien paisible.
PROSERPINE.	PROSERPINE.
Quand un Cœur eſt trop ſenſible, Rien ne peut le rendre heureux.	Quand un Cœur est trop sensible, Rien ne peut le rendre heureux.
LE OITOBVR.	LE OITOBUR.
C’eſt toûjours un mal terrible Que l’ardeur des plus beaux feux.	C'est toujours un mal terrible Que l'ardeur des plus beaux feux.
PROSERPINE.	PROSERPINE.
Quand un Cœur eſt trop ſenſible, Rien ne peut le rendre heureux.	Quand un Cœur est trop sensible, Rien ne peut le rendre heureux.
LE CHOEVR.	LE CHOEUR.
Quand un Cœur eſt trop ſenſible Rien ne peut le rendre heureux.	Quand un Cœur est trop sensible Rien ne peut le rendre heureux.
PROSERPINE.	PROSERPINE.
e noſtre vie Doit faire envie!	 nôtre vie Doit faire envie!
Le vray bonheur Eſt de garder ſon cœur.	Le vrai bonheur Est de garder son cœur.
Le jour n’eſclaire Que pour nous plaire;	Le jour n'éclaire Que pour nous plaire;
Ces Arbres verds.	Ces Arbres verts.
Ont leur plus beau feüillage, Et mille Oyſeaux divers Dans ce boccage Imittent nos Concerts Par leur ramage;	Ont leur plus beau feuillage, Et mille Oiseaux divers Dans ce bocage Imittent nos Concerts Par leur ramage;
Que nostre vie Doit faire envie!	Que notre vie Doit faire envie!
Le vray bonheur Est de garder ſon cœur.	Le vrai bonheur Est de garder son cœur.
Tout s’intereſſe Dans nos deſirs, Iamais l'Amour ne nous bleſſe, Les doux plaiſirs Sont pour les cœurs ſans foibleſſe.	Tout s'intéresse Dans nos désirs, Jamais l'Amour ne nous blesse, Les doux plaisirs Sont pour les cœurs sans faiblesse.
Que noſtre vie Doit faire envie!	Que notre vie Doit faire envie!
Le vray bonheur Eſt de garder ſon cœur.	Le vrai bonheur Est de garder son cœur.
L'E CHOEVR.	L'E CHOEUR.
Que noſtre vie Doit faire envie!	Que notre vie Doit faire envie!
Le vray bonheur Eſt de garder ſon cœur.	Le vrai bonheur Est de garder son cœur.
Pour nous deffendre D’un amour tendre, Avec fierté, Nous avons pris les armes:	Pour nous défendre D'un amour tendre, Avec fierté, Nous avons pris les armes:
Nos biens n’ont point coûté De tristes larmes, Eu tiborté N'a jamais que des charmes:	Nos biens n'ont point coûté De tristes larmes, Eu tiborté N'a jamais que des charmes:
Que noſtre vie, &c.	Que notre vie, etc.
ROSERPINE.	ROSERPINE.
Nous reverrons bien-toſt Ceres dans ces beaux lieux, Il faut luy preparer des guirlandes nouvelles.	Nous reverrons bientôt Ceres dans ces beaux lieux, Il faut parler préparer des guirlandes nouvelles.
Separons-nous, voyons qui ſçait le mieux Aſſortir les fleurs les plus belles.	Séparons-nous, voyons qui sait le mieux Assortir les fleurs les plus belles.
Chœur de Nymphes.	Chœur de Nymphes.
Uoyons qui ſçait le mieux Aſſortir les fleurs les plus belles.	Oùoyons qui sait le mieux Assortir les fleurs les plus belles.
Les Nymphes s’écartent, Proſerpine & Cyané cüeillent des Fleurs.	Les Nymphes s'écartent, Proserpine et Cyané cueillent des Fleurs.
SCENE NEVFIESME.	SCÈNE NEUFIESME.
PLVTON, PROSERPINE, ASCALAPHE, CYANE', Troupe de Divinitez des Enfers.	PLUTON, PROSERPINE, ASCAPHE, CYANE', Troupe de Divinités des Enfers.
Huit Divinitez Infernalles chantantes.	Huit Divinités Infernalles chantes.
PLUTON.	PLUTON.
Nfernales Divinitez, ISecondez mon amour, ſortez.	Néfernales Divinités, ISecondez mon amour, sortez.
Vne Troupe de Divinitez infernales ſort de la Terre, & le Char de Pluton paroiſt en meſme temps.	Une Troupe de Divinités infernales sort de la Terre, et le Char de Pluton paraît en même temps.
PROSERPINE.	PROSERPINE.
Ciel!	Ciel!
prenez ma deffence!	prenez ma défense!
PROSERPINE & CYANE'.	PROSERPINE et CYANE.
O Ciel!	Ô Ciel!
protegeZ l’innocence!	protestez l'innocence!
PLVTON, ASCALAPHE, & les Divinitez infernales.	PLUTON, ASCALAPHÉE, et les Divinités infernales.
Proſerpine ne craignez pas Vn Dieu charmé de vos appas.	Proserpine ne craignez pas Un Dieu charmé de vos appas.
GYANE' retenant Proſerpine.	GYANE' retenant Proserpine.
Qu'elle barbare violence:	Qu'elle barbare violence:
PLVTON.	PLUTON.
Nymphe, crain ma vangeance?	Nymphe, crain ma vengeance?
Sur peine de perdre la voix.	Sur peine de perdre la voix.
Carde-toy de parler de tout ce que tu vois.	Carde-toi de parler de tout ce que tu vois.
L’Eſcharpe de Proſerpine demeure dans les mains de Cyané, & Pluton fait placer Proſerpine prés de luy ſur ſon Char	L'Écharpe de Proserpine demeure dans les mains de Cyané, et Pluton fait placer Proserpine près de Seigneur sur son Char
TROSERTINE.	TROSERTINE.
Cielt preneZ ma deffence!	Cielt prenez ma défense!
PROSERPINE & CYANE'.	PROSERPINE et CYANE.
O Ciel!	Ô Ciel!
protegez l’innocence;	protégez l'innocence;
PLVTON, ASCALAPHE, & les Divinitez infernales deſcendans aux Enfers avec Proſerpine.	PLUTON, ASCALAPHE, et les Divinités infernales descendants aux Enfers avec Proserpine.
E- Proſerpine, ne craignez pas, Vn Dieu charmé de vos appas.	E- Proserpine, ne craignez pas, Un Dieu charmé de vos appas.
Fin du ſecond Acte.	Fin du second Acte.
AATE III.	AATE III.
SCENE PREMIERE.	SCÈNE PREMIÈRE.
Le Theatre change, & repreſente le Mont Ætna vomiſſant des flâmes, & les lieux dalciitour.	Le Theatre change, et représente le Mont Ætna vomissant des flammes, et les lieux dalciitour.
ALPHE’E, ARETHVSE, CRINISE, Troupe de Nymphes, Troupe de Dieux des Bois.	ÀLPHÉ, ARETHUSE, CRINISE, Troupe de Nymphes, Troupe de Dieux des Bois.
Q Tous enſemble.	 Tous ensemble.
Roſerpine?	Roserpine?
respondeZ-nous?	répondez-nous?
Helas!	Hélas!
en quels lieux eſtes-vous?	en quels lieux êtes-vous?
O diſgraces cruelle!	Ô disgrâces cruelle!
L’Echo fidelle Au fond des Bois Reſpond à noſtre voix;	L'Écho fidèle Au fond des Bois Répond à notre voix;
Proſerpine?	Proserpine?
ah faut-il qu’en vain on vous appelle!	ah faut-il qu'en vain on vous appelle!
Proſerpine?	Proserpine?
reſpondeZ-nous?	répondez-nous?
2 ij Helas!	2 ij Élas!
en quels lieux eſtes vous?	en quels lieux êtes -vous?
O diſgrace cruelle!	Ô disgrâce cruelle!
SUENE SECONDE.	SUENE SECONDE.
ARETHVSE, ALPHE’E.	ARETHÉSE, ALPHÉE.
ARETHVSE.	ARETHÉS.
’Aurois-je point innocemment I (Causé tant de cris & de larmes?	Ç'Aurais-je point innocemment I CAusé tant de cris et de larmes?
D’un deſir curieux je n’ay point pris d’allarmes;	D'un désir curieux je n'ai point pris d'alarmes;
Qui croiroit que Pluton pût devenir amant!	Qui croirait que Pluton pût devenir amant!
Il demandoit à voir Proſerpine un moment, Ae eratits qu'et n'un trop oeu ſes charmes, Ce n’est que par mes ſoins que Ceres peut ſçavoir Si le Dieu des Enfers tient ſa Fille captive;	Il demandait à voir Proserpine un moment, Ae eratits qu'et n'un trop œu ses charmes, Ce n'est que par mes soins que Ceres peut savoir Si le Dieu des Enfers tient sa Fille captive;
Il m’eſt permis d’aller ſur l’infernale Rive:	Il m'est permis d'aller sur l'infernale Rive:
Adieu, dans peu de temps j’espere vous revoir.	Adieu, dans peu de temps j'espère vous revoir.
ALPHE’E.	ALPHÉE.
Pouvez-vous oublier qu’il faut que je vous ſuive?	Pouvez-vous oublier qu'il faut que je vous suive?
I'ay ſans ceſſe ſuivy vos pas Quand j’excitois voſtre colere:	J'ai sans cesse suivi vos pas Quand j'excitais votre colère:
Quand j’ay ceßé de vous déplaire Pourrois-je ne vous ſuivre pas?	Quand j'ai cessé de vous déplaire Pourrais-je ne vous suivre pas?
ARETHUSE.	ARETHUSE.
Du Maistre des Enfers je veux aller me plaindre, Craignez en me ſuivant d’attirer ſon courroux.	Du Maître des Enfers je veux aller me plaindre, Craignez en me suivant d'attirer son courroux.
ALPHE’E.	ALPHÉE.
Pour moy rien n’eſt tant à craindre Que d’eſtre éloigné de vous.	Pour moi rien n'est tant à craindre Que d'être éloigné de vous.
Que l’abſence de ce qu’on aime Eſt un ſupplice rigoureux!	Que l'absence de ce qu'on aime Est un supplice rigoureux!
Pour les cœurs amoureux, Tout autre mal beue ur et mut extreſme, Et l’Enfer meſme N'a rien de plus affreux 2 Que l'abjenće de ce qu'on atme.	Pour les cœurs amoureux, Tout autre mal bue ur et mut extrême, Et l'Enfer même N'a rien de plus affreux 2 Que l'abjenće de ce qu'on atme.
ALPHE’E & ARETHUSE.	ALPHÉE et ARETHUSE.
Le bon-heur eſt par tout où l’amour eſt en paix, Ne nous quittons jamais.	Le bonheur est par tout où l'amour est en paix, Ne nous quittons jamais.
SCENE TROISIESME.	SCÈNE -TROISIÈME.
ALPHE’E ARETHVSE, CRINISE, Troupes de Nymphes & de Dieux des Bois.	ALPHE’E ARETHUSE, CRINISE, Troupes de Nymphes et de Dieux des Bois.
Tous enſemble.	Tous ensemble.
NEres revient!	NEres revient!
ah qu’elle peine!	ah qu'elle peine!
Cachons-nous à ſes yeux.	Cachons-nous à ses yeux.
Sa Fille n’eſt plus dans ces lieux;	Sa Fille n'est plus dans ces lieux;
Son eſperance eſt vaine.	Son espérance est vaine.
Que luy pourrons-nous dire, ô Dieux!	Que quelque pourrons-nous dire, ô Dieux!
Ceres revient;	Ceres revient;
ah quelle peine!	ah quelle peine!
Cachons-nous à ſes yeux, * Les Nymphes & les Dieux des Bois ſe cachent, Alphée & Arethuſe deſcendent aux Enfers, le Chat vorarie de Ceres s’arrerte, & la Déeſſe en deſcend.	Cachons-nous à ses yeux, * Les Nymphes et les Dieux des Bois se cachent, Alphée et Arethuse descendent aux Enfers, le Chat vorarie de Ceres s'arrète, et la Déesse en descend.
SCENE QVATRIESME	SCÈNE QUATRIÈME
CERES.	CERES.
E vais revoir ma Fille, elle eſt dans ces CamT pagnes:	E vais revoir ma Fille, elle est dans ces CamT pagnes:
Ie viens d’y voir les Nymphes ſes Compagnes.	Je viens d'y voir les Nymphes ses Compagnes.
Ie vais goûter prés d’elle un ſort doux & charmant.	Je vais goûter près d'elle un sort doux et charmant.
Helas!	Hélas!
qu’vn tendre amour accroiſt l’empreſſement De la tendreſſe maternelle.	qu'un tendre amour accroît l'empressement De la tendresse maternelle.
Proſerpine eſt pour moy le gage precieux De l’amour le plus grand des Dieux, C’eſt Jupiter que j’aime en elle.	Proserpine est pour moi le gage précieux De l'amour le plus grand des Dieux, C'est Jupiter que j'aime en elle.
I'ay rendu les humains heureux, Mes travaux ont comblé leurs vœux;	J'ai rendu les humains heureux, Mes travaux ont comblé leurs vœux;
Il m’eſt permis enfin d’eſtre heureuſe moy-meſme:	Il m'est permis enfin d'être heureuse moi-même:
Apres avoir acquis un immortel honneur, Quand chacun par mes ſoins goûte un bonheur extreſme Qu'il m'est doux de ſonger à mon propre bonheur.	Après avoir acquis un immortel honneur, Quand chacun par mes soins goûte un bonheur extrême Qu'il m'est doux de songer à mon propre bonheur.
Les Nymphes de ces lieux ſemblent fuïr ma preſence:	Les Nymphes de ces lieux semblent fuir ma présence:
Proſerpine?	Proserpine?
ma Fille?	ma Fille?
Ah quel triſte ſilence!	Ah quel triste silence!
Eſt-ce ainſi qu’on devoit dans cét heureux ſéjour Se réjouir de mon retour?	Est-ce ainsi qu'on devait dans cet heureux séjour Se réjouir de mon retour?
VeneZ, Nymphes, veneZ, que ma Fille s’avance.	VeneZ, Nymphes, venez, que ma Fille s'avance.
VeneZ, Dieux des Bois, venez-tous.	VeneZ, Dieux des Bois, venez-tous.
SCENE CNNOVTESME.	SCÈNE CNOUTESME.
CERES, CRINISE, Troupes de Nymphes & de Dieux des Bois.	CERES, CRINISE, Troupes de Nymphes et de Dieux des Bois.
ERES.	ÈRES.
MA Fille n’eſt pas avec vous!	MA Fille n'est pas avec vous!
Quoy, donc, eſt-ce le ſoin que vous en deviez prendre?	Quoi, donc, est-ce le soin que vous en deviez prendre?
Nende(-moy Proſerpine, e u tien de me la rendre, Vous m’offreZ ſeulement des ſoûpirs & des pleurs?	Nende( -moi Proserpine, e u tien de me la rendre, Vous m'offrez seulement des soupirs et des pleurs?
LE CHOEUR.	LE CHOEUR.
O Ceres!	Ô Ceres!
ô Mere trop tendre!	ô Mère trop tendre!
Ah quelles ſeront vos douleurs.	Ah quelles seront vos douleurs.
CERES.	CERES.
Ciel!	Ciel!
on m’oste ma Fille!	on m'ôte ma Fille!
& qui l’oſe entreprendre?	et qui l'ose entreprendre?
Deux Nymphes.	Deux Nymphes.
Nous n’avons pû l’aprendre, Et l’on a pris le temps que nous cüeillions des fleurs.	Nous n'avons pu l'apprendre, Et l'on a pris le temps que nous cueillions des fleurs.
Source gallica.	Source galica.
bnf fr ( Bibliothèque nationale de France	bnf fr ( Bibliothèque nationale de France
ERES.	ÈRES.
I’ay creu qu’un doux repos devoit icy m’attendre, Et je n’y trouve, helas!	J'ai cru qu'un doux repos devait ici m'attendre, Et je n'y trouve, hélas!
que de cruels mal-heurs.	que de cruels malheurs.
LE CHOEVR.	LE CHOEUR.
O Ceres!	Ô Ceres!
6 Mere trop tendre!	6 Mère trop tendre!
Aneuuenes feront &us uouleurs!	Aneuuenes feront etus ouleurs!
SCENE SIXIESME.	SCÈNE SIXIÈME.
CYANE’, CERES, CRINISE, Troupes de Nymphes & de Dieux Champeſtres.	CYANE', CERES, CRINISE, Troupes de Nymphes et de Dieux Champestres.
YANE'.	YANE.
E reſſens vos ennuis, & j'en ſuis trop atteinte, IQuoy qu’il puiſſe arriver, vous allez tout ſçavoir.	E ressens vos ennuis, et j'en suis trop atteinte, JUoy qu'il puisse arriver, vous allez tout savoir.
Il faut que mon devoir L’emporte ſur ma crainte.	Il faut que mon devoir L'emporte sur ma crainte.
CERES.	CERES.
Parle, ma chere Cyané;	Parle, ma chère Cyané;
Soulage un cœur infortuné.	Soulage un cœur infortuné.
ANE’;	ANE;
I'ay ſuivy Proſerpine, & jay pris ſa deffenſe!	J'ai suivi Proserpine, et jay pris sa défense!
Helas tous mes efforts pour elle ont eſté vains!	Hélas tous mes efforts pour elle ont été vains!
Son Eſcharpe eſt entre mes mains.	Son Écharpe est entre mes mains.
CERES.	CERES.
e cher & triſte objet preſſe encore ma vangeance.	e cher et triste objet presse encore ma vengeance.
Haſte-toy de nommer l’ennemy qui m'offence.	Hâte-toi de nommer l'ennemi qui m'offense.
CYANE'	CYANE'
CYANE’.	CYANE'.
C’est.	C'est.
C’est.	C'est.
Cone oc.	Cone oc.
2 RES.	2 RÉS.
CYANE.	CYANE.
T'eſt.	T'est.
CERES CLECHOLUR.	CERES CLECHOLUR.
Oine quer matueur pouveau:	Oine quer matueur pouveau:
Cyané perd la voix & n’eſt plus qu’un Ruiſſeau	Chyané perd la voix et n'est plus qu'un Ruisseau
CENE SEPTIESME.	CÈNE SEPTIÈME.
CERES, CRINISE, Troupe, de Nymphes, & de Dieux des Bois.	CERES, CRINISE, Troupe, de Nymphes, et de Dieux des Bois.
CERES.	CERES.
Malheureuſe Mere!	Malheureuse Mère!
LE CHOEUR.	LE CHOEUR.
O trop malheureuſe Ceres!	Ô trop malheureuse Ceres!
E S.	 E.
Les Dieux n’ont pû ſouffrir qu’une Nymphe ſincere M’ait découvert mes Ennemis ſecrets.	Les Dieux n'ont pu souffrir qu'une Nymphe sincère M'ait découvert mes Ennemis secrets.
Je ne ſçauray donc pas ſur qui lancer les traits De ma juſte colere?	Je ne saurai donc pas sur qui lancer les traits De ma juste colère?
On me ravit une fille ſi chere!	On me ravit une fille si chère!
Iupiter dans les Cieux ſourd à mes vains regrets Ne reſſent plus qu’il eſt ſon Pere!	Jupiter dans les Cieux sourd à mes vains regrets Ne ressent plus qu'il est son Père!
O malheureuſe Mere!	Ô malheureuse Mère!
E CHOEVR.	E CHOEUR.
O trop malheureuſe Ceres!	Ô trop malheureuse Ceres!
Ah!	Ah!
qu’elle injusfice cruelle!	qu'elle injusfice cruelle!
O Dieux pourquoy m’arrachez-vous Vn bien que je trouvois ſi doux?	Ô Dieux pourquoi m'arrachez-vous Un bien que je trouvais si doux?
De cette audace criminelle Est-ce Apollon ou Mars que je doy ſoupçonner?	De cette audace criminelle Est-ce Apollon ou Mars que je dois soupçonner?
Leurs Meres en fureur n’ont pù me pardonner D’avoir une fille ſi belle.	Leurs Mères en fureur n'ont puù me pardonner D'avoir une fille si belle.
Dois-je accuſer l’Amour, & ſert-il aujourd’huy A me ravir un bien que je tenois de luy?	Dois-je accuser l'Amour, et sert-il aujourd'hui À me ravir un bien que je tenais de jours?
Trahiroit-il mon cœur fidelle?	Trahirait-il mon cœur fidèle?
Ah:	Ah:
quelle injustice cruelle!	quelle injustice cruelle!
O Dieux!	Ô Dieux!
pourquoy m’arrachez-vous Vn bien que je trouvois ſi doux?	pourquoi m'arrachez-vous Un bien que je trouvais si doux?
Par mes ſoins, les champs de Cybele De fruits, & de moiſſons viennent d’estre couverts;	Par mes soins, les champs de Cybele De fruits, et de moissons viennent d'être couverts;
De mes dons precieux la richeſſe nouvelle Brille par mes travaux en cent climats divers, Et quand de tant de biens j’ay comblé l’Vnivers, Les Dieux percent mon cœur d’une douleur mortelle.	De mes dons précieux la richesse nouvelle Brille par mes travaux en cent climats divers, Et quand de tant de biens j'ai comblé l'Univers, Les Dieux percent mon cœur d'une douleur mortelle.
Ah!	Ah!
quelle injustice cruelle!	quelle injustice cruelle!
O Dieux pourquoy m’arracheZ-vous Vn bien que je trouvois ſi doux.	Ô Dieux pourquoi m'arrachez-vous Un bien que je trouvais si doux.
Apres un ſi ſenſible outrage, Mon cœur deſeſperé s’abandonne à la rage.	Après un si sensible outrage, Mon cœur désespéré s'abandonne à la rage.
Du Monde trop heureux je veux troubler la paix:	Du Monde trop heureux je veux troubler la paix:
Brulons, ravageons-tout, détruiſons mes bien-faits.	Brulons, ravageons-tout, détruisons mes bienfaits.
SCENE HVITIESME.	SCÈNE HVITIESME.
CERES, Troupes de Nymphes & de Dieux Champeſtres, Troupe de Suivants de Ceres, troupe de Peuples de Sicile.	CERES, Troupes de Nymphes et de Dieux Champêtres, Troupe de Suivants de Ceres, troupe de Peuples de Sicile.
Les Suivants de Ceres rompent les arbres & en prennent des branches & en font des flambeaux qu’ils allument au feu qui ſort du Mont Ætna.	Les Suivants de Ceres rompent les arbres et en prennent des branches et en font des flambeaux qu'ils allument au feu qui sort du Mont Ætna.
Ils en brulent les bleds, malgré les efforts & les cris des Nymphes, des Dieux Champeſtres, & des Peuples.	Ils en brûlent les bleds, malgré les efforts et les cris des Nymphes, des Dieux Champestres, et des Peuples.
Huit Suivãts de Ceres portãts des flambeaux allumez dançans.	Huit Suivants de Ceres portants des flambeaux allumés dançans.
Meſſieurs Chicanneau, Noblet, Mayeux, Germain, Arnal, Favier cadet, Dumirail & Boutteville.	Messieurs Chicanneau, Noblet, Mayeux, Germain, Arnal, Favier cadet, Dumirail et Boutteville.
Quairt Hauitans de diene dunçans.	Quairt Havitants de diène dunçans.
Meſſieurs Faüre, Favier l’aiſné, L’eſtang l’aiſné, & Pecour.	Messieurs Faüre, Favier l'aîné, L'étend l'aîné, et Pecour.
CERES tenant deux Flambeaux allumez.	CERES tenant deux Flambeaux allumés.
VE tout ſe reſſente E De la fureur que je ſens.	VE tout se ressente E De la fureur que je sens.
Le Chœur des Dieux Champeſtres & des peuples.	Le Chœur des Dieux Champestres et des peuples.
Quel crime avons-nous fait?	Quel crime avons-nous fait?
Divinité puiſſante, Eſcoutez les clameurs des Peuples gemiſſants.	Divinité puissante, Écoutez les clameurs des Peuples gémissants.
CERES.	CERES.
I'ay fait du bien à tous, ma fille eſt innocente, Et pour toucher les Dieux, nos cris ſont impuiſſants;	J'ai fait du bien à tous, ma fille est innocente, Et pour toucher les Dieux, nos cris sont impuissants;
I’entendray ſans pitié les cris des Innocents:	J'entendrai sans pitié les cris des Innocents:
Que tout ſe reſſente De la fureur que je ſens.	Que tout se ressente De la fureur que je sens.
DEUR.	DEUR.
Ah!	Ah!
quelle eſpouvantable flâme!	quelle épouvantable flamme!
Ah!	Ah!
quel ravage affreux!	quel ravage affreux!
Portons par tout l’horreur qui regne dans mon ame.	Portons par tout l'horreur qui règne dans mon âme.
Portons par tout d’horribles feux.	Portons par tout d'horribles feux.
LE CHOEVR.	LE CHOEUR.
Ah!	Ah!
quelle eſpouvantable flâme!	quelle épouvantable flamme!
Ah!	Ah!
quel ravage affreux!	quel ravage affreux!
Tin du tiomeme Acte.	Tin du tiomeme Acte.
MAGEE I Le Theatre change, & repreſente les Champs Elyſées.	MAGE I Le Théâtre change, et représente les Champs Elysées.
SCENE PREMIERE.	SCÈNE PREMIÈRE.
OMBRES HEVREVSES.	OMBRES HEUREUSES.
CHOEUR DES OMBRES HEVREVSES.	CHOEUR DES OMBRES HEUREUSES.
Sy Oin d’icy, loin de nous, Triſtes ennuis, importunes allarmes:	Si Oin d'ici, loin de nous, Tristes ennuis, importunes alarmes:
Gardez-vous, gardez-vous  D’interrompre la paix dont nous goûtons les charmes;	Gardez-vous, gardez-vous D'interrompre la paix dont nous goûtons les charmes;
Gardez-pous, gardez-vous De troubler un bonbeur ſi doux.	Gardez-pous, gardez-vous De troubler un bonbeur si doux.
Deux Ombres heureuſes.	Deux Ombres heureuses.
O!	Ô!
bien-heureuſe vie!	bienheureuse vie!
Vous ne nous ferez point rave.	Vous ne nous ferez point rave.
O!	Ô!
doux plaiſirs dont nos vœux ſont comblez!	doux plaisirs dont nos vœux sont comblés!
Vous ne ſerez jamais troubleZ.	Vous ne serez jamais troublés.
Deux autres Ombres heureuſes.	Deux autres Ombres heureuses.
Ah que ces demeures ſont belles!	Ah que ces demeures sont belles!
Que nous y paſſons d’heureux jours!	Que nous y passons d'heureux jours!
Quelte jeltenre pout tes aimiimis puelles!	Quelte jeltenre pout tes aimiimis puelles!
Icy les amours éternelles Ont toûjours les douceurs des nouvelles amours.	Ici les amours éternelles Ont toujours les douceurs des nouvelles amours.
Ah que ces demeures ſont belles!	Ah que ces demeures sont belles!
Que nonn y paſfons uo neureux jours.	Que nonn y pasfons œuo neureux jours.
Deux autres Ombres heureuſes.	Deux autres Ombres heureuses.
Dans ces beaux lieux, tout nous enchante, Les Plaiſirs y ſuivent nos pas;	Dans ces beaux lieux, tout nous enchante, Les Plaisirs y suivent nos pas;
on puis on un femus pauute deſir augmente D’en goûter les appas	on puis on un femus pauvte désir augmente D'en goûter les appas
Le Chœur des Ombres heureuſes.	Le Chœur des Ombres heureuses.
O bien-heureuſe vie!	Ô bienheureuse vie!
Vous ne nous ſerez point ravie.	Vous ne nous serez point ravie.
Ol doux plaiſirs dont nos vœux ſont combleZ Uous ne ſerez jamais troubleZ.	Ol doux plaisirs dont nos vœux sont comblés Uous ne serez jamais troublés.
SCENE SECONDE.	SCÈNE SECONDE.
PROSERPINE, ASCALAPHE, les Ombres heureuſes.	PROSERPINE, ASCALAPHE, les Ombres heureuses.
PROSERPINE.	PROSERPINE.
A chere liberté que vous aviez d’attraits!	À chère liberté que vous aviez d'attraits!
NI En vous perdant, helas;	NI En vous perdant, hélas;
que mon ame est atteinte De douleur, de trouble, & de crainte!	que mon âme est atteinte De douleur, de trouble, et de crainte!
Ma chere liberté que vous aviez, d’attraits:	Ma chère liberté que vous aviez, d'attraits:
Faut-il vous perdre pour jamais?	Faut-il vous perdre pour jamais?
Ombres que j’interromps, ſouffreZ ma triſte plainte, Ce n’eſt pas pour mon cœur que vos plaiſirs ſont faits:	Ombres que j'interromps, souffrez ma triste plainte, Ce n'est pas pour mon cœur que vos plaisirs sont faits:
PlaigneZ-vous avec moy du Dieu qui m’a contrainte Do trouover iu uonoour de vostre, heureuſe paix.	Plaignez-vous avec moi du Dieu qui m'a contrainte Do trouver ju uonoour de votre, heureuse paix.
Ma chere liberté que vous avieZ d’attraits En vous perdant, helas!	Ma chère liberté que vous aviez d'attraits En vous perdant, hélas!
que quon ame eſt atteinte!	que quon âme est atteinte!
dæ PPot De douleur, d’amour, & de crainte!	dæ PPot De douleur, d'amour, et de crainte!
Ma chere liberté que vous avieZ d’attraits!	Ma chère liberté que vous aviez d'attraits!
Faut-il vous perdre pour jamais?	Faut-il vous perdre pour jamais?
ASCALAPHE.	ÀSCALAPHÉE.
Aimez qui vous aime, Rien n’eſt ſi charmant.	Aimez qui vous aime, Rien n'est si charmant.
Pluton n’eſt pas un Dieu ſujet au changement, Il vous offre ſon cœur avec ſon Diadéme.	Pluton n'est pas un Dieu sujet au changement, Il vous offre son cœur avec son Diadème.
Les Ombres repettent ces deux derniers Vers AimeZ qui vous aime, Rien n’eſt ſi charmant.	Les Ombres répettent ces deux derniers Vers Aimez qui vous aime, Rien n'est si charmant.
PROSERPINE.	PROSERPINE.
Que n'eſt-il fattsfait dé ſa grandeur ſupreſme, I'eſtois heureuſe ſans amant;	Que n'est-il fattsfait de sa grandeur suprême, J'étais heureuse sans amant;
ArAomouui jomlamituttimiuteguer ſur luy-meſme.	ArAomoui jomlamituttimiuteguer sur lui-même.
LES OMBRES.	LES OMBRES.
cAimez qui vous aime, Rien n’est ſi charmant.	cAimez qui vous aime, Rien n'est si charmant.
PROSERPINE.	PROSERPINE.
Ahrſans la liberté, ſans ſa douceur extreſme, Tout autre bien eſt un cruel tourment.	Ahrsants la liberté, sans sa douceur extrême, Tout autre bien est un cruel tourment.
LES OMBRES.	LES OMBRES.
AimeZ qui vous aime, Rien n’eſt ſi charmant.	Aimez qui vous aime, Rien n'est si charmant.
SUENE MSIESME nARETHVSE, ALPHE’E, PRO SERPINE, ASCALAPHE.	SUENE MSIESME nARETHUSE, ALPHÉE, PRO SERPINE, ASCALAPHÉ.
PROSERPINE.	PROSERPINE.
St-ce une illuſion dont le charme m’abuſe, C Eſt-ce toy, ma chere Arethuſe.	St-ce une illusion dont le charme m'abuse, Ç St-ce toi, ma chère Arethuse.
ARETHVSE & ALPHE’E.	ARETHÉSE et ALPHÉE.
Pluton veut qu’avec vous nous demeurions icy;	Pluton veut qu'avec vous nous demeurions ici;
Nous ſuivons ſans eſfort ta toy qu'il nous impoſe.	Nous suivons sans éfort ta toi qu'il nous impose.
Ce Dieu veut ſoulager le chagrin qu’il vous cauſe, Et croit que par nos ſoins il peut eſtre adoucy.	Ce Dieu veut soulager le chagrin qu'il vous cause, Et croit que par nos soins il peut être adouci.
Il attend pour vous voir que de vostre colere Heo pramtoid trunſporto forenn cuilmeZ.	Il attend pour vous voir que de votre colère Héo pramtoid trunsporto forenn cuilés.
Le Dieu que vous charmeZ Ne ſonge qu’à vous plaire.	Le Dieu que vous charmez Ne songe qu'à vous plaire.
ERPINE.	ERPINE.
Que devient pour l’amour ton meſpris éclatant?	Que devient pour l'amour ton mépris éclatant?
Cet Amant prés de toy gouſte un bon-heur paiſible.	Cet Amant près de toi goûte un bonheur paisible.
ARÉTHUSE.	ARÊTHUSE.
Rien n’eſt impoßible A l’amour conſtant.	Rien n'est imposible À l'amour constant.
En vain je preſumois tant D’avoir un cœur invincible, Rien n’eſt impoßible A l’amour conſtant,	En vain je présumais tant D'avoir un cœur invincible, Rien n'est impossible À l'amour constant,
AET IILL.	AET IIL.
Qu’un Amant fidele eſt content D’engager ce qu’il aime à devenir ſenſible!	Qu'un Amant fidèle est content D'engager ce qu'il aime à devenir sensible!
ALPHE’E & ARETHUSE.	ALPHÉE et ARETHUSE.
Rien n’eſt impoſſible A l'Amour conſtant.	Rien n'est impossible À l'Amour constant.
ASCALAPHE.	ÀSCALAPHÉE.
Pluton pourra trouver un favorable instant Ou ſon amour pour vous déviendra moins terrible.	Pluton pourra trouver un favorable instant Ou son amour pour vous déviendra moins terrible.
ASCALAPHE, ARET HUSE & ALPHE’E.	ÀSCALAPHE, ARET HUSE et ALPHÉE.
Rien n’eſt impoſſible A l’amour conſtant.	Rien n'est impossible À l'amour constant.
Voyez ce beau ſefour, ces charmantes Campagnes, Ces Vallons eſcartez, ces paiſibles Forests.	Voyez ce beau sefour, ces charmantes Campagnes, Ces Vallons écartés, ces paisibles Forêts.
PROSERPINE.	PROSERPINE.
Ne reverray-je plus Ceres?	Ne reverrai-je plus Ceres?
Ne reverray-je plus mes fidelles Compagnes?	Ne reverrai-je plus mes fidèles Compagnes?
ASCALAPHE.	ÀSCALAPHÉE.
Vous avez par malheur goûté de quelques grains D’un fruit de ces lieux ſouſterrains.	Vous avez par malheur goûté de quelques grains D'un fruit de ces lieux sousterrains.
ALPHÉ’E & ARETHUSE.	ALPHÉT-E et ARETHUSE.
Pluton le ſçait, il vient de nous le dire.	Pluton le sait, il vient de nous le dire.
ASCALAPHE.	ÀSCALAPHÉE.
I’ay pris ſoin de l’en advertir.	J'ai pris soin de l'en advertir.
Par c'amttst du deſin, te Dieu ue tet Empire Peut vous voir deſormais autant qu’il le deſire.	Par c'amttst du désin, te Dieu ue Empire Peut vous voir désormais autant il le desire.
ALPHE’E, ARETHVSE & ASCALAPHE.	ALPHÉE, ARETHUSE et ASCALAPHE.
Iamais s’il n’y veut conſentir, Du ſejour des Enfers vous ne pourreZ ſortir.	Jamais s'il n'y veut consentir, Du séjour des Enfers vous ne pourrez sortir.
OSERPINE.	OSERPINE.
Ie ne verray jamais la lumiere celeſte!	Je ne verrai jamais la lumière céleste!
Dans une ardente ſoif, par un ſecours funeste, C’est toy qui m’as monſtré ce fruit ſi dangereux:	Dans une ardente soif, par un secours funeste, C'est toi qui m'as montré ce fruit si dangereux:
Tu m’as caché l’arreſt du Deſtin rigoureux;	Tu m'as caché l'arrêt du Destin rigoureux;
Perfide, c’eſt toy qui m’abuſe, Et c’eſt toy-meſme qui m’accuſe?	Perfide, c'est toi qui m'abuse, Et c'est toi-même qui m'accuse?
Ah!	Ah!
du moins, le Destin exaucera les vœux De ma juſte vangeance;	du moins, le Destin exaucera les vœux De ma juste vengeance;
Tu ne ſurprendras plus la credule innocence;	Tu ne surprendras plus la crédule innocence;
Tu ſeras vn objet affreux, Et d’un preſage malheureux;	Tu seras un objet affreux, Et d'un présage malheureux;
Va, cruel, va languir dans, l’horreur des tenebres;	Va, cruel, va languir dans, l'horreur des ténèbres;
Va, devien, s’il ſe peut, außi triſte que moy.	Va, devien, s'il se peut, aussi triste que moi.
Que tes cris ſoient des cris funebres;	Que tes cris soient des cris funèbres;
Que le ſombre Chagrin, que le mortel effroy;	Que le sombre Chagrin, que le mortel effroi;
Ne ſe laßent jamais de voler apres toy.	Ne se lassent jamais de voler après toi.
Aſcalaphe ſe transforme en Hibou;	Ascaphe se transforme en Hibou;
& s’envole.	et s'envole.
tnmodt noabamanan	tnmodt noabaman
SCENE QVATRIESME.	SCÈNE QUATRIÈME.
PLVTON, PROSERPINE.	PLUTON, PROSERPINE.
ROSERPINE.	ROSERPINE.
JEntavcoustontre mey aeſſenurc on temeraire?	JEntavcoutontre me aessenurc on téméraire?
I.	I.
Uoſtre pouvoir icy ne ſera point borné;	Uostre pouvoir ici ne sera point borné;
On n’eſt point innocent quand on peut vous déplaire.	On n'est point innocent quand on peut vous déplaire.
Espuiſez, s’il ſe peut ſur cet infortuné, Tous les traits de vostre colere.	Épuisez, s'il se peut sur cet infortuné, Tous les traits de votre colère.
ROSERPINE.	ROSERPINE.
Tout reſſent icy bas mon trouble & ma terreur:	Tout ressent ici bas mon trouble et ma terreur:
Les Ombres ſans trembler ne peuvent plus m’entendre, Ne ſouffrez pas que ma fureur De cet heureux ſejour, faſſe un ſejour d’horreur, A la clarté du Ciel, haſteZ-vous de me rendre.	Les Ombres sans trembler ne peuvent plus m'entendre, Ne souffrez pas que ma fureur De cet heureux séjour, fasse un séjour d'horreur, À la clarté du Ciel, hâtez-vous de me rendre.
Ne regrettez point tant la lumiere des Cieux.	Ne regrettez point tant la lumière des Cieux.
Des Aſtres faits pour nous eſclairent ces beaux lieux;	Des Astres faits pour nous éclairent ces beaux lieux;
Iamais un verdoyant feüillage Ne ceſſe de parer les arbres de nos bois, Sans ceſſe dans nos champs nous trouvons à la fois Des fruits, des fleurs, & de l’ombrage, Et le temps affreux des frimas Est la ſeule ſaiſon que l'on n’y connoiſt pas.	Jamais un verdoyant feuillage Ne cesse de parer les arbres de nos bois, Sans cesse dans nos champs nous trouvons à la fois Des fruits, des fleurs, et de l'ombrage, Et le temps affreux des frimas Est la seule saison que l'on n'y connaît pas.
OSERPINE.	OSERPINE.
Mon triste cœur ne peut connaiſtre La douceur des appas qu’on voit icy paraistre, Helas!	Mon triste cœur ne peut connaître La douceur des appas qu'on voit ici paraître, Hélas!
ces lieux ſi beaux où je frémis d’effroy, Sont toûjours les Enfers pour moy.	ces lieux si beaux où je frémis d'effroi, Sont toujours les Enfers pour moi.
S.	S.
Ie ſuis Roy des Enfers, Neptune eſt le Roy de l’Onde, Nous regardons avec des yeux jaloux Iupiter plus heureux que nous;	Je suis Roi des Enfers, Neptune est le Roi de l'Onde, Nous regardons avec des yeux jaloux Jupiter plus heureux que nous;
Son Sceptre eſt le premier des trois Sceptres du monde.	Son Sceptre est le premier des trois Sceptres du monde.
tiluieſi de vostre cœur j’estois victorieux, Ie ſerois plus content d’adorer vos beaux yeux Au milieu des Enfers dans une paix profonde, Que Iupiter le plus heureux des Dieux N'eſt content d’estre Roy de la Terre & des Cieux,	tiluiesi de votre cœur j'étais victorieux, Je serais plus content d'adorer vos beaux yeux Au milieu des Enfers dans une paix profonde, Que Jupiter le plus heureux des Dieux N'est content d'être Roi de la Terre et des Cieux,
OSERPINE.	OSERPINE.
Que deviendra Ceres à qui je ſuïs ſi chere?	Que deviendra Ceres à qui je sujet si chère?
Qu'elle furprtfe:	Qu'elle furprîtfe:
netas!	netas!
queue aouleur amere!	queue aouleur âme!
Helas!	Hélas!
PLUTON.	PLUTON.
Ne donnereZ-vous Dts jouptrs qu'a voſtre Mrere?	Ne donnerez-vous Déts jouptrs qu'a votre Mre?
Aimez, Beauté trop ſevere, Ets joupirs uamour font doux.	Aimez, Beauté trop sévère, Ets joupirs uamour font doux.
ROSERPINE.	ROSERPINE.
D’un inſenſible cœur que pouveZ-vous attendre?	D'un insensible cœur que pouvez-vous attendre?
LUTON.	LUTON.
I'ignorois le pouvoir des traits qui m’ont ſurpris, Mon cœur ne connoiſſoit rien de doux ny de tendre.	J'ignorais le pouvoir des traits qui m'ont surpris, Mon cœur ne connaissait rien de doux ni de tendre.
Ne pourray-je vous aprendre Ce que vous m’avez, apris?	Ne pourrai-je vous apprendre Ce que vous m'avez, appris?
PROSERPINE.	PROSERPINE.
Dieu cruel!	Dieu cruel!
vous n’aimez que les pleurs & les cris.	vous n'aimez que les pleurs et les cris.
Deviez-vous aux Enfers me contraindre à deſcendre?	Deviez-vous aux Enfers me contraindre à descendre?
Uous m’osteZ le bonheur qui m’eſtoit deſtiné?	Uous m'ôtez le bonheur qui m'était destiné?
PLUTON.	PLUTON.
Eſt-ce à moy qu’il faut vous en prendre?	Est-ce à moi qu'il faut vous en prendre?
AccuſeZ-en l’amour que vous m’aveZ donné,	Accusez-en l'amour que vous m'avez donné,
PROSERPINE.	PROSERPINE.
Voulez vous me cauſer d’eternelles allarmes?	Voulez -vous me causer d'éternelles alarmes?
2 141 Voulez-vous me cauſer d’eternels deſplaiſirs?	2 141 Voulez-vous me causer d'éternels déplaisirs?
PROSERPINE.	PROSERPINE.
LaiſſeZ-moy ſuivre en pune mes imocens deſirs.	Laissez-moi suivre en pune mes imocents désirs.
UTON.	UTON.
Laiſſez-moy la douceur de voir toûjours vos charmes	Laissez-moi la douceur de voir toujours vos charmes
PROSERPINE.	PROSERPINE.
Voyez couler mes larmes.	Voyez couler mes larmes.
PLUTON.	PLUTON.
Eſcoutez mes ſoûpirs.	Écoutez mes soupirs.
PLUTON & PROSERPINE enſemble.	PLUTON et PROSERPINE ensemble.
PLVTON.	PLUTON.
.	.
Mon amour fidelle J Ne touche point voſtre cœur?	Mon amour fidèle J Ne touche point votre cœur?
Ah!	Ah!
quelle rigueur!	quelle rigueur!
Ma douleur mortelle PROSERPINE.	Ma douleur mortelle PROSERPINE.
JNe touche point voſtre cœur?	JNe touche point votre cœur?
Ah!	Ah!
quelle rigueur!	quelle rigueur!
PLYTON.	PLYTON.
N'importe, fuſſieZ-vous cent fois plus inhumaine, Mon amour entreprend de vaincre voſtre haine.	N'importe, fussiez-vous cent fois plus inhumaine, Mon amour entreprend de vaincre votre haine.
SCENE CINQVIESME.	SCÈNE CINQUIÈME.
PLVTON, PROSERPINE, Chœur d’Ombres bien-heureuſes.	PLUTON, PROSERPINE, Chœur d'Ombres bienheureuses.
Chœur de Divinitez Infernales.	Chœur de Divinités Infernales.
Quatorze Divinitez Infernales de la Suite de Pluton, tnumtantes.	Quatorze Divinités Infernales de la Suite de Pluton, tumtantes.
Meſſieurs Bony, Beaumont pere, David, Tiphaine, Bernard, Arnoul, Duhamel, Moreau, Frizon, Poyadon, Ie Coitre, la rorett, Eavernet, e Saye llls.	Messieurs Bony, Beaumont père, David, Tiphaine, Bernard, Arnoul, Duhamel, Moreau, Frison, Poyadon, Je Coître, la roret, Eavernet, e Laisse llls.
Les trois Iuges des Enfers.	Les trois Juges des Enfers.
Meſſieurs le Roy, Gingant & Godoneſche.	Messieurs le Roi, Gingant et Godonesche.
Quame Dronuez uifernalas dançantes.	Quame Dronvez uifernalas dançantes.
Meſſieurs Favier l’aiſné, Pecour, L’eſtang cadet, Germain & Dumirail.	Messieurs Favier l'aîné, Pecour, L'étang cadet, Germain et Dumirail.
Quatre Ombres heureuſes dançantes.	Quatre Ombres heureuses dançantes.
Meſſieurs Magny, Faüre, L’eſtang l’aiſné, & Bout- ville.	Messieurs Magny, Faüre, L'étang l'aîné, et Bout- ville.
PLVTON.	PLUTON.
Ve l’on ſuſpende icy les tourments éternels Des plus criminels:	Ve l'on suspende ici les tourments éternels Des plus criminels:
Qu’aux Enfers en ce jour tout ſoit exempt de peine.	Qu'aux Enfers en ce jour tout soit exempt de peine.
Vous qu’un heureux repos ſuit apres le treſpas, Et vous, Dieux, mes ſujets, veneZ, haſtez vos pas, Rendez hommage à voſtre Reine:	Vous qu'un heureux repos suit après le trépas, Et vous, Dieux, mes sujets, venez, hâtez vos pas, Rendez hommage à votre Reine:
Admirez ſes divins appas.	Admirez ses divins appas.
RegneZ aimable Souveraine, RegneZ à jamais icy bas.	Regnez aimable Souveraine, Regnez à jamais ici bas.
Les Chœurs des Ombres heureuſes, & des Divinitez Infernales.	Les Chœurs des Ombres heureuses, et des Divinités Infernales.
Rendons hommage à nostre Reyne, Admirons ſes divins appas.	Rendons hommage à notre Reine, Admirons ses divins appas.
Regnez, aimable Souveraine, Regnez à jamais icy-bas.	Regnez, aimable Souveraine, Regnez à jamais ici-bas.
Les Ombres heureuſes & les Divinitez Infernales rendent hommage à Proſerpine, & luy apportent de riches preſens:	Les Ombres heureuses et les Divinités Infernales rendent hommage à Proserpine, et lui apportent de riches presens:
Elles témoignent leur joye par leurs dances & par leurs chanſons.	Elles témoignent leur joie par leurs dances et par leurs chansons.
Chœur des Ombres heureuſes.	Chœur des Ombres heureuses.
d'Eſt aßez, de regrets;	d'Est assez, de regrets;
OC’eſt verſer trope de larmes, Goûtez les attraits Du Destin plein de charmes, Pluton aime mieux que Ceres.	OC'est vers trope de larmes, Goûtez les attraits Du Destin plein de charmes, Pluton aime mieux que Ceres.
Vne Mere Vaut-elle un Eſpoux?	Une Mère Vaut-elle un Époux?
L'AL’amour doit toûjours plaire, Les ſoins en ſont doux:	L'AL'amour doit toujours plaire, Les soins en sont doux:
Vn cœur eſt trop ſauvage S’il change l’uſage D'un bien ſi charmant, Et c’eſt grand dommage D’en faire un tourment.	Un cœur est trop sauvage S'il change l'usage D'un bien si charmant, Et c'est grand dommage D'en faire un tourment.
MB TriompheZ dans ces lieux:	MAB Triomphés dans ces lieux:
C’est pour vous que ſoûpire L’un des plus grands Dieux, PoßedeZ ſon Empire.	C'est pour vous que soupire L'un des plus grands Dieux, PossedeZ son Empire.
Tout cede au pouvoir de vos yeux.	Tout cède au pouvoir de vos yeux.
Vne Mere Uaut-elle un Espoux, &c.	Une Mère Uaut-elle un Époux, etc.
Les Chœurs des Divinitez Infernales & des Ombres heureuſes.	Les Chœurs des Divinités Infernales et des Ombres heureuses.
Dans les Enfers Tout rit, tout chante;	Dans les Enfers Tout rit, tout chante;
On vous doit, Beauté charmante, La douceur de nos Concerts.	On vous doit, Beauté charmante, La douceur de nos Concerts.
Vn Dieu ſevere Par vos yeux eſt en flammé, Tout ſon Empire vous revere;	Un Dieu sévère Par vos yeux est en flammé, Tout son Empire vous révère;
Qu’il eſt doux d’avoir charmé Vn cœur qui n’a jamais aimé.	Qu'il est doux d'avoir charmé Un cœur qui n'a jamais aimé.
1 Que vos appas Auront de gloire!	1 Que vos appas Auront de gloire!
Ils eſtendent leur Uictoire Iuſqu au regne le Treſpas.	Ils étendent leur Uictoire Jusqu au règne le Trépas.
Vn Dieu ſevere, &c.	Un Dieu sévère, etc.
Fin du quatriéme Actes	Fin du quatrième Actes
ACT E	ACT E
SCENE PREMIERE.	SCÈNE PREMIÈRE.
Le Theatre change, & repreſente le Falul da EMcon, PLVTON, LES TROIS IVGES DES ENFERS, LES TROIS FVRIES, Troupe de Divinitez Infernales.	Le Theatre change, et représente le Falul da EMcon, PLUTON, LES TROIS IVGES DES ENFERS, LES TROIS FURIES, Troupe de Divinités Infernales.
Les trois Furies.	Les trois Furies.
Mre le Maire, Pulvigny & Deſvelois.	Mre le Maire, Pulvigni et Desvelais.
M L r ON.	M L r ON.
OVS qui reconnoiſſez ma ſupreſme puiſſance, Donnez-moy des conſeils, donnez-moy du ſecours.	OUS qui reconnaissez ma suprême puissance, Donnez-moi des conseils, donnez-moi du secours.
L’orgueilleux Iupiter m’offence, Il veut rompre aujourd’huy l’heureuſe intelligence Que nous avions juré de conſerver toûjours.	L'orgueilleux Jupiter m'offense, Il veut rompre aujourd'hui l'heureuse intelligence Que nous avions juré de conserver toujours.
Les Dieux ont aimé tous, & le Dieu du Ciel-meſme S'est laißé cent fois enflammer.	Les Dieux ont aimé tous, et le Dieu du Ciel-même S'est laisse cent fois enflammer.
H i C’eſt la premiere fois que j’aime, Et l'on veut me ravir ce qui ma ſçeù charmer.	H H J'est la première fois que j'aime, Et l'on veut me ravir ce qui ma sçeù charmer.
Ah!	Ah!
c’est une rigueur extreſme De condamner un Cœur à ne jamais aimer.	c'est une rigueur extrême De condamner un Cœur à ne jamais aimer.
C’eſt voſtre Reine qu’on demande:	C'est votre Reine qu'on demande:
Iupiter veut que je la rende, Et Mercure pretend l’enlever d’icy bas.	Jupiter veut que je la rende, Et Mercure prétend l'enlever d'ici bas.
Rouoonsinom enaurer que t'on nous la raviſſe?	Rouonsinom enaurer que t'on nous la ravisse?
LECHOEVR.	LECHOUR.
Non, non, c’eſt une injuſtice Que nous ne ſouffrirons-pas.	Non, non, c'est une injustice Que nous ne souffrirons-pas.
Et par quel droit faut-il que Jupiter s’obſtine Oftrouuten te ponneur que tZimour me deſtine?	Et par quel droit faut-il que Jupiter s'obstine Oftrouuten te ponneur que tZimour me destine?
Mon pouvoir n’eſt-il pas independant du ſien?	Mon pouvoir n'est-il pas indépendant du sien?
Gardons Proſerpine, Les Enfers ne rend'ent rien.	Gardons Proserpine, Les Enfers ne rend'ent rien.
Le chœur repete ces deux Vers.	Le chœur répète ces deux Vers.
Les trois Iuges des Enfers.	Les trois Juges des Enfers.
Proſerpine a goûté des fruits de vostre Empire, Elle eſt à vous, on ne peut vous l’oster.	Proserpine a goûté des fruits de votre Empire, Elle est à vous, on ne peut vous l'ôter.
Aux Arrests du Destin les Dieux doivent ſouſcriré, C’eſt vainement qu’on y veut reſister.	Aux Arrêts du Destin les Dieux doivent souscriré, C'est vainement qu'on y veut résister.
TON.	TON.
Que le Ciel menace, qu’il tonne;	Que le Ciel menace, qu'il tonne;
Il faut que rien ne nous eſtonne, Nous avons pour nous en ce jour, Les Deſtins & l'Amour.	Il faut que rien ne nous étonne, Nous avons pour nous en ce jour, Les Destins et l'Amour.
Le Chœur repete ces quatre vers.	Le Chœur répète ces quatre vers.
Les trois Furies.	Les trois Furies.
Pluſtost que de ſouffrir l’injure Que le Ciel veut faire aux Enfers, Renverſons toute la Nature Periſſe l’Vnivers.	Plutôt que de souffrir l'injure Que le Ciel veut faire aux Enfers, Renversons toute la Nature Périsse l'Univers.
Vne des Furies.	Une des Furies.
Rerirons tes Geants de teur prifon ovſcure;	Rérirons tes Géants de teur prison ovscure;
Des Eutons enomtenneZ roſuuut veifen tes fers:	Des Étons enomtennés rosuut véifen tes fers:
Les Furies & le Chœur.	Les Furies et le Chœur.
Renverſons toute la Nature, Periſſe l’Vnivers.	Renversons toute la Nature, Périsse l'Univers.
SCENE SECONDE.	SCÈNE SECONDE.
Le Theatre change, & repreſente une Solitude.	Le Theatre change, et représente une Solitude.
CERES ſeule.	CERES seule.
Eſerts eſcartez, ſombres lieux, DCacheZ mes ſoûpirs & mes larmes.	Eserts écartés, sombres lieux, DCachez mes soupirs et mes larmes.
Mon deſeſpoir a trop de charmes Pour les impitoyables Dieux.	Mon désespoir a trop de charmes Pour les impitoyables Dieux.
Deſerts eſcartez, ſombres lieux, Cachez, mes ſoûpirs, & mes larmes.	Déserts écartés, sombres lieux, Cachez, mes soupirs, et mes larmes.
Les Dieux eſtoient jaloux de mon ſort glorieux;	Les Dieux étaient jaloux de mon sort glorieux;
C’eſt un doux Spectacle à leurs yeux Que les malheurs cruels dont je ſuis pourſuivie:	C'est un doux Spectacle à leurs yeux Que les malheurs cruels dont je suis poursuivie:
Ils ſe font un plaiſir de mes cris furieux;	Ils se font un plaisir de mes cris furieux;
Iupiter m’a livréé à leur barbare envie:	Jupiter m'a livré à leur barbare envie:
Iupiter me trahit, ma Fille m’eſt ravie.	Jupiter me trahit, ma Fille m'est ravie.
Ie perds ce que j’aimois le mieux;	Je perds ce que j'aimais le mieux;
Infortunée, helas!	Infortunée, hélas!
le jour m’eſt odieux, Et je ſuis pour jamais condamnée à la vie.	le jour m'est odieux, Et je suis pour jamais condamnée à la vie.
A!	À!
je ne puis ſouffrir la lumiere des Cieux!	je ne puis souffrir la lumière des Cieux!
Mon deſeſpoir a trop de charmes Pour les impitoyables Dieux;	Mon désespoir a trop de charmes Pour les impitoyables Dieux;
Deſerts eſcartez, ſombres lieux, CatneZ mes ſoupirs, & mes larmes.	Deserts écartés, sombres lieux, Catnez mes soupirs, et mes larmes.
SCENE TROISIESME.	SCÈNE -TROISIÈME.
CERES, VOIX INFERNALES.	CERES, VOIX INFERNALES.
ERES.	ÈRES.
Vels abiſmes ſe ſont ouverts ?	Vels abîmes se sont ouverts ?
Qu'entends-je?	Qu'entends-je?
quel affreux murmure!	quel affreux murmure!
VOIX Infernales.	VOIX Infernales.
Renverſons toute la Nature.	Renversons toute la Nature.
Periſſe l’Vnivers.	Périsse l'Univers.
CERES.	CERES.
Le Ciel n’eſt point touché des maux que j’ay ſoufferts, L'Enfer prendroit-il part aux peines que j’endure.	Le Ciel n'est point touché des maux que j'ai soufferts, L'Enfer prendrait-il part aux peines que j'endure.
VOTA Inrermares.	VOTA Nrermares.
Renverſons toute la Nature.	Renversons toute la Nature.
Periſſe l’Vnivers.	Périsse l'Univers.
CERES tepete ce dermer vers.	CERES tepète ce dermer vers.
SCENE QVATRTESME.	SCÈNE QUATRTESME.
ALPHE’E, ARETHVSE, CERES, Alphée & Arethuſe ſortent des Enfers.	ALPHÉPHÉE, ARETHUSE, CERES, Alphée et Arethuse sortent des Enfers.
ERES.	ÈRES.
E m’aprendreZ-vous point où ma Fille peut C 916	E m'apprendrez-vous point où ma Fille peut Ç 916
ARETHVSE.	ARETHÉS.
Voſtre Ennemy ſecret veut ſe faire connaiſtre;	Votre Ennemi secret veut se faire connaître;
Enfin vous pouveZ tout ſçavoir.	Enfin vous pouvez tout savoir.
De l’Empire Infernal le redoutable Maistre Tient voſtre Fille en ſon pouvoir.	De l'Empire Infernal le redoutable Maître Tient votre Fille en son pouvoir.
CERES.	CERES.
L'Enfer retient ma Fille!	L'Enfer retient ma Fille!
ô Ciel!	ô Ciel!
ô ſort barbare!	ô sort barbare!
L’eternelle Nuit nous ſepare!	L'éternelle Nuit nous sépare!
Ma chere Proſerpine.	Ma chère Proserpine.
ô regrets ſuperflus!	ô regrets superflus!
Helas!	Hélas!
je ne la verray plus!	je ne la verrai plus!
Dieux!	Dieux!
ma Fille n’est point coupable, Pourquoy Pluton inexorable Veut-il dans les Enfers l’accabler de douleur?	ma Fille n'est point coupable, Pourquoi Pluton inexorable Veut-il dans les Enfers l'accabler de douleur?
HEPITEE &ARETHUSE.	HÉPITE ETARETHUSE.
C’est quelquefois un grand malheur Que d’eſtre trop aimable.	C'est quelquefois un grand malheur Que d'être trop aimable.
2 S.	2 S.
Pluton l’aime!	Pluton l'aime!
& l’Amour pour me deſeſperer Fait ſoüpirer un Cœur qui doit eſtre infléxible!	et l'Amour pour me désespérer Fait soüpirer un Cœur qui doit être infléxible!
ALPHE’E & ARETHVSE.	ALPHÉE et ARETHUSE.
Quel cœur ſe peut aſſurer D’eſtre toûjours inſenſible?	Quel cœur se peut assurer D'être toujours insensible?
Quel cœur ſe peut aſſurer.	Quel cœur se peut assurer.
De ne jamais ſoûpirer?	De ne jamais soupirer?
ALPHLE.	ÀLPHLE.
Le Dieu qui pour elle ſoûpire Ego un uuo uou grumus Dieux, Mlaiſtres de l'Vnivers.	Le Dieu qui pour elle soupire Ego un uuo ou grumus Dieux, Mlaîtres de l'Univers.
IRETHUSE.	JRETHUSE.
Elle eſt Reine d’un vaste Empire.	Elle est Reine d'un vaste Empire.
ALPHE’E & ARETHVSE.	ALPHÉE et ARETHUSE.
Il eſt beau de regner meſme dans les Enfers.	Il est beau de régner même dans les Enfers.
CERES.	CERES.
Quelque honneur qu’aux Enfers on s’empreſſe à luy rendre, Elle n’en peut ſortir, & je n’y puis deſcendre:	Quelque honneur qu'aux Enfers on s'empresse à M rendre, Elle n'en peut sortir, et je n'y puis descendre:
Ie la perds, je perds tout eſpoir Ie ne pourray jamais la voir.	Je la perds, je perds tout espoir Je ne pourrai jamais la voir.
ALPHEE &ARETHVSE.	ALPHÉE etARETHVSE.
Iupiter la demande, & l’Enfer plein d’allarmes Pour la garder a pris les armes.	Jupiter la demande, et l'Enfer plein d'alarmes Pour la garder a pris les armes.
CERES.	CERES.
Iupiter n’est donc pas inſenſible aux regrets De la malheureuſe Ceres?	Jupiter n'est donc pas insensible aux regrets De la malheureuse Ceres?
ObteneZ Dieu puiſſant que ma Fille revienne;	Obtenez Dieu puissant que ma Fille revienne;
Sans troubler voſtre paix j’irois ſuivre ſes pas Si je pouvois paſſer dans la nuit du Trépas:	Sans troubler votre paix j'irais suivre ses pas Si je pouvais passer dans la nuit du Trépas:
Ne ſouffreZ plus que l’Enfer la retienne, Orand Dieu, c'eſt voſtre Riue auſſi vien que la miẽne, C’eſt voſtre Fille, helas!	Ne souffrez plus que l'Enfer la retienne, Orand Dieu, c'est votre Rive aussi viens que la mienne, C'est votre Fille, hélas!
Ne l’abandonnez pas.	Ne l'abandonnez pas.
SCENE CINQVIESME.	SCÈNE CINQUIÈME.
Mercure deſcend du Ciel.	Mercure descend du Ciel.
MERCVRE, CERES,ALPHE’E,ARETHVSE.	MERCURE, CERES,ALPHÉE,ARETHUSE.
MERCURE.	MERCURE.
TOus les Dieux ſont d’accord, pour vous tout s’intereße, Proſerpine verra le jour, Elle ſuivra Cerés & Pluton tour à tour, Elle partagera ſon temps & ſa tendreſſe Entre la Nature & l’Amour.	TOus Elle Partagera sont sa accord, pour vous tout s'intere, Proserpine verra le jour, Elle suivra Cerrez et Pluton tour à tour, Elle partagera son temps et sa tendresse Entre la Nature et l'Amour.
Vous verreZ voſtre Fille, & Jupiter luy-meſme A pris ſoin qu’à vos vœux le Sort ait reſpondu.	Vous verrez votre Fille, et Jupiter lui-même A pris soin qu'à vos vœux le Sort ait répondu.
ES.	ES.
Apres une peine extreſme Qu'un vien qu'on dvon perdu mee Est doux quand il eſt rendu Par les ſoins de ce qu’on aime.	Après une peine extrême Qu'un vien qu'on dvon perdu mène Est doux quand il est rendu Par les soins de ce qu'on aime.
MERCURE.	MERCURE.
L’Hymen aſſemble tous les Dieux De l'Empire Infernal de la Terre & des Cieux.	L'Hymen assemble tous les Dieux De l'Empire Infernal de la Terre et des Cieux.
Le Ciel s’ouvre, & Iupiter paroiſt accompagné des Divinitez celeſtes.	Le Ciel s'ouvre, et Jupiter paraît accompagné des Divinités célestes.
Pluton & Proſerpine ſortent des Enfers aſſis ſur un Trône, ou Ceres va prenure place pres de la Mie, vne Troupe de Divinitez Infernales richement parées, accompagnent Pluton.	Pluton et Proserpine sortent des Enfers assis sur un Trône, ou Ceres va prenure place pres de la Mie, une Troupe de Divinités Infernales richement parées, accompagnent Pluton.
Et une Troupe de Divinitez de la Terre viennent prendre part à la joye de Ceres, & à la gloire de Proſerpine.	Et une Troupe de Divinités de la Terre viennent prendre part à la joie de Ceres, et à la gloire de Proserpine.
SCENE VI.	SCÈNE VI.
ET DERNIERE.	ET DERNIÈRE.
IVPITER, PLVTON, PROSERPINE, CERES, MERCVRE, ALPHE’E, ARETHVSE, Troupes de Divinitez Celeſtes, rerreſtres, & Infernales.	IUPITER, PLUTON, PROSERPINE, CERES, MERCURE, ALPHÉE, ARETHUSE, Troupes de Divinités Célestes, rerrestres, et Infernales.
Six Divinitez qui joüent de divers Inſtruments, & qui accompagnent Iupiter dans la Gloire.	Six Divinités qui jouent de divers Instruments, et qui accompagnent Jupiter dans la Gloire.
Divinitez Celeſtés qui chantent dans des Machines.	Divinitez Celestés qui chantent dans des Machines.
Venus, Mademoiſelle Doremius.	Venus, Mademoiselle Doremius.
Palla.	Palla.
Mademoiſelle Pieſche.	Mademoiselle Pièche.
Haηοηe, Monſieur Fernon l’aiſné.	Ha! Monsieur Fernon l'aîné.
Apollon, Monſieur Gillet.	Apollon, Monsieur Gillet.
L’Amour, Le ſieur Jacquart.	L'Amour, Le sieur Jacquart.
L’Hymenée, Le ſieur Philbert.	L'Hyménée, Le sieur Philbert.
Troupe de Divinitez de la Terre chantantes.	Troupe de Divinités de la Terre chantes.
Pomone.	Pomone.
Mademoiſelle Bony.	Mademoiselle Boni.
Flore.	Flore.
Mademoiſelle Pulvigny.	Mademoiselle Pulvigni.
Vertumne.	Vertumne.
Monſieur Morel, Troupe de Divinitez de la Terre chantantes.	Monsieur Morel, Troupe de Divinités de la Terre chantes.
Meſdemoiſelles, Rebel, & de la Prée.	Mesdemoiselles, Rebel, et de la Prée.
Meſſieurs, Beaumont pere, Fernon l’aiſné.	Messieurs, Beaumont père, Fernon l'aîné.
Le Maire, Pulvigny, Perchot, Deſvelois, Aubert, Antonio, jonquet, ie petit remon, & Beauſhont fils.	Le Maire, Pulvigni, Perchot, Desvelois, Aubert, Antonio, jonquet, ie petit remon, et Beaushont fils.
Troupe de Divinitez Infernales chantantes.	Troupe de Divinités Infernales chantes.
Meſſieurs, Tihaine, David, Moreau, Poyadon, Bernard, ie Cointre, la Poroit, na verniee, Duhamel, Arnoul, Gingant, le Roy, Frizon, & Gaye fils.	Messieurs, Tihaine, David, Moreau, Poyadon, Bernard, votre Cointre, la Porait, na vernie, Duhamel, Arnoul, Gingant, le Roi, Frison, et Gaie fils.
Troupe de Divinitez Infernales dançantes.	Troupe de Divinités Infernales dançantes.
Monſieur de Beauchamp.	Monsieur de Beauchamp.
Meſſieurs, Favier l’aiſné, L’eſtang l’aiſné, Pecour, Dumirail, Magny, Faüre, Boutteville & Germain.	Messieurs, Favier l'aîné, L'étang l'aîné, Pecour, Dumirail, Magny, Faüre, Boutteville et Germ.
TER.	TER.
Eres, que de vos pleurs le triſte cours finiſſe;	Eres, que de vos pleurs le triste cours finisse;
A Qu’avec Pluton Proſerpine s’uniſſe.	A Qu'avec Pluton Proserpine s'unisse.
Que l’on enchaine pour jamais La Diſcorde & la Guerre Dans les Enfers, dans les Cieux, ſur la Terre, Tout doit joüir d’une eternelle Paix.	Que l'on enchaine pour jamais La Discorde et la Guerre Dans les Enfers, dans les Cieux, sur la Terre, Tout doit jouir d'une éternelle Paix.
a-i-mer Les Chœurs repetent ces quatre derniers Vers, & les Divinitez Celeſtes, Terreſtres & Infernales, témoignent par leurs chants & par leurs Dances la joye qu’ils ont de voir l’intelligence reſtablie entre les plus grands Dieux du Monde, par le Mariage de Pluton & de Proſerpine.	a-yjour Les Chœurs répètent ces quatre derniers Vers, et les Divinités Célestes, Terrestres et Infernales, témoignent par leurs chants et par leurs Dances la joie qu'ils ont de voir l'intelligence rétablie entre les plus grands Dieux du Monde, par le Mariage de Pluton et de Proserpine.
Fin du cinquiéme & dernier Acte.	Fin du cinquième et dernier Acte.
