SUJET GENERAL DES PYGMEES.	SUJET GÉNÉRAL DES PYGMÉS.
I le charme de la Nouveauté ſurpaſſe tous les autres, en toutes choſes;	I le charme de la Nouveauté surpasse tous les autres, en toutes choses;
je le puis bien dire apres Ovide, & toute la Terre en demeure d’accord) l’entrepriſe des Pygmées doit plaire à tout le monde, puis qu’on y trouvera non ſeulement la Nouveauté, mais encore tous les autres charmes qui ſervent à faire les plus agréables & les plus nobles plaiſirs du Siecle.	je le puis bien dire après Ovide, et toute la Terre en demeure d'accord) l'entreprise des Pygmées doit plaire à tout le monde, puis qu'on y trouvera non seulement la Nouveauté, mais encore tous les autres charmes qui servent à faire les plus agréables et les plus nobles plaisirs du Siècle.
La Comedie en est le fondement.	La Comédie en est le fondement.
L’Heroïque y eſt tres-bien ſouſtenu.	L'Héroïque y est très-bien soutenu.
Le Riſible n’en dément point la Majeſté par la baſſeſſe à laquelle on le voit ordinairement s’allier;	Le Risible n'en dément point la Majesté par la bassesse à laquelle on le voit ordinairement s'allier;
& le Galant, qui enchaiſne l’un & l’autre, fait de ces differens caracteres l’aſſemblage le plus charmant & le plus judicieux qu’on ait veu depuis long-temps.	et le Galant, qui enchaîne l'un et l'autre, fait de ces différents caractères l'assemblage le plus charmant et le plus judicieux qu'on ait vu depuis longtemps.
Ce ſont trois beautez en une;	Ce sont trois beautés en une;
la Greque, la Romaine & la Françoiſe.	la Greque, la Romaine et la Française.
Les Spectacles pompeux, les Machines toutes ſurprenantes, les Decorations magnifiques, les Habits extremement propres, les agrémens de Muſique & de Dances, autant qu’il y en doit avoir, en ſont les ſuperbes ornemens.	Les Spectacles pompeux, les Machines toutes surprenantes, les Décorations magnifiques, les Habits extrêmement propres, les agrémens de Musique et de Dances, autant qu'il y en doit avoir, en sont les superbes ornements.
Si des plus illuſtres Genies de l’Antiquité, Homere, Ariſtote, Strabon, Pline, & Olaus, n’ont pas dédaigné d’écrire l’Hiſtoire de ces Peuples, il n’eſt pas indigne d'un eſprit vif & brillant de ce Royaume, d’avoir déterré cette Nation des montagnes des Indes Orientales, pour la faire ſervir aux délaſſemens du plus grand Monarque qui ait jamais eſté, & aux plaiſirs innocens de ſes Sujets.	Si des plus illustres Génies de l'Antiquité, Homère, Aristote, Strabon, Pline, et Olaus, n'ont pas dédaigné d'écrire l'Histoire de ces Peuples, il n'est pas indigne d'un esprit vif et brillant de ce Royaume, d'avoir déterré cette Nation des montagnes des Indes Orientales, pour la faire servir aux délassements du plus grand Monarque qui ait jamais été, et aux plaisirs innocents de ses Sujets.
Que leur petiteſſe ne les faſſe point mépriſer, ils feront tout ce que des Geans feroient, & peut-estre avec meilleure grace.	Que leur petitesse ne les fasse point mépriser, ils feront tout ce que des Géants feraient, et peut-être avec meilleure grâce.
Jls ſouſtiendront außi bien leur merite contre les ignorans & les injuſtes critiques, qu’ils feront leur pays & leur liberté contre les Gruës, avec qui ils ont toûjours eû la guerre.	Ils soutiendront aussi bien leur mérite contre les ignorants et les injustes critiques, qu'ils feront leur pays et leur liberté contre les Grues, avec qui ils ont toujours eu la guerre.
On diroit à tort que nos Pygmées ſont des corps ſans ames;	On dirait à tort que nos Pygmées sont des corps sans âmes;
ils en ont trois pour une, & d’außi raiſonnables qu’il en faut pour ce qu’ils ont à faire.	ils en ont trois pour une, et d' aussi raisonnables qu'il en faut pour ce qu'ils ont à faire.
Ils ſont ſemblables en ce point à un certain Roy nommé Herilus, dont Virgile parle au 8.	Ils sont semblables en ce point à un certain Roi nommé Hérilus, dont Virgile parle au 8.
livre de ſon Eneïde, qui ne pouvoit mourir à moins de trois Morts aſſemblées contre luy.	livre de son Eneïde, qui ne pouvait mourir à moins de trois Morts assemblées contre notre.
A la verité, ce n’eſt que depuis qu’ils ont reſpiré l’air de France:	À la vérité, ce n'est que depuis qu'ils ont respiré l'air de France:
außi nous remarquons qu’ils ſont crûs à veuë d’œil, & qu’ils ſont embellis de moitié:	aussi nous remarquons qu'ils sont crus à vue d'œil, et qu'ils sont embellis de moitié:
le propre de nôtre Soleil eſtant de faire profiter tous ceux qu’il regarde favorablement, ſur tout les Nations étrangeres.	le propre de notre Soleil étant de faire profiter tous ceux qu'il regarde favorablement, sur tout les Nations étrangères.
Les Auteurs, que j’ay cy-devant citeZ, nous apprennent que les Pygmées ſont de petits hommes, de la hauteur d'une coudée, qui habitent les montagnes des Indes Orientales;	Les Auteurs, que j'ai cy-devant citez, nous apprennent que les Pygmées sont de petits hommes, de la hauteur d'une coudée, qui habitent les montagnes des Indes Orientes;
quelques-uns diſent les extrémitez de l'Affrique;	quelques-uns disent les extrémités de l'Afrique;
d’autres, les contrées Septentrionales:	d'autres, les contrées Septentrionales:
mais la plus commune opinion ſur ce point, c’eſt la premiere.	mais la plus commune opinion sur ce point, c'est la première.
Tous conviennent que ce Peuple, monté ſur des chévres & des beliers, armé d’arcs & de fléches, chaque année, au Printems, fait la Guerre aux Gruës;	Tous conviennent que ce Peuple, monté sur des chévres et des béliers, armé d'arcs et de flèches, chaque année, au Printemps, fait la Guerre aux Grues;
qu’il écache, le long du rivage de la mer, tout autant d’œufs de ces oyſeaux qu’ils en peuvent rencontrer, leur principal but eſtant d’exterminer cette race ennemie, qui les trouble & les tourmente de tout temps.	qu'il écache, le long du rivage de la mer, tout autant d'œufs de ces oiseaux qu'ils en peuvent rencontrer, leur principal but étant d'exterminer cette race ennemie, qui les trouble et les tourmente de tout temps.
Pline écrit en ſon particulier, qu’ils habiterent autrefois la Ville de Geranée en Thrace, d’où ils furent chaſſeZ par les Gruës;	Pline écrit en son particulier, qu'ils habitèrent autrefois la Ville de Geranée en Thrace, d'où ils furent chassez par les Grues;
& c’eſt de là, ſans doute, qu’ils prirent occaſion de ſe retirer dans les montagnes des Indes Orientales.	et c'est de là, sans doute, qu'ils prirent occasion de se retirer dans les montagnes des Indes Orientales.
Il les appelle quelquesfois Spithamiens.	Il les appelle quelquefois Spithamiens.
Voila ce que nous en rapportent les Anciens, & ſur quoy l’on a imaginé, non ſeulement l’entrepriſe des Pygmées;	Voilà ce que nous en rapportent les Anciens, et sur quoi l'on a imaginé, non seulement l'entreprise des Pygmées;
mais encore une piece de Theatre de meſme nom, comme eſtant plus convenable à l'établiſſement de la choſe.	mais encore une pièce de Théâtre de même nom, comme étant plus convenable à l'établissement de la chose.
L’on n’a rien épargné pour faire reüßir l'une & l’autre.	L'on n'a rien épargné pour faire réussir l'une et l'autre.
Si les Curieux répondent aux ſoins qu’on a pris pour leurs dhcuirjemnes tejuicez en eſt infaillible.	Si les Curieux répondent aux soins qu'on a pris pour leurs dhcuirjemnes tejuicez en est infaillible.
Ce qu’on n’a point veu juſqu’icy, des A iij figures humaines de quatre pieds de haut, richement habillées, en tres-grand nombre, ſur un vaſte & ſuperbe Theatre repreſenter des pieces en cinq actes, ornées de Muſique, de Balets, de Machines volantes d’une invention toute nouvelle, & de changemens de Decorations, réciter, marcher, actioner comme des perſonnes vivantes, & tres-agréablement, ſans qu’on les tienne ſuſpenduës:	Ce qu'on n'a point vu jusqu'ici, des A jà figures humaines de quatre pieds de haut, richement habillées, en très-grand nombre, sur un vaste et superbe Théâtre représenter des pièces en cinq actes, ornées de Musique, de Ballets, de Machines volantes d'une invention toute nouvelle, et de changements de Decorations, réciter, marcher, action comme des personnes vivantes, et très-agréablement, sans qu'on les tienne suspenduës:
c’eſt ce qu’on verra deſormais à l’Hoſtel Royal des mées, au Marais du Temple, à Paris.	c'est ce qu'on verra désormais à l'Hôtel Royal des mées, au Marais du Temple, à Paris.
8	8
AIGEM IREMIEN.	AIGEM IREMIEN.
A Salle entiere repreſente un puiſſant Rocher, E percé à jour, avec pluſieurs niches, à droit & à gauche, qui ſerviront de loges à ceux qui ne voudront pas eſtre au Parterre.	À Salle entière représente un puissant Rocher, E percé à jour, avec plusieurs niches, à droit et à gauche, qui serviront de loges à ceux qui ne voudront pas chang au Parterre.
La Nature ſemble l’avoir fait exprés pour découvrir au travers le pays enchanté des Pygmées, & ſervir de paſſage, du moins aux yeux des Spectateurs, qui ſouhaitent d’en remarquer les beautez ſurprenantes.	La Nature semble l'avoir fait exprès pour découvrir au travers le pays enchanté des Pygmées, et servir de passage, du moins aux yeux des Spectateurs, qui souhaitent d'en remarquer les beautés surprenantes.
Ce lieu eſt diſpoſé de maniere, qu’on n’y ſouffrira ni la chaleur exceſſive de l’Eſté, ni le trop grand froid de l’Hyver.	Ce lieu est disposé de manière, qu'on n'y souffrira ni la chaleur excessive de l'Été, ni le trop grand froid de l'Hiver.
La façade & les ſupports du Theatre font partie de ce Rocher, & l’on en voit ſortir de part & d’autre quantité de caſcades & de jets qui forment un canal d’eau vive, au delà duquel on decouvre le Palais du Roy.	La façade et les supports du Théâtre font partie de ce Rocher, et l'on en voit sortir de part et d'autre quantité de cascades et de jets qui forment un canal d'eau vive, au delà duquel on découvre le Palais du Roi.
La matiere dont il eſt baſti, l’Ordre, les parties & les ornemens d’Architecture qu’on y apperçoit, n’ont rien de commun avec tous les autres bâtimens qu’on trouve au reſte de la Terre.	La matière dont il est bâti, l'Ordre, les parties et les ornements d'Architecture qu'on y apperçoit, n'ont rien de commun avec tous les autres bâtiments qu'on trouve au reste de la Terre.
Le Roy paroiſt inquiet & chagrin.	Le Roi paraît inquiet et chagrin.
Microton ſon confident en impute la cauſe à l’approche des Gruës, dont le nombre eſt plus grand qu’il n’a jamais eſté;	Microton son confident en impute la cause à l'approche des Grues, dont le nombre est plus grand qu'il n'a jamais été;
& tâche à le tirer de ſon inquietude;	et tâche à le tirer de son inquiétude;
en lay vantant le zéle extréme de ſes peuples, qui va juſqu’à faire prenO dre les armes aux femmes, ainſi qu’aux enfans, pour la deffenſe de ſes Eſtats.	en lay vantant le zèle extrême de ses peuples, qui va jusqu'à faire prenO dre les armes aux femmes, ainsi qu'aux enfants, pour la défense de ses États.
Le Roy luy fait entendre qu’il ſe trouve moins embaraſſé des affreuſes menaces de ſes ennemis que de ſes deux filles, Parvulie ſon aînée, & Pichonine ſa cadete, dont la premiere a rejetté l’amour de Picolus, un de ſes Generaux d’armée, pour ſe garder à la memoire de Timas, à qui elle avoit eſté promiſe en mariage;	Le Roi Roi fait entendre qu'il se trouve moins embarrassé des affreuses menaces de ses ennemis que de ses deux filles, Parvulie son aînée, et Pichonine sa cadète, dont la première a rejeté l'amour de Picolus, un de ses Généraux d'armée, pour se garder à la mémoire de Timas, à qui elle avait été promise en mariage;
& la ſeconde eſt recherchée par ce même Picolus, depuis qu’il a eſſuyé les refus de l’aînée, & par Belus, en meſme temps, ſon autre General, & le premier qui s’eſt déclaré pour cette cadette.	et la seconde est recherchée par ce même Picolus, depuis qu'il a essuyé les refus de l'aînée, et par Belus, en même temps, son autre Général, et le premier qui s'est déclaré pour cette cadette.
Ces deux Princes ſont extrémement neceſſaires au Roy, pour luy conſerver ſes Eſtats, ſur tout, dans la preſente conjoncture, où ſes ennemis ſemblent beaucoup plus forts que luy.	Ces deux Princes sont extrêmement nécessaires au Roi, pour lui conserver ses États, sur tout, dans la présente conjoncture, où ses ennemis semblent beaucoup plus forts que tu.
Si Parvulie eût agreé la recherche de Picolus, Belus eût eu lieu d’épouſer Pichonine;	Si Parvulie eût agréé la recherche de Picolus, Belus eût eu lieu d'épouser Pichonine;
le Roy ſe fût fait de ces deux gendres deux fermes appuis de ſon Trône;	le Roi se fût fait de ces deux gendres deux fermes appuis de son Trône;
& l’obſtination de Parvulie le prive de ce grand avantage.	et l'obstination de Parvulie le prive de ce grand avantage.
D’ailleurs, il craint de faire un dangereux mécontent d’un de ces deux Generaux, en donnant ſa cadette à l’autre;	D'ailleurs, il craint de faire un dangereux mécontent d'un de ces deux Généraux, en donnant sa cadette à l'autre;
c’eſt ce qui fait ſon trouble & ſa peine.	c'est ce qui fait son trouble et sa peine.
Voyant approcher ces deux rivaux & les Princeſſes, il commande à Microton d’aller au Temple, pour apprendre le ſuccez d’un Sacrifice qu’il a ordonné pour rendre Mars favorable à ſes Armes, & de luy en rapporter au pluſtoſt des nouvelles.	Voyant approcher ces deux rivaux et les Princesses, il commande à Microton d'aller au Temple, pour apprendre le succès d'un Sacrifice qu'il a ordonné pour rendre Mars favorable à ses Armes, et de lui en rapporter au plustost des nouvelles.
Les deux Princes, chacun en ſon particulier, ſe plaignent au Roy de ce qu’il n’a point encor fait entr’eux le choix d’un gendre, & nommé l’Epoux de Pichonine.	Les deux Princes, chacun en son particulier, se plaignent au Roi de ce qu'il n'a point encor fait entr'eux le choix d'un gendre, et nommé l'Époux de Pichonine.
Il s’en excuſe d’une maniere obligeante, & rejette la cauſe de ſon ſon ſilence ſur Parvulie.	Il s'en excuse d'une manière obligeante, et rejette la cause de son son silence sur Parvulie.
Picolus témoigne qu’il n’y ſonge plus, d’un air qui luy attire une douceur tréspiquante de la part de cette Princeſſe.	Picolus témoigne qu'il n'y songe plus, d'un air qui était attire une douceur trèspiquante de la part de cette Princesse.
Pichonine qui trouveroit ſa ſatisfaction à les voir tous deux unis ſous les loix de l’Hymen, d’autant qu’elle n’auroit plus de traverſes à eſſuyer dans ſes amours avec Belus, & qu’elle l’épouſeroit ſuivant ſes ſouhaits, invite ſa ſœur à traiter plus favorablement ce Prince;	Pichonine qui trouverait sa satisfaction à les voir tous deux unis sous les lois de l'Hymen, d'autant qu'elle n'aurait plus de traverses à essuyer dans ses amours avec Belus, et qu'elle l'épouserait suivant ses souhaits, invite sa sœur à traiter plus favorablement ce Prince;
mais elle y perd ſon temps & ſes paroles.	mais elle y perd son temps et ses paroles.
Ces deux Rivaux preſts à ſe pouſſer au ſujet de Pichonine, ſont arreſtez par le Roy, qui voudroit remettre ce choix qu’ils preſſent aprés le combat:	Ces deux Rivaux prêts à se pousser au sujet de Pichonine, sont arrêtés par le Roi, qui voudrait remettre ce choix qu'ils pressent après le combat:
mais enfin il ſe voit obligé de declarer, que celuy des deux qui ſera le vainqueur de ſes ennemis, ſera l’époux de ſa cadette;	mais enfin il se voit obligé de déclarer, que celui des deux qui sera le vainqueur de ses ennemis, sera l'époux de sa cadette;
à quoy ils donnent les mains avec plaiſir.	à quoi ils donnent les mains avec plaisir.
Microton revient du Temple avec pluſieurs Officiers & Aſſiſtans du Sacrifice, tous allarmez de ce qui s’y vient de paſſer, & deux des Officiers, aprés une ſymphonie qui marque leur inquiétude & leurs alarmes, chantent ces paroles, Qu'allons-nous faire, Helas, helas, Si le Dieu des Combats Nous eſt contraire?	Microton revient du Temple avec plusieurs Officiers et Assistants du Sacrifice, tous alarmés de ce qui s'y vient de passer, et deux des Officiers, après une symphonie qui marque leur inquiétude et leurs alarmes, chantent ces paroles, Qu'allons-nous faire, Hélas, hélas, Si le Dieu des Combats Nous est contraire?
Helas, helas, O Mars eſtes-vous las D’eſtre nôtre Dieu Tutelaire?	Hélas, hélas, Ô Mars êtes-vous las D'être notre Dieu Tutelaire?
Quoy ne voulez-vous pas Détourner la miſere, Et le trépas De nos climats?	Quoi ne voulez-vous pas Détourner la misère, Et le trépas De nos climats?
Qu'allons-nous faire, &c.	Qu'allons-nous faire, etc.
Si des ingrats Dans ces Eſtats Ont ozé vous déplaire, Confiez-nous vôtre colere, Evom tes immourons nous mefmes dt ce pas.	Si des ingrats Dans ces États Ont ozé vous déplaire, Confiez-nous votre colère, Évom tes immourons nous mêmes dt ce pas.
Qu'allons-nous faire, &c.	Qu'allons-nous faire, etc.
Les autres expriment pâr leurs démarches & par leurs actions, au ſon des inſtrumens, le chagrin, la crainte & la douleur qui les agitent.	Les autres expriment pâtr leurs démarches et par leurs actions, au son des instruments, le chagrin, la crainte et la douleur qui les agitent.
Le Roy ſurpris de ces plaintes en demande la cauſe à Microton, qui luy donne lieu de craindre que Mars ne favoriſe ſes ennemis à ſon déſavantage.	Le Roi surpris de ces plaintes en demande la cause à Microton, qui lui avait lieu de craindre que Mars ne favorise ses ennemis à son désavantage.
Le recit qu’il fait des incidens ſiniſtres qui ſont arrivez au Sacrifice, jette la peur & l’étonnement dans l’ame des Princeſſes;	Le récit qu'il fait des incidents sinistres qui sont arrivés au Sacrifice, jette la peur et l'étonnement dans l'âme des Princesses;
Picolus n’y peut reſiſter;	Picolus n'y peut résister;
le Roy s’en laiſſe emparer;	le Roi s'en laisse emparer;
Belus le r’aſſure:	Belus le rassure:
Sémiandre, un des Aſſiſtans, en fait de meſme, & luy conſeille de députer quelqu’un au Ciel, pour tirer de Mars l’éclairciſſement de leur doute.	Sémiandre, un des Assistants, en fait de même, et tu conseille de députer quelqu'un au Ciel, pour tirer de Mars l'éclaircissement de leur doute.
Le Roy, aprés avoir pris l’avis des Princes, le commet avec Homoncius pour cette députation, dont il ſe charge volontiers.	Le Roi, après avoir pris l'avis des Princes, le commet avec Homoncius pour cette députation, dont il se charge volontiers.
Tous ſe retirent.	Tous se retirent.
Ormin confident de Picolus, que les affaires d’Eſtat touchent moins que celles de ſon amour pour Francine confidente de Pichonine, diſſipe les idées triſtes & lugubres que l’auditeur pourroit avoir conceuës dans les Scenes précedentes, par ſon teſte-à-teſte avec ſa maîtreſſe.	Ormin confident de Picolus, que les affaires d'État touchent moins que celles de son amour pour Francine confidente de Pichonine, dissipe les idées tristes et lugubres que l'auditeur pourrait avoir conçues dans les Scenes précedentes, par son tête-à-teste avec sa maîtresse.
Ce pauvre amant ſe voyant enfin mépriſé, ſe veut tuër de deſeſpoir;	Ce pauvre amant se voyant enfin méprisé, se veut tuer de désespoir;
mais le Roy luy fait le plaifir de l’en empeſcher.	mais le Roy Roi fait le plaisir de l'en empêcher.
Il demande à ſon Confident ſi Sémiandre doit bien-toſt partir;	Il demande à son Confident si Sémiandre doit bientôt partir;
Il apprend qu’il le verra dans peu s’enlever aux Cieux ſur un char attelé de quatre Aigles, que la faim & l’inſtinct naturel portent à ſuivre en l’air du gibier en vie, que Sémiandre & Homoncius tiennent en veuë de ces oyſeaux;	Il apprend qu'il le verra dans peu s'enlever aux Cieux sur un char attelé de quatre Aigles, que la faim et l'instinct naturel portent à suivre en l'air du gibier en vie, que Sémiandre et Hommoncius tiennent en vue de ces oiseaux;
mais dans un tel éloignement, qu’ils n’y peuvent point atteindre.	mais dans un tel éloignement, qu'ils n'y peuvent point atteindre.
Ces deux Députez paroiſſent auſſi toſt dans leur machine.	Ces deux Députez paraissent aussi tôt dans leur machine.
Le premier fait les complimens au Roy, qui luy promet une récompenſe conſiderable au retour de ſon voyage.	Le premier fait les compliments au Roi, qui lui promet une récompense considérable au retour de son voyage.
Ils pourſuivent enſuite leur route, & le Roy ſe retire incontinent aprés, avêc ſa ſuite.	Ils poursuivent ensuite leur route, et le Roi se retire incontinent après, avec sa suite.
Le vol de ces deux Députez eſt aſſez nouveau dans ſon eſpece, puis qu’il part d’une des aiſles gauche du Theâtre, comme pour entrer dans celle qui luy eſt oppoſée;	Le vol de ces deux Députez est assez nouveau dans son espèce, puis qu'il part d'une des ailes gauche du Théâtre, comme pour entrer dans celle qui tu est opposée;
& neantmoins le va perdre lur le Cintre.	et néanmoins le va perdre lur le Cintre.
Fin du premier Acte.	Fin du premier Acte.
ACTE SECOND.	ACTE SECOND.
N Parc compoſé de Jardinages, de Parterres, de Bois, de Figures, de Fontaines, & autres embelliſſemens, en fait la décoration.	N Parc composé de Jardinages, de Parterres, de Bois, de Figures, de Fontaines, et autres embellissements, en fait la décoration.
Ce lieu, pour ainſi dire, ſert d’azyle à Parvulie contre les perſecutions continuelles du Roy ſon pere, qui s’efforce de luy arracher du cœur l’amour qu’elle veut éternelement conſerver pour le Prince Timas, dont les funeſtes idées l’entretiennent dans des chagrins &des douleurs qui ne luy donnent aucun relâche.	Ce lieu, pour ainsi dire, sert d'asile à Parvulie contre les persécutions continuelles du Roi son père, qui s'efforce de même arracher du cœur l'amour qu'elle veut éternelement conserver pour le Prince Timas, dont les funestes idées l'entretiennent dans des chagrins etdes douleurs qui ne était donnent aucun relâche.
La Plainte qui ſuit, & qu’elle chante, pour donner plus de force à ſa paſſion, fait voir les ſentimens qui regnent dans ſon ame.	La Plainte qui suit, et qu'elle chante, pour donner plus de force à sa passion, fait voir les sentiments qui règnent dans son âme.
PLAINTE DE PARVULIE.	PLAINTE DE PARVLIE.
Que feras-tu, mal-heureuſe Princeſſe, Que dois-tu devenir?	Que feras-tu, malheureuse Princesse, Que dois-tu devenir?
Tu ne reverras plus l’objet de ta tendreſſe;	Tu ne reverras plus l'objet de ta tendresse;
S’il vit, c’eſt dans ton cœur, & dans ton ſouvenir, Helas, & chacun s’intereſſe A ben vunnnre Que feras-tu, mal-heureuſe Princeſſe, Que dois-tu devenir?	S'il vit, c'est dans ton cœur, et dans ton souvenir, Hélas, et chacun s'intéresse A ben unnre Que feras-tu, malheureuse Princesse, Que dois-tu devenir?
On pretend que j’oublie L’illuſtre Amant qui me tient ſous ſa loy, Que je le prive de ma foy:	On prétend que j'oublie L'illustre Amant qui me tient sous sa loi, Que je le prive de ma foi:
Non, je ne conſens point à cette perfidie:	Non, je ne consens point à cette perfidie:
Qu'on m’arrache plûtoſt le jour, Je perdray moins qu'en perdant mon amour.	Qu'on m'arrache plutôt le jour, Je perdrai moins qu'en perdant mon amour.
Mais ſeule avec tant de foibleſſe, Pourras-tu long-temps ſoûtenir Les durs efforts qu’on redouble ſans ceſſe Contre l’unique objet de ta juſte tendreſſe, Dont on cherche à te deſunir?	Mais seule avec tant de faiblesse, Pourras-tu longtemps soutenir Les durs efforts qu'on redouble sans cesse Contre l'unique objet de ta juste tendresse, Dont on cherche à te désunir?
Que feras-tu, mal-heureuſe Princeſſe, Que dois-tu devenir?	Que feras-tu, malheureuse Princesse, Que dois-tu devenir?
Aprés un moment de ſilence & de reflexion ſecrette, elle reprend la parole, & chante l’Air ſuivant.	Après un moment de silence et de réflexion secrète, elle reprend la parole, et chante l'Air suivant.
AIR DE PARVULIE.	AIR DE PARULIE.
Cherchons l'Echo dans le fonds de ces Bois, Luy ſeul par la charmante voix Peut ſoulager un cœur qui languit dans ſes chaînes:	Cherchons l'Écho dans le fond de ces Bois, Lui seul par la charmante voix Peut soulager un cœur qui languit dans ses chaînes:
Il offrira du moins ce plaiſir à mes peines, De me redire inceſſamment L’aimable nom de mon Amant.	Il offrira du moins ce plaisir à mes peines, De me redire incessamment L'aimable nom de mon Amant.
Elle n’a pas plûtoſt ceſſé de chanter, qu’elle apperçoit avec chagrin Zélone ſa confidente, à qui elle confirme la reſolution où elle eſt, de ne changer jamais ſon amour pour Timas.	Elle n'a pas plutôt cessé de chanter, qu'elle aperçoit avec chagrin Zélone sa confidente, à qui elle confirme la résolution où elle est, de ne changer jamais son amour pour Timas.
Zélone luy répreſente qu’il a eſté défait dans le dernier combat donné contre les Gruës.	Zélone autre répresente qu'il a été défait dans le dernier combat donné contre les Grues.
Cette raiſon, & pluſieurs autres qu’elle employe pour la perſuader du contraire de ſes ſentimens, ne ſervent qu’à l’y affermir davantage.	Cette raison, et plusieurs autres qu'elle emploie pour la persuader du contraire de ses sentiments, ne servent qu'à l'y affermir davantage.
Des Bergers enfoncez dans l’épaiſſeur des Bois, qui ne ſongent qu’à ſe divertir entr’eux, chantent fort à propos le Dialogue ſuivant.	Des Bergers enfoncés dans l'épaisseur des Bois, qui ne songent qu'à se divertir entr'eux, chantent fort à propos le Dialogue suivant.
AREMIER DERCEI.	AREMIÈR DERCEI.
Il n'eſt rien de ſi beau qu’un cœur tendre & fidelle.	Il n'est rien de si beau qu'un cœur tendre et fidèle.
SECOND BERGER.	SECOND BERGER.
Il n'eſt rien de ſi doux qu’une amour éternelle, Alors qu’un autre cœur brûle des meſmes feux.	Il n'est rien de si doux qu'une amour éternelle, Alors qu'un autre cœur brûle des mêmes feux.
PREMIER BERGER.	PREMIER BERGER.
C’eſt de quoy remplir tous nos vœux.	C'est de quoi remplir tous nos vœux.
ENEADEEa Mais quand on brûle ſeul, & non pas deux à deux, Il n’eſt rien de moins beau qu’un cœur tendre & fidelle;	ENEADEa Mais quand on brûle seul, et non pas deux à deux, Il n'est rien de moins beau qu'un cœur tendre et fidèle;
Il n’eſt rien de moins doux qu’une amour éternelle.	Il n'est rien de moins doux qu'une amour éternelle.
Zélone invite encore cette Princeſſe à ſe défaire d’un feu qui la fait brûler en vain.	Zélone invite encore cette Princesse à se défaire d'un feu qui la fait brûler en vain.
Parvulie luy ferme la bouche en peu de mots, dont voicy les derniers.	Parvulie autre ferme la bouche en peu de mots, dont voici les derniers.
Ce ſont là de l’Amour les veritables loix, Aimer toûjours, & n'aimer qu’une fois.	Ce sont là de l'Amour les véritables lois, Aimer toujours, et n'aimer qu'une fois.
Enfin, ne ſçachant plus par où combattre la réſolution de ſa Maîtreſſe, elle ſouhaiteroit que les meſmes Bergers expliquaſſent, à ſon défaut, ces maximes amoureuſes.	Enfin, ne sachant plus par où combattre la résolution de sa Maîtresse, elle souhaiterait que les mêmes Bergers expliquassent, à son défaut, ces maximes amoureuses.
Ils le font ſans paroiſtre de concert avec elles, & chantent les paroles Inivantes.	Ils le font sans paraître de concert avec elles, et chantent les paroles Inivantes.
CHANSON DES BERGERS.	CHANSON DES BERGERS.
Il faut, il faut aimer toûjours, Quand nous ſommes aimeZ ſans ceſſe;	Il faut, il faut aimer toujours, Quand nous sommes aimés sans cesse;
Mais ſi d'un coſté l’amour ceſſe, De l’autre il doit finir ſon cours.	Mais si d'un côté l'amour cesse, De l'autre il doit finir son cours.
Parvulie reſte inébranlable dans ſon deſſein d’aimer Timas éternellement, nonobſtant que Zélone luy ait redit ce qu’elle vient d’entendre des Bergers;	Parvulie reste inébranlable dans son dessein d'aimer Timas éternellement, nonobstant que Zélone lui ait redit ce qu'elle vient d'entendre des Bergers;
meſme ajoûté que la mort luy doit avoir enlevé l’amour de ſon Amant avec ſa vie.	Elle ajouté que la mort lui doit avoir enlevé l'amour de son Amant avec sa vie.
Pichonine fait plaiſir à Zélone de la relever d’un entretien où elle auroit peine à fournir.	Pichonine fait plaisir à Zélone de la relever d'un entretien où elle aurait peine à fournir.
Cette Cadette n’a pas plûtoſt commencé de parler à ſon aînée en faveur de Picolus, qu’elle eſt contrainte à ſe taire.	Cette Cadette n'a pas plutôt commencé de parler à son aînée en faveur de Picolus, qu'elle est contrainte à se taire.
C’eſt en vain qu’elle luy voudroit faire croire que le ſeul intereſt d’Eſtat l’anime en ce rencontre, puis que Parvulie, non ſeulement la force à déclarer que Belus eſt le Souverain de ſon ame;	C'est en vain qu'elle avait voudrait faire croire que le seul intérêt d'État l'anime en ce rencontre, puis que Parvulie, non seulement la force à déclarer que Belus est le Souverain de son âme;
mais encore luy fait entendre qu’elle connoiſt bien que la recherche de Picolus la gêne & l’outrage, qu’elle s’en taiſt au Roy pour ne le pas aigrir, & qu’enfin elle n’aimeroit à le voir ſon Beau-Frere, que parce qu’elle le hait pour ſa ſeule perſonne, & plus encore, pour la qualité de ſon époux qu’il recherche avec empreſſement.	mais encore deux fait entendre qu'elle connaît bien que la recherche de Picolus la gêne et l'outrage, qu'elle s'en taît au Roi pour ne le pas aigrir, et qu'enfin elle n'aimerait à le voir son Beau-Fre, que parce qu'elle le hait pour sa seule personne, et plus encore, pour la qualité de son époux qu'il recherche avec empressement.
Parvulie, aprés avoir raillé finement ſa 10 ſœur, la voyant preſte à s’emporter, luy en épargne la peine par ſa retraite.	Parvulie, après avoir raillé finement sa 10 sœur, la voyant prête à s'emporter, avait en épargne la peine par sa retraite.
Pichonine demeure ſeule avec ſa confidente, qui calme, autant qu’elle peut, le trouble de ſon cœur.	Pichonine demeure seule avec sa confidente, qui calme, autant qu'elle peut, le trouble de son cœur.
Bélus, avant que de s’engager au Combat, vient prendre congé de ſa Princeſſe.	Bélus, avant que de s'engager au Combat, vient prendre congé de sa Princesse.
La retenuë de l’une & l’ardente amour de l’autre font la matiere d’une converſation toute charmante, que le déſeſpoir d’un Amant qui ſe voit rebuté, démentiroit à la fin, ſi la tendreſſe allarmée de Pichonine ne forçoit ſa bouche à déclarer ouvertement ſon amour à ce Prince, à qui cette déclaration manquoit pour s’en croire abſolument aimé.	La retenue de l'une et l'ardente amour de l'autre font la matière d'une conversation toute charmante, que le désespoir d'un Amant qui se voit rebuté, démentirait à la fin, si la tendresse alarmée de Pichonine ne forçait sa bouche à déclarer ouvertement son amour à ce Prince, à qui cette déclaration manquait pour s'en croire absolument aimé.
Bélus reſte dans une joye indicible, & dans des raviſſemens inconcevables:	Bélus reste dans une joie indicible, et dans des ravissements inconcevables:
mais l’abord de ſon Rival, ſa fauſſe bravoure, & ſes railleries groſſieres, l’obligent à ſoûtenir le caractere d’un veritable Heros & d’un Amant qui ſe connoiſt aimable autant qu’il eſt aimé.	mais l'abord de son Rival, sa fausse bravoure, et ses railleries grossières, l'obligent à soutenir le caractère d'un véritable Héros et d'un Amant qui se connaît aimable autant qu'il est aimé.
Le Roy ſurvient & s’étonne de voir ces deux Generaux enſemble éloignez des Armées, dont il leur a donné le commandement.	Le Roi survient et s'étonne de voir ces deux Généraux ensemble éloignez des Armées, dont il leur a donné le commandement.
Bélus s’en juſtifie.	Bélus s'en justifie.
Picolus preſt à faire le meſme, s’arreſte pour faire obſerver Sémiandre qui revient des Cieux, avec des aſſeurances de r’emporter une entiere victoire ſur leurs ennemis, & d’un ſecours extraordinaire que Mars leur doit envoyer à ce ſujet.	Picolus prêt à faire le même, s'arrête pour faire observer Sémiandre qui revient des Cieux, avec des assurances de rapporter une entière victoire sur leurs ennemis, et d'un secours extraordinaire que Mars leur doit envoyer à ce sujet.
On peut s’imaginer combien ces agreables nouvelles cauſent de joye dans l’eſprit du Roy, & combien elles relevent le courage des Princes.	On peut s'imaginer combien ces agréables nouvelles causent de joie dans l'esprit du Roi, et combien elles relèvent le courage des Princes.
Les ſentimens genereux d’une part, & les obligeantes promeſſes de l’autre ne manquent pas;	Les sentiments généreux d'une part, et les obligeantes promesses de l'autre ne manquent pas;
& ce ſont eux qui terminent cét Acte.	et ce sont eux qui terminent cet Acte.
Les Bergers qu’on vient d’entendre chanter, ſans les avoir veûs, paroiſſent aux yeux des Auditeurs, pour leur chanter chanter les paroles ſuivantes, & dancer aprés une Entrée de Balet, qui convient au ſens de ces paroles.	Les Bergers qu'on vient d'entendre chanter, sans les avoir vus, paraissent aux yeux des Auditeurs, pour leur chanter chanter les paroles suivantes, et dancer après une Entrée de Ballet, qui convient au sens de ces paroles.
AIR DES BERGERS, Tout eſt mort dans nôtre vie, Sans l’Amour & ſes douceurs;	AIR DES BERGERS, Tout est mort dans notre vie, Sans l'Amour et ses douceurs;
Il eſt l’ame de nos cœurs, Quand ils ſuivent ſon envie:	Il est l'âme de nos cœurs, Quand ils suivent son envie:
Conſentons tous au trépas Plûtoſt que de n'aimer pas.	Consentons tous au trépas Plutôt que de n'aimer pas.
rin du lecond Acte.	rin du cond Acte.
E Theâtre répreſente, d’un coſté, le camp des Pygmées, & de l’autre des rochers inacceſſibles, avec la Mer en perſpective.	E Théâtre répresente, d'un côté, le camp des Pygmées, et de l'autre des rochers inaccessibles, avec la Mer en perspective.
Timas paroiſt en l’air avec trois de ſes Amis, tous portez par des Gruës, & tous dans le deſſein de délilivrer à jamais la Patrie des ennemis qui la tourmentent.	Timas paraît en l'air avec trois de ses Amis, tous portez par des Grues, et tous dans le dessein de délilivrer à jamais la Patrie des ennemis qui la tourmentent.
Ce Prince qui ne doit pas eſtre ſurpris pour mieux ſurprendre, entendant du bruit, s’en retourne derriere les rochers, d’où il eſtoit ſorty.	Ce Prince qui ne doit pas être surpris pour mieux surprendre, entendant du bruit, s'en retourne derrière les rochers, d'où il était sorti.
Les Pygmées marchent & ſe rangent en bataille.	Les Pygmées marchent et se rangent en bataille.
Le Roy fait un diſcours à ſes Armées, qui ſeul donneroit du courage aux plus timides.	Le Roi fait un discours à ses Armées, qui seul donnerait du courage aux plus timides.
Les Generaux y répondent comme ils doivent.	Les Généraux y répondent comme ils doivent.
Microton donne avis au Roy de l’approche des Gruës, dont le nombre eſt plus grand qu’il n’a jamais eſté.	Microton donne avis au Roi de l'approche des Grues, dont le nombre est plus grand qu'il n'a jamais été.
Les Princes ſe réjoüiſſent d’avoir une ſi belle occaſion de ſignaler leur valeur, & Picolus va ſe mettre à la teſte de ſon Armée.	Les Princes se réjouissent d'avoir une si belle occasion de signaler leur valeur, et Picolus va se mettre à la tête de son Armée.
Bélus prie le Roy de ſe retirer;	Bélus prie le Roi de se retirer;
ce qu’il fait avec des termes fort obligeans.	ce qu'il fait avec des termes fort obligeants.
Ce brave General voyant les Gruës fort avancées, donne les ordres neceſſaires pour le combat, qui ſe fait enſuite avec beaucoup de vigueur au bruit d’une Symphonie, qui donneroit envie de combattre à ceux qui n’y ſongeroient pas.	Ce brave Général voyant les Grues fort avancées, donne les ordres nécessaires pour le combat, qui se fait ensuite avec beaucoup de vigueur au bruit d'une Symphonie, qui donnerait envie de combattre à ceux qui n'y songeraient pas.
Timas, dans le temps que les Gruës ſont toutes aſſemblées, & s’acharnent le plus au carnage, s’éleve en l’air au deſſus d’elles, dans toute l’étenduë de leur Armée, avec tous ceux de ſes amis & de ſes confidens, qu’il a diſpoſez à ſon ex	Timas, dans le temps que les Grues sont toutes assemblées, et s'acharnent le plus au carnage, s'élève en l'air au dessus d'elles, dans toute l'étendue de leur Armée, avec tous ceux de ses amis et de ses confidents, qu'il a disposez à son ex
ACTE TROISIESME.	ACTE -TROISIÈME.
19 pédition:	19 pédition:
ils laiſſent tous tomber des filets qui les enyelopent & les atterrent de telle ſorte, qu’elles ne ſont plus en eſtat ny d’attaquer ny de ſe défendre.	ils laissent tous tomber des filets qui les enyloppent et les atterrent de telle sorte, qu'elles ne sont plus en état ni d'attaquer ni de se défendre.
Bélus s’imagine alors que ce ſecours extraordinaire eſt celuy que Sémiandre a fait eſperer de la part de Mars.	Bélus s'imagine alors que ce secours extraordinaire est celui que Sémiandre a fait espérer de la part de Mars.
Il luy vient à propos pour empeſcher ſes ſoldats de prendre la fuite, & pour leur faire achever la victoire que Timas a commencé d’aſſeurer.	Il luitaît à propos pour empêcher ses soldats de prendre la fuite, et pour leur faire achever la victoire que Timas a commencé d'assurer.
On combat enfin avec une ardeur incroyable.	On combat enfin avec une ardeur incroyable.
Il ne reſte que tres-peu de Gruës qu’on enchaîne.	Il ne reste que très-peu de Grues qu'on enchaîne.
Les Pygmées ſe retirent au ſon des inſtrumens qui joüent des fanfares.	Les Pygmées se retirent au son des instruments qui jouent des fanfares.
Bélus appercevant de loin Timas ſans le reconnoiſtre, & quelquesuns de ſes Amis à ſa ſuite, s’arreſte pour ſçavoir quels ils ſont.	Bélus apercevant de loin Timas sans le reconnaître, et quelquesuns de ses Amis à sa suite, s'arrête pour savoir quels ils sont.
Il eſt fort ſurpris, & fort ravy quand il revoit ce Prince qu’il eſtime infiniment, aprés avoir crû ſi long-temps qu’il eſtoit mort.	Il est fort surpris, et fort ravi quand il revoit ce Prince qu'il estime infiniment, après avoir cru si longtemps qu'il était mort.
Timas luy fait entendre que ce ſecours, dont j’ay parlé cy-devant, eſt l’effet de ſon amour pour la Patrie, & de l’aſſiſtance de ſes amis.	Timas avait fait entendre que ce secours, dont j'ai parlé cy-devant, est l'effet de son amour pour la Patrie, et de l'assistance de ses amis.
Ces deux Princes, aprés quelques complimens reciproques, quittent la Scene pour aller informer le Roy de ce qui s’eſt paſſé.	Ces deux Princes, après quelques compliments reciproques, quittent la Scène pour aller informer le Roi de ce qui s'est passé.
Ormin voulant meriter les bonnes graces de ſa Maîtreſſe, qui n’aime que les gens de cœur, fait ce qu’il peut pour ſe montrer vaillant.	Ormin voulant mériter les bonnes grâces de sa Maîtresse, qui n'aime que les gens de cœur, fait ce qu'il peut pour se montrer vaillant.
Il jure, il peſte, il paroiſt fort en colere, il vomit des injures, il tranche, il pointe, il eſtocade de loin contre les Gruës qui reſtent ſur la pluce.	Il jure, il peste, il paraît fort en colère, il vomit des injures, il tranche, il pointe, il estocade de loin contre les Grues qui restent sur la pluce.
Que luy rerviroit-il de s’en approcher, & de porter ſes coups ſur elles, puis qu’elles ne les ſentiroient pas?	Que quelque reruirait-il de s'en approcher, et de porter ses coups sur elles, puis qu'elles ne les sentiraient pas?
Ce ſeroit peine perduë.	Ce serait peine perdue.
Juſques-là jamais homme n’a paru ſi brave;	Jusqu'là jamais homme n'a paru si brave;
mais jamais homme auſſi n’a paru ſi lâche, qu’au moment qu’il entend des ſoldats qui viennent pour enlever les corps des Pygmées & des Ennemis qui ſont demeurez dans le Combat, & qu’on parle d’aſſommer & d’achever ce qui conſerveroit encore quelque reſte de vie.	mais jamais homme aussi n'a paru si lâche, qu'au moment qu'il entend des soldats qui viennent pour enlever les corps des Pygmées et des Ennemis qui sont demeurez dans le Combat, et qu'on parle d'assommer et d'achever ce qui conserverait encore quelque reste de vie.
Sa prudence luy conſeille de faire ſemblant d’avoir perdu le jour, pour ne le pas perdre en effet:	Sa prudence homme conseille de faire semblant d'avoir perdu le jour, pour ne le pas perdre en effet:
il donne aveuglement les mains à cét avis ſalutaire.	il donne aveuglément les mains à cet avis salutaire.
Comme il voit dans la ſuite, qu’on le plaint de ſa diſgrace, & qu’on ne ſonge point à luy faire aucun mal, mais ſeulement à l’emporter avec les autres corps morts;	Comme il voit dans la suite, qu'on le plaint de sa disgrâce, et qu'on ne songe point à lui faire aucun mal, mais seulement à l'emporter avec les autres corps morts;
il ſe reſſuſcite luy-meſme, & finit cét Acte par quantité de plaiſanteries fort divertiſſantes.	il se ressuscite lui-même, et finit cet Acte par quantité de plaisanteries fort divertissantes.
Des ſoldats armez dançent, en réjoüiſſance de la Bataille gagnée ſur les Gruës, & forment une Entrée de Balet toute de Jeux & de Plaiſirs.	Des soldats armés dançent, en réjouissance de la Bataille gagnée sur les Grues, et forment une Entrée de Ballet toute de Jeux et de Plaisirs.
Le cliquetis de leurs Armes, les acclamatioſis pupnques, ie bruit des imerumens, toutes ces choſes enſemble font un mélange pour les yeux & pour les oreilles, qui n’a rien que de fort charmant.	Le cliquetis de leurs Armes, les acclamatiosis pupnques, était bruit des imeruments, toutes ces choses ensemble font un mélange pour les yeux et pour les oreilles, qui n'a rien que de fort charmant.
L’on chante les paroles ſuivantes en faveur de la Victoire.	L'on chante les paroles suivantes en faveur de la Victoire.
CHANT DE VICTOIRE.	CHANT DE VICTOIRE.
Victoire, Victoire, Victoire.	Victoire, Victoire, Victoire.
Banniſſons de nôtre mémoire Les chagrins & les maux ſouffers:	Bannissons de notre mémoire Les chagrins et les maux soufferts:
Victoire, Victoire, Victoire.	Victoire, Victoire, Victoire.
Ne ſongeons qu'a chanter la gloire Des Heros qui briſent nos fers:	Ne songeons qu'a chanter la gloire Des Héros qui brisent nos fers:
Victoire, Victoire, Victoire.	Victoire, Victoire, Victoire.
Ne penſons, malgré l’humeur noire, Qu'a joüir des plaiſirs offers:	Ne pensons, malgré l'humeur noire, Qu'a jouir des plaisirs offerts:
Victoire, Victoire, Victoire.	Victoire, Victoire, Victoire.
Fin du troiſiéme Acte.	Fin du troisième Acte.
ACTE QVATRIESME.	ACTE QUATRIÈME.
triomphe des Vainqueurs.	triomphe des Vainqueurs.
Le Roy, que la Victoire aſſeure ſur ſon Trône, en meſme temps qu’elle établit pour jamais le repos & la liberté de ſes Peuples, exprime la joye qu’il en reſſent.	Le Roi, que la Victoire assure sur son Trône, en même temps qu'elle établit pour jamais le repos et la liberté de ses Peuples, exprime la joie qu'il en ressent.
Pichonine au contraire, ſe plonge dans une profonde triſteſſe, ſe voyant prés de paſſer dans les bras d’un Prince pour qui elle n’a que du mépris & de l’ayerſion.	Pichonine au contraire, se plonge dans une profonde tristesse, se voyant près de passer dans les bras d'un Prince pour qui elle n'a que du mépris et de l'aiersion.
C’eſt Picolus, à qui l’on attribuë la victoire, & qui, ſuivant la parole expreſſe du Roy, que le Vainqueur ſera l’époux de ſa cadette, la doit infailliblement épouſer.	C'est Picolus, à qui l'on attribue la victoire, et qui, suivant la parole expresse du Roi, que le Vainqueur sera l'époux de sa cadette, la doit infailliblement épouser.
La repugnance, les larmes, les prieres, les violens tranſports de cette Princeſſe ne peuvent vaincre la fermeté de ſon pere, & le faire conſentir à violer ſa parole.	La répugnance, les larmes, les prières, les violents transports de cette Princesse ne peuvent vaincre la fermeté de son père, et le faire consentir à violer sa parole.
Microton ſaiſi de douleur vient informer le Roy de la mort d’un des Generaux.	Microton saisi de douleur vient informer le Roi de la mort d'un des Généraux.
Pichonine ſouhaiteroit que ce fût Picolus;	Pichonine souhaiterait que ce fût Picolus;
mais Microton ne ſçait abſolument qui des deux a perdu la vie, & toutefois donne lieu de croire que c’eſt Bélus, plûtoſt que ſon Rival.	mais Microton ne sait absolument qui des deux a perdu la vie, et toutefois donne lieu de croire que c'est Blus, plutôt que son Rival.
Le coup eſt trop accablant pour la Princeſſe;	Le coup est trop accablant pour la Princesse;
elle y ſuccombe auſſi dans le moment, & ſe pâme entre les bras de Francine.	elle y succombe aussi dans le moment, et se pâme entre les bras de Francine.
Le Roy donne ordre à ſon confident d’aller chercher du ſecours.	Le Roi donne ordre à son confident d'aller chercher du secours.
Parvulie ſurvient & ſe montre fort ſurpriſe de trouver ſa ſœur en cét eſtat.	Parvulie survient et se montre fort surprise de trouver sa sœur en cet état.
Elle en apprend la cauſe de ſon Pere.	Elle en apprend la cause de son Père.
Tous deux, & Francine de ſon 22 coſté, font ce qu’ils peuvent pour la faire revenir de ſa pâmoiſon.	Tous deux, et Francine de son 22 côté, font ce qu'ils peuvent pour la faire revenir de sa pâmoison.
Le nom de Bélus, qu’elle entend prononcer, fait luy ſeul plus que tout le reſte.	Le nom de Bélus, qu'elle entend prononcer, fait lui seul plus que tout le reste.
Ce qui oblige le Roy de luy faire accroire que ce Prince eſt vivant, & qu’elle le doit bien-toſt voir, ſuppoſant qu’un courier, dans le temps qu’elle eſtoit évanoüie, eſt venu luy en apporter la nouvelle aſſeurée.	Ce qui oblige le Roi de lui faire accroire que ce Prince est vivant, et qu'elle le doit bientôt voir, supposant qu'un courier, dans le temps qu'elle était évanoüie, est venue luy en apporter la nouvelle assurée.
Cette fauſſeté veritable luy épargne la moitié de ſes déplaiſirs.	Cette fausseté véritable même épargne la moitié de ses déplaisirs.
Elle reſte toûjours en proye aux autres, que luy cauſe l’affreuſe penſée d’épouſer l’objet de ſa haine.	Elle reste toujours en proie aux autres, que lui cause l'affreuse pensée d'épouser l'objet de sa haine.
Un ſoldat annonce l’arrivée du Vainqueur.	Un soldat annonce l'arrivée du Vainqueur.
Pichonine ſe retire auſſi-toſt, ne pouvant ſouffrir la veuë de ce Prince odieux, ny meſme qu’on en parle en ſa préſence.	Pichonine se retire aussitôt, ne pouvant souffrir la vue de ce Prince odieux, notre même qu'on en parle en sa présence.
Un moment encore l’euſt fait ſortir de ſon erreur & de ſes chagrins pour entrer dans une joye inconcevable;	Un moment encore l'eût fait sortir de son erreur et de ses chagrins pour entrer dans une joie inconcevable;
elle euſt veû ſon cher Bélus, contre l’attente de toute la Cour;	elle eût vu son cher Bélus, contre l'attente de toute la Cour;
elle euſt appris que Picolus avoit uſurpé la qualité de Vainqueur qui appartenoit à ſon Rival, qu’il auroit aſſaſſiné ſans ce ſoldat à qui il avoit confié ſon deſſein, & qui avoit feint de le vouloir exécuter pour en empeſcher la cruelle exécution;	elle eût appris que Picolus avait usurpé la qualité de Vainqueur qui appartenait à son Rival, qu'il aurait assassiné sans ce soldat à qui il avait confié son dessein, et qui avait feint de le vouloir exécuter pour en empêcher la cruelle exécution;
& pour ſurcroiſt de contentement elle euſt appris la mort de ce perfide.	et pour surcroît de contentement elle eût appris la mort de ce perfide.
Parvulie a eſté mieux inſpirée, de demeurer auprés ſon Pere;	Parvulie a été mieux inspirée, de demeurer auprès son Père;
elle revoit ſon aimable Timas, qu’elle croyoit dans le tombeau.	elle revoit son aimable Timas, qu'elle croyait dans le tombeau.
Toutes ſes eſperances revivent, & ſes déplaiſirs meurent pour jamais.	Toutes ses espérances revivent, et ses déplaisirs meurent pour jamais.
Ces Princes ſont receus du Roy comme ils le meritent.	Ces Princes sont reçus du Roi comme ils le méritent.
Timas luy rend compte de ce qu’il a fait pendant ſon abſence, & luy explique par quel moyen il a ſecouru ſes Armées, & contribué à la Victoire qu’on a remportée ſur le Gruës:	Timas y rend compte de ce qu'il a fait pendant son absence, et même explique par quel moyen il a secouru ses Armées, et contribué à la Victoire qu'on a remportée sur le Grues:
auſſi le Roy veut qu’il triomphe conjointement avec Bélus, mais d’une autre maniere, & luy accorde la main de Parvulie.	aussi le Roi veut qu'il triomphe conjointement avec Bélus, mais d'une autre manière, et quelque accorde la main de Parvulie.
dont il a tout le cœur.	dont il a tout le cœur.
Ceux qui liront ou verront repreſenter la Piece auront la ſatisfaction de remarquer quantité de jeux de Theâtre, de ſurpriſes & d’entretiens touchans qui ſont renfermez, non ſeulement dans cét Acte;	Ceux qui liront ou verront représenter la Pièce auront la satisfaction de remarquer quantité de jeux de Théâtre, de surprises et d'entretiens touchants qui sont renfermés, non seulement dans cet Acte;
mais encore dans tous les autres, & dont je ne parle point icy pour abreger ce Diſcours, autant qu’il m’eſt poſſible.	mais encore dans tous les autres, et dont je ne parle point ici pour abréger ce Discours, autant qu'il m'est possible.
Ormin qui n’a que ſa Francine en teſte, & qui la cherche par tout, la rencontre fort empreſſée d’aller trouver le Roy.	Ormin qui n'a que sa Francine en tête, et qui la cherche par tout, la rencontre fort empressée d'aller trouver le Roi.
Il ne peut jouïr qu’un moment de ſon entretien, encore eſt-il forcé;	Il ne peut jouir qu'un moment de son entretien, encore est-il forcé;
ce moment toutefois qu’il paſſe avec elle, en fera paſſer de fort agreables à l’auditeur.	ce moment toutefois qu'il passe avec elle, en fera passer de fort agréables à l'auditeur.
Le Triomphe de Bélus, par terre, & de Timas en l’air, ſur des Gruës, ſe fait avec toute la pompe & toute la magnificence qui luy conviennent.	Le Triomphe de Bélus, par terre, et de Timas en l'air, sur des Grues, se fait avec toute la pompe et toute la magnificence qui avait conviennent.
Le ſpectacle en eſt d’autant plus curieux qu'ir ert rare & partieuner à ce Peuple.	Le spectacle en est d'autant plus curieux qu'ir ert rare et partieuner à ce Peuple.
Pluſieurs gens de qualité prevenans les réjoüiſſances publiques, dancent une Entrée de Balet tres-galante, aprés qu’un d’eux a chanté ce qui ſuit.	Plusieurs gens de qualité prévenants les réjouissances publiques, dancent une Entrée de Ballet très-galante, après qu'un d'eux a chanté ce qui suit.
CHANSON D'UNE PERSONNE DE ( VALITE’.	CHANSON D'UNE PERSONNE DE ( VALITE.
L’Amour a pour nous Des peines cruelles;	L'Amour a pour nous Des peines cruelles;
L’amour a pour nous Des plaiſirs bien doux:	L'amour a pour nous Des plaisirs bien doux:
Les Ames rebelles Souffrent ſes rigueurs;	Les Âmes rebelles Souffrent ses rigueurs;
Les Amans fidelles Goûtent ſes douceurs.	Les Amants fidèles Goûtent ses douceurs.
Fin du quatriéme Acte.	Fin du quatrième Acte.
ACIL CINVIESME.	ÀCIL CINVIESME.
V’EST dans un Palais beaucoup plus magnifique que le premier, enrichy de colomnes de lapis, de plumes d’oyſeaux de differentes couleurs, & autres choſes précieuſes, que ſe paſſe le dernier Acte.	V'EST dans un Palais beaucoup plus magnifique que le premier, enrichi de colomnes de lapis, de plumes d'oiseaux de différentes couleurs, et autres choses précieuses, que se passe le dernier Acte.
Sémiandre fait entendre au Roy, que ſon voyage aux Cieux eſt purement ſuppoſé, & que c’eſt une ruſe qu’il a pratiquée pour r’affermir le courage des Peuples, que les incidens fâcheux arrivez au Sacrifice avoient extrémement ébranlez;	Sémiandre fait entendre au Roi, que son voyage aux Cieux est purement supposé, et que c'est une ruse qu'il a pratiquée pour r'affermir le courage des Peuples, que les incidents fâcheux arrivez au Sacrifice avaient extrêmement ébranlez;
& pourtant que ſa machine luy a ſervy pour aller trouver Timas, avec qui il a toûjours eû commerce pendant ſon abſence, afin de le preſſer de s’approcher au plûtoſt, pour mettre au jour l’illuſtre entrepriſe dont le ſuccés eſt ſi favorable à la Patrie.	et pourtant que sa machine avoir a servi pour aller trouver Timas, avec qui il a toujours eû commerce pendant son absence, afin de le presser de s'approcher au plutôt, pour mettre au jour l'illustre entreprise dont le succès est si favorable à la Patrie.
Le Roy luy en ſçait bon gré, & commande à Microton de faire venir Pichonine.	Le Roi lui en sait bon gré, et commande à Microton de faire venir Pichonine.
Sémiandre s’entretient avec luy de la joye qu’il croit que cette Princeſſe doit reſſentir de ſon mariage avec Bélus, la croyant informée de la verité touchant le vainqueur & de la mort de Picolus:	Sémiandre s'entretient avec lui de la joie qu'il croit que cette Princesse doit ressentir de son mariage avec Bélus, la croyant informée de la vérité touchant le vainqueur et de la mort de Picolus:
mais il apprend que l’erreur de cette Princeſſe dure encore, & que le Roy l’y entretient exprés, pour la punir d’avoir eſté rebelle à ſes volontez, au ſujet de Picolus, qu’il luy parloit d’épouſer, dans le temps que luy-meſme le croyoit autheur de la victoire.	mais il apprend que l'erreur de cette Princesse dure encore, et que le Roi l'y entretient exprès, pour la punir d'avoir été rebelle à ses volontés, au sujet de Picolus, qu'il lui parlait d'épouser, dans le temps que lui-même le croyait auteur de la victoire.
Elle arrive avec Microton qui la conduit.	Elle arrive avec Microton qui la conduit.
Son pere la preſſe de préparer ſa main pour la donner au vainqueur;	Son père la presse de préparer sa main pour la donner au vainqueur;
elle y réſiſte autant qu’elle peut.	elle y résiste autant qu'elle peut.
Enfin, aprés avoir inutilement tenté les prieres 2 & les pleurs, elle luy préſente un poignard, & le conjure de le luy plonger dans le fein.	Enfin, après avoir inutilement tenté les prières 2 et les pleurs, elle lui prèsente un poignard, et le conjure de le vôtre plonger dans le sein.
Bélus ſe trouve à propos pour la déſarmer.	Bélus se trouve à propos pour la désarmer.
Ce n’eſt pas l’obliger dans le déſeſpoir où elle eſt, elle le fait bien connoître par les inſtances qu’elle fait à ce Prince de luy ravir le iour, ou de la délivrer d’un hymenée qui luy paroiſt plus terrible & plus cruel que la Mort.	Ce n'est pas l'obliger dans le désespoir où elle est, elle le fait bien connaître par les instances qu'elle fait à ce Prince de lui ravir le jour, ou de la délivrer d'un hyménée qui tu paraît plus terrible et plus cruel que la Mort.
Il eſt aiſé de penſer qu’il n’a point d’oreilles pour ces outrageantes prieres;	Il est aisé de penser qu'il n'a point d'oreilles pour ces outrageantes prières;
car comme il croit ſa maîtreſſe déſabuſée des faux bruits que Picolus avoit fait courre, & perſuadée de la verité, ainſi que toute la Cour, il s’applique toute la répugnance & toute l’averſion qu’elIe montre pour ce mariage, auquel il aſpire avec tant d’empreſſement, & ne peut conſentir à ſe trahir luy-meſme, en donnant les mains à la perfidie apparente qu’elle ſemble oppoſer à ſon ardeur fidele.	car comme il croit sa maîtresse désabusée des faux bruits que Picolus avait fait courre, et persuadée de la vérité, ainsi que toute la Cour, il s'applique toute la répugnance et toute l'aversion qu'élIe montre pour ce mariage, auquel il aspire avec tant d'empressement, et ne peut consentir à se trahir toujours-même, en donnant les mains à la perfidie apparente qu'elle semble opposer à son ardeur fidèle.
Pichonine prend ſon refus pour un ſenſible outrage, & le traite avec tout le mépris & toute l’indignation qu’elle croit luy devoir.	Pichonine prend son refus pour un sensible outrage, et le traite avec tout le mépris et toute l'indignation qu'elle croit lui devoir.
Il ne ſort point pour cela du reſpect;	Il ne sort point pour cela du respect;
il ſe plaint ſeulement de ce qu’elle n’a point eſté préſente au triomphe;	il se plaint seulement de ce qu'elle n'a point été présente au triomphe;
& en attribuë la cauſe au peu de cas qu’elle fait de ſa perſonne & de ſes feux.	et en attribue la cause au peu de cas qu'elle fait de sa personne et de ses feux.
Cette plainte l’oblige à luy faire valoir ce procedé comme une inſigne marque de ſon amour extrême;	Cette plainte l'oblige à lui faire valoir ce procédé comme une insigne marque de son amour extrême;
n’ayant pû, dit-elle, prendre plaiſir à voir ſon rival ( c’eſt Picolus dont elle entend parler) parmy les acclamations publiques, inſulter à leurs feux & dérober ſa gloire;	n'ayant pu, dit-elle, prendre plaisir à voir son rival ( c'est Polus dont elle entend parler) parmi les acclamations publiques, insulter à leurs feux et dérober sa gloire;
ny s’imaginer qu’il ait merité les honneurs qu’il a receus, & les lauriers dont on l’a couronné.	Ne s'imaginer qu'il ait mérité les honneurs qu'il a reçus, et les lauriers dont on l'a couronné.
Timas préſent à cét entretien, qui n’eſt point informé de l’erreur de cette Princeſſe, & qui vient de triompher avec Bélus, ſe fait une ſanglante injure de ce diſcours piquãt;	Timas présent à cet entretien, qui n'est point informé de l'erreur de cette Princesse, et qui vient de triompher avec Blus, se fait une sanglante injure de ce discours piquant;
il la traite auſſi, ſur tout, au ſujet de ce mot de rival, d’une maniere qu’on auroit peine à luy pardõner, ſi la préſence deParvulie ne l’excuſoit en quelque façon.	il la traite aussi, sur tout, au sujet de ce mot de rival, d'une manière qu'on aurait peine à nous pardonne, si la présence déParvulie ne l'excusait en quelque façon.
Pichonine en paroiſt toute ſurpriſe, d’autant plus qu’elle ne penſe point à ce Prince;	Pichonine en paraît toute surprise, d'autant plus qu'elle ne pense point à ce Prince;
& comme elle veut éclaircir toutes choſes, ſa ſœur l’entreprend & la pouſſe aſſez pour vanger ſon amour & ſes charmes qu’elle croit avoir eſté cruellement outragez.	et comme elle veut éclaircir toutes choses, sa sœur l'entreprend et la pousse assez pour venger son amour et ses charmes qu'elle croit avoir esté cruellement outragez.
Le Roy pouvoit épargner tous ces déplaiſirs à Pichonine;	Le Roi pouvait épargner tous ces déplaisirs à Pichonine;
mais il y ſemble prendre plaiſir.	mais il y semble prendre plaisir.
Elle en fait ceſſer une partie par la déclaration qu’elle fait, que ce qu’elle a dit juſqu’icy de déſobligeant, ne regarde ny ſa ſœur ny Timas, mais ſeulement Picolus;	Elle en fait cesser une partie par la déclaration qu'elle fait, que ce qu'elle a dit jusqu'ici de désobligeant, ne regarde ni sa sœur avait Timas, mais seulement Picolus;
& ſon pere la délivre de tous les autres en luy apprenant la mort de ce Prince, dont le nom ſeul luy a cauſé tant de maux & d’alarmes;	et son père la délivre de tous les autres en lui apprenant la mort de ce Prince, dont le nom seul lui a causé tant de maux et d'alarmes;
luy aſſûrant encore Bélus pour ſon époux.	Je assurant encore Bélus pour son époux.
Les tendres éclairciſſemens, les douces eſperances, la joye & les plaiſirs prennent la place des troubles, des chagrins, des larmes & des peines qui ont regné juſqu’à preſent.	Les tendres éclaircissements, les douces espérances, la joie et les plaisirs prennent la place des troubles, des chagrins, des larmes et des peines qui ont régné jusqu'à présent.
Le Roy ne veut plus entendre parler déſormais que de réjoüiſſance.	Le Roi ne veut plus entendre parler désormais que de réjoüissance.
Francine ſecondant ſes intentions, invite chacun à les ſuivre par ces paroles qu’elle chante.	Francine secondant ses intentions, invite chacun à les suivre par ces paroles qu'elle chante.
CHANSON DE FRANCINE.	CHANSON DE FRANCINE.
JoüiſſeZ, joüiſſez des charmes de la vie, Tandis qu’ils flatent vos deſirs;	JoüisseZ, jouissez des charmes de la vie, Tandis qu'ils flattent vos désirs;
Il n’eſt plus temps de goûter les plaiſirs, Lors qu'on en a paſſé l’envie:	Il n'est plus temps de goûter les plaisirs, Lors qu'on en a passé l'envie:
Les biens les plus charmãs perdent tous leurs appas, Du moment qu’ils ne plaiſent pas.	Les biens les plus charmands perdent tous leurs appas, Du moment qu'ils ne plaisent pas.
Si le Roy parle d’établir des jeux & des feſtes, c’eſt, ſur tout, pour y honorer le Monarque Dieu des François, & pour luy rendre grace de la glorieuſe protection, dont les Pygmées luy ſont redevables.	Si le Roi parle d'établir des jeux et des fêtes, c'est, sur tout, pour y honorer le Monarque Dieu des Français, et pour lui rendre grâce de la glorieuse protection, dont les Pygmées lui sont redevables.
Les Princes & les Princeſſes applaudiſſent ces nobles ſentimens.	Les Princes et les Princesses applaudissent ces nobles sentiments.
Mercure paroiſt en l’air, & leur témoigne que les Dieux les approuvent.	Mercure paraît en l'air, et leur témoigne que les Dieux les approuvent.
Voicy comme il s’explique.	Voici comme il s'explique.
DISCOURS DE MERCURE.	DISCOURS DE MERCURE.
Les Dieux viennent de tout entendre, Et je vous declare pour eux, Qu'ils ne prendront jamais pour une offence, Que vous inſtituiez, des feſtes & des jeux En l'honneur du Dieu?	Les Dieux viennent de tout entendre, Et je vous déclare pour eux, Qu'ils ne prendront jamais pour une offense, Que vous instituiez, des fêtes et des jeux En l'honneur du Dieu?
de la France;	de la France;
Que vous poußiez vers luy des vœux;	Que vous pouviez vers lui des vœux;
Et que vous l’adorieZ dan uet Fomptes fameux.	Et que vous l'adoriez dan uet Fomptes fameux.
Le Soleil traverſant le Ciel ſur ſon char, qu’il conduit en demi-cercle, le déclare en ſon particulier, avec des termes trés-obligeans.	Le Soleil traversant le Ciel sur son char, qu'il conduit en demi-cercle, le déclare en son particulier, avec des termes très-obligeans.
Ce ſont ceux qui ſuivent.	Ce sont ceux qui suivent.
DISCOURS DU SOLEIL.	DISCOURS DU SOLEIL.
Quant à moy, je luy céde en tout la préference;	Quant à moi, je croit cède en tout la préférence;
Et ſi les nuits, außi-bien que les jours, Ne ſervoient pas à ſon ardeur guerriere,	Et si les nuits, aussi-bien que les jours, Ne servaient pas à son ardeur guerrière,
D ij Dans le milieu de ma carriere, Souvent pour luy j’arreſterois mon cours.	 Déjà le milieu de ma carrière, Souvent pour lui j'arrêterais mon cours.
Le Soleil eſtant diſparu, Mercure recommence à parler de la ſorte.	Le Soleil étant disparu, Mercure recommence à parler de la sorte.
AUTRE DISCOURS DE MERCURE.	AUTRE DISCOURS DE MERCURE.
Quoy que de ma nature, Je ſois un peu fourbe & menteur, Le Soleil qui ne fût jamais un impoſteur, Fait voir que mon diſcours eſt la verité pure.	Quoi que de ma nature, Je sois un peu fourbe et menteur, Le Soleil qui ne fût jamais un imposteur, Fait voir que mon discours est la vérité pure.
Mars croit qu’il eſt de ſon devoir de faire la meſme choſe.	Mars croit qu'il est de son devoir de faire la même chose.
Il ſort du fonds de la Gloire, ſur ſon char, qu’il fait deſcendre à trois pieds de terre, & s’en acquite de fort bonne grace.	Il sort du fonds de la Gloire, sur son char, qu'il fait descendre à trois pieds de terre, et s'en acquite de fort bonne grâce.
Aprés quoy il remonte aux Cieux, vers le cintre, avec une telle rapidité, que la veuë a peine à la diſcerner.	Après quoi il remonte aux Cieux, vers le cintre, avec une telle rapidité, que la vue a peine à la discerner.
Jugez ſi Mars n’eſt pas pour le moins autant éloquent, qu’il eſt brave;	Jugez si Mars n'est pas pour le moins autant éloquent, qu'il est brave;
& conſultez pour cela les termes ſuivans, dont il ſe ſert.	et consultez pour cela les termes suivants, dont il se sert.
DISCOURS DE MARS.	DISCOURS DE MARS.
Moy pareillement je l’aßûre;	Moi pareillement je l'assure;
C’eſt bien à ma confuſion, Et je ſuis garant que Mercure Dit vray dans cette occaſion.	C'est bien à ma confusion, Et je suis garant que Mercure Dit vrai dans cette occasion.
Il peut encor plus dire;	Il peut encor plus dire;
Meſme, il en a permißion.	Même, il en a permission.
La France eſt à préſent un ſi célebre Empire, Que mes Co-éternels, s’il eſtoit queſtion De l'échanger ( par ſuppoſition) Contre leur ſejour qu’on admire, Ils recevroient bien-toſt la propoſition, T ſouſcrivãt, ſans doute, ils n’auroient pas du pire;	La France est à présent un si célèbre Empire, Que mes Co-éternels, s'il était question De l'échanger ( par supposition) Contre leur séjour qu'on admire, Ils recevraient bientôt la proposition, T souscrivãt, sans doute, ils n'auraient pas du pire;
Pour moy, je ne dirois pas non:	Pour moi, je ne dirais pas non:
Je me contenterois à moins ( l’oſay-je dire?	Je me contenterais à moins ( l'osai-je dire?
Je me contenterois de porter le grand nom Du Monarque Divin, qui.	Je me contenterais de porter le grand nom Du Monarque Divin, qui.
mais je me retire.	mais je me retire.
Mercure diſparoiſt au meſme inſtant que Mars, luy coupant chemin, par un vol hemi-ſphérique, tout contraire à celuy du Soleil.	Mercure disparaît au même instant que Mars, lui coupant chemin, par un vol hemi-sphérique, tout contraire à celui du Soleil.
Toute la Cour ſe retire pour aller joüir des plaiſirs qui luy ſont préparez.	Toute la Cour se retire pour aller jouir des plaisirs qui lui sont préparés.
Deux partis, l’un de Vignerons & l’autre de Bergers, font voir la part qu’ils prennent à la joye publique.	Deux partis, l'un de Vignerons et l'autre de Bergers, font voir la part qu'ils prennent à la joie publique.
Un des premiers chante ce qui ſuit.	Un des premiers chante ce qui suit.
CHANSON DES VIGNERONS.	CHANSON DES VIGNERONS.
ompagnons, guerre, guerre, guerre Contre l’amour & le chagrin;	ompagnons, guerre, guerre, guerre Contre l'amour et le chagrin;
Armons-nous du pot & du verre, Bachus conduit nôtre deſtin.	Armons-nous du pot et du verre, Bachus conduit notre destin.
Si quelque ſoin nous preſſe Dans ce combat divin, C’eſt qu’on tire ſans ceſſe Par tout des coups de vin.	Si quelque soin nous presse Dans ce combat divin, C'est qu'on tire sans cesse Par tout des coups de vin.
Les Vignerons dancent enſuite.	Les Vignerons dancent ensuite.
Le meſme chante ce ſecond couplet.	Le même chante ce second couplet.
SECOND GOOIEHI DA HI CHIANSON	SECOND GOIEHI DA HI CHIANSON
DES VIGNERONS.	DES VIGNERONS.
Combattons tous avec audace, Et cédons au nombre des coups;	Combattons tous avec audace, Et cédons au nombre des coups;
Il nous faut reſter ſur la place, Et demain nous revivrons tous:	Il nous faut rester sur la place, Et demain nous revivrons tous:
Quand il s’agit de boire, Les loix du Dieu Bachus Ne donnent la victoire Qu'à ceux qui ſont vaincus.	Quand il s'agit de boire, Les lois du Dieu Bachus Ne donnent la victoire Qu'à ceux qui sont vaincus.
Une lumiere toute ſurprenante, que la veuë ne peut preſque ſupporter, oblige le Roy & toute la Cour d’interrompre cette réjoüiſſance, pour chercher la cauſe de cette merveille.	Une lumière toute surprenante, que la vue ne peut presque supporter, oblige le Roi et toute la Cour d'interrompre cette réjouissance, pour chercher la cause de cette merveille.
Jupiter aſſis ſur ſon Trône, dans un ciel tout brillant de gloire, au milieu de tous les Dieux, la luy fait bien-toſt connoître, & luy confirme ce que Mereure luy a témoigné de leur part.	Jupiter assis sur son Trône, dans un ciel tout brillant de gloire, au milieu de tous les Dieux, la sens fait bientôt connaître, et lui confirme ce que Mère te a témoigné de leur part.
C’eſt ainſi qu’il en parle.	C'est ainsi qu'il en parle.
DISCOURS DE JUPITER.	DISCOURS DE JUPITER.
Tu vois au milieu de ſes Dieux Le Maître du Tonnerre.	Tu vois au milieu de ses Dieux Le Maître du Tonnerre.
Ils te confirment par ma voix, Ce que Mercure a dû te faire entendre Au ſujet du Dieu des François.	Ils te confirment par ma voix, Ce que Mercure a dû te faire entendre Au sujet du Dieu des Français.
Le Ciel prendroit le party qu’il faut prendre S’il ſe ſoûmettotr u jes tort.	Le Ciel prendrait le parti qu'il faut prendre S'il se soumettotr tort.
Ppies, Nous vous ſçaurons bon gré de luy bâtir des TemEt dans nos cœurs, au moins, nous ſuivrons vos exemples.	Ppies, Nous vous saurons bon gré de lui bâtir des TemEt dans nos cœurs, au moins, nous suivrons vos exemples.
N'ayeZ point de plus chers deſirs, Que de ſervir, tantoſt à ſes plaiſirs, Et tantoſt à chanter ſa gloire:	N'ayeZ point de plus chers désirs, Que de servir, tantôt à ses plaisirs, Et tantôt à chanter sa gloire:
Nous en ferons de meſme, & vous le devez croire.	Nous en serons de même, et vous le devez croire.
Que dans tout l’Univers, Et ſur la Terre, & dans les Airs, Cette nouvelle ſoit ſemée Par Mercure & la Renommée.	Que dans tout l'Univers, Et sur la Terre, et dans les Airs, Cette nouvelle soit semée Par Mercure et la Renommée.
Ces deux Divinitez obeïſſent incontinent à ſes ordres.	Ces deux Divinités obéissent incontinent à ses ordres.
Elles s’élancent, pour cét effet, du Ciel en terre;	Elles s'élancent, pour cet effet, du Ciel en terre;
s’élevent enſuite en l’air, formant un demy-rond, à l’oppoſite l’un de l’autre, & prennent enfin leur route, coſte à coſte, vers le Cintre, où elles ſe dérobent aux yeux des Spectateurs.	s'élevent ensuite en l'air, formant un demi-rond, à l'opposite l'un de l'autre, et prennent enfin leur route, côte à côte, vers le Cintre, où elles se dérobent aux yeux des Spectateurs.
Les Vignerons & les Bergers que la preſence du Roy & de la Coul avoit troublez dans leurs plaiſirs, recommencent leurs Jeux & leurs Chanſons, pour achever la réjoüiſſance publique & les divertiſſemens de la Piece.	Les Vignerons et les Bergers que la présence du Roi et de la Coul avait troublés dans leurs plaisirs, recommencent leurs Jeux et leurs Chansons, pour achever la réjouissance publique et les divertissements de la Pièce.
CHANSON DES VIGNERONS.	CHANSON DES VIGNERONS.
Heureux qui peut ſuivre Le Dieu des Tonneaux!	Heureux qui peut suivre Le Dieu des Tonneaux!
Le Vin ſeul nous livre Les biens ſans les maux.	Le Vin seul nous livre Les biens sans les maux.
Le plus doux Empire, Bachus, c’eſt le tien;	Le plus doux Empire, Bachus, c'est le tien;
Si l’on y ſoûpire, C’eſt d’eſtre trop bien.	Si l'on y soupire, C'est d'être trop bien.
Les Bergers jaloux des intereſts de leur Dieu, font chanter ſur le meſme air des Vignerons les paroles luivantes a la gloire de l’Amour.	Les Bergers jaloux des intérêts de leur Dieu, font chanter sur le même air des Vignerons les paroles luivantes à la gloire de l'Amour.
SECOND COUPLET CHANTE' PAR UN des Bergers ſur l’air des Vignerons.	SECOND COUPLET CHANTE PAR UN des Bergers sur l'air des Vignerons.
Soyons ſous les armes Du Dieu des amours;	Soyons sous les armes Du Dieu des amours;
Parlons de ſes charmes, Penſons-y toüjours:	Parlons de ses charmes, Pensons-y tendre:
Ainſi nôtre vie Dans tous ſes momens Se verra remplie De plaiſirs charmans.	Ainsi notre vie Dans tous ses moments Se verra remplie De plaisirs charmants.
Leuis agreables debats le teriiſient enfin par un heureux accord.	Levis agréables débats le teriisient enfin par un heureux accord.
Ces paroles qu’ils chantent d’un & d’autre party, en r’enferment les articles & les raiſons inconteſtables.	Ces paroles qu'ils chantent d'un et d'autre parti, en renferment les articles et les raisons incontestables.
TROISIESME COUPLET CHANTE' PAR LES Bergers & les Vignerons enſemble.	TROISIÈME COUPLET CHANTE PAR LES Bergers et les Vignerons ensemble.
Bachus ſur la terre Fût bien amoureux;	Bachus sur la terre Fût bien amoureux;
L’Amour & ſa Mere Boivent dans les Cieux:	L'Amour et sa Mère Boivent dans les Cieux:
Voulons-nous nous faire Un ſort plus heureux?	Voulons-nous nous faire Un sort plus heureux?
Ceſſons nôtre guerre, Et faiſons comme eux.	Cessons notre guerre, Et faisons comme eux.
L’entrée de Balet qu’ils dancent tous enſemble, eſt l’agrément qu’ils y donnent.	L'entrée de Ballet qu'ils dancent tous ensemble, est l'agrément qu'ils y donnent.
Fin du cinquiéme Acte	Fin du cinquième Acte
