Voſtre tres-humble & tres.	Votre très-humble et très.
obeïſſant ſeruiteur, VALLE’E.	obéissant serviteur, VALLÉLE.
AV LECTEVR.	AU LECTEUR.
M VELQV'VN blâmeroit, peut eſtre, la façon d’écrire que i’ây ſuiuie en ce petit Ouurage, ſur ce que l’on pourroit dire, que ne luy donnant pas vne entiere accommodation au Théâtre, ie deuois en faire vn Poëme continu.	M VELQV'VN blâmerait, peut -être, la façon d'écrire que j'y suivie en ce petit Ouvrage, sur ce que l'on pourrait dire, que ne lui donnant pas une entière accommodation au Théâtre, sans devais en faire un Poème continu.
Mais ie répons par auance, que le Dramatique eſt, à mon auis, celuy par lequel nous exprimons le plus ſenſiblement ce que nous voulons repreſenter:	Mais était réponds par avance, que le Dramatique est, à mon avis, celui par lequel nous exprimons le plus sensiblement ce que nous voulons représenter:
Et que ce ſujet contient des matieres, qui ne pouuoient conuenablement eſtre débitées au Théâtre:	Et que ce sujet contient des matières, qui ne pouvaient convenablement être débité au Théâtre:
Ainſi i’ay voulu me ſeruir de la force de l’vn, ſans profaner la ſaincteté des autres.	Ainsi j'ai voulu me servir de la force de l'un, sans profaner la sainteté des autres.
Il eſt facile!	Il est facile!
d’obſeruer au premier Entretien;	d'observer au premier Entretien;
lors que Suſanne dit à Claude (tu ) ſeulelement vne fois, que c’eſt par le tranſport d’vn ſaint zele, & luy reprochant vn blaſpheme.	lors que Susanne dit à Claude (tu ) seulelement une fois, que c'est par le transport d'un saint zèle, et lui reprochant un blâme.
Fauoris de l’Empereur.	Favoris de l'Empereur.
LA FORTE ROMAINE.	LA FORTE ROMAINE.
PREMIERE PARTIE, SOLILOQVE de jé	PREMIÈRE PARTIE, SOLILOUE de jé
P CLAVDE.	 CLAUDE.
E craignois que Gabin s’ennuyât de m’âttendre, Et ie ſuis le premier où nous deuions nous rendre:	E craignais que Gabin s'ennuyât de m'âttendre, Et ie suis le premier où nous devions nous rendre:
Mais n'en auroit il point perdu le ſouuenir;	Mais n'en aurait il point perdu le souvenir;
Car le temps eſt paſſé;	Car le temps est passé;
non ie l'entends venir.	non ainsi l'entends venir.
Ha!	Ha!
ie me ſuis trompé, c’eſt ſa fille, Guſanne.	Ne me suis trompé, c'est sa fille, Gusanne.
PREMIER ENTRETIEN.	PREMIER ENTRETIEN.
SVSANNE, CLAVDE.	SUSANE, CLAUDE.
V SANNE.	V SANNE.
Fuyés, mes yeux, l'object que mon Eſprir condamne.	Fuyez, mes yeux, l'object que mon Esprir condamne.
CLAVDE.	CLAUDE.
Que cette occaſion vient fauorablement!	Que cette occasion vient favorablement!
Parlons luy, decouurons quel eſt ſon ſentiment.	Parlons lui, découvrons quel est son sentiment.
Ie confeſſe auoir fait vne heureuſe mépriſe:	Je confesse avoir fait quelque heureuse méprise:
Iniuriex refus!	Injuriex refus!
SVSANNE Indiſcrette entrepriſe!	SUSANE Indiscrète entreprise!
CLAVDE Outre que le ſalut doit eſtre indiferent;	CLAUDE Outre que le salut doit être indifèrent;
y ous me deues ertcer comne vortre parent:	y ous me devez ertcer comne vortre parent:
Feignés vous d’ignorer l’ordrede viure à Rome?	Feignez -vous d'ignorer l'ordre vivre à Rome?
SVSANNE I’ay de l’auerſion pour les baiſers d’vn homme:	SUSANNE J'ai de l'aversion pour les baisers d'un homme:
Mon viſage ne fut iamais touché d’aucun, De le flio bucinaiuumomomtrant du commun?	Mon visage ne fut jamais touché d'aucun, De le flio bucinaiuumomomtrant du commun?
Les mouuemens du cœur s’exprimant par paroles Font ſeruir vôtre bouche auaculte des Idoles.	Les mouvements du cœur s'exprimant par paroles Font servir votre bouche auaculte des Idoles.
CLAVDE apart ſoy.	CLAUDE appart soi.
Comment endurés vous (Dieux) que l’impieté Ait pour ſe faire ſuiure vn maſque de beauté?	Comment endurez -vous (Dieux) que l'impiété Ait pour se faire suivre un masque de beauté?
SVSANNE apart ſoy.	SUSANE appart soi.
Pouués vous bien ſouffrir, Diuinité ſupréme, Qu'vir lettnie redorte namonjamtoue aime?	Pouvez -vous bien souffrir, Divinité suprême, Qu'vir lettnie redorte namonjamoue aime?
CLAVDE Que ne rabaiſſés vous ſes ſentimens hautains, Les faiſant ſuccomber ſous le poix de vos mains?	CLAUDE Que ne rabaissez vous ses sentiments hautains, Les faisant succomber sous le poix de vos mains?
SVSANNE Pourquoy ne laiſſés vous agir vôtre Iuſtice, Et rendre l’Vniuers armé pour ſon ſuplice?	SUSANE Pourquoi ne laissez vous agir votre Justice, Et rendre l'Univers armé pour son supplice?
CLAVDE Vous voyant mepriſer, ne faut il pas punir?	CLAUDE Vous voyant mépriser, ne faut -il pas punir?
Vôtre clemence peut vôtre gloire ternir.	Votre clémence peut votre gloire ternir.
SVSANNE Vôtre gloire ne peur eſtre jamais flétrie, C iiboſt) teccupic hio (Y.	SUSANNE Votre gloire ne peur être jamais flétrie, Ç iibost) teccupic hio (Y.
Mnide Pen voue en derove encette idolatiies.	Mnide Pen voue en derove encette idolâtiies.
CLAVDE Faites puiſſamment voir que vous eſtes des Dieux A qui les Chreſtiens ſont des objects odieux.	CLAUDE Faites puissamment voir que vous êtes des Dieux À qui les Chrétiens sont des objects odieux.
SVSANNE Vn ſeul particulier retient le populaire, Quand on luy fait ſouffirir vne peine exemplaire:	SUSANNE Un seul particulier retient le populaire, Quand on lui fait souffir to peine exemplaire:
Mais ie m’efforce en vain d’aigrir vôtre couroux, Car vous ne recherchés que le ſalut de tous.	Mais ainsi m'efforce en vain d'aigrir votre courroux, Car vous ne recherchez que le salut de tous.
Vôtre aureille n’eſt point à mon diſcours ouuerte, Vous ne pouués (mon Dieu) conſentir à ſa perte;	Votre aureille n'est point à mon discours ouverte, Vous ne pensez (mon Dieu) consentir à sa perte;
De quelque énormité que pechent les humains, Pour leur punition vous n’aués point de mains, Qu’apres qu’ils ont receu l’aide de vôtre grace, furqu'a reauemte, lalis leur eitre encace:	De quelque énormité que pèchent les humains, Pour leur punition vous n'avez point de mains, Qu'après qu'ils ont reçu l'aide de votre grâce, furqu'a reavemte, lalis leur eitre encace:
Lors que vous les frapés, c’eſt de traits de douceur, Et quoy que l’offenſé, vous cherchés l’offenſeur.	Lors que vous les frappez, c'est de traits de douceur, Et quoi que l'offensé, vous cherchez l'offenseur.
CLAVDE Vous parlés à ce Dieu dont la toute-Puiſſance Ne parut jamais mieux qu’au haut d’vne potence?	CLAUDE Vous parlès à ce Dieu dont la toute-Puissance Ne parut jamais mieux qu'au haut d'une potence?
SVSANNE Profane, en blaſphemant tu dis la verité, Là, ſon pouuoir parut en ſon humilité;	SUSANE Profane, en blasphèment tu dis la vérité, Là, son pouvoir parut en son humilité;
Son Eſprit (diroit-on) ſecrettement t’inſpire, Car tu dis beacoup plus que tu ne penſe dire.	Son Esprit (dirait-on) secrètement t'inspire, Car tu dis beacoup plus que tu ne pense dire.
Quoy que la Terre, l’Eau, L’air, le feu, ce flambeau Sans lequel l'Vniuers ne ſeroit qu’vn Tombeau, Ces Cieux toûjours roulans, d’admirable ſtructure, Et tout ce qu’à nos yeux étale la Nature, Ait reçeu de luy l’eſtre, & la creation;	Quoi que la Terre, l'Eau, L'air, le feu, ce flambeau Sans lequel l'Univers ne serait qu'un Tombeau, Ces Cieux toujours roulants, d'admirable structure, Et tout ce qu'à nos yeux étale la Nature, Ait reçu de lui l'être, et la création;
Rien ne peut égaler nôtre rédemption.	Rien ne peut égaler notre rédemption.
En elle la colere a l’amour pour complice,	En elle la colère a l'amour pour complice,
A ij La Clemence y paroit jointe auec la Iuſtice:	A ij La Clémence y paraît jointe avec la Justice:
Les contraires par là peuuent ſimpatiſer, Vn Dieu s’y void mourir, l’homme immortaliſer?	Les contraires par là peuvent simpatiser, Un Dieu s'y voit mourir, l'homme immortaliser?
Enfin ce que le Ciel contient de plus auguſte, Y tient lieu de pecheur, & le pecheur de iuſte.	Enfin ce que le Ciel contient de plus auguste, Y tient lieu de pécheur, et le pécheur de juste.
CLAVDE Si ce Dieu pouuoit tout, pourquoy frauroit il pas Reparé le peché, ſans ſouffrir le trepas?	CLAUDE Si ce Dieu pouvait tout, pourquoi fraurait -il pas Réparé le péché, sans souffrir le trépas?
SVSANNE L’immortel ſe rendant de la mort tributaire, Sa Iuſtice eut ainſi dequoy ſe ſatisfaire.	SUSANNE L'immortel se rendant de la mort tributaire, Sa Justice eut ainsi dequoy se satisfaire.
Par ſa loy, le peché deuoit eſtre puni:	Par sa loi, le péché devait être puni:
Et comme ſon object le rendoit infini, Il ne pouuoit auoir de punition telle, Que l’homme ne ſouffrit vne mort éternelle.	Et comme son object le rendait infini, Il ne pouvait avoir de punition telle, Que l'homme ne souffrit une mort éternelle.
Son Amour s’oppoſant â ce dur iugement, Satisfit ſa Iuſtice agiſſant autrement:	Son Amour s'opposant â ce dur jugement, Satisfit sa Justice agissant autrement:
La mort fut temporelle, obſeruant la meſure;	La mort fut temporelle, observant la mesure;
Il la faut infinie, & l’infini l’endure, Reparant dans le temps par ſon infinité, Ce qu’vn fini n’eût pû, meſme en l’Eternité.	Il la faut infinie, et l'infini l'endure, Réparant dans le temps par son infinité, Ce qu'Homme fini n'eût pu, même en l'Éternité.
C eit aui que ron vid la Charité parfaite, Contenter ſa Iuſtice, & reſter ſatisfaite, Et luy meſme en ſa mort eſtre reparateur, Du crime contre luy, dont l’homme eſtoit l’autheur.	Ç Cit aui que ron vit la Charité parfaite, Contenter sa Justice, et rester satisfaite, Et lui avait en sa mort être réparateur, Du crime contre notre, dont l'homme était l'auteur.
CLAVDE Qu el excés de bonté!	CLAUDE Qu el excès de bonté!
SVSANNE Des prodiges viſibles, Montrerent qu’il touchoit les choſes inſenſibles.	SUSANNE Des prodiges visibles, Montrerent qu'il touchait les choses insensibles.
Le grand aſtre du iour, lors qu’il rendit l’Eſprit;	Le grand astre du jour, lors qu'il rendit l'Esprit;
Fit aſſés voir ſon deüil par la couleur qu’il prit,	Fit assez voir son deuil par la couleur qu'il prit,
D'vn voile ténébreux il obſcurcit ſes flames.	D'un voile ténébreux il obscurcit ses flammes.
Quand il vid éclipſer le Soleil de nos Ames:	Quand il vit éclipser le Soleil de nos Âmes:
Ce bel œil ne montroit deſt viue couleur Que des larmes de ſang, dapu ſa noire páleur.	Ce bel œil ne montrait dest vive couleur Que des larmes de sang, dapu sa noire pleur.
Celle qui dans ſoſſſein tient le centre dumonde, Nôtre communeſtttre & prodigue & féconde, Apperceuant finie eppuy de ſon repos, Trembla, de peur dechoir dans le premier chaos La charité, ce feu;	Celle qui dans sosssein tient le centre dumonde, Notre communesttre et prodigue et féconde, Apercevant finie épui de son repos, Trembla, de peur déchoir dans le premier chaos La charité, ce feu;
dont la chaleur diuine, Comme ce vn ſacré Globe eſtoit dans ſa Poitrine, Par vn trou violent trouuant à s’exaler, Suit ſon actiuité, ſort, & cherche à bruler:	dont la chaleur divine, Comme ce un sacré Globe était dans sa Poitrine, Par un trou violent trouvant à s'exaler, Suit son activité, sort, et cherche à brûler:
L’on vid par ſes ardeurs, en tous lieux étendües Les ſepulchres ouuerts, & les Pierres fendües.	L'on vit par ses ardeurs, en tous lieux étendues Les sépulchres ouverts, et les Pierres fendues.
Long-temps auant ce iour fatalement heureux, Le Geſſſé humain tombé ſous vn ſort rigoureux, N’aſioit de ſon ſalut qu’vn fauorable augure, Nôtre redemption n’eſtoit lors qu’en figure;	Longtemps avant ce jour fatalement heureux, Le Gessé humain tombé sous un sort rigoureux, N'asiait de son salut qu'un favorable augure, Notre rédemption n'était lors qu'en figure;
Le plus fauoriſé d’entre tous les mortels, N’oſoit que rarement approcher des Autels;	Le plus favorisé d'entre tous les mortels, N'osait que rarement approcher des Autels;
Mais le voile, témoin d’vne telle diſgrace, Qui du Temple ſacré couuroit la ſainte face, Se rompant, en ce iour de merueilles rempli, Tout parût découuert, comme tout accompli.	Mais le voile, témoin d'une telle disgrâce, Qui du Temple sacré couvrait la sainte face, Se rompant, en ce jour de merveilles rempli, Tout parût découvert, comme tout accompli.
Si jadis, pour former cet excellent ouurage, Qui de ſon Createur eſt la viuante image, Il falut vn effort de puiſſance & d’amour, Le meſme ſe rencontre en ce celebre iour :	Si jadis, pour former cet excellent ouvrage, Qui de son Créateur est la vivante image, Il fallut un effort de puissance et d'amour, Le même se rencontre en ce célèbre jour :
C’eſt le meſme ouurier, & la meſme matiere;	C'est le même ouvrier, et la même matière;
Pluſieurs corps que la mort auoit mis en pouſſiere, Reduits dans le néant de la priuation, Se virent rétablir en leur perfection :	Plusieurs corps que la mort avait mis en poussière, Réduits dans le néant de la privation, Se virent rétablir en leur perfection :
Par vn ſemblable effect d’amour & de puiſſance, Ils receurent encor la vie & l’exiſtance:	Par un semblable effet d'amour et de puissance, Ils recevrent encor la vie et l'existance:
Mais en ce merueilleux & public changement Lhomme perſeuera dans l’endurciſſement.	Mais en ce merveilleux et public changement Lhomme persévéra dans l'endurcissement.
CLAVDE Ha!	CLAUDE Ha!
mon ame, c’eſt trop faire de reſiſtance!	mon âme, c'est trop faire de résistance!
Ce diſcours, d’vn vray Dieu me donne conoiſſance.	Ce discours, d'un vrai Dieu me donne conaissance.
Idolátrie, Erreur, Fauſſe doctrine, Abus, Vous m’appellés en vain, ie ne vous entends plus.	Idolâtrie, Erreur, Fausse doctrine, Abus, Vous m'appelez en vain, enfin ne vous entends plus.
Ceux que vous attirés n’ont que le deſſein d’eſtre Pareils au fer, qui ſuit l’ayman ſans le connoître.	Ceux que vous attirez n'ont que le dessein d'être Pareils au fer, qui suit l'aiman sans le connaître.
Vne viue lumiere éclaire ma raiſon, I’auale l’antidore & vomis le poiſon, La vertu veut regner ſur le Trône du vice, Il eſt temps de produire vn acte de Iuſtice;	Une vive lumière éclaire ma raison, J'avale l'antidore et vomis le poison, La vertu veut régner sur le Trône du vice, Il est temps de produire un acte de Justice;
Et par le changement de contraires partis, Retourner vers le lieu d’ou nous ſommes partis.	Et par le changement de contraires partis, Retourner vers le lieu d'ou nous sommes partis.
Ie m’eſtois égaré, dans mon chemin ie r’entre, Mon cœur ſent gayement l’approche de ſon centre, Mon ame, que l’orage auoit mis loin du bord, Commance à voir le calme, & decouure ſon port.	Je m'étais égaré, dans mon chemin ie rentre, Mon cœur sent gaiement l'approche de son centre, Mon âme, que l'orage avait mis loin du bord, Commance à voir le calme, et découvre son port.
Vils metaux, auſquels l’art poliſſant la nature, A donné l’ornement d’vne belle figure, A qui nôtre ignorance érige des Autels, Sous ces illuſtres noms de Dieux & d’immortels;	Vils mets, auxquels l'art polissant la nature, A donné l'ornement d'une belle figure, À qui notre ignorance érige des Autels, Sous ces illustres noms de Dieux et d'immortels;
Ie vay portér ailleurs tous mes deuots offices, N’eſperés plus de moy ny vœux, ny ſacrifices, Cet oracle diuin m’a fait voir mon erreur, Et vous ne m’eſtes plus que des ſujets d’horreur,	Je vais porter ailleurs tous mes dévots offices, N'espérez plus de moiblé vœux, ni sacrifices, Cet oracle divin m'a fait voir mon erreur, Et vous ne m'êtes plus que des sujets d'horreur,
SVSANNE Que vos ſecrets (mon Dieu) paroiſſentadmirables!	SUSANE Que vos secrets (mon Dieu) paraissentadmirables!
Et vous dont la bonté, qui n’a point de ſemblables, A tant de maux diuers voulut s’aſſuiettir, Meſme iuſqu’a la mort, pour nous en garentir;	Et vous dont la bonté, qui n'a point de semblables, A tant de maux divers voulut s'assuiettir, Même jusqu'a la mort, pour nous en garantir;
Dieu veritablement, puiſſant, ſage, adorable, Si vous daignés jetter les yeux ſur ce coupable, De qui le foible eſprit folement éperdu, Vous a ſouuent rauy l’honneur qui vous eſt dû;	Dieu véritablement, puissant, sage, adorable, Si vous daignez jeter les yeux sur ce coupable, De qui le faible esprit folement éperdu, Vous a souvent ravi l'honneur qui vous est dû;
N’y voyés point l’horreur de cette offence extréme, Qui le rend maintenant odieux à ſoy meſme;	N'y voyez point l'horreur de cette offense extrême, Qui le rend maintenant odieux à soi -même;
Que vos diuins regards ne découurent en luy, Que te vif repentir qu’il conçoit auiourd’huy;	Que vos divins regards ne découvrent en lui, Que te vif repentir qu'il conçoit aujourd'hui;
Et de ſes iours paſſés perdant la ſouuenance, Que ce moment vous lont celuy de la haiſſance.	Et de ses jours passés perdant la souvenance, Que ce moment vous lont celui de la haissance.
SVSANNE Mon eſprit eſt raui de voir ce changement.	SUSANE Mon esprit est ravi de voir ce changement.
CLAVDE Vous, de ſa volonté merueilleux inſtrument!	CLAUDE Vous, de sa volonté merveilleux instrument!
Afelnams pale a u guene ayeo mpemle clclere, Qu’à vôtre charité ie ſerue de matiere:	Afelnams pale a u guene aieo mpemle clclere, Qu'à votre charité Seigneur serve de matière:
Exercés là (de grace) à mon inſtrution, Comme il faut profeſſer vôtre Religion.	Exercès là (de grâce) à mon instrution, Comme il faut professer votre Religion.
SVSANNE Si ma capacité ſe trouuoit aſſés grande, En peu de temps l’effet ſuiuroit vôtre demande?	SUSANNE Si ma capacité se trouvait assez grande, En peu de temps l'effet suivrait votre demande?
Mes ſoins vous ſont acquis;	Mes soins vous sont acquis;
mais il faut qu’vn Docteur, Au chemin de la foy ſoit vôtre condućteur.	mais il faut qu'un Docteur, Au chemin de la foi soit votre conducteur.
Icy vôtre intereſt combat mon ignorance, L’vn ſemble m’engager, & l’autre me diſpenſe;	Ici votre intérêt combat mon ignorance, L'un semble m'engager, et l'autre me dispense;
Ie ſuis contrainte à fuir d’où je voy des appas, En vn mot, ie voudrois ce que ie ne puis pas.	Je suis contrainte à fuir d'où je vois des appas, En un mot, ie voudrois ce que Ne ne puis pas.
La raiſon m’interdit vne telle entrepriſe;	La raison m'interdit une telle entreprise;
Allés vous adreſſer au chef de nôtre Egliſe, Puis que pour lieutenant en terre Dieu l'élut, Il peut bien vous ouurir la porte du ſalut.	Allez -vous adresser au chef de notre Église, Puis que pour lieutenant en terre Dieu l'élut, Il peut bien vous ouvrir la porte du salut.
CLAVDE Ie m’en vay le chercher, en grande diligence.	CLAUDE -Je m'en vais le chercher, en grande diligence.
SVSANNE Ioignés à cette ardeur de la perſeuerance.	SUSANE Ioignez à cette ardeur de la persévérance.
SECOND ENTRETIEN.	SECOND ENTRETIEN.
DIOCLETIAN, MAXIMIAN.	DIOCLETIAN, MAXIMIAN.
DIOCLETIAN Quoy, mon fils!	DIOCLETIAN Quoi, mon fils!
Ce grand cœur, ſi craint, ſi ſignalé, reous paroicra touſous rampanit & raualé!	Ce grand cœur, si craint, si signalé, reous parcra tous rampanit et ravalé!
Quoy!	Quoi!
neus verrons touſiours deſſus vôtre viſage, D’vne viué douleur la plus naïue image?	nus verrons toujours dessus votre visage, D'une vivé douleur la plus naïve image?
MAXIMIAN Si mon viſage montre vne ſombre pâleur, Seigneur, c’eſt de la mort la plus viue couleur;	MAXIMIAN Si mon visage montre une sombre pâleur, Seigneur, c'est de la mort la plus vive couleur;
puls qu’ene na lotiilis, aiaut qu'ene me praue, Ie porte ſa liurée en qualité d’Eſclaue:	puls qu'ène na lotiilis, aiaut qu'ene me prave, Je porte sa livrée en qualité d'Esclave:
Elle agit en vainqueur, & i’agis en vaincu, Elle comme viuant, moy, comme ayant vécu.	Elle agit en vainqueur, et j'agis en vaincu, Elle comme vivant, moi, comme ayant vécu.
DIOCLETIAN I’obſerue en ce diſcours que d’vne ſeule atteinte, En vous le cœur s’abat, la raiſon eſt éteinte.	DIOCLETIAN J'observe en ce discours que d'une seule atteinte, En vous le cœur s'abat, la raison est éteinte.
Moy comme ayant vécu!	Moi comme ayant vécu!
vous parlés, vous mouués, Et i’infere de là qu’encore vous viués.	vous parlez, vous mouvez, Et j'infère de là qu'encore vous vivez.
MAXIMIAN Si le Cœur (comme on dit) eſt principe de vie.	MAXIMIAN Si le Cœur (comme on dit) est principe de vie.
gien qu’elle ne luy ſoit entierement rauie, Il perd vne moitié de ce qui l'animoit, Quand il perd l’vnion de l’objet qu’il aimoit:	gien qu'elle ne lui soit entièrement ravie, Il perd ait moitié de ce qui l'animait, Quand il perd l'Hion de l'objet qu'il aimait:
En ſuite la vie eſt tellement languiſſante, Qu'on peut auec raiſon la nommer mort viuante, Et de cette façon hardiment ie concitis;	En suite la vie est tellement languissante, Qu'on peut avec raison la nommer mort vivante, Et de cette façon hardiment ie concitis;
Que la mort eſt viuante, ou que ie ne vis plus.	Que la mort est vivante, ou que je ne vis plus.
DIOCLETIAN Ce qu’on nomme la mort, n’eſt que ceſſer de viure, Non pas vn ennemy qui nous puiſſe pourſuiure:	DIOCLETIAN Ce qu'on nomme la mort, n'est que cesser de vivre, Non pas un ennemi qui nous puisse poursuivre:
Nous ne conceuons rien quand nous diſons la mort, C’eſt donc rien qui vous braue & vous abat fi fort.	Nous ne concevons rien quand nous disons la mort, C'est donc rien qui vous brave et vous abat fi fort.
MAXIMIAN De ce rien (s’il eſt tel) mon ame poſſédée, Se propoſe vn grand monſtre, & s’en forme l’idée, Là, d’vn fixe regard, mon eſprit arreſté, Examine ſa rage & ſa deformité:	MAXIMIAN De ce rien (s'il est tel) mon âme possédée, Se propose un grand montre, et s'en forme l'idée, Là, d'une fixe regard, mon esprit arrêté, Examine sa rage et sa déformité:
Comme vn Cameléon, duquel ie ſuy l’exemple, Ie reçois la couleur de ce que ie contemple;	Comme un Cameléon, duquel Seigneur suivi l'exemple, Je reçois la couleur de ce que ici contemple;
Et ce que vous voyés qui parôit au de hors, Eſt vne impreſſion de l’eſprit ſur le corps.	Et ce que vous voyez qui parôit au de hors, Est une impression de l'esprit sur le corps.
DIOCLETIAN Ie conſens que la mort ſoit vn monſtre terrible, Non pas imaginé, mais réel & viſible, Qui porte dans les cœurs l’épouuante & l’effroy, Et ſoûmet les plus fiers aux rigueurs de ſa loy.	DIOCLETIAN Je consens que la mort soit un monstre terrible, Non pas imaginé, mais réveil et visible, Qui porte dans les cœurs l'épouvante et l'effroi, Et soumet les plus fiers aux rigueurs de sa loi.
Mais pourroit-il ſur vous, ce qu’il peut ſur vn autre?	Mais pourrait-il sur vous, ce qu'il peut sur un autre?
Quand ie dis dans les cœurs, i’en excepte le vôtre;	Quand notre dis dans les cœurs, j'en excepte le vôtre;
Car ie l’ay veu cent fois le foumettre a vos piéds, Il ſe trouuoit toûjours aux lieux où vous eſtiés:	Car ici l'ai vu cent fois le soumettre à vos piéds, Il se trouvait toujours aux lieux où vous étiez:
Vos mépris l’attiroient, ſa force meurtriere Suiuoit les mouuemens de vôtre main guerriere.	Vos mépris l'attiraient, sa force meurtrière Suivait les mouvements de votre main guerrière.
Plus par vn noble orgueil vous l’aués dédaigné.	Plus par un noble orgueil vous l'avez dédaigné.
Plus il a puiſſamment ſur les autres regné;	Plus il a puissamment sur les autres régné;
Et ſi vous l’euſſiés craint, ou qu’il eût pû vous nuire, Il n’auroit pas ſi loin étendu ſon Empire.	Et si vous l'eussiez craint, ou qu'il eût pu vous nuire, Il n'aurait pas si loin étendu son Empire.
Combien l’ont agrandi vos genereux proiets?	Combien l'ont agrandi vos généreux proiss?
De combien l’à peuplé vôtre bras de ſuiets?	De combien l'à peuplé votre bras de sujets?
Dont la gloire n’auoit jamais eſté ternie, Et qui ſans vous auroient braué ſa tirannie.	Dont la gloire n'avait jamais été ternie, Et qui sans vous auraient bravé sa tyrannie.
Vne ſeule rencontre, vne attaque, vn combat, D’vn incroyable nombre augmentoit ſon Etat.	Une seule rencontre, une attaque, un combat, D'âme incroyable nombre augmentait son État.
De combien plus au prix tant d’illuſtres batailles, Tant d’exploicts à défendre & forcer des murailles, Où l’on voyoit les corps, l’vn ſur l’autre entaſſés, Former vne éminence à l’endroit des foſſés.	De combien plus au prix tant d'illustres batailles, Tant d'exploits à défendre et forcer des murailles, Où l'on voyait les corps, l'Un sur l'autre entassés, Former une éminence à l'endroit des fossés.
Lors ce monſtre inhumain ennemy de la vie, S’il eût eſté poſſible eût ſa rage aſſouuie:	Lors ce montre inhumain ennemi de la vie, S'il eût été possible eût sa rage assouuie:
Vos merueilleux effets de generoſité, Auroient lors veu la fin de ſon auidité, Si les Dieux n’auoient fait ce monſtre épouuantable, Encore moins cruel, qu’il n’eſt inſatiable.	Vos merveilleux effets de générosité, Auraient lors vu la fin de son avidité, Si les Dieux n'avaient fait ce monstre épouvantable, Encore moins cruel, qu'il n'est insatiable.
Ce fut lors neantmoins qu’humble & reconoiſſant, Il céda la victoire à vôtre bras puiſſant, Il ne conteſta pas la gloire & l’auentage;	Ce fut lors néanmoins qu'humble et reconaissant, Il céda la victoire à votre bras puissant, Il ne contesta pas la gloire et l'aventage;
Rien qu’vn ſanglant butin n’entra dans ſon partage, Duquel ſe confeſſant redeuable à vos coups, Il mit tout ſon triomphe à dependre de vous;	Rien qu'un sanglant butin n'entra dans son partage, Duquel se confessant redevable à vos coups, Il mit tout son triomphe à dépendre de vous;
Et commé s’accuſant ſoy meſme d’impuiſſance, Parur bouffid’orgueil de cette dépendance.	Et commé s'accusant soi -même d'impuissance, Parur bouffid'orgueil de cette dépendance.
Par toutes ces raiſons ie ne puis conceuoir, Que ſur vous à préſent il ait tant de pouuoir.	Par toutes ces raisons personne ne puis concevoir, Que sur vous à présent il ait tant de pouvoir.
MAXIMIAN Seigneur, mes ſentimens, ſont conformes aux vôtres, Par moy (vous le ſçaués) il a triomphé d’autres,	MAXIMIAN Seigneur, mes sentiments, sont conformes aux vôtres, Par moi (vous le savez) il a triomphé d'autres,
Mais auſſi ne pouuant me ſurmonter de ſoy, A préſent par vne autre il triomphe de moy.	Mais aussi ne pouvant me surmonter de soi, A présent par fois il triomphe de moi.
Ie ne luy ſemblai pas de facile conqueſte, Il fut trop peu hardi pour m’attaquer en teſte, Craignant que contre moy ſes efforts ſerbient vains;	Je ne lui semblai pas de facile conquête, Il fut trop peu hardi pour m'attaquer en tête, Craignant que contre moi ses efforts serbient vains;
Et voyant que mon cœur n’eſtoit plus en mes mains, Qu’embraſé de l’ardeur d’vne pudique flame Il eſtoit poſſedé par vne chaſte femme, 22 Qui par le ſacré noeud d’vne ſainte amitié Compoſoit de mon tout la plus digne moitié;	Et voyant que mon cœur n'était plus en mes mains, Qu'embrasé de l'ardeur d'une pudique flamme Il était possédé par une chaste femme, 22 Qui par le sacré noeud d'une sainte amitié Composait de mon tout la plus digne moitié;
Il m’attaqua par là, ſans craindre ma défence, Et n’y rencontra pas beaucoup de réſiſtance;	Il m'attaqua par là, sans craindre ma défense, Et n'y rencontra pas beaucoup de résistance;
Car ce charmant objet contre ſa cruauté, Pour ſeule force auoit celle de la beauté.	Car ce charmant objet contre sa cruauté, Pour seule force avait celle de la beauté.
Mais cet horrible monſtre eſt aueugle à ſes charmes, C’eſt dans le plus beau ſang qu’il veut tremper ſes armes:	Mais cet horrible montre est aveugle à ses charmes, C'est dans le plus beau sang qu'il veut tremper ses armes:
Ainſi ſa rage en veint en peu de temps ábout, Et par cette partie il ſurmonta le tout.	Ainsi sa rage en veint en peu de temps Ubout, Et par cette partie il surmonta le tout.
Comme la lâcheté n’eſt point ſans artifice, Il pratiqua l’amour pour eſtre ſon complice, Et l’amour qui logea cet objet dans mon cœur, Luy donna le moyen de s’en rendre vainqueur.	Comme la lâcheté n'est point sans artifice, Il pratiqua l'amour pour être son complice, Et l'amour qui logea cet objet dans mon cœur, Lui donna le moyen de s'en rendre vainqueur.
De cette chere femme il occupe la place, Y regne en conquerant, quelque effort que ie face, Et me fait voir combien vn lâche eſt animé, Des mepris du cienois, quanler n'ent femelmes Ce qui me fait trouuer ſon procedé plus rude, Seigneur, c’eſt de penſer à ſon ingratitude, Qu’il me traitte en Eſclaue apres m’auoir ſuiuy, Qu’il me doiue beaucoup, & qu’il m’ait tout rauy.	De cette chère femme il occupe la place, Y règne en conquérant, quelque effort que sans face, Et me fait voir combien un lâche est animé, Des mépris du cienois, quanler n'ent femmes Ce qui me fait trouver son procédé plus rude, Seigneur, c'est de penser à son ingratitude, Qu'il me traite en Esclave après m'avoir suivi, Qu'il me doive beaucoup, et qu'il m’ait tout ravi.
DIOCLETIAN	DIOCLETIAN
Ce monſtre, ou cette mort, que vôtre diſcours blâme, Me priua de ma fille, en prenant vôtre femme, Et ie puis aſſeurer qu’en ce commun mal-heur, Nos cœurs furent atteints d’vne égale douleur.	Ce montre, ou cette mort, que votre discours blâme, Me priva de ma fille, en prenant votre femme, Et ie puis assurer qu'en ce commun malheur, Nos cœurs furent atteints d'une égale douleur.
I’auois crû que les Dieux nous feroient cette grace, Que l’on verroit par vous reuiure nôtre race, Et qu’ils vous donneroient vn digne ſucceſſeur, Pour eſtre de l’Empire apres vous poſſeſſeur.	J'avais cru que les Dieux nous feraient cette grâce, Que l'on verrait par vous revivre notre race, Et qu'ils vous donneraient un digne successeur, Pour être de l'Empire après vous possesseur.
Puis que leur volonté (comme on a veu) fut autre, Nous deuons prudemment y conformer la nôtre, Et ne murmurer pas contre ce qu’ils ont fait;	Puis que leur volonté (comme on a vu) fut autre, Nous devons prudemment y conformer la nôtre, Et ne murmurer pas contre ce qu'ils ont fait;
L’on offenſe la cauſe, en blâmant ſon effet.	L'on offense la cause, en blâmant son effet.
Leurs ſecrets ne ſont pas de nôtre intelligence, do demidident de fodo Paueugie ebellanee.	Leurs secrets ne sont pas de notre intelligence, do demident de fodo Paveugie ebellanee.
Ce monſtre, ou cette mort, qui cauſe ce diſcours, Eſt le point où les Dieux ont limité ſes iours.	Ce montre, ou cette mort, qui cause ce discours, Est le point où les Dieux ont limité ses jours.
MAXIMIAN Souffrés pluſtoſt (Seigneur) que dans cette auenture, En reſpectant les Dieux ie blâme la nature;	MAXIMIAN Souffrés plutôt (Seigneur) que dans cette aventure, En respectant les Dieux grande blâme la nature;
Et diſons des premiers, par vn commun accord, Qu’ils ſont autheurs de l’eſtre & non point de la mort.	Et disons des premiers, par un commun accord, Qu'ils sont auteurs de l'être et non point de la mort.
Chacun ſçait bien qu’ils ont l’intendance du monde, Mais ils laiſſent agir vne cauſe ſeconde:	Chacun sais bien qu'ils ont l'intendance du monde, Mais ils laissent agir une cause seconde:
Ces fâcheus accidents qui frapent les humains, Ne partent pas toûjours de leurs puiſſantes mains:	Ces fâcheus accidents qui frappent les humains, Ne partent pas toujours de leurs puissantes mains:
La nature à ſon cours franc, libre, ſans contrainte, Et c’eſt d’elle que vient le ſuiet de ma plainte, Qui nous eſt vn teſmoin de ſon aueuglement, Parce qu’elle a détruit ſon plus riche ornement.	La nature à son cours franc, libre, sans contrainte, Et c'est d'elle que vient le sujet de ma plainte, Qui nous est un témoin de son aveuglement, Parce qu'elle a détruit son plus riche ornement.
DIOCLETIAN Vôtre eſprit, dont le deüil offuſqua la lumiere, S’illumine, & reprend ſa vigueur coûtumiere:	DIOCLETIAN Votre esprit, dont le deuil offusqua la lumière, S'illumine, et reprend sa vigueur coutumière:
vôtre ſentiment eſt raiſonnable & pieux, Oüy, blâmés la nature, & reſpectés les Dieux:	votre sentiment est raisonnable et pieux, Oui, blâmés la nature, et respectés les Dieux:
Ce n’eſt pas ſans raiſon que vous vous plaignés d’elle, Vôtre femme a fini par la mort naturelle, Et tous vos mouuemens ont depuis eſté tels Qu’on pouuoit les nommer purement naturels.	Ce n'est pas sans raison que vous vous plaignès d'elle, Votre femme a fini par la morts naturelle, Et tous vos mouvements ont depuis été tels Qu'on pouvait les nommer purement naturels.
le ſçay que ce qui rompt les noeuds du mariage.	le sais que ce qui rompt les noeuds du mariage.
Fait de puiſſans efforts ſur vn cœur qu’il partage:	Fait de puissants efforts sur un cœur qu'il partage:
Qu’on ne peut retenir ce premier mouuement, Qui nous porte tous vifs dedans vn monument:	Qu'on ne peut retenir ce premier mouvement, Qui nous porte tous vifs dedans un monument:
Mais quand ces paſſions paroiſſent ſans meſure, C’eſt que la faiſon eſt ſoumiſe à la nature;	Mais quand ces passions paraissent sans mesure, C'est que la saison est soumise à la nature;
Le mal qu’elles nous font reçoit ſa gueriſon, Lors que la nature eſt ſoûmiſe à la raiſon.	Le mal qu'elles nous font reçoit sa guérison, Lors que la nature est soumise à la raison.
La premiere eut en vous trop long-temps l’auentage, Lautre s’yretabſſt, reprenes en l’vſage, Et formant vn deſſein vtile & genereux, Montrés que vous ſçaués ſatisfaire les deux.	La première eut en vous trop longtemps l'aventage, Lautre s'yretabs, reprenez en l'usage, Et formant un dessein vintile et généreux, Montrés que vous savez satisfaire les deux.
MAXIMIAN Mon ame eſt de guerir par la raiſon preſſée;	MAXIMIAN Mon âme est de guérir par la raison pressée;
Mais ſans ceſſe la mort occupe ma penſée, Et pour luy reſiſter ie me ſens impuiſſant.	Mais sans cesse la mort occupe ma pensée, Et pour M resister ici me sens impuissant.
DIOCLETIAN Imités ſon exemple en vn poinct ſi preſſant:	DIOCLETIAN Imités son exemple en un point si pressant:
Il faut tout pratiquer quand le mal eſt extréme, Vous pouués vous ſeruir d’elle contr’elle meſme:	Il faut tout pratiquer quand le mal est extrême, Vous pouvez -vous servir d'elle contr'elle même:
E prouuéz ſa maxime, & n’eſtant aſſés fort, Recourés à l’amour pour ſurmonter la mort.	E prouuéz sa maxime, et n'étant assez fort, Recourez à l'amour pour surmonter la mort.
Ie médite vn moyen de vous rendre propice Ce Dieu, qui contre vous fut iadis ſon complice.	Je médite un moyen de vous rendre propice Ce Dieu, qui contre vous fut jadis son complice.
MAXIMIAN Cet adorable objet, où l’eſprit & les yeux, Rencontroient les appas les plus délicieux, Vôtre fille (Seigneur) me l’auoit fait connoiſtre.	MAXIMIAN Cet adorable objet, où l'esprit et les yeux, Rencontraient les appas les plus délicieux, Votre fille (Seigneur ) me l'avait fait connaître.
Mais le croy qu’auec enle ii auia cene d’eitre.	Mais le crois qu'avec enle ji a cène d'éitre.
DIOCLETIAN Non ( mon fils) l’amour eſt du rang des immortels Et toutes les beautés luy ſont autant d’Autels, Vôtre femme en fut vn, où (Si ie l’oſe dire) Il exerça longtemps les droits de ſon Empire:	DIOCLETIAN Non ( mon fils) l'amour est du rang des immortels Et toutes les beautés nous sont autant d'Autels, Votre femme en fut un, où (Si après l'ose dire) Il exerça longtemps les droits de son Empire:
Suſanne luy ſuccede, & poſſede auiourd’huy, Les plus grandes faueurs qu’on reçoiue de luy.	Susannefois succède, et possède aujourd'hui, Les plus grandes faveurs qu'on reçoive de Seigneur.
Ce Dieu peut à la mort faire quiter la place;	Ce Dieu peut à la mort faire quitter la place;
Si par vne il l’y mit, que par l’autre il l’en chaſſe:	Si par une il l'y mit, que par l'autre il l'en chasse:
Portés vers cet object vos amoureux transports, S’il entre en vôtre cœur, la mort en eſt dehors.	Portez vers cet object vos amoureux transports, S'il entre en votre cœur, la mort en est dehors.
MAXIMIAN Il eſt iuſte (Seigneur) que ie vous obéiſſe, le ne repugne pas a ce doux artifice, Et mon cœur, dont la mort s’éloigne en ce moment Va préparer la place à cet objet charmant.	MAXIMIAN Il est juste (Seigneur) que je vous obisse, le ne répugne pas à ce doux artifice, Et mon cœur, dont la mort s'éloigne en ce moment Va préparer la place à cet objet charmant.
DIOCLETIAN Suiués les mouuemens où l’amour vous engage, Et me laiſſes le ſoin de vôtre mariage.	DIOCLETIAN Suivez les mouvements où l'amour vous engage, Et me laisses le soin de votre mariage.
SECONDE PARTIE.	SECONDE PARTIE.
PREMIER ENTRETIEN.	PREMIER ENTRETIEN.
SERENE, VIRGINIE.	SERENE, VIRGINIE.
VIRGINIE.	VIRGINIE.
Adame, mon eſprit n’eſt point ſi peu diſcret, M Qu’il veüille pénétrer iuſqu’a vôtre ſecret;	Adame, mon esprit n'est point si peu discret, M Qu'il veuille pénétrer jusqu'a votre secret;
Mais voyant que parmi l’allegreſſe publique, Vous ſeule paroiſſés ſombre & melancolique, Il croiroit faire tort à ſa fidelité, S’il pouuoit vous celer qu’il eſt inquieté.	Mais voyant que parmi l'allégresse publique, Vous seule paraissez sombre et mélancolique, Il croirait faire tort à sa fidélité, S'il pouvait vous celer qu'il est inquiété.
I’en cherche le ſuiet ſans le pouuoir conoître, Votre bon-heur eſt grand, ou du moins ſemble l’eſtre, Vôtre grandeur ne peut à plus haut poinct monter, Vous n’auez rien à craindre, & rien à ſouhaitter.	J'en cherche le sujet sans le pouvoir conoître, Votre bonheur est grand, ou du moins semble l'être, Votre grandeur ne peut à plus haut poinct monter, Vous n'avez rien à craindre, et rien à souhaiter.
SERENE.	SERENE.
Ha!	Ha!
que tu fais bien voir que dans vne ame baſſe, L’aueugle ambition a la premiere place, Et que vous renfermés nôtre felicité En ces mots de grandeur, d’honneur, d’authorité.	que tu fais bien voir que dans une âme basse, L'aveugle ambition a la première place, Et que vous renfermez notre félicité En ces mots de grandeur, d'honneur, d'autorité.
Tu ſuis ton ſentiment, & crois que ie n’aſpire, Qu’à ce bien apparent d’auoir part à l’Empire, Que ſon Trône eſt le poinct où ie dois m’arreſter;	Tu suis ton sentiment, et crois que je n'aspire, Qu'à ce bien apparent d'avoir part à l'Empire, Que son Trône est le point où tu dois m'arrêter;
Peut-eſtre ce ſeroit dequoy te contenter:	Peut-être ce serait dequoy te contenter:
Cherches-tu le vray bien ſur lequel ie me fonde?	Cherches-tu le vrai bien sur lequel Rome me fonde?
Apprens que la vertu vaut plus que tout le monde.	Apprends que la vertu vaut plus que tout le monde.
Comme on ne peut regler ſa valeur & ſon prix, Elle ſeule eſt l’obiet des genereux eſprits, Ils la pourſuiuent tous par vn deſir auide, Tout autre bien pour eux, n’eſt point vn bien ſolide;	Comme on ne peut régler sa valeur et son prix, Elle seule est l'objet des généreux esprits, Ils la poursuivent tous par un désir aujde, Tout autre bien pour eux, n'est point un bien solide;
Et ſi le mien te ſemble à préſent abatu, Crois (ma fille) que c’eſt qu’il manque de vertu:	Et si le mien te semble à présent abattu, Crois (ma fille) que c'est qu'il manque de vertu:
VIRGINIE.	VIRGINIE.
Madame, on reconoît la vôtre ſans égale, Vous feriés des leçons de toute la Morale;	Madame, on reconoît la vôtre sans égale, Vous feriez des leçons de toute la Morale;
Celles qui prenent ſoin' de s’en mieux acquiter, Voudroient pour tout ſouhait vous pouuoir imiter?	Celles qui prennent soin de s'en mieux acquitter, Voudraient pour tout souhait vous pouvoir imiter?
Ainſi ie ne croys pas qu’aucun ſuiet vous reſte, Capable de cauſer ce chagrin manifeſte.	Ainsi ici ne crois pas qu'aucun sujet vous reste, Capable de causer ce chagrin manifeste.
SERENE.	SERENE.
La Morale eſt vtile, elle polit les mœurs, Retient les mouuemens des mauuaiſes humeürs;	La Morale est utile, elle polit les mœurs, Retient les mouvements des mauvaises humers;
Regle nôtre conduite, & par ſon aſſiſtance, Toutes nos actions ſe font auec prudence;	Règle notre conduite, et par son assistance, Toutes nos actions se font toujours prudence;
Mais c’eſt prudence humaine, & qui ne s’étend pas Où l’eſprit peut trouuer de ſolides appas:	Mais c'est prudence humaine, et qui ne s'étend pas Où l'esprit peut trouver de solides appas:
Il retient ſa viguenr, s’aſſoupit, ſe rauale, S’il n’aſpire plus haut qu’à la vertu Morale;	Il retient sa viguenr, s'assoupit, se ravale, S'il n'aspire plus haut qu'à la vertu Morale;
Et ſi le mien te ſemble à préſent abatu, Crois (ma fille) qu’il n’a qu’vne fauſſe vertu.	Et si le mien te semble à présent abattu, Crois (ma fille) qu'il n'a qu'une fausse vertu.
VIRGINIE.	VIRGINIE.
Si mon profond reſpect permet que ie replique, A la Morale;	Si mon profond respect permet que je réplique, À la Morale;
Enfin, ie ioins la Politique, L’on void agir les deux d’égale force en vous,	Enfin, Seigneur joins la Politique, L'on voit agir les deux d'égale force en vous,
SERENE.	SERENE.
I'entends venir quelqu’vn, tais-toy, retirons-nous Peut-eſtre vne autre fois te feray-ie comprendre Quelles ſont les vertus où nôtre eſprit doit tendre.	J'entends venir quelqu'autre, tais-toi, retirons-nous Peut-être autre fois te ferai-je comprendre Quelles sont les vertus où notre esprit doit tendre.
SECOND ENTRETIEN.	SECOND ENTRETIEN.
DIOOLE PIAN, MAMIMIE, ANTISE,	DIOLE PIAN, MAMIMIE, ANTISE,
DIOCLETIAN.	DIOCLETIAN.
Que dificilement l’eſprit peut conceuoir Les ſoins que nos grandeurs nous obligent d’auoir!	Que dificilement l'esprit peut concevoir Les soins que nos grandeurs nous obligent d'avoir!
Le Trône impérial en éleuant nos teſtes, Les approche des lieux où ſe font les tempeſtes, Et le plus fortuné que l’on y voye aſſis, Aux Pauots du repos ioint toûjours des ſoucis.	Le Trône impérial en élevant nos têtes, Les approche des lieux où se font les tempêtes, Et le plus fortuné que l'on y voie assis, Aux Pauots du repos joint toujours des soucis.
MAXIME.	MAXIME.
Vos ſemblables, Seigneur, dans l’Etat où nous ſommes, Sont bien moins que les Dieux, mais bien plus que les hommes :	Vos semblables, Seigneur, dans l'État où nous sommes, Sont bien moins que les Dieux, mais bien plus que les hommes :
S'éleuent à ceux-là, par vn culte éternel, S’abaiſſent à ceux-cy, par vn ſoin paternel;	S'éleuent à ceux-là, par un culte éternel, S'abaissent à ceux-cy, par un soin paternel;
Et comme le milieu d’entre ces deux extrémes, Les hommes vont par eux aux Déités ſuprémes?	Et comme le milieu d'entre ces deux extrêmes, Les hommes vont par eux aux Déités suprêmes?
Comſmé par eux auſif, ſes meſmes Deires, Départent aux mortels leurs liberalités.	Comsmé par eux ausif, ses mêmes Dires, Départent aux mortels leurs libéralités.
Ainſi, l’on peut iuger quels emplois ſont les voſtres, Chargés des intereſts & des vns & des autres.	Ainsi, l'on peut juger quels emplois sont les vôtres, Chargés des intérêts et des et des autres.
ARTISE.	ARTISE.
Ce ſacré Caractere, auquel les Dieux ont mis Le pouuoir de tenir tous les peuples ſoûmis;	Ce sacré Caractère, auquel les Dieux ont mis Le pouvoir de tenir tous les peuples soumis;
Ce qui dans nos eſprits ſecrettement imprime, Le reſpect que l’on doit au Seigneur legitime;	Ce qui dans nos esprits secrètement imprime, Le respect que l'on doit au Seigneur légitime;
Cette puiſſance, enfin, où cette authorité, Qui triomphe aiſément de noſtre liberté, Eſt vn preſent des Dieux, qui dans ſon exercice, Doit pour premier objet regarder leur ſeruice.	Cette puissance, enfin, où cette autorité, Qui triomphe aisément de notre liberté, Est un présent des Dieux, qui dans son exercice, Doit pour premier objet regarder leur service.
Mais ſi mon ſentiment vous ſemble vn peu hardi, Veüillés me pardonner, Seigneur, ſi ie le di.	Mais si mon sentiment vous semble un peu hardi, Veüillés me pardonner, Seigneur, si toujours le di.
Voyons où ce pouuoir peut iuſtement s’étendre;	Voyons où ce pouvoir peut justement s'étendre;
Ce que vous tenés d’eux, vous deués le leur rendre:	Ce que vous tenezez d'eux, vous devez le leur rendre:
peuuent-ils vous admettre au rang de leurs amis, Si vous laiſſés errer ceux qu’ils vous ont comis.	peuvent-ils vous admettre au rang de leurs amis, Si vous laissez errer ceux qu'ils vous ont comis.
Vous ne leur eſtes pas de vous ſeul reſponſable, Par le crime d’autruy vous vous rendés coupable, Car vous n’ignorés pas, Seigneur, que c’eſt pecher, Si l’on ſouffre le mal, le pouuant empeſcher;	Vous ne leur êtes pas de vous seul responsable, Par le crime d'autrui vous vous rendez coupable, Car vous n'ignorez pas, Seigneur, que c'est pécher, Si l'on souffre le mal, le pouvant empêcher;
Ce pouuoir abſolu leur haine vous attire, S iis ne font reueres par tous eeux de l’Empire;	Ce pouuoir absolu leur haine vous attire, S is ne font révères par tous ceux de l'Empire;
C’eſt leur intention, & c’eſt voſtre intereſt, D’en faire exactement executer l’arreſt,	C'est leur intention, et c'est votre intérêt, D'en faire exactement exécuter l'arrêt,
DIOCLETIAN Quoy!	DIOCLETIAN Quoi!
les Dieux peuuent-ils nous imputer le blâme D’vn mal qu’on ne peut voir, ſans penetrer dans l’ame Tout ce qui leur déplaiſt ne ſe peut-il celer?	les Dieux peuvent-ils nous imputer le blâme D'un mal qu'on ne peut voir, sans pénétrer dans l'âme Tout ce qui leur déplaît ne se peut-il celer?
MATME Il ſe peut;	MATME Il se peut;
mais, Seigneur, nous entendons parler, De ce crime public de la Secte Chreſtienne, Dont.	mais, Seigneur, nous entendons parler, De ce crime public de la Secte Chrétienne, Dont.
DIOCLETIAN Il n’eſt pas beſoin que l’on m’en entretienne Ce ſeul nom de Chreſtien m’eſt vn ſuiet d’horreur;	DIOCLETIAN Il n'est pas besoin que l'on m'en entretienne Ce seul nom de Chrétien m'est un sujet d'horreur;
Mon zele, à leur égard ſe transforme en fureur, Et quelque cruauté que contr’eux i’exagere, Ie ſens inçeſſamment accroiſtre ma colere.	Mon zèle, à leur égard se transforme en fureur, Et quelque cruauté que contr'eux j'exage, Je sens inçessamment accroître ma colère.
Mais comme nous voyons la plus cruelle mort, Sur leurs cœurs obſtinés ne faire aucun effort, l'ay crû par la douceur auancer dauantage, Et nous les acquerir par l’heureux mariage De mon Gendre à Suſanne, & Claude en eſt l’agent.	Mais comme nous voyons la plus cruelle mort, Sur leurs cœurs obstinés ne faire aucun effort, l'ai cru par la douceur avancer davantage, Et nous les acquérir par l'heureux mariage De mon Gendre à Sanne, et Claude en est l'agent.
ARTISE Tres-capable, Seigneur,	ARTISE Très-capable, Seigneur,
DIOCLETIAN Oüy, mais peu diligent.	DIOCLETIAN Oui, mais peu diligent.
Allés le voir Maxime, & faites que i’apprenne, En quel ſentiment eſt cette belle Chreſtienne;	Allez le voir Maxime, et faites que j'apprenne, En quel sentiment est cette belle Chrétienne;
MAXIME Peu de temps me r’améne à voſtre Majeſté.	MAXIME Peu de temps me ramène à votre Majesté.
SOLILOQVE de	SOLILOQUE de
SVSANNE Illuſtres dignités, grandeurs, mondaine pompe, De qui le faux éclat en nous charmant nous trompe;	SUSANE Illustres dignités, grandeurs, mondaine pompe, De qui le faux éclat en nous charmant nous trompe;
Delices, voluptés;	Délices, voluptés;
abondance, plaiſirs, Appas, qui nous perdés, en gaignant nos deſirs, Funeſtes rejettons d’vne fatale ſouche, Vos fruicts paroiſſent beaux;	abondance, plaisirs, Appas, qui nous perdez, en gagnant nos désirs, Funestes rejettons d'une fatale souche, Vos fruits paraissent beaux;
mais n’ont rien qui me touche.	mais n'ont rien qui me touche.
le ſçay que vous n’aués qu’vn luſtre faſtueux, Qui ne peut ébloüir les yeux des vertueux:	le sais que vous n'avez qu'un lustre fastueux, Qui ne peut ébloüir les yeux des vertueux:
Que voſtre auantage eſt dans la ſeule apparence, Et que vous ſuccombés, en trouuant réſiſtance.	Que votre avantage est dans la seule apparence, Et que vous succombez, en trouvant résistance.
Neantmoins, ſi mon cœur n’eſt par vous abatu, le ne l’impute point à ma propre vertu:	Néanmoins, si mon cœur n'est par vous abattu, le ne l'impute point à ma propre vertu:
Mépriſant voſtre force, hautement ie confeſſe, Que pour luy reſiſter i’aurois trop de foibleſſe;	Méprisant votre force, hautement ici confesse, Que pour M resister j'aurais trop de faiblesse;
Qu'à vos moindres efforts ie ſerois ſans vigueur, Et que chacun de vous ſe rendroit mon vainqueur.	Qu'à vos moindres efforts Seigneur serais sans vigueur, Et que chacun de vous se rendrait mon vainqueur.
Mais ie me fortifie en cette conoiſſance;	Mais ie me fortifie en cette conaissance;
Plus ie voy mon deffaut, moins i’ay de confiance:	Plus Seigneur vois mon défaut, moins j'ai de confiance:
Et ma timidité fait que dans le danger, I’implore auec ardeur vn ſecours étranger.	Et ma timidité fait que dans le danger, J'implore avec ardeur un secours étranger.
Mais ſecours ſi puiſſant, que ſi toute la terre, Se ioignoit à l’enfer pour me faire la guerre, Quelque ſi viue ardeur qui les pût échaufer, Parluy, l’on me verroit & vaincre, & triompher.	Mais secours si puissant, que si toute la terre, Se joignait à l'enfer pour me faire la guerre, Quelque si vive ardeur qui les pût échauffer, Parlui, l'on me verrait et vaincre, et triompher.
Adorable ſecours d’vne force infinie, Dont le chef glorieux regne ſans tirannie.	Adorable secours d'une force infinie, Dont le chef glorieux règne sans tyrannie.
Qu’il eſt doux de ſeruir ce puiſſant protecteur!	Qu'il est doux de servir ce puissant protecteur!
Il nous promet beaucoup, ſans paroiſtre menteur;	Il nous promet beaucoup, sans paraître menteur;
Et pour combler les ſiens d’vne gloire ſupréme, Sa charité l’oblige à ſe donner ſoy-meſme.	Et pour combler les siens d'une gloire suprême, Sa charité l'oblige à se donner soi-même.
Tout ce que l’Vniuers poſſede de plus beau, Eſt moins qu’vne étincelle au prix de ce flambeau;	Tout ce que l'Univers possède de plus beau, Est moins qu'une étincelle au prix de ce flambeau;
Flambeau, dont la lumiere en éclairant vne ame, L’embraſe de l’ardeur d’vne diuine flame, Et luy faiſant trouuer ce ſéjour odieux, L’illumine âu chemin qui nous conduit aux Cieux.	Flambeau, dont la lumière en éclairant une âme, L'embrase de l'ardeur d'une divine flamme, Et tu faisant trouver ce séjour odieux, L'illumine âv chemin qui nous conduit aux Cieux.
C’eſt là, que la douceur ſe goûte ſans meſlange, Que la félicité n’eſt point ſujette au change, Et qu’on a des plaiſirs, dont la ſolidité, Ne ſçauroit prendre fin, qu’auec l’Eternité.	C'est là, que la douceur se goûte sans mélange, Que la félicité n'est point sujet au change, Et qu'on a des plaisirs, dont la solidité, Ne saurait prendre fin, qu'avec l'Éternité.
C’eſt là, charmant objet, que i’ay ferme eſperance, De poſſeder bien-toſt voſtre auguſte preſence;	C'est là, charmant objet, que j'ai ferme espérance, De posséder bientôt votre auguste présence;
Et parmi les beautez de ce diuin ſéjour, Eſtre vnie auec vous, par vn lien d’amour.	Et parmi les beautés de ce divin séjour, Être unie avec vous, par un lien d'amour.
Ie ſçay bien mes pechés, qui me rendent indigne, De receuoir de vous cette faueur inſigne;	Je sais bien mes péchés, qui me rendent indigne, De recevoir de vous cette faveur insigne;
Mais ie n’ignore pas que le plus criminel, Peut rencontrer en vous vn amour paternel, Et que ſollicitant voſtre miſericorde, Pour obtenir pardon, ſoudain elle l’accorde.	Mais était n'ignore pas que le plus criminel, Peut rencontrer en vous un amour paternel, Et que sollicitant votre miséricorde, Pour obtenir pardon, soudain elle l'accorde.
C’eſt pour cela, mon Dieu, que ie ſuis deuant vous;	C'est pour cela, mon Dieu, que je suis devant vous;
Mais, ne me voyez point, ſi ce n’eſt d’vn œil doux:	Mais, ne me voyez point, si ce n'est d'un œil doux:
Voilés en ce moment ces lumieres ſublimes.	Voilés en ce moment ces lumières sublimes.
Qui vous font tout preſent, pour ne voir pas mes crimes:	Qui vous font tout présent, pour ne voir pas mes crimes:
Banniſſez-les, mon Tout, de voſtre ſouuenir, Et que mon repentir ſerue pour m’en punir.	Bannissez-les, mon Tout, de votre souvenir, Et que mon repentir serve pour m'en punir.
Rendez-le plus ſenſible, afin de ſatisfaire Plus conuenablement voſtre iuſte colere:	Rendez-le plus sensible, afin de satisfaire Plus convenablement vôtre juste colère:
Et qu’ainſi mon eſprit contrit & pénitent, rame preil-toit loun du pon-ſeu qu'i pretend.	Et qu'ainsi mon esprit contrit et pénitent, rame préil-toit loun du pon-seu qu'y prétend.
TROISIESME ENTRETIEN.	TROISIÈME ENTRETIEN.
MAXIMIAN, CVRCE,	MAXIMIAN, CURÉE,
MAXIMIAN.	MAXIMIAN.
lete l’auoüe, enfin, il eſt vray que mon ame, Dés long-temps ſent l’ardeur d’vne pudique flame;	lete l'auoüe, enfin, il est vrai que mon âme, Dès longtemps sent l'ardeur d'une pudique flamme;
Et ce feu violent, conſommant ma couleur, Faiſoit voir ſur mon front vne ſombre pâleur.	Et ce feu violent, consommant ma couleur, Faisait voir sur mon front assez sombre pâleur.
Tu ſçais bien quelle loy le deuoir nous impoſe;	Tu sais bien quelle loi le devoir nous impose;
Cét effet paroiſſant, i’en déguiſois la cauſe;	Cet effet paraissant, j'en déguisais la cause;
Et l’on m’a veu ſouuent, par vn adroit effort, Ce que faiſoit l’amour, l’imputer à la mort.	Et l'on m'a vu souvent, par un adroit effort, Ce que faisait l'amour, l'imputer à la mort.
Ainſi, ie ſoûpirois & ſans crainte & ſans blâme:	Ainsi, Seigneur soupirais et sans crainte et sans blâme:
Pour pretexte, i’auois la perte de ma femme,	Pour prétexte, j'avais la perte de ma femme,
B iij Et ce que ie feignois pouſſer vers ſon tombeau, Suiuoit les doux attraits d’vn objet tout nouueau.	 iij Est ce que ici feignais pousser vers son tombeau, Suivait les doux attraits d'un objet tout nouveau.
D’abord ma douleur fit reſiſtance à ſes charmes, Au feu de ſes beaux yeux elle oppoſa mes larmes, Et leur humidité qui ne pût l’empeſcher De penetrer au cœur, s’en ſentit déſeicher.	D'abord ma douleur fit résistance à ses charmes, Au feu de ses beaux yeux elle opposa mes larmes, Et leur humidité qui ne put l'empêcher De pénétrer au cœur, s'en sentit déseicher.
De mon premier objet le ſouuenir funeſte, Combat en ſa faueur, & fait vn coup de reſte;	De mon premier objet le souvenir funeste, Combat en sa faveur, et fait un coup de reste;
Mais enfin, ſes efforts ſont vains & ſuperflus, Le dernier eſt puiſſant, le premier ne l’eſt plus:	Mais enfin, ses efforts sont vains et superflus, Le dernier est puissant, le premier ne l'est plus:
Car cette paſſion, qui ne peut eſtre oiſiue, Dii ibirceciuite veut virobiet qui viue.	Car cette passion, qui ne peut être oisive, Di ibircecite veut virobjet qui vive.
Acquité du deuoir d’vn vif reſſentiment, L’office de mary, paſſe en celuy d’amant.	Acquité du devoir d'un vif ressentiment, L'office de mari, passe en celui d'amant.
CVRCE Cét heureux changement me comble d’allegreſſe, Rien n’affligea mon cœur, comme voſtre triſteſſe;	CURÉE Cet heureux changement me comble d'allégresse, Rien n'affligea mon cœur, comme votre tristesse;
Mais s’il faut en amour ſuiure l’égalité, Seigneur, qui peut répondre à voſtre qualité?	Mais s'il faut en amour suivre l'égalité, Seigneur, qui peut répondre à votre qualité?
MAXIMIAN Ce ſont des ſentimens que l’ignorance excite:	MAXIMIAN Ce sont des sentiments que l'ignorance excite:
Le veritable amour regarde le merite;	Le véritable amour regarde le mérite;
Il admet pour objets, les graces, les appas, Et comment les aimer, où l’on ne les void pas?	Il admet pour objets, les grâces, les appas, Et comment les aimer, où l'on ne les voit pas?
Ces belles qualitez, que la Nature donne, Sont des droits de naiſſance, acquis à la perſonne.	Ces belles qualités, que la Nature donne, Sont des droits de naissance, acquis à la personne.
Son bien eſtant ſans prix, ne peut eſtre acheté, Et quand elle en départ, c’eſt par gratuïté.	Son bien étant sans prix, ne peut être acheté, Et quand elle en départ, c'est par gratuïté.
Mais au diuin ſuiet pour lequel ie ſoûpire, Tout ſemble concourir à faire qu’on l’admire.	Mais au divin sujet pour lequel mot soupire, Tout semble concourir à faire qu'on l'admire.
Ses parents, apres nous, tiennent le premier rang, Et Rome n’en a point d’vn plus illuſtre ſang.	Ses parents, après nous, tiennent le premier rang, Et Rome n'en a point d'un plus illustre sang.
En elle, la Nature a mis ſon induſtrie, Pour rendre les humains ſuſpects d’idolâtrie;	En elle, la Nature a mis son industrie, Pour rendre les humains suspects d'idolâtrie;
Dautant que ſi l’eſprit croid le rapport des yeux, Rien n’eſt plus adorable, en la troupe des Dieux.	Dautant que si l'esprit croid le rapport des yeux, Rien n'est plus adorable, en la troupe des Dieux.
Quoy que d’eux on ſe forme vne excellente idée, Cétéclat s’obſcurcit, quand on l’a regardée:	Quoi que d'eux on se forme une excellente idée, Cétéclat s'obscurcit, quand on l'a regardée:
L’imagination en ſes puiſſans efforts, Ne peut ſe figurer vn plus merueilleux corps.	L'imagination en ses puissants efforts, Ne peut se figurer un plus merveilleux corps.
Ce prince de nos ſens, qui iuge & qui diſcerne, Par qui la volonté ſe regle & ſe gouuerne, Conclut, dans la vigueur de ſon raiſonnement Qu’il ne ſe peut iamais rien voir de plus charmant.	Ce prince de nos sens, qui juge et qui discerne, Par qui la volonté se règle et se gouverne, Conclut, dans la vigueur de son raisonnement Qu'il ne se peut jamais rien voir de plus charmant.
La memoire, en offrant ſa plus parfaite image, Ne repreſente rien qui ne luy doiue homage.	La mémoire, en offrant sa plus parfaite image, Ne représente rien qui ne lui doive hommage.
La Puiſſance, laquelle a le droit de choiſir, Où ſe forme toûjours la fuite, ou le deſir, Par vne violence auſſi douce que forte, Quite tout autre objet, vers celuy-cy s’emporté;	La Puissance, laquelle a le droit de choisir, Où se forme toujours la fuite, ou le désir, Par une violence aussi douce que forte, Quite tout autre objet, vers celui-cy s'emporté;
Et croid, en l’embraſſant comme vn ſouuerain bien;	Et croid, en l'embrassant comme un souverain bien;
Qu’auoir tout, l’exceptant, c’eſt ne poſſeder rien.	Qu'avoir tout, l'exceptant, c'est ne posséder rien.
Mais ce n’eſt que parler de la moindre partie, Examinons l’eſprit, dont elle eſt aſſortie;	Mais ce n'est que parler de la moindre partie, Examinons l'esprit, dont elle est assortie;
Mais non, l’on ne ſçauroit en parler dignement :	Mais non, l'on ne saurait en parler dignement :
Laparole, pour luy, cede à l’eſtonnement.	Lapparole, pour lui, cède à l'étonnement.
Quoy que l’on en conçoiue, & qu’on ait d’eloquence, Il faut ſur ce ſujet obſeruer le ſilence :	Quoi que l'on en conçoive, et qu'on ait d'éloquence, Il faut sur ce sujet observer le silence :
Le plus preſſant diſcours ne peut aller ſi haut, Et ſa perfection cauſeroit vn defaut.	Le plus pressant discours ne peut aller si haut, Et sa perfection causerait un défaut.
Iuges ſi mon amour n’eſt donc pas legitime.	Juges si mon amour n'est donc pas légitime.
CVRCE Seigneur, me croiriez-vous capable de ce crime, B iiij D’oſer inſolemment condamner voſtre chois?	CURÉE Seigneur, me croiriez-vous capable de ce crime, B ijà D'oser insolemment condamner votre chois?
Ie ſçay ce que ie luis, & ce que ie vous dois.	Je sais ce que ici luis, et ce que je vous dois.
MAXIMIAN.	MAXIMIAN.
Non, ie la veux nommer, & t’obliger à dire onoentroude curiore prus digne de l’Empire:	Non, Seigneur la veux nommer, et t'obliger à dire onoentroude curiore prus digne de l'Empire:
C’eſt Suſanne.	C'est Susanne.
CVRCE.	CURÉE.
Ha!	Ha!
Seigneur, ie denieure interdit;	Seigneur, ie dénieure interdit;
En elle ſeule on void ce que vous auez dit.	En elle seule on voit ce que vous avez dit.
MAXTMIAN.	MAXTMIAN.
Nous ſerons bien-toſt ioins, du nœud de Mariage,	Nous serons bientôt joins, du nœud de Mariage,
SINeEs Veüillenties pieur naſter cét illuſtre aſſemblage.	SINeEs Veüillenties pieur naster cet illustre assemblage.
SOLILOQVE de	SOLILOQUE de
CLAVDE.	CLAUDE.
Imperceptible attrait des rebelles eſprits, Qui ſçaués conuertir en reſpects nos mépris!	Imperceptible attrait des rebelles esprits, Qui savez convertir en respects nos mépris!
I’admire les effets de vôtre prouidence, C’eſt inutilement qu’on luy fait reſiſtance, Son coup eſt infaillible;	J'admire les effets de votre providence, C'est inutilement qu'on toujours fait résistance, Son coup est infaillible;
& dans meſme chemin, Qui léuite auiourd’huy, le receura demain.	et dans même chemin, Qui léuite aujourd'hui, le recevra demain.
Par quelle voye en moy ſon ordre s’execute!	Par quelle voie en moi son ordre s'exécute!
Vous aimés tendrement ceux que ie perſecute;	Vous aimez tendrement ceux que je persécute;
Et le plus foible ſexe, en cet heureux party Mépriſe mon attaque, & i’en ſuis conuerti, Mais quelqu’vn vient.	Et le plus faible sexe, en cet heureux parti Méprise mon attaque, et j'en suis converti, Mais quelqu'un vient.
1	1
QVATRIESME ENTRETIEN.	QUATRIÈME ENTRETIEN.
MAAIME, CLAVDES	MAYME, CLAUDES
MAXIME.	MAXIME.
momieur, encures, ie vous prie, Si ie vous interromps en voſtre réuerie.	moment, encures, Seigneur vous prie, Si je vous interromps en votre réuerie.
CLAVDE Mon eſprit, qui ne peut rien de grand conceuoir Ne la préfére pas à l’honneur de vous voir.	CLAUDE Mon esprit, qui ne peut rien de grand concevoir Ne la préfére pas à l'honneur de vous voir.
MAXIME.	MAXIME.
Ce meſme honneur, Monſieur, m'eit e tout préférable.	Ce même honneur, Monsieur, m'éit e tout préférable.
CLAVDE Qui ſe tait par foibleſſe en eſt bien excuſable.	CLAUDE Qui se taît par faiblesse en est bien excusable.
MAXIME.	MAXIME.
Vous ex cellés entout, & les plus grands eſprits, Vous eſtans comparés, ſont dignes de mépris.	Vous ex celez entout, et les plus grands esprits, Vous étant comparés, sont dignes de mépris.
L’Empereur nous en donne vne preuue aſſés claire, Vous faiſant conducteur d’vne importante affaire.	L'Empereur nous en donne une preuve assez claire, Vous faisant conducteur d'une importante affaire.
CLAVDE L’Empereur conſidere en cette élection, Moins ma capacité que mon affection.	CLAUDE L'Empereur considère en cette élection, Moins ma capacité que mon affection.
MAXIME.	MAXIME.
ie lçay qu’il a des deux parfaite conoiſſance, Qu’il eſt de vous reuoir en grande impatience;	Ce lçai qu'il a des deux parfaite conaissance, Qu'il est de vous revoir en grande impatience;
Et ſuis venu, Monſieur, vous le faire ſçauoir, Par l’ordre que deluy ie viens de receuoir.	Et suis venu, Monsieur, vous le faire savoir, Par l'ordre que délui notre viens de recevoir.
CLAVDE En ce retardement mes ſoins luy ſont fidelles;	CLAUDE En ce retardement mes soins lui sont fidèles;
Ie ſçay qu’on doit celer les mauuaiſes nouuelles:	Je sais qu'on doit celer les mauvaises nouvelles:
Son intereſt, Monſieur, m’oblige à differer, Enfin, Suſanne eſt vierge, & le veut demeurer.	Son intérêt, Monsieur, m'oblige à différer, Enfin, Susanne est vierge, et le veut demeurer.
MAXIME.	MAXIME.
P'eut elle refuſer vn ſi grand auantage?	P'eût elle refuser un si grand avantage?
CLAVDE Elle fremit d’horreur, au nom de mariage.	CLAUDE Elle frémit d'horreur, au nom de mariage.
MAXIME Mais ne craint elle point le ſouuerain pouuoir?	MAXIME Mais ne craint -elle point le souverain pouvoir?
CEAVDE Ie n’ay rien oublie, qui la puſt émouuoir.	CEAUDE Je n'ai rien oublie, qui la pût émouuoir.
MAXIME L’on ne parla jamais d’vne pareille audace.	MAXIME L'on ne parla jamais d'une pareille audace.
CLAVDE Ei tedl ron y pruaquu de palla ce manace.	CLAUDE Ei tedl on y pruaquu de palla ce manace.
MAXIME Qu'entreprend l'Emmpereur, dont ir ne vienne à bout?	MAXIME Qu'entreprend l'Emmpereur, dont ir ne vienne à bout?
CLAVDE Ce deſſein excepté, i’eſtime qu’il peut tout.	CLAUDE Ce dessein excepté, j'estime qu'il peut tout.
MAXIME Peut eſtre que le temps vaincra ſa réſiſtance.	MAXIME Peut être que le temps vaincra sa résistance.
CLAVDE Vous croirés le contraire, apres l’experience.	CLAUDE Vous croirez le contraire, après l'expérience.
Cen eit pas que le lois incapable d’erreur.	Cen eit pas que le lois incapable d'erreur.
MAXIME Toûjours en deués vous reſoudre l’Empereur.	MAXIME Toujours en devez vous résoudre l'Empereur.
Que luy diray-ie donc?	Que sent dirai-je donc?
CLAVDE Il eſt bon ce me ſemble, Que nous allions plutoſt la viſiter enſemble;	CLAUDE Il est bon ce me semble, Que nous allions plutôt la visiter ensemble;
Peut eſtre voſtre eſprit, qui fait tout reüſſit, Pourra-t’il la changer, ou du moins l’adoucir:	Peut être votre esprit, qui fait tout réussit, Pourra-t-il la changer, ou du moins l'adoucir:
Et nous irons apres, en plaine certitude Rerirer l'Empereur de ſon inquiétude.	Et nous irons après, en plaine certitude Rérirer l'Empereur de son inquiétude.
Faire cette entrepriſe, apres vos vains efforts, Seroit employer l’ombre, où n’a rien pũ le corps.	Faire cette entreprise, après vos vains efforts, Serait employer l'ombre, où n'a rien pun le corps.
CLAVDE Mais pluſtoſt le contraire, & par experience, Nous voyons que ſouuent l’ombre le corps deuance.	CLAUDE Mais plutôt le contraire, et par expérience, Nous voyons que souvent l'ombre le corps devance.
MAXIME Suſanne eſt vn Soleil, nous l’allons pourſuiuant;	MAXIME Susanne est un Soleil, nous l'allons poursuivant;
Il s’infere de là que le corps va deuant.	Il s'infère de là que le corps va devant.
Et pour dire en vn mot à quoy ie me diſpoſe, C’eſt la voir pour vous plaire, & non pour autre choſes	Et pour dire en un mot à quoi je me dispose, C'est la voir pour vous plaire, et non pour autre choses
CLIIVDE le votls iuſs feſteuable, & louidicte didaimnens Voir en cette viſite vn heureux changement.	CLIIVDE le vots jusqu' festeuable, et louidicte didaiments Voir en cette visite un heureux changement.
TROISIESME PARTIE.	TROISIÈME PARTIE.
PREMIER ENTRETIEN.	PREMIER ENTRETIEN.
SVSANNE, CLAVDE, MAXIME.	SUSANE, CLAUDE, MAXIME.
SVSANNE Puis que par vn bon-heur, qui tout autre ſurpaſſe, Ce Dieu, plein de bonté, vous a fait cette grace, D’ouurir à ſes clartés les yeux de vos Eſprirs, Afin qu’en les voyant ils en fuſſent épris;	SUSANNE Puis que par un bonheur, qui tout autre surpasse, Ce Dieu, plein de bonté, vous a fait cette grâce, D'ouvrir à ses clartés les yeux de vos Éprirs, Afin qu'en les voyant ils en fussent épris;
Aprenés comme il faut receuoir ces lumieres, Pour ne retomber pas dans vos erreurs premieres.	Aprenez comme il faut recevoir ces lumières, Pour ne retomber pas dans vos erreurs premières.
CLAVDE Nous attendons, Madame, auec docilité Les vtiles effets de voſtre charité.	CLAUDE Nous attendons, Madame, avec docilité Les vtiles effets de votre charité.
Dans la ſecte idolâtre, ignorante & groſſiere, Où l’eſprit eſt toûjours ſoumis à la matiere, L’on aſſuiettit tout à l’Empire des ſens;	Dans la secte idolâtre, ignorante et grossière, Où l'esprit est toujours soumis à la matière, L'on assuiettit tout à l'Empire des sens;
De leurs diuinités on les fait comiſſans:	De leurs divinités on les fait comissants:
Comme ce ſont des Dieux formés dans la Nature, Ils n’ont rien, qui des ſens excede la meſure:	Comme ce sont des Dieux formés dans la Nature, Ils n'ont rien, qui des sens excede la mesure:
Et les hommes ſouuent ont oſté ſi brutaux, D’admettre pour leurs Dieux des plus vils animaux.	Et les hommes souvent ont ôté si bruts, D'admettre pour leurs Dieux des plus vils animaux.
De ces Diuinités, l’humaine connoiſſance Comprend facilement la grandeur & l’eſſence;	De ces Divinités, l'humaine connaissance Comprend facilement la grandeur et l'essence;
Et l’adoré ne peut, de ſon adorateur Comprendre, ou conceuoir l’eſſence & la grandeur.	Et l'adoré ne peut, de son adorateur Comprendre, ou concevoir l'essence et la grandeur.
Noſtre Religion, & ſaincte & ſalutaire En ces cultes ſacrés obſerue le contraire;	Notre Religion, et sainte et salutaire En ces cultes sacrés observe le contraire;
Nous ne ſoûmettons pas à l’Empire des ſens L’office de l’eſprit dont ils ſont impuiſſans:	Nous ne soumettons pas à l'Empire des sens L'office de l'esprit dont ils sont impuissants:
Et meſme cet eſprit,libre de la matire, Ne peut connoiſtre Diet, par la propre famiere.	Et même cet esprit,libre de la matire, Ne peut connaître Diet, par la propre famière.
MAXIME.	MAXIME.
Mais, Madame, comment nous pourroit il blamer Ne le connoiſſant pas, du defaut de l’aimer?	Mais, Madame, comment nous pourrait -il blâmer Ne le connaissant pas, du défaut de l'aimer?
SVSANNE.	SUSANE.
Nous adorons vn Dieu que de ſa propre eſſence, Eſt puiſſant, ſage, bon, iuſte, éternel, immenſe, Sainct, ou pour mieux parler la meſme ſaincteté, Dont tous leo uceribues lonit daiis r'iifimte:	Nous adorons un Dieu que de sa propre essence, Est puissant, sage, bon, iuste, éternel, immense, Saint, ou pour mieux parler la même sainteté, Dont tous leo uceribues lit daiis riifimette:
Comment donc noſtre eſprit dont la foible portée, A des termes finis ſe trouué limitée, Le pourroit il comprendre en ſon plus grandeffort?	Comment donc notre esprit dont la faible portée, À des termes finis se trouvé limitée, Le pourrait il comprendre en son plus grandeffort?
La puiſſance à l’objet n’ayant aucun raport.	La puissance à l'objet n'ayant aucun rapport.
Puis qu’il eſt infini, c’eſt bien noſtre croyance Qu’on ne peut en auoir parfaite connoiſſance;	Puis qu'il est infini, c'est bien notre croyance Qu'on ne peut en avoir parfaite connaissance;
Mais nous nous éleuons à ſa diuinité Autant que noſtre eſprit a de capacité.	Mais nous nous élevons à sa divinité Autant que notre esprit a de capacité.
SVSANNE.	SUSANE.
Quand d’vn œil trop hardi le vif regard s’obſtine Achercher la clarté iuſqu’en ſon origine;	Quand d'un œil trop hardi le vif regard s'obstine Achercher la clarté jusqu'en son origine;
Que d’vn deſſein nuiſible, autant qu’audacieux, Pour iuger du Soleil il veut percer les Cieux;	Que d'un dessein nuisible, autant qu'audacieux, Pour juger du Soleil il veut percer les Cieux;
Il en perd la clarté ſitoſt qu’il là receüe:	Il en perd la clarté sitôt qu'il là reçue:
Ces eſprits delicats, qui forment noſtre veüe, D’en ſoûtenir l’éclat ne ſont pas en pouuoir, Et nous n’en voyons rien pour en vouloir trop voir.	Ces esprits délicats, qui forment notre vue, D'en soutenir l'éclat ne sont pas en pouvoir, Et nous n'en voyons rien pour en vouloir trop voir.
Il faut de ſa bonté receuoir la pratique;	Il faut de sa bonté recevoir la pratique;
Ce que nous en ſçauons, il nous le communique, Mais en ge raualant;	Ce que nous en savons, il nous le communique, Mais en ge ravalant;
& ſi nous le voyons, Ce n’eſt qu’au doux enuoy qu’il fait de ſes rayons;	et si nous le voyons, Ce n'est qu'au doux envoi qu'il fait de ses rayons;
Par le moindre deſquels l’on raiſonne du reſte, Et comprend, à peuprés, tout ce grand corps celeſte.	Par le moindre desquels l'on raisonne du reste, Et comprend, à peuprès, tout ce grand corps celeste.
Noſtre foible eſprit eſt enuers ce Dieu des Dieux, Ce qu’enuers le Soleil ſont nos debiles yeux:	Notre faible esprit est envers ce Dieu des Dieux, Ce qu'envers le Soleil sont nos débiles yeux:
Il va communiquant la bonté de ſon eſtre, Mais c’eſt l’abaiſſement qui nous le fait connoitre:	Il va communiquant la bonté de son être, Mais c'est l'abaissement qui nous le fait connaître:
Son exceds de ſplendeur nous pourroit ébloüir, Ce n’eſt que de bien loin que l’on en peut ioüir.	Son excéds de splendeur nous pourrait éblouir, Ce n'est que de bien loin que l'on en peut jouir.
Croyons ces verités, dont la raiſon s’étonne, Par vne foy ſoûmiſe, & c’eſt luy qui la donne.	Croyons ces vérités, dont la raison s'étonne, Par une foi soumise, et c'est quequi la donne.
Pour le bientoſt conoiſtre, il faut dés auiord’huy Renoncer à ſoy meſme, & recourir à luy.	Pour le bientôt conoistre, il faut dès aujord'hui Renoncer à soi même, et recourir à lui.
MAXIME.	MAXIME.
Madame, nous voulons ſuiure cette doctrine;	Madame, nous voulons suivre cette doctrine;
Mais nos indignes vœux, de ſa bonté diuine N’oſeroir eſperer dey e voir exauces.	Mais nos indignes vœux, de sa bonté divine N'oseroir espérer dey e voir exauces.
4071	4071
SVSANNE Ouurés luy voſtre cœur, mes freres, c’eſt aſſés.	SUSANE Ouvrés était vôtre cœur, mes frères, c'est assez.
Tenebres lumineux!	Ténèbres lumineux!
lumiere tenebreuſe!	lumière ténébreuse!
à part ſoy O foy!	à part soi Ô foi!
qui r’afermis l’ame foible & douteuſe, Qui noüs fais trouuer iour aux miſteres obſcurs, Et qui nous rends preſens les biens qui ſont futurs;	qui ressermis l'âme faible et douteuse, Qui noüs fais trouver jour aux misères obscurs, Et qui nous rends presens les biens qui sont futurs;
Diuine qualité, qui nos ſens illumines!	Divine qualité, qui nos sens illumines!
Imprimeen leurs eſprits tes qualités diuines:	Imprimeen leurs esprits tes qualités divines:
Etcomme le Soleil naiſt dans l’obſcurité, Au milieu de l’erreur produis la verité.	Etcomme le Soleil naît dans l'obscurité, Au milieu de l'erreur produis la vérité.
SECOND ENTRETIEN.	SECOND ENTRETIEN.
DIOCLETIAN, MACE DIONE ARTISE, LE PREVOST,	DIOCLETIAN, MACE DIONE ARTISE, LE PRÉVÔT,
DIOCLETIAN Adorables obiects de nos ſaincts ſacrifices!	DIOCLETIAN Adorables objets de nos saints sacrifices!
Immortels ennemis des crimes & des vices!	Immortels ennemis des crimes et des vices!
Puiſſans & ſages Dieux!	Puissants et sages Dieux!
de qui la volonté, A pour objet le bien, pour regle l’equité;	de qui la volonté, A pour objet le bien, pour règle l'équité;
Puis-je pas vous blâmer de trop de négligence, Vous voyans ſi tardifs à punir cette offence?	Puis-je pas vous blâmer de trop de négligence, Vous voyant si tardifs à punir cette offense?
Ie crains, auec raiſon, que bientoſt les humains, Croyant que vous ſoyés ou ſans cœur, ou ſans mains, Non contents d’abolir vos droits deſſus la terre, Voudront iuſques au Ciel vous declarer la guerre;	Je crains, avec raison, que bientôt les humains, Croyant que vous soyez ou sans cœur, ou sans mains, Non contents d'abolir vos droits dessus la terre, Voudront jusques au Ciel vous déclarer la guerre;
Et par l’ambition, d’où naiſt vn attentat, Gouuerner à leur tour le ſouuerain Etat.	Et par l'ambition, d'où naît un attentat, Gouverner à leur tour le souuerain Etat.
lamais auéun mortel fut il ſi temeraire, D’oſer ce que ces deux ont l’audace de faire?	lamais auéun mortel fut -il si téméraire, D'oser ce que ces deux ont l'audace de faire?
Dans l’empire Romain comettre vne action Dont la tâche noircit toute la nation.	Dans l'empire Romain comettre une action Dont la tâche noircit toute la nation.
Eux, en qui mes bontés grauoient toutes les marques, Capables d’acquerir des ſuiets aux Monarques, Dont i’eſtimois l’eſprit, demandois les Conſeils, Et qui dans mes faueurs n’auoient point de pareils, Changent, par vne erreur abſurde & volontaire, Le nom de confident en celuy d’aduerſaire;	Eux, en qui mes bontés gravaient toutes les marques, Capables d'acquérir des sujets aux Monarques, Dont j'estimais l'esprit, demandais les Conseils, Et qui dans mes faveurs n'avaient point de pareils, Changent, par une erreur absurde et volontaire, Le nom de confident en celui d'adversaire;
Et par le changement de contraires partis, Rendent le droit diuin & l’humain peruertis.	Et par le changement de contraires partis, Rendent le droit divin et l'humain pervertis.
Mais quoy qu’aparẽment leurs crimes ſoiẽt ſemblables, Et qu’on iuge les deux également coupables, Claude l’eſt plus que l’autre, & par ſa traliſon, Il a voulu ſe mettre hors de comparaiſon.	Mais quoi qu'aparẽment leurs crimes soient semblables, Et qu'on juge les deux également coupables, Claude l'est plus que l'autre, et par sa tralison, Il a voulu se mettre hors de comparaison.
Pouragir en vn fait de telle conſequence, Le chois que ie faiſois marquoit ma confiances le le crus le dernier qui me voudroit trahir, Ie ne commandai pas, bien qu’il deût m’obeir;	Pourquir en un fait de telle conséquence, Le chois que tu faisais marquait ma confiances le le crus le dernier qui me voudrait trahir, Je ne commandai pas, bien qu'il dût m'obéir;
Mais dans mon cabinet, où ie l’auois fais rendre, Ie luy fis le diſcours que vous allés entendre.	Mais dans mon cabinet, où ici l'avais fais rendre, Je lui fis le discours que vous allez entendre.
le ſçay l’affection que vous aués pour moy, Et conois voſtre adreſſe égale à voſtre foy:	le sais l'affection que vous avez pour moi, Et conais votre adresse égale à votre foi:
Auiſi dans vn deſſein, d’vne importante ſuite, Ie veux vous demander voſtre lage conduite;	Ajuis que un dessein, d'une importante suite, Je veux vous demander votre lage conduite;
Et pour la recompenſe, il faut s’imaginer, lout ce qu’vn Empereur peur iuſtement donner.	Et pour la récompense, il faut s'imaginer, lout ce qu'un Empereur peur justement donner.
MACEDONE Ces termes ſont preſſans.	MACEDONE Ces termes sont pressants.
DIOCLETIAN Ie fis bien dauentage,	DIOCLETIAN Je fis bien daventage,
Ie l'ambraſſai, ioignant l’action au langage;	Je l'ambrassai, joignant l'action au langage;
Ie crus l’obliger plus en le traitant ainſi:	Je crus l'obliger plus en le traitant ainsi:
Et luy, me répondit aux termes que voicy.	Et Elle, me répondit aux termes que voici.
Que voſtre majeſté m’excuſe & mediſpenſe, D’attendre de ſes mains aucune recompenſe, Mon cœur, pour la ſeruir, conforme à mon deuoir, N’aſpire qu’à l’honneur qu’il en peut receuoir.	Que votre majesté m'excuse et médispense, D'attendre de ses mains aucune récompense, Mon cœur, pour la servir, conforme à mon devoir, N'aspire qu'à l'honneur qu'il en peut recevoir.
Ie répris, que ſon cœur eſtant ſi magnanime, Qu’il iugeoit l’honneur ſeul digne de ſon eſtime, Il ne ſe trouuoit rien que l’on luy deût offrir, En poſſedant autant qu’il s’en peut acquerir.	Je répris, que son cœur étant si magnanime, Qu'il jugeait l'honneur seul digne de son estime, Il ne se trouvait rien que l'on lui deût offrir, En possédant autant qu'il s'en peut acquérir.
Il repartit, Seigneur, ce diſcours me ſurpaſſe;	Il répartit, Seigneur, ce discours me surpasse;
Mais à tant de faueurs ioignés vne autre grace;	Mais à tant de faveurs ioignés une autre grâce;
Sans me preoccuper d’vn ſentiment ſi vain, Vſés en Empereur, enuers vn vray Romain.	Sans me préoccuper d'une sentiment si vain, Usez en Empereur, envers un vrai Romain.
Rien ne touche mon cœur comme la modeſtie;	Rien ne touche mon cœur comme la modestie;
Et ie dis, pour loüer en luy cette partie, C'eſt le temperament des belles qualités, C’eſt vn petit ombrage, à de grandes clartés, En l’abſence duquel leur pointe trop aigüe, Ne peut ſe faire voir ſans bleſſer noſtre veüe.	Et petit dis, pour louer en même cette partie, C'est le tempérament des belles qualités, C'est un petit ombrage, à de grandes clartés, En l'absence duquel leur pointe trop aigue, Ne peut se faire voir sans blesser notre vue.
Enfin, ayant receu cet honorable employ, Il iura d’y prouuer & ſon zele, & ſa foy.	Enfin, ayant reçu cet honorable emploi, Il jura d'y prover et son zèle, et sa foi.
Voylà du procedé toutes les circonſtances.	Voilà du procédé toutes les circonstances.
Quel crime, de trahir apres tant d’aſſeurances!	Quel crime, de trahir après tant d'assurances!
Ie blame neantmoins ce qui m’eſt glorieux, Et me plains, de me voir traité comme les Dieux, Mais, Artiſe, comment ſçais tu cette nouuelle?	Je blâme néanmoins ce qui m'est glorieux, Et me plains, de me voir traité comme les Dieux, Mais, Artise, comment sais tu cette nouvelle?
ARTISE Si jamais vn raport peut eſtre crû fidelle, Celuy-cy doit paſſer pour vne verité, Puis que ſon autheur eſt de grande probité;	ARTISE Si jamais un rapport peut être cru fidèle, Celui-cy doit passer pour une vérité, Puis que son auteur est de grande probité;
Et poſſede nt poneue r'homieur d’ertre dans voitre eitimes	Et possède nt ponève rhomieur d'ertre dans voitre eitimes
DIOCLETIAN oçais tu ce que fit Claude, auant qu’il viſt Maxime?	DIOCLETIAN oçais -tu ce que fit Claude, avant qu'il vit Maxime?
ARTISE Si nous iugeons, Seigneur, ſur ce que l’on en dit, Sans doute, de luy ſeul l’affaire dépendit.	ARTISE Si nous jugeons, Seigneur, sur ce que l'on en dit, Sans doute, de notre seul l'affaire dépendit.
Incontinent qu’il eut à Gabin fait entendre, Que vous luy deſtiniés Maximian pour gendre;	Incontinent qu'il eut à Gabin fait entendre, Que vous avez destiniez Maximian pour gendre;
Ce diſcours le ſurprit auec tant d’agrément, Que ſon cœur, y donnant vn prompt conſentement, Veut deuancer ſa bouche, & paroît au viſage, Pour en aſſeurer Claude, en ſon muet langage.	Ce discours le surprit avec tant d'agrément, Que son cœur, y donnant un prompt consentement, Veut devancer sa bouche, et paraît au visage, Pour en assurer Claude, en son muet langage.
Vnrayon de couleur, le ris, la gayeté, Sont produis pour témoins de cette verité:	Unrayon de couleur, le ris, la gaieté, Sont produis pour témoins de cette vérité:
Son regard vif & doux hautement la publie;	Son regard vif et doux hautement la publie;
Et ſa voix, que le temps ſemble auoir affoiblie, Par imitation des mouuemens du cœur, Reprend, pour l’exprimer, vne ieune vigueur.	Et sa voix, que le temps semble avoir affaiblie, Par imitation des mouvements du cœur, Reprend, pour l'exprimer, une jeune vigueur.
Illuy répond d’vn ton enſemble graue & ferme;	Illui répond d'un ton ensemble grave et ferme;
Et dans cette réponce, il n’oublie aucun terme, Dont il ſe peût ſeruir, au deſſein qu’il auoit, De traiter dignement l’honneur qu’il receuoit.	Et dans cette réponse, il n'oublie aucun terme, Dont il se put servir, au dessein qu'il avait, De traiter dignement l'honneur qu'il recevait.
Il paroît tres ſoûmis, quoy que tres vénérable:	Il paraît très soumis, quoi que très vénérable:
Il confeſſe, Seigneur, vous eſtre redeuable, Non comme vn ſeul ſujet enuers ſon ſouuerain, Mais plus que ne vous l’eſt tout le peuple Romain.	Il confesse, Seigneur, vous être redevable, Non comme un seul sujet envers son souverain, Mais plus que ne vous l'est tout le peuple Romain.
A ce que vous voulés, Seigneur, il ſe diſpoſe, D'vn tel air, qu’on ne ſçait s’il accepte ou propoſe:	À ce que vous voulez, Seigneur, il se dispose, D'un tel air, qu'on ne sait s'il accepte ou propose:
L’on croid, ſi le reſpect ne l’auoit retenu, Qu’il eût paru fâché, de ſe voir preuenu.	L'on croid, si le respect ne l'avait retenu, Qu'il eût paru fâché, de se voir prévenu.
Mais à ne pas conclure vne choſe l’oblige;	Mais à ne pas conclure une chose l'oblige;
Ce que la bienſéance en pareil cas exige:	Ce que la bienséance en pareil cas exige:
Il veut à ſes parents faire ciuilité, Non pour délibérer, mais par formalité.	Il veut à ses parents faire civilité, Non pour délibérer, mais par formalité.
Peu de temps luy ſuffit, pour faire qu’il s’acquite, L’écoulement d’vn iour eſt celuy qu’il limite;	Peu de temps Seigneur suffit, pour faire qu'il s'acquite, L'écoulement d'un jour est celui qu'il limite;
Apres lequel il veut ſuiure de poinct en poinct, Ce qui de voſtre part luy pourroit eſtre enjoinct.	Après lequel il veut suivre de point en point, Ce qui de votre part lui pourrait être enjoint.
Il détermine tout, ne met rien en balance, N’oppoſe de ſa fille aucune repugnance;	Il détermine tout, ne met rien en balance, N'oppose de sa fille aucune répugnance;
Elle eſt obéiſſante, & luy pere abſolu:	Elle est obéissante, et lui père absolu:
Si bien que ſans conclure, il ſemble auoir conclu.	Si bien que sans conclure, il semble avoir conclu.
Mais pour le confirmer auec cérémonie;	Mais pour le confirmer avec cérémonie;
Inſpiré, diroit-on, d’vn tres mauuais Génie, Ennemy denos Dieux & de nos ſainctes loix, Il ſounaitté voir Cſaude, vile ſeconde lois.	Inspiré, dirait-on, d'un très mauvais Génie, Ennemi denos Dieux et de nos sainte lois, Il sounaité voir Csaude, vile seconde lois.
Le temps & le lieu pris, châcun d’eux ſe retire.	Le temps et le lieu pris, châcun d'eux se retire.
Pour le reſte, Seigneur, vous l’aués oüy dire.	Pour le reste, Seigneur, vous l'avez oui dire.
DIOCLETIAN lo ſçay bien que Suſanne, au premier entretien, Porta l’eſprit de Claude à ſe faire Chreſtien:	DIOCLETIAN lo semai bien que Susanne, au premier entretien, Porta l'esprit de Claude à se faire Chrétien:
Mais ie demande auſſi, ſçais tu comment Maxime, Par l’eſpnit de Suſaiiſe à coiimis inemſe cimez	Mais était demande aussi, sais tu comment Maxime, Par l'épnit de Susayise à coiimis inemise cimez
ARTISE Seigneur, Claude obligea Maxime à l’aller voir, Qui par elle auſſitoſt ſe laiſſa déceuoir.	ARTISE Seigneur, Claude obligea Maxime à l'aller voir, Qui par elle aussitôt se laissa décevoir.
DIOCLETIAN C’eſt aſſés, mon courroux à ce récit s’augmente:	DIOCLETIAN C'est assez, mon courroux à ce récit s'augmente:
Excuſés, puiſſans Dieux, vne ardeur violente, Oui cauſant vn grand trouble en mon entendement, Vous a fait imputer mon propre manquement.	Excusez, puissants Dieux, une ardeur violente, Oui causant un grand trouble en mon entendement, Vous a fait imputer mon propre manquement.
Ma raiſon ſe reueille, & me fait reconoître, Que puis que vos bontés voulurent me commettre, Sur ce peuple peruers, en pleine authorité, C’eſt moy, qu’il faut blâmer de cette impunité:	Ma raison se réveille, et me fait reconoître, Que puis que vos bontés voulurent me commettre, Sur ce peuple pervers, en pleine autorité, C'est moi, qu'il faut blâmer de cette impunité:
C’eſt moy, qui dois veiller à vos droits ſur la terre;	C'est moi, qui dois veiller à vos droits sur la terre;
La bonté vous rauit l’vſage du Tonerre:	La bonté vous ravit l'usage du Tonerre:
Mon ſouuerain pouuoir doit ſeruir d’inſtrument, Al’execution d’vn iuſte châtiment:	Mon souverain pouvoir doit servir d'instrument, Al'exécution d'un juste châtiment:
le veux m’en acquiter, & dans cette oſurrence, M’ontrer mon intereſt à ce qui vous offenſe.	le veux m'en acquitter, et dans cette osurrence, M'ontrer mon intérêt à ce qui vous offense.
Sivous aués jamais chéri l’occaſion De me rendre aſſeuré de voſtre affection;	Sivous aués jamais chéri l'occasion De me rendre assuré de votre affection;
Cherchés, diligemment cette cabale infâme:	Cherchez, diligemment cette cabale infâme:
Il faut qu’elle choiſiſſe, ou mes loix, ou la flame,	Il faut qu'elle choisisse, ou mes lois, ou la flamme,
LE PREVOST Si ce commandement n’eſt ſuiui de l’effet, Mvonle majelte in miipelte leui lorlalta	LE PRÉVÔT Si ce commandement n'est suivi de l'effet, Muonle majelte in mipelte lui lorlalta
ROTSTESME ENTRETIEN.	ROTSTESME ENTRETIEN.
SERENE, VIRGINIE.	SERENE, VIRGINIE.
Celeulen Si le temps le permet, afin que ie m’acquite, De mon dernier diſcours, reprenons en la ſuite:	Celeulen Si le temps le permet, afin que deux m'acquite, De mon dernier discours, reprenons en la suite:
oţais tu par où ie fus contrainte de finir?	oais -tu par où ils fus contrainte de finir?
VIRGINIE Le ſujet eſt trop beau, pour ne s’en ſouuenir:	VIRGINIE Le sujet est trop beau, pour ne s'en souvenir:
Madame, vous parliés des vertus qu’on pratique:	Madame, vous parliez des vertus qu'on pratique:
SERENE Iu me faiſois paſſer pour grande politique.	SERENE Ju me faisais passer pour grande politique.
Mais, enfin, mon deſſein n’eſt pas de t’enſeigner Les maximes d’Etat, ny comme il faut regner;	Mais, enfin, mon dessein n'est pas de t'enseigner Les maximes d'État, ni comme il faut régner;
l'out cela, pour object, n’a pas vn bien extreme.	l'out cela, pour object, n'a pas un bien extrême.
Ma fille, c’eſt beaucoup de regner ſur ſoy meſme;	Ma fille, c'est beaucoup de régner sur soi -même;
Et c’eſt peu de ſçauoir dompter des Ennemis, Si chés nous la raiſon ne tient les ſens ſoûmis.	Et c'est peu de savoir dompter des Ennemis, Si chez nous la raison ne tient les sens soumis.
Mais, veux tu des vertus entrer en conoiſſance?	Mais, veux tu des vertus entrer en conaissance?
Apprens, que leurs objects forment leur excellence;	Apprends, que leurs objects forment leur excellence;
Celle qui ne va pas directement à Dieu, Du vice à la vertu, ne fait que le milieu.	Celle qui ne va pas directement à Dieu, Du vice à la vertu, ne fait que le milieu.
Elle vſurpe le nom, ſi d’autre elle regarde, De vertu legitime, eſtant vertu bâtarde.	Elle usurpe le nom, si d'autre elle regarde, De vertu légitime, étant vertu bâtarde.
Par elle, noſtre eſprit n’eſt jamais ſatisfait, Ne pouuant l’enrichir, que d’vn bien imparfait.	Par elle, notre esprit n'est jamais satisfait, Ne pouvant l'enrichir, que d'un bien imparfait.
Sçais tu d’où cet eſprit tire ſon origine?	Sais -tu d'où cet esprit tire son origine?
C’eſt vn écoulement d’vne ſource diuine, Lequel ſans ceſſe agit, pour s’y voir réüny, Aſſeuré d’y trouuer vn bonheur infini.	C'est un écoulement d'une source divine, Lequel sans cesse agit, pour s'y voir réuni, Assuré d'y trouver un bonheur infini.
Il doit donc pratiquer la vertu qui l’y porte;	Il doit donc pratiquer la vertu qui l'y porte;
Et touté autre, pour luy, n’eſt qu’vne vertu morte?	Et touté autre, pour lui, n'est qu'une vertu morte?
Qui du moins le retarde au deſſein glorieux, Qui le doit occuper de s’éleuer aux Cieux.	Qui du moins le retarde au dessein glorieux, Qui le doit occuper de s'élever aux Cieux.
VIRGINIE Madame, ce chemin s’apprend en voſtre Ecole.	VIRGINIE Madame, ce chemin s'apprend en votre École.
SERENE Dure captiuité, qui môte la parole!	SERENE Dure captivité, qui môte la parole!
Faut il qu’inceſſemment ie me voye au milieu, D’vne foule de peuple, ennemy de mon Dieu !	Faut il qu'incessemment je me voie au milieu, D'une foule de peuple, ennemi de mon Dieu !
LTT(TRETIEN.	LTTTRETIEN.
MACEDONE, LE PREVOST.	MACEDONE, LE PRÉVÔT.
MACEDONE Noſtre commiſſion eſt de telle importance, Qu’il y faut procéder engrande diligence.	MACEDONE Notre commission est de telle importance, Qu'il y faut procéder engrande diligence.
Les Dieux & l’Empereur, irrités contre nous, Feroient auec iuſtice éclater leur courroux;	Les Dieux et l'Empereur, irrités contre nous, Feraient toujours justice éclater leur courroux;
Si nous n’apportions pas tout le ſoin neceſſaire, Pour nous bien acquiter, & pour les ſatifaire.	Si nous n'apportions pas tout le soin nécessaire, Pour nous bien acquitter, et pour les satifaire.
LE PREVOST Si le deſſein que i’ay, peut eſtre exécuté, lls ne douteront point de ma fidelité;	LE PRÉVÔT Si le dessein que j'ai, peut être exécuté, lls ne douteront point de ma fidélité;
Au contraire, ils verront la grandeur de monzele, Ales faire honorer & vanger leur querelle:	Au contraire, ils verront la grandeur de monzèle, Ales faire honorer et venger leur querelle:
Caril ne ſera point d’endroit ſi reſerué, Qui ne ſoit par mes ſoins deſormais obſerué;	Caril ne sera point d'endroit si réservé, Qui ne soit par mes soins désormais observé;
Afin de decouurir cette troupe perfide, De qui l’ame eſt vn trone, où le Demon préſide?	Afin dé couvrir cette troupe perfide, De qui l'âme est un trone, où le Démon préside?
Pour luy faire ſouffrir de ſenſibles tourments, Et la ſacrifier à leurs reſſentimens.	Pour ici faire souffrir de sensibles tourments, Et la sacrifier à leurs ressentiments.
MACEDONE Ce deſſein me rauit, tant il eſt plein de gloire:	MACEDONE Ce dessein me ravit, tant il est plein de gloire:
Par là, nous nous rendrons d’éternelle memoire.	Par là, nous nous rendrons d'éternelle mémoire.
Ayant quité ce lieu, pour l’immortalité, Nos noms ſeront cheris de la poſterité.	Ayant quité ce lieu, pour l'immortalité, Nos noms seront chéris de la postérité.
l’on dira, c’eſt par eux que l’on vid la Patrie, Se purger du venim de meinte idolâtrie:	l'on dira, c'est par eux que l'on vit la Patrie, Se purger du venim de meinte idolâtrie:
Par eux furent détruits tous ces magiciens Qui ſeduiſoient le peuple, & ſe nommdierle Chrétiens:	Par eux furent détruits tous ces magiciens Qui séduisaient le peuple, et se nommdierle Chrétiens:
Et nos ſanglans Arreſts, ornemens de l’hiſtoire, Seront graués en marbre au temple de memoire.	Et nos sanglants Arrêts, ornements de l'histoire, Seront gravés en marbre au temple de mémoire.
Ainſi, nous nous verrons doublement glorieux, Honorés par le monde, & chéris par les Dieux.	Ainsi, nous nous verrons doublement glorieux, Honorés par le monde, et chéris par les Dieux.
LE PREVOST l'en conçoy de la ioye, auſſi, lors que i’y penſe:	LE PRÉVÔT l'en conçois de la joie, aussi, lors que j'y pense:
Mais pour en dire plus i’ay trop d’impatience:	Mais pour en dire plus j'ai trop d'impatience:
d li Sans employer le temps en ces vains entretiens, Ie m’en vay de ce pas, à la chaſſe aux Chrétiens?	 li Sans employer le temps en ces vains entretiens, Je m'en vais de ce pas, à la chasse aux Chrétiens?
S’ils ne ſont auertis d’éuiter ma pourſuite, Ie ne reuiendray point, ſans vne bonne ſuite.	S'ils ne sont avertis d'éuiter ma poursuite, Je ne reviendrai point, sans une bonne suite.
MACEDONE Allés;	MACEDONE Allés;
& moy, ie vay cependant inuenter, Quelque nouueau moyen, pour ſes perſecuter.	et moi, Seigneur vais cependant inventer, Quelque nouveau moyen, pour ses persécuter.
SOLILQQVE de	SOLILQUE de
SVSANNE Flambeau de mon eſprit!	SUSANE Flambeau de mon esprit!
lumiere de mon ame!	lumière de mon âme!
Principe merueilleux de la diuine flame!	Principe merveilleux de la divine flamme!
Faites que de mes ſens vos céleſtes clartés, Banniſſent l’ignorance & ſes obſcurités.	Faites que de mes sens vos clestes clartés, Bannissent l'ignorance et ses obscurités.
A mon entendement donnés la conoiſſance, Du néant de ce monde, & de voſtre excellence.	À mon entendement donnés la conaissance, Du néant de ce monde, et de votre excellence.
Ie ne demande pas, que voſtre immenſité, Se racourciſſe au poinct de ſa capacité;	Je ne demande pas, que votre immentsité, Se racourcisse au point de sa capacité;
Non plus que demeurant au degré de voſtre eſtre, Vous faſſiés qu’il vous puiſſe entierement conoître:	Non plus que demeurant au degré de Seigne ur, Vous fassiez qu'il vous puisse entièrement conoître:
L’vn ſeroit vous détruire, & l’autre l’éleuer, Où, ſans eſtre vous meſme, on ne peut arriuer.	L'un serait vous détruire, et l'autre l'élever, Où, sans être vous même, on ne peut arriver.
Ie demande, qu’aidé d’vne foy viue & ferme, Vous ſeul ſoyés toûjours ſon objet & ſon terme.	Je demande, qu'aidé d'une foi vive et ferme, Vous seul soyez toujours son objet et son terme.
Qu’il s’élance vers vous , ſans ſortir du deuoir, Qu’il admire vn ſujet, qu’il ne peut conceuoir, Qu’humblement curieux ſans ceſſe il vous contemple:	Qu'il s'élance vers vous , sans sortir du devoir, Qu'il admire un sujet, qu'il ne peut concevoir, Qu'humblement curieux sans cesse il vous contemple:
Et vous conſiderant ſans pareil, ſans exemple, Qu’il forme ce diſcours de ſon raiſonnement, Que vous ſeul eſt pon, mais ſouuerainement.	Et vous considérant sans pareil, sans exemple, Qu'il forme ce discours de son raisonnement, Que vous seul est pon, mais souverainement.
Et comme l’amour doit ſuiure la conoiſſance, Faites que celle cy captiue vne Puiſſance.	Et comme l'amour doit suivre la conaissance, Faites que celle cy captive une Puissance.
Moderés cet exceds de liberalité, Qui nous mit & conſerue en plaine liberté.	Modérez cet excéds de libéralité, Qui nous mit et conserve en plaine liberté.
En m’aſſuiettiſſant voſtre gloire s’aſſure, Ce que le Créateur veut de la Créature.	En m'assuiettissant votre gloire s'assure, Ce que le Créateur veut de la Créature.
Mais ce fatal preſent, par vous fait aux humains, La volonté, qui met leurs ames dans leurs mains, Agiſſant librement, errante & vagabonde, Suit l’inſtabilité des faux objets du monde;	Mais ce fatal présent, par vous fait aux humains, La volonté, qui met leurs âmes dans leurs mains, Agissant librement, errante et vagabonde, Suit l'instabilité des faux objets du monde;
Et comme s’atachant ſoy meſme à ſe trahir, Ne ſe laiſſe charmer qu’à ce qu’on doit haïr.	Et comme s'atachant soi -même à se trahir, Ne se laisse charmer qu'à ce qu'on doit haïr.
Mais que di-ie imprudente?	Mais que di-je imprudente?
hé, ne dois-ie pas croire, Que nôtre vtilité fut iointe à voſtre gloire, En ce don pretieux, que voſtre amour nous fit.	hé, ne dois-je pas croire, Que notre vtilité fut jointe à votre gloire, En ce don prétieux, que votre amour nous fit.
Qui ne poſſede rien, d’où tirer du profit?	Qui ne possède rien, d'où tirer du profit?
Qui veritablement, ſe cultiue auec peine, Où nous deuons ſans ceſſe auoir l’œil & la main, Pour arracher l’iuroye & ſoigner le bon grain.	Qui véritablement, se cultive avec peine, Où nous devons sans cesse avoir l'œil et la main, Pour arracher l'ivroie et soigner le bon grain.
Encor, noſtre trauail, noſtre ſolicitude, Seroient ils ſans effet, par ſon ingratitude;	Encor, notre travail, notre solicitude, Seraient ils sans effet, par son ingratitude;
C’eſt vn terroir aride, & duquel le deffaut, Demande le ſecours d’vne vertu d’enhaut.	C'est un terroir aride, et duquel le défaut, Demande le secours d'une vertu d'enhaut.
Noſtre eſperance en vain ſur nos forces s’appuye:	Notre espérance en vain sur nos forces s'appuie:
Il faut pour l’humecter vne céleſte pluye:	Il faut pour l'humecter une céleste pluie:
Le monde n’a poinct d’eau qui le puiſſe arroſer:	Le monde n'a point d'eau qui le puisse arroser:
ets netues ce icomers le venolene epuner Noſtre age en cet employ ſe rendroit à ſon terme;	ets netues ce icomers le venolene épuner Notre âge en cet emploi se rendrait à son terme;
Sans que noſtre œil y pût découurir vn bon germe, Si par vn merueilleux & charitable ſoin Vos bontés ne veilloient ſans ceſſe à ſon beſoin.	Sans que notre œil y pût découvrir un bon germe, Si par un merveilleux et charitable soin Vos bontés ne veillaient sans cesse à son besoin.
Mais cette terre ſeiche eſtant fauoriſée, Du doux écoulement d’vne ſainte roſée, Vn rayon échaufant de la diuinité, Venant à temperer ſa froide qualité;	Mais cette terre seiche étant favorisée, Du doux écoulement d'une sainte rosée, Un rayon échauffant de la divinité, Venant à tempérer sa froide qualité;
Elle produit des fruicts, dont l’excellence eſt telle, Qu’ils ſeruent d’alliment pour la vie éternelle:	Elle produit des fruits, dont l'excellence est telle, Qu'ils servent d'alliment pour la vie éternelle:
Qu’on ne void pas pluſtoſt boutonner que meurir, Si peu que noſtre main y veüille concourir.	Qu'on ne voit pas plustost boutonner que mûrir, Si peu que notre main y veuille concourir.
Et nous vous les offrons, comme les témoignages De nos ſoûmiſſions, de nos humbles homages:	Et nous vous les offrons, comme les témoignages De nos soumission, de nos humbles homages:
Nous les portons au lieu duquel ils ſont venus, Comme vn iuſte deuoir, dont nous ſommes tenus, Noſtre ſtérilité ſe rend ainſi féconde, Sans que nous en ſoyons que la cauſe ſeconde;	Nous les portons au lieu duquel ils sont venus, Comme un juste devoir, dont nous sommes tenus, Notre stérilité se rend ainsi féconde, Sans que nous en soyons que la cause seconde;
Et dans ces larges dons que voſtre main départ, Sans nulle exception chacun peut prendre part:	Et dans ces larges dons que votre main départ, Sans nulle exception chacun peut prendre part:
Car comme vn bien immenſe & qui tout autre excede, Vous vous offrés à tous, qui vous veut vous poſſede.	Car comme un bien immense et qui tout autre excède, Vous vous offrez à tous, qui vous veut vous possède.
Faites donc, Dieu d’amour, s’il ſe faut expliquer, Que cette volonté ne ſe puiſſe appliquer, Qu’aux préceptes diuins que voſtre loy m’impoſe, Qu'elle aime tout en vutts, & vous en toute choſe.	Faites donc, Dieu d'amour, s'il se faut expliquer, Que cette volonté ne se puisse appliquer, Qu'aux préceptes divins que votre loi m'impose, Qu'elle aime tout en utz, et vous en toute chose.
QVATRIESME PARTIE.	QUATRIÈME PARTIE.
PREMIER ENTRETIEN.	PREMIER ENTRETIEN.
DIOCLETIAN, MACEDONE,	DIOCLETIAN, MACEDONE,
DIOCLETIAN.	DIOCLETIAN.
Eauté pleine de fard, offuſquante ſplendeur, DPompeux deguiſement, affaiſſante grandeur, Geſne de noſtre eſprit, trouble de noſtre vie Fatale dignité!	Eauté pleine de fard, offusquante splendeur, DPompeux déguisement, affaissante grandeur, Gêne de notre esprit, trouble de notre vie Fatale dignité!
qu’à grand tort l’on t’enuie.	qu'à grand tort l'on t'envie.
Ceux qui trouuent en toy tant de charmans appas, Teſmo ignent clairement ne te conoiſtre pas.	Ceux qui trouvent en toi tant de charmants appas, Témo ignent clairement ne te conoistre pas.
Tu parois éclatante, & ta lumiere eſt ſombre;	Tu parais éclatante, et ta lumière est sombre;
Ponte prend pour vn corps, duquel tu n’és que l’ombre.	Ponte prend pour un corps, duquel tu n'ez que l'ombre.
Paruenir à l’Empire, eſt-ce pas ſe charger D’vn fardeau tres-peſant, pour vn bien fort leger?	Parvenir à l'Empire, est-ce pas se charger D'un fardeau très-pesant, pour un bien fort léger?
MACEDONE.	MACEDONE.
Ceux qui tiennent ce rang, ſans en eſtre capables, Ont des peines, Seigneur, qui ne ſont pas nombrables.	Ceux qui tiennent ce rang, sans en être capables, Ont des peines, Seigneur, qui ne sont pas nombrables.
Vn Cedre eſt à l’orage expoſé bien ſouuent, Qu’vne plante abaiſſée eſt à l’abri du vent.	Un Cette est à l'orage exposé bien souvent, Qu'une plante abaissée est à l'abri du vent.
Mais voſtre Majeſté, qu’autre ne peut atteindre, Eſtant crainte de tout, n’a point ſuiet de craindre.	Mais votre Majesté, qu'autre ne peut atteindre, Étant crainte de tout, n'a point sujet de craindre.
Le Soleil fait ſon tour, ſans rien apperceuoir, Qui n’aime ſes vertus, redoutant ſon pouuoir.	Le Soleil fait son tour, sans rien apercevoir, Qui n'aime ses vertus, redoutant son pouvoir.
Cét eſprit pénétrant, où la ſageſſe abonde, Sans trouble & ſans peril peut régir tout le monde;	Cet esprit pénétrant, où la sagesse abonde, Sans trouble et sans péril peut régir tout le monde;
C’eſt vn puiſſant Neptune, en cette grande mer, Capable d’adoucir tout ce qu’elle a d’amer:	C'est un puissant Neptune, en cette grande mer, Capable d'adoucir tout ce qu'elle a d'amer:
Quand le mal-heur pourra ſur ſa prudence mordre.	Quand le malheur pourra sur sa prudence mordre.
Alaudra le reloudre à voir tout en delorare,	Alaudra le reloudre à voir tout en délorare,
DIOCLETIAN L’Empire, entre mes mains eſt aſſez affermi Pour n’apprehender pas l’effort d’vn ennemi, I'entends d’vn Etranger;	DIOCLETIAN L'Empire, entre mes mains est assez affermi Pour n'appréhender pas l'effort d'un ennemi, J'entends d'un Étranger;
mais mon ſort eſt bien pire.	mais mon sort est bien pire.
Puis que mes Ennemis naiſſent dans mon Empire.	Puis que mes Ennemis naissent dans mon Empire.
SECOND ENTRETIEN.	SECOND ENTRETIEN.
DIOCLETIAN, MACEDONE, LE PREVOST, CLAVDE, MAXIME, SVSANNE.	DIOCLETIAN, MACEDONE, LE PRÉVÔT, CLAUDE, MAXIME, SUSANE.
LE PREVOST I’améne ces Chreſtiens à voſtre Majeſté, Seigneur, pour faire voir ſon ordre executé.	LE PRÉVÔT J'amène ces Chrétiens à votre Majesté, Seigneur, pour faire voir son ordre exécuté.
DIOCLETIAN Hé bien!	DIOCLETIAN Hé bien!
chers partiſans de ma haute fortune, Vous, auec qui ie tiens toute choſe commune;	chers partisans de ma haute fortune, Vous, avec qui Qui tiens toute chose commune;
Miniſtres genereux, fideles confidents, Qui dans mes intereſts eſtes les plus ardans:	Ministres généreux, fidèles confidents, Qui dans mes intérêts êtes les plus ardans:
L’inuiolable foy que vous m’auiez donnée, Triomphe maintenant, & ſe void couronnée.	L'inviolable foi que vous m'aviez donnée, Triomphe maintenant, et se voit couronnée.
L’on ne vous peut aſſez admirer & loüer;	L'on ne vous peut assez admirer et louer;
Ie ſerois trop ingrat de le deſauoüer:	Je serais trop ingrat de le désavouer:
Pour moy voſtre valeur tout obſtacle ſurmonte, Et ie me ſens couuert d’vn ombrage de honte, De n’auoir, en l’eſtat où vous m’auez reduit, Pour vos nobles trauaux, vn aſſez digne fruict.	Pour moi votre valeur tout obstacle surmonte, Et ie me sens couvert d'un ombrage de honte, De n'avoir, en l'état où vous m'avez réduit, Pour vos nobles travaux, une assez d' fruict.
Qu'vn Monarque a ſur nous vn pouuoir admirable Quand nous le conoiſſons courtois, benin, affable!	Qu'un Monarque a sur nous un pouuoir admirable Quand nous le conaissons courtois, bénin, affable!
Ces rares qualitez ont des charmes vainqueurs, Qui par vn doux effort conqueſtent rous les cœurs.	Ces rares qualités ont des charmes vainqueurs, Qui par un doux effort conquêtent rous les cœurs.
C’eſt dans l’art de regner la plus haute prudence:	C'est dans l'art de régner la plus haute prudence:
L’on ſert mieux par amour que par obeïſſance;	L'on sert mieux par amour que par obéissance;
Celle-cy trouue en nous vn courage endormi, Et ſeruir par deuoir, c’eſt ſeruir à demi.	Celle-cy trouve en nous un courage endormi, Et servir par devoir, c'est servir à demi.
Cent hommes de qui l’ame eſt d’ardeur enflamée, Font d’execution plus que toute vne armée, Dont les feints combatans ne feroient nul effort, S’ils n’auoient pour objet la crainte de la mort.	Cent hommes de qui l'âme est d'ardeur enflamée, Font d'exécution plus que toute une armée, Dont les feints combattants ne feraient nul effort, S'ils n'avaient pour objet la crainte de la mort.
Voſtre Majeſté docte en cette Politique, Nous en fait des leçons, par ce qu’elle prâtique.	Votre Majesté docte en cette Politique, Nous en fait des leçons, par ce qu'elle prâtique.
Puis que n’ayant rien fait elle nous traite ainſi, Qu’en faudroit-il attendre, ayant bien réuſſi?	Puis que n'ayant rien fait elle nous traite ainsi, Qu'en faudrait-il attendre, ayant bien réussi?
DIOCLETIAN N’ayant rien fait perfide!	DIOCLETIAN N'ayant rien fait perfide!
as-tu bien l’inſolence De déguiſer ton crimeauec tant d’aſſeurance?	as-tu bien l'insolence De déguiser ton crimeavec tant d'assurance?
Eſt-ce ainſi, Célérat, que dans ce digne employ Tu deuois ſignaler & ton zele & ta foy?	Est-ce ainsi, Célérat, que dans ce digne emploi Tu devais signaler et ton zèle et ta foi?
Par vne trahiſon faire éclater ton zele;	Par une trahison faire éclater ton zèle;
C’eſt vne inuention bien rare & bien nouuelle:	C'est une invention bien rare et bien nouvelle:
Situ peux ajuſter ces contrarietez, ret lais mipatier toutes les quuelitezo Et ie ne penſe pas qu’autre que toy nous die Que l’on preuue ſa foy par vne perſidie.	Situ peux ajuster ces contrariétés, ret ais mipatier toutes les quuelitéso Et grande ne pense pas qu'autre que toi nous die Que l'on preuve sa foi par une persidie.
CLAVDE Oſerois-je, Seigneur, encore repartir?	CLAUDE Oserai-je, Seigneur, encore répartir?
DIOCLETIAN Oüy, ie tele permets;	DIOCLETIAN Oui, je te permets;
mais parle ſans mentir.	mais parle sans mentir.
Quoy que ſenſiblement ce changement m’attriſte, De me voir difamer par mon Panegiriſte, L’on ne m’entendra point plaindre ny murmurer:	Quoi que sensiblement ce changement m'attriste, De me voir diamer par mon Panégiriste, L'on ne m'entendra point plaindre ni murmurer:
Vous pouuez m’outrager & ie dois l’endurer, Ie ſçay ce que ie ſuis, ie ſçay ce que vous eſtes, Et que les membres ſont inferieurs aux teſtes:	Vous pouvez m'outrager et ainsi dois l'endurer, Je sais ce que ie suis, toujours sais ce que vous êtes, Et que les membres sont inférieurs aux têtes:
Ces diferens degrez, que i’obſerue entre nous, M’obligent à cherir tout ce qui vient de vous.	Ces diferens degré, que j'observe entre nous, M'obligent à chérir tout ce qui vient de vous.
Mais vne autre raiſon, qui ſoulage ma peine, C’eſt d’eſtre innocemment digne de voſtre haine.	Mais une autre raison, qui soulage ma peine, C'est d'être innocemment digne de votre haine.
Mon cœur à mon deuoir puiſſamment attaché, Se ſent, en ce regard, ſans tâche ny peché.	Mon cœur à mon devoir puissamment attaché, Se sent, en ce regard, sans tâche ni péché.
Pour vous ſeruir, ma foy s’eſt conſeruée entiere;	Pour vous servir, ma foi s'est conservée entière;
Et ſi vous m’en auez offert vne matiere, Dans la légation où d’ardeur ie vollois, I’ay fait ce que i’ay deû, non ce que ie voulois.	Et si vous m'en avez offert une matière, Dans la légation où d'ardeur ie vollois, ay fait ce que ay deû, non ce que ie voulois.
Quand de mes actions il faudra rendre conte, L’on ne me verra point le front couuert de honte.	Quand de mes actions il faudra rendre conte, L'on ne me verra point le front couvert de honte.
Rome n’ignore pas de quel air i’ay vécu, Ie puis eſtre accuſé;	Rome n'ignore pas de quel air j'ai vécu, Je puis être accusé;
mais non pas conuaincu.	mais non pas convaincu.
Le ſuccez incertain trompant voſtre eſperance, Produit-il des teſmoins contre mon innocence?	Le succès incertain trompant votre espérance, Produit-il des témoins contre mon innocence?
S’il vous fournit aſſez dequoy la condamner, C’eſt en vain diſcourir, c’eſt en vain raiſonner.	S'il vous fournit assez dequoy la condamner, C'est en vain discourir, c'est en vain raisonner.
Sur moy voſtre pouuoir eſt grand & legitime;	Sur moi votre pouvoir est grand et légitime;
Et ſi voſtre courroux demande vne victime, Ilſe peut ſatisfaire & s’immoler ce corps:	Et si votre courroux demande une victime, Ilse peut satisfaire et s'immoler ce corps:
En mourant innocent ie mourray ſans remords.	En mourant innocent appris mourrai sans remords.
Mon courage mépriſe & le fer & la flame, Agiſſant ſur le corps, ils ne bleſſent point l’ame.	Mon courage méprise et le fer et la flamme, Agissant sur le corps, ils ne blessent point l'âme.
Ce diſcours plein d’orgueil, & ce zele indiſcret, Montrent publiquement ce que tu crois ſecret.	Ce discours plein d'orgueil, et ce zèle indiscret, Montrent publiquement ce que tu crois secret.
Voylà de nos Chreſtiens le ſtile & l’artifice;	Voilà de nos Chrétiens le style et l'artifice;
Ils mépriſent la mort, ſe mocquent du ſuplice, A ſouffrir des tourmens leur corps eſt toûjours preſt, Et l’ame, diſent-ils, fait tout leur intereſt.	Ils méprisent la mort, se moquent du supplice, A souffrir des tourments leur corps est toujours prêt, Et l'âme, disent-ils, fait tout leur intérêt.
Comme ſi l’ame eſtoit tellement aſſortie, Qu’elle n’eût pas beſoin de cette autre partie:	Comme si l'âme était tellement assortie, Qu'elle n'eût pas besoin de cette autre partie:
Que chacune à part ſoy ſentit ſes paſſions, Et pût ſeule exercer toutes ſes fonctions:	Que chacune à part soi sentit ses passions, Et pût seule exercer toutes ses fonctions:
Qu’eſtans dans vne intime & parfaite alliance, L’ame prît part au bien;	Qu'étant dans une intime et parfaite alliance, L'âme prît part au bien;
& non à la ſouffrance:	et non à la souffrance:
Que l’on n’eût iamais veu par les douleurs du corps, Rompre leur armonie & troubler leurs accords:	Que l'on n'eût jamais vu par les douleurs du corps, Rompre leur armonie et troubler leurs accords:
Qu’en ce monde il reſtât quelque vſage de l’ame, Apres que le corps eſt conſummé dans la flame:	Qu'en ce monde il restât quelque usage de l'âme, Après que le corps est consummé dans la flamme:
Qu’enfin, ce rude effort qui les fait deſvnir, Ne nous mît pas au poinct qu’on appelle finir.	Qu'enfin, ce rude effort qui les fait desvnir, Ne nous mett pas au point qu'on appelle finir.
Les puiſſantes leçons, que t’a fait cette belle!	Les puissantes leçons, que t'a fait cette belle!
Puis qu’elles te font eſtre à toy-meſme infidelle:	Puis qu'elles te font être à toi-même infidèle:
Que pour les pratiquer, par vn crime odieux, L’on te void lâchement renoncer à tes Dieux.	Que pour les pratiquer, par un crime odieux, L'on te voit lâchement renoncer à tes Dieux.
Mais elle n’en doit pas auoir la gloire entiere;	Mais elle n'en doit pas avoir la gloire entière;
Iaperfidie, ingrat, prepara la matiere:	Japerfidie, ingrat, prépara la matière:
Elle ne peut pretendre en ce qui s’eſt paſſé Que l’accompliſſement d’vn œuure commencé.	Elle ne peut prétendre en ce qui s'est passé Que l'accomplissement d'être œuvre commencé.
Lors que tu me quittai pour luy rendre viſite, Ton viſage & ta voix marquoient vn hypocrite:	Lors que tu me quittai pour lui rendre visite, Ton visage et ta voix marquaient un hypocrite:
Tu me dis ſeulement, pour ne paroître vain, Vſez en Empereur, enuers vn vray Romain.	Tu me dis seulement, pour ne paraître vain, Vsez en Empereur, envers un vrai Romain.
De prendre ce beau titre eus-tu l’éfronterie, Pour en te diffamant diffamer ta Patrie?	De prendre ce beau titre eus-tu l'éfronterie, Pour en te diffamant diffamer ta Patrie?
Qui peut à ſon honneur donner vn coup mortel, S’il eſtoit vray Romain, il ceſſe d’eſtre tel.	Qui peut à son honneur donner un coup mortel, S'il était vrai Romain, il cesse d'être tel.
Ce nom, qui ne conuient qu’aux eſprits magnanimes, Ne peut ſimpatiſer auec les moindres crimes.	Ce nom, qui ne convient qu'aux esprits magnanimes, Ne peut simpatiser avec les moindres crimes.
Rome, qui de tout temps fait haute vanité De n’auoir point d’égale en ſa fidelite, Te peut-elle auoüer, ame vile & de boüe?	Rome, qui de tout temps fait haute vanité De n'avoir point d'égale en sa fidélité, Te au-elle auoüer, âme vile et de bannée?
Ne te dis plus Romain, Rome te deſauoüe.	Ne te dis plus Romain, Rome te désavoue.
CLAVDE En me deſauoüant, l’on verroit auiourd’huy, Que reome detrunoitee qui fut ſon appuy:	CLAUDE En me desauoüant, l'on verrait aujourd'hui, Que reome détrunoite qui fut son appui:
C’eſt vne verité, Seigneur, que i’oſe dire, Que mon bras à ſerui de coiomie arEipnes	C'est une vérité, Seigneur, que j'ose dire, Que mon bras à servi de coiomie arÉjpnes
DIOCLETIAN Ne nous deuoit-il pas du moins ce qu’il a fait?	DIOCLETIAN Ne nous devait-il pas du moins ce qu'il a fait?
CLAVDE S’il vous deuoit beaucoup il a bien ſatisfair.	CLAUDE S'il vous devait beaucoup il a bien satisfair.
Evdecette pemcea prelenle le ile urere, Que mon honneur eſt quitte, & que Rome eſt ingratte.	Évecette pemcea prenle le île ure, Que mon honneur est quitte, et que Rome est ingrate.
DIOCLETIAN La ſçauroit-on blâmer d’haïr vn Apoſtat?	DIOCLETIAN La saurait-on blâmer d'haïr un Apostat?
CLAVDE.	CLAUDE.
Mon corps, comme mes biens, dépend de voſtre Etat!	Mon corps, comme mes biens, dépend de votre État!
Mais mon ame, Seigneur, qui du Ciel tient ſon eſtre.	Mais mon âme, Seigneur, qui du Ciel tient son être.
ii voitre uuuionte ne ſe doit pas ſoûmettre.	ji voitre uvionte ne se doit pas soumettre.
DIOCLETIAN Mon pouuoir n’eſt-il pas à celuy des Dieux ioint?	DIOCLETIAN Mon pouvoir n'est-il pas à celui des Dieux joint?
MAXIME.	MAXIME.
C’eſt, en diſant des Dieux, dire n’en auoir point.	C'est, en disant des Dieux, dire n'en avoir point.
mipie:	mipie:
oles-tu bien me tenir ce langage?	oles-tu bien me tenir ce langage?
MAXIME Le ſouuerain pouuoir iamais ne ſe partage.	MAXIME Le souuerain pouvoir jamais ne se partage.
Multiplier les Dieux, c’eſt raiſonner tres-mal, L’vn n’eſt pas ſouuerain, où l’eſt ſur ſon égal;	Multiplier les Dieux, c'est raisonner très -mal, L'un n'est pas souverain, où l'est sur son égal;
S’il l’eſt il détruit l’autre, & n’a point de ſemblable.	S'il l'est il détruit l'autre, et n'a point de semblable.
SVSANNE velgneur, ce ſentiment n'eſt-il pas raiſonnable?	SUSANE velgneur, ce sentiment n'est-il pas raisonnable?
Et ne pourroit-il point vous retirer d’erreur?	Et ne pourrait-il point vous retirer d'erreur?
CLAVDE Vn Empire, Seigneur, n’admet qu’vn Empereur?	CLAUDE Un Empire, Seigneur, n'admet qu'un Empereur?
Comme il eſt tout-puiſſant, il faut qu’il ſoit vnique.	Comme il est tout-puissant, il faut qu'il soit unique.
DIOCLETIAN Ce beau raiſonnement, où voſtre eſprit s’applique, N’eſt point aſſez preſſant pour faire conceuoir, Qu’il ne ſoit qu’vn ſeul Dieu, de ſouuerain pouuoir.	DIOCLETIAN Ce beau raisonnement, où votre esprit s'applique, N'est point assez pressant pour faire concevoir, Qu'il ne soit qu'un seul Dieu, de souuerain pouvoir.
Lors que Rome offre aux ſiens de pieux ſacrifices, Pour ſelon ſes beſoins ſe les rendre propices;	Lors que Rome offre aux siens de pieux sacrifices, Pour selon ses besoins se les rendre propices;
Elle croid que chacun diſpoſe abſolument, De l'état des mortels;	Elle crois que chacun dispose absolument, De l'état des mortels;
mais c’eſt diſtinctement.	mais c'est distinctement.
L’vn domine la mer, l’autre régit la terre, Celuy cy regne en paix, l’autre preſide en guerre, Et dans leurs fonctions, chacun d’eux agiſſant, N’en détruit poinct vn autre & paroît tout-puiſſant.	L'un domine la mer, l'autre régit la terre, Celui cy igné en paix, l'autre préside en guerre, Et dans leurs fonctions, chacun d'eux agissant, N'en détruit point autre et paraît tout-puissant.
C’eſt inutilement que tu viens de nous dire Qu'vn vnique Empereur diſpoſe d’vn Empire:	C'est inutilement que tu viens de nous dire Qu'un unique Empereur dispose d'un Empire:
Vn autre en ſon Empire eſt-il moins ſouuerain, Parce que ie le ſuis dans l’Empire Romain?	Un autre en son Empire est-il moins souverain, Parce que je le suis dans l'Empire Romain?
CLAVDE Ha!	CLAUDE Ha!
les foibles raiſons que voſtre eſprit oppoſe!	les faibles raisons que votre esprit oppose!
Celuy là peut il tout qui ne peut qu’vne choſe?	Celui là peut -il tout qui ne peut qu'une chose?
Et ne faites vous pas de ridicules Dieux, Quand vous les limités par les temps & les lieux?	Et ne faites -vous pas de ridicule Dieux, Quand vous les limités par les temps et les lieux?
Quel pouuoir aura donc ſur la terre Neptune?	Quel pouvoir aura donc sur la terre Neptune?
Sur la mer Iupiter?	Sur la mer Jupiter?
voſtre Dieu de fortune.	votre Dieu de fortune.
Aquoy s’occupe Mars dans la tranquilité?	Aquoi s'occupe Mars dans la tranquillité?
Et le Dieu de la paix, quand Mars eſt agité?	Et le Dieu de la paix, quand Mars est agité?
Ce monde ſe partage entre vn grand nombre d’hommes Parce que déffaillans & foibles que nous ſommes, Rien n’eſt par nous regi, conduit & gouuerné, Que proportionnément à noſtre eſprit borné.	Ce monde se partage entre un grand nombre d'hommes Parce que défaillants et faibles que nous sommes, Rien n'est par nous régi, conduit et gouverné, Que proportionnément à notre esprit borné.
Mais, Dieu, qui créa tout par ſa ſeule parole, Qui voit inceſſemment de l’vn à l’autre Pole, Qui des Cieux aſurés regle les mouuemens, Qui fait ſubſiſter l’ordre entre les Elemens, Dont la Iuſtice éclatte au profond des abîmes, Et là miſericorde aux lieux les plus ſublimes;	Mais, Dieu, qui créa tout par sa seule parole, Qui voit incessemment de l'un à l'autre Pole, Qui des Cieux assurés règle les mouvements, Qui fait subsister l'ordre entre les Éléments, Dont la Justice éclate au profond des abîmes, Et là miséricorde aux lieux les plus sublimes;
De tant d’Etas diuers compoſe vn ſeul Etat, Duquel il ſe fait voir l’auguſte Potentat.	De tant d'Étas divers compose un seul État, Duquel il se fait voir l'auguste Potentat.
MAXIME Seigneur, cette raiſon vous met hors de defence;	MAXIME Seigneur, cette raison vous met hors dé fors;
Peut on admettre vn Dieu qui ne ſoit pas immenſe?	Peut on admettre un Dieu qui ne soit pas immense?
Et comment établir en luy l’immenſité, Si par les droits d’vn autre il eſtoit limité?	Et comment établir en lui Madimmensité, Si par les droits d'un autre il était limité?
Apperceués, Seigneur, quelle erreur eſt la voſtre, Et ne conteſtés plus que l’vn detruiroit l’autre:	Apercevez, Seigneur, quelle erreur est la vôtre, Et ne contestez plus que l'un détruirait l'autre:
Qu’il faut qu’il ſoit vnique;	Qu'il faut qu'il soit unique;
& que c’eſt l’vnité Qui faitit iondement de la diuinité, Dont l’extreme puiſſance & ſageſſe infinie De tout cet vniuers entretient l’armonie.	et que c'est l'vnité Qui faitit iondement de la divinité, Dont l'extrême puissance et sagesse infinie De tout cet univers entretient l'armonie.
Et pour abréuier ce que nous en dirons, C’eſt le Dieu des Chrétiens, lequel nous adorons.	Et pour abréuier ce que nous en dirons, C'est le Dieu des Chrétiens, lequel nous adorons.
DIOCLETIAN	DIOCLETIAN
DIOCLETIAN C’eſt aſſes diſcouru;	DIOCLETIAN C'est asses discouru;
que de leur chair roſtie, L'on faſſe ſacrifice aux Dieux, au Port d’Oſtie:	que de leur chair rôtie, L'on fasse sacrifice aux Dieux, au Port d'Ostie:
Et leurs cendres eſtant indignes du Tombeau, Pour n’en reſeruer rien, qu’on les iette dans l’eau.	Et leurs cendres étant indignes du Tombeau, Pour n'en réserver rien, qu'on les jette dans l'eau.
Vous, reſtés au Palais, auec l’Imperatrice.	Vous, restez au Palais, avec l'Impératrice.
Heureuſe tirannie!	Heureuse tyrannie!
ClAvDE	ClAvDE
MAXIME Agréable iniuſtice!	MAXIME Agréable injustice!
SVSANNE Courage mes amis, c’eſt le chemin des Cieux, Ha!	SUSANE Courage mes amis, c'est le chemin des Cieux, Ha!
que de voſtre ſort l’on doit eitre endieux!	que de votre sort l'on doit eitre endieux!
CLAVDE canoit ce les norreuis n'on nen qui m'intimide.	CLAUDE canait ce les norreuis n'on nen qui m'intimide.
YSANNÉ Plût à Dieu deuſſe ie vous y ſeruir de guide.	YSANN Plût à Dieu dusse ie vous y servir de guide.
MAXIME Vous le faites Madame, pres Dieu nous deurons, Avos ſoins tout le bien que nous en receurons.	MAXIME Vous le faites Madame, pres Dieu nous devrons, Avos soins tout le bien que nous en recevrons.
Emmenés les.	Emenez -les.
DiodeEenia	DiodeEénia
LE PREVOSI Marchés.	LE PREUOSI Marchés.
DIOCLETIAN Leur conſtance m'irfite.	DIOCLETIAN Leur constance m'irfite.
CLAVDE Dans le chemin du Ciel peur on aller trop vîté	CLAUDE Dans le chemin du Ciel peur on aller trop vîté
SVSANNE Aumoins ſouuenés vous eſtant en ce ſainct lieu, l'offrir en ma faueur vos ſacrés veux à Dieu.	SUSANNE Aumoins souvenez vous étant en ce saint lieu, l'offrir en ma faveur vos sacrés veux à Dieu.
MAXIME, s’en allant.	MAXIME, s'en allant.
l'our oubſier ce ſoin il eſt trop legitime.	l'our oubsier ce soin il est trop légitime.
DIOCLETIAN Voſtre beauté, ma fille, excuſe voſtre crime.	DIOCLETIAN Votre beauté, ma fille, excuse votre crime.
Allons.	Allons.
SVSANNE Ta!	SUSANE -Ta!
que i’aurois de funeſtes appas Si i’euitois par eux vn ſemblable trepas,	que j'aurais de funestes appas Si j'évitais par eux un semblable trépas,
SOLILOQVE de	SOLILOQUE de
MAXIMIAN Doux & charmant deſir, eſperance flatteuſe, Qui cauſés les tranſports de mon ame amoureuſe, Aquoy la portés vous d’vn violent effort?	MAXIMIAN Doux et charmant désir, espérance flatteuse, Qui causez les transports de mon âme amoureuse, Aquoi la portés vous d'un violent effort?
N’eſt-ce pas à pourſuiure ardamment voſtre mort?	N'est-ce pas à poursuivre ardamment votre mort?
Ouelques impreſſions que vous faſſiés en elle, C’eſt agir contre vous, leur fin vous eſt mortelle.	Ouelques impressions que vous fasiez en elle, C'est agir contre vous, leur fin vous est mortelle.
Vous n’eſtes que les fleurs dont elle attend les fruicts.	Vous n'êtes que les fleurs dont elle attend les fruits.
Peut-elle vous aimer que pour vous voir détruits?	Peut-elle vous aimer que pour vous voir détruits?
Genereux mouuemens, auſſi deués vous croire Qu’vne pareille fin aſſeure voſtre gloire:	Généreux mouvements, aussi devez vous croire Qu'une pareille fin assure votre gloire:
C’eſt le plus beau deſtin où vous ſoyés ſoumis, Qui vous fait triompher de vos fiers ennemis.	C'est le plus beau destin où vous soyez soumis, Qui vous fait triompher de vos fiers ennemis.
Tres heureux qui paruient au but de ſon enuie!	Très heureux qui parvient au but de son envie!
Cette mortrout tuite vne honteuſe vie.	Cette mortrout tuite une honteuse vie.
Donc nobles Paſſions qui venés m’émouuoir!	Donc nobles Passions qui venez m'émouvoir!
Par vn dernier effort môntrés vôtre pouuoir.	Par un dernier effort môntrés votre pouvoir.
Impatient deſir & flateuſe eſperance!	Impatient désir et flatteuse espérance!
L’on ne vous ſatis fait que par la ioüiſſance, Et puis qu’elle vous eſt vn digne monument, Mourés, pour voſtre gloire & mon contentement.	L'on ne vous satî fait que par la jouissance, Et puis qu'elle vous est un digne monument, Mourz, pour votre gloire et mon contentement.
TROISIESME ENTRETIEN.	TROISIÈME ENTRETIEN.
CVRCE, MAXIMIAN.	CURÉE, MAXIMIAN.
CVRCE Ie viens vous anoncer d’agreables nouuelles;	CURÉE Je viens vous anoncer d'agréables nouvelles;
Dé Suſanne, Seigneur, ce miracle des belles:	Dé Susanne, Seigneur, ce miracle des belles:
LEmpereur, au Palais vient de la retenir, Pour en voſtre faueur la faire entretenir.	LEmpereur, au Palais vient de la retenir, Pour en votre faveur la faire entretenir.
,	,
MAXIMIAN Et les nouueaux Chreſtiens?	MAXIMIAN Et les nouveaux Chrétiens?
CYNCE Seigneur, Claude & Maxime Par la flamme bien-toſt vont expier leur crime.	CYNCE Seigneur, Claude et Maxime Par la flamme bientôt vont expier leur crime.
MAXIMIAN O vous!	MAXIMIAN Ô vous!
de nos ſaints vœux les éternels objets, De qui les plus puiſſans ne ſont qu’humbles ſuiets!	de nos saints vœux les éternels objets, De qui les plus puissants ne sont qu'humbles sujets!
Voyez que mon amour a des effets ſublimes, De luy vous receuez de célébres victimes, Sa gloire fait la voſtre, & vos ſacrez Autels N’eurent iamais le ſang de plus dignes mortels.	Voyez que mon amour a des effets sublimes, De lui Vous recevez de célèbres victimes, Sa gloire fait la vôtre, et vos sacrez Autels N'eurent jamais le sang de plus dignes mortels.
Si l’on vous peut toucher par ces grands ſacrifices, Regardez qui les fait & luy ſoyez propices.	Si l'on vous peut toucher par ces grands sacrifices, Regardez qui les fait et ton soyez propices.
Inſpirez à Suſanne vn ſentiment plus doux;	Inspirez à Susanne un sentiment plus doux;
En me fauoriſant vous agiſſez pour vous, Nos intereſts ſont ioints;	En me favorisant vous agissez pour vous, Nos intérêts sont joints;
ſi nous n’auons le meſme, Dieux!	si nous n'avons le même, Dieux!
elle vous adore à l’inſtant qu’elle m’aime.	elle vous adore à l'instant qu'elle m'aime.
L’amour confondles cœurs, en compoſe vn de deux, Par la conformité de deſirs & de vœux:	L'amour confondles cœurs, en compose un de deux, Par la conformité de désirs et de vœux:
Si mon feu la réchaufe & qu’elle y participe, Les noſtres agiront par vn meſme principe, Et le mien demeurant à vous ſeruir conſtant, Sans doute obligera le ſien d’en faire autant.	Si mon feu la réchauffe et qu'elle y participe, Les nôtres agiront par un même principe, Et le mien demeurant à vous servir constant, Sans doute obligera le sien d'en faire autant.
Allons à ſa froideur expoſer noſtre flame;	Allons à sa froideur exposer notre flamme;
Dieux, faites que des yeux elle pénetre à l’ame.	Dieux, faites que des yeux elle pénetre à l'âme.
QVATRIESME ENTRETIEN.	QUATRIÈME ENTRETIEN.
SVSANNE, SERENE.	SUSANE, SERENE.
SVSANNE Madame, ces faueurs ſurprennent ma raiſon.	SUSANE Madame, ces faveurs surprennent ma raison.
Ie trouue le refuge au lieu de la priſon, Ce qui ſembloit ma perte a diſſipé ma crainte, Pour me faire idolâtre on employe vne ſaincte.	Je trouve le reste au lieu de la prison, Ce qui semblait ma perte a dissipé ma crainte, Pour me faire idolâtre on emploie une sainte.
Et ces éuénemens, ſi grands, ſi merueilleux, Sont des ſecrets de Dieu, lequel i’adore en eux.	Et ces événements, si grands, si merveilleux, Sont des secrets de Dieu, lequel j'adore en eux.
SERENE Nous conoiſſons combien ſa bonté ſouueraine A de moyens couuerts à la prudence humaine.	SERENE Nous conaissons combien sa bonté souveraine A de moyens couverts à la prudence humaine.
D’vn mal tout apparent il tire vn bien caché, Et cét ordre inconû ne peut eſtreempeſché.	D'un mal tout apparent il tire un bien caché, Et cet ordre inconu ne peut estreempesché.
Noſtre foibleſſe en vain à ſes deſſeins s’oppoſe, Il détruit les projects que l’homme ſe propoſe:	Notre faiblesse en vain à ses desseins s'oppose, Il détruit les projéts que l'homme se propose:
Et celuy-cy reſtant dans la ſtupidité, Impute vn coup du Ciel à la fatalité.	Et celui-cy restant dans la stupidité, Impute un coup du Ciel à la fatalité.
L’Empereur étonné que voſtre reſiſtance Ait généreuſement épuiſé ſa puiſſance, Apres auoir tenté iuſqu’au dernier effort, Ne ſçait qui quereller, ou ſes Dieux, ou le ſort, Il n’oſe pas blâmer les premiers d’iniuſtice.	L'Empereur étonné que votre résistance Ait généreusement épuisé sa puissance, Apres avoir tenté jusqu'au dernier effort, Ne sait qui quereller, ou ses Dieux, ou le sort, Il n'ose pas blâmer les premiers d'injustice.
L’autre eſt, dit-il, aueugle & fait tout par caprice, Confond les qualitez, & ſans dicernement, Rend maiſtre le hazard de chaque éuenement.	L'autre est, dit-il, aveugle et fait tout par caprice, Confond les qualités, et sans dicernement, Rend maître le hasard de chaque événement.
Helas!	Hélas!
s’il s’éleuoit au deſſus de ſoy-meſme, Qu’il portât ſon eſprit vers cét Eſtre ſupréme, Duquel la volonté n’eſt iamais ſans effet, Qu’il raiſonneroit bien autrement qu’il ne fait!	s'il s'élevait au dessus de soi-même, Qu'il portât son esprit vers cet Être suprême, Duquel la volonté n'est jamais sans effet, Qu'il raisonnerait bien autrement qu'il ne fait!
SVSANNE Mais durant ce repos, dont mon eſprit ſe flatte, Ie dois apprehender que ſon courroux éclatte;	SUSANE Mais durant ce repos, dont mon esprit se flatte, Je dois appréhender que son courroux éclatte;
Madame, vous ſçauez que peut vn Empereur, Qui pour loy ſeule admet celle de ſa fureur.	Madame, vous savez que peut un Empereur, Qui pour loi seule admet celle de sa fureur.
Encét heureux état ie demeure en balance:	Encet heureux état mieux demeure en balance:
l’eſpere en vos bontez, & crains ſa violence.	l'espère en vos bontés, et crains sa violence.
SERENE Cette crainte, ma fille, à preſent doit finir, Ayant préueu le mal, i’ay ſçeu le préuenir:	SERENE Cette crainte, ma fille, à présent doit finir, Ayant prévu le mal, j'ai su le prévenir:
Ie vous ay deuant luy tellement abaiſſée, Qu’il ne vous luge pitis dignle de la pemnee.	Je vous ai devant Seigneur tellement abaissée, Qu'il ne vous luge pitis dignle de la pemnée.
Et par ces feints mépris ſon eſprit diuerty, forme vn nouueau deſſein pour vn autre party.	Et par ces feints mépris son esprit diverti, forme un nouveau dessein pour un autre parti.
Vous pouuez librement aller chez voſtre pere.	Vous pouvez librement aller chez votre père.
SVSANNE Le rémunerateur, auquel mon ame eſpere, Pour vous recompenſer de ſi rares bien-faits, Veüille accomplir les vœux que pour vous ie luy faits.	SUSANNE Le rémunérateur, auquel mon âme espère, Pour vous récompenser de si rares bienfaits, Veuille accomplir les vœux que pour vous ie luy faits.
D iij	 Dijà
CINQVIESME ENTRETIEN.	CINQUIÈME ENTRETIEN.
MAXIMIAN, SERENE, SVSANNE.	MAXIMIAN, SERENE, SUSANNE.
MAXIMIAN Si ie vous interromps en cette conférence, Ne me condemnez pas ſans ouſl ina derence:	MAXIMIAN Si ici vous interromps en cette conférence, Ne me condemnez pas sans ousl ina derence:
Traitez ma paſſion d’égal à mon reſpect.	Traitez ma passion d'égal à mon respect.
SERENE Ne craignez pas, Monſieur, de nous eſtre ſuſpect, Noſtre entretien n’a rien que l’on ne vous partage.	SEIGNEUR , craignez pas, Monsieur, de nous être suspect, Notre entretien n'a rien que l'on ne vous partage.
MAXIMIAN Madame, ſi chacun aime ſon auentage, Si le malade doit chercher ſa gueriſon, Ie ne vous interromps qu’auec double raiſon;	MAXIMIAN Madame, si chacun aime son aventage, Si le malade doit chercher sa guérison, Je ne vous interromps qu'avec double raison;
Puis que l’vne de vous poſſede le remede, Que ie n’oſe eſperer, ſi l’autre n’intercede.	Puis que l'une de vous possède le remède, Que tu n'ose espérer, si l'autre n'interçède.
SVSANNE Mioneur, voitte dicotns a de robieunte;	SUSANE Mioneur, voitte dicotns a de robieunte;
L’on n’intercede point qu’en inégalité:	L'on n'intercede point qu'en inégalité:
C’eſt le moindre au plus grand qui fait demander grace, Et peut-on rencontrer quelqu’vn qui vous ſurpaſſe?	C'est le moindre au plus grand qui fait demander grâce, Et peut-on rencontrer quelqu'un qui vous surpasse?
MAXIMIAN A quelque ſi haut rang que le Deſtin m’ait mis, Mon cœur fait vanité de vous eſtre ſoûmis, Et croid ne ſe pouuoir montrer plus magnanime, Qu’en oſant déſirer l’honneur de voſtre eſtime:	MAXIMIAN À quelque si haut rang que le Destin m'ait mis, Mon cœur fait vanité de vous être soumis, Et croid ne se pouvoir montrer plus magnanime, Qu'en osant désirer l'honneur de votre estime:
Il la pourſuit, Madame, & s’il la peut gaigner, Sa gloire eſt préférable à celle de regner.	Il la poursuit, Madame, et s'il la peut gagner, Sa gloire est préférable à celle de régner.
Approuuez les tranſports de ce cceur qui ſoûpire, ingez digne de vous ce qui l'eſt de l'Empite Et ſi vous mépriſez l’Empire & la grandeur, Au moins loyez leniipie à ma noeſle ardeur.	Approuvez les transports de ce coeur qui soupire, ingez digne de vous ce qui l'est de l'Empite Et si vous méprisez l'Empire et la grandeur, Au moins loyez leniipie à ma noèle ardeur.
SVSANNE En ce premier aſpect, où ie vous conſidere, Il eſt iuſte, Monſieur, que chacun vous réuére:	SUSANE En ce premier aspect, où je vous considère, Il est juste, Monsieur, que chacun vous révère:
Au titre de Ceſar, illuſtre & ſomptueux, On vous doit regarder d’vn œil reſpectueux:	Au titre de César, illustre et somptueux, On vous doit regarder d'un œil respectueux:
Ce droit vous elt acquis, aucui le le conteſte;	Ce droit vous elt acquis, aucui le le conteste;
Mais ne m’obligez point à vous répondre au reſte.	Mais ne m'obligez point à vous répondre au reste.
MAXIMIAN Traitez-vous mon amour de cette indignité?	MAXIMIAN Traités-vous mon amour de cette indignité?
SVSANNE Pouuez-vous aim er bien, eſtant ſans Charité?	SUSANE Pouvez-vous aim er bien, étant sans Charité?
MAXIMIAN rouuez-vous n'aimer pas entant n'Charitable?	MAXIMIAN rouvez-vous n'aimer pas entant n'Charitable?
SVSANNE Qui ſe vante d’aimer doit en eſtre capable.	SUSANE Qui se vante d'aimer doit en être capable.
MAXIMIAN Quelle incapacité découurez-vous en moy?	MAXIMIAN Quelle incapacité découvrez-vous en moi?
SIEMAMCE Le veritable amour préſupoſe la foy.	SIEMCE Le véritable amour présupose la foi.
MAXIMIAN Mon amoura pour but la foy du Mariage.	MAXIMIAN Mon amoura pour but la foi du Mariage.
SVSANNE Celle-là n’vnit pas ceux que l’autre partage.	SUSANE Celle-là n'unit pas ceux que l'autre partage.
Commancez par la foy pour la Diuinité;	Commancez par la foi pour la Divinité;
L’vnion ne ſe fait que par ſon vnité:	L'union ne se fait que par son unité:
Aimez le Créateur auant la créature.	Aimez le Créateur avant la créature.
MAXIMIAN Mon amour eſt trop fort pour changer de Nature.	MAXIMIAN Mon amour est trop fort pour changer de Nature.
SVSANNE On ne peut aimer mieux qu’aimant tout en ſon Dieu.	SUSANE On ne peut aimer mieux qu'aimant tout en son Dieu.
D iiij	 Dijà
MAXIMIAN Aimer parfaitement, c’eſt aimer lans milieu.	MAXIMIAN Aimer parfaitement, c'est aimer lans milieu.
SVSANNE Sans ce milieu, Monſieur, voſtre Pourpre Romaine Receura mes reſpects, & voſtre amour ma haine.	SUSANE Sans ce milieu, Monsieur, votre Pourpre Romaine Recra mes respects, et votre amour ma haine.
SERENE Changez, ne la pouuant à vos deſirs ranger.	SERENE Changez, ne la pouvant à vos désirs ranger.
Al friliſ Pirre gen allant, Oüy, Madame, bien-toſt l’on me verra changer,	Al frilis Pyrre gen allant, Oui, Madame, bientôt l'on me verra changer,
SERENE Dieu, pour voſtre repos, veüille qu’il vous mépriſe!	SERENE Dieu, pour votre repos, veuille qu'il vous méprise!
SCOANSNVE.	SOCANSNVE.
Et toûjours ſa bonté vos deſſeins fauoriſe.	Et toujours sa bonté vos desseins favorise.
CINQVIESME PARTIE, REMIER ENTRETIEN.	CINQUIÈME PARTIE, REMIER ENTRETIEN.
DIOCLETIAN, MACEDONE, CVRCE,	DIOCLETIAN, MACEDONE, CURÉE,
DIOCLETIAN On eſprit agité de mouuemens étranges, MApeine à ſe reſoudre en de ſi grands mélanges.	DIOCLETIAN On esprit agité de mouvements étranges, MApeine à se résoudre en de si grands mélanges.
Si ie dois pour les Dieux punir l’impieté;	Si ici dois pour les Dieux punir l'impiété;
La Nature qui veut conſeruer ſa beauté, De toute ſa vigueur à ce deſſein s’oppoſe, Et me fait balancer en faueur de ſa cauſe.	La Nature qui veut conserver sa beauté, De toute sa vigueur à ce dessein s'oppose, Et me fait balancer en faveur de sa cause.
L’intereſt de l’Empire eſt meſme partagé Son pouuoir mépriſé voudroir eſtre vengé.	L'intérêt de l'Empire est mesme partagé Son pouvoir méprisé voudroir avoir vengé.
Mais auſſi pourroit Il ſe venger ſans ſe nuire?	Mais aussi pourrait Il se venger sans se nuire?
Ce qu’il a de plus beau, l’oſeroit-il détruire?	Ce qu'il a de plus beau, l'oserait-il détruire?
Et porter à tel poinct cette ialouſe ardeur, D'éteindre en ſe vengeant l’éclat de ſa ſplendeur.	Et porter à tel point cette jalouse ardeur, D'éteindre en se vengeant l'éclat de sa splendeur.
Faites vne action doublement glorieuſe, Dieux, ſouffrez qu’elle viue & la rendez pieuſe:	Faites une action doublement glorieuse, Dieux, souffrez qu'elle vive et la rendez pieuse:
Ou, Nature, reprens ces charmes les plus doux, Pour laiſſer librement agir noſtre courroux.	Ou, Nature, reprends ces charmes les plus doux, Pour laisser librement agir notre courroux.
Empire, à cét objet abrégé de merueilles, A l’vſage des yeux préfére les aureilles:	Empire, à cet objet abrégé de merveilles, A l'usage des yeux préfère les oreilles:
ourde d’eſtre cbiouy par ſes diuiſis appas, Pour eſtre incorruptible, entends & ne vois pas.	ourde d'être cbiouy par ses divis appas, Pour être incorruptible, entends et ne vois pas.
MACEDONE Seigneur, ces ſentimens qui partagent voſtre ame, Sont, ſi ie l’oſe dire, vn peu dignes de blâme.	MACEDONE Seigneur, ces sentiments qui partagent avoir âme, Sont, si toujours l'ose dire, un peu dignes de blâme.
L'honneur qu’on doit aux Dieux leur eſtant refuſé Ce crime abſolument ne peut eſtre excuſé, Ettout doit concourir à venger leur iniure:	L'honneur qu'on doit aux Dieux leur étant refusé Ce crime absolument ne peut être excusé, Étout doit concourir à venger leur injure:
Sivous conſiderez les droicts de la Nature, Ne iugerez-vous pas ſoûmiſe aux Dieux qu’elle eſt Qu'elle ne peut, Seigneur, prendre d’autre intereſt?	Sivous considérez les droits de la Nature, Ne jugerez-vous pas soumise aux Dieux qu'elle est Qu'elle ne peut, Seigneur, prendre d'autre intérêt?
Nul à leurs volontez ne ſe montre rebelle, Suiuant ſes mouuemens & ſans agir contre elle:	Nul à leurs volontés ne se montre rebelle, Suivant ses mouvements et sans agir contre elle:
Car les Dieux à l’inſtant de ſa création, Par vne merueilleuſe & douce impreſſion, Mirent deſſus ſon front vn ſacré caractere, Lequel nous éfaçons en oſant leur déplaire.	Car les Dieux à l'instant de sa création, Par une merveilleuse et douce impression, Mirent dessus son front un sacré caractère, Lequel nous éfaçons en osant leur déplaire.
Pour l’Empire, Seigneur, s’il balançoit au choix, Il ne luy faudroit plus, ny de Dieux, ny de Loix.	Pour l'Empire, Seigneur, s'il balançait au choix, Il ne était faudrait plus, ni Se Dieux, ni de Lois.
Il doit abhorer ceux qui ſont ſi temeraires De refuſer le culte à ſes Dieux tutélaires, Et ſans délibérer, lors que le crime eſt tel, Si-toſt qu’il eſt commis, punir le criminel.	Il doit abhorer ceux qui sont si téméraires De refuser le culte à ses Dieux tutélaires, Et sans délibérer, lors que le crime est tel, Sitôt qu'il est commis, punir le criminel.
Partoutes ces raiſons, le deuoir vous obliger.	Partoutes ces raisons, le devoir vous obliger.
DIOCLET IAN Ie veux m’en acquiter, & ce deuoir m’afflige.	DIOCLET IAN Je veux m'en acquitter, et ce devoir m'afflige.
Ie reſpecte les Dieux, ſenſible à ſes appas, Ie la plains, il eſt vray, mais ne l’excuſe pas:	Je respecte les Dieux, sensible à ses appas, Je la plains, il est vrai, mais ne l'excuse pas:
Et quoy qu’auec ardeur, pour eux ie m’intéreſſe Sa beauté, ie l’auoüe, excite ma tendreſſe:	Et quoi qu’avec ardeur, pour eux -je m'intéresse Sa beauté, toujours l'avoue, excite ma tendresse:
Sa perte, à mon auis, eſt vn commun mal-heur, La Nature y conſent, mais c’eſt auec douleur, Et l’Empire qui void qu’elle n’a point d’égale, Sçait blen en la perdant, que fon pria le rutlaſe:	Sa perte, à mon avis, est un commun malheur, La Nature y consent, mais c'est avec douleur, Et l'Empire qui voit qu'elle n'a point d'égale, Sait blen en la perdant, que son pria le rutlase:
Sans doute par ſa chûte il déchoit de ſon rang, Et ne peut refuſer des larmes à ſon ſang.	Sans doute par sa chute il déchoit de son rang, Et ne peut refuser des larmes à son sang.
CVRCE Outre encore, Seigneur, que ſon crime eſt énorme Sila beauté réſide en la plus noble forme, S’il eſt vray que l’eſprit l’emporte ſur le corps, L’on peut facilement ajuſter ces diſcords.	CURÉE Outre encore, Seigneur, que son crime est énorme Sila beauté réside en la plus noble forme, S'il est vrai que l'esprit l'emporte sur le corps, L'on peut facilement ajuster ces discords.
Quand la Nature veut par le concours des cauſes, Nous porter du néant iuſqu’à l’eſtre des choſes;	Quand la Nature veut par le concours des causes, Nous porter du néant jusqu'à l'être des choses;
Elle diſpoſe vn Corps, dont le commencement Ne marque membre, chef, trait, ny linéament.	Elle dispose un Corps, dont le commencement Ne marque membre, chef, trait, Seigneur linéament.
En ſuite, elle s’occupe à cette vile maſſe, Forme chaque partie & luy regle ſa place, Aſſortit la ſubſtance auec les accidens, Le moins noble au dehors, le plus noble au dedans, Et fait que par ſes ſoins la matiere conuie Les puiſſances d’enhaut à luy donner la vie.	En suite, elle s'occupe à cette vile masse, Forme chaque partie et lui règle sa place, Assortit la substance était les accidents, Le moins noble au dehors, le plus noble au dedans, Et fait que par ses soins la matière convie Les puissances d'enhaut à lui donner la vie.
L’ame, quis’introduit par de ſecrets reſſors, Prenant ſon ſiege au Cœur anime tout ce Corps, D'abord elle le rend mobile, actif, ſenſible?	L'âme, qu'introduit par de secrets ressorts, Prenant son siège au Cœur anime tout ce Corps, D'abord elle le rend mobile, actif, sensible?
Et quoy que ſa clarté ne nous ſoit pas viſible, Néantmoins elle enuoye au dehors des rayons, Qui font les agrémens qu’à ce Corps nous voyons.	Et quoi que sa clarté ne nous soit pas visible, Néanmoins elle envoie au dehors des rayons, Qui font les agrémens qu'à ce Corps nous voyons.
Mais ſi l’ame n’a plus ſa beauté naturelle, Quand elle eſt diſſemblable à ſon diuin modele;	Mais si l'âme n'a plus sa beauté naturelle, Quand elle est dissemblable à son divin modèle;
Lors que nous mépriſons le titre glorieux, Par lequel nous pouuons nous dire Enfans des Dieux;	Lors que nous méprisons le titre glorieux, Par lequel nous penons nous dire Enfants des Dieux;
Que bien loin d’honorer ces Peres débonnaires, Nous diſons que ce ſont objets imaginaires;	Que bien loin d'honorer ces Pères débonnaires, Nous disons que ce sont objets imaginaires;
Que c’eſt idolâtrie, ou trouble de nos ſens, De leur offrir des vœux & brûler de l’encens;	Que c'est idolâtrie, ou trouble de nos sens, De leur offrir des vœux et brûler de l'encens;
Qu’enfin leur déniant tous ces cultes ſuprémes, Aulieu de nos reſpects ils n’ont que des blaſphémes;	Qu'enfin leur déniant tous ces cultes suprême, Aulieu de nos respects ils n'ont que des blasphémes;
Sile Corps n’eſt réduit en ſon premier état, Au moins il eſt priué de ce céleſte éclat:	Sile Corps n'est réduit en son premier état, Au moins il est privé de ce céleste éclat:
Et comme hay des Dieux, ſi l’on leur ſacrifie, la Narure s’égaye, elle ſe puriſie, Et l’Empire ne peut ſe ſatisfaire plus Qu’en voyant retrancher ſes membres corrompus.	Et comme hais des Dieux, si l'on leur sacrifie, la Narre s'égaie, elle se purisie, Et l'Empire ne peut se satisfaire plus Qu'en voyant retrancher ses membres corrompus.
DIOCLETIAN Contentons donc les Dieux, la Nature & l’Empire;	DIOCLETIAN Contentons donc les Dieux, la Nature et l'Empire;
Mais quoy que vous penilles & que vous puiſſiez dire, Nous voyons bien ſouuent par la ſuite du temps, Que les plus criminels ſont les plus pénitens.	Mais quoi que vous pénilles et que vous puissiez dire, Nous voyons bien souvent par la suite du temps, Que les plus criminels sont les plus pénitents.
Sa beauté me ſera différer pour quelque heure.	Sa beauté me sera différer pour quelque heure.
MACE DONE Ia Iuſtice, Seigneur, demande qu’elle meure.	MACE DONE Ia Justice, Seigneur, demande qu'elle meure.
SOLILOQVE de	SOLILOQUE de
SVSANNE Ie vous ay ſuppliée, inéfable Bonté!	SUSANE -Je vous ai suppliée, inéfable Bonté!
Qu’afin de rechaufer ma froide volonté, De mon entendement diſſipant le nuage, La foy luy fiſt de vous vne brillante Image.	Qu'afin de réchauffer ma froide volonté, De mon entendement dissipant le nuage, La foi-même fît de vous une brillante Image.
Mais, outre ces beautez, pour la mieux émouuoir, Et l’ob liger d’aimer par vn double deuoir;	Mais, outre ces beautés, pour la mieux émouuoir, Et l'ob liger d'aimer par un double devoir;
Que de tant de bien-faits la ſuite reprochante, La preſſe inceſſamment, luy ſoit toûjours preſente.	Que de tant de bienfaits la suite reprochante, La presse incessamment, lui soit toujours présente.
Faites qu’elle contemple auec étonnement L’origine du Monde & ſon commencement:	Faites qu'elle contemple était étonnement L'origine du Monde et son commencement:
Cét object des Reſueurs, qu’ils cherchent ſans lumiers Sous le nom ſupoſé de Matiere premiere:	Cet object des Résueurs, qu'ils cherchent sans lumiers Sous le nom suposé de Matière première:
Ce Rien réaliſé, dont créant l’Vniuers, Voſtre main donna l’eſtre à tant d’Eſtres diuers;	Ce Rien réalisé, dont créant l'Univers, Votre main donna l'être à tant d'Êtres divers;
Sur leſquels vous m’auez miſe en cét auentage, Qu’ils ſemblent n’eſtre faits que pour mon ſeul vſage, Apres auoir adioint au plus bas Element, Afin de me former, vn ſouffle ſeulement.	Sur lesquels vous m'avez mise en cet aventage, Qu'ils semblent n'être faits que pour mon seul usage, Apres avoir adjoint au plus bas Élement, Afin de me former, un souffle seulement.
Ce pouuoir ſouuerain, ſi digne qu’on l’obſerue, Eſt celuy qui depuis m’appuye & me conſerue:	Ce pouvoir souverain, si digne qu'on l'observe, Est celui qui depuis m'appuie et me conserve:
De ſorte que ie ſuis, à parler proprement L’ouurage de vos mains, produit inceſſenient.	De sorte que je suis, à parler proprement L'ouvrage de vos mains, produit incessénient.
Mais s’il faut plus auant cette ingrate pourſuiure, Ne mourûtes vous pas pour me faire reuiure?	Mais s'il faut plus avant cette ingrate poursuivre, Ne mourûtes -vous pas pour me faire revivre?
Voſtre amour, qui ne peut du monde eſtre compris, Me voulant racheter, fit voſtre ſang mon prix.	Votre amour, qui ne peut du monde être compris, Me voulant racheter, fit votre sang mon prix.
Que ma foible memoire à ces graces fidelle.	Que ma faible mémoire à ces grâces fidèle.
Soit iointe au doux eſpoir de la gloire éternelle.	Soit jointe au doux espoir de la gloire éternelle.
Que ces deux appétits, ſource des Paſſions, Ne troublent plus l’eſprit par leurs rebellions:	Que ces deux appétits, source des Passions, Ne troublent plus l'esprit par leurs rébellions:
Qu'embraſez d’vne ardeur auſſi ſaincte que viue, Le premier vous deſire & l’autre vous pourſuiue, Sur tout, Eſtre infini, puis que la Chaſteté A l’heur d’eſtre conforme à voſtre volonté;	Qu'embrasez d'une ardeur aussi sainte que vive, Le premier vous désire et l'autre vous poursuive, Sur tout, Être infini, puis que la Chasteté A l'heur d'être conforme à votre volonté;
Que d’vnamour impur iamais mon cœur ne brûle;	Que d'unamour impur jamais mon cœur ne brûle;
Que ma virginité demeure ſans macule;	Que ma virginité demeure sans macule;
Que les tentations qui pourroient m’approcher, Soient ſemblables aux vents, qui choquent vn Rocher?	Que les tentations qui pourraient m'approcher, Soient semblables aux vents, qui choquent un Rocher?
Qu’ayant de mes pechez vne douleur extréme, le viue pour vous ſeul & lieure tout de hemie:	Qu'ayant de mes péchés une douleur extrême, le vive pour vous seul et lièvre tout de hémie:
Et qu’apres ce paſſage étroit & dangereux, Il vous plaiſe me mettre au rang des Bien-heureux.	Et qu'après ce passage étroit et dangereux, Il vous plaise me mettre au rang des Bienheureux.
SOLILOQVE de MAXIMIAN	SOLILOQUE de MAXIMIAN
TANCES.	TANCES.
Paſſion, cruelle ennemie, Qui viens combattre ma vertu, Aquel deſſein te portes-tu, Que de me combler d’imaine :	Passion, cruelle ennemie, Qui viens combattre ma vertu, Aquel dessein te portes-tu, Que de me combler d'imaine :
Tant d’actes glorieux qui fondent mon bon-heur, Qu’auroient-ils, qu’vne fin tragique, Apres qu’vne flame impudique Auroit conſumé mon honneur?	Tant d'actes glorieux qui fondent mon bonheur, Qu'auraient-ils, qu'une fin tragique, Après qu'une flamme impudique Aurait consumé mon honneur?
Que dis-je?	Que dis-je?
à preſent il faut ſuiure La iuſte loy de mes tranſports;	à présent il faut suivre La juste loi de mes transports;
Qui refiſte à de doux efforts, Par la rigueur ſe doit pourſuiure.	Qui résiste à de doux efforts, Par la rigueur se doit poursuivre.
* Ce peut-il que ma gloire ait quelque fondement, Et ſouffre l’orgueil qui m’outrage?	* Ce peut-il que ma gloire ait quelque fondement, Et souffre l'orgueil qui m'outrage?
Ne ſerois-je pas ſans courage Si i’eſtois ſans reſſentiment?	Ne serais-je pas sans courage Si j'étais sans ressentiment?
Amour!	Amour!
conſidere ſes charmes Entremeſlez de grauité, Aurois-tu la temerité D’oſer luy prouoquer des larmes?	considère ses charmes Entremêlés de gravité, Aurais-tu la témérité D'oser toujours provoquer des larmes?
Si tu conois ſes yeux ſi brillans & ſi beaux;	Si tu conais ses yeux si brillants et si beaux;
Sources en lumiere fécondes;	Sources en lumière fécondes;
Ne fais pas que de triſtes ondes, Viennent éteindre ces flambeaux.	Ne fais pas que de tristes ondes, Viennent éteindre ces flambeaux.
Que tes mouuemens ſont timides!	Que tes mouvements sont timides!
Amour, en prouoquant ſes pleurs, Sur ſon teint parſemé de fleurs, Tu verras des perles liquides.	Amour, en proquant ses pleurs, Sur son teint parsemé de fleurs, Tu verras des perles liquides.
Sçais-tu pas que le feu rechaufe beaucoup mietix, Lors que l’eau ſa chaleur irrite?	Sais-tu pas que le feu rechauffe beaucoup miétix, Lors que l'eau sa chaleur irrite?
Si le Soleil l’onde viſite, C’eſt pour eſtre plus radieux.	Si le Soleil l'onde visite, C'est pour être plus radieux.
Sa voix qui produit des merueilles Par la douceur de ſes accens, Et donne enuie à tous les ſens, D’eſtre placez dans les aureilles:	Sa voix qui produit des merveilles Par la douceur de ses accents, Et donne envie à tous les sens, D'être placés dans les oreilles:
Elle, qui tant de fois te cauſa du mépris Pour la plus charmante armonie, En exagerant ta manie, Fera de lamentables cris.	Elle, qui tant de fois te causa du mépris Pour la plus charmante armonie, En exagérant ta manie, Fera de lamentables cris.
Ma voix, dont l’office fidelle, Exagérant ma paſſion, Ne pût faire d’impreſſion Sur l’eſprit de cette rebelle:	Ma voix, dont l'office fidèle, Exagérant ma passion, Ne pût faire d'impression Sur l'esprit de cette rebelle:
Elle, dont la douceur aigriſſoit ſa rigueur, Veut que la ſienne aux cris s’employe;	Elle, dont la douceur aigrissait sa rigueur, Veut que la sienne aux cris s'emploie;
La triſteſſe comme la ioye, Sert au triomphe du vainqueur.	La tristesse comme la joie, Sert au triomphe du vainqueur.
Quoy laſche amour, tu deliberes!	Quoi lâche amour, tu délibères!
Et dois paroître le plus fort;	Et dois paraître le plus fort;
Tous mes ſentimens ſont d’accord, Il ne faut plus que tu differes:	Tous mes sentiments sont d'accord, Il ne faut plus que tu diffères:
D'vne illuſtre Conqueſte, anont ceui le fruict, Prenons vne douce vengeance.	D'une illustre Conquête, anont ceui le fruit, Prenons une douce vengeance.
Peut-on blâmer ma violence, ol la cruaute m’y reduit?	Peut-on blâmer ma violence, ol la cruauté m'y réduit?
SOLILOQVE de	SOLILOQUE de
SERENE Funeſte aſſortiment!	SERENE Funeste assortiment!
ridicule aſſemblage!	ridicule assemblage!
Deſordre, déguiſé du nom de Mariage!	Désordre, déguisé du nom de Mariage!
Triſte condition!	Triste condition!
ſe peut-il que ton cours, Doiue durer autant que celuy de mes iours?	se peut-il que ton cours, Doive durer autant que celui de mes jours?
Ne vous offenſez pas, amitié conjugale, A conſeruer vos droits, ie ſuis toûjours égale:	Ne vous offensez pas, amitié conjugale, À conserver vos droits, Seigneur suis toujours égale:
Ie garde le reſpect dans l’indignation, Ma vertu ſe tient ferme en cette émotion :	Je garde le respect dans l'indignation, Ma vertu se tient ferme en cette émotion :
Mon cœur, quey qu’embraſé de l’ardeur qui l’anime, Ne forme aucun deſir qui ne ſoit legitime.	Mon cœur, quei qu'embrasé de l'ardeur qui l'anime, Ne forme aucun désir qui ne soit légitime.
Si par diuers objets il paroît partagé, Pour l’vn, plein d’vn ſaint zele, & pour l’autre affligé, Dans l’intereſt des deux il rencontre le voſtre, Dans la gloire de l’vn, l'vrilité de l’autre:	Si par divers objets il paraît partagé, Pour l'un, plein d'un saint zèle, et pour l'autre affligé, Dans l'intérêt des deux il rencontre le vôtre, Dans la gloire de l'un, l'unité de l'autre:
Il eſt fidele à Dieu, fidele à l’Empereur, Et ne le peut aimer ſans haïr ſon Erreur.	Il est fidèle à Dieu, fidèle à l'Empereur, Et ne le peut aimer sans haïr son Erreur.
En cette auerſion la raiſon m’authoriſe, Elle n’a pour ſujet que cẽ qui nous diuiſe.	En cette aversion la raison m'autorise, Elle n'a pour sujet que comp qui nous divise.
I’honore lelien duquel nos corps ſont ioints;	J'honore lelien duquel nos corps sont joints;
Ces mouuemens m’en ſont de fideles témoins?	Ces mouvements m'en sont de fidèles témoins?
Et ſur noſtre vnion, tout ce que ie ſouhaitte, C’eſt afin de la rendre & durable & parfaite, Que l’vnité d’eſprit faſſe voir en nous deux, Meſme Religion, meſme Dieu, meſmes Vœux.	Et sur notre vnion, tout ce que femme souhaite, C'est afin de la rendre et durable et parfaite, Que l'vnité d'esprit fasse voir en nous deux, Même Religion, même Dieu, mêmes Vœux.
Qu’aux clartez de la foy, ſon ame ſoit ouuerte;	Qu'aux clartés de la foi, son âme soit ouverte;
Qu’il pourſuiue ſon bien, qu’il éuite ſa perte?	Qu'il poursuive son bien, qu'il éuite sa perte?
Qu’il craigne, qu’il eſpere, & qu’il aime ardamment Celuy qui recompenſe & fait le chaſtiment.	Qu'il craigne, qu'il espère, et qu'il aime ardamment Celui qui récompense et fait le châtiment.
Qu’il prie en l’adorant, le priant qu’il obtienne Le don auentageux de la vertu Chreſtienne:	Qu'il prie en l'adorant, le priant qu'il obtienne Lé on aventageux de la vertu Chrétienne:
Que ſes Loix il réuére, & que ſes Charitez Se répanchent ſur ceux qu’il a perſecutéz.	Que ses Lois il réuére, et que ses Charités Se répanchent sur ceux qu'il a persécutés.
Qu’ainſi noſtre vnion ſainctement reformée, Chaque partie enſoit de l’autre plus aimée.	Qu'ainsi notre imion sainte réformée, Chaque partie ensait de l'autre plus aimée.
Qu’il n’arriue aucun trouble à ſa tranquilité;	Qu'il n'arrive aucun trouble à sa tranquillité;
Et pour comble de gloire & de felicité, 44 12 Apres que nous aurons détruit l’Idolâtrie, Qu’elle ſe continuë en vne autre Patrie.	Et pour comble de gloire et de félicité, 44 12 Apres que nous aurons détruit l'Idolâtrie, Qu'elle se continue en une autre Patrie.
SECOND ENTRETIEN.	SECOND ENTRETIEN.
DIOCLETIAN, MAXIMIAN.	DIOCLETIAN, MAXIMIAN.
DIOCLETIAN Si cette viſion, dont l’éclat vous ſurprit, Ne vous laiſſe à preſent aucun trouble d’eſprit, Si vos ſens ont repris leur premiere aſſeurance, Faites-nous le détail de chaque circonſtance.	DIOCLETIAN Si cette vision, dont l'éclat vous surprit, Ne vous laisse à présent aucun trouble d'esprit, Si vos sens ont repris leur première assurance, Faites-nous le détail de chaque circonstance.
MAXIMIAN En pareille rencontre, vn autre comme moy, Auroit eſtéſaiſi de merueille & d’éfroy;	MAXIMIAN En pareille rencontre, un autre comme moi, Aurait estésaisi de merveille et d'éfroi;
Seigneur, ſans repugner ie vous en rendrois conte, Si ma ſeule frayeur deuoit cauſer ma honte;	Seigneur, sans répugner vôtre vous en rendrais compte, Si ma seule frayeur devait causer ma honte;
Elle fut raiſonnable & ie n’en rougis pas:	Elle fut raisonnable et ici n'en rougis pas:
Mais l’iniuſte deſſein qui conduiſoit mes pas, Ne ſe peut declarer & receuoir d'exeuſe, Qui ne laiſſe mon ame agitée & confuſe.	Mais l'injuste dessein qui conduisait mes pas, Ne se peut déclarer et recevoir d'exeuse, Qui ne laisse mon âme agitée et confuse.
Siie vous dis, Seigneur, la choſe comme elle eſt, Ie prefere voſtre ordre à mon propre intereſt:	Siie vous dis, Seigneur, la chose comme elle est, Je préfère votre ordre à mon propre intérêt:
Ie découure vn ſecret, qui m’attire le blame Des eſprits, ennemis d’vne action infame:	Je découvre un secret, qui m'attire le blâme Des esprits, ennemis d'une action infâme:
Infidele à moy-meſme & fidele au deuoir, Ie m’accuſe d’vn crime horrible à conceuoir.	Infidèle à moi-même et fidèle au devoir, Je m'accuse d'un crime horrible à concevoir.
Que l’amour eſt fatal aux ames généreuſes!	Que l'amour est fatal aux âmes généreuses!
Et que l’honneur eſt foible aux ames amoureuſes!	Et que l'honneur est faible aux âmes amoureuses!
Le plus grand Cœur eſt lâche & manque de vertu Incontinent qu’il eſt par l’amour abatu,	Le plus grand Cœur est lâche et manque de vertu Incontinent qu'il est par l'amour abattu,
Et celuy dont l’honneur par l’amour ne s’égare Eſt, à mon ſentiment, la choſe la plus rare.	Et celui dont l'honneur par l'amour ne s'égare Est, à mon sentiment, la chose la plus rare.
Des mépris de Suſanne, outré de déplaiſirs, Sa froideur échaufant dautant plus mes deſirs, Ie conſulte, ſçauoir, ſi par la violence Ie dois m’en acquerir l’aimable ioüiſſance.	Des mépris de Susanne, outré de déplaisirs, Sa froideur échauffant dautant plus mes désirs, Je consulte, Savoir, si par la violence Je dois m'en acquérir l'aimable jouissance.
Lors mon honneur s’oppoſe & mes eſprits flotans En ce doute incertain balancent quelque temps:	Lors mon honneur s'oppose et mes esprits flottants En ce doute incertain balancent quelque temps:
Mais aux tranſports d’amour, mon ame s’abandonne, Aueuglement ie ſuy le conſeil qu’il me donne, Ie n’ay d’autre clarté que ſon flambeau fatal;	Mais aux transports d'amour, mon âme s'abandonne, Aveuglement ie zvi le conseil qu'il me donne, Je n'ai d'autre clarté que son flambeau fatal;
Ma raiſon ſe transforme en mouuement brutal, Ie cours pour l’aſſouuir par vn acte tragique;	Ma raison se transforme en mouvement brutal, Je cours pour l'assouvir par un acte tragique;
I’entre, ſans rencontrer Pere ny domeſtique, Et ie me rends au lieu, malgré l'obſcurité, Que ie faiſois le but de ma félicité.	J'entre, sans rencontrer Père ici domestique, Et tu me rends au lieu, malgré l'obscurité, Que te faisois le but de ma félicité.
4 11 Seigneur, qu’en peu de temps l’état des hommes change!	4 11 Seigneur, qu'en peu de temps l'état des hommes change!
Et que ie fus changé par ce prodige étrange!	Et que ici fus changé par ce prodige étrange!
I’allois pour la forcer, & ſon premier aſpect, M’inſpire puiſſamment la crainte & le reſpect.	J'allais pour la forcer, et son premier aspect, M'inspire puissamment la crainte et le respect.
Plus ie veux l’obſeruer, plus mon eſprit s’étonne, De la grande ſplendeur dont l’éclat l’enuironne, Et ie doute, en voyant ſa face qui reluit, Si ce nouueau Soleil vient éclairer la nuict.	Plus ie veux l'observer, plus mon esprit s'étonne, De la grande splendeur dont l'éclat l'environne, Et ie doute, en voyant sa face qui reluit, Si ce nouveau Soleil vient éclairer la nuit.
Aucune majeſté ne fut iamais ſi graue.	Aucune majesté ne fut jamais si grave.
Ie ne puis ſoûtenir ſon regard qui me braue, Et meſle à ſes rayons de la ſéuérité, Aſin de me paint de ne temernte.	Je ne puis soutenir son regard qui me brave, Et mêle à ses rayons de la séuérité, Regard qui me paint de ne témernte.
Ainſi ie ſuis contraint à fuir ce que i’admire, 2 La fureur m’y pouſſa, la frayeur m’en retire;	Ainsi ie mai contraint à fuir ce que j'admire, 2 La fureur m'y poussa, la frayeur m'en retire;
Ie fay pour me haſter des efforts impuiſſans:	Je fais pour me hâter des efforts impuissants:
Il me reſte ſi peu de l’vſage des ſens;	Il me reste si peu de l'usage des sens;
Que ie n’en auois pas aſſez pour ma conduite, Lois que l'ay rericontre quelques gens de ma ſuite.	Que était n'en avais pas assez pour ma conduite, Lois que l'ai rericontre quelques gens de ma suite.
DIOCLETIAN Ce prodige eſt cauſé par vn magique ſort;	DIOCLETIAN Ce prodige est causé par un magique sort;
Mais Macédone vient nous anoncer ſa mort.	Mais Macédone vient nous anoncer sa mort.
TROISTESME ENTRETIEN.	TROISTESME ENTRETIEN.
MACEDONE Seigneur, ſuiuant voſtre ordre, exerçant mon office, Le plus modérément que permet la Iuſtice;	MACEDONE Seigneur, suivant votre ordre, exerçant mon office, Le plus modérément que permet la Justice;
Apres auoir tenté ce que i’ay crû de mieux, Pour engager Suſanne au ſeruice des Dieux, Exactement cité dans vn diſcours tres-ample, Pluſieurs Chreſtiens punis, pour luy ſeruir d’exemple;	Après avoir tenté ce que j'ai cru de mieux, Pour engager Susanne au service des Dieux, Exactement cité dans un discours très -ample, Plusieurs Chrétiens punis, pour lui servir d'exemple;
Ie la preſſe & luy dis que ſans plus différer, Le puiſſant Iupiter il faloit adorer.	Je la presse et lui dis que sans plus différer, Le puissant Jupiter il fallait adorer.
Lors, les yeux & les mains au Ciel on luy void tendre, Elle dit quelques mots que l’on ne peut entendre, Et l’on vid à l’inſtant par leur forte vertu, Son ſacré Simulacre en la place abatu.	Lors, les yeux et les mains au Ciel on lui voit tendre, Elle dit quelques mots que l'on ne peut entendre, Et l'on vit à l'instant par leur forte vertu, Son sacré Simulacre en la place abattu.
Comme cét incident la rend plus criminelle, Ie ne puis differer la Sentence mortelle, Les Loix, de mon office exigent ce deuoir;	Comme cet incident la rend plus criminelle, Je ne puis différer la Sentence mortelle, Les Lois, de mon office exigent ce devoir;
Cét inflexible Cœur l’entend ſans s’émouuoir.	Cet inflexible Cœur l'entend sans s'émouvoir.
Le funeſte appareil qu’on fait pour les ſupplices, Paroit à ſon eſprit comme vn lieu de delices, D’vn œil brillant de ioye elle void le Bourreau, Son aſſeurance ſemble animer ſon couteau:	Le funeste appareil qu'on fait pour les supplices, Parait à son esprit comme un lieu dé lices, D'un œil brillant de joie elle voit le Bourreau, Son assurance semble animer son couteau:
Elleparle tout bas dans le temps qu’il s’appreſte;	Elleparle tout bas dans le temps qu'il s'apprête;
Puis, ſans qu’on le commande, elle baiſſe la Teſte, Et traite le ſuplice auec tant de mépris, Qu’en receuant le coup elle fait vn ſouris.	Puis, sans qu'on le commande, elle baisse la Tête, Et traite le suplice avec tant de mépris, Qu'en recevant le coup elle fait un souris.
Son viſage en ſa chûte acquiert de nouueaux charmes, Les Spectateurs ont peine à retenir leurs larmes:	Son visage en sa chute acquiert de nouveaux charmes, Les Spectateurs ont peine à retenir leurs larmes:
Auſſi fait-elle voir l’égalité du ſort;	Aussi fait-elle voir l'égalité du sort;
D’vne admirable vie, vne admirable mort.	D'une admirable vie, une admirable mort.
DIOCLETIAN Telles punitions dans le ſein de l’Hiſtoire, Seruent de monumens à conſeruer ma gloire, Et laiſſent pour Maxime à la poſterité, Qu’on ne peur eſtre Impie auec impunité.	DIOCLETIAN Telles punitions dans le sein de l'Histoire, Servent de monuments à conserver ma gloire, Et laissent pour Maxime à la postérité, Qu'on ne peur être Impie avec impunité.
