M.	M.
D.	D.
C.	Ç.
XCVI.	XCVI.
da Cotite.	da Cotite.
D.	D.
DIEQUES, Fere de Rodrigue.	DIQUÊ, Fère de Rodrigue.
LOMBRE du Comté	LOMBRE du Comté
D.	D.
ROURIGUE, rnis de D.	ROURIGUE, rinis de D.
Diſtgue,	Distgue,
& Mary de Chimene.	et Mari de Chimène.
D.	D.
SANCHE,	SANCHÉ,
D.	D.
ARIAS, Gentilhomme.	ARIAS, Gentilhomme.
LA MORI ET L’OMBRE 7L DU COMTE ORMAS TRAGI.	LA MORY ET L'OMBRE 7L DU COMTE ORMAS TRAGI.
COMEDIE.	COMÉDIE.
ROIDE SCENE PREMIERE L’INFANTE LEONOR, LE PAGE,	ROIDE SCÈNE PREMIÈRE L'INFANTE LEONOR, LE PAGE,
LEONOR E lis dans vos ſoûpirs la douleur qui vous touche;	LEONOR E lis dans vos soupirs la douleur qui vous touche;
Sans la mieux exprimer en ouvraut votre bouche, hhbMbajear & cette ſombrauameur, Vous avez quelque vers qui vous tonge le cœur;	Sans la mieux exprimer en ouvraut votre bouche, hhbMbajear et cette sombravameur, Vous avez quelque vers qui vous tonge le cœur;
Et fait de vos beaux yeux, (tant ſa pointe vous bleſſe) De deux Soleils d’amour deux dlambeaux de triſteſſe, Vn coup de jalouſie en preſence du Roy.	Et fait de vos beaux yeux, (tant sa pointe vous blesse) De deux Soleils d'amour deux dlambeaux de tristesse, Un coup de jalousie en présence du Roi.
M’a fait croire qu’amour vous tenoit ſous ſa loy.	M'a fait croire qu'amour vous tenait sous sa loi.
Alors que la colere en ſa chaleur ſoudaine, Vous fit porter la main ſur le front de Chimene, Et changeant de couleur par un prompt mouvement.	Alors que la colère en sa chaleur soudaine, Vous fit porter la main sur le front de Chimène, Et changeant de couleur par un prompt mouvement.
Votre œil lui reprocha le ceur de ſon amant, Et le reſpect eut peine au coup de cette offence, De retenir la langne aux chaiſnes du ſi ence, Tant le reſſentiment avec la paſſion Fut ſuivy du coprice & de laver ſion	Votre œil lui reprocha le ceur de son amant, Et le respect eut peine au coup de cette offense, De retenir la langne aux chaînes du si ense, Tant le ressentiment avec la passion Fut suivi du coprice et de laver sion
L'INFANE Tu las dit, Leonor, mon ame eſt obſedée, Elle vit des appas de ſa charmaute idée;	L'INSANE Tu las dit, Leonor, mon âme est obsédée, Elle vit des appas de sa charmaute idée;
Rodrigue eſt mon Soleil, & ſes tais glorieux, Allament mes deſirs & me charment les yeux, Mon ame eſt un croiſſant ſous une auue himiſphere, Plus il s'éloigne delle, & tant plus il léclaure.	Rodrigue est mon Soleil, et ses tais glorieux, Allament mes désirs et me charment les yeux, Mon âme est un croissant sous une auue himisphere, Plus il s'éloigne delle, et tant plus il léclaure.
Ie l'ay dans mon eſprit & de nuit & de jour, Il traverſe mon cœur des traits de ſon amour, M interdit tous les ſens, & mon œil qui me trompe, Me le montre éc’atant de gloire & de pompe, Victorieux du More, & lui donnant des lois, Nous mener en caprifs ſes Princes & ſes Roys, Recevoir leur couronne, & triomphant ſe rendre Au faiſte de la gloire où fon vit Alexaudre, Tyran de mes deſirs, ſerpent couvert de fleurs, Qui me tient à la chaiſne, & te ris de mes pleurs, Amour le ſeul auteur du mal qui me poſſede Tu me fais la douleur, & m’ôtes le remede, Et martyrant mon cœur de ta douce priſon, Tes charmes ſont plus forts que ceux de la raiſon.	Je l'ai dans mon esprit et de nuit et de jour, Il traverse mon cœur des traits de son amour, M interdit tous les sens, et mon œil qui me trompe, Me le montre éc'attant de gloire et de pompe, Victorieux du More, et lui donnant des lois, Nous mener en caprifs ses Princes et ses Roys, Recevoir leur couronne, et triomphant se rendre Au te de la gloire où son vit Alexaudre, Tyran de mes désirs, serpent couvert de fleurs, Qui me tient à la chaîne, et te ris de mes pleurs, Amour le seul auteur du mal qui me possse Tu me fais la ur, et m'ô le remède, Et m' on cœur de ta douce prison, Tes charmes et plus forts que ceux de la m.
LEONOR miudenie, on ne voit pas que perſonne ſoûpire Aux lieux où cette Reyne établit ſon empire.	LEONOR miudénie, on ne voit pas que personne soupire Aux lieux où cette Reine établit son empire.
Vous prenez pour raiſon un lache aveuglement Qui trahit votre honneur & votre ſentiment.	Vous prenez pour raison un lâche aveuglement Qui trahit votre honneur et votre sentiment.
Conſultez avec elle avant que d’entreprendre, Et vous triompherez ao tied ue vous défendre, Que votre Majeſté daigne me pardonner, Allet contre l'honneur ce n’eſt pas raiſonner.	Consultez avec elle avant que d'entreprendre, Et vous triompherez a tied ue vous défendre, Que votre Majesté daigne me pardonner, Allet contre l'honneur ce n'est pas raisonner.
L'INFANTE Leonor, cet honneur & Ieclat de ſes gloires Ont ajoüté mon eœur au rang de ſes victoires.	L'INFANTE Leonor, cet honneur et Jeclat de ses gloires Ont ajouté mon eœur au rang de ses victoires.
L’ont mis dans mon eſprit, & ce doux ſemiment D’un geneteux vainqueur m'en a fait un amant, Mes yeux ſes partiſans m’en firent vne idole, Et quand ie le de ſire, un autre me le vole, Et par l’injuſte ſort d’un cœur inforiuné, Mon Pere m'a ravi ce qu’amour m’a donré, Rigoureux frein d’honneur qui choque ma conſtarce, De l’inéglalité de rang & de naiſſance, Que peux-tu reprocher en ta ſevere loy Qui terniſſe ma gloire, & offenſe le Roy:	L'ont mis dans mon esprit, et ce doux semiment D'un geneteux vainqueur m'en a fait un amant, Mes yeux ses partisans m'en firent une idole, Et quand on le de sire, un autre me le vole, Et par l'injuste sort d'un cœur inforiuné, Mon Père m'a ravi ce qu'amour m'a donré, Rigoureux frein d'honneur qui choque ma constarce, De l'inéglalité de rang et de naissance, Que peux-tu reprocher en ta se trouva Se trouvère l' amour, et offense le Roi:
Ce qui manque à ſon ſang, ſa valeur le lui donne, Qui triomphe des Roys peut porter leurs Couronnes.	Ce qui manque à son sang, sa valeur le lui donne, Qui triomphe des Rois peut porter leurs Couronnes.
Il en a vaincu deux, & le More a tout dit;	Il en a vaincu deux, et le More a tout dit;
C’eſt le nommet ſon Roy, que l'appellet ſon CID, Il partage déja leurs Sceptres & leurs Provinces.	C'est le nommet son Roi, que l'appellet son CID, Il partage déjà leurs Sceptres et leurs Provinces.
On s’acquieit le Royaume en captivant ſes Princes.	On s'acquieit le Royaume en captivant ses Princes.
Leur Couronne eſt acquiſe à ce vaillant Guerriet, Il en peut porter dor comme il fait de laurier.	Leur Couronne est acquise à ce vaillant Guerriet, Il en peut porter dor comme il fait de laurier.
Et marchant ſot les pas & le rang de Pompée.	Et marchant sot les pas et le rang de Pompée.
Tenir un Sceptre en main égal à ſou épée, Et faire un ſeul Royaume en ſes explous divers, Qui commar de aux Etats de tout cet Vnivers, Et que peur la Caſtille à ma gloire redire, Si j’ayme le Heros qui maintient ſon Empire?	Tenir un Sceptre en main égal à sou épée, Et faire un seul Royaume en ses explous divers, Qui commar de aux États de tout cet Univers, Et que peur la Castille à ma gloire redire, Si j'aime le Héros qui maintient son Empire?
Ma flame eſt legitime, & mon affection Fait voir mon jugement en cette éle ction.	Ma flamme est légitime, et mon affection Fait voir mon jugement en cette éle ction.
Qu'en dis tu Leonor, quoy que vieille chenuë;	Qu'en dis tu Leonor, quoi que vieille chenue;
Prononce un ſentiment d'une ame toute nuë, Raiſonne à cœur ouvert, donne en ton jugement Vn aveu pour ma flame.	Prononce un sentiment d'une âme toute nue, Raisonne à cœur ouvert, donne en ton jugement Un aveu pour ma flamme.
O Dieux?	Ô Dieux?
quel mouvement!	quel mouvement!
LEONOR	LEONOR
2 N'en parlez pas, Madame, une ſi noire flame Tacheroit votre honneur auſſi bien que votre ame, Rejettez cet objet de votre ſouvenir, Le crime en eſt honteux & ſujet à puuir Votre rang le défend, la gloire s’intereſſe De voir qu’un Cavalier caprive une Princeſſe.	2 N'en parlez pas, Madame, une si noire flamme Tacherait votre honneur aussi bien que votre âme, Rejettez cet objet de votre souvenir, Le crime en est honteux et sujet à puvir Votre rang le défend, la gloire s'intéresse De voir qu'un Cavalier caprive une Princesse.
Amour ne fait ces coups que contre des eſprirs Qui vivent dans la honte & ſont daus le mépris:	Amour ne fait ces coups que contre des éprirs Qui vivent dans la honte et sont daus le mépris:
Faites que le dédain triomphe de ces charmes, Eteignez ces ardeurs avec l’eau de vos larmes, Et qu’une folle erreur & ua faux jugement Faſſent place à labord d’un meilleur ſentiment, L’amour eſt-ce une foudre où votre ame abatuë, Ait perdu la raiſon dans le feu qui la tuë?	Faites que le dédain triomphe de ces charmes, Eteignez ces ardeurs avec l'eau de vos larmes, Et qu'une folle erreur et ouva faux jugement Fassent place à labord d'un meilleur sentiment, L'amour est-ce une foudre où votre âme abattue, Ait perdu la raison dans le feu qui la tue?
Rodrigue eſt à Chimene, & un nœud Gordien Enchaîne leurs deux cœurs daus un méme lien.	Rodrigue est à Chimène, et un nœud Gordien Enchaîne leurs deux cœurs daus un même lien.
Quel droit d'aimer aux lieux où fon ne peur pretendre?	Quel droit d'aimer aux lieux où son ne peur prétendre?
Et que le Roy reçoive un vaſſal pour ſon Gendre?	Et que le Roi reçoive un vassal pour son Gendre?
Et que la Sœur du Prinee arrive à ce bonheur D’épouſer un ſoldat Fils de ſon Gouverneur.	Et que la Sœur du Prine arrive à ce bonheur D'épouser un soldat Fils de son Gouverneur.
Cela tient du prodige, & votre ame bleſée Doit banir cet objet du fond de ſa penſée, Faire un plus grand deſſein, & de n’avoir des yeux Que pour renare amoureux ou les Roys ou les Dieux.	Cela tient du prodige, et votre âme blesée Doit bannir cet objet du fond de sa pensée, Faire un plus grand dessein, et de n'avoir des yeux Que pour renare amoureux ou les Rois ou les Dieux.
Le Roy de Dannemare a ſa flame allumée Des charmes raviſſans de voire renommée, Vous verrez ſa recherche, & gardez des appas Pour ravir des Monarques, & non pas des Soldats.	Le Roi de Dannemare a sa flamme allumée Des charmes ravissants de voire renommée, Vous verrez sa recherche, et gardez des appas Pour ravir des Monarques, et non pas des Soldats.
L'INFANTE Diſcours injurieux !	L'INFANTE Discours injurieux !
implacable Megere, Oui vtomis ues diſcours que l'enfer te ſuggere, Eſt-ce ainſi qu’aux malheurs tes ſoins me ſont offerts, Et que tu viens briſer mes chaiſnes & mes fers?	implacable Mégère, Oui vtomis discours que l'enfer te sugère, Est-ce ainsi qu'aux malheurs tes soins me sont offerts, Et que tu viens briser mes chaînes et mes fers?
Adoueir mes langueurs & termiuer mes peines Avecque des raiſons auſſi fauſſes que vaines?	Adouir mes langueurs et termiver mes peines Avec des raisons aussi fausses que vaines?
Se ſerteon de lorage à cauier les cpritorm Peut-on guerir un mai avecque du mépris?	Se serteon de lorage à cavier les cpritorm Peut-on guérir un mai que du mépris?
Faire un raiſonnement étant dans la manie, Et traiter un malade avec la tyrannie, Ingrate radoreuſe avec tes ſots diſcours, Tu redouble mes feux avecque mes amours:	Faire un raisonnement étant dans la manie, Et traiter un malade avec la tyrannie, Ingrate radoreuse avec tes sots discours, Tu redouble mes feux avec mes amours:
Parle mieux de Rodrigue, & crois que ſon courage A fait d’un Cavalier un Heros de notre àge, Et que ſa renommée & ſes faits immortels Auront un jour un Temple avecque mille Autels:	Parle mieux de Rodrigue, et crois que son courage A fait d'un Cavalier un Héros de notre âge, Et que sa renommée et ses faits immortels Auront un jour un Temple avec mille Autels:
Mais pendant que ma flamme auſſi chaſte que grande Lui couſerve ma vie & mon cœur en ontande;	Mais pendant que ma flamme aussi chaste que grande Lui couserve ma vie et mon cœur en ontande;
Demande-lui pardon, & les lar mes aux yeux Donne.	Demande-lui pardon, et les lar mes aux yeux Donne.
lui de l'enſens comme Ion fait aux Dieux.	lui de l'ends comme Ion fait aux Dieux.
LEONOR Ma lame, pardonnez aux ferveurs de mon zele, Qui flate cette erreur ne vous eſt pas ſidele, Aprés tant de ſoûpirs qui vous ſechent les os, Dounez treuve à voire ame & vivez en repos.	LEONOR Ma lame, pardonnez aux ferveurs de mon zèle, Qui flatte cette erreur ne vous est pas sidele, Après tant de soupirs qui vous sèchent les os, Dougnez trouve à voire âme et vivez en repos.
LE PAGE Qu'amour eſt triomphant & ſa flame feconde, Puiſqu’il brûle les Dieux auſfi-bien que le monde?	LE PAGE Qu'amour est triomphant et sa flamme féconde, Puisqu'il brûle les Dieux aussi-bien que le monde?
En aveuglant notre ame il nous tient ſous ſa loy, Et fat d’une Bergere une Femme de Roy:	En aveuglant notre âme il nous tient sous sa loi, Et fat d'une Bergère une Femme de Roi:
On en voit maintenant une preuve évidente De lamour de Rodrigue & des feux de l’Infapte, Pour moy ?	On en voit maintenant une preuve évidente De lamour de Rodrigue et des feux de l'Infapte, Pour moi ?
j’aime bien mieux, n’eu déplaiſe au renom, Moun d'untrait d amui, que dun coup de canon.	j'aime bien mieux, n'eu déplaise au renom, Moun d'untrait d amuï, que dun coup de canon.
SCENE II.	SCÈNE II.
CHIMENE, ELVIRE.	CHIMENE, ÉLVIRE.
ELVIRE Ieux quels eſprits flollets entens-ie dans la nuit?	ELVIRE Ieux quels esprits flollets entends-je dans la nuit?
U Qui troublent mon ſi ence, & m’é veillent du bruit Qu'ils font à tous momens dans la chambre du Comte;	V Qui troublent mon si ence, et m'é veillent du bruit Qu'ils font à tous moments dans la chambre du Comte;
La fayeur me ſaiſit auſſi-toſt que i'y monte.	La fais me saisit aussitôt que j'y monte.
Vn friſon tremblotant de foibleſſe & de peur, Heriſſe mes cheveux & me glace le cœur.	Un frison tremblotant de faiblesse et de peur, Hérisse mes cheveux et me glace le cœur.
Parfois plus reſoluë, préte à ne rien craindre, I’entens parler, j'y cours, & ne puis rien atteindre, Et cette triſte voix en ſon begaïement Ne me laiſſe aprés tout qu'un ſeul étonnement, Méreint le plus ſouvent le flambeau qui m'eclaire:	Parfois plus résolue, préte à ne rien craindre, J'entends parler, j'y cours, et ne puis rien atteindre, Et cette triste voix en son begaïement Ne me laisse après tout qu'un seul étonnement, Mèreint le plus souvent le flambeau qui m'éclaire:
Madame, hé qu’eſt-cel á?	Madame, hé qu'est-cel 7?
CHIMENE C’eſt IOmbre de man Pere Qui ehingent nos plaiſirs en de triſtes douleurs, Nous predit notre perte avecque nos hamcers, Le retour de mon Frete.	CHIMENE C'est JOmbre de man Père Qui ehingent nos plaisirs en de tristes douleurs, Nous prédit notre perte avec nos hamcers, Le retour de mon Frère.
ELVIRE	ELVIRE
CHIMENE Son objet me travaille & ſa plainte me tuë, Ce ne ſont que ſoupirs, ce ne ſont que regrets, Ie crains que nos lautiers ne ſe changent en cyptés.	CHIMENE Son objet me travaille et sa plainte me tue, Ce ne sont que soupirs, ce ne sont que regrets, Je crains que nos lautiers ne se changent en cyptés.
Hier que le Soleil avoit fini ſa ronde, D'un voile tenebreux embruniſſoit le monde.	Hier que le Soleil avait fini sa ronde, D'un voile ténébreux embrunissait le monde.
Révant dedans ſa chambte aprés ie ne ſçay quoy, Contte ſon cabinet il ſe preſente à moy Vn petit vent, un broit, un ſuaire, une plainte, Aſſaillent mon eſprit & de deüil & de etainte;	Révant dedans sa chambte après avoir ne sais quoi, Contte son cabinet il se présent à moi Un petit vent, un broit, un suaire, une plainte, Assaillent mon esprit et de deüil et de étainte;
L’effroy ſaiſit mon ame, & ce drap à mes yeux Donnoit quelque candeur parmy ces ſombres lieux;	L'effroi saisit mon âme, et ce drap à mes yeux Donnait quelque candeur parmi ces sombres lieux;
Ie vnvois dans fombrage une petite nue.	Je unvais dans sombrage une petite nue.
Dont la ſombre blancheur n'étoit pas reconnuë.	Dont la sombre blancheur n'était pas reconnue.
Ma vuë eſt en défaut;	Ma vue est en défaut;
mais écoutant parfois.	mais écoutant parfois.
Ce ſuaire rendoit une plaintive voix;	Ce suaire rendait une plaintive voix;
voir que le teconnus auſſi nette & ſi claire Comme me lexprimoit la bouche de mon Pere, Lots qu’il m’entretenoit attendant ſon retour, Du deſtin de mon Frere & de ſon long ſejour, Et pendant que j’écoute & retiens ma patole, l'éntens une voix caſſte u plamede derteieQui touche mon oreille & parlant baſſement, Sembloit en loûpirent ſortir du monument.	voir que le teconnus aussi nette et si claire Comme me lexprimait la bouche de mon Père, Lots qu'il m'entretenait attendant son retour, Du destin de mon Frère et de son long séjour, Et pendant que j'écoute et retiens ma patole, l'entends une voix casste plamede derteieQui touche mon oreille et parlant bassement, Sembloit en loûpirent sortir du monument.
ELVIRE	ELVIRE
O Dieux!	Ô Dieux!
que diſoit-elle?	que disait-elle?
CHIMENE Ajoûte, ame perfide, Ajoûte à tes pechés celui de patricide;	CHIMENE Ajoute, âme perfide, Ajoute à tes péchez celui de patricide;
Fais que les accidens te ſoient indifferens, Commence par ton Pere à meurtrir tes parens;	Fais que les accidents te soient indifférents, Commence par ton Père à meurtrir tes parents;
Prens en main baiſe encor cette fuueſte épee Qu’on a dedans mon ſang ſi lachement trempée, Défaire un ennemi ſur la terre abaru, C’eſt un coup de fureur, & non pas de vertu;	Prends en main baise encor cette fueste épée Qu'on a dedans mon sang si lâchement trempée, Défaire un ennemi sur la terre abaru, C'est un coup de fureur, et non pas de vertu;
Il eſt digne de blame, & non pas de gloire, Son laurier eſt honteux autant que ſa victoire.	Il est digne de blâme, et non pas de gloire, Son laurier est honteux autant que sa victoire.
Par un achopement j ay gliſe ſut les pas, Et recu toui ſoudain le coup de man trépss.	Par un achopement j ai glise sut les pas, Et reçu toui soudain le coup de man trépss.
Rodrigue infortuné, j’aurois fait de tes reſtes, Et préveou d’un coup des amours ſi funeſtes:	Rodrigue infortuné, j'aurais fait de tes restes, Et préveou d'un coup des amours si funestes:
Mais ie laiſſe à mon Comre avec un meilleur ſort, A diſpurer ta vie & à vanger ma mort.	Mais était laisse à mon Comre avec un meilleur sort, A dispurer ta vie et à venger ma mort.
Sçache que cet Enfant tient du ſang de ſon Pere, Et qu’il faut que ta perte éteigne ſa colere,  Que les plus genereux tedoutent ſa valeur, Et qu’il vient pour venger ma perte & mon malheur, Qoy que courant les Mers contre les Infidelles, Deux luſtres ſoient paſſez ſans en avoir nouvell s, Les Dieux en foient loüez puiſquils me lons rendu;	Sache que cet Enfant tient du sang de son Père, Et qu'il faut que ta perte éteigne sa colère, Que les plus généreux tedoutent sa valeur, Et qu'il vient pour venger ma perte et mon malheur, Qoi que courant les Mers contre les Infidèles, Deux lustres soient passez sans en avoir nouvel s, Les Dieux en fi loüez puisquils me lons rendu;
L quil apit feparer l’honneut que j’ay petdu, Mon domaine l'arrend & Rodrigue à ſa honte, Sçaura juſqu’ou s’ésend la valeur de ce Comte.	L' il apit séparer l'honnut que j'ai petu, Mon domaine l'arrend et Rodrigue à sa honte, Saura jusqu'ou s'ésend la valeur de ce Comte.
Voila ma chere Eluire, uu diſcours bien nouye au Qui martyre mon ame & me met au tombeau.	Voilà ma chère Elvire, u discours bien nouye au Qui martyre mon âme et me met au tombeau.
–	
ELLIRE La s’il venoir Madame, auroir-il lien de prendre Le Comie de Gormas ſans le pouvoir, défendre?	ELLIRE La s'il venoir Madame, auroir-il lien de prendre Le Comie de Gormas sans le pouvoir, défendre?
Ha!	Ha!
non, laiſſons des moris les diſcours ſuperflus, Ie corps meurt, Ieſprit part, & ne rerey ue plus:	non, laissons des moris les discours superflus, Je corps meurt, Jésprit part, et ne recréi ue plus:
Ie donne ces penſers à la melancolie, Les dire c’eſt menſonge, & les croire folie, vutre Pere n'er plus jui votre frere auſſi, Vivons dans les plaiſirs, & chaſſons le ſouey	Je donne ces pensers à la mélancolie, Les dire c'est mensonge, et les croire folie, vutre Père n'er plus jui votre frère aussi, Vivons dans les plaisirs, et chassons le souéi
OMIMERE Que tu prens peu de ſoin du malheur qui m’afflige?	OMIMERE Que tu prends peu de soin du malheur qui m'afflige?
ELVIRE La playe eſt dangereuſe alors qu’on la neglige;	ÉLVIRE La plaie est dangereuse alors qu'on la néglige;
Mais ce trait dont la peur a votre eſprit bleſſé, M’aſſure que le mal ſera bien toſt paſſé.	Mais ce trait dont la peur a votre esprit blessé, M'assure que le mal sera bien tôt passé.
eHialala Quand on voit éclairer & tonner ſur ſa téte, L on doit apprehender lorage & la tempete.	eHialala Quand on voit éclairer et tonner sur sa tête, L on doit appréhender lorage et la tempette.
ELVIRE C'eſt n’avoir pointde cœur de eroire au mouvement, Vn corps qui n’a point d’ame & de reſſentiment.	ELVIRE C'est n'avoir pointde cœur de eroire au mouvement, Un corps qui n'a point d'âme et de ressentiment.
Rodrigue eſt votre Epous, on ne peur faire un crime D'un ſacré mariage & d’un feu legitime, Et ſi vous lavez pris, e eſt de la main du RoyLaiſſez parler le monde avec la médilance, Où lon prend de lhonneur, on ne fait point d’offence;	Rodrigue est votre Épous, on ne peur faire un crime D'un sacré mariage et d'un feu légitime, Et si vous lavez pris, e st de la main du RoiLaissez parler le monde avec la médilance, Où lon prend de lhonneur, on ne fait point d'offense;
L’amour eſt triomphant, quand il eſt aſſailly, Et qu'avez-vous à craindre en n’ayant point failly.	L'amour est triomphant, quand il est assailli, Et qu'avez-vous à craindre en n'ayant point failly.
CHIMENE Ha, que trop, & le monde, & fombre de mon Pere Font du cœur d une Fille une ame de vipere;	CHIMENE Ha, que trop, et le monde, et fombre de mon Père Font du cœur d une Fille une âme de vipère;
L’ombre me ſuit par tout, & marchant flanc à flanc, Me montre en ſoûpirant & ſes playes & ſon ſange Me parle en ſon ſilence, & triſte me reproche Vn ſentiment de ladre & une ame de roche, Que ma flame eſt un crime, & de voir ſeulement Rodrigue, c’eſt ſeigner ſon cœur au monument.	L'ombre me suit par tout, et marchant flanc à flanc, Me montre en soupirant et ses plaies et son sangée Me le en son silence, et triste me reproche Un sentiment de ladre et une âme de roche, Que ma flamme est un crime, et de voir seulement Rodrigue, c'est seigner son cœur au monument.
Que l’ingrate fortune en ſon double viſage Nouriſſant ſa memoire a trahi ſon courage, Et qu’il revit encor ayant forcé le ſort, De luitendre la vie en depit de la mort:	Que l'ingrate fortune en son double visage Nourrissant sa mémoire a trahi son courage, Et qu'il revit encor ayant forcé le sort, De luitendre la vie en dépit de la mort:
Que les Cieux ont horreur de voir qu’une joürnée Eclaire à ſon ſepulchre & à mon hymenée;	Que les Cieux ont horreur de voir qu'une joürnée Eclaire à son sépulcre et à mon hyménée;
Et qu’un Prince offenſé d’un excés de couroux Du meurtrier de mon Pere en ait fait mon Epoux.	Et qu'un Prince offensé d'un excès de courroux Du meurtrier de mon Père en ait fait mon Époux.
Que lorſque ſon pouvoir vouloit forcer mon ame, Ma perte avoit des pleurs pour éreindre ma ſlame, Que mon deüil s’oppoſoit aux plaiſirs de ſa Cour, Et la force du ſang à celle de Iamour;	Que lorsque son pouvoir voulait forcer mon âme, Ma perte avait des pleurs pour éreindre ma slamme, Que mon deuil s'opposait aux plaisirs de sa Cour, Et la force du sang à celle de Jamour;
Et ce qui plus encor ma conſtance ſurmonte, Qui rengrege ma peine & redouble ma honte, Que j'ay mis en un jour, en aimant ſon boureau, Sa memoire & ſon corps dans le méme tombeau.	Et ce qui plus encor ma constance surmonte, Qui rengrége ma peine et redouble ma honte, Que j'ai mis en un jour, en aimant son boureau, Sa mémoire et son corps dans le même tombeau.
ELVIRE Choſe étrange à loüir, à ce conte, Madame, Le corps doit au ſepulchre, & fait parler ſon ameVotre Pere endormy dans la tombe & le deüil, Pour vous faire une plainte eſt ſorty du cercüeil!	ELVIRE Chose étrange à louir, à ce conte, Madame, Le corps doit au sépulcre, et fait parler son âmeVotre Père endormi dans la tombe et le deuil, Pour vous faire une plainte est sorti du cercueil!
Quelque impoſteur Démon vous a voulu ſeduire, La verité vous parle en la boucbe d’Eluire.	Quelque imposteur Démon vous a voulu séduire, La vérité vous parle en la boucbe d'Elvire.
Laiſſez les Morts aux morts, les Dmons aux enfers, Quittez e:	Laissez les Morts aux morts, les Dmons aux enfers, Quittez e:
tte humeur noire & ſortez de ſes fers, Rejettez ces objets dont vous étes decuë, Et cette illuſion qui vous trompe la vûë.	tte humeur noire et sortez de ses fers, Rejettez ces objets dont vous êtes décue, Et cette illusion qui vous trompe la vue.
C’eſt un ennemi de crainte & de langueur Qui travaille votre ame & trouble votre cœur.	C'est un ennemi de crainte et de langueur Qui travaille votre âme et trouble votre cœur.
Quand lame eſt dans le Ciel aux delices ravie, Elle na plus de foins de vengeance ceu envie, D'enfer on n’en vient pas, & des deux autres lieux Elle n’en ſort jamais que pour aller aux Cieux.	Quand lame est dans le Ciel aux délices ravie, Elle na plus de foins de vengeance ceu envie, D'enfer on n'en vient pas, et des deux autres lieux Elle n'en sort jamais que pour aller aux Cieux.
Dans ce raiſonnement comment ſe peur-il faire, Qu'un ombre vous reproche une ame de vipere?	Dans ce raisonnement comment se peur-il faire, Qu'un ombre vous reproche une âme de vipère?
CITIMENE Cet entretien m'ennuye, & pour en voir le fonds, Il faudroit épuiſer une Mer de raiſous.	CITIMENE Cet entretien m'ennuie, et pour en voir le fond, Il faudrait épuiser une Mer de raisous.
Prens-le pour un prodige ou bien pour des merveilles, I en appelle à témoin mes yeux & mes oreilles.	Prends-le pour un prodige ou bien pour des merveilles, I en appelle à témoin mes yeux et mes oreilles.
L’oreille la plus juſte a de trompeurs appas,	L'oreille la plus juste a de trompeurs appas,
B2 Mais ce que lœil à eu ne le diſpute pas.	B2 Mais ce que lœil à eu ne le dispute pas.
ELVIRE Madame, c’en eſt fait.	ÉLVIRE Madame, c'en est fait.
j'ay le don du filence.	j'ai le don du silence.
Pardonnez à ma langue & a mon ignorance.	Pardonnez à ma langue et à mon ignorance.
SCERE III.	SCE III.
L'INFANTE LEONOR, LE PAGE.	L'INFANTE LEONOR, LE PAGE.
L’INFANIE La fio la raiſon lemporte- ſur Iamour;	L'INFANIE La fio la raison lemporte- sur Iamour;
Le jugement pre ſide & commande à ſon tour, La prudence à lardeur de ma flame ariétée, I’ay perdu le tranſport qui m'avoit emportée, Et voy ſans paſſion que tes divins cor ſeils Sont contre un trait d’amour de puiſſans appareils, I'avois Iſprit demis, & mon ame bleſſée N'adoroit que l'objer de ſa folle penſee.	Le jugement pré side et commande à son tour, La prudence à lardeur de ma flamme ariétée, J'ai perdu le transport qui m'avait emportée, Et vois sans passion que tes divins cor seils Sont contre un trait d'amour de puissants appareils, J'avais Isprit demis, et mon âme blessée N'adorait que l'objer de sa folle pense.
I’oub iois mon honneur pour mon contentement, Et trahiſois ma gloire en aimant cet amant.	J'oubais mon honneur pour mon contentement, Et trahisais ma gloire en aimant cet amant.
Mon cœur en eſt honteux, & mon regret s’exprime Avec mon repentir la tache de mon crime;	Mon cœur en est honteux, et mon regret s'exprime Avec mon repentir la tache de mon crime;
Es ayant balancé ma flame & mon devoir, Ie lui ferme les yeux, & ne le veux plus voir.	Es ayant balancé ma flamme et mon devoir, Je lui ferme les yeux, et ne le veux plus voir.
Que Rodrigue poſſede & adore Chimene, le neu prenuraj jemuionno siour i de hame;	Que Rodrigue possède et adore Chimène, le neu prenurajà jemuionno si jour de hame;
Ces aveugles deſirs témorgnent mon erreut .	Ces aveugles désirs témorgnent mon erreut .
Sa gloire ni ſon nom ne ſont plus dans mon cœur, Et rien que le dédaain maintenant ny demeure, La plus courre folie eſt toûjours la meilleure.	Sa gloire ni son nom ne sont plus dans mon cœur, Et rien que le dédaain maintenant ni demeure, La plus courre folie est toujours la meilleure.
LEONOR ren renargruec tor Prux.	LEONOR ren renargruec tor Prux.
puiſque mes ſentimens Ont touché votre cœur de ſi bous mouvemens, Amour que tes beaux feux dans le cœur de nos Dame Sont de peu de durée & touchent peu leurs ames.	puisque mes sentiments Ont touché votre cœur de si bous mouvements, Amour que tes beaux feux dans le cœur de nos Dame Sont de peu de durée et touchent peu leurs âmes.
Rodrigue la cha rmoit & dardeur & d’appas, Et maintenant ſes yeux ne le connoiſſent pas.	Rodrigue la cha mait et dardeur et d'appas, Et maintenant ses yeux ne le connaissent pas.
SCENE IV.	SCÈNE IV.
CHIMENE, ELVIRE, L'OMBRE DV COMTE qui entre au Theatre par une porte auſſi-toſt qu'Eluire eſt entrée.	CHIMENE, ÉLVIRE, L'OMBRE DU COMTE qui entre au Théâtre par une porte aussitôt qu'Elvire est entrée.
L’OMBRE DV COMTE	L'OMBRE DU COMTE
Eynes du destin des humains, N Severes & fatales Parques Qui tordez dans vos triſtes mains, Les fu ſeaux des Bergers comme ceux des Monarques;	Eynes du destin des humains, N Severes et fatales Parques Qui tordez dans vos tristes mains, Les fu seaux des Bergers comme ceux des Monarques;
Filtandrieres qui de nos jours Racourcieez la trame ou prolongez le cours, Prononçans vos Arrets dans votre Chambre obſeure.	Filtandrières qui de nos jours Racourcieez la trame ou prolongez le cours, Prononçant vos Arrets dans votre Chambre obsure.
Déeſſes agrée que mon Ombre en ces lieux Aceu ſe un monſtre de nature, D’un crime deteſté des hommes & des Dieux.	Déesses agrée que mon Ombre en ces lieux Acev se un monstre de nature, D'un crime détesté des hommes et des Dieux.
Furte étrange des Enfers, Cruelle & perfide Chimene, La Parque me tient dans ſes fers:	Furte étrange des Enfers, Cruelle et perfide Chimène, La Parque me tient dans ses fers:
Mais ils ont des douceurs à l'égard de ma peine, Peux-tu vivre & voir à ton flane, Le Meurtrier de ton Pere, & le bourreau de ton ſang Luy pardonner ma mort, lui partager ta couche, Ame prodrgieuſe!	Mais ils ont des douceurs à l'égard de ma peine, Peux-tu vivre et voir à ton flane, Le Meurtrier de ton Père, et le bourreau de ton sang Lui pardonner ma mort, lui partager ta couche, Âme progieuse!
ô cœur ſans mouvement Au malheur qui me touche As perdu l’honneur & te reſſentiment?	ô cœur sans mouvement Au malheur qui me touche As perdu l'honneur et te ressentiment?
Cœur ingrat ſans humanité, Au lieu de vanger certe offence, Tu la mets dans l’impudicité.	Cœur ingrat sans humanité, Au lieu de venger certe offense, Tu la mets dans l'impudicité.
Fermant l’œil à l’honneur & à la bienſceance, Tu fais des vœux en ſa faveur, Lorſque le ſang te pouſſe, amaur retient ton cœur, Et tu devrois mourir ou venger cette injure, Mais par un artifice & un ſubtil détour Les ſentimens de la nature Ont cedé leur puiſſance à celle de l’amour.	Fermant l'œil à l'honneur et à la bienséance, Tu fais des vœux en sa faveur, Lorsque le sang te pousse, amaur retient ton cœur, Et tu devrais mourir ou venger cette injure, Mais par un artifice et un subtil détour Les sentiments de la nature Ont cedé leur puissance à celle de l'amour.
Ses feux eſſuyerent tes larmes, Ton ame eſclave en ta priſon, Fit de mon homicide un ſu jet de tes eharmes?	Ses feux essuyèrent tes larmes, Ton âme esclave en ta prison, Fit de mon homicide un su jet de tes eharmes?
Tu ſouffris quul te vint offrir L’épée à mon logis qui m'avoit fait mourir, Apés lavoir plongée au fond de mes entrailles, Et feignant de te plaindre en tes fauſſes douleurs, On ne vid à mes funerailles, Pour un fleuve de ſang qu’une goute de pleurs, Dun jour de ſoûpirs & de deüil, Ton amour en fiſt une Féte, Ie n’éſtois pas dans le cercüeil, Qu'on le vit couronné dun laurier ſur la téte, Et par un excés d’amitié Le nommant de ta vie une chere moitié, Ton ame plus d'amour que de douleur atteinte, Aprés que ton amant eut éteint mon flambeau, Oſa dire en faiſant ſa plainte, – La moitié de ma vie a mis l’autre au tombeau.	Tu souffris quul te vint offrir L'épée à mon logis qui m'avait fait mourir, Apez lavoir plongée au fond de mes entrailles, Et feignant de te plaindre en tes fausses douleurs, On ne vit à mes funérailles, Pour un fleuve de sang qu'une goute de pleurs, Dun jour de soupirs et de deüil, Ton amour en fit une Fête, Je n'éstois pas dans le cercueil, Qu'on le vit couronné dun laurier sur la tête, Et par un excès d'amitié Le nommant de ta vie une chère moitié, Ton âme plus d'amour que de douleur atteinte, Aprés que ton mant eut éteint mon flambeau, Osa de en ta sa plainte, La moitié de ma vie a mis autre , tombeau.
V'angeurs des crimes des humains, O Dieux avez-vous pû reſoudre, A retenir vos juſles mains De ne jetter la flame & les careaux de foudre.	V'angeurs des crimes des humains, Ô Dieux avez-vous pu résoudre, A retenir vos jusles mains De ne jeter la flamme et les careaux de foudre.
O Monſtre que ton ſang eſt impur !	Ô Montre que ton sang est impur !
A changé dans les feux de cet amour trompeur.	À changé dans les feux de cet amour trompeur.
Que tes ſens ſont gâtez, que ton cœur dégenere!	Que tes sens sont gâtez, que ton cœur dégenere!
Que tu rends le devoir avec pou déquité, De mettre l’amour de ton Pere Et celle dun Meurtrier en méme egalité.	Que tu rends le devoir avec pou déquité, De mettre l'amour de ton Père Et celle dun Meurtrier en même égalité.
L’amour & le ſang dans ton cœur Ont voulu diſputer leur place, L’amour l’a trouvé tout d’ardeur, Et l'autre en l’aprochant l’a trouvé tout de glace:	L'amour et le sang dans ton cœur Ont voulu disputer leur place, L'amour l'a trouvé tout d'ardeur, Et l'autre en l'approchant l'a trouvé tout de glace:
La nature avec le devoir Ont montré leur foibleſſe en croyant t'émouvoir, La paſſion d’amour préocupe ton ame,	La nature avec le devoir Ont montré leur faiblesse en croyant t'émouvoir, La passion d'amour préoccupe ton âme,
Ton eſprit n'a des ſoins que pour l'entretenir, Et fon idée avee ſa flame En ont bani la mienne avec mon ſouvenir.	Ton esprit n'a des soins que pour l'entretenir, Et son idée avée sa flamme En ont bani la mienne avec mon souvenir.
L’honneur m'a tiré du tombeau, Mon couroux va juſqu'à la rage, De voir dans tonlit mon beurreau, Et qu’ayant eu ma vie il ait mon heritage.	L'honneur m'a tiré du tombeau, Mon courroux va jusqu'à la rage, De voir dans tonlit mon beurreau, Et qu'ayant eu ma vie il ait mon héritage.
Avec mes eſprits égarez – Il m'a vû dans ſa chambre en ſes lieux effrayez, Oú mon gleve de feu ſouvent le perſecute, Mais avec ma fureur & tout mon deſeſpoir, Lorſque mon Ombre l’execute, Ie n'ay que l’ardeur & non pas le pouvoir.	Avec mes esprits égarés , Il m'a vu dans sa chambre en ses lieux effrayés, Où mon glève de feu souvent le persécute, Mais avec ma fureur et tout mon désespoir, Lorsque mon Ombre l'exécute, Je n'ai que l'ardeur et non pas le pouvoir.
Flaté dun faux ſoulagement, Dans la vengeance qui me tuë Ie m'en défais en un moment, Et j'oyplaindre ſon ombre à mes pieds abatuë.	Flatte dun faux soulagement, Dans la vengeance qui me tue Je m'en défais en un moment, Et j'aiplaindre son ombre à mes pieds abattue.
Le tranſport d’un cœur indompté, Lui donne le trépas qu’il avoit merité, Et ma rigueur n'eſt pas encoreépuiſée, Puis revenant aprés d’un ſonge décevant Mon ame ſe trouve abusée De n’avoir combatu que l’ombre avec le vent;	Le transport d'un cœur indompté, Lui donne le trépas qu'il avait mérité, Et ma rigueur n'est pas encoreépuisée, Puis revenant après d'un songe décevant Mon âme se trouve abusée De n'avoir combattu que l'ombre avec le vent;
Mais je ſens l’aproche du tems Avec le retour d’un vi ſage Qui doit faire des malcontens.	Mais je sens l'approche du temps Avec le retour d'un vi age Qui doit faire des malcontents.
A la lice oú l'honneur & ma pertel éngage;	À la lice où l'honneur et ma pertel éngage;
Le Comte n'eſt pai loin d’icy;	Le Comte n'est pai loin d'ici;
D'une ame inexorable & d’un cœur ſans mercy, Il vient venger mon ſang par l’effort de ſes armes, Adieu je n’ay plus rien au monde à deſirer, Il te fera jetter des larmes, Autant que mon trépas l’avoit fait ſoûpirer.	D'une âme inexorable et d'un cœur sans merci, Il vient venger mon sang par l'effort de ses armes, Adieu je n'ai plus rien au monde à désirer, Il te fera jeter des larmes, Autant que mon trépas l'avait fait soupirer.
L’Ombre ſort.	L'Ombre sort.
SCENE V.	SCÈNE V.
ELVIRE, CHIMENE, ELVIRE.	ÉLVIRE, CHIMENE, ÉLVIRE.
Ieux:	Jeux:
que viens-je d’oüir ?	que viens-je d'ouïrir ?
Cieux !	Cieux !
qu’ay-je vù L paton.	qu'ai-je vù L pâton.
Qu'un morr revienne au moude & ſe faſſe counoitre?	Qu'un morr revienne au moude et se fasse counaitre?
Tout eſt perdu, Madame!	Tout est perdu, Madame!
CHIMENE.	CHIMENE.
Helas:	Hélas:
je n’en puis plus:	je n'en puis plus:
Le venin eſt mortel, les diſcours ſuperflus.	Le venin est mortel, les discours superflus.
Ie voy déja le mal dont l'Ombre nos menace.	Je vois déjà le mal dont l'Ombre nos menace.
ELVIRE Mon ame eſt a la géns & mon eſprit de glace.	ÉLVIRE Mon âme est à la gens et mon esprit de glace.
CHIMENE.	CHIMENE.
La mienne eſt éperduë, & fobjet des malheurs Ne fait mes entretiens que de ſang & de pleurs.	La mienne est éperdue, et fobjet des malheurs Ne fait mes entretiens que de sang et de pleurs.
ELVIRE Divertiſſez la erainte d’avec leſperance, Montrez aux accidens l'effort de la conſſance:	ELVIRE Divertissez la erainte d'avec lespérence, Montrez aux accidents l'effort de la conssance:
ded on cipin esa plence d'anmene trune, Et les biens & les maux que les deſtins nos font.	ded on cipin esa plence d'anmène trune, Et les biens et les maux que les destins nos font.
12 II.	12 II.
SCENE PREMIERE D.	SCÈNE PREMIÈRE D.
FERNAND LE PRINCE.	FERNAND LE PRINCE.
D ARIAS, ALONSE D.	 ARIAS, ALONSE D.
DIEGE D ANCHE, D FERNAND.	DIÉGE D ANCHE, D FERNAND.
V on ne differe plas prévenons lentrepriſe, I IL'ennemi prend ſon tems pendant on on le méprile L'avis eſt trop expres, le Mote a daus le telhu Puiſqu’il ancte en nos ports quelque mauvais de ſſein.	V on ne diffère plas prévenons lentreprise, I L'ennemi prend son temps pendant on on le méprile L'avis est trop exprès, le Mote a daus le telhu Puisqu'il ancte en nos ports quelque mauvais de sein.
Vn Roy de ſes Erats eſt l’Ange tetelaire, La crainte eſt legitime & la mort neceſſaire, Nos Vaiſſeaux ſont armez pour aller au devant, Donnons la tame à fonde & les voiles au vent, Il les faut attaquer par devant, par deriere, Et gagnions en leur perte une bataille entiere, Puiſqu’ils viennent à nous allons les racüeillir, Au lieu de nous défendre il les faut aſſaillir, La victoire nous rit, & arréte ſon aîle, Dedans les champs de gloire où l’honneur nous apelle.	Un Roi de ses Erats est l'Ange tetélaire, La crainte est légitime et la mort nécessaire, Nos Vaisseaux sont armés pour aller au devant, Donnons la tame à fonde et les voiles au vent, Il les faut attaquer par devant, par derière, Et gagnions en leur perte une bataille entière, Puisqu'ils viennent à nous allons les racueillir, Au lieu de nous défendre il les faut assaillir, La victoire nous rit, et arrête son âme, De les champs de gloire où l'honneur nous apelle.
Ie voy déja couvers de corps & d’oſſemens Des ennemis défaits, tous ces deux Elemens, Et la plaee & la rade & la méme frontiere, Etre un champ de bataille avec un cemetiere.	Je vois déjà couverts de corps et d'osssements Des ennemis défaits, tous ces deux Éléments, Et la place et la de et la même frontière, Etre un champ de bataille avec un cemetiere.
L'exces de leur orgïeil en m’échauffant le ſein Me met la fougue en lame & lépée à la main, Allons en triomphant ajoûter leur dé faite.	L'excès de leur orgieil en m'échauffant le sein Me met la fougue en lame et lépée à la main, Allons en triomphant ajouter leur dé faite.
A tant de vers lauriers qui nous ceignent la téte ?	À tant de vers lauriers qui nous ceignent la tête ?
Et apprendre aux vaincus que c’eſt un pas gliſtaht De chocquer les Etats d’un Monarque puiſſant, Arias eſt party pour aller reconnoitre, Et voir qui de nos Ports eſt maintenant le Maitre:	Et apprendre aux vaincus que c'est un pas glistaht De chocquer les États d'un Monarque puissant, Arias est parti pour aller reconnaître, Et voir qui de nos Ports est maintenant le Majaitre:
Dieux!	Dieux!
qu’il eſt diligent, le voicy de retour, Ie m’étonne à le voir de ſon peu de ſejonr:	qu'il est diligent, le voici de retour, Je m'étonne à le voir de son peu de séjonr:
Vous voila, Cavalier?	Vous voilà, Cavalier?
Et bien quelles nouvelles?	Et bien quelles nouvelles?
Les deſtins feront-ils nos guerres éternelles?	Les destins feront-ils nos guerres éternelles?
Le More avec le trait qu’il porte dans le flane.	Le More avec le trait qu'il porte dans le flamane.
Nous veut-il faire encore nagenetouus ion lang?	Nous veut-il faire encore nagenetouus ion lang?
N'eſt.	N'est.
il pas ſatitfait de ce que la victoire M’a donné deſſus lui deux triomphe de gloire?	il pas satitfait de ce que la victoire M'a donné dessus lui deux triomphe de gloire?
Qu’ayant renté deux fois ma force & ma vertu, Il ſe ſoit vû deux fois à mes pieds abata?	Qu'ayant renté deux fois ma force et ma vertu, Il se soit vu deux fois à mes pieds abata?
I	I
D.	D.
ARIAS.	ARIAS.
Sire, la Mer blanchit de vagues & de voiles, Les hunes des Vaiſſeaux aprochent des étoiles, On a vû ce matin venir de toutes paits Des appareils de guerre avec des étendarts, Les forces d’Aragon, des Mores & des Perſes Rempliſſent norre Port de nations diveiſes, Et n’attendent armés de moment en moment Pour gagner le canal qu'un favorable vent;	Sire, la Mer blanchit de vagues et de voiles, Les hunes des Vaisseaux approchent des étoiles, On a vu ce matin venir de toutes paits Des appareils de guerre avec des étendards, Les forces d'Aragon, des Mores et des Perses Remplissent norre Port de nations divises, Et n'attendent armés de moment en moment Pour gagner le canal qu'un favorable vent;
Quoyque venant à nous contre vent & marée Vne Flote ſe ſoit dans lorage égarée.	Quoique venant à nous contre vent et marée Une Flote se soit dans lorage égarée.
Neptune eſt pour Seville, & Ionde & les écüeils Découvrent à leurs yeux de funeſtes cercüeils.	Neptune est pour Seville, et Ionde et les écueils Découvrent à leurs yeux de funestes cercueils.
L’orage les combat, & perſonne ne teute De s’approcher du lieu pour faire la deſcente, – Le Cieſ n'eit pomt anejious lesvents lont pour voue, Si nous les attaquons, la victoire eſt à nous,	L'orage les combat, et personne ne tute De s'approcher du lieu pour faire la descente, Le Cies n' pomt anejious lesvents lont pour voue, Si nous les attaquons, la victoire est nous,
D.	D.
FERNAND Faiſons-le, c’eſt bien dit, leur mal eſt dans la criſe, E nonneur rait mon deſſein, & le droit l'autoriſe, Les Dieux en ma faveur arment les Elemens, I'attens de ton avis de bons évenemens.	FERNAND Faisons-le, c'est bien dit, leur mal est dans la crise, E nonneur rait mon dessein, et le droit l'autorise, Les Dieux en ma faveur arment les Éléments, J'attends de ton avis de bons événements.
LE PRINCE Sire, un cœur geuereux en la fleur de ſon àge, Doit rendre ſa valeut égale à ſon courage.	LE PRINCE Sire, un cœur geuereux en la fleur de son âge, Doit rendre sa valut égale à son courage.
Donnez-moy ces employs, & que jeune Guerrier Ie m’éleye en Guerrier à l'ombre du laurier, Vn Prince que l'honneur pouſſe aprés la victoire, Ainſi que dans le ſang eſt conçâ dans la gloire, Il doit étre ſemblable au je ton fleuriſſant, Qui nous porte la roſe, qui nous pique en naiſſant, Tous les enfans des Roys ont une ame allumée, D’un deſit de triomphe & de la renommée, Sans meſurer ma force au nombre de mes ans Dounen amataieurees empioje triomphans.	Donnez-moi ces emplois, et que jeune Guerrier Je m'élise en Guerrier à l'ombre du laurier, Un Prince que l'honneur pousse après la victoire, Ainsi que dans le sang est conçâ dans la gloire, Il doit être semblable au je ton fleurissant, Qui nous porte la rose, qui nous pique en naissant, Tous les enfants des Rois ont une âme allumée, D'un des de triomphe et de la renommée, Sans mesurer ma force au nombre de mes ans Dounén amataieurees empioje triomphans.
Ie veux aprendre aux Mores en montrant ma puiſſanee Que ſon Sceptre trembloit au jour de ma naiſſance:	Je veux apprendre aux Mores en montrant ma puissance Que son Sceptre tremblait au jour de ma naissance:
Qu il doit prendre mes loix, m’avoüer pour Vainqueur Et que tout ſon Empire eſt moindre que mon cœur.	Qu il doit prendre mes lois, m'avouer pour Vainqueur Et que tout son Empire est moindre que mon cœur.
D.	D.
FERNAND On bort iieux ſonger, cette ardeur de courage N’eſt pas encore au point d'étre miz en uſage, Ie loüe fort vos deſſeins quoyqu’ils ne ſoient pas meurs L’Eté donne des fruits.	FERNAND On bort iieux songer, cette ardeur de courage N'est pas encore au point d'être miz en usage, Je loue fort vos desseins quoiqu'ils ne soient pas meurs L'Été donne des fruits.
& le Printems des fleurs, Les épies que le tems hors de ſaiſon avance Annoncent la moiſon de non pas mounonidor Quand les fruits ſont pendans on les laiſſe meurir, Vn ſems fait concevoit, un autre conquerir.	et le Printems des fleurs, Les épies que le temps hors de saison avance Annoncent la moison de non pas mounonidor Quand les fruits sont pendants on les laisse mûrir, Un sems fait concevait, un autre conquérir.
D DIEGIE C’eſt un cœur d’Alexandre;	 DIIEGIE C'est un cœur d'Alexandre;
ou l'ame de Pompée.	ou l'âme de Pompée.
D SANCHE Quand il vint dans le monde il portoit ſon épées	 DANCHE Quand il vint dans le monde il portait son épées
D DIEGVE Si la torce egaloit les deſſeins & les vœuxs L’Vnivers trembleroit ſous ſes faits genereux.	 DIIEGUE Si la torce égalait les desseins et les vœuxs L'Univers tremblerait sous ses faits généreux.
D ALONE Son cœur exprime aſſez qu’il eſt né pour la guerre, Et qu’il doit être un jour le Maitre de la terre.	 DONE Son cœur exprime assez qu'il est né pour la guerre, Et qu'il doit être un jour le Majaitre de la terre.
D DIEG Qu'à ce grand Prince à craindre D SANCHEIl doit tout eſperer:	 DIEG Qu'à ce grand Prince à craindre D ANCHEIl doit tout espérer:
Vn cœur dans ſa faveur n’a rien à deſirer.	Un cœur dans sa faveur n'a rien à désirer.
SCENE II.	SCÈNE II.
ELVIRE, CHIMENE, ELVIRE.	ÉLVIRE, CHIMENE, ÉLVIRE.
E Comte eſt de retour.	E Comte est de retour.
L CHIMENE Hé Dieux!	 LHIMENE Hé Dieux!
quelle nouvelle?	quelle nouvelle?
Mon ame en eſt honteuſe autant que criminelle, Qui le ſçait, Eluire?	Mon âme en est honteuse autant que criminelle, Qui le sait, Elvire?
ELVIRE Madame, ie le croy,	ÉLVIRE Madame, ie le crois,
OMIMENE S’il étoit dans Seville, il auroit vû le Roy:	OMIMENE S'il était dans Seville, il aurait vu le Roi:
Il n’eſt pas ignorant des devoits qu’il doit rendre, Ie ne le ſçaurois croire, & ne l- puis comprendre, Dix ans ſont écoulez quil partit de chez nous	Il n'est pas ignorant des devaits qu'il doit rendre, Je ne le saurais croire, et ne l' est comprendre, Dix ans sont écoulez quil partit de chez nous
EL IRE Et s’il vient aujourd’huy vous en étonnez-vous ?	ELLE IRE Et s'il vient aujourd'hui vous en étonnez-vous ?
Le tems eſt il ſi long pour un homme de guerre?	Le temps est il si long pour un homme de guerre?
Qui vient de parcourir & la mer & la terre.	Qui vient de parcourir et la mer et la terre.
CHIMENE Non, mais le ſeul objet dun ſiniſtre malheur M'en ôta la creance, & m’en donne la peur.	CHIMENE Non, mais le seul objet dun sinistre malheur M'en ôta la créance, et m'en donne la peur.
ELVIRE Comme on a pris ſouvent des verités pour fables, Des bruits ſemés à faux ſe trouvent veritables.	ELVIRE Comme on a pris souvent des vérités pour fables, Des bruits semés à faux se trouvent véritables.
CHIMENE Ha!	CHIMENE Ha!
qu’il n'eſt que trop vray, puiſque mon ſentimen' Met mon ame en deſordre & dans l'étonnement, Le cœur (de nos malheurs le fidele interprete) Me preſente un foudre allumé ſur ma téte, Mon Frore eſt genereux, il ne ſouffrira pas Cette funeſte mort ſans vanger ce trépas, Le ſang ne peut mentir la vengeance eſt ſi douce Qu'elle ſert d'égüillon au devoir qui le pouſſe.	qu'il n'est que trop vrai, puisque mon sentimen Met mon âme en désordre et dans l'étonnement, Le cœur (de nos malheurs le fidèle interprète) Me présente un foudre allumé sur ma tête, Mon Frore est généreux, il ne souffrira pas Cette funeste mort sans venger ce trépas, Le sang ne peut mentir la vengeance est si douce Qu'elle sert d'égüillon au devoir qui le pousse.
Ciel!	Ciel!
que puis-je eſpe ur d’un mal ſans gueriſon?	que puis-je espée ur d'un mal sans guérison?
Qui m'ôte la prudentt, & blaiſſe ma raiſon!	Qui m'ôte la prudent, et blaisse ma raison!
Mais d’où vient çet avis?	Mais d'où vient çet avis?
ELVIRE Ce ſoin eſt inutile, Perſonne ne le ſçair que par unbruit de Ville :	ELVIRE Ce soin est inutile, Personne ne le sçair que par unbruit de Ville :
C’eſt une fauſſe alarme, & le.	C'est une fausse alarme, et le.
Roy ni la Cour Ne parlent poiut de lui, ni moins de ſon retour.	Roi ni la Cour Ne parlent poiut de lui, ni moins de son retour.
Ie m'en ſuis informée, & le ſçay de l’Infante, Par la bouche d’Alonſe & de ſa Gouvernante.	Je m'en suis informée, et le sais de l'Infante, Par la bouche d'Alonse et de sa Gouvernante.
On dit que des Marchands trafiquans ſur les eaux L’ont vû deſſus la Mer commander des Vaiſſeaux.	On dit que des Marchands trafiquants sur les eaux L'ont vu dessus la Mer commander des Vaisseaux.
Ie n’en ſçay plus, Madame, demeure étonnée Des faveurs que le Ciel donne à ſa deſtinée, Et que courant le monde & les Ports étrangers, Il ait pû ſubfiſſer parmi tant de dangers;	Je n'en sais plus, Madame, demeure étonnée Des faveurs que le Ciel donne à sa destinée, Et que courant le monde et les Ports étrangers, Il ait pu subfisser parmi tant de dangers;
Pour prevenir un mal, s’il vient dans la Province, Faites aller ce bruit à l'oreille du Prince, Son aſbolu pouvoir d’un ſeul commandement Portera ces deux cœurs dans l'accommodement;	Pour prévenir un mal, s'il vient dans la Province, Faites aller ce bruit à l'oreille du Prince, Son asbolu pouvoir d'un seul commandement Portera ces deux cœurs dans l'accommodement;
Detems qui de ioosli termine toutes choſes, L'un buiſſon epineux fera naitre des roſes.	Detems qui de ioosli termine toutes choses, L'un buisson épineux fera naître des roses.
Et ſi lon voit un jour ces Cavaliers amis, Le Roy va triompher de tous ſes ennemis.	Et si lon voit un jour ces Cavaliers amis, Le Roi va triompher de tous ses ennemis.
CHIMENE Iuſtes Cieux?	CHIMENE Justes Cieux?
fi ma ſaute eſt du tout eftacce;	fi ma saute est du tout eftacce;
Détournez les malheurs dont ie ſuis mémacée?	Détournez les malheurs dont ici suis mémacée?
Finiſſez mes ſoûpirs, & bornant mes douleurs, Donnez treuve a mon ame, & eſſuyez mes pleurs.	Finissez mes soupirs, et bornant mes douleurs, Donnez trouve à mon âme, et essuyez mes pleurs.
BUTHIEI.	BUTHIEI.
LE COMIE, TEANDRE, LE PAGE.	LE COMIE, TEANDRE, LE PAGE.
LE COMTE Epuis ce triſte jour que dans les Champs d’Ibere, DCe Cavalier m’aprit le meurire de mou Pere, Que Chimene étoit jointe à ce monſtre d’horreur, I’ay peine à retenir ma rage & ma fureur, Baron, voicy la place où ma juſſe vengeance ruoit orer la vie & punir ſon offenſe.	LE COMTE Epuis ce triste jour que dans les Champs d'Ibère, DCe Cavalier m'aprit le meurire de mou Pere, Que Chimène était jointe à ce monstre d'horreur, J'ai peine à retenir ma rage et ma fureur, Baron, voici la place où ma jusse vengeance ruait orer la vie et punir son offense.
Donne lui ce cartel, & mets tout ton pouvoir, Sans qu'on s’en aperçoive à me le faire voit.	Donne -lui ce cartel' on sainte tout ton pouvoir, Sans qu'on s'en aperçoive à me le faire voit.
TEANDRE L'honneur de cet employ m'emporte dans la gloire.	TEANDRE L'honneur de cet emploi m'emporte dans la gloire.
I’attens de ce combat une double victoire, Ie vois déja mourir à mes pieds ſon ſecond, Et pars pour les conduire oú l’honneur les ſemond, oeignez un refuge en cas d’une pourſuite, Et que leur mort honteuſe honore notre fuite, Rodrigue a le ſuport & les faveure de Roy, La colere du Prince eſt pire que ſa loy.	J'attends de ce combat une double victoire, Je vois déjà mourir à mes pieds son second, Et pars pour les conduire oú l'honneur les semond, oeignez un refuge en cas d'une poursuite, Et que leur mort honteuse honore notre fuite, Rodrigue à le suport et les faveure de Roi, La colère du Prince est pire que sa loi.
LE COM E Va, nous n'avons qu'an pas juſquaux murs de Tolede, C’eſt le lien de refoge & de notre remede.	LE COM E Va, nous n'avons qu'an pas jusquaux murs de Tole, C'est le lien de refoge et de notre remède.
LE PAAGE Monſieur, pour prévenir toutes fortes de maux, Ie m’en vais préparer nos gens & nos chevaux.	LE PAGE Monsieur, pour prévenir toutes fortes de maux, Je m'en vais préparer nos gens et nos chevaux.
LE COMTE Oüy, Page, prend ce ſoin, jartens cet homieide.	LE COMTE Oui, Page, prend ce soin, jartends cet homie.
LE PAGE Ce monſtre doit mourir des mains de cet Alcide.	LE PAGE Ce montre doit mourir des mains de cet Alcide.
SCLNE IV.	SCLNE IV.
LE COMTE ſeul,	LE COMTE seul,
grands Dieux qui voyez les deſtins des humains, O Et tenez leur vie & leur mort dans vos mains;	grands Dieux qui voyez les destins des humains, Ô Et tenez leur vie et leur mort dans vos mains;
Qui vous intereſſez dans leurs jaſtes querelles, Et avez en horreur les ames criminelles, Vous voyez mon deſſein, & liſſez dans mon cœur, Aitendunt un Meurtrier dedans ce champ n’houneur;	Qui vous intéressez dans leurs jastes querelles, Et avez en horreur les âmes criminelles, Vous voyez mon dessein, et lissez dans mon cœur, Aitendunt un Meurtrier dedans ce champ n'houneur;
En demandant la vie & le ſaug de mon Pere, Favorilez mes vœur & ma junte conte	En demandant la vie et le saug de mon Père, Favorez mes vœur et ma junte conte
SCENE THEANDRE, D RODRIGVE, D SANCHE,	SCÈNE -THÉANDRE, D RODRIGUE, D ANCHE,
THEANDRE N genereux Guerrier meurt aprés le deſſein U De vous voir en chemiſe & lépée a là maiu.	THÉANDRE N généreux Guerrier meurt après le dessein V De vous voir en chemise et lépée a là maiu.
Cavalier, ie le ſers, ſans aucune repartie, Amenez un ſecond qui ſoit de la partie, Rec-vez ce cartel, n'en faites point de bruit, Et allons voir le lieu fans attendre la nuit.	Cavalier, Madame le sers, sans aucune répartie, Amenez un second qui soit de la partie, Rec-vez ce cartel, n'en faites point de bruit, Et allons voir le lieu sans attendre la nuit.
D.	D.
RODRIGVE O Cielt il faudra donc que ſuivaneſa eolere l'ôte la vie au Fils, comme j’ay fait au Pere!	RODRIGUE Ô Cielt il faudra donc que suivanesa éolère l'ôte la vie au Fils, comme j'ai fait au Père!
Et qu’une méme épee eteignant leur flambeau, Les enterrer tous deux dans un meme tombeau !	Et qu'une même épee éteignant leur flambeau, Les enterrer tous deux dans un même tombeau !
O foit!	Ô soit!
ô ſang!	ô sang!
ô Dieux!	ô Dieux!
ô ma chere Chimene?	ô ma chère Chimène?
Que nos maovais deſtins nous donnerons de peme, Les rerpects pour rhohneur nous ſont indifferens, Il faut perdre ma gloire, ou perdre tes parens, Ne erois pas.	Que nos maovais destins nous donnerons de peme, Les retrépects pour rhoheur nous sont indifférents, Il faut perdre ma gloire, ou perdre tes parents, Ne erais pas.
Cavalier qu’au regret qui me touche Le manquement de cœur faſſe parler ma bouche;	Cavalier qu'au regret qui me touche Le manquement de cœur fasse parler ma bouche;
Mais j’ay du déplaiſir de mettre au monument Vn corps que ma Chimeue aime ſi tendremens,	Mais j'ai du déplaisir de mettre au monument Un corps que ma Chimeue aime si tendrements,
Tragi Comedie.	Tragi Comédie.
Allous, c’eſt trop parler voyons ce jeune Comte, La paſſion m’emporte, il faut que ie Iaffronte, Et voir ſi mon acier aprés tant de deſits, Comme il a fait le Pere atrétera l e Fils :	Allous, c'est trop parler voyons ce jeune Comte, La passion m'emporte, il faut que ie Iaffronte, Et voir si mon acier après tant de désits, Comme il a fait le Père atrétera e Fils :
Dom Sanches iey preient aura part a la gloire.	Dom Sanches iey preient aura part à la gloire.
Il ſeta mon ſecoud, & en dira l’hiſtoire.	Il seta mon second, et en dira l'histoire.
D.	D.
SANCHE Le Cler pous partager avec vour cer nohdeur, Re double mon audace & m’enflame le cœur, DOREDRIGVE	SANCHE Le Cler pous partager avec vour cer nohdeur, Re double mon audace et m'enflamme le cœur, DOREDRIGUE
Allons donc, Cavalier, fais-moy voîr ce viſage Ie plains ſon infortune & pleute ſon dommage.	Allons donc, Cavalier, fais-moi voîr ce visage Je plains son infortune et plute son dommage.
TAEANDRE Aprehendez plutoſt un ſiniſtre malheur Et redoutez ſa force avecque ſa valeur.	TAEANDRE Appréhendez plutôt un sinistre malheur Et redoutez sa force avec sa valeur.
D.	D.
RODRIGVE Eſt-il plus que ſon Pere, & porte-il des charmes Qui rendent reuoutiuie & lon nom & ſes armes?	RODRIGUE Est-il plus que son Père, et porte-il des charmes Qui rendent revoutiie et lon nom et ses armes?
THEANDRE Son charme eſt ſon cournge, & mille Cavaliers de vu dans les combats ſe couvrir de ſauriers.	THÉANDRE Son charme est son cournge, et mille Cavaliers de vu dans les combats se couvrir de sauriers.
D.	D.
RODRIGVE.	RODRIGUE.
Ce ſont des coups d’aij courans méme fortune Dont la gloire & la perte eſt enſemble commune.	Ce sont des coups d'aij ourants même fortune Dont la gloire et la perte est ensemble commune.
TAIEANDRE	TAIEANDRE
Ce ſont des verités qui font craindre ſon nom Par tout où ſon courage a porté ſon renom.	Ce sont des vérités qui font craindre son nom Par tout où son courage a porté son renom.
D.	D.
RODRIGVE Il me tarde à le voir.	RODRIGUE Il me tarde à le voir.
THEANDRE Cette roche eſcarpée Nous le couvre tout ſeul avec ſon épée, le le voy, ſoyez preſt, il vient à ſein ouver, Vuidons le differend deſſus le gazon verd, Viſitez-le Dom Sanche, & s’il eſt en poſture, iſputons ce laurier en vengeant certe injure.	THÉANDRE Cette roche escarpée Nous le couvre tout seul avec son épée, le le vois, soyez prêt, il vient à sein ouver, Vidons le différend dessus le gazon verd, Visitez-le Dom Sanche, et s'il est en posture, isputons ce laurier en vengeant certe injure.
Ou tu perdras enſemble & la vie & l’honneur.	Ou tu perdras ensemble et la vie et l'honneur.
D.	D.
RCDRIGVE Tu las dit, c’eſt a toy que ie viens pour la tendre, ſeapelle t2 parole & pemie rte défendre.	RCDRIGUE Tu las dit, c'est a toi que je viens pour la tendre, seapelle t2 parole et pémie rète défendre.
LE COMTE	LE COMTE
Monttre, en ay plus fait en ce métier que toy.	Monttre, en ai plus fait en ce métier que toi.
D RODRIGVE	D RODRIGUE
Tu le dis.	Tu le dis.
LE COMTE	LE COMTE
onie IginD.	onie IginD.
RODRICVE Comte non fait pas moy, Ta valeur ne va pas au poiut de tacoicit.	RODRICUE Comte non fait pas moi, Ta valeur ne va pas au poiut de tacoicit.
LE COMTE Le Ciel me vengera du meurtre de mion Pere.	LE COMTE Le Ciel me vengera du meurtre de myon Père.
D.	D.
RODRIGVE D antont étoit trop e LE COMTE	RODRIGUE D antont était trop e LE COMTE
Ten voy deja tortir des goutes de ton Hanc.	Ten vois déjà tortir des goutes de ton Hanc.
D.	D.
RODRIGVE Ce n'eſt rien.	RODRIGUE Ce n'est rien.
Quireu faut avant que ie ut recre,	Quireu faut avant que ici ut recre,
LE COME Si faut-il que le Comte ou que Rodrigue meure.	LE COME Si faut-il que le Comte ou que Rodrigue meure.
D.	D.
RODRIGVE reu tiens, ce coup mortel me traverſe le ſein.	RODRIGUE re viens, ce coup mortel me traverse le sein.
LE COMTE	LE COMTE
Cet autre achevera ta vie & mon deſſein.	Cet autre achèvera ta vie et mon dessein.
Il tombe mort.	Il tombe mort.
Dieux!	Dieux!
ie ſuis ſatisfait en voyaut mon épée Du ſang de ce Meurtrier juiqu aux garueutrempé	Il suis satisfait en voyaut mon épée Du sang de ce Meurtrier juiqu aux garueutrempé
S0	S0
LE COMTE Prenons une autre route!	LE COMTE Prenons une autre route!
Adieu Sanche.	Adieu Sanche.
& t’apréte A diſcourir au vray des coups de ſa défaite, Tes veux ſont témoins.	et t'apprête A discourir au vrai des coups de sa défaite, Tes veux sont témoins.
Dis de ma part au Roy, Que ie mour tay pour lui ſi ſon zele eſt pour moy.	Dis de ma part au Roi, Que tu mour tai pour lui si son zèle est pour moi.
Le pardon de Rodrigue interine ma grace;	Le pardon de Rodrigue interine ma grâce;
Et un ſang pour un ſang les deux crimes efface:	Et un sang pour un sang les deux crimes efface:
Que ie le ſerviray contre ſes ennemis Si faccés de ſa Cour m’eſt librement permis.	Que était le servirai contre ses ennemis Si faccès de sa Cour m'est librement permis.
Dis-lui que hier au ſoir lui-méme étant en Ville, Le More avoit deſſein d aller prendre Seville, Qu il armoit puiſſamment, & que ie vis au Port L’appareil des guerriers qui doit faire leffort, Et que s’il veut donner des gens à ma conduite, Ie veux perdre I'honneur, s’ils ne prennent la fuite Et s il manque ce coup, qu il ſçaura cette nuit A quel point de malheur il ſe verra reduit.	Dis-lui que hier au soir lui-même étant en Ville, Le More avait dessein d ' prendre Ur, Qu il armait puissamment, et que personne vis au Port L'appareil des guerriers qui doit faire leffort, Et que s'il veut donner des gens à ma conduite, Je veux perdre J'honneur, s'ils ne prennent la fuite Et s' il manque ce coup, qu ' aura cette nuit A quel point de malheur il se verra réduit.
D.	D.
SANCHE (me, Grand Comte, arrétez donc ie remarque un GendarLe More eſt en campagne, & Seville en allarme, Voyez vous ce genet d’un be au gris-pommelé Prés d'un Barbe fougueux de poil alzan-brûlé, C’eſt le Comte de Gormas vorte Oncle & ſa ſuite, Vous avez des parens & des amis d’élite, Ioignez vous avec eux, rout vous ſera petmis, Vainquez & triomphez de tous nos ennemis:	SANCHE (me, Grand Comte, arrêtez donc été remarque un GendarLe More est en campagne, et Seville en alarme, Voyez vous ce genet d'un be au gris-pelé Près d'un Barbe fougueux de poil asan-brûlé, C'est le Comte de Gormas vorte Oncle et sa suite, Vous avez des parents et des amis d'élite, Ioignez vous avec eux, rout vous sera petis, Vainquez et triomphez de tous nos ennemis:
C’eſt un beau champ d'honneur ouvert pour la victoire Et pour y ſignaler Iéclat de votre gloite, Vous aurez un rentort & d’armer & de fyue La fottune aide aux ſoins des hommes diligens;	C'est un beau champ d'honneur ouvert pour la victoire Et pour y signaler Iéclat de votre gloite, Vous aurez un rentort et d'armer et de sive La fottune aide aux soins des hommes diligents;
Empoignez ſes cheveux, puiſqu elle ſe preſente, Et que votre bonheur réponde à mon attente:	Empoignez ses cheveux, puisqu elle se présente, Et que votre bonheur réponde à mon attente:
Que le Merre vous prenne ayant changé d habit, Pour le Mars de Caſtille, & non pas pour le Cid, Et quayant leui painu ce & leur force étouffée Leurs Roys & leurs captifs honorent vos trophées;	Que le Merre vous prenne ayant changé d' habit, Pour le Mars de Castille, et non pas pour le Cid, Et quayant levi ainu ce et leur force étouffée Leurs Rois et leurs captifs honorent vos trophées;
SCENE VIII.	SCÈNE VIII.
D SANCHE Ve l'homme eſt bien ſujet au caprice du ſort, En léelat de la vie il rencontre la mort, Tout ce bas Vnivers d’une regle commune, Dépend abſolument des loix de la Fortune;	 SANCHE Ve l'homme est bien sujet au caprice du sort, En léelat de la vie il rencontre la mort, Tout ce bas Venivers d'une Dépends de, La absolument des lois de la Fortune;
Ce qu'on apelle ſort, elle Ia decreté, Nos biens & nos malheurs ſont en ſa volonté;	Ce qu'on apelle sort, elle Ia décreté, Nos biens et nos malheurs sont en sa volonté;
Rendant l'être inégal nos penſées les plus meures Trouvent de bons momens & de mauvaiſes heures, Les mortels ont leurs jours & leur tems limité, Tout le monde eſt ſojet à la fatalité, Quand un corps ſe releve, on voit qu’un autre tombe?	Rendant l'être inégal nos pensées les plus meures Trouvent de bons moments et de mauvaises heures, Les mortels ont leurs jours et leur temps limité, Tout le monde est soujet à la fatalité, Quand un corps se relève, on voit qu'un autre tombe?
L’un entre au jour & j'autre ſous la tombe:	L'un entre au jour et j'autre sous la tombe:
Le ſort eſt doux à Iun à fautre rigoureux, Les uns ſont foriuné, les autres malheureux.	Le sort est doux à Jun à fautre rigoureux, Les uns sont foriuné, les autres malheureux.
Rodrigue ſe défiſt du Pere de ce Comte, Et il vange ſon ſang & repare ſa honte:	Rodrigue se défît du Père de ce Comte, Et il venge son sang et répare sa honte:
Tout ce qu’ou voit au monde hors le cours du Soleil, Peut avoir ſon ſemblable & trouver ſon pareil, Deplorable Guerrier au coup de ce naufrage, Que n'eus-tu de fortune autant que de courage!	Tout ce qu'ou voit au monde hors le cours du Soleil, Peut avoir son semblable et trouver son pareil, Déplorable Guerrier au coup de ce naufrage, Que n'eus-tu de fortune autant que de courage!
Ie ne répandrois pas ſolitaire en ces lieux, Des ſoûpirs de mon cœur, ni des pleurs de mes yeux:	Je ne répandrais pas solitaire en ces lieux, Des soupirs de mon cœur, ni des pleurs de mes yeux:
Mais à quoy ces regrets?	Mais à quoi ces regrets?
ſi les cendres éreintes Font auſſi peu de cas des ſoûpirs que des plaintes.	si les cendres éreintes Font aussi peu de cas des soupirs que des plaintes.
Vn mort paſſant loubli rejette tout ennui, Il perd le ſouvenir, & ie fais comme lui, La forttune eſt plus grande à celui qui demeure, De pleurer un ami, que ſi l'ami le pleure.	Un mort passant loubli rejette tout ennui, Il perd le souvenir, et personne fais comme lui, La fortune est plus grande à celui qui demeure, De pleurer un ami, que si l'ami le pleure.
SCENE IX.	SCÈNE IX.
D.	D.
FERNAND LE PRINCE, D.	FERNAND LE PRINCE, D.
FERNAND,	FERNAND,
Ve leSceprte dun Prince eſt un fardeau peſant!	Ve leSceprte dun Prince est un fardeau pesant!
Qu il lob'ige à de peines & de ſoins en naiſſant!	Qu il lob'ige à de peines et de soins en naissant!
Sou regue eſt une Mr, dont le calme & l'orage Changent à ſa fortune à tous coups de viſage:	Sou rège est une Mr, dont le calme et l'orage Changent à sa fortune à tous coups de visage:
Maintenant un triomhe en ſes exploits guerriers Le fait voir couronné de palmes & de lauriers:	Maintenant un triomhe en ses exploits guerriers Le fait voir couronné de palmes et de lauriers:
Et tantoſt un malheur perdant une vctoire, Lui ravit cet éclat, & ternit cette gloire;	Et tantôt un malheur perdant une vctoire, Lui ravit cet éclat, et ternit cette gloire;
Reſſemblaut au Soleit dont un nuage.	Ressemblaut au Soleit dont un nuage.
put Nous couvre la lumiere avec uuc vapeur, Ha!	put Nous couvre la lumière avec uc vapeur, Ha!
qu il n’eſt pas à faux ce vieil mot qu’on nont donne Qu il n’eſt point de fardeau tel que d’une Couronne :	qu il n'est pas à faux ce vieil mot qu'on nont donne Qu il 'est point de fardeau tel que d'une Couronne :
Et qui la trouveroit à terre lur ſes pas, Pour en orner ſon front ne la leveroit pas.	Et qui la trouverait à terre lur ses pas, Pour en orner son front ne la lèverait pas.
Combien de Roys fameux en pompe & en puiſſance Ont trouvé leur ruine avec leur ec d nce?	Combien de Rois fameux en pompe et en puissance Ont trouvé leur ruine avec leur ec d née?
Et brûlans à tous vens comme le pannonceau, rait de leur Sceptre d’or un sceptre de roſeau, Vû détruire leur peuple avecque leur fortune, Et n’avoir avec eux qu’une tombe commune :	Et brûlants à tous vents comme le pannonceau, rait de leur Sceptre d'or un sceptre de roseau, Vu détruire leur peuple avec leur fortune, Et n'avoir avec eux qu'une tombe commune :
Et porter leur Couronne, ayant été ſeumts, Au plus barbare cœur de tous leurs ennemis.	Et porter leur Couronne, ayant été seumts, Au plus barbare cœur de tous leurs ennemis.
LE PRINCE Grand Roy, quelle pensée & qu’avez-vous à craindr Verroit-on des ma heurs qui nous puiſſent atteiudre Le Ciel qui vous a mis au monde ſans pareil, A mis votre fortune à Iégal du Soleil.	LE PRINCE Grand Roi, quelle pensée et qu'avez-vous à craindr Ait-on des ma heurs qui nous puissent attejudre Le Ciel qui vous a mis au monde sans pareil, A mis votre fortune à Iégal du Soleil.
Vous é es au deſſus des foudres & des tempétes, Où lon voir ſes rayons, on y voit vos conquéres.	Vous éq es au des des foudres et des tempête, Où lon voir ses rayons, on y voit vos conquères.
Il vous a fait égaux en des titres divers Lui Roy des feux du Ciel, & vous de IVuivers;	Il vous a fait égaux en des titres divers Lui Roi des feux du Ciel, et vous de IVuivers;
D 2 Et parmi les faveurs & léclar qu’il vous donne, Que craignez-vous au monde en portant la Couronne?	 2 Et parmi les faveurs et léclar qu'il vous donne, Que craignez-vous au monde en portant la Couronne?
Vainquez en conquerani & la terre & les eaux.	Vainquez en conquérani et la terre et les eaux.
I’ay de nouveaux deſſeins pour des mondes nouveaux.	J'ai de nouveaux desseins pour des mondes nouveaux.
Mon cœur comme un Aiglon commence de s étendre, Et meſurer ſon vol à celui d’Alexandre.	Mon cœur comme un Aiglon commence de s étendre, Et mesurer son vol à celui d'Alexandre.
Let crromples d nonneur lont teſſement émeu.	Let cromples d nonneur lont tessement ému.
Qu’il touche avec le Sceptre à la Sphere du feu.	Qu'il touche avec le Sceptre à la Sphère du feu.
D FERNAND Le mien juſques icy dans ſon independance, A fait voir ſa grandeur avec ſa puiſſance:	 FERNAND Le mien jusques ici dans son indépendance, A fait voir sa grandeur avec sa puissance:
Et l’honneur n’eſt pas moindre apres avoir conquis, rder un païs que de Iavoir acquis;	Et l'honneur n'est pas moindre après avoir conquis, rder un pays que de Javoir acquis;
Des chandes ennemis j’augmentois mon Empire Et leur donnois e loix qu'ils me vouloient preſcrite, Quand ie voyois mon tems, ie trouvois des ébats A leur donner la chaſſe au milieu des combats;	Des chandes ennemis j'augmentais mon Empire Et leur donnais e loix qu'ils me voulaient prescrite, Quand Je voyais mon temps, je trouvais des ébats À leur donner la chasse au milieu des combats;
Aais les Mores ayant vû nos armes inégales epuis que j’ay vaincu les peuples de Vendalles, ſouſcrit une ligue.	Aais les Mores ayant vu nos armes inégales eût que j'ai vaincu les peuples de Vendalles, souscrit une ligue.
& paroit dans mes Ports ur de nouveaux deſſeins & de nouveaux renforts.	et parait dans mes Ports ur de nouveaux desseins et de nouveaux renforts.
n craignant une chute en voulant entreprendre, met tout ſon eſprit à me pouvoir ſurptendre.	n craignant une chute en voulant entreprendre, met tout son esprit à me pouvoir surptendre.
s’eſt rendu puiſſant ayant pour ſon apuy Perſe & l’Aragon armés avecque luy;	s'est rendu puissant ayant pour son appui Perse et l'Aragon armés avec notre;
bien que s’il m'attaque ou vient dans mes Provinees dois combattre ſeul les forces de rrois Princes, voir devant mes yeux partager mes Etats * triomphans exploirs de ces trois Potentats, nce, que de malheurs, lorſque notre Couronne pour ſoûtien la main de celui qui la donne!	bien que s'il m'attaque ou vient dans mes Provinées dois combattre seul les forces de rois Princes, voir devant mes yeux partager mes États * triomphants exploirs de ces trois Potentats, non, que de malheurs, lorsque notre Couronne pour soutien la main de celui qui la donne!
ux, ie la tiens de vous, foyes en le luport!	ux, Seigneur la tiens de vous, foies en le luport!
vous a pour garant eſt ioûjours aſſez fort;	vous a pour garant est toujours assez fort;
vous tout ſe détruit, les armes s’affoibliſſent, t tombe en deadence, & les Etats periſſent, me ayans daus vos mains nos étres & nos fins, vernez ma fortune, & guidez mes deſtins.	vous tout se détruit, les armes s'affoiblissent, t tombe en désadence, et les Etats périssent, me ayant daus vos mains nos êtes et nos fins, vernez ma fortune, et guidés mes destins.
Les grands Dieux daignent donc nous couvrir de leur Et nous faire un preſent d'une bonne nouvelle;	Les grands Dieux daignent donc nous couvrir de leur Et nous faire un présent d'une bonne nouvelle;
Et que divertiſſant nos eſprits & nos cœurs, Les Moies ſoient vaincus, & nos gens les vainqueurss	Et que divertissant nos esprits et nos cœurs, Les Moies soient vaincus, et nos gens les vainqueurss
LE PRINCE Agréez que mes vœux ſecondent vos prieres, Et atendons d’enhaut des eictoires entieres.	LE PRINCE Agréez que mes vœux secondent vos prières, Et atendons d'enhaut des eictoires entières.
mue puamue jies laulllel ler caplols gincor, Sont des faveurs du Ciel & des preſens des Dieux D.	mue puamue jies laulllel ler capplols gincor, Sont des faveurs du Ciel et des présents des Dieux D.
FERNAND (aile,	FERNAND (aile,
ACTL III.	ACTL III.
SCENE PREMIERE CHIMENE, ELVIRE, CHIMENE.	SCÈNE PREMIÈRE CHIMENE, ELVIRE, CHIMENE.
Ve mon cœur a de trouble, & que j’ay lame ateinte De doutes, de ſoupçons, de triſteſſe & de crainte:	Ve mon cœur a de trouble, et que j'ai lame ateinte De doutes, de soupçons, de tristesse et de crainte:
Eluire, ouvre ton cœur, n’aurois-tu rien apris, Pour môier ces penſées qui troublent mes eſprits?	Elvire, ouvre ton cœur, n'aurais-tu rien appris, Pour môier ces pensées qui troublent mes esprits?
A te voir ſoûpiter dedans la ſolitude le n’ay de mouvement que pour l’inquietude;	À te voir soupiter dedans la solitude le n'ai de mouvement que pour l'inquiétude;
Ton viſage en changeant à tous coups de couleur, Par de muets regards fan parler mon malheur, Ma triſteſſe conçon une vapeur ſi noire.	Ton visage en changeant à tous coups de couleur, Par de muets regards fan parler mon malheur, Ma tristesse conçon une vapeur si noire.
Qu'elle en trouble mes ſens avec ma memoire.	Qu'elle en trouble mes sens avec ma mémoire.
Le Comte eſt dans Seville, & tu me veux cacher Le bruit de ſon retour de peur de me fachet, Et couvrant la nouvelle à l'ombre du ſilence, Tu lui donne le tems de venger ſon offence, De voir ſon ennemi, d'achever ſon de ſſein A vecque la vengeance & l'épée a la main:	Le Comte est dans Seville, et tu me veux cacher Le bruit de son retour de peur de me sachet, Et couvrant la nouvelle à l'ombre du silence, Tu lui donne le temps de venger son offense, De voir son ennemi, d'achever son de sinsein A vecque la vengeance et l'épée à la main:
Au contraire ayant ſçû qu’il eſt dans la Province, En le faiſant ſçavoir aux oreilles du Prince ion abſolu pouvoir leur preſcrivant ſa loy, es auroit retenus dans les ordres du Roy, uiſquà ce qu'etot ffaticette haine mortelle;	Au contraire ayant su qu'il est dans la Province, En le faisant avoir aux oreilles du Prince ion absolu pouvoir leur prescrivant sa loi, es aurait retenus dans les ordres du Roi, uisquà ce qu'étot faticette haine mortelle;
Il les eût fait amis, & éteint leur querelle.	Il les eût fait amis, et éteint leur querelle.
EL!	ÉL!
IRE Mhadame, ce bonheur étoit à de ſirer.	IRE Mhadame, ce bonheur était à de sirer.
Pour prévenir le mal qui me fait ſoûpirer.	Pour prévenir le mal qui me fait soupirer.
OHIRARE Et quel éclarcicement, mon ame eſt alarmée!	OHIRARE Et quel éclarcicement, mon âme est alarmée!
ELVIRE Le Comte eſt General & commande l’Armée, La nouvelle eſt certaine on le croit en la Coir, Ie m’étonne comment Rodrigue y fait ſejour:	ÉLVIRE Le Comte est Général et commande l'Armée, La nouvelle est certaine on le croit en la Coir, Je m'étonne comment Rodrigue y fait séjour:
Ils joindront la querelle avec la jalouſie, Et c’eſt la ſeule peur dont mon ame eſt ſaiſie, Et s’il eſt dans Seville ou s’aproche de nous, Ie jure ſur l'Autel que j’en ſçais moins que vous.	Ils joindront la querelle avec la jalousie, Et c'est la seule peur dont mon âme est saisie, Et s'il est dans Seville ou s'approche de nous, Je jure sur l'Autel que j'en sais moins que vous.
Plut au Ciel!	Plut au Ciel!
Cet avis étoit ſi neceſſaire, Que ſans commettre un crime on ne le pouvoit taire, Au ſortir du logis on lauroir retenu, Et tout mauvais denemduntté pré venu.	Cet avis était si nécessaire, Que sans commettre un crime on ne le pouvait taire, Au sortir du logis on lauroir retenu, Et tout mauvais denemduntté pré venu.
SCENE II.	SCÈNE II.
D.	D.
ARIAS ſeul Ve la force du ſang a de puiſſantes armes!	ARIAS seul Ve la force du sang a de puissantes armes!
Que narure a de feux, & d’amour & de charmes:	Que narre a de feux, et d'amour et de charmes:
Que le meurtre du Pere eſt ſenſible à Ienfant?	Que le meurtre du Père est sensible à Jenfant?
Que la vengeance eſt douce à ſon cœur triomphant!	Que la vengeance est douce à son cœur triomphant!
Que l’injure eſt peſante aux perſonnes bien nées!	Que l'injure est pesante aux personnes bien nées!
Et que les loix d’houneur ſont juſtemeut données!	Et que les lois d'houneur sont justemeut données!
La gloire d’un Guerrier & d’un homme de cœur, Eſt ſemblable à la Mer qui ne tient rien d’impur, Elle jette à ſes bords tout ce qu'elle a de ſale.	La gloire d'un Guerrier et d'un homme de cœur, Est semblable à la Mer qui ne tient rien d'impur, Elle jette à ses bords tout ce qu'elle a de sale.
La playe d'honneur eſt mortelle & fatale, Quiconque voit ſon Pere au creux d’un monument, Et ſouffre laſſaſſia, il vit honteuſement:	La plaie d'honneur est mortelle et fatale, Quiconque voit son Père au creux d'un monument, Et souffre lassassia, il vit honteusement:
Il faut á deux partis ſe vanger de l’injure Pour conſerver ſa gloire & Ialoy de nature.	Il faut § deux partis se venger de l'injure Pour conserver sa gloire et Jaloi de nature.
Tant I'Amour & le Sang ont le devoit prefix.	Tant J'Amour et le Sang ont le devait préfix.
pour le ſoutient du Pere au courage du Fils, Rodrigue intereſſé dans une moindre offence, N’eut point de ſentimeus que pour cette vengeance, Et le Comte aujourd’huy d'un plus juſte tranſport Vange cet homicrde & lui donne la mort.	pour le soutient du Père au courage du Fils, Rodrigue intéressé dans une moindre offense, N'eut point de sentimeus que pour cette vengeance, Et le Comte aujourd'hui d'un plus juste transport Venge cet homicrède et lui donne la mort.
DCENE III.	DCENE III.
D.	D.
FERNAND, LE PRINCE, D.	FERNAND, LE PRINCE, D.
DIEGVE,	DIÉGUE,
D ARIAS, D ALONSE, D ARIAS.	 ARIAS, D ALONSE, D RIAS.
* Omme au milieu du calme ou a vû des naufrages.	* Omme au milieu du calme ou a vu des naufrages.
Qu'un heur ſui un malheur, un beau tems les oraSire je vous sporte en cet evenement Avec un déplaiſir un grand contentement.	Qu'un heur su un malheur, un beau temps les oraSire je vous sporte en cet événement Avec un déplaisir un grand contentement.
Les Mores s’écartant par une canonnade, Ont perdu deux vaiſſeaux du côté de la rade;	Les Mores s'écartant par une canonnade, Ont perdu deux vaisseaux du côté de la rade;
Leurs maſts ſont abatus, & lennemi ſur Ie a Ne leur peut envoyer ni voile ni bateau, Le Comte eſt au devant & gaignant le paſſege, (ges:	Leurs mâts sont abattus, et lennemi sur Je a Ne leur peut envoyer ni voile ni bateau, Le Comte est au devant et gagnant le passe, (ges:
Leur marque un choix de mort de foudre ou de naufragi Les aſſauts, les provoque, & attendant ſon tems, Reconnoit leurs deſſeins à voir leurs mouvemens, Leurs Chefs ſont ébranlez, & leur flote eſt reduite Au point de ſe défendre ou de prendre la foire:	Leur marque un choix de mort de foudre ou de naufragi Les assauts, les provoque, et attendant son temps, Reconnait leurs desseins à voir leurs mouvements, Leurs Chefs sont ébranlez, et leur flotte est réduite Au point de se défendre ou de prendre la foire:
Bien que plus grands en nombre, ayans vu de quel cœui Aeetre enTa domne des marques de valeur, Ses exploits genereux font que chacun ladmire, Il pointe les canons, & lui-méme les tire, Il ſemble que ce Comie, & ſur terre & ſur mer Ne trouve des appas que parmy le danger.	Bien que plus grands en nombre, ayant vu de quel cœui Atevre enTa domne des marques de valeur, Ses exploits généreux font que chacun ladmire, Il pointe les canons, et lui-même les tire, Il semble que ce Comie, et sur terre et sur mer Ne trouve des appas que parmi le danger.
D.	D.
PERNAND Parle moins & parlant que tour ſoit veritable, Ne me dis pas un mot qui reſſente la fable, Ie hais les diſcoureurs, les oreilles d’un Roy Abhorrent le menſonge & les diſcours ſans foy	PERNAND Parle moins et parlant que tour soit véritable, Ne me dis pas un mot qui ressente la fable, Je hais les discoureurs, les oreilles d'un Roi Abhorrent le mensonge et les discours sans foi
D, ARIAS Sire, ce que lon voit on a droit de le dire.	D, ARIAS Sire, ce que lon voit on a droit de le dire.
Plus ie penſe à ſes faits & plus ie les admire;	Plus ie pense à ses faits et plus grands les admire;
Mes diſcours ſont ſans fard comme ſans vanité, Tous nos gens ſont témoins de cétte verité.	Mes discours sont sans fard comme sans vanité, Tous nos gens sont témoins de cet vérité.
D.	D.
FERNAND Quel eſt ce grand Guerrier?	FERNAND Quel est ce grand Guerrier?
ARIAS Sire, voicy l'intrigue, Vn qui vient de ſe batre & de tuer Rodrigue, Le Comte de Gormas qui tout chaud de fureur Pour la mort de ſon Pere auroir mange ſon cœur;	ARIAS Sire, voici l'intrigue, Un qui vient de se battre et de tuer Rodrigue, Le Comte de Gormas qui tout chaud de fureur Pour la mort de son Père auroir mange son cœur;
Er quoyque General d’une puiſſante Armée, Dunc ame de vengcance de de prons anumce :	Er quoique Général d'une puissante Armée, Dunc âme de vengance de de prons anumce :
Prit congé de ſon Paince, & ſans faire de bruit, Hier entra dans Seville à lombre de la nuit,	Prit congé de son Paince, et sans faire de bruit, Hier entra dans Seville à lombre de la nuit,
Dom Diegue entre au Theatre & écoute.	Dom Diègue entre au Théâtre et écoute.
Et avec un cartel ſe portant ſur la place, Comme deux fiers Lvons pleins de rage & daudace, Tous deex de méme force & de meme chaleur Témoigne leur adreſſe avec leur valeur, L’honneur de ce combat dans le ſort ſe balance, L’un s’attend à la gloire, & lautte à la vengeance, L’un combat pour le ſang, & l'autre pour l’honneur, Et Rodrigue en paſſant eſt bleſſé ſous le cœur, Et quoyque la bleſſure en fût aſſez legere Sa playe & la douleur échauffa ſa colere;	Et avec un cartel se portant sur la place, Comme deux fiers Luons pleins de rage et daudace, Tous deex de même force et de même chaleur Témoigne leur adresse avec leur valeur, L'honneur de ce combat dans le sort se balance, L'un s'attend à la gloire, et lautte à la vengeance, L'un combat pour le sang, et l'autre pour l'honneur, Et Rodrigue en passant est blessé sous le cœur, Et quoique la blessure en fit assez légère Sa plaie et la douleur échauffa sa colère;
Pat ai huuvead tramport qui le rend plus émeu, Suivant les mouvemens d’on courage de feu, Croyant tuer le Comte & finir leur querelle, Il reçoit dans le ſein deux bleſſures mortelles, Tombe mort ſur la place.	Pat ai huvead tramport qui le rend plus ému, Suivant les mouvements d'on courage de feu, Croyant tuer le Comte et finir leur querelle, Il reçoit dans le sein deux blessures mortelles, Tombe mort sur la place.
4 Le mal n’eſt que trop prompt & le remede tard, Il meurt d'un coup de foudre oyant certe nouvelle, Il a reçû dans Iame une playe mortelle, Certe perte eſt ſi grande & de ſi grand malheur Que ie croy qu’il eſt mort d'un excés de douleur.	4 Le mal n'est que trop prompt et le remède tard, Il meurt d'un coup de foudre oyant certe nouvelle, Il a reçu dans Iame une plaie mortelle, Certe perte est si grande et de si grand malheur Que ie croy il est mort d'un excés de douleur.
LE PRINCE vn rel corps decrepit & caſe de vieinene Meurt auſſi-toſt d'effroy que d’un coup de triſtrſſes	LE PRINCE un rel corps décrépit et case de vieinène Meurt aussitôt d'effroi que d'un coup de tristrsses
D.	D.
FERNAND Vn homme de cet âge expire en un moment, Et vit en ſommeillant au oord du monument.	FERNAND Un homme de cet âge expire en un moment, Et vit en sommeillant au oord du monument.
SCENE IV.	SCÈNE IV.
D.	D.
ALONE Vel funeſte accident que la Parque ſevere, Ait pris en méme jour & le Fils & le Pere!	ÀLONE Vel funeste accident que la Parque sévère, Ait pris en même jour et le Fils et le Père!
Et que le ſang produiſe un rel reſſentiment, Que du coup de ſon Fils il meure en un moment?	Et que le sang produise un rel ressentiment, Que du coup de son Fils il meure en un moment?
le croy qu’entre parens & les cœurs & les ames Par un excés d’amour vivent de mémes flames;	le crois qu'entre parents et les cœurs et les âmes Par un excès d'amour vivent de mêmes flammes;
Que le Pere & le Fils ont de ſecrets raports, Et que le feu d’une ame anime les deux corps, Quand lez deſtins en ont une moitié ravie, L’autre tient à dédain les reſtes de la vie.	Que le Père et le Fils ont de secrets rapports, Et que le feu d'une âme anime les deux corps, Quand lez destins en ont une moitié ravie, L'autre tient à dédain les restes de la vie.
Nous tommes oongex a feurievere loy;	Nous tommes oongex a feurievère loi;
Mais puiſque j’en ay Iordre, allons le dire au Roy.	Mais puisque j'en ai Jordre, allons le dire au Roi.
SCENE V.	SCÈNE V.
ELVIRE Ffet prodigieux de l’inſtinct de nature, LQu'elle ue peut ſouffrir ſans vengeance une injure, L’outr age qu’on nous fait eſt un feu couſemant, Qui ſe prend dans le cœur comme à ſon element .	ÉLVIRE Ffet prodigieux de l'instinct de nature, LQu'elle ue peut souffrir sans vengeance une injure, L'outr age qu'on nous fait est un feu cousemant, Qui se prend dans le cœur comme à son élément .
La colere lallume & redoublant ſa flame L’eleve dans llempire & des ſens & de Iame:	La colère lallume et redoublant sa flamme L'élève dans llempire et des sens et de Jame:
Nous trouble les eſprits & nous piquant le flanc Fait nos plus doux objers de meurtre & de ſang Ces Cavaliers touchez de l’honneur de leurs Peres, Tirent de mes deux yeux mille larmes ameres.	Nous trouble les esprits et nous piquant le flanc Ait nos plus doux objers de meurtre et de sang Ces Cavaliers touchés de l'honneur de leurs Pères, Tirent de mes deux yeux mille larmes amères.
Malheur inopiné, en deux funeſtes coups, Ma Maitreſſe a perdu ſon Pere & ſon Epoux!	Malheur inopiné, en deux funestes coups, Ma Maitresse a perdu son Père et son Époux!
Ce ſeroit lachete que leur vouloir ſurvivre, La gloire & le devoir moblige a les ſuivre, Le trépas eſt heureux qui dans un grand malheur, Finit en méme tems la vie & la douleur.	Ce serait lâcheté que leur vouloir survivre, La gloire et le devoir moblige a les suivre, Le trépas est heureux qui dans un grand malheur, Finit en même temps la vie et la douleur.
SCENE IV.	SCÈNE IV.
D FERNAND, LE PRINCE, D.	 FERNAND, LE PRINCE, D.
ALONSE.	ÀLONSE.
D ARIAS, SANCHE, D, FERNAND.	 ARIAS, SANCHÉ, D, FERNAND.
E eroy ce que tu dis l'apparence en eſt claire, La perte de l'Enfant a fait mourir le Pere.	 eroy ce que tu dis l'apparence en est claire, La perte de l'Enfant a fait mourir le Père.
Les Symptomes, la Mort, le ſilence & les pleurs, Sont les tableaux parlans des mortelles douleurs, I’ay ſouffert ce malheur avec beaucoup de peine, Ie perds un bon conſeil & un grand Capitaine, La donleur eſt ſenſible alors qu’un Porentat Perd un Maitre de Camp & un homme d'Etat, Ce funeſte accident & ce coup de vengeance Affoibliſſent mon Sceptre avec ma puiſſance, En lalarme, au combat, aux dangers.	Les Symptomes, la Mort, le silence et les pleurs, Sont les tableaux parlants des mortelles douleurs, J'ai souffert ce malheur avec beaucoup de peine, Je perds un bon conseil et un grand Capitaine, La donleur est sensible alors qu'un Porent Perd un Majaitre de Camp et un homme d'État, Ce funeste accident et ce coup de vengeance Affaiblissent mon Sceptre avec ma puissance, En laarme, au combat, aux dangers.
aux malheurs, Ie laiſſois la conduite a ſa ſeule valeur.	aux malheurs, Je laissais la conduite a sa seule valeur.
Le More s’étonnoit du bruit de mon Armée, Leur triomphe étendoit par tout leur renommée, Et finne exploits d’honneur à mes Ports achevez, Avoient juſqu au Ciel leurs lauriers élevez.	Le More s'étonnait du bruit de mon Armée, Leur triomphe étendait par tout leur renommée, Et finne exploits d'honneur à mes Ports achevez, Avaient jusqu' au Ciel leurs lauriers élevés.
LE PRINCE tire, tout eſt mortel, les Deſtins & les Parques, e joüent des grandeurs & des ans des Monarquet, Et la loy du trepas doit mettre aux monumens, Tour ee que la nature a fait des Elemens.	LE PRINCE tire, tout est mortel, les Destins et les Parques, e joüent des grandeurs et des ans des Monarquet, Et la loi du trépas doit mettre aux monuments, Tour ce que la nature a fait des Éléments.
Nous naiſſons pour mourir, & toute choſe née Eſt du jour de ſon étte à la mort deſtinée.	Nous naissons pour mourir, et toute chose née Est du jour de son étte à la mort destinée.
Ce malheur eſt facheux;	Ce malheur est fâcheux;
mais ou doit ſupotter Ce que les ſens humains ne peuvent éviter.	mais ou doit supotter Ce que les sens humains ne peuvent éviter.
Balancez dans Ieſprit cette juſte querelle, L’injure de ce Comte, & où l’honneur l'apelle;	Balancez dans Jésprit cette juste querelle, L'injure de ce Comte, et où l'honneur l'appelle;
Le meurtre de ſon Pere & ſon funeſte ſort;	Le meurtre de son Père et son funeste sort;
Vous ne trouverez rien d’étrange encette mort.	Vous ne trouverez rien d'étrange encette mort.
Pour un ſoufflet, Rodrigue eur à cœur cetre offence, Et mépriſa lamour pour ſuivre la vengeance;	Pour un soufflet, Rodrigue eur à cœur cet offense, Et méprisa lamour pour suivre la vengeance;
Que peut-on eſperer de ce cœur outragé, Qu un deſſein de mourir, ou d'en étre vengé?	Que peut-on espérer de ce cœur outragé, Qu un dessein de mourir, ou d'en être vengé?
L’offenſe de Rodrigue étoit bien plus legere, Vn ſoufflet touche moins que le meurtre d’un Pere.	L'offense de Rodrigue était bien plus légère, Un soufflet touche moins que le meurtre d'un Père.
Et la force du ſang a de tels mouvemens Qu'elle remplit de feux tous nos reſſentimens.	Et la force du sang a de tels mouvements Qu'elle remplit de feux tous nos ressentiments.
o nlutun veuaraox mams, le Momte enidi la place Plus digne de pardon que Rodrigue de grace.	ô nlutun vuéraox mams, le Momte enidi la place Plus digne de pardon que Rodrigue de grâce.
Mais écoutons Dom Sanche;	Mais écoutons Dom Sanche;
il vient tout glorieux, La joye de ſon cœur s’exprime pat ſes yeuz.	il vient tout glorieux, La joie de son cœur s'exprime pat ses yeus.
D FERNAND A voir ſes pas comtez dans laudace & la gloire, Il m’annonce un triomphe avec une victoire.	 FERNAND A voir ses pas comptez dans laudace et la gloire, Il m'annonce un triomphe avec une victoire.
Sanche, quand verrons-nous revenir nos Guerriers Portant dedus le frour la paine a les lauilera:	Sanche, quand verrons-nous revenir nos Guerriers Portant dedus le frour la paine a les lavilera:
Ie veux aprendre au More aprés cette défaite, Que tout ce qu’il poſſede, eſt un pays de conquére.	Je veux apprendre au More après cette défaite, Que tout ce qu'il possède, est un pays de conquère.
D.	D.
SANCHE Site, aprés que Rodrigue.	SANCHE Site, après que Rodrigue.
,.	Ç,
D.	D.
FERRAIDIHCIIadplus parler, Diſcourir d’un malheur c’eſt le renouveller, l’ay ſçû lapel, le lieu le combat, l’infortune, Le bruit en eſt certain, la nouvelle commune, C’en eſt fait, il eſt mort, qu’on ne m’en parle plus, La vie & le trépas ſont un flus & reflus;	FERRAIDIHCIadplus parler, Discourir d'un malheur c'est le renouveler, l'ai su lapel, le lieu le combat, l'infortune, Le bruit en est certain, la nouvelle commune, C'en est fait, il est mort, qu'on ne m'en parle plus, La vie et le trépas sont un flus et reflus;
E 2	 2
Le iour pouſſe la nuit comme londe fait londe, La Parque a lieu de prendre en tous les lieux du monde Et le Pere & le Fils out reſſenti ſa loy.	Le jour pousse la nuit comme londe fait londe, La Parque a lieu de prendre en tous les lieux du monde Et le Père et le Fils out ressenti sa loi.
Et leur perte a tiré des ſoûpirs de leur Roy, Mais aprés ces regrets, il faut qu’une ame cede A I-ffort des malheurs qui n'ont point de remęde, Mon cœur en ſouffre encor de ſi fortes douleurs, Qu'à peine en retient.	Et leur perte a tiré des soupirs de leur Roi, Mais après ces regrets, il faut qu'une âme cède A I-sort des malheurs qui n'ont point de remède, Mon cœur en souffre encor de si fortes douleurs, Qu'à peine en retient.
t’il les ſoûpirs & les pleurs.	t'il les soupirs et les pleurs.
Le mot eſt general, la maxime vulguaire, Qu’un Fils vit ſans honneur s’il ne venge ſon Pere.	Le mot est général, la maxime vulguaire, Qu'un Fils vit sans honneur s'il ne venge son Père.
Rodrigue fit un coup d’un homme de valeur, Le Comte en fit un autre, & venge ſon malheur.	Rodrigue fit un coup d'un homme de valeur, Le Comte en fit un autre, et venge son malheur.
I ay donné le paudon à la premiere offence, I’ay la méme joſtice & la méme clemence:	I ai donné le paudon à la première offense, J'ai la même jostice et la même clémence:
Vſer tantoſt de grace, & rautoſt de rigueur, Ie ſerois inégal avce un double cœur, Ce crime a ſon excuſe, il eſt ſi pardonnable, Qu’on ſeron eriminel de le croire coupable.	Vser tantôt de grâce, et rautôt de rigueur, Je serais inégal avance un double cœur, Ce crime à son excuse, il est si pardonnable, Qu'on seron eriminel de le croire coupable.
Enfin aprés avoir ces malheurs balancez, Le Roy les abolit.	Enfin après avoir ces malheurs balancés, Le Roi les abolit.
ils leurs ſont effacez Dom Sanche, parle donc, & conte-nous l'hiſtoire, De Iordre des combats & de notre victoire, Les lauriers de ce Comte & comme il fut reçũ.	ils leurs sont effacés Dom Sanche, parle donc, et conte-nous l'histoire, De Jordre des combats et de notre victoire, Les lauriers de ce Comte et comme il fut reçũ.
Pour commander l'Armée & éteindre ce feu, Aprés avoir vengé par la forme ordinaire Dans le champ d'honneur le meurtre de ſon Pere;	Pour commander l'Armée et éteindre ce feu, Après avoir vengé par la forme ordinaire Dans le champ d'honneur le meurtre de son Père;
Comme il fut reconnu de tous nos Caſtillans, Et reçue tant d'honneur de tant de braves gens.	Comme il fut reconnu de tous nos Castillans, Et reçue tant d'honneur de tant de braves gens.
Ie change tous mes ſeus en yeux & en oreilles Pour remarquer ta grace à conter ces merveilles, Du vemtoudus chatma avec ſes appas .	Je change tous mes zeus en yeux et en oreilles Pour remarquer ta grâce à conter ces merveilles, Du emtoudus chatma avec ses appas .
Rens-nous-la toute pure & ne la farde pas, Fais-la voir à nos yeux comme les tiens ſont vûë.	Rends-nous-la toute pure et ne la farde pas, Fais-la voir à nos yeux comme les tiens sont vue.
D.	D.
SANCHE	SANCHÉ
Sire, en voicy l’image & ſans tache & ſans nuë, Le Comte qui tenon dedaremtraumms,	Sire, en voici l'image et sans tache et sans nue, Le Comte qui tenon dédaremtraums,
De courir ſur les flots un monde dangers, De remplir de ſon bruit la Cieile & la Grece, Paroiſſant dans le Pori aux yeux de la Nobieſſe, Eſt reçû des Guerriers à cœur & bras ouveits, Avec des compliment de mille hommes divers.	De courir sur les flots un monde dangers, De remplir de son bruit la Cile et la Grèce, Paraissant dans le Pori aux yeux de la Nobiesse, Est reçu des Guerriers à cœur et bras ouvits, Avec des compliment de mille hommes divers.
Son Oncle en le vovant que le Crel Ienvoye Pour combler la Caſtille & de gloire & de joye?	Son Oncle en le vouant que le Crel Ienvoie Pour combler la Castille et de gloire et de joie?
Que le More eſt défait, & que les Cieux amis, Les feront triompher de tons leurs ennemis.	Que le More est défait, et que les Cieux amis, Les feront triompher de tons leurs ennemis.
Tout le Conſeil s’aſſemble, & d’une voix commune Ils le font General & Chef de leur fortune.	Tout le Conseil s'assemble, et d'une voix commune Ils le font Général et Chef de leur fortune.
Chacun reçoit ſon ordre, & tous nos Cavaliers Trouvent tous ſes conſeils égeux & reguliers.	Chacun reçoit son ordre, et tous nos Cavaliers Trouvent tous ses conseils égeux et réguliers.
Qu'il ſuit les ſéntimens d un grand homme de gurre, Pour vainere ſur les flots auſſi-bien que ſur terre, Qu'il a les qualités qu’on pourroit demander Pour ſçavoit bien couduire & pour bien commander;	Qu'il suit les séntimens dou grand homme de gurre, Pour vaine sur les flots aussi-bien que sur terre, Qu'il a les qualités qu’on pourrait demander Pour savait bien couduire et pour bien commander;
Il range nos Vaiſſeaux, remarque leur Armée, Iuge où le vent contraire aporte la fumee.	Il range nos Vaisseaux, remarque leur Armée, Juge où le vent contraire apporte la fumée.
Fait pointer les canons, prend la faveur du vent Pour faire la retraite ou gagner le devant;	Fait pointer les canons, prend la faveur du vent Pour faire la retraite ou gagner le devant;
Nous montre la conduite & lordre qu’il faut prendre Quand il faut aſſaillir, ou qu’il faur ſe défendre, Ajuſte nos Guerriers & les met ſur les pas Où la gloite de vainere amorce les Soldats:	Nous montre la conduite et lordre qu'il faut prendre Quand il faut assaillir, ou qu'il saur se défendre, Ajuste nos Guerriers et les met sur les pas Où la gloite de vainere amorce les Soldats:
D'un diſcours genereux leur enfle le coutage, Et leur fair mépriſer & la crainte & Iorage:	D'un discours généreux leur enfle le coutage, Et leur fair mépriser et la crainte et Jorage:
Enfin ayant les rang & les ordres donnez, Et tous les Eſcadrons en bataille ordonnez, Comme le General il donne la conduire Au genereux Baron qu’il avoit a ſa ſuire, Vaillant comme l'epée, & qui nous o fait voir Ce que peut aux combats ladreſſe & le pouvoir.	Enfin ayant les rang et les ordres donnés, Et tous les Escadrons en bataille ordonnés, Comme le Général il donne la conduire Au généreux Baron qu'il avait à sa suire, Vaillant comme l'epée, et qui nous ô fait voir Ce que peut aux combats ladresse et le pouvoir.
D.	D.
FERNAND Ce diſcours me ravit, & ie ne puis comprendre Quel eſt ce Cavalier!	FERNAND Ce discours me ravit, et ici ne puis comprendre Quel est ce Cavalier!
D.	D.
DANCHE Le Baron de Teandre.	DANCHE Le Baron de Téandre.
D.	D.
FERNAND De quelle narion?	FERNAND De quelle narion?
ce nom m’eſt étranger?	ce nom m'est étranger?
Qui la fait expoſer pour nous dans le danger?	Qui la fait exposer pour nous dans le danger?
DeeRens C'eſt Tamitie du domter	DeRends C'est Tamitie du dompter
D.	D.
FERNAND Elle eſt certes extréme D.	FERNAND Elle est certes extrême D.
SANCHE Chacun eſt la moitié de ſon autre ſoy-méme, Vn cœur dedans deur corps vivant ſous méme loix, Quoy qu’un ſoit Caſtillan & lautre foit François.	SANCHE Chacun est la moitié de son autre soi-même, Un cœur dedans devr corps vivant sous même lois, Quoi qu'un soit Castillan et lautre soit Français.
Le Comte pourſuit donc ce qu’il a pris à rache, Sans que jamais ſon cœur s’arréte & ſe relache, Ses yeux & ſa valeur nous échauffent le ſein, Nous voyons letriomphe au bout de fon deſſein :	Le Comte poursuit donc ce qu'il a pris à rache, Sans que jamais son cœur s'arrête et se relache, Ses yeux et sa valeur nous échauffent le sein, Nous voyons letriomphe au bout de son dessein :
Sa conduite aux dangers, ſa chaleur aux alarmes, Nous font voir nos lauriers à léelat de ſes armes, La Mer, l'onde & les vents vont au gré de nos vœuz, Nou tenons la fortune au bout de ſes cheveux, L'heure tarde à nos cœars, & chacun meurt d'envie De gagner un laurier ou de perdre la vie:	Sa conduite aux dangers, sa chaleur aux alarmes, Nous font voir nos lauriers à léelat de ses armes, La Mer, l'onde et les vents vont au gré de nos vœuz, Nou tenons la fortune au bout de ses cheveux, L'heure tarde à nos cœars, et chacun meurt d'envie De gagner un la ou de perdre la vie:
l’ennemi dans la peur bilançant ſut les ſtots.	l'ennemi dans la peur bilançant sut les stots.
loyant ceder au vent l'effort des Matelois, I’oſe rien entreprendre & ne ſçait que reſoudre, yant vû les éclairs il redoute la foudre, leux que le Comte voit en terre décendus, – les juge auſſi-toſt & défaits & perdus.	loyant céder au vent l'effort des Matelais, J'ose rien entreprendre et ne sait que résoudre, yant vu les éclairs il redoute la foudre, leux que le Comte voit en terre décendus, les juge aussi-tôt et défaits et perdus.
t donnant le ſignal il fond comme un tonnerte ur les Vaiſſeaur épars, & les preſſe & les ſetre,  es bat de tons côtés, & les met ſur des lieux lú féclat du Soleil leur donne dans les yeer, eandre en méme tems avec l' Irfanterie, élangeant la vileur avec la furie.	t donnant le signal il fond comme un tonnerte ur les Vaisseaur épars, et les presse et les soire, ès bat de tons côtés, et les met sur des lieux l' éclat du Soleil leur donne dans les ie, élandre en même temps avec l' Irfanterie, élangeant la vileur avec la furie.
ttaque l'autre Armée, & dans le champ d'honneur hacun montre au dauger qu’il eſt homme de cœur.	taque l'autre Armée, et dans le champ d'honneur hacun montre au dauger qu'il est homme de cœur.
es ennemis rangez de côté de la plage, Tachent de repouſſer goare par orage.	es ennemis rangez de côté de la plage, Tachent de repousser goare par orage.
Mais l’honneur du comhat demeure à nos efforts, Et le More voit moins de vivans que de morts, A ſes Chefs plus hardis il voit mordre la poudre, L’effet de nos canons eſt égal à la foudre, Ilt n’ont jamais tiié ſans voir dans leurs éclats, Démembrer ou, les rangs ou les corps des ſoldats.	Mais l'honneur du comhat demeure à nos efforts, Et le More voit moins de vivants que de morts, À ses Chefs plus hardis il voit mordre la poudre, L'effet de nos canons est égal à la foudre, Ilt n'ont jamais tier sans voir dans leurs éclats, Démembrer ou, les rangs ou les corps des soldats.
Enfin reconnoiſſans leur perte & leur foibleſſe, Ils ſe rendent vaincus à celui qui les preſſe, Le Comte qui pourſuit les autres ſur les flots, Toûjours en action & jamais en repos, Voyant que ſes canons avec la fumée En leur ôtant la vuë écartoit leur Armée, Et à voile & a rame il les ſuit deſſus l'eau, S'aggraphe, prend, ſaiſit & deſarme un Vaiſſeau, Se rend maitre de l'autre & voyant que la Flote Ayant perdu le cœur a recours au Pilote, La défait en fuyant, & à coups de canon Fait les uns priſonniers & met les autres à fond;	Enfin reconnaissant leur perte et leur faiblesse, Ils se rendent vaincus à celui qui les presse, Le Comte qui poursuit les autres sur les flots, Toujours en action et jamais en repos, Voyant que ses canons avec la fumée En leur ôtant la vue écartait leur Armée, Et à voile et à rame il les suit dessus l'eau, S'aggraphe, prend, saisit et désarme un Vaisseau, Se rend maître de l'autre et voyant que la Flote Ayant perdu le cœur a recours au Pilote, La défait en fuyant, et à coups de canon Fait les autres prisonniers et à coups mets m fond;
Tellement que paſſant comme un foudre de guerre, Nous triomphons du More & ſur mer & ſur terre.	Tellement que passant comme un foudre de guerre, Nous triomphons du More et sur mer et sur terre.
Et ſans que dix Vaiſſeaux d’un incroyable effort Prirent pour leur azile un favorable Port, Que la peur leur donna de bonne heure des aîles, Aucun n’en échapoit pour porter les nouvelles, Le Prince d'Aragon, quatre cens guerriers, Leur General d’Armée & ſix Chefs priſonniers, Avec douze Vaiſſeaux eut la méme défaite, Honorent le triomphe avecque la conquete.	Et sans que dix Vaisseaux d'un incroyable effort Prirent pour leur asile un favorable Port, Que la peur leur donna de bonne heure des aîles, Aucun n'en échappait pour porter les nouvelles, Le Prince d'Aragon, quatre cens guerriers, Leur Général d'Armée et six Chefs prisonniers, Avec douze Vaisseaux eut la même défaite, Honorent le triomphe avec la conquête.
Les autres en fuyant ont crié ſur lee eaux – De préparer nos gens a des combats nouveaux, Et qu’ils prendront leur tems en une heure oportune, Pour avoir comme nous le veut & la fortune:	Les autres en fuyant ont crié sur lee eaux um De préparer nos gens a des combats nouveaux, Et qu'ils prendront leur temps en une heure oportune, Pour avoir comme nous le veut et la fortune:
Et qu’à peine aurons-nous déchargé le harnois, Qu'ils reviendront au Port avec deux ou trois Roys Dont les ames d'honneur & de gloire échauffées, Ont dé ja this Seville au rang de leurs trophées.	Et qu'à peine aurons-nous déchargé le harnais, Qu'ils reviendront au Port avec deux ou trois Rois Dont les âmes d'honneur et de gloire échauffées, Ont dé jà this Serville au rang de leurs trophées.
D.	D.
FERNAND ne pouem en eſt beau, nous les verrons venir, Ils ſſçavent entreptendre, & ie les ſçay punir.	FERNAND ne pouem en est beau, nous les verrons venir, Ils savent entreptendre, et Seigneur les sais punir.
UCEACEMRIe LE PRINCE, D.	UCEACEMRIe LE PRINCE, D.
SANCHE.	SANCHÉ.
LE PRINCE DEs exploirs glorieux qui paſſent pour merveilles, Charment en raviſſant mon eœur & mes oreilles;	LE PRINCE DEs exploirs glorieux qui passent pour merveilles, Charment en ravissant mon eœur et mes oreilles;
Mais léclat en ſeroit encor plos glorieux, Si le Comte les eût achevez à mes yeux, Ie voulois cet emp loy pour avoit cette gloire;	Mais léclat en serait encor plos glorieux, Si le Comte les eût achevés à mes yeux, Je voulais cet emp loi pour avait cette gloire;
Mais j’en eus les deſſeins, il en a la victoire :	Mais j'en eus les desseins, il en a la victoire :
Le Roy men fiſt refus ſur mes trop jeunes ans, Quoy qu’Alcide au Berceau fiſt mourir des Serpens, Qu'Alexandre le Grand au bouton de ſon age Ait fait ttembler le monde au bruit de ſon courage, Et que de tems en tems on ait vù des Guerriers Elever leur jeuneſſe à lombre des lauriers.	Le Roi men fît refus sur mes trop jeunes ans, Quoi qu'Alcide au Berceau fît mourir des Serpents, Qu'Alexandre le Grand au bouton de son age Ait fait embler le monde au bruit de son courage, Et que de temps en temps on ait venù des Guerriers Élever leur jeunesse à lombre des lauriers.
Le Prince eſt un Soleil, le feu dont il nous touche Eſt le méme au levant qu'à l’heure qu’il ſe couche, Le Midy luit toûjours deſſus cet horiſon, Son courage & ſa force eſt toûjoues de ſaiſon:	Le Prince est un Soleil, le feu dont il nous touche Est le même au levant qu'à l'heure qu’il se couche, Le Midi luit toujours dessus cet horizon, Son courage et sa force est toûjoues des saison:
En l’nyver du vulgaire ii y des fleurs écloſe.	En l'niver du vulgaire ji y des fleurs éclose.
Et donne deux fois lan des bourons & des roſes, Semblable à ces noyers qu’on voit en une nuit Produire tout euſemble & la fleur & le fruit.	Et donne deux fois lan des bourons et des roses, Semblable à ces noyers qu'on voit en une nuit Produire tout eusemble et la fleur et le fruit.
Mon cœur Iauguir de voir ma valeur occupé .	Mon cœur Jauguir de voir ma valeur occupé .
Dans les lieux où le Comte a fait voir ſon épée:	Dans les lieux où le Comte a fait voir son épée:
Et en renpumtmmii qui quil ſoit dans mon cœur Ses beaux faits m'ont pique dun ſentiment d’honneur, Vne ame geneteuſe eſt auſſi-toſt ſaiſie Au bruit des grands exploits d’un peu de jalouſie, Si le More conçoit quelque mauvais deſſein, Qu’il s’attende à me ton les armet à la main.	Et en renpumammi qui quil soit dans mon cœur Ses beaux faits m'ont pique dun sentiment d'honneur, âme géneteuse est aussitôt saisie Au bruit des grands exploits d'un peu de jalousie, Si le More conçoit quelque mauvais dessein, Qu'il s'attende à me ton les armet à la main.
D.	D.
SANCHE	SANCHÉ
D.	D.
SANCHE Grand Prince ſupaſſez les exploits de Pompée, Ie vous offre ma vie avecque mon épée.	SANCHE Grand Prince supassez les exploits de Pompée, Je vous offre ma vie avec mon épée.
HOR.	HOR.
E SCENE TREMIERE CHIMENE inconſolable	 SCÈNE -THREMIERE CHIMENE inconsolable
STANCES V Fuve d'eſperance & d’Epoux, Fille ingrate & perfido, Amante infortunée!	STANCES V Fuve d'espérance et d'Époux, Fille ingrate et perfido, Amante infortunée!
Que dois-je devenir aprés ces rudes coups Des armes de mon Frere & de ma destinée?	Que dois-je devenir après ces rudes coups Des armes de mon Frère et de ma destinée?
Est-il courage en ce malheur Qui puiſſe ſuporter l'excés de ma douleur?	Est-il courage en ce malheur Qui puisse supporter l'excès de ma douleur?
Loſpoir n’a rien de legitime, Mon ame eſt deſolée & mon cœur abatu, Ma conſtance ſeroit un crime.	Lospoir n'a rien de légitime, Mon âme est désolée et mon cœur abattu, Ma constance serait un crime.
Quoy qu'elle ſoit au monde une granda vertu, Tous conſeils ſont hors de ſaiſon, La doueeur de la mort a charmé ma penſée, Les paſſions de l’ame ébranlent la raiſon.	Quo qu'elle soit au monde une granda vertu, Tous conseils sont hors de saison, La douceur de la mort a charmé ma pensée, Les passions de l'âme ébranlent la raison.
Mais la mienne en effet eſt toute renverſée;	Mais la mienne en effet est toute renversée;
Mes eſprits & mes ſentimens Sont toû jours agités de divers mouvemens.	Mes esprits et mes sentiments Sont tou jours agités de divers mouvements.
Mon Epoux a tué mon Pere, Ie ne ſçay qui des deux mon cœur a plus chery?	Mon Époux a tué mon Père, Je ne sais qui des deux mon cœur a plus chéri?
Et s’il doit aecuſer mon Frere D'avoir vengé ſon ſang en tuant mon Mary.	Et s'il doit aecuser mon Frère D'avoir vengé son sang en tuant mon Mari.
Dieux que mon ſort a de rigueur?	Dieux que mon sort a de rigueur?
Parmy les accidens qui travaillent mon ame, Et la mort de mon Epoux violente mon cœur, La mort de mon Pere y conſerve ſa flâme, A qui ſçaurois-je plus devoir?	Parmi les accidents qui travaillent mon âme, Et la mort de mon Époux violente mon cœur, La mort de mon Père y conserve sa flamme, À qui saurais-je plus devoir?
Quel ſur mes ſentimens aura plus de pouvoir?	Quel sur mes sentiments aura plus de pouvoir?
Chacun également me touche Mes malheurs ſont ſi granas qu'on ne les peut coler?	Chacun également me touche Mes malheurs sont si granas qu'on ne les peut coler?
Et le ſang me ferme la bouche.	Et le sang me ferme la bouche.
Quand l'excés de lamour la force de parler.	Quand l'excès de lamour la force de parler.
Mon étre & mon affection Demeurans ſuſpendus en égale balance, Combatent mon devoir, & à chaque action Me propoſent les loix d’Hymen & de naiſſanée, Ie dois à mon Pere le jour.	Mon être et mon affection Demeurants suspendus en égale balance, Combatent mon devoir, et à chaque action Me proposent les lois d'Hymen et de naissanée, Je dois à mon Père le jour.
Mon Mary tient mon cœur en des chaînes d’amour, Iamais Sœur ne perdit ſon Frere:	Mon Mari tient mon cœur en des chaînes d'amour, Jamais Sœur ne perdit son Frère:
Si je pourſuis le mien e eſt fort pou justement, Puiſqu’il vient de venger mon Pere, Et que j’ay pardonné ſa mort à mon Amant.	Si je poursuis le mien e st fort pour justement, Puisqu'il vient de venger mon Père, Et que j'ai pardonné sa mort à mon Amant.
Amour ſubtil à décevoir!	Amour subtil à décevoir!
Complico de mon crime & fauteur de l’in jure Aprés avoir ſeduit mon ame & mon devoir, Leur a fait violer les loix de la nature.	Complico de mon crime et fauteur de l'in jure Après avoir séduit mon âme et mon devoir, Leur a fait violer les lois de la nature.
Et quoy que la force du ſang Allumaſt ma colere en me picquant le flanc Avec un deſir de vengeance:	Et quoi que la force du sang Allumât ma colère en me piquant le flanc Avec un désir de vengeance:
Cet amour combatant le couroux dans mon ſein M’en a fait pardonner l’offence, Mépriſer la pourſuite, & rompre le deſſein.	Cet amour combattant le courroux dans mon sein M'en a fait pardonner l'offense, Mépriser la poursuite, et rompre le dessein.
Croire mon Frere criminel!	Croire mon Frère criminel!
Par un acte d’honneur réparant un outrage Qui noirciſſoit ſon nom d’un reproche éternel, Et diffamoit ſa gloire avec ſon courage, Ce ne ſeroit pas raiſonner.	Par un acte d'honneur réparant un outrage Qui noircissait son nom d'un reproche éternel, Et diffamait sa gloire avec son courage, Ce ne serait pas raisonner.
Etxtmple de Rodrigue oblige à pardonner Le feu dune juſte vengeance:	Etxtmple de Rodrigue oblige à pardonner Le feu dune juste vengeance:
Et le reſſentiment nous donne tant d’appas, Que diſſimulant cette offence, Qui porte un nom d'honneur ne le merite pas.	Et le ressentiment nous donne tant d'appas, Que dissimulant cette offense, Qui porte un nom d'honneur ne le mérite pas.
Ie bleſſe ma haeite	Je blesse ma haècite
Tragt-Comedie.	Tragt-Comédie.
Tant la foree du ſang eſt puiſſante & extréme, Le Frere avec la Sœur ont bien l’affinité, Mais la Femme à l’Epoux eſt un autre ſoy-méme;	Tant la farée du sang est puissante et extrême, Le Frère avec la Sœur ont bien l'affinité, Mais la Femme à l'Époux est un autre soi-même;
Accuſeray je mon Germain Aprés avoir baiſé la parricide main Qui venoit de tuer mon Pere?	Accuserai je mon Germain Après avoir baisé la parricide main Qui venait de tuer mon Père?
Non, non, il faut montrer une égale doueeur, Et forcer mon deüil à ſe taire Lorſque mon ſentiment luy mangeroit le cœur.	Non, non, il faut montrer une égale douceur, Et forcer mon deuil à se taire Lorsque mon sentiment Seigneur mangerait le cœur.
Mes douleurs ſont ſans gueriſon:	Mes douleurs sont sans guérison:
Ie n’ay plus de malheurs & de peines à craindre, La mort me doit guerir & non pas la raiſon.	Je n'ai plus de malheurs et de peines à craindre, La mort me doit guérir et non pas la raison.
Il eſt tems de mourir & non pas de ſe plaindre:	Il est temps de mourir et non pas de se plaindre:
Trépas refuge de mon cœur:	Trépas refuge de mon cœur:
Que tu charme mon ame avec de doueeur!	Que tu charme mon âme avec de douceur!
Que tes appas ſont agreables!	Que tes appas sont agréables!
Que ta main, quoy qu'armée eſt pleine d'équité:	Que ta main, quoi qu'armée est pleine d'équité:
Tu ſers d'azile aux miſerables, Et les fais triompher de leur averſité Mon eœur gemit ſous des malheurs De qui la eruauté paſſe la tyrannie.	Tu sers d'asile aux misérables, Et les fais triompher de leur aversité Mon eœur gémit sous des malheurs De qui la ervauté passe la tyrannie.
Ma vie avec mon ſang ſe diſtille en pleurs, Mes eſprits & mes ſens s’en vont dans l’agonie:	Ma vie avec mon sang se distille en pleurs, Mes esprits et mes sens s'en vont dans l'agonie:
Ces ſiniſtres evenemens Ont rendus ſi confus tous mes reſſentimens, Qu'ils ont renverſé ma constance, Mes organes bleſſés en demeurent perclus;	Ces sinistres événements Ont rendus si confus tous mes ressentiments, Qu'ils ont renversé ma constance, Mes organes blessés en demeurent perclus;
Et dans leur rude viclence, Mes ſens & ma raiſon ne ſe connoiſſent plus.	Et dans leur rude viclence, Mes sens et ma raison ne se connaissent plus.
Tout ce qui ſe preſente à moy N’est à mes ſtmbres yeux qu’un ob jet de tristeſſe, Rodrigue tient mon cœur pour gage de ma foy, Elle eſt inviolable en gardant ſa promeſſe.	Tout ce qui se présente à moi N'est à mes stmbres yeux qu'un ob jet de tristesse, Rodrigue tient mon cœur pour gage de ma foi, Elle est inviolable en gardant sa promesse.
Amour d’une chaîne de fleurs Liu ſi doucement & nos ames & nos cœurs Que rien ne les ſçauroit défaire;	Amour d'une chaîne de fleurs Liv si doucement et nos âmes et nos cœurs Que rien ne les saurait défaire;
12 Et la mort dont les traits me font tant ſoûpirer:	12 Et la mort dont les traits me font tant soupirer:
Plus favorable que mon Frere, L Re joindra nos deux corps qu’il vient de ſeparer.	Plus favorable que mon Frère, L Re joindra nos deux corps qu'il vient de séparer.
SCENE II.	SCÈNE II.
D.	D.
FERNAND, LE PRINCE, TEANDRE, D.	FERNAND, LE PRINCE, TEANDRE, D.
SANCHE, LE COMTE, D.	SANCHÉ, LE COMTE, D.
FERNAND, » Omte dont la valeur & les exploits de guetre J Ont rempli de triomphe, & la mer & la terre.	FERNAND, " Omte dont la valeur et les exploits de guetre Ont rempli de triomphe, et la mer et la terre.
Ag ſſant aux combats comme un foudre éclairant, Qui force tout obſtacle & frape en conquerant, Plus connu pat ra gloire & faus de ta vaillance, Que par l’illuſtre nom que tu tiens de naiſſance, Genereux ſucceſſeur d’un ttiomphant Guerrier, Que l’honneur a couvert mille fois de laurier Dans les champs de bataille & aux places forcées, Oû ſa vie & ma gloire étoient intereſſées.	Ag sant aux combats comme un foudre éclairant, Qui force tout obstacle et frappe en conquérant, Plus connu pat ra gloire et faus de ta vaillance, Que par l'illustre nom que tu tiens de naissance, Généreux successeur d'un ttiomphant Guerrier, Que l'honneur a couvert mille fois de laurier Dans les champs de bataille et aux places forcées, Oû sa vie et ma gloire étaient intéressées.
Que ne te dois-je pas aprés avoir ſoûmis La puiſſance & lorgüeil de tous mes ennemis!	Que ne te dois-je pas après avoir soumis La puissance et lorgueil de tous mes ennemis!
Et d’une paſſion auſſi chaude que promte, Couvert leurs Eſcadrons & de ſang & de honte;	Et d'une passion aussi chaude que promte, Couvert leurs Escadrons et de sang et de honte;
Etouffé leurs deſſeins, affronté les dangers?	Étouffé leurs desseins, affronté les dangers?
Et purgé tous mes Ports de vaiſſeaux étrangers?	Et purgé tous mes Ports de vaisseaux étrangers?
Eſſuyé nos malheurs, & couru ſans contrainte Où les cœurs des Cœſars auroient eu de la crainte.	Essuyé nos malheurs, et couru sans contrainte Où les cœurs des Cœsars auraient eu de la crainte.
Ces exploits couronnés de palmes & d'honneur, Ont charmé de ton Prince & leſprit & le cœur, Leur merite eſt ſi grand que pour reconnoiſſance, Ie me trouve impuiſſant en toure ma puiſſance, Et avec mes honneurs ie ne puis m’acquiter De ce que tes hauts faits viennent de meriter:	Ces exploits couronnés de palmes et d'honneur, Ont charmé de ton Prince et lesprit et le cœur, Leur mérite est si grand que pour reconnaissance, Je me trouve impuissant en toure ma puissance, Et avec mes honneurs on ne puis m'acquitter De ce que tes hauts faits viennent de mériter:
Et quoy que le triomphe ait des mains de la gloite Ecrit du ſang du More & la perte & l’hiſtoire, L’honneur qui rejallit des coups de leur malheur Demande une Couromne egale a te vaſcuer Pourſui ces beaux exploits, ton valeureux genie Doit triompher du More & de ſa tyrannie, Ton courage te rend digne d’un grand employ, Demande, eſpere tout ayant le cœur du Roy.	Et quoi que le triomphe ait des mains de la gloite Écrit du sang du More et la perte et l'histoire, L'honneur qui rejaillit des coups de leur malheur Demande une Couromne égale a te vascuer Poursui ces beaux exploits, ton valeureux génie Doit triompher du More et de sa tyrannie, Ton courage te rend digne d'un grand emploi, Demande, espère tout ayant le cœur du Roi.
Ioint en prenant du tems Ia rencontre opoitune;	Joint en prenant du temps Ia rencontre opoitune;
A ta grande valeur une grande fortune.	A ta grande valeur une grande fortune.
Ayant mes ennemis ſur la poudre abatus, Ajoûte ma puiſſance aux faits de tes vertus Acheve de les perdre, & que la renommée Seme le bruit que Mars eſt Chef de mon Irmée:	Ayant mes ennemis sur la poudre abattus, Ajoute ma puissance aux faits de tes vertus Achève de les perdre, et que la renommée Sme le bruit que Mars est Chef de mon Irmée:
Ie t’en fais General, la conduite eſt à toy, La gloire i’en eſt dúẽ & l'honneur à ton Roy.	Je t'en fais Général, la conduite est à toi, La gloire j'en est donc et l'honneur à ton Roi.
LE COMTE Sire, ie ſuis honteux, ma gloire eſt ſi petite Que lexcés de l'honneur ſurmonte le merite:	LE COMTE Sire, je suis honteux, ma gloire est si petite Que lexcès de l'honneur surmonte le mérite:
Mourant pour votre Etat, mon corps au monument Seroit trop ſatisfait d’un ſoûpir ſeulement, Ie vous doy mon épée avec ma naiſſance, Et trouve mon honneur dans mon obeyſſance;	Mourant pour votre État, mon corps au monument Serait trop satisfait d'un soupir seulement, Je vous dois mon épée avec ma naissance, Et trouve mon honneur dans mon obéissance;
Ie feray vanité d'avoir ce digne employ, Si le Roy de Sicile en diſpenſoit ma foy;	Je ferai vanité d'avoir ce digne emploi, Si le Roi de Sicile en dispensait ma foi;
Il m’a fait Lieutenant & General d’Armée;	Il m'a fait Lieutenant et Général d'Armée;
La guerre dans ſon pays eſt par tout allumée:	La guerre dans son pays est par tout allumée:
S’il eut ſçû mon deſſein & ce peu de ſejour, Il ne m’eût pas permis d’abandonner ſa Cour.	S'il eut su mon dessein et ce peu de séjour, Il ne m'eût pas permis d'abandonner sa Cour.
Que votre Majeſté, pour l’honneur quil me donne, Ttouve bon que ie meure en ſervant ſa Couronne;	Que votre Majesté, pour l'honneur quil me donne, Touve bon que de meure en servant sa Couronne;
Ma fortune & mon bien ſont dûs à ſa faveur, Recevant mon ſervice, il m'a donné ſon cœur:	Ma fortune et mon bien sont dus à sa faveur, Recevant mon service, il m'a donné son cœur:
Ie ſuis auprés de lui comme un autre lui-méme, I’ay le commandement & lui le Drademle.	Je suis auprès de lui comme un autre lui-même, J'ai le commandement et lui le Drademle.
D FERNAND Attends plus de fortute, & un meilleur party, Ton cœur nous a fait voir de ſang qu’il eſt ſorty, Pour triompher du More & finir nos allarmes, La Caſtille a beſoin des Exploits de tes Armes.	 FERNAND Attends plus de fortute, et un meilleur parti, Ton cœur nous a fait voir de sang qu'il est sorti, Pour triompher du More et finir nos alarmes, La Castille a besoin des Exploits de tes Armes.
La Sieile n’a pas de lauriers aſſez beaux Pour couronner des faits ſi grauds & ſi nouveaux:	La Sièile n'a pas de lauriers assez beaux Pour couronner des faits si grauds et si nouveaux:
Mon cœur eſt ſatisfait d’avoir vú leurs defaites, Ie te donne ce Prince avecque tes conquétes;	Mon cœur est satisfait d'avoir veine leurs défaites, Je te donne ce Prince avec tes conquétes;
Goûte avec ce doux air les plaiſirs de ma Cour, Et méle à tes lauriers les myrthes de Iamour?	Goûte avec ce doux air les plaisirs de ma Cour, Et mêle à tes lauriers les myrthes de Jamour?
La Comté de Gormas n’a pas ſi peu de charmes, Qu'elle n’ait des appas pour divertir tes armes, Viſite tes chateaux, voy ces rares objets, Reçoy de nouveaux vœux du cœur de tes Sujets;	La Comté de Gormas n'a pas si peu de charmes, Qu'elle n'ait des appas pour divertir tes armes, Visite tes châteaux, vois ces rares objets, Reçois de nouveaux vœux du cœur de tes Sujets;
Il n’eſt tel charme aux yeux que l’appas de nos terres, La beauté du nos Tours, les fleurs de nos partetres:	Il n'est tel charme aux yeux que l'appas de nos terres, La beauté du nos Tours, les fleurs de nos partetres:
Fay voir encor Seville à ce brave Bacon Qui remplit la Caſtille & nos cœurs de lon nom, Et que le bruit publie allant de place en placé.	Fais voir encor Seville à ce brave Bacon Qui remplit la Castille et nos cœurs de lon nom, Et que le bruit publie allant de place en placé.
Que la France a des Mars auſſi-bien que la Thrace.	Que la France a des Mars aussi-bien que la Thrace.
LE COMTE Grand Prince, qui n’avez que le Ciel deſſûs vous, Vous nous poſſederiez ſi nous erions à nous;	LE COMTE Grand Prince, qui n'avez que le Ciel dessus vous, Vous nous posséderiez si nous erions à nous;
Ie ſens un trait d'amour qui traverlan mou ame Produit pour deux objets une pareille flame, Et mon deſir reçoit ſi doucement vos loix, Que ſi javois deux corps ie ſervitois deux Rois.	Je sens un trait d'amour qui traverlan mou âme Produit pour deux objets une pareille flamme, Et mon désir ait si doucement vos lois, Que si javais deux corps ont servitais deux Rois.
D.	D.
FERNAND Comte nous apprenons ce mot de nos Ancétres, Qu’un homme en meme tems ne peut être à deux maiires :	FERNAND Comte nous apprenons ce mot de nos Ancètres, Qu'un homme en me temps ne peut être à deux mires :
Tu dois fétre à ton Prince, acheve tes beaux faits, Et crois que tes deſirs ſeront tous ſatisfaits;	Tu dois fêtre à ton Prince, achève tes beaux faits, Et crois que tes désirs seront tous satisfaits;
Mon Conſeil aſſemblé tantoſt en ta preſence, Parlera de ta gloire & de ta recompenſe.	Mon Conseil assemblé tantôt en ta présence, Parlera de ta gloire et de ta récompense.
SCENE III.	SCÈNE III.
LINFANTE LEONOR, LE PAGE.	LINFANTE LEONOR, LE PAGE.
LEONOR Adame, avez-vous vû ce genereux Vainqueur MQui porte Amour aux yeux, & Mars dedans le cœur ?	LEONOR Adame, avez-vous vu ce généreux Vainqueur MQui porte Amour aux yeux, et Mars dedans le cœur ?
Mon Dieu quelle douceur, & quel charmant viſage, Sa grace & ſes appas égalent ſon courage:	Mon Dieu quelle douceur, et quel charmant visage, Sa grâce et ses appas égalent son courage:
Vit-on rien de mieux fait?	Vit-on rien de mieux fait?
il eſt beau comme un jour, Et va tout conquerir par force ou par amour:	il est beau comme un jour, Et va tout conquérir par force ou par amour:
Que cette taille eſt riche, admirez ſa poſture!	Que cette taille est riche, admirez sa posture!
C’eſt un chef d’œuvro entier des mains de la nature!	C'est un chef d'œuvro entier des mains de la nature!
Qu’il méle de douceur avec ſes complimens!	Qu'il mêle de douceur avec ses compliments!
Qu'il montre de grandeur avee ces mouvemens:	Qu'il montre de grandeur ave ces mouvements:
Que ſa façon me charme, & fait voir qu’il aſpire D’avoir un jour en main les reſnes d’un Empire!	Que sa façon me charme, et fait voir qu'il aspire D'avoir un jour en main les rés d'un Empire!
Chimene a des atrrais de grace & de douceur.	Chimène a des atrais de grâce et de douceur.
Mais le frere eſt encor plus charmant que la ſœur;	Mais le frère est encor plus charmant que la sœur;
Que j’avois de plaiſir de voir cetre Nobleſſe Lui rendre tant d’honneur avec tant de ſoupleſſe, Et de le voir paroitre avec cet appareil Parmy les Courtiſans comme un nouveau Soleir!	Que j'avais de plaisir de voir cetre Noblesse Lui rendre tant d'honneur avec tant de souplesse, Et de le voir paraître avec cet appareil Parmi les Courtisans comme un nouveau Soleir!
lamais homme de cœur n'eut de meilleures marques D'égaler ſa fortune à celle des Monarques;	lamais homme de cœur n'eut de meilleures marques D'égaler sa fortune à celle des Monarques;
Ses effets de valeur nous montrent qu’il eſt né Pour manier le Sceptre, & ſe voir couronné.	Ses effets de valeur nous montrent qu'il est né Pour manier le Sceptre, et se voir couronné.
L’INFANTE Ce glorieux éelat m’a priſe à l’impourvuë Il m'a touche le cœur auſſi-toſt que la vúë;	L'INFANTE Ce glorieux éelat m'a prise à l'impourvue Il m'a touche le cœur aussitôt que la vue;
Ie ne ſçay ſi famour a ſur nous du deſſeris.	Je ne sais si famour a sur nous du desseris.
Mais d’un trait de ſes yeux il m’a percé le ſein, Et dépuis ce moment ie reſſens dans mon ame De petits mouvemens & d’amour & de flame:	Mais d'un trait de ses yeux il m'a percé le sein, Et depuis ce moment ie ressens dans mon âme De petits mouvements et d'amour et de flamme:
Mais quand i' auroit mis le feu dedans mon cœur, le ſçay bien lart de feindre & cacher ſon ardeur.	Mais quand j' aurait mis le feu dedans mon cœur, le sais bien lart de feindre et cacher son ardeur.
Leonor, mon honneur veut que ie diſſimule Et le trait qui me bleſſe & le feux qui me brûle?	Leonor, mon honneur veut que ici dissimule Et le trait qui me blesse et le feux qui me brûle?
Retiens tes ſentimens afin que dans la Cour On ne conçoive rien de ce nouvel amour .	Retiens tes sentiments afin que dans la Cour On ne conçoive rien de ce nouvel amour .
Qui naiſſant de ſa gloire & de ma connoiſſance, Pourroit trouvet ſa fin au point de ſa naiſſance, Et pairer dansmun cœur en forme d’un ccrair Qui nous touche les yeux & ſe perd dedans lair.	Qui naissant de sa gloire et de ma connaissance, Pourrait trouvet sa fin au point de sa naissance, Et pairer dansmun cœur en forme d'un ccrair Qui nous touche les yeux et se perd dedans lair.
LEONOR	LEONOR
Madame, c’eſt à vous de veiller ſur vous-méme, Et d’y jetter de l'eau quand la flame eſt extremg.	Madame, c'est à vous de veiller sur vous-même, Et d'y jeter de l'eau quand la flamme est extrémg.
Vous prenez de lamour, & parmy ſes appas Vous trouvez du plaiſir à ne le celer pas, Vn a noureux attrait, une ſombre penſée Nous exprime le coup dont une ame eſt bleſſée, Menagez vos regards & que leur mouvement Le traite comme un Comte & non comme un Amant.	Vous prenez de lamour, et parmi ses appas Vous trouvez du plaisir à ne le celer pas, Venn a nouvreux attrait, une sombre pensée Nous exprime le coup dont une âme est blessée, Ménagez vos regards et que leur mouvement Le traite comme un Comte et non comme un Amant.
L'INFANTE Il n’eſt point de deſſeins dans mon ame bleſſée  Qui ne ſoient enchaînez au fond de ma penſée:	L'INFANTE Il n'est point de desseins dans mon âme blessée Qui ne soient enchaînés au fond de ma pensée:
Amour n'eſt plus aveugle, il ſuit les mouvemens Qu’une honnéte pudeur donne à mes ſentimens, Ma flame eſt retenuë, & dans la bienſeance La Majeſté reluit avec la complaiſance.	Amour n'est plus aveugle, il suit les mouvements Qu'une honnête pudeur donne à mes sentiments, Ma flamme est retenue, et dans la bienséance La Majesté reluit avec la complaisance.
Le Comte tient mon cœur, mais dans ſes entretiens Ie le feray voir libre, & non pas aux liens, Et qu’au degré de gloire où l’honneur tient l’infante, Elle parle en Princeſſe, & non pas en Amante, Et que sil eſt d’objet qui me charme les veux, C’eſt l'honneur de Heros, ou la gloire des Dieux:	Le Comte tient mon cœur, mais dans ses entretiens Je le ferai voir libre, et non pas aux liens, Et qu'au degré de gloire où l'honneur tient l'infante, Elle parle en Princesse, et non pas en Amante, Et que sil est d'objet qui me charme les veux, C'est l'honneur de Héros, ou la gloire des Dieux:
Quoj que le Comte donne en triomphant des marques Des Heros & des Dieux, & des plus grands Monarques Et que déja mon cœur d’une ſecrete loy L’honore comme Prince, & laime comme Roy.	Quoj que le Comte donne en triomphant des marques Des Héros et des Dieux, et des plus grands Monarques Et que déjà mon cœur d'une secrète loi L'honore comme Prince, et laime comme Roi.
Un	Un
LE PAGE Madame, eſtlamoureuſe, & que ſert-il de feindre Vn feu que IOcean ne pourroit pas éteindre?	LE PAGE Madame, estlamoureuse, et que sert-il de feindre Un feu que JOcéan ne pourrait pas éteindre?
Le Comte apré le Prince eſt le plus favo, Et s’il eſt ſou Amant, il ſera ſou Mary.	Le Comte appré le Prince est le plus favo, Et s'il est sou Amant, il sera sou Mari.
SCERE ELVIRE ſeule.	SCERE ÉLVIRE seule.
V	V
STANCES Ve me reſervez-vous obſcure destinée, Si centraire à mes bonheurs?	STANCES Ve me réservez-vous obscure destinée, Si centraire à mes bonheurs?
Ferez vous durer mes malheurs Iuſqu’à ce que la mort fineſſe mes années!	Ferez -vous durer mes malheurs Jusqu'à ce que la mort finesse mes années!
Mes maux ſe rendent plus puiſſans, Ie paſſe tous mes jours en ſoûpirs languiſſans, Ma vie eſt triſte & ennuyeuſe, Que puu-je perdre de nouveau?	Mes maux se rendent plus puissants, Je passe tous mes jours en soupirs languissants, Ma vie est triste et ennuyeuse, Que puv-je perdre de nouveau?
Ma Maitreſſe au jourd huy ſe rend Religieuſe, Et hier on mit mon Maitre & ſon Pere au tombeau Execrable ſoufflet, combat, fatales armes!	Ma Maitresse au jourd hui se rend Religieuse, Et hier on mit mon Majaitre et son Père au tombeau Exécrable soufflet, combat, fatales armes!
Que j’ay vüës teintes de leur ſang Vous laiſſez me perçant le flanc Mon cœur dans les ſoũpirs & mes yeux dans les larmes, Que vos pointes ont de rigueur!	Que j'ai vues teintes de leur sang Vous laissez me perçant le flanc Mon cœur dans les soũpirs et mes yeux dans les larmes, Que vos pointes ont de rigueur!
2 Vous ôtez à mon cœur ſa force & ſa vigucur:	2 Vous ôtez à mon cœur sa force et sa vigucur:
La lumiere m’eſt odieuſe:	La lumière m'est odieuse:
Soleil cache-moy ton flambeau;	Soleil cache-moi ton flambeau;
Ma Chimene au jourd huy ſe rend Religieuſe, Et hier on mit Rodrigue & Dom Diegue au tombeau, Mes jours ſeroient honteux de leur vouloir ſurvivre Ils ſont dans le lit de la mort;	Ma Chimène au jourd hui se rend Religieuse, Et hier on mit Rodrigue et Dom Diègue au tombeau, Mes jours seraient honteux de leur vouloir survivre Ils sont dans le lit de la mort;
Ma Chimene eſt encor au Port Et j'ay mis ma fortune & ma gloire à la ſuivre, Laiſſons aux Morts les monumens.	Ma Chimène est encor au Port Et j'ai mis ma fortune et ma gloire à la suivre, Laissons aux Morts les monuments.
Et ſuivons pour le Ciel de meilleurs ſentimens;	Et suivons pour le Ciel de meilleurs sentiments;
Cette routo eſt delicieuſe, Le deſſeln paroitra plus beau, En imitant Madame étant Religieuſe, Et priant pour les Morts qui ſont dans le tombeau.	Cette routo est délicieuse, Le desseln paraîtrait plus beau, En imitant Madame étant Religieuse, Et priant pour les Morts qui sont dans le tombeau.
Aimables entretiens de la Beatitude:	Aimables entretiens de la Béatitude:
Qui détachez l'ame du corps, Et luy découvrez des treſors Que le Ciel ne fait voir que dans la ſolitude!	Qui détachez l'âme du corps, Et lui découvrez des trésors Que le Ciel ne fait voir que dans la solitude!
Doux ſe jour des cœurs innocens, Oú l’œil voit des ob jets qui raviſſent los ſens, Oú les larmes ſont précieuſes, Mes yeux tous baignez de cette eau Vont répander mes pleurs ebez les Religieuſes, Et prier pour les Morts qui ſont dans le tombeau.	Doux se jour des cœurs innocents, Où l'œil voit des ob jets qui ravissent los sens, Où les larmes sont précieuses, Mes yeux tous baignez de cette eau Vont répander mes pleurs ébez les Religieuses, Et prier pour les Morts qui sont dans le tombeau.
Dun zele acompagné de prieres & de flâme.	Dun zèle acompagné de prières et de flamme.
Voyant mon bien devant mes yeux Ie donne tous mes vœux aux Cieux, Et fais de leurs beautés les charmes de mon ame, Monde reçoy ce triste Adieu, Ie m’en vais daus un Cloiſtre au partir de ce lien Cuerainuui palmes glorieuſes Ie viens de quitter ton bandeau:	Voyant mon bien devant mes yeux Je donne tous mes vœux aux Cieux, Et fais de leurs beautés les charmes de mon âme, Monde reçois ce triste Adieu, Je m'en vais daus un Cloître au partir de ce lien Cuerainuui palmes glorieuses Je viens de quitter ton bandeau:
Chimene & ſon Eluire étans Religieuſes Prieront pour les Morts qui ſont dans le tombeau.	Chimène et son Élvire étant Religieuses Prieront pour les Morts qui sont dans le tombeau.
L TL SCENE PREMIERE TEANDRE, LE COMTE, TEANDRE, Omte, un nouveau deſſein nous donne un nouveau Maitre!	 LL SCÈNE PREMIÈRE -THEANDRE, LE COMTE, TEANDRE, Omte, un nouveau dessein nous donne un nouveau Majaitre!
LE COMTE Baron, ie ne ſçay plus à quel Saint me promettte, Ce Prinee tient mon eœur, fautre a reçû ma foy:	LE COMTE Baron, Seigneur ne sais plus à quel Saint me promette, Ce Prine tient mon eœur, fautre a reçu ma foi:
Et j'aime également.	Et j'aime également.
& l'un & l'autre Roy?	et l'un et l'autre Roi?
Ma Patrie à du charme, la Sicile m’apelle;	Ma Patrie à du charme, la Sicile m'appelle;
Ie doy á fun mon étre, à lautre mon bonheur, Et tous deux m’ont comblé de faveur & d'honneur, Ciel!	Je dois „ fun mon être, à lautre mon bonheur, Et tous deux m'ont comblé de faveur et d'honneur, Ciel!
que n’ay-je deux cœurs, quatre mains, deux perſonnes, Pour mourir en ſervant ces deux nobles Couronnes:	que n'ai-je deux cœurs, quatre mains, deux personnes, Pour mourir en servant ces deux nobles Couronnes:
Ou que n’a fait le ſort en ces combats derniers Ma tombe dans la Mer y ceüillant des lauriers:	Ou que n'a fait le sort en ces combats derniers Ma tombe dans la Mer y ceillant des lauriers:
Mon ame entre l'amour & l'honneur balancée, Ne ſçait en quelle patt arrerer ſa penſée.	Mon âme entre l'amour et l'honneur balancée, Ne sait en quelle pat arrer sa pensée.
Mon cœur aime deux Roys en méme égalité, Et fuit l’ingratitude & l'infidelité:	Mon cœur aime deux Rois en même égalité, Et fuit l'ingratitude et l'infidélité:
Ne ſuis-je pas ingrat en reſuſant mon Prince?	Ne suis-je pas ingrat en ressusant mon Prince?
Et infidele au ſſi quittant une Province Que le Roy de Sicile à laiſſée ſur mes bras, Mes deſſeins ſont honteux & mes refus ingrats.	Et infidèle au ssi quittant une Province Que le Roi de Sicile à laissée sur mes bras, Mes desseins sont honteux et mes refus ingrats.
Et dans ce mouvement mou ame eſt alarmée, Des ſoins que tous nos Chefs ont eu pour ſon Armée	Et dans ce mouvement mou âme est alarmée, Des soins que tous nos Chefs ont eu pour son Armée
TEANDRE Perſonne en ces quartiers n'a ſçu notre départ, Et l'ennemi batu ſe tenoit à lécard:	TEANDRE Personne en ces quartiers n'a sçu notre départ, Et l'ennemi battu se tenait à lécard:
Mous nos Cheſs ont leur ordre:	Mous nos Chess ont leur ordre:
& léur ame échauffés Veut joindre avec la palme un glorieux trophée, Tous ſçaurons aujourd huy ce que Sa Majeſté Aura dans ſon Conſeil pour ta gloire arrété Ce Prince eſt obligeant aux offres qu’il t'a faires, Deſa la recompenſe égale les conqueëtes, Ie croy qu’il apprehende & craint pour ſes Etats.	et léur âme échauffez Veut joindre avec la palme un glorieux trophée, Tous Saurons aujourd' y ce que Sa Majesté Aura dans son Conseil pour ta gloire arrêté Ce Prince est obligeant aux offres il t'a saires, Desa la recompense égale les conqueëtes, Ie croy il apprehende et craint pour ses Etats.
Cette ligue du More avec trois Poteutats, Qui viendroni dans trois jourr lur portes de Seville Pour aſſaillir ſon Sceptre & toute la Caſtille.	Cette ligue du More avec trois Poteutats, Qui viendroni dans trois jourr lur portes de Seville Pour assaillir son Sceptre et toute la Castille.
LE COMTE Il eſt vray qu'en fuyant, ils erioient ſur les eaux, De preparer Iarmée à des combats nouveaux:	LE COMTE Il est vrai qu'en fuyant, ils eriaient sur les eaux, De préparer Iarmée à des combats nouveaux:
Mais ce font de vains bruits, imitant le tounerre Qui paſſe ſans effet.	Mais ce font de vains bruits, imitant le tounerre Qui passe sans effet.
& fait tremb er la tene.	et fait tremb er la téne.
THEANDRE Trois grands Princes igués avec ſes ennemis Le metront en deſordre & tous en compromis, Le Roy tient du vieillard, le Prince eſt jeune d’âge L’unn'a que le Confeil.	THÉANDRE Trois grands Princes iguez avec ses ennemis Le mettront en désordre et tous en compromis, Le Roi tient du vieillard, le Prince est jeune d'âge L'unn'a que le Confeil.
Iautre que le courage, Le tems défaut à l'un, & la force à tous deux;	Jautre que le courage, Le temps défaut à l'un, et la force à tous deux;
Le Pere a trop de glace, & le Fils trop de feux;	Le Père a trop de glace, et le Fils trop de feux;
Le More cependant qui veille lur l'Empire, Ayant fait cette ligue, à trois Princes ſouſcrire;	Le More cependant qui veille lur l'Empire, Ayant fait cette ligue, à trois Princes souscrire;
Prenantiheur & le tems pourroit deſſous ſa loy Mettre vn jour le Royaume, & le Prince & le Roy?	Prenantiheur et le temps pourrait dessous sa loi Mettre un jour le Royaume, et le Prince et le Roi?
Comte que ton épée eſt cy neceſſaire!	Comte que ton épée est cy nécessaire!
Et qu’il te fera grard afin de te complaire!	Et qu'il te fera grard afin de te complaire!
Son Sceptre branletoit s’il n’avoit ton appuy;	Son Sceptre branletait s'il n'avait ton appui;
Ton reuom lIaffermit, eſpere tout de luy, Le Ciel à tes vœux la fortune preſente, de prir de ta viceone ei le nom de l'Infante.	Ton revom lIaffermit, espère tout de Seigneur, Le Ciel à tes vœux la fortune présente, de prir de ta viceone ei le nom de l'Infante.
LE COMTE Cet honneur eſt ſi haut mon merite ſi bas, Que c’eſt étre prudent de ne l'eſperet pas.	LE COMTE Cet honneur est si haut mon mérite si bas, Que c'est être prudent de ne l'espéret pas.
THEANDRE Ainſi que ta victoire a paſſé pour miraele, Mi onuche a ton bonheur eſt an fidele oracle.	THÉANDRE Ainsi que ta victoire a passé pour miraèle, Mi onuche à ton bonheur est an fidèle oracle.
Eſpere rout du ſort & de la volonté D'un Prince qui ſur toy n’a que la Majeſté:	Espère rout du sort et de la volonté D'un Prince qui sur toi n'a que la Majesté:
Ie ſçay comme il te rient en quel rang, quelle eſtime, Ton triomphe d'honneur rend ton don iegitime.	Je sais comme il te rient en quel rang, quelle estime, Ton triomphe d'honneur rend ton don iegitime.
LE COME Si le Ciel écouroit les deſi s des amis, Ce ſouhait de bonbeur poutroit étre permis;	LE COME Si le Ciel écouroit les desi s des amis, Ce souhait de bonbeur poutrait être permis;
Mais e peu de merite y trouve tant d’obſtacles, Qu’il faudroit pour le voir attendre des miracles.	Mais eu peu de mérite y trouve tant d'obstacles, Qu'il faudrait pour le voir attendre des miracles.
THEANDRE Hé quoy !	THÉANDRE Hé quoi !
ne ſçais-tu pas avee ces vains diſcours, Qu amour & la valeus Couboudat tous les jours.	ne sais-tu pas avée ces vains discours, Qu amour et la valeus Couboudat tous les jours.
LE COMTE Ie fetois bien aveugle & couvert d’ignorace, De croire que l'Infaute en fût la recempenſe;	LE COMTE Je fétais bien aveugle et couvert d'ignorace, De croire que l'Infaute en fût la recempense;
Ma valeur dans lexcés né meriteroit pas La gloire d'eſperer un trait de ſes appas.	Ma valeur dans lexcès né mériterait pas La gloire d'espérer un trait de ses appas.
Briſons ſur ces diſcours, & crois, moncher TeandrQu’apiés tant de raiſons ie ne m'en puis défendre, E.	Brisons sur ces discours, et crois, mon TandruQu'apiz tant de raisons quelque ne m'en puis défendre, E.
que mon cœur conçoit pour elle tant de feux, Que pour trop de fortune il devient maleureux, A caule que lamour à tour moment l'agite, Et voit que le defir excede le merite.	que mon cœur conçoit pour elle tant de feux, Que pour trop de fortune il devient maleureux, A caule que lamour à tour moment l'agite, Et voit que le désir excède le mérite.
THEANDRE Comte, crois pour certain qu’un battement de cœur Eſt le coerrier d’un bien ou de quelque malheur :	THÉANDRE Comte, crois pour certain qu'un battement de cœur Est le coerrier d'un bien ou de quelque malheur :
Pouvant tout ſouhaiter, & n’ayant rien à craindre;	Pouvant tout souhaiter, et n'ayant rien à craindre;
Ta fortanmelt au point que lu devois atteindre.	Ta fortanmelt au point que lu devais atteindre.
Ce eau jour eſt heureux a ta felicité, Et donne a ta valeur ce qu’elle a merire	Ce eau jour est heureux a ta félicité, Et donne a ta valeur ce qu'elle a mérire
SCENE II.	SCÈNE II.
LE PRINCE, L’INFANTE, LEONOR,	LE PRINCE, L'INFANTE, LEONOR,
LE PRINCE A Sœur toute la Cour a recours à vos charmes, M il faut que vos beaurés nous fourniſſent des armes Le Comte eſt ſur l'adieu, mais vos divins appas Out des traits trop puiſſans pour ne lartéter pas, Souffrez que vos faveurs nous tirent de ces peines, Que for de vos cheveux ſoit le pœud de ſes chaiſnes, Et qu’un trait de vos yeux en lui perçant le cœur Apréte auprés du Roy ce genereux Vainqueur.	LE PRINCE A Sœur toute la Cour a recours à vos charmes, M il faut que vos beaurés nous fournissent des armes Le Comte est sur l'adieu, mais vos divins appas Ut des traits trop puissants pour ne lartéter pas, Souffrez que vos faveurs nous tirent de ces peines, Que for de vos cheveux soit le pœud de ses chaînes, Et qu'un trait de vos yeux en lui perçant le cœur Aprète auprès du Roi ce généreux Vainqueur.
Vttus ſçavez quel honneur ſa victoire nous bonue Contre les ennemis qui chocquent la Conronne, Qui de nouveau l guez avec deux Poreutats, Arment contre l Empire & contre nos Etats?	Vîts savez quel honneur sa victoire nous bonue Contre les ennemis qui chocquent la Conronne, Qui de nouveau l gué avec deux Poreutats, Arment contre l Empire et contre nos États?
Pour voir de leurs deſſeins leſperance trompée Nos armes ont beſoin encor de ſon épée:	Pour voir de leurs desseins lespérance trompée Nos armes ont besoin encor de son épée:
d'ous avons droit de craindre un ſiniſtre malheur En perdant ſa conduite avec ſa valeur Ma Sœur, & l’interét, & la perte eſt commune, i les chainons d’amour n’arrétent ſa fortune:	d'ous avons droit de craindre un sinistre malheur En perdant sa conduite avec sa valeur Ma Sœur, et l'intérêt, et la perte est commune, y j' inter d'amour n'arrétent sa fortune:
Mélez la complaiſance aux douceurs des appas, Es qu’en vos entretiens il tombe dans vos lacs;	Mêlez la complaisance aux douceurs des appas, Es qu'en vos entretiens il tombe dans vos lacs;
L'éclar d'une Princeſſe, & ſa gloire & ſa flame sont des charmes puiſſans pour triompher d'une ame En quelque point d’honneur que ſon cœur ſoit monté, Sa plus grande fortune étoit votre beauté.	L'éclar d'une Princesse, et sa gloire et sa flamme sont des charmes puissants pour triompher d'une âme En quelque point d'honneur que son cœur soit monté, Sa plus grande fortune était votre beauté.
L’INFANTE Prince, tout mon bonheur à la gloire cù j’aſpire, Sont de voir triompher le Monarque & l Empire?	L'INFANTE Prince, tout mon bonheur à la gloire cù j'aspire, Sont de voir triompher le Monarque et l Empire?
le conçoy vos deſſeins, & mou cœur fera voir Que mon obeïſſance eſt jointe à mon devoir;	le conçois vos desseins, et mou cœur fera voir Que mon obéissance est jointe à mon devoir;
Qu'il n’eſt rien que ie doive & que ie puiſſe faire, Qui n’éclate au de ſir que j’ay de vous complaire;	Qu'il n'est rien que ici doive et que je puisse faire, Qui n'éclate au de sir que j'ai de vous complaire;
Et que ie n’ay dans l'ame un plus chaud mouvement Que de faure ma loy de votre ſentiment.	Et que ici n'ai dans l'âme un plus chaud mouvement Que de faure ma loi de votre sentiment.
Le Comte eſt dans mes rets la victoire eſt aiſée, Ie voy naitre l'amour au fonds de ſa penſée.	Le Comte est dans mes rets la victoire est aisée, Je vois naître l'amour au fond de sa pensée.
A ce cœur genereux féclat de ma beauté Doit ravir le cournge avec la liberté, Et quand il porterois le cœur d’une Tygreſſe, Il ne peut reſiſter aux yeux d’une Princeſſe:	À ce cœur généreux féclat de ma beauté Doit ravir le cournge avec la liberté, Et quand il porterais le cœur d'une Tigresse, Il ne peut résister aux yeux d'une Princesse:
Pour Iaction preſente & le tems avenir Avec un ſeul cheveul ie veux le retenr Sans ſçavoir à quel lieu ſa fortune eſt bornée, Vn ſeul de mes regards fera ſa deſtinée;	Pour Iaction présente et le temps avenir Avec un seul chevul ie veux le retenr Sans savoir à quel lieu sa fortune est bornée, Un seul de mes regards fera sa destinée;
Repoſez tout ſur moy, c’eſt l'objet de mes ſoins, Er piere & les effets en ſeront les témoins.	Reposez tout sur moi, c'est l'objet de mes soins, Er pière et les effets en seront les témoins.
LEONOR Prince, comme les fleurs font le miel des Avettes, Des traits de ſes beaux yeux Amour fait ſes eonquétes, Et leur charmans regards méléz de doux appas Lui captivent des cœurs quand il'uy penſene pas;	LEONOR Prince, comme les fleurs font le miel des Avettes, Des traits de ses beaux yeux Amour fait ses eonquétes, Et leur charmants regards mêlés de doux appas Lui captivent des cœurs quand il'y pensène pas;
Tragi-Comedie.	Tragi-Comédie.
Le Comte a trop d’eſprit pour narréter pour elle En voyaut ta fortune & ſi haute & ſi belle, D’un inſtinct naturel chacun cherche ſon mieux;	Le Comte a trop d'esprit pour narréter pour elle En voyaut ta fortune et si haute et si belle, D'un instinct naturel chacun cherche son mieux;
La gloire de ce Comte eſt d’aimer ſes beaux yeux;	La gloire de ce Comte est d'aimer ses beaux yeux;
Et ſi pour prix d’honneer notle Roy la lur donne, Il lui fait un preſent qui vaut une couronne.	Et si pour prix d'honneer notle Roi la lur donne, Il lui fait un présent qui vaut une couronne.
LE PRINCE Il doit porter un Sceptre, & ſa gloire & ſon nom Ont fait de ce grand Comte un Roy de l’Atragon, Apres avoir défait & les Rois & les Princes, Ls Royaume eſt en branle avecque les Provinces;	LE PRINCE Il doit porter un Sceptre, et sa gloire et son nom Ont fait de ce grand Comte un Roi de l'Atragon, Apres avoir défait et les Rois et les Princes, Lois Royaume est en branle avec les Provinces;
Et s’il fait un renforr d’un armement nouveau, Ie le voy rriompher ſur la terre & ſur Ieau, Monter deſſus le Trône & du Peſe & du More, Et planter ſes lauriers ſur le lict de l'Aurore, Ravager comme un foudre & tonnant & bruyant, Du climat du Midy juſques à l’Orient;	Et s'il fait un renforr d'un armement nouveau, Je le vois riompher sur la terre et sur Jeau, Monter dessus le Trône et du Pèse et du More, Et planter ses lauriers sur le lit de l'Aurore, Ravager comme un foudre et tonnant et bruyant, Du climat du Midi jusques à l'Orient;
Et aprés avoir vû tous nos orages calmes, Revenir tout chargé de lauriers & de palmes.	Et après avoir vu tous nos orages calmes, Revenir tout chargé de lauriers et de palmes.
Ma Sœur, prenez à cœur ce de ſſein glorieux, Et donnez ce triomphe uer enaries de vos yeux;	Ma Sœur, prenez à cœur ce de sein glorieux, Et donnez ce triomphe uer enaries de vos yeux;
Iettez-le dans Ienceinte, & quelque part qu’il aille, Que ſon cœur priſonnier demeure à la bataille,	Jettez-le dans Jenceinte, et quelque part qu'il aille, Que son cœur prisonnier demeure à la bataille,
SCENE III.	SCÈNE III.
L'INFANTE LEONOR, LE PAGE.	L'INFANTE LEONOR, LE PAGE.
LEONOR Adame, d’où vous vient cette changeante humeur AVTEſt-il rien de nouveau qui vous trouble le cœur?	LEONOR Adame, d'où vous vient cette changeante humeur AUTEst-il rien de nouveau qui vous trouble le cœur?
Craigne-vous d’entreprendre une victoire aiſée Dune ame qui ſe donne aux yeux qui l'ont bleſſée?	Craigne-vous d'entreprendre une victoire aisée Dune âme qui se donne aux yeux qui l'ont blessée?
Pour lui ravir le cœur, & en faire un Amant, Il ne faut qu'un regard de vos yeux ſeulement,	Pour lui ravir le cœur, et en faire un Amant, Il ne faut qu'un regard de vos yeux seulement,
L'INFANTE Leonor, une fourbe a ſurpris ma franchiſe;	L'INFANTE Leonor, une fourbe a surpris ma franchise;
e Prince a fait le piege où mon ame s’eſt priſe, Mon cœur en ſa preſence a moidu l’hameçon;	 Je a fait le piège où mon âme s'est prise, Mon cœur en sa présence a moidu l'hameçon;
e ne puis cacher mon feu & ma priſon tu vain ie t’ay priée en me voulant contraindre De la mettre à couver quand ie la voulois feindre.	Je ne puis cacher mon feu et ma prison tu vain ie t'ai priée en me voulant contraindre De la mettre à couver quand tu la voulais feindre.
on eſprit plus ſubtil par un détour trompeur A vû tous les ſecrets que j’avois dans le cœur.	on esprit plus subtil par un détour trompeur A vu tous les secrets que j'avais dans le cœur.
angager mes beautés pour arreter le Comie:	Oangager mes beautés pour arrêter le Comie:
reibre pas engager & ma flame & ma honte?	reibre pas engager et ma flamme et ma honte?
Et iémoigner qu’Amour dans ſon Aveuglement A charme ma raiſon avec mon jûgemeut.	Et iémoigner qu'Amour dans son Aveuglement A charme ma raison avec mon jugemut.
LEONOR Madame;	LEONOR Madame;
excuſez-moy, cela n’eſt pas croyable, Le Prince na rien dit qui ne ſoit veritable:	excusez-moi, cela n'est pas croyable, Le Prince na rien dit qui ne soit véritable:
l parloit tout de bon, & le Roy ni la Cour N’ont point de mouvement qui chocque vetre amour;	l parlait tout de bon, et le Roi ni la Cour N'ont point de mouvement qui chocque vœetre amour;
Achevez cetre gloire à demy commencée, Et jettez dans loubly cette noirs penſee:	Achevez cetre gloire à demi commencée, Et jetez dans loubli cette noirs pensée:
Ajuſiez vos beaux yeux avee votre beauté, Et enchaiuez ſon ame avec ſa liberté, Mélez les doux appas avec la comp ailance, Faiſant naitre lamour avee leſperance;	Ajusiez vos beaux yeux ave votre beauté, Et enchaivez son âme avec sa liberté, Mêlez les doux appas avec la comp ailance, Faisant naître lamour avée lespérance;
Et nouriſſant ſa flame avecque des douceurs, Faites ſes beaux liens d’une chaine de fleurs.	Et nourrissant sa flamme avec des douceurs, Faites ses beaux liens d'une chaîne de fleurs.
L'INFAN E C’eſt un pas bien glifſant ou d’honneur ou de honte, De tenter le refus ou laveu de ce Comte, Er au premier abord lui faire les doux yeux, Pour le rendre auſſi vain qu’il eſt ambitieux :	L'INFAN E C'est un pas bien glissant ou d'honneur ou de honte, De tenter le refus ou lavu de ce Comte, Er au premier abord lui faire les doux yeux, Pour le rendre aussi vain qu'il est ambitieux :
Méme aprés le congé qu’il demande à ſon Prince Pour en fern un autre en une autre Province;	Même après le congé qu'il demande à son Prince Pour en fern un autre en une autre Province;
Et que tous nos honneurs, nos dons & nos treſors Pour reteuir ſon cœur ne ſont pas aſſez forts.	Et que tous nos honneurs, nos dons et nos trésors Pour retuir son cœur ne sont pas assez forts.
LEONOR Madame, un trait d’amour vous promet la victoire.	LEONOR Madame, un trait d'amour vous promet la victoire.
Le coup ſera ſuivi d’une palme de gloire:	Le coup sera suivi d'une palme de gloire:
Son Son cœur entre la crainte & lamour ſuſpendu Ne ſera pás ſomme qu’on le verra rendu;	Son Son cœur entre la crainte et lamour suspendu Ne sera pussy somme qu'on le verra rendu;
C'eſt un deſſein d'honneur que l'Amour favoriſe La gloire du ſuccés honore Ientrepriſe.	C'est un dessein d'honneur que l'Amour favorise La gloire du succès honore Jentreprise.
Avec un compliment de vouceur ce d'Amiour Vous obligez enſemble & le Prince & la Cour.	Avec un compliment de vouceur ce d'Amiour Vous obligez ensemble et le Prince et la Cour.
L'INFANTE Faire des complimens à qui me doit hommage, C’eſt un coup d’imprudence & d’une ame peu ſage, I’expoſe mon honneur & ma gloire au danger:	L'INFANTE Faire des compliments à qui me doit hommage, C'est un coup d'imprudence et d'une âme peu sage, J'expose mon honneur et ma gloire au danger:
Vne Fille de Roy ſe doit mieux ménager, Il faut que la grandeur reluiſe dans la grace.	Une Fille de Roi se doit mieux ménager, Il faut que la grandeur reluise dans la grâce.
LEONOR On ne prend pas ces cœurs avec des rets de glace, Les deſſeins amoureur ſont conçûs dans lardeur, Ils ont pour ennemis la crainte & la froideur.	LEONOR On ne prend pas ces cœurs avec des rets de glace, Les desseins amoureur sont conçus dans lardeur, Ils ont pour ennemis la crainte et la froideur.
Montrez en cet exploit une excés de courage, Et cüeillez une palme où lhonneur tode engage.	Montrez en cet exploit une excès de courage, Et cueillez une palme où lhonneur toujours engage.
L'INFANTE Quoyque l'honneur conçoive & qu’il faſſe eſperer;	L'INFANTE Quoique l'honneur conçoive et qu'il fasse espérer;
Avant que d’entreprendre il faut conſiderer.	Avant que d'entreprendre il faut considérer.
LE PAGE entrant au Theatre.	LE PAGE entrant au Théâtre.
Pendant qu'en ce diſcours le tems perdu s’écoule, Madame, les bonheurs ſe preſentent en foulet Ne vous travaille prus lecmiprits hi les ſens, Le Comte eſt à l’Infante & l’hymen vous apelle, Pour lier vos deux cœurs d’une chaine éternelle:	Pendant qu'en ce discours le temps perdu s'écoule, Madame, les bonheurs se présent en foulet Ne vous travaille prus lecmiprits hi les sens, Le Comte est à l'Infante et l'hymen vous apelle, Pour lier vos deux cœurs d'une chaînfe éternelle:
L'INFANIE 2 Que j'aime ta franchiſe en cette liberté.	L'INFANIE 2 Que j'aime ta franchise en cette liberté.
LE PAGE Vous verrez les effets de rette verité, Madame, il n’eſt plus tems de railler ni de feindre.	LE PAGE Vous verrez les effets de rette vérité, Madame, il n'est plus temps de railler ni de feindre.
LINFANTE Hẽ quoy!	LINFANTE Hien quoi!
ma volonté ſe peur elle contraindre?	ma volonté se peur elle contraindre?
LE PAGE Non, mais ie ſçay qu’Amour étant votre vainqueur,	LE PAGE Non, mais ainsi sais qu'Amour étant votre vainqueur,
L’INFANJE Tu me veur faire eſclave en ma pleine franchiſe.	L'INFANJE -Tu me veut faire esclave en ma pleine franchise.
LE PAGE Quand le mal de IEtat ſe trouve dans la criſe, Et que votre refus le peut rendre irrité, Ie fais de votre amour une neceſſité, Et qu’étant engagée au Punce par promeſſe, Vous devez triompher du Comte qui vous bleſſe, Et le baume d’amour agiſſant ſaus éclat quernra vontetur auſſi-bien que l'Etat, Votre ame emportera tout ce qu'elle deſire, Be vous ferde du Gomte un appay de Iampirts	LE PAGE Quand le mal de JÉtat se trouve dans la crise, Et que votre refus le peut rendre irrité, Je fais de votre amour une nécessité, Et qu'étant engagée au Punce par promesse, Vous devez triompher du Comte qui vous blesse, Et le baume d'amour agissant saus éclat quernra vontetur aussi-bien que l'État, Votre âme emportera tout ce qu'elle désire, Be vous ferde du Gomte un appai de Jampirts
L'INFANTE Page, qui du Conſeil t'en a ſi-bien inſtruit?	L'INFANTE Page, qui du Conseil t'en a si-bien instruit?
LE PAAGE Tout le monde le ſçait, tour le monde en fait bruit?	LE PAGE Tout le monde le sait, tour le monde en fait bruit?
Le Prince & les Seigneurs ont déja vû le Comte, Qui mélant dans ſa gloire un petit trait de honte, ceur rendoit les honfeurs par mne complimens, Et exprimoit ſa joye avec ſes mouvemens, Er ſi vous tetardez de les aller attendre, e prévoy leur deſſein, ils vous viendront ſurprendre.	Le Prince et les Seigneurs ont déjà vu le Comte, Qui mêlant dans sa gloire un petit trait de honte, ceur rendait les honfeurs par mont complimens, Et exprimait sa joie avec ses mouvements, Er si vous tetardez de les aller attendre, prévoi leur dessein, ils vous viendront surprendre.
L'INFANTE Allons, j’ay reconnu parlant de ſon retour;	L'INFANTE Allons, j'ai reconnu parlant de son retour;
Que ſon cœur étoit pris dans les chaines d’amour, Et quoy que dans le mien ſon merite le place, Ie veux paroitre enſemble & de feu & de glace.	Que son cœur était pris dans les chaines d'amour, Et quoi que dans le mien son mérite le place, Je veux paraître ensemble et de feu et de glace.
LEONOR à l'écart, Quel dédaigneux diſcours qu'elle vueille chercher, La toux le feu, lamour ne ſe peuvent cacher:	LEONOR à l'écart, Quel dédaigneux discours qu'elle veuille chercher, La toux le feu, lamour ne se peuvent cacher:
Et pour voir les effets de ces douces nouvelles, Le tems ſemble boiteux, quoy quil porte des ailles?	Et pour voir les effets de ces douces nouvelles, Le temps semble boiteux, quoi quil porte des ailles?
Les heures, les inſtans, les jours & les momens Sont des ſiecles entiers aux defirs des Amans.	Les heures, les instants, les jours et les moments Sont des siècles entiers aux désirs des Amants.
SCENE IV.	SCÈNE IV.
D.	D.
FERNAND, LE PRINCE, LE COMTE,	FERNAND, LE PRINCE, LE COMTE,
TEANDRE, D.	TEANDRE, D.
FERNAND Omte, do-t les Ayeux ont porié les Couronnes QQue te puis.	FERNAND Omte, do-t les Aïeux ont porié les Couronnes QQue te puis.
je donner pour cé que tu me donne?	je donner pour cé que tu me donne?
Vn Royaume eſt un point qu’on ne peut diviſer, Qui partage ſon Scepire;	Un Royaume est un point qu'on ne peut diviser, Qui partage son Scepire;
il le fait mépriſer:	il le fait mépriser:
Te faire Géneral d’une puiſſante Armée, Cet honneur pour un autre, eſt pour toy de fumée:	Te faire Général d'une puissante Armée, Cet honneur pour un autre, est pour toi de fumée:
Ie n’ay rien d'aſſez haut avec tous mes Etats.	Je n'ai rien d'assez haut avec tous mes États.
Qui pour un prix d'honneur ne me ſemble trop bas?	Qui pour un prix d'honneur ne me semble trop bas?
La Caſtille aujourd huy qui tes haurs faits admire, Et doit à ta valeur la paix de ſon Empire, Pour ne paroitre ingrate à tes faits glorieux, T ouvre avecque ſon cœur ſes trefors préciéux?	La Castille aujourd' hui qui tes haurs faits admire, Et doit à ta valeur la paix de son Empire, Pour ne paraître ingrate à tes faits glorieux, T ouvre avec son cœur ses trésors préciéux?
ne unn que lefrer reponue l ſon attente, Pour prix de tes beaux faits te donne ſon infante, Remarque ta fortune, & le Prince & la Cour Font du Vainqueur da More un priſonnier d’Amour	ne unn que lefrer réponue l son attente, Pour prix de tes beaux faits te donne son infante, Remarque ta fortune, et le Prince et la Cour Font du Vainqueur da More un prisonnier d'Amour
LE COMTE Grand Heros, quel deſtin m’auroit pû faire eroire Que ſi peu de valeur m’eut donnè tant de gloire.	LE COMTE Grand Héros, quel destin m'aurait pu faire eroire Que si peu de valeur m'eut donné tant de gloire.
Avoir pour prix dhonneur la Fille d un grand Roy La gloire eſt exceſive & trop grande pour moy.	Avoir pour prix dhonneur la Fille d un grand Roi La gloire est excesive et trop grande pour moi.
Quand j’aurois délivié la Caſtille oppreſſée, Ma victoire ſeroit par trop recompenſée;	Quand j'aurais délivié la Castille oppressée, Ma victoire serait par trop récompensée;
Pour meriter l'honneur d’adorer ſes cheveux, Il faudroit étre aſſis dans le trône des Dieux.	Pour mériter l'honneur d'adorer ses cheveux, Il faudrait être assis dans le trône des Dieux.
Mais c'eſt à vous, grand Mars, que la gloire renor D élever dans le Ciel la fortune d'un homme.	Mais c'est à vous, grand Mars, que la gloire renor D élever dans le Ciel la fortune d'un homme.
Mon eœur & la raiſon ont trop d’affinité Paur oſer attenter à certe vanité;	Mon eœur et la raison ont trop d'affinité Paur oser attenter à certe vanité;
Mais la loy d un Monarque eſt ſi juſte & ſi grand Que l'honneur nos oblige alors qu’il nous comma I'accepte ces faveurs avec des ſentimens Qui me ferout des loix de vos commandemens?	Mais la loi d un Monarque est si juste et si grand Que l'honneur nos oblige alors qu'il nous comma J'accepte cette faveurs avec des sentiments Qui me ferout des lois de vos commandements?
Mon cœur de vos deſirs le fidele complice Fera ſa paſſion du vœn de mon ſervice.	Mon cœur de vos désirs le fidèle complice Fera sa passion du vœn de mon service.
Et ie jure, ô graud Prince embraſſant vos genoux, Que ie vivray pour elle, & ie moutay pour vous,	Et beau jure, ô graud Prince embrassant vos genoux, Que me vivrai pour elle, et Seigneur moutai pour vous,
D.	D.
FERNAND Comte, de quelques lauriers qu’on te ceigne la téte, e croy que ta valeur n'en eſt pas ſaris faiteMonte ſur un triomphe au faiſte du bouheur, I te falloit un prix égal à ton honneur;	FERNAND Comte, de quelques lauriers qu'on te ceigne la tête, e ois que ta valeur n'en est pas saris faiteMonte sur un triomphe au faîte du bouheur, I te fallait un prix égal à ton honneur;
a fameuſe victoire eſt un certain préſage (mege;	a fameuse victoire est un certain présage (mège;
Que ce qui nous choequoit nous vienara rendre honii qu’un jour triomphant dans ce bas Vnivers, u mettras ſous nos loix mille peuples divers.	Que ce qui nous choèquait nous vienara rendre honi qu'un jour triomphant dans ce bas Vénivers, u mettras sous nos lois mille peuples divers.
LE COM'E rand Roy, vous verrez toſt la fin de ces alarmes;	LE COM'E rand Roi, vous verrez tôt la fin de ces alarmes;
ſçay des coups mortels au defaut de leurs armes, t vos ſages conſeils m’en ont ſi bien inſtruit.	sais des coups mortels au défaut de leurs armes, t vos sages conseils m'en ont si bien instruit.
ue ie eroy que le More eſt à demy détruit.	Ne ton erai que le More est à demi détruit.
D FERNAND y valoir ton épée, & que le ſort ordonne, le le Perſe à tes Pieds aporte ſa Couroune;	 FERNAND y valoir ton épée, et que le sort ordonne, le le Perse à tes Pieds aporte sa Couroune;
que lorgüeil du More aux combats abatu nde hommage à ta gloire admirant ta vertu;	que lorgueil du More aux combats abattu nde hommage à ta gloire admirant ta vertu;
que nos ennemis aux fureurs de res armes gent ouns uitortent d de rang & de larmes, ils vivent ſous tes loix, & les ayant défaits, no aonorent la guerre, & demandent la paix, aduiſant mon Armée, oſe tout entreprendre, que tout obeïſſe, ou penſe à ſe défendre.	que nos ennemis aux fureurs de rés armes gent ouns uitortent dès de rang et de larmes, ils vivent sous tes lois, et les ayant défaits, nô aonorent la guerre, et demandent la paix, avisant mon Armée, ose tout entreprendre, que tout obéisse, ou pense à se défendre.
LE COME r ſang vous parlera de leur temerité.	LE COME r sang vous parlera de leur témérité.
D.	D.
FERNAND ray part à l'honneur, ton triomphe eſt ma gloire, palme eſt attachée avecque ta victoire.	FERNAND rai part à l'honneur, ton triomphe est ma gloire, palme est attachée avec ta victoire.
SCENE V.	SCÈNE V.
LE PRINCE, L’INFANTE, LE COMTE, TEANDRE, LI EARCHE, DAMIAS, LE PAGE DV COMTE, D.	LE PRINCE, L'INFANTE, LE COMTE, TEANDRE, LI EARCHE, DAMIAS, LE PAGE DU COMTE, D.
SANCHE,	SANCHÉ,
LEONOR, LE PRINCE.	LEONOR, LE PRINCE.
Aiſſons-là les combats, & les palmes de Mars Et parlons de l'amour & non pas des hazards.	Aissons-là les combats, et les palmes de Mars Et parlons de l'amour et non pas des hasards.
I'ay déja préſenti leſprit de la Princeſſe;	J'ai déjà présenti lesprit de la Princesse;
Son cœut dans le devoir a mont tammrorene;	Son cœut dans le devoir a mont tammrorène;
C’eſt une table à peindre & marquer vos deſirs, Vos ſeules volontes ſeront ſes ſeuls plaiſirs.	C'est une table à peindre et marquer vos désirs, Vos seules volontés seront ses seuls plaisirs.
D.	D.
FERNAND Ie lis dans ſes deux yeux la paſſion d’une ame Qui ſe fait un triomphe & de gloire & de flame, Piinceſſe, ſans contraindre ou forcer votre humeur, Ouvrez nous tout enſemble & la bouche & le cœur, Lrvoyvool Taisrae, e vore ame contente, De ſçavoir que le Comte eſt promis à l’Infante?	FERNAND Je lis dans ses deux yeux la passion d'une âme Qui se fait un triomphe et de gloire et de flamme, Piincesse, sans contraindre ou forcer votre humeur, Ouvrez nous tout ensemble et la bouche et le cœur, Lrvoyovo Traînée, é vore âme contente, De savoir que le Comte est promis à l'Infante?
Et que pour triompher de ce cœur glorieux, Amour ſe ſoit ſervi du charme de vos yeux?	Et que pour triompher de ce cœur glorieux, Amour se soit servi du charme de vos yeux?
L’INFANTE Grand Prince, à qui ie doy l’honneur & la naiſſance, le tire vanité de mon obeïſſance:	L'INFANTE Grand Prince, à qui belle dois l'honneur et la naissance, le tire vanité de mon obéissance:
Puiſque vos volontés m’impoſent cette loy, e nay hente n'ener que les delis du Roy :	Puisque vos volontés m'imposent cette loi, est né hente n'ener que les délis du Roi :
Mon cœur ſuivra toûjours ce que le ſien deſire, le fais mes interéts de ceux de ſon Empire.	Mon cœur suivra toujours ce que le sien désire, le fais mes intérêts de ceux de son Empire.
Iaime ce qu’il agrée, & mon plus doux objet Eſt de faire mes vœux de tout ce qui lui plaiſt.	Jaime ce qu'il agrée, et mon plus doux objet Est de faire mes vœux de tout ce qui lui plaît.
D.	D.
FERNAND Admirable douceur d'une Fille bien née, Qui du vouloir du Pere a fait ſa deſtinée!	FERNAND Admirable douceur d'une Fille bien née, Qui du vouloir du Père a fait sa destinée!
Qui pourroit reſiſter à ce doux compliment?	Qui pourrait résister à ce doux compliment?
Tu me ravis le cœur avec le ſentiment.	Tu me ravis le cœur avec le sentiment.
conite;	conite;
prenu ne ma main ce triomphe de gloire;	prenu ne ma main ce triomphe de gloire;
D FERNAND lui donne lInfante.	 FERNAND lui donne lInfante.
Ajoûte la Princeſſe au prix de ta victoire;	Ajoute la Princesse au prix de ta victoire;
Et vois comme ton Prince au cours de ton bonheur, Eleve ta fortune & te, comble d’honneur, Et l’Hymen & l'Amour préparent vos delices, Et comme les Aureurs en ſeront les complices:	Et vois comme ton Prince au cours de ton bonheur, Élève ta fortune et te, comble d'honneur, Et l'Hymen et l'Amour préparent vos délices, Et comme les Aureurs en seront les complices:
C’eſt un decret du Ciel qu’on ne peut éviter, Et tes exploits d’honneur te la font meriter.	C'est un décret du Ciel qu'on ne peut éviter, Et tes exploits d'honneur te la font mériter.
LE COMTE Agréez donc, grand Roy que j’adore ma Reyne, Qui commeuce ma gloire & termine ma peine, Et qu’ajoûtant mes ſeus, mon ame, & ma raiſon, I enchaine mes deſirs daus ſa douce priſon, Le Ciel hrûlant nos cœurs d une flame commune, Veut rendre mon amour égal à ma fortune.	LE COMTE Agréez donc, grand Roi que j'adore ma Reine, Qui commeuce ma gloire et termine ma peine, Et qu'ajoutant mes zeus, mon âme, et ma raison, I enchaine mes désirs daus sa douce prison, Le Ciel hrûlant nos cœurs d ' âme commune, Veut rendre mon amour égal à ma fortune.
12 n’appartient auſſi qu’aux douceurs de ſes yeux, De faire d'un Amant un compagnon des Dieux, Puiſque mille vertus & l’hooneur de Princeſſe, De riile de Monarque en toue dne Getne.	12 n'appartient aussi qu'aux douceurs de ses yeux, De faire d'un Amant un compagnon des Dieux, Puisque mille vertus et l'honneur de Princesse, De riile de Monarque en toue gne Getne.
LEONOR Comme vos beaux exploits vont dans l'infinité, Il falloit que leur prix fut une Deï é.	LEONOR Comme vos beaux exploits vont dans l'infinité, Il fallait que leur prix fut une Deï é.
LE COMTE à l Infante.	LE COMTE à l Infante.
Adorable Beauté dont la gloire & les flames Font triompher lamout & des cœurs & des ames, Quel d'entre les Mortels eút voulu préſomer, Darteindre a ton merite, & de t’oſer aimer, Si moy-méme ayant eu les deux Princes propices, Suis honteux de t’offrir mes vœux & mes ſervices?	Adorable Beauté dont la gloire et les flammes Font triompher lamout et des cœurs et des âmes, Quel d'entre les Mortels eût voulu présomer, Darteindre à ton mérite, et de t'oser aimer, Si moi-même ayant eu les deux Princes propices, Suis honteux de toffrir mes vœux et mes services?
ogocuant tire an peché qu’on ne peut ignorer;	ogocuant tire an péché qu'on ne peut ignorer;
De te vouloir aimer au lieu de t’adorer:	De te vouloir aimer au lieu de t'adorer:
Mais mon ame d’amour & de flame atteinte, N’ayant jamais conçû le rebut ni la crainte:	Mais mon âme d'amour et de flamme atteinte, N'ayant jamais conçu le rebut ni la crainte:
Te vient off ir mon cœur adorant tes beaux yeux, Comme ſes beaux Soleils, & ſes Rois & ſes Dieux:	Te vient off ir mon cœur adorant tes beaux yeux, Comme ses beaux Soleils, et ses Rois et ses Dieux:
Reçoy, ma chere Reyne, une offrande ſacrée, Puiſque le Ciel le veut, & le Prince lagrée, Cependant qu'Hymenée en s'aprochant de nous, De ce fidele Amant te va faire un Epoux,	Reçois, ma chère Reine, une offrande sacrée, Puisque le Ciel le veut, et le Prince lagrée, Cependant qu'Hyménée en s'approchant de nous, De ce fidèle Amant te va faire un Époux,
L'INFANTE L’offrande a tant d’honneur, le Comte tant de gloire, Qu'on trouve en ſa conquéte une double victoire, Et le Ciel donne au Prince un tel pouvoir ſur moy Que de ſa volonté ie m’en fais une loy :	L'INFANTE L'offrande a tant d'honneur, le Compte tant de gloire, Qu'on trouve en sa conquête une double victoire, Et le Ciel donne au Prince un tel pouvoir sur moi Que de sa volonté un m'en fais une loi :
Quand ie poſſederois une double couronne, Mon cœur eſt à celui que mon Pere me donne.	Quand ici posséderais une double couronne, Mon cœur est à celui que mon Père me donne.
LE PRINCE Nouveau Mars, qui remplis le monde de ton nom!	LE PRINCE Nouveau Mars, qui remplis le monde de ton nom!
Crois que tous nos trelors ne vaſent pas ce don, Qe l’honneur de l’Infante égale un Diadéme, Et qu’avecque ma Sœur ie me donne moy-méme.	Crois que tous nos trelors ne vasent pas ce don, Qe l'honneur de l'Infante égale un Diadème, Et qu'avec ma Sœur ie me donne moi-même.
LE COMTE Prince, ie ſuis à vous, & mon ame & mon cœur Adorent enſemble & le Frere & la Sœur.	LE COMTE Prince, je suis à vous, et mon âme et mon cœur Adorent ensemble et le Frère et la Sœur.
THEANDRE Comte depuis le jour qu’une gloire commune Oblige mom épée à ſuivre ta fortune, I'ay toujours reconnu qu’en excés de bonheur Couronneroit tes faits d’un triomphe dhonneur.	THÉANDRE Comte depuis le jour qu'une gloire commune Oblige autre épée à suivre ta fortune, J'ai toujours reconnu qu'en excès de bonheur Couronnerait tes faits d'un triomphe dhonneur.
La Princeſſe pour prix que ce grand Roy te donne, Te porte cette palme avec cette Couronne;	La Princesse pour prix que ce grand Roi te donne, Te porte cette palme avec cette Couronne;
Le preſent qu’il te fait eſt auſſi précieux, Que ta victoire eſt grande & tes faits glorieux?	Le présent qu'il te fait est aussi précieux, Que ta victoire est grande et tes faits glorieux?
Acheve ces exploits, rend ces orages calmes, Prend ces Princes liguez ponr diſputer tes palmes;	Acheve ces exploits, rend ces orages calmes, Prend ces Princes ligués ponr disputer tes palmes;
Que le More & le Perſe & l’Atragou ſoûmis, Portent le nom d’eſclaves, & non pas d’ennemis:	Que le More et le Perse et l'Atragou mis, Portent le nom d'esclaves, et non pas d'ennemis:
Dom Sanche, & Atias, Alonſe & ton Teapdre Se perdront pour te voir au trône d'Alexandre:	Dom Sanche, et Atias, Alonse et ton Teapdre Se perdront pour te voir au trône d'Alexandre:
Et quoy que tes hazards nous en veuillent conter, Ta fortune eſt au point de i’y faire monter.	Et quoi que tes hasards nous en veuillent conter, Ta fortune est au point de j'y faire monter.
D.	D.
SANCHE Cẽs exploits de valeur ſur la terre & ſur londe;	SANCHE Ciens exploits de valeur sur la terre et sur londe;
Promettent à ce cœur la conquête du monde.	Promettent à ce cœur la conquête du monde.
D.	D.
ARIAS Et le l'aurapjamdis de ple eners mouvemens, Que de ſuivre ſes loix & ſes commandemens.	ARIAS Et le l'aurapjamdis de ple ers mouvements, Que de suivre ses lois et ses commandements.
D.	D.
ALONSE Tant de beaux ſentimens que l'honneur vous inſpire, Regardent la grandeur & le bien de l'Empire.	ALONSE Tant de beaux sentiments que l'honneur vous inspire, Regardent la grandeur et le bien de l'Empire.
Ie ſuis de la partie & conçoy dans mon ſein Vn genereux deſir d’accomplir ce deſſein, Il me tarde déja d’oüir la renommée Publier la terreur uu brolt de tonihidiee.	Je suis de la partie et conçois dans mon sein Un généreux désir d'accomplir ce dessein, Il me tarde déjà d'oüir la renommée Publier la terreur u brolt de tonihidie.
Et de le voir ſi grand qu’il faſſe à tous la loy, Et n ait rien deſſus lui que le Prince & le Roy.	Et de le voir si grand qu'il fasse à tous la loi, Et n' ait rien dessus lui que le Prince et le Roi.
LE COMTE Genereux Cavaliers, une méme victoireNous fera partager le triomphe & la gloire.	LE COMTE Généreux Cavaliers, une même victoireNous fera partager le triomphe et la gloire.
Et expoſant vos cœurs pour moy dans le danger, Vous ferez un ingrat pour me trop obliger.	Et exposant vos cœurs pour moi dans le danger, Vous ferez un ingrat pour me trop obliger.
D.	D.
FERNAND Que cet deſſeins ſont beaux!	FERNAND Que cet desseins sont beaux!
ie ne voy point d’obſtacles Qui puiſſent empécher l'effet de ces miracles.	Ce ne vois point d'obstacles Qui puissent empêcher l'effet de ces miracles.
Il ne faut qu’entreprendre invinſibles Guerriers, C vous voy revenir tous couverts de lauriers:	Il ne faut qu'entreprendre invinsibles Guerriers, Ç ne faut revenir tous couverts de lauriers:
Mais pendant que le Ciel pour des palmes exquiſes, Suggere à vos eſprits ces belles entrepriſes, Allons ſolemniſer avec toute la Gour, Dans le Temple d’Hymen ce triomphe d’Amour,	Mais pendant que le Ciel pour des palmes exquises, Suggère à vos esprits ces belles entreprises, Allons solenniser avec toute la Gour, Dans le Temple d'Hymen ce triomphe d'Amour,
D.	D.
SANCHE Cẽs exploits de valeur ſur la terre & ſur londe;	SANCHE Ciens exploits de valeur sur la terre et sur londe;
Promettent à ce cœur la conquête du monde.	Promettent à ce cœur la conquête du monde.
D.	D.
ARIAS Et le l'aurapjamdis de ple eners mouvemens, Que de ſuivre ſes loix & ſes commandemens.	ARIAS Et le l'aurapjamdis de ple ers mouvements, Que de suivre ses lois et ses commandements.
D.	D.
ALONSE Tant de beaux ſentimens que l'honneur vous inſpire, Regardent la grandeur & le bien de l'Empire.	ALONSE Tant de beaux sentiments que l'honneur vous inspire, Regardent la grandeur et le bien de l'Empire.
Ie ſuis de la partie & conçoy dans mon ſein Vn genereux deſir d’accomplir ce deſſein, Il me tarde déja d’oüir la renommée Publier la terreur uu brolt de tonihidiee.	Je suis de la partie et conçois dans mon sein Un généreux désir d'accomplir ce dessein, Il me tarde déjà d'oüir la renommée Publier la terreur u brolt de tonihidie.
Et de le voir ſi grand qu’il faſſe à tous la loy, Et n ait rien deſſus lui que le Prince & le Roy.	Et de le voir si grand qu'il fasse à tous la loi, Et n' ait rien dessus lui que le Prince et le Roi.
LE COMTE Genereux Cavaliers, une méme victoireNous fera partager le triomphe & la gloire.	LE COMTE Généreux Cavaliers, une même victoireNous fera partager le triomphe et la gloire.
Et expoſant vos cœurs pour moy dans le danger, Vous ferez un ingrat pour me trop obliger.	Et exposant vos cœurs pour moi dans le danger, Vous ferez un ingrat pour me trop obliger.
D.	D.
FERNAND Que cet deſſeins ſont beaux!	FERNAND Que cet desseins sont beaux!
ie ne voy point d’obſtacles Qui puiſſent empécher l'effet de ces miracles.	Ce ne vois point d'obstacles Qui puissent empêcher l'effet de ces miracles.
Il ne faut qu’entreprendre invinſibles Guerriers, C vous voy revenir tous couverts de lauriers:	Il ne faut qu'entreprendre invinsibles Guerriers, Ç ne faut revenir tous couverts de lauriers:
Mais pendant que le Ciel pour des palmes exquiſes, Suggere à vos eſprits ces belles entrepriſes, Allons ſolemniſer avec toute la Gour, Dans le Temple d’Hymen ce triomphe d’Amour,	Mais pendant que le Ciel pour des palmes exquises, Suggère à vos esprits ces belles entreprises, Allons solenniser avec toute la Gour, Dans le Temple d'Hymen ce triomphe d'Amour,
1	1
