A MONSIEVR, MONSIEVR LE COMTE BELIN 13 BARON DE MILLY, Seigneur du Bourg Dauerton, De Lorgerie.	À MONSIEUR, MONSIEUR LE COMTE BELIN 13 BARON DE MILLY, Seigneur du Bourg Daverton, De Lorgerie.
Dautré, &c.	Dautré, etc.
NSIEVR	NSIEUR
I’ay beau rechercher les moyens de vous payer en quelque ſorte ce que ie vous doy:	J'ai beau rechercher les moyens de vous payer en quelque sorte ce que je vous dois:
le trouue apres tout, que les obliga tions que ie vous ay, ſont des debtes dont il faut que ie demeure inſoluable;	le trouve après tout, que les obliga tions que je vous ai, sont des débtes dont il faut que ie demeure insolvable;
Les courtoiſies que ie reçoy chez vous ſe donnent trop prodiguement pour laiſſer aucune eſperance de les meriter:	Les courtoisies que personne reçois chez vous se donnent trop prodiguement pour laisser aucune espérance de les mériter:
Mais puis qu’il faut que ie ſois vaincu, au moins i’ay la gloire de l’eſtre par de belles armes.	Mais puis qu'il faut que ici sois vaincu, au moins j'ai la gloire de l'être par de belles armes.
On ſe peut laiſſer vaincre aux bien faits ſans ingratitude;	On se peut laisser vaincre aux bien faits sans ingratitude;
Ftil y ade la difference, entre ne pas rendre, & eſtre mécognoiſſant;	Ftil y ade la différence, entre ne pas rendre, et être méconnaissant;
Ie ne faits pas l’vn, & ne ſuys pas l’autre:	Je ne faits pas l'vn, et ne suis pas l'autre:
Ie recognoy les bontez que vous auez pour moy, de toutes les forces de mon ame, & pour les effets, ie m’aſſeure que le peu de proportion qu’il y a de ma fortune à la voſtre, vous obligera touſiours à m’en tenir quitte:	Je reconnais les bontés que vous avez pour moi, de toutes les forces de mon âme, et pour les effets, toute m'assure que le peu de proportion qu'il y a de ma fortune à la vôtre, vous obligera toujours à m'en tenir quitte:
Comme cette meſme diſproportion m’empeſchera touſiours de rougir en la cõtinuation de vos faueurs;	Comme cette même disproportion m'empêchera toujours de rougir en la continuation de vos faveurs;
l’entre encor auiourd’huy chez vous, MONSIEVR, pour vous en demãder vne.	l'entre encor aujourd'hui chez vous, MONSIEUR, pour vous en demander une.
C’eſt de ſouffrir, que ces – 1 deux lumeaux que i’ay habillez à la Françoiſe, ſeront monſtrez ſous voſtre protection:	C'est de souffrir, que ces § 1 deux lumeaux que j'ai habillez à la Française, seront montrez sous votre protection:
Ie les ay flattez de cette eſperance, par la cognoiſſance que i’ay de l’honneur que vous leur faites de les aymer, & par la qualité que ie porteray toute ma vie, de	Je les ai flattez de cette espérance, par la connaissance que j'ai de l'honneur que vous leur faites de les aimer, et par la qualité que je porterai toute ma vie, de
MONSIEVR, Voſtre tres-humble, tres- obeyſſant, & trea-obligé ſeruiteur ROrROY.	MONSIEUR, Votre très-humble, très- obéissant, et tre-obligé serviteur ROrOrOY.
DArgrace & Priuilege du Roy, donné Y à Paris le trentielme iour d’Auril.	DArgrace et Privilège du Roi, donné Y à Paris le trentiel jour d'Oril.
mil ſix cẽt trente-ſix, Signé, Par le Roy en ſon Conſeil, CHAPPIILAIN, il eſt permis à ANTOINE DE SOMMAVILLE, Marchand Libeaire à Pars d’imprimer ou faire imprimer, vendre & diſtribuer vne piece de Theatre inticulée, Les Menechmes.	mil six cẽt trente-six, Signé, Par le Roi en son Conseil, CHAPILAIN, il est permis à ANTOINE DE SOMAUILLE, Marchand Libeaire à Pars d'imprimer ou faire imprimer, vendre et distribuer une pièce de Théâtre inticulée, Les Ménèchmes.
Comedie.	Comédie.
de Monſieur de Rotrou:	de Monsieur de Rotrou:
& ce durant le temps de ſeptans, à compter du iour que ladite Piece ſera acheuée d’imprimer, & defenſes ſont faites à tous Imprimeurs & ciorines, ce autres de quelque condition qu’ils ſoient, d’en imprimer, vendre ou diſtribuer d’autre impreſſion que de celle qu’aurafait ou fait faire ledit De SOMMAVILLE ouſes ayans cauſe, ſur peine aux contreuenans de trois mil liures d’amẽde, e de tous ſes depens, dommage & intereſts;	et ce durant le temps de septants, à compter du jour que ladite Pièce sera achevée d'imprimer, et défenses sont faites à tous Imprimeurs et ciorines, ce autres de quelque condition qu'ils soient, d'en imprimer, vendre ou distribuer d'autre impression que de celle qu'aurafait ou fait faire ledit De SOMAUILLE ouses ayant cause, sur peine aux contrevenants de trois mil livres d'amends, eu de tous ses dépens, dommage et intérêts;
ainſi qu’il eſt plus amplement porté par leſdites Lettres, qui ſont en vertu du preſent extraict tenuës pour deüement ſignifiées.	ainsi qu'il est plus amplement porté par lesdites Lettres, qui sont en vertu du présent extrait tenues pour deuement signifiées.
Acheué d'imprimer leis May1616.	Achevé d'imprimer leis May1616.
Les Exemplaires ont eſté fournis	Les Exemplaires ont été fournis
Tledit De SOMMAVTILE, a aſſocié aues Lluy audit Priuilege TOVSSAINCT QVINET, auſſi Marchand Libraire, ſuiuant l’accord faitentre-eux.	Tudit De SOMAUTILE, a associé êtes Llui audit Privilège TOUSAINCT QUINET, aussi Marchand Libraire, suivant l'accord faitentre-eux.
LES ACTEVRS.	LES ACTEURS.
ERGASTE, Paraſite.	ERGASTE, Parasite.
EROTIE.	EROTIE.
Vefue, courtiſée de Menechme rauy	Veve, courtisée de Menechme ravi
MENECHME Soſicle, Frere de Menechme rauy.	MENCHME Sosicle, Frère de Menechme ravi.
MESSENIE.	MESSENIE.
Valet de Mencchme Soſicle.	Valet de Mencme Sosicle.
CICLINDRE, Valet de Cabaret!	CICLINDRE, Valet de Cabaret!
ORAZIE, Femme de Menechme rauy!	ORAZIE, Femme de Menechme ravi!
VIEILLARD.	VIEILLARD.
Pere d’Orazie.	Père d'Orasie.
LE MEDECIN.	LE MÉDECIN.
LES VALETS.	LES VALETS.
LES MENECHMES.	LES MENECHMES.
COMEDIE.	COMÉDIE.
ACTE I SCENE PREMIERE,	ACTE I CÈNE PREMIÈRE,
ERGASTE.	ÉRGASTE.
E plaigne qu'voudra, ma pauureté me plaiſt, Iela voy d’vn bon œil toute affreuſe qu’elle eſt, Elle entretient chez, moy les plaiſirs de la vie, Le ſoucy des threſors touche peu mon enuiez Auoir des coffrespleint, ces lieniſont ſaperſius, Le coſſre natureil'eſtant, que fautil pius?	E plaigne qu'voudra, ma pauvreté me plaît, Jela vois d'un bon œil toute affreuse qu'elle est, Elle entretient chez, moi les plaisirs de la vie, Le souci des trésors touche peu mon enviés Avoir des coffrespleint, ces lienisont sapersius, Le côsre natureil'étant, que faut pius?
Ie ne voy qu’à deſdain ces excremens de terre, Ie ſouſmets toute choſe à la beauté d'va verre, Où Bacchus me paroiſt ſous un teint plus riant, Que celuy du Soleil n'eſt deſſus l’Orient Lei chaiſnes tiennent mal vn capri enſeruage, On a peu de raiſon d’en conſeruer l’vſage.	Je ne vois qu'à dédain ces excréments de terre, Je sousmets toute chose à la beauté d'une verre, Où Bacchus me paraît sous un teint plus riant, Que celui du Soleil n'est dessus l'Orient Le chaînes tiennent mal un capri enservage, On a pu de raison d'en conserver l'usage.
Ce mal heur qu’on adjouſte à ſes aſflictions, Aiguiſe ſon eſprit dans ſes inuentions.	Ce mal heur qu'on ajoute à ses asflictions, Aiguise son esprit dans ses inventions.
La rigueur le rendpire, & plus on le tourmenPlus le deſir qu’il a de s'eſchapper augmente.	La rigueur le rendpire, et plus on le tourmenPlus le désir qu'il a de s'échapper augmente.
Il ſe traiſne à la porte, il lime les verroux, Et cherche le moyen d’en arracher les cloux:	Il se traîne à la porte, il lime les verroux, Et cherche le moyen d'en arracher les cloux:
Les gardes le matin ne treuuent que la place:	Les gardes le matin ne trouvent que la place:
Ainſi le trop grand ſoin de l’arreſter le chaſſe.	Ainsi le trop grand soin de l'arrêter le chasse.
Il faut d’autres lienspour retenir ſespas, Et ie n’en ſçache point comme les bous vepas.	Il faut d'autres lienspour retenir sespas, Et ici n'en sache point comme les bous vepas.
Il n’imagine point la liberté ſi chere, Qu'on nel arreſte bien auec la bonne chere.	Il n'imagine point la liberté si chère, Qu'on nel arrête bien avec la bonne chère.
Fuſt il cent fois coulpable & digne de la mort, Il ne peut s’eſchapper en vnlien ſi fort.	Fût -il cent fois coulpable et digne de la mort, Il ne peut s'échapper en vnlien si fort.
Les feſtins ont ſur nous vne puiſſante amorce, Plus tette chaiſne eſt douce, & plus elle a de force:	Les festins ont sur nous une puissante amorce, Plus tette chaîne est douce, et plus elle a de force:
Vn ſeruage pareil eſt mon vnique bien, I'ayme d’eſtre captiſ en vn ſi doux lien.	Un servage pareil est mon unique bien, J'aime d'être captis en un si doux lien.
Ie porte ma franchiſe auec beaucoup de peine, Et ie meurs ſi Menechme auiourd’huy ne m'enchaiſne.	Je porte ma franchise avec beaucoup de peine, Et ie meurs si Menechme aujourd'hui ne m'enchaîne.
Le Nectar, & les mets les plus delicieux, Quipaiſſent tontenter noſtre gouſt & nosyeux, Et chaſſer des eſpries toute melanchelie, Sont les aymablesnœuds dont ce geollier me lie.	Le Nectar, et les mets les plus délicieux, Quipaissent tontenter notre goût et nosoyeux, Et chasser des épries toute mélancelie, Sont les aimablesnœuds dont ce géollier me lie.
O combien cette vie eſt contraire au ſoucy!	Ô combien cette vie est contraire au souci!
Que nous boirons long temps ſi ie le treuue i'y Mais ie le voy qui ſort.	Que nous boirons long temps si ici le trouve j'y Mais tu le vois qui sort.
SCENE II.	SCÈNE II.
MENECHME rauy.	MENCHME ravi.
ERGASTE MENECHME rauy, regardant dans ſa porte demye ouuerte.	ERGASTE MENECHME ravi, regardant dans sa porte demie ouverte.
I Ndoπραlle, mſoſ́, Ne t'incere iamais d'expliquer ma penſée, Si tout ce que ie hais, tu ne le veux hair, Si tu ne me veux pas autrement obeir, Si tu te plait touſiours d’exciter ma colere, Ialouſe, reſous-toy, de viure chez ton pere, Et briſonmnosliexs d’vn deſſein mutuel, Le vefuage eſt plus doux qu’vn hymen ſi cruel.	I Ndoπραlle, msoś, Ne t'incère jamais d'expliquer ma pensée, Si tout ce que enfin hais, tu ne le veux haïr, Si tu ne me veux pas autrement obéir, Si tu te plaît toujours d'exciter ma colère, Jalouse, résous-toi, de vivre chez ton père, Et brisonmnosliexs d'un dessein mutuel, Le vefuage est plus doux qu'un hymen si cruel.
Ie ne ſors par ſi toſt, que tu viens à la porte, Demander où ie vais, chez qui, ce que ie porte;	Je ne sors par si tôt, que tu viens à la porte, Demander où tu vais, chez qui, ce que jour porte;
I’eſpouſois mon tuteur, à l’inſant malheureux, Que nous fuſmes vnis ſous ce ioug rigoureux;	J'épousais mon tuteur, à l'insant malheureux, Que nous fûmes unis sous ce joug rigoureux;
Tant ieſuis obligé de te rendre de compte, Tant ma farilité ma procuré de honte.	Tant iesuis obligé de te rendre de compte, Tant ma farilité ma procuré de honte.
Mais tu fais ton deuoir, tu me dois ce tourmẽ, Carie t’entretenoittrep delicatement.	Mais tu fais ton devoir, tu me dois ce tourment, Carie t'entretenaittrep délicatement.
Ie t’aymois trop ialouſe, vne amitie ſi forte, Eſt ce qui t’au toriſe à viure de la ſorte.	Je t'aimais trop jalouse, une amitié si forte, Est ce qui t'au torise à vivre de la sorte.
Mais puiſque ma bonté n'a point d’autres efſets, Apprend en peu de mots le deſſeinque ie faits:	Mais puisque ma bonté n'a point d'autres eufsets, Apprend en peu de mots le desseinque tu faits:
C'eſt trop t’entreteuir da ts'une hameur ſi vaiine, Quand ie te ſourniray du chanvre, de lalaise, Et des habus decents à ta condition, Que ceſoit vneborne à ton ambition.	C'est trop t'entreteuir da ts'-une hameur si vaiine, Quand ie te sournirai du chanvre, de lalaise, Et des habus décents à ta condition, Que ces vrborne à ton ambition.
Ne porte plus les yeux que deſſus taſeruante, Que deſires tu plus afe d'eſtre coutente?	Ne porte plus les yeux que dessus taservante, Que désires tu plus afe d'être coutente?
Trauaille, vy paiſible & ne t'incere plus, D’eſpier mes deſſeius par det ſoini ſ perſlut	Travaille, vis paisible et ne t'incère plus, D'épier mes desseius par dét soini s perslut
La porte ſe ferme.	La porte se ferme.
Enfinelle eſtr'entrée.	Enfinelle estr'entrée.
O Dieux!	Ô Dieux!
que cette ſemmne, Eſt vn faſcheux obſtacle à ma nouuelle flâme.	que cette semne, Est un fâcheux obstacle à ma nôtre flamme.
Sous quelioug malneurenx me trouuay-je afreſté?	Sous quelioug malneurenx me trouvai-je afresté?
Pourquey ne puis ie plus donner maliberté?	Pourquei ne puis rien plus donner maliberté?
Vn obiect ſi charmant a mou ame bleſſee, Que ie n’en ſcauroisplus diuertir ma penſee, Vn de ſes entretiens, vn regard ſeu ement, Forceroitl inconſtante à l aymer conſtamment.	Un objet si charmant à mou âme blessée, Que je n'en sauraisplus divertir ma pensée, Un de ses entretiens, un regard seu sèment, Forcerait inconstante à l aimer constamment.
Quei'aur ay de by heur ſi ce preſent la touche, S’il m'obti nt ſeulement vnbaiſer de ſa bouthbe.	Quei'aur ai de by heur si ce présent la touche, S'il m'obti naît seulement unaiser de sa bouthbe.
Monſtrant vn poinçon Maialouſe auiourd huyſerre mal ſes ioyaux, Celuy cy que i'ay pris eſt du rãg des plus beaux.	Monstrant un poinçon Maialouse aujourd' uiserre mal ses joyaux, Celu cy que j'ai pris est du rang des plus beaux.
Auſſi iele tonſatre à l'objet leplęsrars, Qui deſſonde aux Amants la qualuté d’auare,	Aussi icile tonstre à l'objet leplęsrars, Qui dessonde aux Amants la qualuté d'avare,
ERGASTE.	ÉRGASTE.
Son diſcours iuſqu' icy ne me contente pas, Toute l’amour qu’il a vaut moius quux bon lapui;	Son discours jusqu' ici ne me contente pas, Toute l'amour qu'il a vaut moius quux bon lapui;
Ille fauraborder.	Ille fauraborder.
Qoy triſte & ſoluaire?	Qoi triste et soluaire?
MENECHME rauy.	MENCHME ravi.
Helas!	Hélas!
t'eſtonnes-tu d'vne humeur ordinaire, Puis ie eſtre plus joyeux au milieu du tourMlare Et mon teint n’eſt-il parla couleurd'un Amãtt	t'étonnes-tu d'une humeur ordinaire, Puisqu' une été plus joyeux au milieu du tourMlare Et mon teint n'est-il parla couleurd'un Amant
ERGASTE.	ÉRGASTE.
Ieſuis Amant auſii.	Jesuis Amant aussi.
ERGASTE.	ÉRGASTE.
Deibonnes cheres.	Déibonnes chères.
Les plus tarei beautez ne me ſont pas ſi cheres, Et ie vieus là deſſus chercher uotre ſecours, Vous m'auez fait ſouuent poſſeder mes amours.	Les plus tarei tés ne me sont pas si chères, Et grands vieus là -dessus chercher uotre secours, Vous m'auez fait souuent posséder mes amours.
MENECHME rauy.	MENCHME ravi.
Et tu nemerendipoiat cét apreuble oſtut,	Et tu nemerendipoyat cet apreuble ôtut,
ERGASTE.	ÉRGASTE.
Il n'eſt rien que i'epargne, & rien que le ne fiſſe.	Il n'est rien que j'épargne, et rien que le ne fisse.
Si ie pouuols autant ſur l'object de ves vœux, Quie vous pouuez, Monſieur, ſur celiy que ie veux.	Si personne puis autant sur l'object de vez œux, Quie vous pouvez, Monsieur, sur celi que je veux.
MENECHME rauy.	MENCHME ravi.
M ais ne voy tu iamais ceſoleil de mon ame?	M Mais ne vois tu jamais cesoleil de mon âme?
Ne luyparle-tu print de ma ouuelle flâme?	Ne luyparle-tu print de ma ouvelle flamme?
Et n’as tu point ſondé par quelle inuention Ie puis m'iuſinuer en ſon affection ?	Et n'as tu point sondé par quelle invention Je puis m'iusinuer en son affection ?
ERGASTE.	ÉRGASTE.
C'eſt l'eſprit le plus ſroid de toutes vos maiſtreſIeluy parle de vous, ie vante vorlargeſſes, Ie reproche à ſon cœur de s’eſchaufer ſi peu, Ie luy fais de voſtreame vn pourtraict tout de feu, Ie feints mille tourmeus, ie pous peints tout en larmes Ie combaisſa froideur de mes meilleures armes, Maisl ingrate ſerit des conteique i faits, Et tout autre rendron vos deſirs ſa i aits;	C'est l'esprit le plus sroid de toutes vos maîtresIelui parle de vous, toujours vante vorglargesses, Je reproche à son cœur de s'échauffer si peu, Je tu fais de votre vn pourtrait tout de feu, Je feints mille tourmus, sans pous peints tout en larmes Je combaissa froideur de mes meilleures armes, Maisl ingrate servit des conte y faits, Et tout autre rendron vos désirs sa j' aits;
Carie croy que ia mais tour vneivoyſſance, Mereure n'mploya de ſi loucs eloguence;	Carie crois que ja mais tour vneivoyssance, Mère n'mploya de si loucs éloguence;
Elle ne reſpoud rien, ou me di Rulenent, Que voſtre aſſection l'oblige iſinimeut, Que demeurant touſiours aux termes où vous leſtes, Elle eſtimera ſort l'hõneur que vous luy faites, Mais que d'autres eſpoirs vousſoroiés ſuperflus, Et que vousperdrez tout, ſi vous demandez plus.	Elle ne respoud rien, ou me di Rulennent, Que votre assection l'oblige isinimeut, Que demeurant toujours aux termes où vous lestes, Elle estimera sort l'honneur que vous lui faites, Mais que d'autres espoirs voussoroiés superflus, Et que vousperdrez tout, si vous demandez plus.
Bien des femmes pourtant s’eſtant bien deffendu s, Apres un long comb at, enſii ſe ſont renduës;	Bien des femmes pourtant s'étant bien défendu s, Apres un long comb at, ensi se sont rendues;
Et lon tient que ce ſexe en de certains momens, Ne peut rien refuſer aux vœux de ſes amans.	Et lon tient que ce sexe en de certains moments, Ne peut rien refuser aux vœux de ses amants.
Neluy reprochez point vos fidelles ſeruices, Rendez-luy chaque iour de plus humbles offices;	Nelui reprochez point vos fidèles services, Rendez-lui chaque jour de plus humbles offices;
vont denez epertr, & ſouffrir iuſqu'au bout, Puiſqu'apres tant de maux vn moment payt tout.	vont denez épertr, et souffrir jusqu'au bout, Puisqu'après tant de maux un moment paît tout.
MENECHM EJrauy.	MENECHM ERavi.
Le Cielne vid iamais vne ardeur de la ſorte, Mes biens ſont épuiſez d's dons que ie luyporte, Et ie luy vais encor offrir ce diamant, Que ma femme entre tous priſoit vniquement.	Le Cielne vit jamais une ardeur de la sorte, Mes biens sont épuisés d's dons que ie luyporte, Et de lui vais encor offrir ce diamant, Que ma femme entre tous prisait vniquement.
ERGASTE.	ÉRGASTE.
C’eſt bien là pourtoucher cette ieune merueille, C’eſt vn rare moyen pour gaigner ſon oreille.	C'est bien là pourtoucher cette jeune merveille, C'est un rare moyen pour gagner son oreille.
Les preſens auiourd huy ſont par tout adorez, L’amour ne fait plus rien qu’auit des traicts dorez, 'Et de quelque beauté que la Vertu ſe vante, L’or abienplus d'eſfect ſur l’eſprit d’une amanfe Tout cede à ſon pouuoir:	Les prés auiourd hui sont par tout adorés, L'amour ne fait plus rien qu'avit des traits dorés, 'Et de quelque beauté que la Vertu se vante, L'or abienlus d'efect sur l'esprit d'une amane Tout cède à son pouvoir:
Ce met al ſouuerain A briſe les verroux de cent portes d’airain.	Ce met al souverain À brise les verroux de cent portes d'airain.
Et le Soleiliadis pour pagner ſes maiſtreſſes, Leur monſtroit ſeulement l'or de ſes blondes Itreſles Les dons ferons pour vous bien plus que ie ne fais.	Et le Soleiliadis pour pagner ses maîtresses, Leur montrait seulement l'or de ses blondes Itresles Les dons ferons pour vous bien plus que je ne fais.
Ils ſont plus eloquens que ie ne fus iamais;	Ils sont plus éloquents que je ne fus jamais;
Et ſur ſoy cette vefue a beaucoup de pu ſſance, Si vous n’en obtenez vne entiere licence.	Et sur soi cette veuve a beaucoup de pu ssance, Si vous n'en obtenez une entière licence.
MENECHME rauy.	MENCHME ravi.
Iy dſuc auscquetey.	Ii dsuc aussi.
ERGASTE.	ÉRGASTE.
C'eſt le mot quei attendi	C'est le mot quei attendi
MENECHME rauy.	MENCHME ravi.
Ton tumpsle permet il?	Ton tumpsle permet il?
ERGASTE.	ÉRGASTE.
Ie n’ay que trop de tembs.	Je n'ai que trop de tembs.
Combien faut-il de mets, & combien de beuteilles?	Combien faut-il de mets, et combien de buteilles?
I'aypour veus obeyr dus ardeurs ſaus poreilles.	J'aipour us obéir dus ardeurs saus poreilles.
MENECHME rauy.	MENCHME ravi.
Ieſuisfort redeuable à ton aſfection, Car tu forces pour moy ton inelination.	Jésuisfort redevable à ton asfection, Car tu forces pour moi ton inelination.
Attends, ue v'y l’object qui cauſe mon martyre.	Attends, ue vy l'object qui cause mon martyre.
SCENE III.	SCÈNE III.
MENECHME puy, EROTIE.	MENCHME puy, EROTIE.
ERGASTE.	ÉRGASTE.
MENECHME rauy, continué.	MENECHME ravi, continué.
J Oui ſortez iuſtement aupoint qu’en veus deſire.	 Oui sortez justement aupoint qu'en veux désire.
Mais auee vne grace, & ds attraits ſi doux.	Mais avait grande grâce, et ds attraits si doux.
Que vous me ſorcerez à m'ſloigner de vous.	Que vous me sorcerez à m'sloigner de vous.
Si vous ne retenez lesregardi tout de ſldme, Qui m’inchantent lesyeux, & qui m’embraſent l’ame;	Si vous ne retenez lesregardi tout de slême, Qui m'inchantent lesyeux, et qui m'embrasent l'âme;
Iene puis conceuoir comment chaque momens, Vouspeuuent apporter de nouueaux ornemens.	Jène puis concevoir comment chaque moments, Vouspeuuent apporter de nouveaux ornements.
Iadis vousparoiſſiez des plus belles du monde.	Jadis vousparaissiez des plus belles du monde.
N’aguitresſans pareille, auiourd huy ſaus ſeconde.	N'aguitressants pareille, aujourd' hui saus seconde.
Mais le Ciil voit infin ſes efforts limitez, Il nepeus qu’aaiouſtes à votrares beautes;	Mais le Ciil voit infin ses efforts limités, Il nepeus qu'aaioustes à votrares beautés;
Et vous auez, Madame, épuiſe ſes merueilles, Si l’eſprit & le corps ont des douceurs pareilles, Si ma douleur vous touchs, & ſi vous gueriſſez Vn homme ſeulement entre tant de bleſſez.	Et vous avez, Madame, épuise ses merveilles, Si l'esprit et le corps ont des douceurs pareilles, Si ma douleur vous touchs, et si vous guérissez Vann homme seulement entre tant de blessez.
EROTIE.	EROTIE.
Si vous ne reſeruez vne voix ſi feconde, Vous me rendrez, Monſieur, la plus vaine du imonde.	Si vous ne réservez une voix si féconde, Vous me rendrez, Monsieur, la plus vaine du imonde.
Et ie croy qu’auiourd huy vous auez entrepris, De vous nuire vous meſme, & de m'eſtre à miſpris.	Et ie au qu'aujourd' hui vous avez entrepris, De vous nuire vous même, et de m'être à mispris.
Puis que vous m’eſleuez en vn degré de gloirs.	Puis que vous m'élevez en un degré de gloirs.
Où rien ne m’eſt égal, ſi i’ay d'oit de veust oirs.	Où rien ne m'est égal, si j'ai d'oit de veust oirs.
MENECHME rauy.	MENCHME ravi.
Von amour ſeul aſpire à cette égalité.	Von amour seul aspire à cette égalité.
Il eſt ſeul infiny cemme voſtre beauté.	Il est seul infini cème votre beauté.
En cét unique point vous pouuez eſtre vaint, De reietter mes vœux, & de cauſer mapeint.	En cet unique point vous pouvez être vaint, De rejetter mes vœux, et de causer mapeint.
ERGASTE.	ÉRGASTE.
Commandez lediſner.	Commandez ledisner.
EROTIE I'eſtime infiniment, Le diſcours que vous dites, vn eſprit ſi charmãt Quy que ie diſſimule, & que ie deſaduouë.	EROTIE J'estime infiniment, Le discours que vous dites, un esprit si charmant Qui que je dissimule, et que sans désavoue.
Ieſuisfemme pourtãt, & i'ayme qu'on me loué,	Jésuisfemme pourtant, et j'aime qu'on me loué,
ERGASTE.	ÉRGASTE.
Moy, i’ayme qu’on me traite.	Moi, j'aime qu'on me traite.
EROTIE.	EROTIE.
Ainſi ie dois aymer, Vn pii ſtait ſi bien feindre, & ſi bien eſtimer.	Ainsi ici dois aimer, Un pi stait si bien feindre, et si bien estimer.
MENECHME rauy.	MENCHME ravi.
N’eſtes vous point du rang de ces ames fauiles.	N'êtes -vous point du rang de ces âmes faviles.
Quuimte mommm également dociles.	Quuite mommm également dociles.
En qui tous les eſprits ſont de meſmes eſſects, Qui promettent touſiours, & ne donnent iamais;	En qui tous les esprits sont de mêmes essects, Qui promettent toujours, et ne donnent jamais;
O Dieux!	Ô Dieux!
que voſtre bumear doit eſtre meſpriſee;	que votre bumear doit être méprisée;
Que ſouuent ces diſcours ont mon ame abuſee.	Que souvent ces discours ont mon âme abusée.
Telle qui me charmoit par l’appas de ſa voix, Que ie croyois m’aymer, autant que iel’aymois, Dont l’inclination me paroiſſoit ſi grande, Qu’il ne me reſtoit plus qu’à faire la demande.	Telle qui me charmait par l'appas de sa voix, Que ie croyais m'aimer, autant que iel’aimais, Dont l'inclination me paraissait si grande, Qu'il ne me restait plus qu'à faire la demande.
Me voyant approcher m’a repoußé la main.	Me voyant approcher m'a repoulé la main.
Et m’a tout en raillint accuſe deſtre vain;	Et m'a tout en raillint accuse dêtre vain;
Auecque tout le monde elle vit tout de meſme, Et quiconque la voit eſtime qu’ellel aime;	Avec tout le monde elle vit tout de Seigneur, Et quiconque la voit estime qu'elle aime;
Madame, que ce point me cauſe de ſoucy, I Queie ſuis malheurenx ß veus viuez aini.	Madame, que ce point me cause de souci, I Queie suis malheurenx us vivez ain.
ERGASTE.	ÉRGASTE.
Monſieur il eſt bien tard.	Monsieur il est bien tard.
EROTIE.	EROTIE.
Enfa cettelicence.	Enfa cettelicence.
Paſſe vne iuſte borne, & ce diſcoursm'offence Ie tiens voſtre amitié pour vn rare bon-heur, Pourueu qu’elle demeure aux termes de l'honneur;	Passe une juste borne, et ce discoursm'offense Je tiens votre amitié pour un rare bonheur, Pourvu qu'elle demeure aux termes de l'honneur;
Qus mon honneſteté ne ſoit point offencée, Et qu'vn but vertueux borne voſtre penſée.	Quus mon honnêteté ne soit point offensée, Et qu'une but vertueux borne votre pensée.
Autrement vous perdrez vos diſcours & vos ſois, Et medemandant plus ie vous donnerois moins.	Autrement vous perdrez vos discours et vos sois, Et médemandant plus je vous donnerais moins.
Ie ne remarque point d’action de ma vie, Qui doiue authoriſer voſtre amoureuſe enuie, Si ma ioyeuſe humeur vous fait imaci ler, Que me demandant tout ie doiue tout lonner;	Je ne remarque point d'action de ma vie, Qui doive autoriser votre amoureuse envie, Si ma joyeuse humeur vous fait imaci ler, Que me demandant tout personne doive tout lonner;
Il faus viure autrements me contenir, me taire Et eus ſroids entretiens prouueront le contraire.	Il faus vivre autrements me contenir, me taire Et eus soids entretiens prouveront le contraire.
MENECHME rauy.	MENCHME ravi.
Bien, il me faut reſoudre à ſouffrir conſtamiment, A n’amoliriamais ce cœur de diamant.	Bien, il me faut résoudre à souffrir constamiment, À n'amoliriamais ce cœur de diamant.
A mourir tourlesiours pour de vaines thimeQue vous ſont esc uoir les esptes de vos meres.	À mourir tourlesiours pour de vaines thimeQue vous sont éc uoir les éptes de vos mères.
Que vousperdez detemps, & combien depluiſirs, Ce ſantoſme d’honneur dérobe à vos deſirs!	Que vousperdez detemps, et combien dépluisirs, Ce santôme d'honneur dérobe à vos désirs!
Mais c’iſt trep irriter cette humeur obſtinée, Ielaiſſe à vos deſſeins reçir ma deſtinée.	Mais c'ist trep irriter cette humeur obstinée, Jelaisse à vos desseins reçir ma destinée.
C’eſt trop vous amuſer dinutiles propos, Peut- eſtre que le temps fera pour mon repos.	C'est trop vous amuser dinutiles propos, Peut- être que le temps fera pour mon repos.
I’attends ma gueriſon de voſtre repentance, Elle retractera cette iniuſteſentence;	J'attends ma guérison de votre repentance, Elle rétractera cette injustesentence;
Cependant ce poinçon qui vous eſt dedié, Aura l’heur de ſeruir à ce poil delié, Et ie m'eſtuneray leplus heureux du monde, De le voir tousles iours ſous cette treſſe blonde, Et tous les tours touche par ſes aiuines mains.	Cependant ce poinçon qui vous est dédié, Aura l'heur de servir à ce poil delié, Et autre m'estuneray leplus heureux du monde, De le voir tousles jours sous cette tresse blonde, Et tous les tours touche par ses aivines mains.
A quile Ciel permet d’enchaiſner tant d’humains.	À quile Ciel permet d'enchaîner tant d'humains.
EROTIE.	EROTIE.
Quoy qu’indigue, Menſieur, d'vn preſent de la 13 ſonte, Puiſque vous l’ordonnez il faut que ie leports.	Quoi qu'indigue, Mensieur, d'un présent de la 13 sonte, Puisque vous l'ordonnez il faut que deux leports.
Qu'il eſt bien trauaillé!	Qu'il est bien travaillé!
i'admire ſa beauté, Tous ce que vousdonnez acette qualité.	j'admire sa beauté, Tous ce que vousdonnez acte qualité.
ERGASTE.	ÉRGASTE.
Quand faut-il qu’il ſoit preſt?	Quand faut-il qu'il soit prêt?
MENECHMES rauy.	MENECHMES ravi.
Dmne orare, mapenſée, Qu'au retour du Palais la table ſoit dreſſée, Ie reuiens de te pas, & nous diſnonsioy.	Damne orare, mapensée, Qu'au retour du Palais la table soit dressée, Je reviens de te pas, et nous disnonsioi.
EROTIE.	EROTIE.
Adieu, ie vous attends.	Adieu, Seigneur vous attends.
ERGASTE.	ÉRGASTE.
Et mey iy diſne auſſi.	Et mei ici dîne aussi.
SCENE IV.	SCÈNE IV.
EROTIE, CILINDRE.	EROTIE, CYLINDRE.
Mlindre?	Mlindre?
EROTIE.	EROTIE.
CIIINDRE.	CIIINDRE.
&αy!	eti!
Madame.	Madame.
EROTIE.	EROTIE.
Ilfaut que trois perſonner Treuuent vn bon repas en ce que tu me donnes.	Ilfaut que trois personner Treuent un bon repas en ce que tu me donnes.
Menechme fait vn tour, & vient dans vn momint.	Menechme fait un tour, et vient dans un moment.
CILINDRE.	CYLINDRE.
I' n'en ſaut appreſter que pour dix ſeulement, Pour Uenechme, pour vous, & pour ſon poraſite, Qui tout ſeul diſne autant que huict mangeur, 4 elue.	 J'en saut apprêter que pour dix seulement, Pour Uenechme, pour vous, et pour son porasite, Qui tout seul dîne autant que huit mangeur, 4 élue.
quoy qu’on puiſſe appreſter, ie n’imagive pas, Q’apres luy vos valets faſſent vn bon repas.	quoi qu’on puisse apprêter, on n'imagive pas, QU'après lui vos valets fassent un bon repas.
Sur tout, il boit des mieux, & nous verrons merueilles, Sice goinſre alieré gouuerne lesbouteilles,	Sur tout, il boit des mieux, et nous verrons merveilles, Sièce goins alieré gouverne lesbouteilles,
ACPE II.	ACPE II.
SCENE PREMIERE MENECHME ſoſicle, MESSENIE ſon valet.	SCÈNE PREMIÈRE MENCHE sosicle, MESSENIE son valet.
MENECHME foficle.	MENCHME foficle.
Onſeſſe que leport eſt bien doux aux NoLchers Ejeappez du peril, des flots, & des Rochers, Et que le ſouuenir de la ſureur de ſ’onde, Eſt vne voluptéqui n’a point de ſetonde.	Onsesse que leport est bien doux aux Nochers Éjeappés du péril, des flots, et des Rochers, Et que le souvenir de la sûreur de s'onde, Est une voluptéqui n'a point de setonde.
MESSENIE.	MESSENIE.
Ietrouueroisencor vn plaiſirplus charmant, A ne s’expoſer pontſur ce traiſtre element.	Ietrouueroisencor un plaisirplus charmant, À ne s'exposer pontsur ce traître élément.
Apaſſerchez les ſiens le cours de ſes aunees.	Apasserchez les siens le cours de ses ânes.
Et n’allerpoint a nſi tenter les deſtinées;	Et n'allerpoint a ni tenter les destinées;
I’ay veutent ſoisla mort, & les vents courroucez, Out le mille dangers uos vaiſſeaux menaſſez.	J'ai veutent soisla mort, et les vents courroucés, Out le mille dangers os vaisseaux menassez.
Cent fois leur violance a deſchiré nos voiles, Cent ſoit ils nous ont mis au deſſus des étoilles.	Cent fois leur violance a déchiré nos voiles, Cent soit ils nous ont mis au dessus des étoilles.
Les efforts du Pilote ont cent fois eſté vains, Et le timon cent fois eſt tombé deſes mains, Nous tournons commel onde à l’entour de ces iſtes, Et par tout nous faiſons deschemins inutiles.	Les efforts du Pilote ont cent fois été vains, Et le timon cent fois est tombé deses mains, Nous tournons commel onde à l'entour de ces istes, Et par tout nous faisons déchemins inutiles.
En toutes nous voyons des gens & des maiſons, En toutes on meſme air, & de meſmes ſaiſons, Quàd finira, Moſieur, vn ſi faſtheux voyage, Où vous perdez ſans fruit le pluibeau de voſtre aage:	En toutes nous voyons des gens et des maisons, En toutes on même air, et de mêmes saisons, Quad finira, Mosieur, un si fâtheux voyage, Où vous perdez sans fruit le pluibeau de votre âge:
Au lieu que vous deuſſiez dans vn autre ſeiour boer ces ieunes am unplaiſir de l'amour.	Au lieu que vous dussiez dans un autre séjour boer ces jeunes am unplaisir de l'amour.
MENECHME ſoſicle.	MENCHME sosicle.
L’amour n’eſt point ſi doux, ny le vent ſi contraire, Qu’ils m’oſtent de l’eſprit la perte de mon frere, Seulieſcay quel il eſt.	L'amour n'est point si doux, Seigneur le vent si contraire, Qu'ils m'ôtent de l'esprit la perte de mon frère, Seuliescai quel il est.
& combien il m'eſt cher, Seul ie ſçay quel inſtinct m'oblige à le chercher, Le repos m’eſt honteux, ſi ma nef uagabonde N’a fait auparauant le tour de tour le monde.	et combien il m'est cher, Seul a sçay quel instinct m'oblige à le chercher, Le repos m'est honteux, si ma nef agabonde N'a fait auparavant le tour de tour le monde.
MESSENIE.	MESSENIE.
Que ee temps ennuyra vos parens deſolez!	Que ce temps ennuira vos parents désolés!
Depuis noſtre deſpart ſix ansſont eſcoulaz.	Depuis notre départ six anssont escoulaz.
Songez quelles sollleurs ont leurs ames atraintui.	Songez quelles sollleurs ont leurs âmes atraintui.
Imagmet leuri pleurs, ſigurte-vous leurs plaintes Qu’ils maudiſſent de fois ce voyage hazardux, Où pour leur rendre vn ſils vouileur en oſtez deux!	Imaget leur pleurs, sigurte-vous leurs plaintes Qu'ils maudissent de fois ce voyage hasardux, Où pour leur rendre un sils vouileur en ôtez deux!
Helas!	Hélas!
où noſtre nef n’a elle eſté portee, Et quelle region n’auons-nous viſitee?	où notre nef n'a elle été porte, Et quelle région n'avons-nous visite?
Quel fruit eſperez vous de vos tas ſuperflus, Si vous cherchez en terre vn homme qui n'eſt plus?	Quel fruit espérez -vous de vos tas superflus, Si vous cherchez en terre un homme qui n'est plus?
Aptrenez le chemin qui meine chez les ombres, Et nousl irons tirer de cet riuiges ſombres, Sil on peut repaſſer le chemin du treſpas.	Aptrenez le chemin qui mène chez les ombres, Et nousl irons tirer de cet riviges sombres, Sil on peut repasser le chemin du trépas.
Autrement n’eſperez que de perdrs voipas.	Autrement n'espérez que de perdrs voias.
MENECHME.	MENCHME.
Sila mort a ſuiuy ſon ſeruage, & ſes peines, Au moins i’en veux auoir des nouuelles certaines;	Sila mort a suivi son servage, et ses peines, Au moins j'en veux avoir des nouvelles certaines;
Et ce paint obtenu i’iray ohez mes parens, Baſtir un Mauſolée à ſes manes crans.	Et ce paint obtenu j'irai ohez mes parents, Bâtir un Mausolée à ses mânes crans.
MESSENIE.	MESSENIE.
Vous verray-it touſiours dans vne humiur ſi noire?	Vous verrai-it toujours dans une humivr si noire?
Auez-vous reſolu de compoſer l'Hiſtoire?	Avez-vous résolu de composer l'Histoire?
Nous aurions meſurd le quart de l'Vniuert, Depuis que nous faiſons tant de chemins diuers.	Nous aurions mesurd le quart de l'Univert, Depuis que nous faisons tant de chemins divers.
MENECHME.	MENCHME.
Ne me preſente plus eet aduis ſalutaire, Au lieu de me l’offrir, preu celuy de te taire.	Ne me présente plus cet avis salutaire, Au lieu de me l'offrir, preu celui de te taire.
Garde que ces propos n’excitent mon courroux.	Garde que ces propos n'excitent mon courroux.
Et ceſſe de railler, ſi tu n’aymes lescoups.	Et cesse de railler, si tu n'aimes lescoups.
MESSENIE.	MESSENIE.
O mal-heureux effect de mon ſort miſtrabla!	Ô malheureux effet de mon sort mistrabla!
Qui fait que mon aduis n’eſt pas conſi derable;	Qui fait que mon avis n'est pas consi derable;
Le ſilence pourtant, m’eſt vne eſtoitte loy, Et ie dcy l aduortir des maux que ie preuoy.	Le silence pourtant, m'est une estoitte loi, Et ie cy l uortir des maux que ie preuoy.
Ie voy bien à regret tette riue eſtrangere, Lors que ie ſens, Monſieur, la bourſe ſi legere.	Je vois bien à regret tette rive étrangère, Lors que tu sens, Monsieur, la bourse si légère.
Emmunnuuni poiguuuren ces bords eſcartez, Plus nous nous approchons desincommoditez.	Emmunnuuni poiguren ces bords écartés, Plus nous nous approchons desincommodités.
Et vous n’imployriez pas vn ſoin moins neceſſaire, A chercher de l'argent, qu'à chercher voſtre frere.	Et vous n'imploieriez pas un soin moins nécessaire, À chercher de l'argent, qu'à chercher votre frère.
Nouiſommes abordez chez des gens incogreus, Qui declarent la guerre aux eſprits retenus.	Novisommes abordez chez des gens incogreus, Qui déclarent la guerre aux esprits retenus.
Icy, par lesplus ſaincts, Venus eſt inuoquee, La volupté cherie, & la vertu mocquee;	Ici, par lesplus saints, Venus est invoquée, La volupté chérie, et la vertu moquée;
Tant de raresobiects, tant de ieunes beautez Tiennent icy lesyeux, & les cœurs enchantez, Et pour ſe faire aymer vſent de tat de charmes, Qu’il eſt bien mal-aiſé de ne rendre les armes.	Tant de raresobjets, tant de jeunes beautés Tiennent ici lesyeux, et les cœurs enchantez, Et pour se faire aimer usent de tat de charmes, Qu'il est bien malaisé de ne rendre les armes.
Apres, les biens qu’on a ſont bien-toſt diſparus.	Après, les bientôt qu'on a sont bientôt disparus.
Vn Craſusles aymant, deuiendroit vn lras Qui leur denne des væux s'appreſte des ſuppl, ces, Et la neceſſité ſuit ces molles deliees.	Un Crasusles aimant, deviendrait un lras Qui leur denne des væux s'apprête des suppl, ces, Et la nécessité suit ces molles déliées.
MENECHME.	MENCHME.
C’eſtaſſez, i'aurayſoin d'euirer leurs appas, Mais donne moy la bourſe, & ue t'eſtoignepas,	C'étassez, j'auraisoin d'évirer leurs appas, Mais donne moi la bourse, et ue t'étoignepas,
MESSENIE.	MESSENIE.
Quoy!	Quoi!
vousſuis.	Voussuis.
ie ſuſpect?	On suspect?
MENECHME.	MENCHME.
Cetteiſte eſt dangereuſe A ceux qui comme toy ſont d'humeur amoureuſe.	Cetteiste est dangereuse À ceux qui comme toi sont d'humeur amoureuse.
Vne fille ſ'oſſrant, ie te tieni ſi courtois.	Une fille s'ossrant, ie te tieni si courtois.
Que ie ſerois trompé ſi tula rejettois.	Que ici serais trompé si tula rejettais.
Moy ie me ſaſche soſt, & iamait ne ſupporte Le tort que me peut faire vn lomme de ta ſorte:	Moi mille me sâche sitôt, et jamait ne supporte Le tort que me peut faire un lomme de ta sorte:
Et ie ne prends l’argent que pour nous empeſcher, Toy de me faire tort, & moy de me faſcher.	Et ici ne prends l'argent que pour nous empêcher, Toi de me faire tort, et moi de me fâcher.
MESSENIE.	MESSENIE.
Vous m’auez déchargé d’vn fardeau ſi peniblé, Que i'en reçoy, Monſieur, vn plaiſir indicible, Et ſi vous m’accordez le ſouhait que ie faits, Vous me diſpenſerez dele porter iamais,	Vous m'avez déchargé d'un fardeau si péniblé, Que j'en reçois, Monsieur, plaisir indicible, Et si vous m'accordez le souhait que mille faits, Vous me dispenserez dele porter jamais,
SCENE II.	SCÈNE II.
CILINDRE.	CYLINDRE.
MENECHME ſoſicle;	MENCHME sosicle;
MESSENIE.	MESSENIE.
CILINDRE.	CYLINDRE.
IE croy qu’il ſuffira de tes mets que ie porte.	JE crois qu'il suffira de tes mets que sans porte.
IMais, Dieux!	JMais, Dieux!
eſt il ſi tard!	est il si tard!
Menechme eſt à la porte:	Menechme est à la porte:
Le vin eſt en la chambre, entrez y ſeulement, Ie ne vous ſeray plus attenarè qu’vn moment.	Le vin est en la chambre, entrez y seulement, Je ne vous serai plus attenaré qu'un moment.
MENECHME.	MENCHME.
Quoy, ſpais tu quiie ſuis?	Quoi, spais -tu quiie suis?
CILINDRE.	CYLINDRE.
I'auroispeu de memoire, I'ay cent ſois eu l’honneur de vous verſer à boire.	J'auraispu de mémoire, J'ai cent sois eu l'honneur de vous verser à boire.
MENECHME.	MENCHME.
Et ſçais tu bien monnem?	Et sais tu bien monnem?
CILINDRE.	CYLINDRE.
Ouy, c'eſt Menechme.	Oui, c'est Menechme.
B inj	B inj
MENECHME.	MENCHME.
O Dieux!	Ô Dieux!
Comment peut-on deſia me cognoiſtre en tes lieux?	Comment peut-on déjà me connaître en tes lieux?
CILINDRE.	CYLINDRE.
Ezaſc ouſt-ilpu?	Ezasc oust-ilpu?
MENECHME.	MENCHME.
Qui!	Qui!
CILINDRE.	CYLINDRE.
Voſtre paraſite, Dont tous les bont beuueurs eſtiment le merite.	Votre parasite, Dont tous les bont buveurs estiment le mérite.
Ce grand vuideur de plats, ce grand reinceur de pots, Qui daus les Cabarets a fendt ſon rep-s;	Ce grand videur de plats, ce grand reinceur de pots, Qui daus les Cabarets à fendât son reps;
Hal qu’il va trio mpher ſur l’eſſime des tables, Et qu'il vous contera de merueilleuſes ſables!	Hal qu'il va trio mépher sur l'essime des tables, Et qu'il vous contera de merveilleuses sables!
MESSENIE.	MESSENIE.
MENECHME.	MENCHME.
Oùms ſus-ie addreſſe!	Oùms sus-je adresse!
Et guelpla ſant d ſeourim fait cet inſenſe?	Et guela sant d seourim fait cet insensé?
CILINDRE.	CYLINDRE.
Voustrouuerez, Monſieur, vn diſner aſſez roEn la diuerſitédes mets que ie prepare.	Voustrouverez, Monsieur, un dîner assez roEn la diversité mets que votre prépare.
MESSENIE.	MESSENIE.
O le plus plaiſant ſou qui ſoit deſſour les Cieux!	Ô le plus plaisant sou qui soit dessour les Cieux!
Amy, tu te meſprends, il aborde en ceslieux.	Ami, tu te méprends, il aborde en ceslieux.
A peine la Nauire eſt encore arreſtee, Et l’ancre n’eſt qu'à peine à la riuciettee.	À peine la Navire est encore arrête, Et l'ancre n'est qu'à peine à la rivciette.
Que veux tu qu’il comprenne aux contes quetu fais, Tey qu’il ne cognoiſt poins, & qu’il nevidiamais.	Que veux tu qu'il comprenne aux contes quetu fais, Téi qu'il ne connaît poins, et qu'il nevidiamais.
CILINDRE.	CYLINDRE.
Amy, tu ne dois pas m’outrager dauan'age, Où ie vais de ces platste couurir le viſage, Ne dy mot ſeulement à qui ne te ait riea, Ie ne te vis jamais, & is le cognoybien.	Ami, tu ne dois pas m'outrager davanage, Où ne vais de ces platste couvrir le visage, Ne dis mot seulement à qui ne te ait riea, Je ne te vis jamais, et is le cognoybien.
MENECHME.	MENCHME.
Où m'aurois-tu cogneu?	Où m'aurais-tu connu?
CILINDRE.	CYLINDRE.
Que vaus ſert cette ſemte, B uij Ie ſçay la paſſion dont voſtre ame eſt atteinte.	Que vaus sert cette semte, B uij Je sais la passion dont votre âme est atteinte.
Erotie a ſur vous vn abſolu pouuoit, N'ay je pas tous les iours l’honneur de vousy vois?	Erotie a sur vous un absolu pouvait, N'ai je pas tous les jours l'honneur de vous vois?
Pouuez -vous meſcognoiſtre vn homme de ma ſorte?	Pouvez -vous méconnaître un homme de ma sorte?
Ne vous ſouuient il plusdes poulett que ie por 14 Et du bruit que nous ſi voſtre chaſte moitié, Lers qu’elle deſcouurit voſtre ardente amitié?	Ne vous souvient il plusdes poulet que votre por 14 Et du bruit que nous si votre chaste moitié, Lers qu'elle découvrit votre ardente amitié?
O Dieux!	Ô Dieux!
qu’elle me fit vn inſigne reproche, Quand vne lettre vn iour me tomba de lapoche, Et qu'elle y recogneus certaines priuautez, Par quice rare objedt tient vos ſens arreſtez?	qu'elle me fit un insigne reproche, Quand une lettre un jour me tomba de lapoche, Et qu'elle y reconnus certaines privautés, Par ce rare objet tient vos sens arrêtez?
Ma ſuitte me ſauua de mille baſtonnades, I'eur d’apprehenſion les eſpaules malades;	Ma suitte me sauva de mille bastonnades, J'eur d'appréhension les épaules malades;
Et depuis me trouuant en mille endroits diuers, Elle ne m’aſpeu voir que d'vn œil de trauers.	Et depuis me trouvant en mille endroits divers, Elle ne m'asput voir que d'un oeil de travers.
MESSENIE.	MESSENIE.
Ny, tu cognoisſa ſimme?	Ni, tu cognoissa simme?
CILINDRE.	CYLINDRE.
Ouy.	Oui.
Caſemmis, Oraſie.	Casemis, Orasie.
Dont vn ialaux ſoupçon trouble la fantaiſie:	Dont un jalaux soupçon trouble la fantaisie:
Mais va cauſer ailleurs, O melaiſſe eu repos, Car ce n’eſt pas à toy que ie tiens ces propos Si tu veux diſcourir, cherche qui te reſpon	Mais va causer ailleurs, Ô melsse eu repos, Car ce n'est pas à toi que ie tiens ces propos Si tu veux discourir, cherche qui te répon
MESSENIE.	MESSENIE.
O le plus inſenſe de tous les foux da monde!	Ô le plus insensé de tous les foux da monde!
CILINDRE.	CYLINDRE.
Amy, ie pourrois bien te ſeruir de ces plats, Mais en vne facon que tu n’eſpere pas.	Ami, Seigneur pourrais bien te servir de ces plats, Mais en une façon que tu n'espère pas.
MESSENIE.	MESSENIE.
Toy, ie t’auroisbriſé plus ayſemens qu’vn verEt du moindre regard ie t’aurois mis à terre.	Toi, Seigneur t'auraisbrisé plus aysemens qu'un vérêt du moindre regard quelque t'aurais mis à terre.
num u ummn unmmme, indigne de mes coups, Ie reſpecte mon Maiſtre, & i'eſpargne lesſous.	num u un Âme, indigne de mes coups, Je respecte mon Maître, et j'épargne lessous.
CILINDRE.	CYLINDRE.
Sue ce maraut eſt vain, quoy l Menechme eſt ton Maiſtre?	Sue ce maraud est vain, quoi l Ènechme est ton Maître?
MESSENIE.	MESSENIE.
Ill'eſt, & ſi tu veux qu’il le faſſeparaiſtre, Tun as qu’à le prier de parler ſeu ement, E tuſeras battu parſon commandement.	Ill'est, et si tu veux qu'il le fasseparaître, Tun as qu'à le prier de parler seu ement, E tuseras battu pars commandement.
CILINDRE.	CYLINDRE.
Monſieur, il doit beaucoup à voſtre compagnie, Sant vous i'aurois deſia ſa vanitépunie.	Monsieur, il doit beaucoup à votre compagnie, Sant vous j'aurais déjà sa vanitépunie.
Que veut-il à celuy qui ne le vid iamais?	Que veut-il à celui qui ne le vit jamais?
Me veut il quaceller pour excroquer cesm tit	Me veut il quaceller pour excroquer ces tit
MENECHME.	MENCHME.
Toy-meſine t’es meſpris, toy meſmes nous affrontes, Et ie ne comprends rien aux ſables que tu contes;	Toi-mène t'es mépris, toi -mêmes nous affrontes, Et personne ne comprends rien aux sables que tu contes;
Conſultez vousicy quelque ſçauaut demon, Qui vous apprenne tout, & qui t’ait dis mon nom?	Consultez vousici quelque saut démon, Qui vous apprenne tout, et qui t'ait dis mon nom?
Sommes nous abordez en quelque iſte enchantée, Qu'vn nombre de ſorciert aut iadis halitíe?	Sommes nous abordez en quelque iste enchantée, Qu'un nombre de sorciert aut jadis halite?
MESSENIE.	MESSENIE.
Monſieur, n'en doutez pas, les peuples de ces bords Sont des Demꝰs cachęz ſous des ſormes de corps.	Monsieur, n'en doutez pas, les peuples de ces bords Sont des Demꝰs cachés sous des sormes de corps.
Lesm fique vout voyez ſous des mets en pein- iture, Et cesplatsſont del air, qui n’a que la ſigure;	Les fique vout voyez sous des mets en pein- iture, Et cesplatsont dél air, qui n'a que la sigure;
Nos yeux ſont abuſez d'vn fantoſme moüuant, Frappez-le mille fois, vous ſrapperez du vent.	Nos yeux sont abusés d' fantôme mouant, Frappez-le mille fois, vous sraperez du vent.
CILINDRE.	CYLINDRE.
N’eſprouuez point ſur moy de telles deſiances, Vous deuez eſtre exempt de ces vaines creances.	N'éprouvez point sur moi de telles desiances, Vous deuez être exempt de ces vaines créances.
Vous me cognoiſſez trop, & vouin ignorez pas, Queit vouray areſſe de ſolides repas;	Vous me connaissez trop, et vouin ignorez pas, Queit vourai àresse de solides repas;
Mais il vousplaiſt, Mouſieur, de railler de la ſorte I'entre, & vaisenuoyer ma Maiſtreſſe à la perti Qui vous attend ſans doute, & dont les complimens Vous ſeront meſpriſer ces diuertiſſemens.	Mais il vousplaît, Mousieur, de railler de la sorte J'entre, et vaisenvoyer ma Maîtresse à la perti Qui vous attend sans doute, et dont les compliments Vous seront mépriser ces divertissements.
Il s’euva.	Il s'euva.
MENECHME.	MENCHME.
Tum' aiſidellemint la verité predi te, Et quelque Gourtiſane en ce logis habite.	Tum' aisidèlemint la vérité prédi te, Et quelque Gourtisane en ce logis habite.
N’importe, quelqu’aduis dont ie ſois deſpourueu, Ne crain pas que ie tombe en vn filet preueu.	N'importe, quelqu'avis dont Madame sois dépourvu, Ne crain pas que ici tombe en un filet preuvu.
» Attendone ſeulement:	" Tendone seulement:
mais i'admire cet honme.	mais j'admire cet honme.
Qui ne m’ayantpoint veu, me cognoiſt, & me nomme.	Qui ne m'ayantpoint vu, me connaît, et me nomme.
MESSENIE.	MESSENIE.
Moy ie ſuis eſtonné de cet eſtonnement, Ayant veutant d'eſfets de voſtre iugement.	Mo ie suis étonné de cet étonnement, Ayant vutant d'efets de votre jugement.
Nous n’auiõs pas quittél humide ſein de l’onde, Que l’on ſçauoit icy les noms de tout le mon le.	Nous n'avion pas quittél humide sein de l'onde, Que l'on savait ici les noms de tout le le le.
Les femmes ont des gensſur le bord de cestaux, Qui ſi toſt qu’on arriue entrent dans les vaiſſeaux.	Les femmes ont des genssur le bord de cetaux, Qui si tôt qu'on arrive entrent dans les vaisseaux.
Et i'enqueſtent des noms, da puis, desricheſſes, Pour les venir en haſte apprendre à leurs maiſtreſſes;	Et j'enquêtent des noms, da puis, dérichesses, Pour les venir en hâte apprendre à leurs maîtresses;
Elles prennent alors leurs plus beaux ornemens, Vous ne viſtes iamais des obiets ſi charmans.	Elles prennent alors leurs plus beaux ornements, Vous ne vite jamais des objets si charmants.
Tout cede à leurs appas, les mains les plus auares Font des profuſions pour des beautez ſi rares.	Tout cède à leurs appas, les mains les plus avares Font des profusions pour des beautés si rares.
Laur entretien eſt doux, mais cette volupté Eſt vn chemin ouuert en la neceſſité.	Laur entretien est doux, mais cette volupté Est un chemin uert en la nécessité.
On voit bien-toſt ſaioye en douleur conuertie, Et tel rit en entrant qui pleure à la ſortie.	On voit bientôt saie en douleur convertie, Et tel rit en entrant qui pleure à la sortie.
MENECHME.	MENCHME.
I'eſtime ton conſeil, mais n’apprehende rient	J'estime ton conseil, mais n'appréhende rient
MESSENIE.	MESSENIE.
Ieſtauray qu’il eſt bon ſi vous en vſez bien.	Iestauray qu'il est bon si vous en us bien.
SCENE III.	SCÈNE III.
EROTIE, MENECHME ſoficle, MESSENIE.	EROTIE, MENECHME soficle, MESSENIE.
EROTIE.	EROTIE.
Vattendez-vous, Monſieur, quand la porte eſt ouuerte, Moy dansl'impatience, & la table couuerte.	Vattendez-vous, Monsieur, quand la porte est ouverte, Moi dansl'impatience, et la table couverte.
Qui vous rend ſi penſif & ſourd à mes propon, Le ſois de vosprocés trouble voſtre repoi.	Qui vous rend si pensif et sourd à mes propon, Le sois de vosprocez trouble votre répoi.
MENECHME.	MENCHME.
Dieux le Diuin objet, ie merends Meſſenie, Et ne puis reſiſter à ſa force infinie.	Dieux le Divin objet, Seigneur mérends Messénie, Et ne puis résister à sa force infinie.
MESSENIE.	MESSENIE.
Il eſt vray qu'elle eſt belle.	Il est vrai qu'elle est belle.
EROTIE.	EROTIE.
Enirez donc, tout eſt preſt.	Enirez donc, tout est prêt.
MENECHME.	MENCHME.
Que ſon viſage eſt doux, que ſon diſcours me plaiſt.	Que son visage est doux, que son discours me plaît.
MESSENIE.	MESSENIE.
Fut-elle plus charmante, & eent fois plus aymable, Le mal que ie preuoy m'eſt bien deſ-agreable.	Fut-elle plus charmante, et cent fois plus aimable, Le mal que je preuoi m'est bien désagréable.
Ce n’eſt qu’à voſtre argent qu’elle tend ſes appu.	Ce n'est qu'à votre argent qu'elle tend ses appu.
EROTIE.	EROTIE.
Vous ne reſpondez rien, ne m'entendez-vous past	Vous ne répondez rien, ne m'entendez-vous past
MFNECHME.	MFNECHME.
Quoy!	Quoi!
me cognoiſſez-vou?	me connaissez-vou?
EROTIE.	EROTIE.
Monſieur deuez- voureroire.	Monsieur devez- vousreroire.
Qu’vn momeut vous ai pu chaſſer de ma me:	Qu'un momeut vous ai pu chasser de ma me:
moire?	moire?
Ne me firois ie plus au rapport de mes yeux?	Ne me firais beau plus au rapport de mes yeux?
Et ne venez-vouspas de ſortir de cesluux?	Et ne venez-vouspas de sortir de cesluux?
MENECHME.	MENCHME.
Madame, briſoni-là, ce diſcours inutils, Ie ne vous uis iamais, & i’aborde es cette iſie.	Madame, brisoni-là, ce discours inutils, Je ne vous uis jamais, et j'aborde es cette isie.
EROTIE.	EROTIE.
Dieux!	Dieux!
combien auiour d’huy ſon humeur d’appas!	combien aujour d'hui son humeur d'appas!
Et qu’il plaiſt à railler oùſa femme n’eſt pas!	Et qu'il plaît à railler oùsa femme n'est pas!
MENECHME.	MENCHME.
Vous vous donnez, Madame, vne inutile peine.	Vous vous donnez, Madame, une inutile peine.
EROTIE.	EROTIE.
Quoy!	Quoi!
veus n'habitez pas cette maiſon prothaie.	vus n'habitez pas cette maison prothaie.
MENECHME.	MENCHME.
Ie cide &qui voudrale droict que 'y vvetends, Puiſe fairele Ciel perir ſeshobuaus.	Je cide etqui voudrale droit que 'y vvetends, Puise fairele Ciel périr seshobuaus.
EROTIE.	EROTIE.
Que cet homme eſt ſaiſi d'vne folie extrémet Il renonce à ſon bien, & ſe maudit ſoy-meſme.	Que cet homme est saisi d'une folie extrémet Il renonce à son bien, et se maudit soi-même.
MENECHME.	MENCHME.
Si vousauez deſſein d’at irer vn amane.	Si vousavez dessein d'at irer un amane.
lin Jraut empioyer que vos yeux ſeulement, Voui n’auezpoint beſoin d vne ſi vaine ſeinte, Ma raſſon s'eſt renduë, & mon ame eſt atteinte.	lin Jaut empioyer que vos yeux seulement, Voui n'avezpoint besoin d une si vaine seinte, Ma rasson s'est rendue, et mon âme est atteinte.
L'honneur de vis baiſers eſt vubien iofiny, Et quil’a meſpriſe, ſoy meſme s’eſt puny.	L'honneur de vis baisers est vien iofiny, Et qu'à méprise, soi -même s'est puni.
Ne d fferez donc plus un bien ſi diledable, Dont vous fauoriſez vn objet inçapable.	Ne d ferez donc plus un bien si diledable, Dont vous favorisez un objet inapable.
O Dieux!	Ô Dieux!
qui n’aymeroit la force de vos coupss Et qui pourroit tenir conte destraits ſi doux?	qui n'aimerait la force de vos coupss Et qui pourrait tenir compte détraits si doux?
EROTIE.	EROTIE.
Vaus reprenez touſiours vospremieres licences;	Vaus reprenez toujours vospremières licences;
Mais ie ne ſuis pas ſemme à ſouffrir cer oſfences.	Mais ici ne suis pas semme à souffrir cer osfenses.
Ie vous ay fait paroiſtre & iuré trop ſouuent, Que voſtre affection ſe repaiſſoit de vent.	Je vous ai fait paraître et juré trop souvent, Que votre affection se repaissait de vent.
Que vousentreteniez vne eſperance vaine, Et que vous vrua donniez vne inutile pius.	Que vousentreteniez une espérance vaine, Et que vous vra donniez une inutile pius.
Rétraignez voſtre ardeur aux termes d'amitié, Honorez de l’amour voſtre chaſte moitié.	Rétraignez votre ardeur aux termes d'amitié, Honorez de l'amour vôtre chaste moitié.
Nousſerons tous contents, & dans ces deux limnes Rien ne m'empeſchera de cherir vos viſites;	Nousserons tous contents, et dans ces deux limnes Rien ne m'empêchera de chérir vos visites;
I’eſtime voſtre humeur, & le bien de vous voir M’eſt un bon-heur plus grand qu’on ne peut contenoir.	J'estime votre humeur, et le bien de vous voir M'est un bonheur plus grand qu'on ne peut contenoir.
MENECHME.	MENCHME.
Votyeux ſeſont meſpris, voyez bien mon viſa, Vous penſez à quilqu’autre adreſſer ce lagage;	Votyeux sesont mépris, voyez bien mon visa, Vous pensez à quilqu’autre adresser ce lagage;
Mon çœur ne fut iamais ſous l’Hymen arreſté, Et ie n’ay iamais veu voſtre rare beauté.	Mon çœur ne fut jamais sous l'Hymen arrêté, Et tu n'ai jamais vu votre rare beauté.
EROTIE.	EROTIE.
Vnpaſſe temps ſi lõg commence à me deſplaire, N'eſtes-vous pas Menechme, & Moſque voſtre pere?	Unpasse temps si lõg commence à me déplaire, N'êtes-vous pas Menechme, et Mosque votre père?
La Sicile, l’endroit où vous priſtes le iour, It celieu maintenant voſtre unique ſejour?	La Sicile, l'endroit où vous prîtes le jour, It celieu maintenant votre unique séjour?
MENECHME.	MENCHME.
Eſcoute.	Écoute.
Meſſenie, ê Dieux!	Messie, êtes Dieux!
quelle merueille!	quelle merveille!
En l’eſtat où ue ſuis ie doute ſi ie veille.	En l'état où ue suis ie doute si tu veille.
EROTIE.	EROTIE.
Et poin ton n'eſt-il pas vn preſent de vos maine Pourquoy prolongez-vous des entretieus ſa vains?	Et poin ton n'est-il pas un présent de vos maine Pourquoi prolongez-vous des entretieus sa vains?
Quand l’haure du repas eſt à demy paſſée, Tous les mets preparez, & la table dreſſéa.	Quand l'haure du repas est à demi passée, Tous les mets préparés, et la table dresséa.
MESSENIE.	MESSENIE.
O Dieux!	Ô Dieux!
te paſſe temps ne ſepeut trop loüer.	te passe temps ne séput trop louer.
MENECHME.	MENCHME.
Ne dy mot ſeulement, ie vay tout aduoüer;	Ne dis mot seulement, On vais tout avouer;
Eſprouuons ſon deſſein quelque rets qu'elle dreſSiit m'y trennepmite tontray ſon addreſſe.	Éprouvons son dessein quelque rets qu'elle dresSiit m'y trennepmite tontrai son adresse.
Il n'eſt plus temps de feindre, adorable beauté, Vous treuuez peu d’appas en cette volupté, Et comme ie ſeignois à deſſein de vous plaire, Pour le meſme deſſein, ie ne le doy plus faire;	Il n'est plus temps de feindre, adorable beauté, Vous trouvez peu d'appas en cette volupté, Et comme ici seignais à dessein de vous plaire, Pour le même dessein, Seigneur ne le dois plus faire;
Ouy, ie ſuis ce Menichme, eſclaue de vos yeux, Ces aſtres les plus doux qui brillent en ceslieux.	Oui, Seigneur suis ce Ménichme, esclave de vos yeux, Ces astres les plus doux qui brillent en ceslieux.
Dont l'unique douceur me conſerue la vie, Et m’anime au deſfaut de mon ame rauie,	Dont l'unique douceur me conserve la vie, Et m'anime au défaut de mon âme ravie,
EROTIE, Ergaſie viendra-il?	EROTIE, Ergasie viendra-il?
MENECHME.	MENCHME.
Iene le cepueypas.	Jène le cépueypas.
EROTIE.	EROTIE.
Vous m’auez auet luy commandé ce nepus.	Vous m'avez aut luy commandé ce nepus.
EROITIE, luy donnant le poinçon.	EROITIE, lui donnant le poinçon.
Cet agreable gage.	Cet agréable gage.
S’il eſtox eſmaillé me plairoit aauantage.	S'il estox émaillé me plairait àavantage.
MENECHME.	MENCHME.
Ilatrop demeuré.	Ilatrop demeuré.
MENECHME.	MENCHME.
Donuez-moy ſeulement, i'en prendray le ſoucy, Et demain au plus tard ie le rapporte icy, Il dit à Meſſenie tout bas.	Doncez-moi seulement, j'en prendrai le souci, Et demain au plus tard toujours le rapporte ici, Il dit à Messénie tout bas.
Entrons.	Entrons.
Tien cet argent, & m’attends au nauire, Cependant que ie ſuy cet aimand qui m'attire.	Tiens cet argent, et m'attends au navire, Cependant que je suis cet aimand qui m'attire.
MESSENIE ſeul.	MESSENIE seul.
Qu’il ſoit ſourd maintenant à mes ſaces propot.	Qu'il soit sourd maintenant à mes saces propot.
Gardant ce que le tiens i’ay l'eſprit en repos :	Gardant ce que le tiens j'ai l'esprit en repos :
Dieux!	Dieux!
ie tremblois de peur;	Il tremblais de peur;
car il eſt ſi facile.	car il est si facile.
Que pour vne faueur il en rend touſiours mille.	Que pour une faveur il en rend toujours mille.
Et que pour le plaiſir d'un repas ſeulement, Ilnous eut mis au point de ieuſner longuement.	Et que pour le plaisir d'un repas seulement, Ilnous eut mis au point de jeûner longuement.
ACTE III.	ACTE III.
SCENE PREMIERE.	SCÈNE PREMIÈRE.
ERGASTE.	ÉRGASTE.
Guhemjor ant, nepuis l’heure premiert, E Que tan gil a iouy du bien de la lumiere, Helas!	Guhémjor ant, nepuis l'heure premiert, E Que tan gil a joui du bien de la lumière, Hélas!
fus tuiamais deſpourueu de conſeil, Iuſqu’à commettre vn malà cettuy-y pareil;	fus tuiamais dépourvu de conseil, Jusqu'à commettre un malà cettuy-y pareil;
Eſtre dans le palais au milieu de la ſoule, Et ne prendre pas garde où Menechme ſe coule, En deſtourner les yeux, voir battre deslaquais, Vn ſemblable malheur m’arriua-iliamais?	Être dans le palais au milieu de la soule, Et ne prendre pas garde où Menechme se coule, En détourner les yeux, voir battre délaquais, Un semblable malheur m'arriva-iliamais?
Que ie manque d'eſprit, que i’ay peu de prudẽce, Tout ſon deſſéin eſtoit de perdre ma preſence, Et d’eſpargner le bien que ie mepromettois, Di boire iuſqu’au ſoir en l'humeur où i’eſtois, Qu’il s’eſt bien-toſt défait, l’extreme diligencé.	Que me manque d'esprit, que j'ai peu de prudience, Tout son desséin estoit de re ma présence, Et d'épargner le bien que je mepromettois, Di boire jusqu'au soir en l'humeur où j'étais, Qu'il s'est bientôt défait, l'extrême diligencé.
Ces laquais ſe battoient par ſon intelligence, Et paroiſſant ainſi de colere enſl immez, C’eſtoit contre ma faim qu’ils eſtoient animez, Leur colere & leur coups ſe deſchargeoient ſur Ie portois le danger de toute leur querele, (elle.	Ces laquais se battaient par son intelligence, Et paraissant ainsi de colère ensgl ès, C'était contre ma faim qu'ils étaient animés, Leur colère et leur coups se déchargeaient sur Je portais le danger de toute leur querele, (elle.
Et i’eſtois reſiouy de mor propre malheur, Alorsque ie penſois ne l’eſtre que duleur;	Et j'étais réjoui de mór propre malheur, Alorsque personne pensais ne l'être que duleur;
Depuisie l’ay cherché parmy toute la preſſe, Mais inutilement;	Depuisie l'ai cherché parmi toute la presse, Mais inutilement;
il eſt chez ſa maiſtreſſe, Où ie ſuis aſſeuré qu’il ne reſerue pas, Pour la faim que ie ſents le meilleur du repas;	il est chez sa maîtresse, Où je suis assuré qu'il ne réserve pas, Pour la faim que ie sents le meilleur du repas;
Ha!	Ha!
que leur entretien maintengnt a de charmes, Et qu'ils treuuent à rire au ſuiet de mes larmes!	que leur entretien maintengnt a de charmes, Et qu'ils trouvent à rire au sujet de mes larmes!
Mais il ſort, ie le voy.	Mais il sort, Seigneur le vois.
SCENE II.	SCÈNE II.
MENEGHME ſoſicle, EROTIE ERGASTE.	MENEGHME sosicle, EROTIE ERGASTE.
MENECHME foſicle, tenant le poinçon.	MENCHME fosicle, tenant le poinçon.
DEmain te vonc le rends, Adieu, repoſez-vous ſur le ſom que i'enprendi	DEmain te vonc le rends, Adieu, reposez-vous sur le som que j'enprendi
MENECHME.	MENCHME.
Que cét objet occuppe ma penſee!	Que cet objet occuppe ma pensée!
Les a reables traits dont mon ame eſt bleſſee!	Les a reables traits dont mon âme est blessée!
Que de propos charmaus, que d'honneſtes reſus, Cddeluy maraiſon, ne luy réſiſte plus, ω viſage eſt pourueu d’ineuitablescharmes, Et ſes moindres attraits ſont plus forts que tes armes;	Que de propos charmaus, que d'honnêtes ressus, Cédelui maraison, ne lui résiste plus, visage est pourueu ineuitablescharmes, Et ses moindres attraits sont plus forts que tes armes;
Mon cœur eſt tout deſlame, & des ſceptrerofeferts, Ne luy plairoient pas tant que l’honneur de ſes fers;	Mon cœur est tout deslame, et des sceptreroferts, Ne lui plairaient pas tant que l'honneur de ses fers;
Combien ie beniray cettt heureuſe iournée, Si ie puis l’attirer ſoxsles loiæ d Hymenée:	Combien ici beniray cett heureuse journée, Si tu puis l'attirer souoxsles loisæ d' Hymenée:
Cur m'en promettre rien qu’à ces conditions, Seroit d’vn vain eſpoir flatter mes paſſiens;	Cur m'en promettre rien qu'à ces conditions, Serait d'un vain espoir flatter mes passiens;
I’ay parſon entretien ſon humeur reçogneuë.	J'ai parson entretien son humeur reçogneuë.
Iamais vne beauté ne fut ſi retenuë, Et la ſeul.	Jamais une beauté ne fut si retenue, Et la seul.
vanjon jai tamomon ſoucy, C’eſt que ſans me cognoiſtre elle me traitte ainIure qu’il n’eſt franchiſi à monbumeur lgale, Qu’elle tient ce poinçon de ma main liberale, Que i'habite en ces lieux, qu'elle me tognoſi fort, Qu'Orazie eſt ma femme, & que ie ſeins à tort:	vanjon jai tamomon souci, C'est que sans me connaître elle me traite ainIure qu'il n'est franchisi à monbumeur lgale, Qu'elle tient ce poinon de ma main libérale, Que j'habite en ces lieux, qu'elle me tognosi fort, Qu'Orasie est ma femme, et que ie seins à tort:
La ie reſtois muet;	La ici restais muet;
mais auecque ces ſables, Elle meſtoit auſſi des diſcours veritables, Car elle Cuit mon nom, & cojnoiſt monpays;	mais auecque ces sables, Elle mestoit aussi des discours véritables, Car elle Cuit mon nom, et cojnoist monpays;
Qus cette obſcurité rend mes ſent eibays.	Quus cette obscurité rend mes sent éibays.
ERGASTE.	ÉRGASTE.
Il eſt ſaoulmaintenant, il diſcourt à ſon aiſe, Mepuis je contenter, faut il que ie me taiſe?	Il est saoulmaintenant, il discourt à son aise, Mepuis je contenter, faut -il que Seigneur me taise?
Dieux!	Dieux!
le ſaperbe eſprit, ie marche ſurſespas Il me void, il m’entend, & ne me parle pas:	le saperbe esprit, je marche sursépas Il me voit, il m'entend, et ne me parle pas:
Le faut-il aborder?	Le faut-il aborder?
quelle preignante iniure Allegera mon cæur en li faim que i’endure.	quelle préignante injure Allegera mon cæur en li faim que j'endure.
MENECHME.	MENCHME.
Que veut cet importun!	Que veut cet importun!
ERGASTE.	ÉRGASTE.
Ouy i'ay fort merité Qu’auiourd huyy vous blaſmiez men importunité, Ie vous deuſſe eſpargner en l’humeur dõt vous eſtes, Et ie ſuistout chargé des dons que vous me fai1fes.	Oui j'ai fort mérité Qu'aujourd' hui vous blâme men importunité, Je vous dusse épargner en l'humeur dont vous êtes, Et ie suistout chargé des dons que vous me fait1fes.
Vous m’auez fait diſner de mets ſi delicas, Que ie ne fis iamais vn ſi friand repas, Ixſe aniourd huy de vous auec trop de licence, Vous eſtes ruine de payer ma deſpence.	Vous m'avez fait dîner de mets si délicas, Que je ne fis jamais un si friand repas, Ixse anjourd hui de vous était trop de licence, Vous êtes ruine de payer ma dépense.
MENECHME.	MENCHME.
Que conte cet yurongne!	Que conte cet yurongne!
ERGASTE.	ÉRGASTE.
Ha !	Ha !
que vous auez tort, Pourquoy m’obligiez-vous à m'enyurer ſi fory Vous déuiez m’eſpargner, & deſendre à la table, Quie l'ou me prodiģaſt vn vin ſi deleſtable:	que vous avez tort, Pourquoi m'obligiez-vous à m'enivrer si fori Vous deviez m'épargner, et désendre à la table, Quie l'ou me prodiģast un vin si délestable:
Olcombieu de vapeurs oſfiſquent ma raiſou, Et que i’auray de pe ne à trouuer ma maiſon!	Olcombieu de vapeurs osfisquent ma raisou, Et que j'aurai de pe ne à trouver ma maison!
MENECHME.	MENCHME.
Adieu, ſuy ton chemin?	Adieu, suis ton chemin?
ERGASTE.	ÉRGASTE.
Peſte de tousles hommes, Eſprit le plus meſchant du ſeiour où nous ſommes, Pahmmmnpamt vaypie aiſcours, eſſronté?	Peste de tousles hommes, Esprit le plus méchant du séjour où nous sommes, Pahmnpamt vaispie aiscours, essronté?
Ne te ſufit i'pas de m’auoir affronté?	Ne te suffit j'pas de m'avoir affronté?
Voyez quelle ſurpriſe en ſon viſage eſt peinte, Il ne ſe ſouuient pas duſuiet de ma plainte:	Voyez quelle surprise en son visage est peinte, Il ne se souvient pas dusuiviet de ma plainte:
I’ay tort de l’accuſer, il m’attendoit icy, Il n’auois pas deſſein de me quitter ainſi, Il trouus en ma preſence vn bien ſort delectabie.	J'ai tort de l'accuser, il m'attendait ici, Il n'avais pas dessein de me quitter ainsi, Il trouus en ma présence un bien sort délectabie.
N’eſt il pas vray, reſponds, infame, deteſtable, Parle, reproche moy d'eſtre venu trop tard, Dy qu’un chien par malheur a deuoré ma part, Qu on a pour me trouaer fait tous le tour de Liſle.	N'est il pas vrai, répond, infâme, détestable, Parle, reproche moi d'être venu trop tard, Dis qu'un chien par malheur a dévoré ma part, Qu on a pour me trouvaer fait tous le tour de Lisle.
Mais qu’on ne s’eſt donné qu’vne peme inutile, Dy moyque tu n’as fait qu’vn ennupeur repas, Que iu n’es point content quand tu ne me voy pas, Vien me conter encor cette vaine chimere, Infame, diſſolu, deteſtable, adultere;	Mais qu'on ne s'est donné qu'une peme inutile, Dis -moique tu n'as fait qu'un ennupeur repas, Que ju n'es point content quand tu ne me vois pas, Viens me conter encor cette vaine chimère, Infâme, dissolu, détestable, adultère;
Ta ſemme, deibordé, ſp̧aura comme tu vis, Et ie luy vais conter ce que tu luy rauis.	Ta semme, deibordé, spaura comme tu vis, Et tu tu tu vis , Et tu lui ravis.
MENECHME.	MENCHME.
De quoy vient eét yurongne eſtourdir mon oreille, Et quelle extrauarauce à la ſienne eſt pareille?	De quoi vient eét yurongne étourdir mon oreille, Et quelle extravarauce à la sienne est pareille?
Où nous conduit le ſort, où ſommes nous venus, Et que veulent ces fous à des gens intogneus?	Où nous conduit le sort, où sommes nous venus, Et que veulent ces fous à des gens intogneus?
ERGASTE.	ÉRGASTE.
Il eſt vray que i’ay tort, ie ne te puis cognoiſtre, L’affront que i’ay reçeule fait aſſez pareſtre, L'effet dément touſicurs les diſcours que tu fais, Ta bource & ton eſprit ne s’accordent iamais, On te iuge à te voir le plus libre du monde, Car ton humeur fardée en paroles abonde, Ta voix n’eſt point auure, elle promet touſiours, Mais tu ne nous repais que de ces vains diſcours, Et nous n’auonsiamais eſprouué tes largeſſes, Lors que nous eſperio is l’eſſet de tes promeſſes, Quand on ouureles mains, & qu’on croit tout tenir, Quelqu’affairt impreueu t’empeſche de venir, On t'a voléta bource, ou tul as oubliée Enſin, ton auarice eſt touſiours paliée.	Il est vrai que j'ai tort, Seigneur ne te puis connaître, L'affront que j'ai reçeule fait assez paraître, L'effet dément toujours les discours que tu fais, Ta bource et ton esprit ne s'accordent jamais, On te juge à te voir le plus libre du monde, Car ton humeur fardée en paroles abonde, Ta voix n'est point auure, elle promet toujours, Mais tu ne nous repais que de ces vains discours, Et nous n'avons esprouué tes largesses, Lors que jours esperio esset de tes promesses, Quand on ouureles mains, et quon croit tout tenir, Quelqu’affairt impreueu empêche de venir, On t'a voléta bource, ou as que Ensin, ton auarice est tousiours péri.
Qui ne te croiroit pas, qui n'euſt dit ce matiu, Que tu me preparois vnſuperbe feſtin, Que tes intentions eſtoient ſans artifices, Et que rien ne deuoit eſçaler nos delices:	Qui ne te croirait pas, qui n'eût dit ce mativ, Que tu me préparais unsuperbe festin, Que tes intentions étaient sans artifices, Et que rien ne devait esçaler nos délices:
N’us tu pas ordonné qu’on tint le diſner preſt?	N'us tu pas ordonné qu'on tint le dîner prêt?
Et n’a t on pàs promis d’accomplir cet arreſt?	Et n'a t on pays promis d'accomplir cet arrêt?
De quoy peut on douter apres tant d’apparence Et qui ne te croiroit en pareille occurrencet Ie ne t'eſpioispoint, lors que ie te ſuiuois, Et ie diſnois deſia par l’eſporr quei auois, Nous eſtions au palais, où tun as point d'aſfaiOù tu n’auoisquebl'u prtie aduerſaire, Où ta ſeule auarice auoit dreſſé tes pas, Oà tout noſtre procez eſtoit pour vn repas;	De quoi peut -on douter après tant d'apparence Et qui ne te croirait en pareille occurrencet Je ne t'espiaispoint, lors que personne te suivais, Et ie dînais déjà par l'esporr quei avais, Nous étions au palais, où tun as point d'asfaiOù tu n'avaisquebl'u prétie adversaire, Où ta seule avarice avait dressé tes pas, Çà tout notre procès était pour un repas;
Tu taſchois d’eſchapper;	Tu tâchais d'échapper;
ô la belle victoire!	ô la belle victoire!
Qu'vn repas eſpargné luy proture degloire!	Qu'un repas épargné lui proture dégloire!
MENECHME.	MENCHME.
Quede ſens & d'eſprit cet homme eſt depouruou, Que me conte te fou que ie n’ay iamais veu?	Quede sens et d'esprit cet homme est dépourvou, Que me conte te fou que ici n'ai jamais vu?
ERGASTE.	ÉRGASTE.
Ta ne m’as iamais veu?	Ta ne m'as jamais vu?
MENECHME.	MENCHME.
No,	No,
ERGASTE.	ÉRGASTE.
Qui mey?	Qui mei?
MENECHME.	MENCHME.
De ma vie.	De ma vie.
ERGASTE.	ÉRGASTE.
Tune mo cognoispas?	Tune mo connaispas?
MENECHME.	MENCHME.
Et n’en ay point d'enuie;	Et n'en ai point d'envie;
I'arriue ſraiſchement en ce bord eſtranger.	J'arrive sraîchement en ce bord étranger.
ERGASTE.	ÉRGASTE.
Il t'eſtpermis de rire,à moy de me vanger;	Il t'estpermis de rire,à moi de me venger;
Adieu, tout l’Vniuers ne me pourroit diſtraué Du deſſein que m’inſpire vne iuſte colere, Tu te repentiras de m’auoir fait ieuſner, Et tu te ſouuiendras d’vn ſemblable diſner.	Adieu, tout l'Univers ne me pourrait distravé Du dessein que m'inspire quelque juste colère, Tu te repentiras de m'avoir fait jeûner, Et tu te souviendras d'un semblable dîner.
Il s’enva.	Il s'enva.
MENECHME.	MENCHME.
Dieux !	Dieux !
ie croy qu'à deſſein cette fourbe eſt tiſt ſuë, Et ie commente bien d'en redouter l'iſſuë:	Ne crois qu'à dessein cette fourbe est tît sue, Et cament commente bien d'en redouter l'issue:
Que veulens tous ces gens que ie ne cognoy pas?	Que veulends tous ces gens que ici ne connais pas?
Mais quelle ſemme encor dreſſe vert moy ſes pas, Fuyons, ſaus repartir à ſa moindre parole, I’entreprendrouplutoſt mille fous, qu’vne fole,	Mais quelle semme encor dresse vert moi ses pas, Fuyons, sa répartir à sa moindre parole, J'entreprendrouplutôt mille fous, qu'une sole,
SCENE III.	SCÈNE III.
ORAZIE.	ORAZIE.
NRains-tuque mon diſſein ſoit de te retes C nir?	NRains-tuque mon dissein soit de te retes Ç nir?
Croy, que ſi ie te ſuy, tu peux bien reuenir;	Crois, que si ici te suis, tu peux bien revenir;
Va mary débordé, careſſer tes amantes, Et redonne à tes yeux leurs lumieres abſentes, Ie beniray cent fois ces objetseſfrontez, I’aime tatrahiſon, i’ayme tes voluptez;	Va mari débordé, caresser tes amantes, Et redonne à tes yeux leurs lumières absentes, Je bénirai cent fois ces objetsesfrontés, J'aime tatrahison, j'aime tes voluptés;
Ie veux bié que iamaisle remord ne te touche, Que tu craignes ma veuë, & deteſtes ma couche, Que nul contentement n’eſgale tesplaiſirs, Et qu’on accorde tout à tes ſales deſirs, Si i’obtiens ce bon heur, apres tant de ſupplices, Que tu rendes l’eſprit au milieu des delices, que iamais ton obiect ne ſe preſente à moy, Que ta mort me deliure, & degage ma ſoy;	Je veux bié que jamaisle remord ne te touche, Que tu craignes ma vue, et détestes ma couche, Que nul contentement n'égale tesplaisirs, Et qu'on accorde tout à tes sales désirs, Si j'obtiens ce bon heur, après tant de supplices, Que tu rendes l'esprit au milieu des délices, que jamais ton objet ne se présente à moi, Que ta mort me délivre, et dégage ma soi;
Helas quelle fortune egale ma miſere?	Hélas quelle fortune égale ma misère?
Que la loy de l’Hymen eſt vne loyſeuere, Et qu'on eſt ennimy deſon contentement, Lors qu’à ſa tirannie on preſte leſerment;	Que la loi de l'Hymen est une loyseuere, Et qu'on est ennimi deson contentement, Lors qu'à sa tyrannie on prête leserment;
Vne femme promer d’endurer, de ſe taire, De renoncer à loy, de viure ſolitaire, Aloriqu'elle promet de craindre ſon eſpoux, Vne nuict ſeulement eſt ce qu’elle a de doux;	Une femme promer d'endurer, de se taire, De renoncer à loi, de vivre solitaire, Aloriqu'elle promet de craindre son époux, Une nuit seulement est ce qu'elle a de doux;
Ses plaiſirs ſont finis auſſi-toſt que la dance, Et la ſec onde nuict ſon vefuage commence;	Ses plaisirs sont finis aussitôt que la dance, Et la sec onde nuit son vefuage commence;
Depuis que ſon mary la tient en ſesliens, Il a bien toſt repris ſes chemins anciens, Il deſdaigne bien toſt ſa grace & ſon merite, Pour reueir Amarante, ou Philis, ou Carite, Et nous voyonsbien tiſt noſtre bien conſommé, Par l’impudique ardeur dont il eſt enflammé.	Depuis que son mari la tient en sesliens, Il a bien tôt repris ses chemins anciens, Il dédaigne bien tôt sa grâce et son mérite, Pour reueir Amarante, ou Philis, ou Carite, Et nous voyonsbien tît nôtre bien consommé, Par de ur dont il est enflammé.
SCENE IV.	SCÈNE IV.
ERGASTE, ORAZIE.	ÉRGASTE, ORAZIE.
ERGASTE.	ÉRGASTE.
Adame, en quel eſtat vous verrons nous M redaite, Si dans peu voſtre iſpouxne change de conduite;	Adame, en quel état vous verrons nous M redaite, Si dans peu votre ispoux change de conduite;
On murmure par tout de ſes desbordemens, Onrit de ſa folie, & l’on plaint vos tourmens;	On murmure par tout de ses débordements, Onrit de sa folie, et l'on plaint vos tourments;
Il acquiert tous lesiours de uouuelles maiſtreſfus.	Il acquiert tous jours de elles maîtresfus.
Il achepte leur veui & leurs moindr es carlſſes;	Il achette leur vi et leurs moindr es lès;
Vne telle manie a ſes ſens oceupez, Qu’il aura dans vn an tous vos biens diſſipez, Diuertiſſe le Ciel ſemblable prophetie;	Une telle manie a ses sens oceupez, Qu'il aura dans un an tous vos biens dissipés, Divertisse le Ciel semblable prophétie;
Mais i’en dirois beaucoup ſans nommer qu’Erotie, Qui ſans rien accorder à ce cœur diſſolu, A ſur luy touteſois vn empire abſolu, Et le deſir qu’il a de vaincre cette belle, Fait que ſa libre humeur prodigue tout pour elle:	Mais j'en dirais beaucoup sans nommer qu'Erotie, Qui sans rien accorder à ce cœur dissolu, A sur lui toutesais un empire absolu, Et le désir qu'il a de vaincre cette belle, Fait que sa libre humeur prodigue tout pour elle:
Encore à ce matin, i’ay veu cet inconſtant, Luy donner ce poinſon que vous cheriſsiez tant, Que chacun eſtimoit, & de qui la parure Adiouſtoit tant de grace à voſtre cheuelure, Ie ſray bien qu’elle eſt ſourde à ſes vaines amours, Qu'elle rit de ſes vœux, mais elle prend touſjeurs.	Encore à ce matin, j'ai vu cet inconstant, Lui donner ce poinson que vous chérissiez tant, Que chacun estimait, et de qui la parure Adioustait tant de grâce à votre cheelure, Je sais bien qu'elle est sourde à ses vaines amours, Qu'elle rit de ses vœux, mais elle prend toujours.
ORAZIE.	ORAZIE.
Helas!	Hélas!
tu m’aduertis d’vn malheur ſansremede, Il eſt deuenutel, qu’il faut que taut luy cede, C’eſt vn arbre ployé qu’on ne peut redriſſer.	tu m'avertis d'un malheur sansremède, Il est devenutel, qu'il faut que taut g cede, C'est un arbre ployé qu'on ne peut redrisser.
I’en uy plus de douleur que tunc peux penſer;	J'en est plus de douleur que tunç peux penser;
Mais dant te deplaiſir, dont mon ame eſt atteinte, Ie n’ay pour tout nceur, quunc inutile plamnte I'ay bien veu te ma tin, quandi’ay prismethe.	Mais dant te déplaisir, dont mon âme est atteinte, Je n'ai pour tout nceur, qu' inutile plamnte J'ai bien vu te ma tin, quandi'ai prismethe.
bits.	bits.
Qu'il auoit deteurné le poinçon que tu dis, Et ie l’entendois là, mais ſi toſt qu’il m’a veuë, Il a preſſe le pas, & detoumé la veuë.	Qu'il avait déteurné le point qu' entendais là, Mais sitôt qu'entendais là, mais si tôt qu'il m'a vue, Il a presse le pas, et détoumé la vue.
ERGASTE.	ÉRGASTE.
Le voicy quiriuient:	Le voici quirivient:
O RAZIE.	Ô RAZIE.
O Cieltô iuſtes dieux!	Ô Cieltô justes dieux!
Que n’offrez-vous plutot vn ſerpent à nus yeux!	Que n'offrez-vous plutôt un serpent à nus yeux!
SCENE V MENECHME rauy.	SCÈNE V ENECHME ravi.
ORAZIE.	ORAZIE.
ERGASTE.	ÉRGASTE.
MENECHME rauy, parle ſeul.	MENECHME ravi, parle seul.
N finceſſe Themis de troubler ma penſee, EL’heure que i’ay donnee eſt à dimy paſſee, Donne tréus à mes ſoins le reſte de ce iour, Souffre que ie l’imploye en va procez d’amour:	N fincesse Themis de troubler ma pensée, ÉL'heure que j'ai donnée est à dimy passée, Donne tréus à mes soins le reste de ce jour, Souffre que je l'imploie en va procès d'amour:
I’ayme laplus ſarouche, & la plus inhumaine, Que ie pouuoischoſir pour l’obiect dema peine.	J'aime laplus sarouche, et la plus inhumaine, Que était pouuoischosir pour l'objet dema peine.
L'inſenſible ſe rit despleurs deſes amant, On ſouffre à ſon ſuiet d inutiles tourmens, Onperd ſon cœur pour elle, & ſi l’on ſe propoſe D'en dumander le prix, on perd auſii ſa cauſe:	L'insensible se rit dépleurs deses amant, On souffre à son sujet d inutiles tourments, Onperd son cœur pour elle, et si l'on se propose D'en dumander le prix, on perd ausi sa cause:
En vain pour la combattre on prend tant de ſoucy, I Car eſtant la partie, elle eſt le iuge auſii;	En vain pour la combattre on prend tant de souci, I Car étant la partie, elle est le juge aussi;
Ierit, iel entretiens, ie vante ſes merites, Maisie n’oze paſſer cesétroitteslimites, I’ay de mille preſens aſſailly ſa riģueur, Et ces foibles moyens ne touchent point ſon tœur.	Jérit, jel entretiens, on vante ses mérites, Maisie n'oze passer cesétroitteslimites, J'ai de mille presens assailly sa riveur, Et ces faibles moyens ne touchent point son tœur.
EMGASTE.	ÉMGASTE.
Entindiz-vousces mots?	Entindis-vousces mots?
MENECHME rauy.	MENCHME ravi.
Mais eu vain on mo blaſme, La deuſſay ie enrichir aux deſpens de ma ſomme, Me deuſt elle reduire à la neceßité, Ie nepuis la main vuide aller voirſa beauté.	Mais eu vain on mo blâme, La dussa iB enrichir aux dépens de ma somme, Me deust -elle réduire à la nécessité, Je nepuis la main vide aller voirsa beauté.
ORAZIE le ſurprenant.	ORAZIE le surprenant.
C’eſt viure comme i' ſaut.	C'est vivre comme j' saut.
MENECHME rauy.	MENCHME ravi.
O ſurpriſe importune!	Ô surprise importune!
ORAZIE.	ORAZIE.
Et nourſeronseuſemble vne heureuſe fortunes Voila pour m'obliger à vous eſtimer fort, C’eſt bien là le moyen de nour mettre d’accord.	Et nourseronseusemble une heureuse fortunes Voila pour m'obliger à vous estimer fort, C'est bien là le moyen de nour mettre d'accord.
MENECHME rauy, tout bas.	MENECHME ravi, tout bas.
O Dieux!	Ô Dieux!
ie ſu iperdu, quelle aſſez prompiu ruſe En cette octaſiun meſeruira d'excuſe?	Elle su iperdu, quelle assez prompive ruse En cette octasiun meservira d'excuse?
Dequoy m'accuſes-tu?	Dequoy m'accuses-tu?
ORAZIE.	ORAZIE.
Derien, ame ſaniſoy, Et ton protre d ſoours t’at tuſe aſſet ſans moy.	Dérien, âme sanisais, Et ton protre d oours t'at tuse asset sans moi.
Deſaduous, eſtouté, cet aſfront qui metouche, Iure que d'auiourd'h y tu n’as ouuert la bouche, Repren maialouſie ie le parfaiteſpeux!	Désaduous, estouté, cet asfront qui métouche, Jure que d'aujourd'h y tu n'as ouvert la bouche, Repren malousie ici le parfaitespeux!
Qe i’ay peu de raiſon d’exciter ſon courroux!	Que j'ai peu de raison d'exciter son courroux!
Q' i'accroil noin oesbur des peines eſtrâçes.	QU' accroil noin oesbur des peines estrâçes.
Qe ſafidelité merite de louanges Si ſes veur out receux, & ſes trauaux benis, Il nous amaſera des treſors infinis.	Que safidélité mérite de louanges Si ses veur out receux, et ses travaux bénis, Il nous amasera des trésors infinis.
MENECHME rauy.	MENCHME ravi.
Quoy!	Quoi!
ce que iediſois a ton ame abuſce?	ce que iedisois a ton âme abusée?
Tu manques bien d’eſprit, tey qu’on tient ſi ruſee;	Tu manques bien d'esprit, tei qu'on tient si ruse;
L’as-je dit ſans deſſein, ne te veyois- iepas Eſcouter mes diſcours, & marcher ſur mes pes!	L'as-je dit sans dessein, ne te veiais- 1pas Écouter mes discours, et marcher sur mes pes!
Conſerue ſi tu veux cette ereance vaine, Ie ne parlois ainſi que pour te mettre en peine, Q pour nourrir la peur dont ton cœur eſtronOoromlamioininpait in euſt ainſi iuaé;	Conserve si tu veux cette fréance vaine, Je ne parlais ainsi que pour te mettre en peine, Q pour nourrir la peur dont ton cœur étronOoromlamioininpait in eût ainsi juaé;
Mais quand iuſqu'à ce point vn eſprit eſt malade, Il n'eſt rien au’aiſemem il ne ſe perſuade, Tu cros m’auoir ſurpris, quand tu m'as eſcouté, Et tu tiens mes diſeours pour vne verité.	Mais quand jusqu'à ce point un esprit est malade, Il n'est rien au'aiemem il ne se persuade, Tu cros m'avoir surpris, quand tu m'as écouté, Et tu tiens mes diseours pour une vérité.
ERGASTE.	ÉRGASTE.
O qu’il eſt aſſeuré!	Ô qu'il est assuré!
MENECHME rauy, luy faiſant ſigne.	MENECHME ravi, Seigneur faisant signe.
Tu nourrisſacolere.	Tu nourrissacolère.
ERGASTE.	ÉRGASTE.
Voyez, que d'vn clein d'æil il m’inuue à me tant.	Voyez, que d'un clein d'æil il m'inue à me tant.
3	3
MENECHME rauy.	MENCHME ravi.
Que dit tet inſenſé?	Que dit tet insensé?
ERGASTE.	ÉRGASTE.
Queie ſuis ſarisf it, H’eſtant ſi bien vangé du tour que tu m’as fait;	Que suis sarisf it, H'étant si bien vengé du tour que tu m'as fait;
Exalte maintenant cette fourbe ſubtile, Va ſaire ced ſcours à tous ceux de cette iſte;	Exalte maintenant cette fourbe subtile, Va zaïre céd scours à tous ceux de cette iste;
Va te vanter par tout de m’auoir fait ieuſner, Ieiure maintenant de te le pardonner, Tu n’en diras point tant que ie ne le confeſſe, I'entiray lepremier, quelque faim qui treſſe.	Va te vanter par tout de m'avoir fait jeûner, Jeivre maintenant de te le pardonner, Tu n'en diras point tant que je ne le confesse, J'entirai lepremier, quelque faim qui tresse.
MENECHME rauy, Dieux!	MENECHME ravi, Dieux!
que puir-ie comprendre à de ſi vains propos, Et qui porte cesgens à troubler mon repos?	que puir-je comprendre à de si vains propos, Et qui porte cesgents à troubler mon repos?
ERGASTE.	ÉRGASTE.
Me croyoir-tu d’humeur à ſouffrir cel outrage?	Me croyoir-tu d'humeur à souffrir cel outrage?
Eſtimois tu qu'Ergaſte eut ſi peu de courage?	Estimais -tu qu'Érgaste eut si peu de courage?
Croy que de quelque ſoifque ie ſois embraſé.	Crois que de quelque soifque je sois embrasé.
I'ay bien de quoy l’éteindre, & ie t’euſſeexeuſe;	J'ai bien de quoi l'éteindre, et Elle t'eusseexeuse;
Mais turis.	Mais turis.
& tu ſeins de ne mepascognoiſtre.	et tu seins de ne mepascognoistre.
Quand tu i’es enyuré tu m’accuſes de l’être, Et ie me pourrois taire, eſtant ainſi raillé?	Quand tu j'es enivré tu m'accuses de l'être, Et personne me pourrais taire, étant ainsi raillé?
Il n’eſt ſi patient qui mel euſt conſeillé;	Il n'est si patient qui mel eût conseillé;
I’ay parle comme il faut de ton mauais ménage, Et ſans que que reſped i'en dirois d'auantege.	J'ai parle comme il faut de ton mavais ménage, Et sans que que respéd j'en dirais d'auantege.
ORAZIE.	ORAZIE.
Traiſtre!	Traître!
qui m'eſtois chez plus qu’on ne peut penſer.	qui m'étais chez plus qu'on ne peut penser.
Tu me rauis mon bien aſin de m’oſfenſer?	Tu me ravis mon bien asin de m'osfenser?
Il faut que ie te ſerue à çagner tes maiſtreſſes.	Il faut que Seigneur te serve à çagner tes maîtresses.
De ce qui m appartient, tu leur faite des lar.	De ce qui m appartient, tu leur faite des lar.
geſſes, Ie verray mes ioyaux leur ſeruir d’ornement;	gesses, Je verrai mes joyaux leur servir d'ornement;
C’eſt là trahirſa ſemme aſſez ouuertement.	C'est là trahirsa semme assez ouuertement.
Ne dois ie point außi faire ton Amboſſade, Ne deſire-tu point que ie les perſuade?	Ne dois Seigneur point aussi faire ton Ambossade, Ne désire-tu point que ici les persuade?
Ouy ie veux eſpargner les pas de les vaiett, Et ie leur porteray moy méme tes poulets;	Ou ie était épargner les pas de les vaiett, Et tu leur porterai moi -même tes poulets;
Ie declare la guerre à leur humeur farouche, Ie prendray le ſoucy de les mettre en ta couche, Apres, i’iray par tout publier ta vertu :	Je déclare la guerre à leur humeur farouche, Je prendrai le souci de les mettre en ta couche, Après, j'irai par tout publier ta vertu :
Eſt ce aſſez t’obliger s'm eu remertieras.	Est -ce assez t'obliger s'm eu remertieras.
.	.
tu.	tu.
MENECHME rauy.	MENCHME ravi.
Erfin c’eſt troplong temps choquer ma patienPa leplus c’airement, ou garde le ſilence:	Erfin c'est troplong temps choquer ma patienPa leplus c'airement, ou garde le silence:
¶et ay-iefatt	¶et ai-jefatt
ORAZIE.	ORAZIE.
Ta m'as,	Ta m'as,
MENECHME rauy.	MENCHME ravi.
294	294
ORAZIE.	ORAZIE.
Volimon poinfon.	Volimon poinfon.
MENECHME rauy.	MENCHME ravi.
Eroie en veut vn de la meſme facon, Et renuoyrale tien au plus tard das vne heure.	Eroie en veut un de la même façon, Et renvoirale tien au plus tard das une heure.
ORAZIE.	ORAZIE.
Pouuoit ilrencontrer vne excuſe meilleure?	Pou vrencontrer une excuse meilleure?
Pourquoyl as-tu porté ſans m’en donner aduist Ie ne m'ingere point de preſter tes habits, Ie cheris ce que i’ay, i en vſe, i’en diſpoſe, Et croyne teuoir point me meſler d’autre thoſe, Quene vis-tu de meſme?	Pourquoil as-tu porté sans m'en donner avist Je ne m'ingère point de prêter tes habits, Je chéris ce que j'ai, y en use, j'en dispose, Et croine toir point me mêler d'autre those, Quène vis-tu de rendre?
MENECHME rauy.	MENCHME ravi.
A quey tant deſony?	A quei tant désoni?
De sepas ſi tu veux ie lerapportei y.	De sepas si tu veux ici leraportei y.
ORAZIE.	ORAZIE.
C’eſt parler ſarement, & ſi tu ne l’apportes, Tu rentrerai bien tard, ou tu rompras lesportes.	C'est parler sarement, et si tu ne l'apportes, Tu rentrerai bien tard, ou tu rompras lesportes.
MENECHME rauy, entre chez Erotie.	MENCHME ravi, entre chez Erotie.
Ie reuins, attend moy.	Je revins, attend moi.
ERGASTE.	ÉRGASTE.
Madame, de quelprix Recompenſeret-vous leſou.	Madame, de quelprix Rompenseret-vous lesou.
y quei' ay vris Laiſſez vous ſaniloyer va ſi digne ſeruice?	y quei' ai vris Laissez vous saniloyer va si digne service?
ORAZIE.	ORAZIE.
Ie te recognoiſtray par vn ſemblable office, Et te redray le bien qu’auiourd huy tu meſaiſ, St ie puis deſcouurir qu’on t vn ei tmus.	Je te reconnaîtrai par un semblable office, Et te redrai le bien qu'aujourd' au tu mesais, St ie puis découvrir qu'on t un ei mus.
Elle s’en va.	Elle s'en va.
ERGASTE.	ÉRGASTE.
Te ſuis dont en danger de longuement attendre, Car ne poſſedantrien, que me pourroit en prendre?	Te suis dont en danger de longuement attendre, Car ne possédantrien, que me pourrait en prendre?
Il faudroit relener d’une ſeuere loy, Pour mourird vn larcin qu’on auroit fait chez moy.	Il faudrait relener d'une sévère loi, Pour mourird un larcin qu'on aurait fait chez moi.
Où faut-il mainten unt que mon eſpoir ſe foude, Ie ſuis à cette fois leplis confus du monde;	Où faut-il mainten unt que mon espoir se foude, Je suis à cette fois leplis confus du monde;
Que puis-ie, malheureux, eſptrer deſormais?	Que puis-je, malheureux, esptrer désormais?
Menechme n’iſt pathommi à me traitter ialMnn.	Menechme n'ist pathommi à me traiter jalMn.
I’auois tort dirriter vn eſprit ſi ſenſible, A des gens qui n’ont rien, la vengean t el nuiſible.	J'avais tort dirriter un esprit si sensible, À des gens qui n'ont rien, la vengean t el nuisible.
La faim eſt bien plus dure à porter qu’vn affront, Et ie deuois bien plus à mes dents, qu’à mon front.	La faim est bien plus dure à porter qu'un affront, Et tu devais bien plus à mes dents, qu'à mon front.
Adieu, cheremsiſon, zdieutoute maioye, RLaison ouure, c’eſt luy, paſiõs qu’il ne me voyé,	Adieu, cheremsison, zdieutoute maie, RLaison ouvre, c'est toujours, pasions qu'il ne me voyé,
SCENE VI EROTIE.	SCÈNE VI EROTIE.
MENECHME rauy.	MENCHME ravi.
MENECHME rauy.	MENCHME ravi.
Vez de moy, Madame vn meilleur ſenti  meut, L’amour n'a pai ſi ſort treublé mon iugemeut, S’il me deuoit reduire à ce pont de manie, Ie me dégagerois de ſa force inſinie;	Vez de moi, Madame un meilleur senti meut, L'amour n'a pai si sort treublé mon jugement, S'il me devait réduire à ce pont de manie, Je me dégagerais de sa force insinie;
Mairi ay desyeux encore pour voir ce que ie faits, Ie ſçay que de ce pas i'arriue dupalais:	Mairi ai desyeux encore pour voir ce que ie faits, Je sais que de ce pas j'arrive dupalais:
On ſe propoſe en vain de tromper ma memoire, Ce que ie n’ay point fait, ie ue le ſpaureis croire.	On se propose en vain de tromper ma mémoire, Ce que tu n'ai point fait, en ue le spaureis croire.
EROTIE.	EROTIE.
Vous nil auex paspris pour le ſaire émaillert	Vous nil auex paspris pour le zaïre émaillert
MENECHME rauy Que vouefeiſtauonteen l'art de vous railler, Si vous auez porté la qualue d'lpouſe, Figurez-vous l’humeur d’une ſemme ialouſe, Et que ſi ie nerends ce poinçon que i'ay pris, La mienne tout letiourt m'étourdira de cris;	MENCHME rav Que vouefeistavonteen l'art de vous railler, Si vous avez porté la qualue d'Eouse, Figurez-vous l'humeur d'une semme jalouse, Et que si ie rends ce poinçon que j'ai pris, La mienne tout letiourt m'étourdira de cris;
Exemptez-moy des bruits de cette femme Lauare, Ie vous en prometi vn, plus exquis, & plus rare.	Exemptez-moi des bruits de cette femme Lavare, Je vous en prometi un, plus exquis, et plus rare.
EROTIE.	EROTIE.
Monſieur ien'entends rien à ces ieux deſplaiſans, Re m'importunez plus, & gardez vos preſinn Voſtre ioyeuſe hum u t'eſt aſſez exereée, D'autre, ſoins maintenant m’occuppeni li pen, Adieu.	Monsieur yen attends rien à ces jeux déplaisants, Re m'importunés plus, et gardez vos présinn Votre joyeuse humenu t'est assez exereée, D'autre, soins maintenant m'occuppeni li pen, Adieu.
le.	le.
MENECHME rauy.	MENCHME ravi.
Madame, vn mot, ô rigoureux deſtin!	Madame, un mot, ô rigoureux destin!
Qu’vn aſtre inferiuné m'eſclaire ce matin;	Qu'un astre infériuné m'éclaire ce matin;
O Ciel!	Ô Ciel!
que nous deuons reuerer ta iuſtice, Et que tu me punis d’vn ſeuere ſupplice:	que nous devons révérer ta justice, Et que tu me punis d'âme sévère supplice:
Où me dois je adreſſer?	Où me dois je adresser?
que dois je deuenir?	que dois je devenir?
Quel aduis ſaut ilpredre, & quel el emin tenir?	Quel avis saut ilpredre, et quel él emin tenir?
Chatun me traite en ſou, tout le monde me vame, On me ferme la porte enquelque part que i’ailTout couſpire à venger le velque i’ay commit, Ilme faut la deſſus eenſulier met amys.	Chatun me traite en sou, tout le monde me vame, On me ferme la porte enquelque part que j'ailTout couire à venger le velque j'ai commit, Ilme faut la dessus éensulier met amis.
ACTE IV.	ACTE IV.
SCENE PREMIERE.	SCÈNE PREMIÈRE.
MENECHMEſoſicle, ORAZIE.	MENCHMEsosicle, ORAZIE.
MENECHME ſoſicle.	MENCHME sosicle.
NOmbien ie perds de pasà cherther MoſſeD nie, Il n’arien en horreur tant que ma compagnie, Il ne i'eſtime ſerf qu’alors qu’il ſuit mespas;	NOmbien Dieu perds de pasà cherther MosseD nie, Il n'arien en horreur tant que ma compagnie, Il ne j'estime serf qu'alors qu'il suit mespas;
Il eſt en liberté quand il ne me void pas, Il ſçait tout, il a tout, & i’ay peu de prudence, D’honorer vn captif de tant de co fidence, Ie cognoisſou humeur, & ſuis mauais deuin, S’il ne i’enſeuelit maintenant dans le uin.	Il est en liberté quand il ne me void pas, Il sait tout, il a tout, et j'ai peu de prudence, D'honorer un captif de tant de co fidence, Je connaissou humeur, et suis mauais devin, S'il ne j'ensévelit maintenant dans le uin.
ORAZIE vient à ſa porte, & le voyant Il reuient, ie l'auiſe,	ORAZIE vient à sa porte, et le voyant Il revient, jusqu'avise,
MENEGEIME ſoſicle.	MENEGEIME sosicle.
Anparauart qu’ilſorts.	Anparavart qu'ilsorts.
ORAZIE.	ORAZIE.
Et ie dois à mes cris ce pointon qu’il rapporte,	Et ici dois à mes cris ce pointon qu'il rapporte,
MENECHME.	MENCHME.
Eesobiets doubleront, il vecra deux ſoleils, En moy ſeul il vcrra deux Menechmes pareili Il pert entre lespotstout ſoucy de me ſuiure, Ily paſſeletiours, & n’ex ſort iamais qu’y ure.	Eésobjets doubleront, il vecra deux soleils, En moi seul il vcra deux Menechmes pareili Il pert entre lespottout souci de me suivre, Ily passeletours, et n'ex sort jamais qu'y ure.
ORAZIE.	ORAZIE.
Homme le plus brutalqui reſpire en ces lieuu?	Homme le plus brutalqui respire en ces lieuu?
Oſei-tu deſormais te monſtrer à mes yeux?	Osei-tu désormais te montrer à mes yeux?
Ma plainte, déloyal, eſt elle legitime, Mainteuant que tu tiens la preuus de 1on crime!	Ma plainte, déloyal, est elle légitime, Mainteuant que tu tiens la prévus de 1on crime!
MENECHME.	MENCHME.
Quel erime!	Quel erime!
que veux-tu?	que veux-tu?
ORAZIE.	ORAZIE.
Qu'il parle effrontímintt Le tonfeſſera-il, tourit-iſeulement?	Qu'il parle effrontímintt Le tonfessera-il, tourit-iseulement?
MENECHME.	MENCHME.
De quy m’actuſes tu?	De qui m'actuses tu?
ORAZIE.	ORAZIE.
Dieux!	Dieux!
l'impudenee extr-d I’ay bien tort, & ie ſuisle ſeul obiet cil ayz me.	l'impudence extrand J'ai bien tort, et tu suisle seul objet c' ils me.
MENFCHME.	MENFHME.
S’il eſt vray que mon cœur bruſle pour tes appas, C’eſt d'un braſier ſi doux que iene le ſeus pas.	S'il est vrai que mon cœur brûle pour tes appas, C'est d'un brasier si doux que iene le zeus pas.
ORAZIE.	ORAZIE.
Ie te crey, ſans iurer, traiſtre, infame, adultere, Il faut nerien valoir pour ne te pas deſplaire;	Je te créi, sans jurer, traître, infâme, adultère, Il faut nérien valoir pour ne te pas déplaire;
La vertun’aiamais ton eſprit arreſté, Ta haine eſt vne preune à mon honneſteté;	La vertun'aiamais ton esprit arrêté, Ta haine est une preune à mon honnêteté;
Et ſi ie te cauſois quelqu’amoureuſe enuis, Ie m’examinerois, i’accuſeroit ma vie;	Et si ici te causais quelqu'amoureuse envis, Je m'examinerais, j'accuserait ma vie;
Mon honneur te me ſomble auroit quelque defaut, Ie ne me croirois pascomporter comme il faus.	Mon honneur te me somble aurait quelque défaut, Je ne me croirais pascomporter comme il faus.
MENECHME.	MENCHME.
Quel monſtre de folie en eette iſte preſi de!	Quel montre de folie en cette ôte presi de!
Qu’il auroit fait de peine à la valeur d’Alcide!	Qu'il aurait fait de peine à la valeur d'Alcide!
Qu’il l’euſt bien empeſché d’eterniſer ſon nom, Et qu’ileuſt obligé la haine de Iunon :	Qu'il l'eût bien empêché d'éterniser son nom, Et qu'ileust obligé la haine de Junon :
Qu’on trouue icy de fous, que cet Hydre à teſtes, 3 Et que i’auray de mal à vaincre tant de beſtus,	Qu'on trouve ici de fous, que cet Hydre à têtes, 3 Et que j'aurai de mal à vaincre tant de bétus,
ORAZIE.	ORAZIE.
It me dois aſ-anchir de ſemblables tourmens, Et i’ay trop endure de tes deportemens, I’abhorre cet Hymen, & ſouhaite vn veſua Qui te mette en repos & m’oſte de ſeruage;	It me dois as-anchir de semblables tourments, Et j'ai trop endure de tes déportements, J'abhorre cet Hymen, et souhaite un vesua Qui te mette en repos et m'ôte de servage;
Lors ie ne pourray plus trauerſer tes plaiſirs, Si i’obtiens ce bon-heur, ſay te ſalles deſirs, De monlid, chaſte, & ſaind, faits vne cout cheiname, Donne à qui te plaira la place deta femme;	Lorsque ne pourrai plus traverser tes plaisirs, Si j'obtiens ce bonheur, sai te salles désirs, De monlid, chaste, et saind, faits un coût cheiname, Donne à qui te plaira la place déta femme;
Tu pourras en repos gouſter ſes priuautez, Ie ne troubleray point tes ſalles voluptez, Rien ne t'empeſchera d'obliger vne amante, Tu ſcras bien-heureux, & ieſeray contente.	Tu pourras en repos goûter ses privautés, Je ne troublerai point tes salles volupté, Rien ne t'empêchera d'obliger une amante, Tu scras bienheureux, et jéserai contente.
MENECHME.	MENCHME.
Adieu, tn m’eſtourdis des contes que tu faits, Ie ne te tegnoy point, & ne te vy iamais.	Adieu, t 'étourdis des contes que tu faits, Je ne te tegnoy point, et ne te vi jamais.
ORAZIE.	ORAZIE.
O Dieux!	Ô Dieux!
quand ſinira le couride ma miſert, Preſſe le pas.	quand sinira le couride ma misert, Presse le pas.
Detie, at pelleicy monpere, Quilentexde maplainte, de quelle Cacon, Il ſeint eſire inſenſe, four n'eſter ce pomfou	Detie, at pelleici monpère, Quilentexde maplainte, de quelle Cacon, Il seint éire insensé, four n'ester ce pomfou
MENECHME.	MENCHME.
Coy cepoincon eſt tier	Coi cepoincon est tier
ORAZIE.	ORAZIE.
Ouy que peux-tureſpondre.	Oui que peux-turespondre.
Et quils teſmoins faus-il afin de te tonfondre?	Et quils témoins faus-il afin de te tonfondre?
MENECHME.	MENCHME.
Nul, que la verité.	Nul, que la vérité.
ORAZIE.	ORAZIE.
Comme il eſt aſſeurt́!	Comme il est assurt!
Ton larein n’eſt donc pas aſſez bien aueré?	Ton larein n'est donc pas assez bien avéré?
Hal ſi ie m'affrauchis d’vne loy ſi fatale, Qu’au ſejour des damnez viuante ie deuale, Si tamais ſous l’Hymen meu cœur eſt arreſté, Si iamais ſous te ioug ie rends ma liberté.	Hal si ici m'affrauchis d'une loi si fatale, Qu'au séjour des damnés vivante vertu deval, Si tamais sous l'Hymen meu cœur est arrêté, Si jamais sous te joug ie rends ma liberté.
MINECHME.	MINECHME.
Qoy ie ſuis ton mary?	Qo ie suis ton mari?
que ie plains ta maniel	que ici plains ta maniel
ORAZIE.	ORAZIE.
Voyez de ce gauſſeur l’impudence infinie.	Voyez de ce gausseur l'impudence infinie.
Il ne me cos noit pas!	Il ne me cos noit pas!
MENECHME.	MENCHME.
Soſicle.	Sosicle.
Nenſi ie me conng.	Nensi belle me conng.
OIRAZIE.	ÔIRAZIE.
Et ce vieillard qui vient!	Et ce vieillard qui vient!
MENECHME.	MENCHME.
Auſſi peu comme toy.	Aussi peu comme toi.
SCENE II.	SCÈNE II.
LE VIEILLARD, MENECHME Soſicle, ORAZIE.	LE VIEILLARD, MENCHHE Sosicle, ORAZIE.
LE VIEILLARD.	LE VIEILLARD.
L faut donc que touſiours les importunesſia,  mes De la diſſenſion des vniſſent vos ames?	L faut donc que toujours les importunessia, mes De la dissension des unissent vos âmes?
Ne verra t’on iamais vos eſprits ſatisfaits?	Ne verra t'on jamais vos esprits satisfaits?
Ne goûterez-vouspoint les douceuri de la paix?	Ne goûterez-vouspoint les douceuri de la paix?
Ne reſpectez-vous point le nœud qui vous aſſemble?	Ne respectez-vous point le nœud qui vous assemble?
Et ſerez vous touſiours deux ennemis enſemble?	Et serez -vous toujours deux ennemis ensemble?
Iadis vous teſmoigniez tant de conformitez, Lors qu’vn vœumutuel ioignit vos libertez, Quel ſuiet maintenant cauſe cette diſcorde?	Jadis vous témoigniez tant de conformités, Lors qu'un vœumutuel joignit vos libertés, Quel sujet maintenant cause cette discorde?
Deſſus quel accidet faut il qu’on vous accorde!	Dessus quel accidet faut -il qu'on vous accorde!
ORAZIE.	ORAZIE.
Helaslretirez-moy de l'iniuſte pounoir B'vn mary que i’abhorre, & queie nepuis voir3 Le plus indigne eſpoux duſeiour où nousſommnes, L’opprobre de ceslieux, & la peſte des hommes:	Helaslretirez-moi de l'injuste pounoir B'un mari que j'abhorre, et queie nepuis voir3 Le plus indigne époux duseiour où noussommnes, L'opprobre de cette, et la peste des hommes:
Ie ne puis plus ſouſfrir ces meſpris apparens,	Je ne puis plus soufrir ces mépris apparents,
Vous eſt il arriué de nouueaux differends?	Vous est il arrivé de nouveaux différends?
Dois-ie de vos diſcords eſtre le ſeul arbitre, Vn autre ne peut il ſe charger de ce titre?	Dois-je de vos discords être le seul arbitre, Un autre ne peut il se charger de ce titre?
Et ne deuſſiez vous pas eſpargner mes vieux iours Dont vos diſſenſionsprecipitent le tours?	Et ne dussiez -vous pas épargner mes vieux jours Dont vos dissensionsprecipitent le tours?
ORAZIE.	ORAZIE.
Relus qui doit que voui quand ce traitre m'ofſence, Aſſißter voſtre fille, & prendre ſa deſfence?	Relus qui doit que voui quand ce traître m'ofsence, Assisster votre fille, et prendre sa défense?
LE VIEILLARD.	LE VIEILLARD.
Ne t’oppoſe iamais à ſes intentions, Auctoriſe touſiours ſes reſolutions, Et ceſſe d'expliquer ſespas, & ſes penſees, Comme tu me promis aux querelles paſſées, Preſente à ſes regords vn viſage plus doux, Ne luy teſmoigne point vn eſprit ſi ialoux, Euite letſujeti d’extiter ſa colere, Et qu’à tous ſes deſſeint ta volonté deſere, Entretieaiſon amour par des moyens ſi forts, Alors rien nepourra vous c auſer ces diſcords, Rinne trauerſera veſtre heureux mariage,	Ne t'oppose jamais à ses intentions, Auctorise toujours ses résolutions, Et cesse d'expliquer sespas, et ses pensées, Comme tu me promis aux querelles passées, Presente à ses regords un visage plus doux, Ne quelque témoigne point un esprit si jaloux, Euite letsujet d'extériter sa colère, Et qu'à tous ses desseint ta volonté desere, Entretieaison amour par des moyens si forts, Alors rien nepourra vous ç ôter ces discords, Rinne traversera vête heureux mariage,
ORAZIE.	ORAZIE.
Depuisque cesbeautez ont touchéſes eſprits, Ie ne ſuis qu’vn objet d’affronts & de meſprit, Il y perd tout ſon temps, il leur rit illas uante;	Depuisque cesbeautez ont touchés esprits, Je ne suis qu'un objet d'affronts et de méprit, Il y perd tout son temps, il leur rit illas uante;
Et ne me tient chez luy qu'en titre de ſeruaute, Mais qu’il craigne vn malheur, ſi mesſoupirs ſont vains Et ſi vous ne voulez me tirer de ſes maint.	Et ne me tient chez teint qu'en titre de servaute, Mais qu'il craigne un malheur, si messoupirs sont vains Et si vous ne voulez me tirer de ses maint.
LE VIEILLARD.	LE VIEILLARD.
Souſfre vn peu cette ardeur dont ſon ame eſt atteinte, Ctoy tu que par tes pleurs elle puiſſe eſtre eſteinte Feinti de ne la voir pas, cache tesdeſplaiſirs, Quand ſon amour deſcroiſt, aug mente tes deſirs;	Sousfre un peu cette ardeur dont son âme est atteinte, Ctoi tu que par tes pleurs elle puisse être éteinte Feinti de ne la voir pas, cache tesdesplaisirs, Quand son amour décroît, aug mente tes désirs;
Teſmoigne plus de ſeux, quaud les ſiens s’allentiſſent, Rechauffe tes baiſers quand lesſiens refroidiſſent, Careſſe le de l’œil.	Témoigne plus de seux, quaud les siens s'allentissent, Rechauffe tes baisers quand lessiens refroidissent, Caresse le de l'œil.
& du nom le plus doux Dont la ſemme peut voir, & nommer ſan époux, Parais touſiours contente, & touſiours enflammee;	et du nom le plus doux Dont la semme peut voir, et nommer san époux, Parais toujours contente, et toujours enflammée;
En fiu ay me le lien, & tu ſeras aymee:	En siv ai me le lien, et tu seras aimée:
Letpreuues d’amitié ſont de puiſſaus appas, Et quin eſt poit aymeſaus doute n’apms pai	Letpreues d'amitié sont de puissaus appas, Et quin est poit aimesaus doute n'apms pai
ORAZIE.	ORAZIE.
Que me proſitera d'uſer dorepartis, Mon Aduocat m’aceuſe, & deſſend ma panis	Que me prositera d'user dorepartis, Mon Aduocat m'aceuse, et dessend ma panis
LE VIEILLARD.	LE VIEILLARD.
En quoy recognoit-tuſes mauuais traittemens Ne t’accorde t’il pas d'honne tes veſtemens?	En quoi reconnaît-tuses mauuais traitements Ne t'accorde t'il pas d'honne tes vêtements?
En ai-tu dans te lieu, veu quelqu’vns qui purVn habit plus ſortable à celles de ta ſortet Vis tu d’vne faton qu'il n’auctoriſe pail Et ie reproche-il tesieux, ou tes repas?	En ai-tu dans te lieu, veu quelqu'uns qui purUn habit plus sortable à celles de ta sortet Vis tu d'une faton qu'il n'autorise pail Et Seigneur reproche-il tesieux, ou tes repas?
Te manque il de gens pour ſoulager ta pein?	Te manque il de gens pour soulager ta pein?
Ne te fournit il pas de chanvre, de la laine?	Ne te fournit -il pas de chanvre, de la laine?
Surqu yt a-il faſches?	Surqu y a-il fâches?
Et qu'ai-tu demandé, Qe c'il a deu lefa re, il ne ast accordé:	Et qu'ai-tu demandé, Qe c'il a dev lefa re, il ne ast accordé:
ORAZIE.	ORAZIE.
O Dieux!	Ô Dieux!
les vains diſcours dont vous ſlat tez ſon vice;	les vains discours dont vous slat té son vice;
Il ne me do nerien qu’apres il ne rauiſſe, Ce que i'ay le matin, leſoirille pro net, Il paye de mon bien les affronts qu’il me fait.	Il ne me do nérien qu'après il ne ravisse, Ce que j'ai le matin, lesoirille pro net, Il paye de mon bien les affronts qu'il me fait.
Ce pointon luy gagnoit une de ſes Maiſtreſſes!	Ce pointon lui gagnait une de ses Maîtresses!
Voyez ſi i’ay raiſon de blaſmer ſes largeſſes, Et deteſter le nœud dent nousſommes unis, Puis qu'il me fait ſouffrir des affront infinis.	Voyez si j'ai raison de blâmer ses largesses, Et détester le nœud dent noussommes unis, Puis qu'il me fait souffrir des affront infinis.
LE VIEILLARD.	LE VIEILLARD.
Mon fili ce nœudſatre qui ioint vos deſtineet, Vous doit faire autrement employer vos annees, Et la neceſſité d’eſtre vnis à iamais Doit eſtablir chez vous le reſpect, & la paix;	Mon fili ce nœudsatre qui joint vos destineet, Vous doit faire autrement employer vos anères, Et la nécessité d'être unis à jamais Doit établir chez vous le respect, et la paix;
Son bien vous touche plus que l’intereſt d’vns autre, Quand vous le diſſpez, vous diſſipez le voſtre:	Son bien vous touche plus que l'intérêt d'uns autre, Quand vous le disspez, vous dissipez le vôtre:
Vous releuez d’Himendont les ſacrez arreſts Comme ils ioignent vos corps, ioignent vos intereſts.	Vous relevez d'Hymendont les sacrez arrêts Comme ils joignent vos corps, joignent vos intérêts.
MENECHME:	MENCHME:
Qui que tu ſois (Vieillard) ie te iure, & i'atteſte Les diuers habitans de la voute celeſte,	Qui que tu sois (Villard) Seigneur te jure, et j'atteste Les divers habitants de la voute celeste,
LEVIEILLARD.	LEUIEILLARD.
Dequoy?	Dequoy?
MENECHME.	MENCHME.
Que ta folie eſt ſans comparaiſon.	Que ta folie est sans comparaison.
Et qu’vn eſtrange effort a troubléta raiſou,	Et qu'un étrange effort a troubléta raisou,
LE VIEILLARD.	LE VIEILLARD.
A quoy leiuges-veur?	À quoi lejuges-veur?
T---	T-
MENECHME.	MENCHME.
Dieux quelle extrauagance!	Dieux quelle extravagance!
Et quedois-iereſpondre au propos qu’il m’auance?	Et quedais-ierespondre au propos qu'il m'avance?
LE VIEILLARD.	LE VIEILLARD.
Ceſſez de metenir ces mots iniurieux, Ou ie ſp̧auray calmor voſtre eſprit furieux;	Cessez de métenir ces mots injurieux, Ou vain spaurai calmor vôtre esprit furieux;
N’irritez pas l’humeur où la voſtre me porte, Rendiz-moy cepoinfon, & viuez d'autre ſorte.	N'irritez pas l'humeur où la vôtre me porte, Rendis-moi cepoinfon, et vivez d'autre sorte.
HIDOHME.	HIDOHME.
Comme ce bon ſVieillard a les ſens hebetuz!	Comme ce bon sVieillard a les sens hébétuz!
L’aage traiſne apres ſoy ces incommoditez, Son torps s'affoibliſſant, ſon eſprit fait de méme, Et ie dois pardonner à ſa folie extreme.	L'âge traîne après soi ces incommodités, Son torps s'affaiblissant, son esprit fait de même, Et enfin dois pardonner à sa folie extrême.
Que voulez vous de moy?	Que voulez -vous de moi?
que i’expire à vos jeux Si ie connus iamais perſonne de cetlieux;	que j'expire à vos jeux Si tu connus jamais personne de cetlieux;
S’il m’arriua iamais d’entrer ex cette porte, Et ſi ie vous ay pris ce poincon que it porte.	S'il m'arriva jamais d'entrer ex cette porte, Et si je vous ai pris ce point que porte.
Vne ohaſte beauté n’a prie pres d’icy De le faire émailler.	Une ohâte beauté n'a prie pres d'ici De le faire émailler.
& i’en prends le ſoucy.	et j'en prends le souci.
Adieu diſpenſez moy d’vne vaine audiance, Et ne m’obligez plus à tant de patience.	Adieu dispensez -moi d'une vaine audience, Et ne m'obligez plus à tant de patience.
Que la terre m’entende, & s’ouure deſſous moy fiie vous visiamais, & ſi ie vous connoy.	Que la terre m'entende, et s'ouvre dessous moi fiie vous visiamais, et si ie vous connais.
LEVIEILLARD.	LEUIEILLARD.
O Diux qu’entonds-ie icyt puis-ie apresce langage Croire que ſa raiſon conſerue ſon vſage, Qu'amour cauſe de trouble au terueaus leplus ſam!	Ô Ojux qu'entonds-je ici puis-je appresce langage Croire que sa raison conserve son usage, Qu'amour cause de trouble au terueaus leplus sam!
Ilue me cognoiſtpas.	Ilue me cognoistpas.
MENECHME.	MENCHME.
Et n'en ay pardeſſein.	Et n'en ai pardessein.
LE VIEILLARD.	LE VIEILLARD.
C'eſt trop long temps mon fils, prelonger cette plamte Et tu nous porterois du plaiſir à la plainte, C’eſt trop s’entretenir d mutile propos, Entrons, rends ce poincon, & viuex enrepos	C'est trop long temps mon fils, prèsonger cette plamte Et tu nous porterais du plaisir à la plainte, C'est trop s'entretenir d mutile propos, Entrons, rends ce poinçon, et vivex enrepos
MENECHME.	MENCHME.
En fin n’irrite plus le courreur aui m’erſtame, Que viux-tu?	En fin n'irrite plus le courreur auj m'erstâme, Que vivux-tu?
dis ton nom5 & quelle eſt vette femme?	dis ton nom5 et quelle est vette femme?
ORAZIE.	ORAZIE.
*l n'en faut plusdouter, des ſignes ſi puiſſans Nous ſont paroiſtre aſſez qu’il a perdu le ſens, Et l’alieration qu’on voit en ce viſage, E d'uneſtrange accez vn aſſeuré preſage,	*l n'en faut plusdouter, des signes si puissants Nous sont paraître assez qu'il a perdu le sens, Et l'alieration qu'on voit en ce visage, E d'unestrange accès un assuré présage,
MENECHME.	MENCHME.
Illes faut confirmer en des ſoupçons ſi vaint, Ia puis par ce moyen m’eſchapper de letus mains;	Illes faut confirmer en des soupçons si vaint, Ia puis par ce moyen m'échapper de letus mains;
Feignons d’itreſs fou que chatun d'eux m'la uite, Et que la peur descoups leur conſeille la ſuitte.	Feignons d'itress fou que chatun d'eux m'la uite, Et que la peur descoups leur conseille la suitte.
ORAZIE.	ORAZIE.
Qantim ifitnange, voyez mon pere i Dieux!	Quantim jitnange, voyez mon père y Dieux!
Voyez les traitile ſeu qui ſortent de ſes yeux.	Voyez les traitile seu qui sortent de ses yeux.
LEVIEILLARD.	LEUIEILLARD.
Eloignont nous de luy ſoz action m'eſtonne, La folie eſt aueugle, & n’épargne perſonne.	Éloignont nous de deux sœur action m'étonne, La folie est aveugle, et n'épargne personne.
MENECHME Soſicle, faiſant le fol.	MENCHME Sosicle, faisant le fol.
Ferß les ennemis de mon audorité, Vous auez trop de fois mon pouuoir irrité, En fin vouscognoiſtrez ma valeur infinie, Et ie combattray ſeul tou e l'Epidamnie;	Fergli les ennemis de mon audorité, Vous avez trop de fois mon pouuoir irrité, En fin vouscognoistrez ma valeur infinie, Et personne combattrai seul tou e l'Épidamnie;
Seulie ſubiugueray ce ſup rbe pays, Et mesexploicts rendront ſes peuples ébays.	Seulie subiugueray ce svp ebe pays, Et mesexploits rendront ses peuples ébays.
Vouspleurez vainement, une mer de vos larNe duertiroit pas cet effect de mes armes.	Vouspleurez vainement, une mer de vos larNe duertirait pas cet effet de mes armes.
Donnons, frappons, iuons, rangeons tout ſurnes pas Que de ſang rípandu!	Donnons, frappons, juons, rangeons tout surnes pas Que de sang répandu!
que d’ennemis à bail	que d'ennemis à bail
LE VIEILLARD.	LE VIEILLARD.
Dieux qu’eſt-ce que ie voy?	Dieux qu'est-ce que ie cy?
MENECHME.	MENCHME.
Cette aſfreaſeſorcitre Me priue de l'honneur de leur defaitte entiert, Ses magiques ſecrets repouſſent mes efforts, Font pancher la victoire, & ranituent ces corpsi C’eſt tontre elle qu’il ſaut exercer mon courage Malgré tous ces Demons qu’elle oppoſe à ma raSuicheſſons cess prits de ces lieux eſtrangeri Ma valeur mi promet de franchir cesdangers.	Cette asfrasesorcitre Me prive de l'honneur de leur défaite entiert, Ses magiques secrets repoussent mes efforts, Font pencher la victoire, et ranituent ces corpsi C'est tontre elle qu'il saut exercer mon courage Malgré tous ces Lieux étrange oppose à ma raSuichessons cess prits de ces lieux étranger Ma valeur mi promet de franchir cesdangers.
LE VIEILLARD.	LE VIEILLARD.
Menechmeoù ſongez-voun	Menechmeoù songez-voun
ORAZIE.	ORAZIE.
Helas ieſuis perdui,	Hélas iesuis perdui,
MENECHME.	MENCHME.
Tu nepeus euiter la peine qui t'eſt deu?	Tu nepeus éviter la peine qui t'est dev?
Tout le pouuoir du Ciel cãtraire à mou d ſſein, Ne m’empeſcheroit pas de te percer le ſein	Tout le pouvoir du Ciel cétraire à mou d sein, Ne m'empêcherait pas de te percer le sein
ORAZIE.	ORAZIE.
O Dieux quelle folie eſt lgale à la ſiennes Ie vais chercher icy quilqu’vn qui le retunne.	Ô Dieux quelle folie est légale à la siennes Je vais chercher ici quilqu’amour qui le retunne.
MENECHME.	MENCHME.
Medois-ie contenter de ces rares effects?	Medais-je contenter de ces rares effets?
La ſorciere eſt en fuitte,& ſes Demons defaits, Ce Caualier armé nuit encore à ma gloire, Il faut que ſa defaitte atheue ma victoire.	La sorcière est en fuite,et ses Demons défaits, Ce Cavalier armé nuit encore à ma gloire, Il faut que sa défaite athève ma victoire.
LE'VIEILLARD.	LE'VIEILLARD.
Dieux en l'eſtat qu’il eſt dois-ie attendre ſes pas, Regarde qui ie ſuis, & ne m'approche pas.	Dieux en l'état qu'il est dois-je attendre ses pas, Regarde qui personne suis, et ne m'approche pas.
MENECHME.	MENCHME.
Tu refuſestimidi vn combat honorable, Tun’oſes repouſſer ma ſorte incomparable, Tu trembles, tu pâlis, lâche, tu ſuis en vain, Rien ne tepeut ſauuer des eſforts de ma main.	Tu refusestimidi un combat honorable, Tunes repousser ma sorte incomparable, Tu trembles, tu pâlis, lâche, tu suis en vain, Rien ne teput sauver des esforts de ma main.
LE VIEILLARD.	LE VIEILLARD.
Helas combien ſon mala croiſt ſa violence!	Hélas combien son mala croît sa violence!
MENECHME.	MENCHME.
Le Ciel ne tepourroit ſou traire à ma vaillaet.	Le Ciel ne tepourrait sou traire à ma vaillaet.
D iij	 Dijà
LE VIEILLARD.	LE VIEILLARD.
D'où naiſt cet accident?	D'où naît cet accident?
ô ſeuert deſtin, Euitont ſa fureur, courons au Medecin.	ô seuert destin, Euitont sa fureur, courons au Medecin.
MENECHME ſeul.	MENCHME seul.
Les Dieux ont à la ſama priers leoutez, Ces fous qui m'ont fait fou, m’ont la place quittee, Les atreables ſous, dont les cris m’ont forcé, De feindre que comme eux i’auois l’eſprit bleſIls reu endrout bien toſt, ſi ie ne me retire, Par des lieux ſcartez, retournons au Nauire, O Dieux!	Les Dieux ont à la sama priers leoutez, Ces fous qui m'ont fait fou, m'ont la place quitte, Les atreables sous, dont les cris m'ont forcé, De feindre que comme eux j'avais l'esprit blesIls réu endrout bien tôt, si je ne me retire, Par des lieux scartés, retournons au Navire, Ô Dieux!
en ma faueur gueriſſez leurs eſprits, Ou ne leur monſtrez pas le chemin que i’uy pris.	en ma faveur guérissez leurs esprits, Ou ne leur montrez pas le chemin que j'hui pris.
SCENE III.	SCÈNE III.
LEVIEILLARD, à la porte du Medecin.	LEUIEILLARD, à la porte du Médecin.
Vil eſt long à venir, que ie luis las d'attendre!	Vil est long à venir, que iecluis las d'attendre!
Et que de vains diſcours il me va faire entendre, Il perſuadera ſi l’on veut l'écouter Q’un mort par ſon moyen vient de reſſuſciter, Q’il a remis la iambe, ou le bras de Merchre, Ouqu’il a guery Mars d'vn inſigne bleſſure;	Et que de vains discours il me va faire entendre, Il persuadera si l'on veut l'écouter Qun mort par son moyen vient de ressusciter, Qil a remis la jambe, ou le bras de Merchère, Ouqu'il a guéri Mars d'un insigne blessure;
Cependant qui ſçauroit ce qu’il fait là dedans, Le verroit conſulter ſur quelque mal de dents.	Cependant qui saurait ce qu'il fait là -dedans, Le verrait consulter sur quelque mal de dents.
Il deſcend ie le voy.	Il descend esprit le vois.
SCENE IV.	SCÈNE IV.
DE HEDPEIN LE VIEIL:	DE HÉPEIN LE VIEIL:
LARD.	LARD.
teux qu’au ſiecle où nous ſommes, Don dait pas faire eſtat delafantídes hommes, Vn iour peut ruiner les plus ſortes ſantezLe plus ſain eſt ſuiet à mille infirmitez, Nousproduiſont en nous les bumeurs qui noue nuiſent, Et deux meſmes nos cape tous les iours ſe defruiſent.	teux qu'au siècle où nous sommes, Don dait pas faire état delafantídes hommes, Un jour peut ruiner les plus sortes siètezLe plus sain est sujet à mille infirmités, Nousproduisont en nous les bumeurs qui noue nuisent, Et deux mêmes nos cape tous les jours se defruisent.
LEVIEILLARD.	LEUIEILLARD.
Cattedoſtruction produit voſtre intereſt, Les Medecins ſont mal quand perſonne ne l’eſt.	Cattedôtruction produit votre intérêt, Les Médecins sont mal quand personne ne l'est.
Mais quitons ce diſceurs, & ſongeons aure mede DvD’vn accidét ſi prompt qui reclame vôtre aide;	Mais quitons ce disceurs, et songeons aure mède DuD'un accidet si prompt qui réclame votre aide;
Voyez cer yeux mourans, & ce teint inégal, Ne nous eſpargnez poirt, & ſoulagez ſon mal.	Voyez cer yeux mourants, et ce teint inégal, Ne nous épargnez poir, et soulagez son mal.
SCENE V.	SCÈNE V.
MENECHME rauy.	MENCHME ravi.
ORAZIE, LE VIEILLARD.	ORAZIE, LE VIEILLARD.
LE MEDECIN, Deux hommes.	LE MÉDECIN, Deux hommes.
MENECHME rauy.	MENCHME ravi.
Ve ie vis auiourd’huy ſous vn aſtreſeuere, Et que le Ciel me void d’vn regard de colere, Ha!	Ve autre vis aujourd'hui sous un astreseuere, Et que le Ciel me voit d'un regard de colère, Ha!
que i’ay mal’heureux manqué de iugemêt, Quand i'ay ſouffert qu’Ergaſte ait veu te dia, mant!	que j'ai mal'heureux manqué de iugemêt, Quand j'ai souffert qu'Érgaste ait vu te dia, mant!
Mais ſi deuant ce ſoir ie n’acheue ſa vie Ie veux qu’en ce moment la mienne ſoit rauie, Sa vie, halqu'ay io dit?	Mais si devant ce soir ici n'achève sa vie Je veux qu'en ce moment la mienne soit ravie, Sa vie, halqu'ai jo dit?
puis que ie l’entretiens, Et qu’il fut mort ſans moy, ſes iours ſont ils pas miens?	puis que ici l'entretiens, Et qu'il fut mort sans moi, ses jours sont ils pas miens?
Onſpait qu’il m’eſtoit cher, & que ce deteſtable Ne vit depuis trois aus que des mets de ma tabla	Onspait qu'il m'était cher, et que ce détestable Ne vit depuis trois aussi que des mets de ma tabla
LE VIEILLARD, Ille faut abörder.	LE VIEILLARD, Ille faut abrder.
LE.	LE.
MEDECIN.	MÉDECIN.
L’amour, ou vos procez, Vous ont cauſé, Monſieur, ces violens accez!	L'amour, ou vos procès, Vous ont causé, Monsieur, ces violents accès!
Quelles afflictions vouiſent les plus ſenſibles,	Quelles afflictions vouisent les plus sensibles,
MENECHME rauy.	MENCHME ravi.
Que veut ee vieux reſueur?	Que veut ce vieux rêveur?
LE MEDECIN.	LE MÉDECIN.
D’oùprouient ce tourment?	D'oùprouient ce tourment?
Eſt-ce deuurs le front qu’il eſt plus vehement?	Est-ce devrs le front qu'il est plus véhément?
MENECHME rauy, Dieux qu’il eſtmſenſe.	MENECHME ravi, Dieux qu'il estmsence.
LE VIEILLAR( Voyez l'extranagaua.	LE VIEILLAR( Voyez l'extranagaua.
ORAZIE.	ORAZIE.
Obligez le, Monſieur, d'vns prompte ord donnance.	Obligez le, Monsieur, d'uns prompte ord donnance.
LE MEDECIN.	LE MÉDECIN.
Qulmetr aſode ie D vj	Qulmettr asode après D éj
ORAZIE.	ORAZIE.
Des mett trop dilicats.	Des mett trop dilicats.
LE MEDECIN.	LE MÉDECIN.
Qelle ſorte de vin boit-il à ſes repas?	Quelle sorte de vin boit-il à ses repas?
MENECHME rauy.	MENCHME ravi.
Le vinsles plus friands & les plus delectables:	Le vinsles plus friands et les plus délectables:
Maisai-tu prisle ſoin de reſormer las tables, que me compte ce fol?	Maisai-tu prisle soin de résormer las tables, que me compte ce fol?
ne veut il point ſp̧auoir Si le pain que ie mange eſt du pain rouge ou noir, Si i'vſe de poiſſon qu’il ſoit couuert de plumes?	ne veut il point spavoir Si le pain que on mange est du pain rouge ou noir, Si j'une de poisson qu'il soit couvert de plumes?
Eß-ilſi deſireux de ſpauoir mes couſtumes?	Ess-ilsi désireux de spavoir mes coutumes?
LEVIEILLARD.	LEUIEILLARD.
Et bienqueiugez- vousde cus propas conſus?	Et bienqueiugez- vousde cvs propas consus?
Et queluy pourrez vous ordonner là deſſus?	Et quelui pourrez -vous ordonner là -dessus?
LEMEDECIN.	LEMEDECIN.
Et-il fort amourex?	Et-il fort amourex?
MENECHME rauy.	MENCHME ravi.
Ouy detoutes les balln, Apprends-le de ta ſemme elle en ſpait desnouuelleſ	Oui détoutes les balln, Apprends-le de ta semme elle en spait desnouuelles
LE MEDECIN.	LE MÉDECIN.
O commeſt-iltroublé!	Ô commêt-iltroublé!
ORAZIE.	ORAZIE.
Vous luy pardonnez bion.	Vous avait pardonnez bion.
LE MEDECIN.	LE MÉDECIN.
Dert-ilpreſondement?	Dert-ilprèsondement?
MENECHME fauy.	MENCHME savy.
Ouy, ſi ie ne doy ries.	Oui, si belle ne dois ries.
LE MEDECIN.	LE MÉDECIN.
Goſtparler de bonſent.	Gôtparler de bonsent.
MENECHME rauy.	MENCHME ravi.
Qαεrεſροndνηy ιεεnσοrες	Qαεrεsροndνηy y
LE MEDECIN.	LE MÉDECIN.
Sæſamtí ne depend que d vn peu d'Elebere, Et ſon maln’apaitant atteriſa raiſon, R’ilne puiſſe bien toſt eſperer gueriſen.	Sæsamt ne dépend que dommes peu d'Elebere, Et son maln'apaitant atterisa raison, R'ilne puisse bien tôt espérer guérisen.
LE VIEILLARD.	LE VIEILLARD.
Sa douleur maintenant a moint de vialence, Vous n’euſſiez pû tantoſt ſouffrir ſoninſolence, En l'humeur qu’il eſtoit il nous euſt frappez tous:	Sa douleur maintenant a moint de vialence, Vous n'eussiez pu tantôt souffrir soninsolence, En l'humeur qu'il était il nous eût frappez tous:
Il nous a menacez d’vn orage de coups, Il s’eſtoit propoſé de ruiner cette iſte, Et ſans toucher vn homme il en a defait mille, Ses geſtes & ſa voix nous ſaiſiſſoient d’horreur, Et i’ay fait ſasement d’euiter ſa fureur.	Il nous a menacés d'vn orage de coups, Il s'était proposé de ruiner cette iste, Et sans toucher un homme il en a défait mille, Ses gestes et sa voix nous saisissaient d'horreur, Et j'ai fait sasement d'éviter sa fureur.
MENECHME rauy.	MENCHME ravi.
Dieux qu'eſt-te que i'entendn	Dieux qu'est-te que j'entendn
LE VIEILLARD.	LE VIEILLARD.
N’ai-tupaila memoire D'auoir contre du vent diſputé la victoire?	N'ai-tupaila mémoire D'avoir contre du vent disputé la victoire?
D’auoir menaßé l’air, defait des viſions, Ne te ſouuient-ilpoint de ces illuſions?	D'avoir menassé l'air, défait des visions, Ne te souvient-ilpoint de ces illusions?
Tu no te propoſois, qu’horreur, & que carnage, Et tu nous as voulusimmoler à ta rage.	Tu nô te proposais, qu'horreur, et que carnage, Et tu nous as voulusimmoler à ta rage.
MENECHME, rauy.	MENECHME, ravi.
Et toyTeſouuient-ilopprobre des mortels, D’aurir deuant mes yeux pille ſur les autels, Baitpar tout abhorrer ie humeus ſanguinaire, Deuoré tes enfans, aſſaſſiné ta mere, Empoiſonnéta femme, & viudu ton pays, En find auoir les dieux, & les bom mes trahis, Eſt-ce là commeil faut publierta louange?	Et toiTesouient-ilopprobre des mortels, D'aurir devant mes yeux pille sur les autels, Baitpar tout abhorrer Seigneur humeus sanguinaire, Deuoré tes enfants, assassiné ta femme, Empoisonnêta femme, et viudu ton pays, En find avoir les dieux, et les bom mes trahis, Est-ce là commeil faut publierta louange?
Eſt-te aſſez pour un fou t’auoir rendu ton change?	Est-te assez pour un fou t'avoir rendu ton change?
LE VIEILDARD.	LE VIEILDARD.
Céme ſon mal s’accroit eſtoutez ſon diſcours, Et ne diſſerez plus dy ther-her duſecours.	Cême son mal s'accroît étoutez son discours, Et ne disserez plus d theriher décours.
LE MEDECIN.	LE MÉDECIN.
Si ie nele gueris de cette maladie, Il eſt bien mal aiſe qu’un autre y remedie, Qu'on l'amene à ma chambre, & malgré ſes efforts Que quelqu’un de ces gens le ſaiſiſſent au corps.	Si ici nele guéris de cette maladie, Il est bien mal aise qu'un autre y remédie, Qu'on l'amène ma chambre, et malgré ses efforts Que quelqu'un de ces gens le saisissent au corps.
Ie connoy de te mal la cauſe veritable, En de cert ains accez il eſt plus redoutable.	Je connais de te mal la cause véritable, En de cert ains accès il est plus redoutable.
Quilque ſanglant ennuy l’a reduit à ue poinct, Et s’il n'eſt attache ie n’en approche point.	Quilque sanglant ennui l'a réduit à ue point, Et s'il n'est attache ie notren approche point.
Allons apportez le.	Allons apportez le.
MENECHME rauy.	MENCHME ravi.
Dieux, dort-ie ou ſi ieveille ;	Dieux, dort-je ou si ieveille ;
O Cielquelle inſortune à la mienne eſt pareille, Dieux, hommes, animaux qui mi vient affiſter:	Ô Cielquelle insortune à la mienne est pareille, Dieux, hommes, animaux qui mi vient assister:
Qe meveulent tes gins, où me veus en porter?	Que meveulent tes gins, où me veux en porter?
SCENE VI.	SCÈNE VI.
MESSENIE, MENECHME ORAZIE, LE MEDECIN.	MESSENIE, MENECHME ORAZIE, LE MÉDECIN.
MESSENIE.	MESSENIE.
LMon maiſtrey peut venir, ſa chambre eſt preparee:	LMon maîtrei peut venir, sa chambre est préparée:
Mais las!	Mais las!
en quel eſtat il paroiſt à mes yeux!	en quel état il paraît à mes yeux!
Quelle iniure a ilfaite au pauple de ces lieux?	Quelle injure a ilfaite au pauple de ces lieux?
Il le faut aſſiſter, & fendre cette preſſe.	Il le faut assister, et fendre cette presse.
MENECHME rauy.	MENCHME ravi.
O Dieux!	Ô Dieux!
qu'ay-ie commis que chacun me deiaiſſe?	qu'ai-je commis que chacun me déjaisse?
MESSENIE.	MESSENIE.
Que veut aux eſtrangers ce peuple iniurieux?	Que veut aux étrangers ce peuple injurieux?
Traitres, n’irritez pas mon eſprit furieux, Rendez cet innocent à mesiuſtes requeſtes, Oueraignez que muibras ue foudent ſur vos teſte.	Traitres, n'irritez pas mon esprit furieux, Rendez cet innocent à miustes requêtes, Oueraignez que muibras ue soudent sur vos tête.
LE VIEILLARD.	LE VIEILLARD.
Que veut cet inſenſe?	Que veut cet insensé?
LE MEDECIN.	LE MÉDECIN.
Secourir ſon pareil,	Secourir son pareil,
MENECHME rauy.	MENCHME ravi.
Ha' quelheureux demon t’inſpire ce conſeil.	Ha quelheureux demon t'inspire ce conseil.
Seulſenſible à mes eris, ſeul à mou ſort propiE7.	Seulsensible à mes eris, seul à mou sort propiE7.
Acheue, cher amy, ce faurrable office, N’en eſpargnepas vn, & ſuy ta paſſion, L’innocence reſpond de ta remiſſion.	Achève, cher ami, ce faurable office, N'en épargnepas un, et suis ta passion, L'innocence répond de ta rémission.
VN VALET fayant, Aieuie cude aux coups,	UN VALET faisant, Aieuie cude aux coups,
MESSENIE au Vleillard.	MESSENIE au Vleillard.
Toy dont la main hardie, D’vn coup ſi furieux m’a la ioue etourdie.	Toi dont la main hardie, D'un coup si furieux m'a la joue étourdie.
LE VIEILLARD.	LE VIEILLARD.
Hat ma fille ſayons.	Hat ma fille sayons.
MINECHME.	MINECHME.
Tousles Dieux vainement, Te voudroient dérober à man reſſentiment:	Tousles Dieux vainement, Te voudraient dérober à man ressentiment:
Eumonfaleprix.	Eumonfaleprix.
LE MEDECIN.	LE MÉDECIN.
Il faut fuir ſi ie m'ayme?	Il faut fuir si ici m'aime?
ME'NECHME rauy.	ME'NCHME ravi.
Que ie ſuis redeuable à ta valeur extreme, Le ciel te ſoit propice, & que ſes deitez Te comblent deplaiſirs, &!	Que ie suis redevable à ta valeur extrême, Le ciel te soit propice, et que ses dé Te comblent plaisirs, et!
de proſperitez.	de prospérités.
Leur rage ſut ſans toy de mon ſang aſſouuie.	Leur rage sut sans toi de mon sang assouuie.
Et ſant toy danslaurs mains i’aurois perdu la vie.	Et sant toi danslaurais mains j'aurais perdu la vie.
MESSENIE.	MESSENIE.
Admirez maintenant la valeur de te bras, Voyez comme let coupiſont ſes plus doux ébats, Comme cette canaille A mesyeux diſparuë, Euite ma fureur, & me codela ruë, Suis-ie pas à propos ſorty de la maiſon?	Admirez maintenant la valeur de te bras, Voyez comme let coupisont ses plus doux ébats, Comme cette canaille À mesïeux disparue, Euite ma fureur, et me codela rue, Suis-je pas à propos sorti de la maison?
Et pouuois ie venir en meilleure ſaiſont Heureuſe occaſion que lo tiel m’a fait naiſtre, Pour ſignaler ma ſorce en faueur de mon Maiſtre, Maisqui portoit cesgens à vous traitter ainßi, Dequoy ſe plaig noient-ili, oſtez moy deſoucy?	Et pouvais ie venir en meilleure saisont Heureuse occasion que lo tiel m'a fait naître, Pour signaler ma sorce en faveur de mon Maître, Mais portait cesgents à vous traiter ainsi, Dequoi se plaig noient-ili, ôtez moi désouci?
MINECHME rauy.	MINECHME ravi.
Daux motste l’apprendront.	Daux motste l'apprendront.
Mafimme.	Mafimme.
MESSENIE.	MESSENIE.
Quis	Quis
MENECHME rauy.	MENCHME ravi.
Mafemme,	Mafemme,
MESSENIE.	MESSENIE.
Que ſon eſprit ſe trouble, en l’ardeurqui l'enſlame, Henechme ou ſouget vouss	Que son esprit se trouble, en l'ardeurqui l'enslamme, Henechme ou souget vouss
MENECHME rauy.	MENCHME ravi.
Et qui t’a dit mon nom?	Et qui t'a dit mon nom?
MESSENIE.	MESSENIE.
Dieux l’extreme ſureur qui troubls ſa raiſon.	Dieux l'extrême fureur qui troubls sa raison.
MENECHME rauy.	MENCHME ravi.
Comment t’appelle tu?	Comment t'appelle tu?
MESSENIE.	MESSENIE.
Mon nomeſt Meſſenie.	Mon nomêt Messénie.
MENECHME rauy.	MENCHME ravi.
Que iaſuis redeuab'e à ta ſorce infinieCroy que ie ſuis ſenſible au bien que tu me fais, Et que ie cherirayta memoire à iamais.	Que jasuis redevab'e à ta sotce infinieCroi que je suis sensible au bien que tu me fais, Et que personne chériraita mémoire à jamais.
Ie publieray par tout ta force incomparable, Adieu, que ſoit le ciel à tes yeux fauorable.	Je publierai par tout ta force incomparable, Adieu, que soit le ciel à tes yeux favorable.
MESSENIE.	MESSENIE.
Ha!	Ha!
ie voy de ſon mal des ſignes tros puiſſans, Ie veux perdre le iour i’il n’a perdu le ſens, Ne le puis ie tirer de cette reſierie;	On vois de son mal des signes tros puissants, Je veux perdre le jour j'il n'a perdu le sens, Ne le puis ie tirer de cette résierie;
Mon maiſtre, tout eſt preſt à voſtre hoſtellerit, Ie vous ay trop vange de ces affrons receus, Ne perdez point de temps à reſuer là deſſus:	Mon maître, tout est prêt à votre hostellerit, Je vous ai trop venge de ces affrons reçus, Ne perdez point de temps à rêver là dessus:
Il faut rendre le ca’me à cet eſprit mala le, Et diuertir vos ſoins par quelque pourmenade, Lors que vous aurez veu ſi la maiſon vous faaini;	Il faut rendre le came à cet esprit mala le, Et divertir vos soins par quelque pourmenade, Lors que vous aurez vu si la maison vous faaini;
O Ciel!	Ô Ciel!
oiuſte, Dieux, en quel eſtas il eß.	oite, Dieux, en quel estas il estime.
MENECHME rauy.	MENCHME ravi.
Aurois-tuma raiſon, oublil ton vſage, Ilfaut que ie ſois fou ſi tout le monde eſt ſage, Et voyant tant de voix i’accorder en ci point, Ie commence à douter ſi ie ne le ſuis point, Amy, qui que tu ſois, ie ne te puis connoiſtre, Tu m’honorec à tort du titre de ton Maiſtre, Ie ne m ſouuieus point de t’auoir iamais veu, E ie t’affranchirois ſi ce nom m’eſtoit deu.	Aurais-tuma raison, oublil ton usage, Ilfaut que je sois fou si tout le monde est sage, Et voyant tant de voix j'accorder en cy point, Je commence à douter si je ne le suis point, Ami, qui que tu sois, je ne te puis connaître, Tu m'honorec à tort du titre de ton Maître, Je ne m' était point de t'avoir jamais vu, E ie t'affranchirais si ce nom m'était dev.
MESSENIE.	MESSENIE.
Ciſt trep continuer cette foivte inutile, Ne me croyez vouspoint dupeuple de cette Iſier Nrrlue comme vous en cette nation, Et ie n’arpoint depart en leur intention;	Cit trep continuer cette faite inutile, Ne me croyez vouspoint dupeule de cette Isier Nrrlue comme vous en cette nation, Et personne n'arpoint départ en leur intention;
Mais vous cog oiſſiz trop monnom, & mon ſeruage, I'enporteſur le dos un trop ſeur teſmoignge	Mais vous cog oissiz trop monnom, et mon servage, J'enportesur le dos un trop sûr témoignge
MENECHME rauy.	MENCHME ravi.
Dieux!	Dieux!
qu’eſt-ce que i’attendst	qu'est-ce que j'attendais
MESSENIE.	MESSENIE.
C'eſt que voſtre bont!	C'est que votre bont!
Me deliure auiourd huy de ma captiuité.	Me délivre aujourd' hui de ma captivité.
Monſieur, prononcez-moy cet arreſt fauornble, Deux motipeuuent changer mon deſtin miſe, rable	Monsieur, prononcez-moi cet arrêt favornble, Deux motipeuvent changer mon destin mise, rable
MEBECHME rauy Sois libre, i'y conſeni.	MEBECHME ravi Sois libre, j'y conséni.
MESSENIE.	MESSENIE.
Agreable diſcours.	Agréable discours.
Quel bon-heur eſt pareil à celuy de mes iours, Vſez pourtant.	Quel bonheur est pareil à celui de mes jours, Verts pourtant.
Monſieur, de la meſmepuiſſanQue auand ie dependois de voſtre obeiſſanct, Ne m’abandonnez pas en cette uation, Carieſuis voſtre utor, par iuclination.	Monsieur, de la mêmepuissanQue avant ie dépendais de votre obéissanct, Ne m'abandonnez pas en cette uation, Cariesuis votre utor, par juclination.
Allons aulogement que là ie me décharge De tout ce que vos, maius ont commis ex ma charge	Allons aulogement que là on me décharge De tout ce que vos, mais ont commis ex ma charge
MENECHME rauy.	MENCHME ravi.
Non ie t'attendri.	Non ici t'attendri.
MESSENIE.	MESSENIE.
Ie reuientde ce pas.	Je revient ce pas.
Et i'apporie ler cleſi, ne vonseſtoignez pas.	Et j'apporie ler cli, ne vonsestoignez pas.
MENECHME rauy ſeul.	MENECHME ravi seul.
O Dieux!	Ô Dieux!
qu’auec plaiſir i’aurois veu ſa folie, Si i’eſtois deliuré de ma melancholie, Mais ie ne puisforcer l’excez de mes ennuis, Tout m’eſt deſagreable in l'eſtat où ie ſuis, En l’extremi ſureur dont i’ay l’ame embrazee, Ie verſerois des pleurs d vnſuiet de rizee, Plus confus, & plus mort que ie ne ſus iamais, Ie vay chercher quelqu’vn qui trauaille à ma Pix.	qu'avec plaisir j'aurais vu sa folie, Si j'étais délivré de ma mélancolie, Mais ainsi ne puisforcer l'excès de mes ennuis, Tout m'est désagréable in l'état où je suis, En l'extrême sûreur dont j'ai l'âme embrasée, Je verserais des pleurs d' unsuiet de rise, Plus confus, et plus mort que je ne sus ais, Ie vay chercher quelqu'un qui travaille à ma Pix.
ACTE V SCENE PREMIERE.	ACTE V CÈNE PREMIÈRE.
MENECHME, SOſ.	MENCHME, SOs.
MESSENIE.	MESSENIE.
MENECHME Soſicle.	MENCHME Sosicle.
Mour il eſt trop vray.	Mour il est trop vrai.
ma raiſon i’eſt renduë, M'on eœur bumilié, ma franchiſe eſt perduë.	ma raison j'est rendue, M'on eœur bumilié, ma franchise est perdue.
Sil’on eſt amoureux apres tous ces effits, I’ayme, ie le confeſſe oul’on n’ayma iamais, Mais l'obiect que ie ſers auroit charmé Cithere.	Sil’on est amoureux après tous ces effits, J'aime, tu le confesse oul'on n'aima jamais, Mais l'objet que je sers aurait charmé Cithère.
Il auroit demoly les temples de ta mere, On v’y graueroit plus ſon nom, ny ſes portraicts, Si ma belle en ces lieux auoit porté ſes traicts;	Il aurait démoli les temples de ta mère, On vy oit plus son nom, ni ses portraicts, Si ma belle en ces lieux auoit porté ses traicts;
Il faut que tout ſuccombe à ſa ſorce infinie, On ne luy peut ietter vne œillade impunie;	Il faut que tout succombe à sa sorce infinie, On ne te peut jeter une œillade impunie;
Il faut ozer ſouffrir alors qu’on l’oze voir.	Il faut oser souffrir alors qu'on l'ose voir.
Et ſon moindre regard vous range à ſon pouuoir, Elle porte enſes yeux des traits ineuitables, Ta miren'en a point qui ſoient ſi redoutable	Et son moindre regard vous range à son pouvoir, Elle porte enses yeux des traits inévitables, Ta mirenen a point qui soient si redoutable
MESSENIE.	MESSENIE.
Tous eſtfais, les voicy, ſous ces eleſi i'ay nimis, Tout ce que vous auiet en ma garde commis, Eſtant enliberté ie veux viure ſans peine Et n’auoir pluiaeſoin	Tous estfais, les voici, sous ces elesi j'ai nimis, Tout ce que vous ajet en ma garde commis, Étant enliberté un veux vivre sans peine Et n'avoir pluiaesoin
MENECHME.	MENCHME.
Ai-tul ami bien ſaind	Ai-tul ami bien saind
MESSENIE.	MESSENIE.
Teſpert toutesfois auoir touſiours le bien De voſtrecompagnie, & de voſtre entretiens	Tespert toutefois avoir toujours le bien De votrecompagnie, et de votre entretiens
MENECHME ſeul.	MENCHME seul.
Que dit cet inſenſe?	Que dit cet insensé?
MESSENIE.	MESSENIE.
Viuant en domeſtique Qui ne releuepoint d'vn vouuoir tyraxnique, Mais de qui les de oirs & la ſoumiſm, Depandront ſeulement de l’inclination.	Vivant en domestique Qui ne relèvepoint d'un vouvoir tyraxnique, Mais de qui les de oirs et la soumism, Dépandront seulement de l'inclination.
MENBCHME.	MENBCHME.
D'oh vient tuconceuoir de ſi belles idecs, Traiſtre, combien as-tu de bouteilles vuidees?	D'oh vient tuconcvoir de si belles idecs, Traître, combien as-tu de bouteilles vidées?
Ilte faut donc attendre, & te cbercher pan tout, I'ay viſité le port del'ux à l’autre bout, I'ay fait dans toutel'ſte vne recherche vaine, Et tupaſſetton temps lort que ie ſuis en peinet	Il faut donc attendre, et te cbercher pan tout, J'ai visité le port dél'ux à l'autre bout, J'ai fait dans toutel'site une recherche vaine, Et tupasseton temps lort que je suis en peinet
MESSENIE.	MESSENIE.
Relaſchez-vous, ſi toſt, voſtre eſprit genereux, Et vous repentez-vous de m’auoir fait heureux?	Relâchez-vous, si tôt, votre esprit généreux, Et vous repentez-vous de m'avoir fait heureux?
N’ay-ie pas à vos yeux ſigualé mon courage, Mammila duui panuus temps la valeur en ſeruage?	N'ai-je pas à vos yeux sigualé mon courage, Mammila duvy anuus temps la valeur en servage?
Remutez-vous aux fers qui vous a deliurét	Remutez-vous aux fers qui vous a deliurét
MENECHME.	MENCHME.
Apprends moy ie teprie où tu t'es enyuré;	Apprends moi -je teprie où tu t'es enivré;
Eſt-se là qu’on t’a veu ſignaler ton addreſſe, ais tu baieu le maiſtre ou querellé l'hoſteſſe.	Est- là qu'on t'a vu signaler ton adresse, ais tu baieu le maître ou querellé l'hôtesse.
MESSENIE.	MESSENIE.
O Dieu!	Ô Dieu!
le vain propos ee diſcours m'eſt il deu Pour lerare plaifir que ie vous ay rendu, Auec combien d’adreſſe, & combien de colere, Vous ay-ie oſtez des mains d’vne troupe aduerſairet Qui vous trainoit ſans doute aux priſons de ceslieux, Vous auez veuces gens diſparoiſtre à mœyeux, Et vous auez donné ma franchiſe à ma peine, Si voui ne me flattiez d’vne eſperants vaine.	le vain propos ce discours m'est il dev Pour lérare plaisir que je vous ai rendu, Avec combien d'adresse, et combien de colère, Vous ai-je ôtés des mains d'une troupe aversairet Qui vous traînait sans doute aux prisons de ceslieux, Vous avez veuces gens disparaître à mœyeux, Et vous avez donné ma franchise à ma peine, Si voui ne me flattiez d'une espérants vaine.
MENECHME.	MENCHME.
D'où vient cet inſenſé forger ces viſions, Et qui t’a veu paraiſtre en ſes occaſions?	D'où vient cet insensé forger ces visions, Et qui t'a vu paraître en ses occasions?
MESSENIE.	MESSENIE.
Que monſort eſt propice, & ma fortune heuveide O le maiſtre diuin!	Que monsort est propice, et ma fortune heuveide Ô le maître divin!
ô l'ame genereuſe!	ô l'âme généreuse!
Que cet homme eſt pourueu derares qualitez, Qui pourroit exprimer ſes liberalitez?	Que cet homme est pourvu derares qualités, Qui pourrait exprimer ses libéralités?
MENECHME.	MENCHME.
Ceſſe de murmurer ſi tu ne bays ta vie, Et ſuy moy chez l’obiect dont mon amo eſt raquie, O Dieux!	Cesse de murmurer si tu ne bays ta vie, Et suis -moi chez l'objet dont mon amo est raquie, Ô Dieux!
comme à propos ces aſtres glorieux, Viennent faire briller leur lumieres à met yenx.	comme à propos ces astres glorieux, Viennent faire briller leur lumières à met yenx.
SCENE II.	SCÈNE II.
MENECHME Soſ.	MENCHME Sos.
EROTIE à la porte.	EROTIE à la porte.
MESSENIE.	MESSENIE.
MENECHME Soſ.	MENCHME Sos.
tTRiſte, conſus, charmé i'apportei y Madame, Vn cœur qui n’eſt plurlibre, & des veux tout det ame, Quelque rare pouuoir qu’on donne à vos beautez, Quoy qu’ayent iamais produit les traits que vous iettez, Qelque inſigne fioideur qui cede à vos amor0 Cetteſeule defaite a ſignalé leurs forces, Iamais dans vn eſpriton n’a veutant de feu, Et iamaisla raiſon ne combattit ſi peu;	tTRiste, consus, charmé j'apportei y Madame, Un cœur qui n'est pleurlibre, et des veux tout dét âme, Quelque rare pouvoir qu'on donne à vos beautés, Quoi qu'aient jamais produit les traits que vous jetez, Qelque insigne fioideur qui cède à vos amor0 Cetteseule défaite a signalé leurs forces, Jamais dans un espriton n'a vutant de feu, Et jamaisla raison ne combattit si peu;
Vos charmes rauiſſans m'ont forcé de me rendre;	Vos charmes ravissants m'ont forcé de me rendre;
Sans l’auoir conſuliee, & ſans m'ozer deffendre.	Sans l'avoir consulie, et sans m'oser défendre.
MESSENIE.	MESSENIE.
Ouy ſon amour eſt grande, ô le parfait amant, lameure s’il ſpait rieu apres te tompliment, Par tout où nous allons, il dit ila meſme choſe, Mais apres ce diſcours il ala bouche cloſe,	Oui son amour est grande, ô le parfait amant, lameure s'il sait rieu après te tompliment, Par tout où nous allons, il dit -ila même chose, Mais après ce discours il ala bouche close,
EROTIE.	EROTIE.
I'admire fort.	J'admire fort.
Monſieur, ce changement ſoudain, Ie croyois n’eſtre plus qu'un obiet de dedain:	Monsieur, ce changement soudain, Je croyais n'être plus qu'un objet de dédain:
Et vous voyant ſortir auec tant de colero, Ie ne me flattois plus de l’eſpoir de vous plaire:	Et vous voyant sortir avec tant de colero, Je ne me flattais plus de l'espoir de vous plaire:
Parlons de ce poinfon que ie vous ay rendu, Le cherchez- vous encor, où l’auez vous perdu?	Parlons de ce pointfon que je vous ai rendu, Le cherchez- vous encor, où l'avez -vous perdu?
MENECHME.	MENCHME.
Il eſt chez vn orpheure, & dés demain i'eſpere, De le voir dans ce poil, ſi le Soleil m'íclaire, Mais que ie ſuis confus du diſcours que i’entends!	Il est chez un orpheure, et dès demain j'espère, De le voir dans ce poil, si le Soleil m'claire, Mais que sans suis confus du discours que j'entends!
Madame exemptez moy de reſuer plus longtemps:	Madame exemptez -moi de rêver plus longtemps:
Surquoy qui ie midite, & que ie m'enami111 I'ay touſiours reutré voſtre beauté diuine, Ie n’ay veu ces attraits que d’vn æil amoureux, Et que dant le reſput qu'on doit auoir pous eux.	Sur quoi qui midite, et que je m'enami111 J'ai toujours reutré votre beauté divine, Je n'ai vu ces attraits que d'un æil amoureux, Et que dant le resput qu'on doit avoir pous eux.
EROTIE.	EROTIE.
Ie nepuis que comprendre en tout clt artiftee;	Je nepuis que comprendre en tout clît artifée;
Maisentrons là dedans que it vous y puniſſe,	Maisentrons là -dedans que it vous y punisse,
MESSENI E ſeul.	MESSENI E seul.
Dieux!	Dieux!
le mal heur extréme où mes iours ſont reduits, Dure condition que l'eſtat où ie ſuis Il va cueillir les fruicts où ſon deſir le porte, Durant que ie m’amuſe à garder cetteporte, Il conſidere peu, le froid, ou la chaleur, Il me troit bien par tout, & rit de mon malbeur Sous quel aſtre inclement le Cul m'a-il fait naiſtre?	le mal heur extrême où mes jours sont réduits, Dure condition que l'état où tu suis Il va cueillir les fruits où son désir le porte, Durant que Un m'amuse à garder cetteporte, Il considère peu, le froid, ou la chaleur, Il me troit bien par tout, et rit de mon malbeur Sous quel astre inclément le Cul m'a-il fait naître?
Que n’eſt ilen ma place, & que ne ſuis ie Maiſtre?	Que n'est ilen ma place, et que ne suis a Maistre?
Que le Ciel eut pour moy d’aueugle auerſion De ne me tirer pas d’vne autre extradtion;	Que le Ciel eut pour moi d'aveugle aversion De ne me tirer pas d'une autre extradtion;
Que ie porte d'enuie à ſes bonnes fortunes!	Que ie porte d'envie à ses bonnes fortunes!
A-il des qualitez qui ne me ſoient communes?	A-il des qualités qui ne me soient communes?
A il meilleure mine, eſt-il plus gen reux?	À il meilleure mine, est-il plus gen reux?
Pourquoy ne ſuis-ie pas egalement heuręux?	Pourquoi ne suis-je pas également heurreux?
S’il l’emporte ſur moy, c’eſt d’vn peu d'apparence, Les habit, ſeulement font noſtre difference;	S'il l'emporte sur moi, c'est d'un peu d'apparence, Les habit, seulement font notre différence;
Et pourle rare exploit, que t'ay fait en tes lieux, Le ſaperbe qu’il eſt, me deuſt voir d'autresyeux, La valeur en te Fecle eſt bien mal recounuë, Le vice va couuert, & la vertu vanuë, Le monde eſt abruty.	Et pourle rare exploit, que t'ai fait en tes lieux, Le saperbe qu'il est, me dût voir d'autresyeux, La valeur en te Fecle est bien mal recounue, Le vice va couvert, et la vertu vanue, Le monde est abruti.
ſes inclinations Ne dounent plus de prix aux belles actions;	ses inclinations Ne dounent plus de prix aux belles actions;
L’eſprit n’a point derang, le fort, & la naiſſance Donnent toute la gloire, & toute la puiſſance.	L'esprit n'a point derang, le fort, et la naissance Donnent toute la gloire, et toute la puissance.
Mais à quoy ſeruirovt ces doctes entretiens, Que m’arriuera-i' des diſcours que ie tiens?	Mais à quoi serviroût ces doctes entretiens, Que m'arrivera-i' des discours que ie tiens?
Mon ſort nepeut changer, & toute ma ſcien116 Me proſitera moins, qu’un peu de patience.	Mon sort nepeut changer, et toute ma scien16 Me prositera moins, qu'un peu de patience.
SCENE III.	SCÈNE III.
ORAZIE Seule.	ORAZIE Seule.
V vne eſtrange manie a trouble ſes eſprits, Il a tout fait trembler eu l’humeur qui Ila pris.	V Votre étrange manie a trouble ses esprits, Il a tout fait trembler eu l'humeur qui Ila pris.
Auec vne autre fou, dont l’aueugle aſſeſt ince L’atiré de nos mains, & de noſtre pu ſſance;	Avec une autre fou, dont l'aveugle assest ince Latiré de nos mains, et de notre pu ssance;
Il rendra ce poincon à l’aimable beauté, Dont les perfections ont ſon cœur enchanté;	Il rendra ce poinçon à l'aimable beauté, Dont les perfections ont son cœur enchanté;
Que ie la reprendr ay de viure de la ſorte, St ie trouue quelq u'un qui me monſtre ſa porEt qu’ille a peud égard al'infamermnom Qui ternira ſa gloire & tachera ſonnom, Ses vertus paroiſſoient vn meroir de noſtre âge, La meſme modeſtie eſt peinte en ſon viſage, Et io ne croyois pas que ſans auerſion, On la peut accuſer d'vne laſche action, Cepend eut nos maris luy donnent des viſites, Elle regoit leurs dous, & ſouffre leurs pourſui1es, Le mien eſt ſi touché de cet obiet charmant, Qu’auec ce qu’il me vole il perd le iugement:	Que afin la reprendr ai de vivre de la sorte, St Un trouve quelq uun qui me monstre sa porEt qu'ille a peud égard al'infamermnom Qui ternira sa gloire et tachera sonnom, Ses vertus paraissaient un meroir de notre âge, La même modestie est peinte en son visage, Et jo ne croyais pas que sans aversion, On la peut accuser d'une lâche action, Cépend eut nos maris Seigneur donnent des visites, Elle regait leurs dous, et souffre leurs poursui1es, Le mien est si touché de cet objet charmant, Qu'avec le qu'il me vole il me le iugement:
Dieuxiqu Ergaſte à prepesà mes yeuï ſe preſente, Il me peut faire voir cette indiſcritte amantt, Et ie l’al’ois chercher pour cutte occaſion	Dieuxiqu Érgaste à prépesà mes yeu se présente, Il me peut faire voir cette indiscritte amant, Et ie ondamois chercher pour cute occasion
SCENE IV.	SCÈNE IV.
ERGASTE, ORAZIE.	ÉRGASTE, ORAZIE.
ERGASTE.	ÉRGASTE.
Telle peine eſt égalle à ma cosfuſion, Qu'on ne me blaſme plus de peu de continence, Ie ſuis le ieuſne meſme & la meſme abſtinence;	Telle peine est égale à ma cosfusion, Qu'on ne me blâme plus de peu de continence, Je suis le jeune même et la même abstinence;
Ie n’ay vécu que d’air depuis que Iœi du jour A pris conce de l’onde, de commence ſou tour;	Je n'ai vécu que d'air depuis que Jœi du jour A pris conce de l'onde, de commence sou tour;
O Dieux que l’Ouun.	Ô Dieux que l'Ouun.
a f gué de l’Ourſe, Et que le tour du ciel eſt vas lonque courſel	a f gué de l'Ourse, Et que le tour du ciel est vas lonque cours
ORAZIE.	ORAZIE.
Ergaſte pourrois-tu metirer de ſouy;	Ergaste pourrais-tu metirer de souy;
Oà demeure Erotie?	Ôà demeure Erotie?
ERGASTE.	ÉRGASTE.
Elle dumeure icy.	Elle dumeure ici.
ORAZIE.	ORAZIE.
Ne m’abandonnepoint ie recognoy ce traiſtre;	Ne m'abandonnepoint ie recognoy ce naître;
Vey comme il a rougy quand il m'a veu paraiſtre.	Vei comme il a rougi quand il m'a vu paraître.
SCENE V.	SCÈNE V.
ORAZIE, ERGASTE, MES.	ORAZIE, ERGASTE, MES.
SENIE.	SENIE.
ORAZIE.	ORAZIE.
N'eſt-ce pas toy voleur?	N'est-ce pas toi voleur?
MESSENIE.	MESSENIE.
L’honviſte compliment!	L'honviste compliment!
ORAZIE.	ORAZIE.
Qui porte leipoulets & qui ſers cet Amant;	Qui porte leipoulets et qui sers cet Amant;
Toy qu’on dit que Menechme a touſiours à ſa ſuite?	Toi qu'on dit que Menechme a toujours à sa suite?
Qui nous l'as arraché, qui nous as mis en fuitte?	Qui nous l'as arraché, qui nous as mis en fuite?
MESSENIE.	MESSENIE.
Tous les iours ma valeur a de plus beaux effets, C’eſt la moindre aſtion que ie commis iamais I’ay profané mes bras pour vn ſi petit nombre, Et ie n’auois beſoin d’employer que mon ombre.	Tous les jours ma valeur a de plus beaux effets, C'est la moindre astion que ie clis jamais J'ai profané mes bras pour un si petit nombre, Et grands n'avais besoin d'employer que mon ombre.
ORAZIE.	ORAZIE.
Traiſtre qui t’obligeoit à t’adreſſer à Nous?	Traître qui t'obligeait à t'adresser à Nous?
E quelle part as tu dans l’interest des fous?	E quelle part as tu dans l'intérêt des fous?
MESSENIE.	MESSENIE.
Donnez à vos valet, la qualité de traiſtre.	Donnez à vos valet, la qualité de traître.
Et ne vous meſlez point de parler de mon maiſtre;	Et ne vous mêlez point de parler de mon maître;
Quel ſuies auiez-vourde le traitter ainſi, Luy que iusqu'à ce iour n’entra iamais icy.	Quel suies aviez-vourde le traiter ainsi, Lui que jusqu'à ce jour n'entra jamais ici.
ERGASTE.	ÉRGASTE.
Madame entendez- vous le propot qu’il auan.	Madame entendez- vous le propot qu'il avan.
*:	*:
EV.	EU.
Quoy!	Quoi!
Menechme eſt ton Maiſtre, ô quelle extrauagance.	Menechme est ton Maître, ô quelle extravagance.
MESSENIE.	MESSENIE.
Helai!	Hélai!
ſanste citer mes ſeruices paſſez, L’état où tu me voit te le coufirme aſſez:	sanste citer mes services passez, L'état où tu me voit te le couffirme assez:
Tous autre que mon Maiſire en des chaleurs ſi fortes.	Tous autre que mon Maisire en des chaleurs si fortes.
Ne m’obligeroit pas à demeurer aux portes;	Ne m'obligerait pas à demeurer aux portes;
Mais il faut obeir, & le Cielirrité, M’enioignit ennaiſſant cette noteſſité, La mine & la valear ſont peu conſi derees Lors que d'vn mauuas aſtre elles ſont éclairees, Le iour que ie naquisétoit vn mauuais temps, Et les Dieux en ceiour combattoient les Titans:	Mais il faut obéir, et le Cielirrité, M'enioignit ennaissant cette notessité, La mine et la valar sont peu consi dères Lors que d'un mauvas astre elles sont éclairees, Le jour que je naquisétoit un mauvais temps, Et les Dieux en cejour combattaient les Titans:
Le Ciel n’eſtoit pas tel qu’on le voit de couſtu me, Les aſtres les plus doux verſoient de l’amertu.	Le Ciel n'était pas tel qu'on le voit de coutu me, Les astres les plus doux versaient de l'amertu.
me;	me;
Les femmes enfantoient auec mille tourmens, Lucine eſtoit troublee en leurs accouchemens, En fin ie naſquis ſerſ, pleurant, triſte, malade Comme ſi i'euſſe eu vart aupeché d’Encelade, Mais ie vou, traiste icy de mets trop delicats, Etis parle à des geniquine m'entendent pus.	Les femmes enfantaient avec mille tourments, Lucine était troublée en leurs accouchements, En fin ie nasquis sers, pleurant, triste, malade Comme si j'eusse eu vart aupéché d'Encelade, Mais ie tu, traite ici de mets trop délicats, Étis parle à des géniquine m'entendent pus.
ERGASTE.	ÉRGASTE.
Que j'eſtou attentif à cer belles parolles, Ma faim ſe repaiſſoit de ces comptes friuolles, Ne pleure point amy, ton mal heur euident, Puiſque nous ſommes nez ſous vn meſme aſcendant:	Que j'étou attentif à cer belles paroles, Ma faim se repaissait de ces comptes frivoles, Ne pleure point ami, ton mal heur évident, Puisque nous sommes nés sous un même ascendant:
Plûtoſt rend grace au Ciel, & me permets de dir e pue.	Plutôt rend grâce au Ciel, et me permets de dir é lève.
Ie dous bien l’accuſer ſi tu n'espas content, I'ay ieuſné pour huict iours, & to beu pou autant.	Je dous bien l'accuser si tu n'espas content, J'ai ieusné pour huit jours, et to buvu pou autant.
ORAZIE.	ORAZIE.
Laiſſons là cet yurongne.	Laissons là cet yurongne.
MESSENIE.	MESSENIE.
Euitez ma ſurie, Quellepreuue auez vous de mon yuregnerie?	Euitez ma surie, Quellepreuve avez -vous de mon yuregnerie?
ERGASTE.	ÉRGASTE.
Quelle pre que en faut il que tesprotres diſcourst	Quelle près que en faut -il que tesprotres discours
MISSENIE.	MISENIE.
Que i'ay tort de parler à des 'ſprits ſi lourds EV.	Que j'ai tort de parler à des ' èsprits si lourds EU.
ERGASTE.	ÉRGASTE.
Tu nout voudrois prouuer que Menec'me eſt ton maiſtre, Toyqu’il ne vid iamait, & qu’il ne peut connoijm.	Tu nout voudrais prover que Ménecme est ton maître, Toiqu'il ne vit jamait, et qu'il ne peut connaisjm.
MESSENIE.	MESSENIE.
Il ne me vidiamais?	Il ne me vidiamais?
Oypour en parler mieux Que ie ne fus iamais éloigné de ſes yeux.	Oypour en parler mieux Que ils ne fus jamais éloigné de ses yeux.
Dy que depuis ſix ans, à la mercy de l’onde Nous auons fait le tour de la moitié du monde;	Dis que depuis six ans, à la merci de l'onde Nous avons fait le tour de la moitié du monde;
Que ſi nous n’obtenons la fin de ſon deſſein, Rien ne nous peut tirer de ſon humide ſein.	Que si nous n'obtenons la fin de son dessein, Rien ne nous peut tirer de son humide sein.
ORAZIE.	ORAZIE.
Qui luy fait conceuoir ce diſcours inutile?	Qui avait fait concevoir ce discours inutile?
Siiamais mon eſpoux n'eſt ſorty de cette 'ſle.	Siiamais mon époux n'est sorti de cette ' Île.
MESSENIE.	MESSENIE.
Dieux les plaiſans propos!	Dieux les plaisants propos!
que me veulent ces fous?	que me veulent ces fous?
Ie parle de Menechme, & non de voſtre eſpoux.	Je parle de Menechme, et non de votre époux.
ERGASTE.	ÉRGASTE.
Mippon parle à Madams aues plus de pru dence.	Mipon parle à Madams avez plus de pru denee.
Oùie vaisde cent couprpunir ton impudenee.	Où vaisde cent couprpunir ton impudence.
MESSENIE.	MESSENIE.
Approche, approche vn peu qu’il diſcoure hardiment:	Approche, approche un peu qu'il discoure hardiment:
Lache, m’ozerois-tu regarder ſeulemeut?	Lache, m'oserais-tu regarder seulemut?
ERGASTE tout bas.	ÉRGASTE tout bas.
Foible comme ie ſuis, il pourroit bien m’abbattre.	Faible comme tu suis, il pourrait bien m'abattre.
Veuqu'en luy i’ay Bachus, & luy-meſme à combattre.	Veuqu'en amour j'ai Bachus, et notre-même à combattre.
Ne tomminont pouriant hucune lâcheté, Et ne rabbaiſſons rien de noſtre granité.	Ne tomminont pouriant hucune lâcheté, Et ne rabaissons rien de notre granité.
Mais quilqu'vn va ſortir, c’eſt Ment hme Madame, Et vous voyez l’obiet de ſa nouuelle flame.	Mais quilqu'un va sortir, c'est Ment hame Madame, Et vous voyez l'objet de sa nouvelle flamme.
SCENEVI.	SCENEVI.
ORASIE, ERGASTE, MESSENIE.	ORASIE, ERGASTE, MESSENIE.
MENECHME Soſicle, EROTIE.	MENCHME Sosicle, EROTIE.
MENECHME Soſ.	MENCHME Sos.
TEtinnocens attraits m'ent fau nſiſeE ter.	TEtinnocents attraits m'ent fau nsiseE ter.
Et ie vay remourir au point de te quitter, Adieu, mais perdsmon tout la creance ob ßinte Que rien pûſt diuertir noſtre heureux Hymenee Derechef ie renonce au bien de la clairté, Si iamais ſous ce ioux mon cœur fut arreſté.	Et petit vais remourir au point de te quitter, Adieu, mais perdsmon tout la créance ob ssinte Que rien pût divertir notre heureux Hymène Derechef ie renonce au bien de la clairté, Si jamais sous ce youx mon cœur fut arrêté.
ORAZIE.	ORAZIE.
Hais'ileſtoit ainſi que ie viurois conceate, Et qu’vn rigour eux ſort veut que ie te demente Ton cœur ne fut iamais ſout ce ioug arreſté?	Hais'ilestait ainsi que ici vivrais conceate, Et qu'il rigour eux sort veut que sans te démente Ton cœur ne fut jamais sout ce joug arrêté?
Que teſuit ie donc traiſtre!	Que tesuit Seigneur donc traître!
en quelle qualité?	en quelle qualité?
La loy qui nous aſſemble eſt-ce une loy proſanil Ay ie part en tonlict comme ta courtizane?	La loi qui nous assemble est-ce une loi prosanil Ai fait part en tonlict comme ta courtisane?
N’ay ie point tort laſcif, de me vanter de plus Que d’auoir aſſouuites deſirs diſſolus?	N'a ie point tort lascif, de me vanter de plus Que d'avoir assouites désirs dissolus?
Tous met contentem eniont iliété des crimes?	Tous met contentement eniont iliété des crimes?
N'ay-ie receu iamais de baiſerslegitimes?	N'ai-je reçu jamais de baiserslegitimes?
Es tu pour ces raiſons poſſeſſeur de mon bient Tutrembles, tu palis, tu ne me réponds rin?	Es tu pour ces raisons possesseur de mon bient Tutrembles, tu palis, tu ne me réponds rin?
MENECHME.	MENCHME.
Bons dieux!	Bons dieux!
combien ie l ay cette femme impor tune;	combien ici l ai cette femme impor tune;
Quoy' nous ſommes vnis ſous vne loy cemmune?	Quoi nous sommes unis sous une loi cemmune?
Himenee, autreſois a mon ſerm ent reces?	Himenee, autresois à mon serm ent recès?
Seroit-ie marié ſans m’eaetre appercea?	Serait-je marié sans m'eaètre aperceà?
Tan eſprit eſt bieſſe d'une estrange ma nte!	Tan esprit est biesse d'une étrange ma nte!
Ie nete connois point, i'entre en Epidamnie;	Je nette connais point, j'entre en Épidamnie;
Ce matin qu’elle m'a ce diſcours auancé, Sescris m’ont obligé de paroiſtrein enſe;	Ce matin qu'elle m'a ce discours avancé, Sescris m'ont obligé de paroistrein ense;
Ie l'ay ſait eſloigner par cette heureuſefeinte, Et voila qu’elle vient recommencer ſaplainte, QuIe autre inuention doit eßtre mon recours!	Je l'ai sait éloigner par cette heureusefinte, Et voilà qu'elle vient recommencer saplainte, QuIe autre invention doit eutre mon recours!
R'eutrons, exemptez-moy d'entendre ſes diſcours.	R'eutrons, exemptez-moi d'entendre ses discours.
EROTIE.	EROTIE.
Quoy!	Quoi!
vous niez, Monſieur le nœud qui vour aſſembla, Depuis ſix ans entiers que vous eſtes enſemble, Ie ne puis que iuger de tette intention.	vous niez, Monsieur le nœud qui vour assembla, Depuis six ans entiers que vous êtes ensemble, Je ne puis que juger de tette intention.
ORAZIE.	ORAZIE.
Madame elleprouient de voſtre affection, Cette meſcognoiſſance à vos yeux eſt tropnue, S’il ne me tognoiſt plus, c’eſt qu'il vous a tonnue.	Madame elleprovient de votre affection, Cette méconnaissance à vos yeux est tropnue, S'il ne me tognoist plus, c'est qu'il vous a tonnue.
La quailté d’eſpoux luy peſeinſiniment, Ie ſuis vn grand obstacte à ſon contentement, Sa femmel’importune ayant tant de maiſtreſ, ſes, Ie ne luy permets pas d’acheter vos careſſes, De vanter vos faueurs, de diſſiper ſon bien, Et de chercher la nuid d’autre lict que le mien, Seuffrant qu’il vous hantaſt, auec cette licence, Ie ne me plainarois plus de ſa meſcognoiſſance, Hne me dirous plus qu’il ne me vid iamais, Et cette liberté retabliroit la paix;	La quailté me époux plus pèneinsiniment, Je suis un grand obstacte à son contentement, Sa femmelimportune ayant tant de maîtres, ses, Plain ne avait permets pas d'acheter vos caresses, De vanter vos faveurs, de dissiper son bien, Et de chercher la nuid d'autre lit que le mien, Seuffrant qu'il vous hantât, avec cette licence, Je ne me plainais plus de sa méconnaissance, Haine me dirous plus qu'il ne me vit jamais, Et cette liberté rétablirait la paix;
Mais ie ne puis ſouffrtr qu’il viue de la ſorte:	Mais ici ne puis souffr qu'il vive de la sorte:
Ie me plaint tousles iours des preſens qu’il vou, porte, Ie l'oblige à rougir de ſes feux d ſſolus, Et t’eſtpour ce ſuiet qu'il ne me cognoiſt plus.	Je me plaint tousles jours des présents qu'il vou, porte, Je l'oblige à rougir de ses feux d solus, Et t'estpour ce sujet qu'il ne me connaît plus.
EROTIE.	EROTIE.
I'excuſe vosſoupfons, & ris de ce langage, Il ſpait ſi i’ay receu quelque don qui m'engaSonimportunité m'en a fait receuoir, Il eſt vray qu’il m'lerit, & qu’il m’oſt vinu voir, I'ay ſouffert ees deux points, mais cette toleranA deu iuſquesity borner ſon eſperance, La méme honneſteté permet de ſe hanter;	J'excuse vossoupfons, et ris de ce langage, Il spait si j'ai reçu quelque don qui m'engaSonimportunité m'en a fait recevoir, Il est vrai qu'il m'élit, et qu'il m'ost vinu voir, J'ai souffert ces deux points, mais cette toleranA devre jusquesiti borner son espérance, La même honnêteté permet de se hanter;
S’ilobtient d’auantageil i’en peut bien vanter.	S'ilobtient d'avantageil j'en peut bien vanter.
MENECHME.	MENCHME.
Dieux!	Dieux!
que puis-ie comprendre en tes comptes friuolles	que puis-je comprendre en tes comptes frivoles
MESSENIE.	MESSENIE.
Et ne voyez-vouspas que ces ſemmes ſont ſolles Que nous demandez-vous qu’a fait tereſtranAuez vousr-ſolu de nous faire enrayer?	Et ne voyez-vouspas que ces semmes sont solles Que nous demandez-vous qu'a fait tertranAuez vousrsolu de nous faire enrayer?
SCENE DERNIERE.	SCÈNE DERNIÈRE.
MENECHME Soſicle, MENECHME Rauy, MES SENIE, EROTIE, ORAZIE, ERGASTE, LE VIEILLARD, LE MEDECIN, Lut nEnle	MENECHME Sosicle, MENCHE Ravi, MES SENIE, EROTIE, ORAZIE, ERGASTE, LE VIEILLARD, LE MÉDECIN, Lut nEnle
MENECHME Rauy, eſtant pourſuiuy du Vieillard, du Medecin, & du Valet.	MENCHME Ravi, étant poursuivi du Vieillard, du Médecin, et du Valet.
V'on blaſme ma foibliſſe, & qu'on me la reproche.	V'on blâme ma foiblisse, et qu'on me la reproche.
ve ie n’étends à bas le premier qui m'approche, Que me veulent cesgens?	ve ici n'étends à bas le premier qui m'approche, Que me veulent cesgents?
E VIEILLARD dit aux Valets.	E VIEILLARD dit aux Valets.
Allez, que craignez vous?	Allez, que craignez -vous?
MENECHME rauy.	MENCHME ravi.
Sils ont l'eſprit bien ſain qu’ils craignent mor courroux.	Sils ont l'esprit bien sain qu'ils craignent mór roux.
LE MEDECIN.	LE MÉDECIN.
Marchez, ſaiſiſſez-le.	Marchez, saisissez-le.
MENECHME rauy.	MENCHME ravi.
Si quelqu’vn d'eux s’auanct.	Si quelqu'un d'eux s'avanct.
UN VALET.	UN VALET.
Erecutez vous meſme vne telle o-donnance Iecrains.	Erecutez vous -même telle ô-donnance Jécrains.
LE MEDECIN.	LE MÉDECIN.
Qi	Ai
VN VALET.	UN VALET.
Sa folie.	Sa folie.
MENECHME rauy.	MENCHME ravi.
Ha traiſtre ce diſcours.	Ha traître ce discours.
O nuux!	Ô nuux!
IN VALIT.	IN VALIT.
MENECHME rauy.	MENCHME ravi.
Sera ſuiuy de la fin de ſis iours.	Sera suivi de la fin de sis jours.
MESSENIE.	MESSENIE.
Que vεyez vous moiyeux êprodigelí meνueille!	Que visez vous moiyeux êprodigelí meνueille!
Ie doute ſi ie vis, ie doute ſi ie veille!	Je doute si ici vis, ie doute si On veille!
Mon maiſtre eſt en deux lieux!	Mon maître est en deux lieux!
que vous veulent ces fous?	que vous veulent ces fous?
e vay vousſttourir, & ſeconder vos coupt.	Je vais vousstourir, et seconder vos coupt.
MENECHME.	MENCHME.
On ne m’attaque pas.	On ne m'attaque pas.
MESSENIE.	MESSENIE.
Voyez comme on vous traine, Et vous ne ſeutez pailareſſects deleur haint?	Voyez comme on vous traine, Et vous ne sutés pailaressects déleur haint?
ORAZIE.	ORAZIE.
Dieux!	Dieux!
qu'e quu voy!	qu'e quu vois!
MESSENIE.	MESSENIE.
Gardez n'approchez pas, vay ſeul à voiyeux vous tirer de leuribras.	Gardez n'approchez pas, vais seul à voiieux vous tirer de leuribras.
MENECHME rauy.	MENCHME ravi.
O toy qui que tu ſois dont la main fauorable M’eſt encor tette ſois a u beſoin ſecourable, jeul amy qui me reſte, autheur de mon repos.	Ô toi qui que tu sois dont la main favorable M'est encor tette sois a besoin secourable, jeul amy qui me reste, autheur de mon repos.
Que ton ſecours me vient, & m'aſſiſte à prot	Que ton secours me vient, et m'assiste à prot
MENECHME.	MENCHME.
Dieuxlie voy mon image!	Dieuxlie vois mon image!
LE VIEILLARD.	LE VIEILLARD.
O!	Ô!
Ciel à tette veuë, Quemisyeux ſont troublez, que mon ame d eſmeus.	Ciel à tette vue, Quemisyeux sont troublés, que mon âme d' eus.
ERGASTE.	ÉRGASTE.
Ce n’eſt qu’vn méme obiet ie ne puis deuirer qui des deux ce matin m'aredut à ieuner,	Ce n'est qu'un même objet ie ne puis dévirer qui des deux ce matin m'aredut à jeûner,
MESSENIE.	MESSENIE.
Qui de vous eſt Menechme, ô!	Qui de vous est Menechme, ô!
que i’ay d'eſt rance, Si ie puis de vous deux faire la difference, Si le Ciel auiour d’huy fauoriſe mes vœux, Ie trouue vn ſecond maiſtre, & vous l'eſt tous deux.	que j'ai d'est rance, Si je puis de vous deux faire la différence, Si le Ciel aujour d'hui favorise mes vœux, Je trouve un second maître, et vous l'est tous deux.
MENECHME rauy.	MENCHME ravi.
Lailie n’aypoint de gens au beſoin ſi propices Ils ne m’ont peint rendu de ſemblables offices.	Lailie n'aipoint de gens au besoin si propices Ils ne m'ont peint rendu de semblables offices.
MESSENIE.	MESSENIE.
Maisquil eſt voſtre nom, tirez-moy de ſoucy,	Maisquil est votre nom, tirez-moi de souci,
MENECHME rauy, On m’appelle Menechms.	MENCHME ravi, On m'appelle Menechms.
MENECHME.	MENCHME.
Et moy Menechme auſe.	Et moi Menechme ause.
MENECHME rauy.	MENCHME ravi.
Siracuſe, in Sicile.	Siracuse, in Sicile.
Maislai dqpuirlong-temptie demeure en ectie Iſte, Ie fus prischez mon ptre en mes plus ieune ans.	Maislai dquepuirlongtempie demeure en ectie Iste, Je fus prischez mon ptre en mes plus jeune ans.
MLOUEMIE.	MLOUEMIE.
avel eſt voſtre pays?	avel est votre pays?
MENECHME.	MENCHME.
C’eſttay n'en doutons plus que mus vaurſon contents.	C'est n'en doutons plus que mus vaurson contents.
MESSENIE.	MESSENIE.
Et voſtre pere à nont	Et votre père à nont
MENECHME rauy.	MENCHME ravi.
Moſque.	Mosque.
ME'NEGHME.	ME'NEGHME.
OIDieux lò mon frere!	ÔIDieux lettre mon frère!
O!	Ô!
vencontre agreable, e fortune proſpere.	vencontre agréable, eu fortune prospère.
Mesſoiniſont ncheuez, & mes trauaux ſinis En cet heureux moment qui nous a reunis.	Messoinisont neuez, et mes travaux sinis En cet heureux moment qui nous a réunis.
MENECHME rauy.	MENCHME ravi.
Ouy, ſi i'en ay de vous le moindretémoignage	Oui, si j'en ai de vous le moindretémoignage
MENECHME.	MENCHME.
Quand vous fuſtesrauy nous eßiont de meſ meage.	Quand vous fustesrauy nous essiont de mes ménage.
Orante eſt noſtre mere.	Orante est notre mère.
MENECHME rauy.	MENCHME ravi.
O Dieux!	Ô Dieux!
qu’ay ie ent ndu?	qu'a ie ent nédu?
Ol Menechme, mon frere.	Ol Menechme, mon frère.
MESSENIE.	MESSENIE.
Et ce cher Meſſenie, Que vout auix aymé d’vn amonr inſinie?	Et ce cher Messénie, Que vout auix aimé d'un amonr insinie?
C'aκεz-vοuιεubl l'li meſcognoiſſez-vous?	C'asez-vοuιεubl l'li méconnaissez-vous?
Ne luy ferez vous point vn viſage plus doux?	Ne notre ferez -vous point un visage plus doux?
MENECHME rauy.	MENCHME ravi.
Le temps m’a de ton nom effacé la memoire, Oimon cher Meſſenie, ôl Dieux le puis-ie croire.	Le temps m'a de ton nom effacé la mémoire, Oimon cher Messénie, ôl Dieux le puis-je croire.
LE VIEILLARD.	LE VIEILLARD.
Oibon-heur ſans pareill	Oibon-heur sans pareill
ORAZIE.	ORAZIE.
Bons Dieux qu'auont voutfait.	Bons Dieux qu'avont voûtait.
Fi cet autre Meauumin mon frere en effect.	Fi cet autre Meauumin mon frère en effet.
LE VIEILLARD.	LE VIEILLARD.
Embraſſez le ma fille.	Embrassez le ma fille.
ORAZIE.	ORAZIE.
Eſt ce donc vous monfrere Extuſez les tranſports d'une aueugle colere;	Est -ce donc vous monfrere Extusez les transports d'une aveugle colère;
Cette heureuſe rencontre amortit mon courroux, Madame, pardonnez à mesſoupgontialoux:	Cette heureuse rencontre amortit mon courroux, Madame, pardonnez à messoupontialoux:
Accordez vos defirs à ce bon heurextreme;	Accordez vos désirs à ce bon heurextre;
Et ne dedaignez pas que mon ſrere vous ayme, Puis qu'Hymen eſt l’obiet de ſes affections, Et qu’il peut diſpoſer de ſes intentions.	Et ne dédaignez pas que mon frère vous aime, Puis qu'Hymen est l'objet de ses affections, Et qu'il peut disposer de ses intentions.
MENECHME.	MENCHME.
Madamepour combler eette reſiouiſſante Auoüez mon amour, & mon obeiſſance.	Madamepour combler cette réjouissante Auoüez mon amour, et mon obéissance.
Vos charmes rauiſſansont mon cœur enchanté Et vos premiers regards, ont pris ma liberté, I’offre tous mes deſirs, i’offre mon ame nüe;	Vos charmes rauissansont mon cœur enchanté Et vos premiers regards, ont pris ma liberté, J'offre tous mes désirs, j'offre mon âme nue;
A voſtre honneſteté que i’aytrop reconnüe, Et ſi vous n’auez plus mon ſeruice à mépris, Vn fauorable Hymen conioindra nos eſprits.	À votre honnêteté que j'aitrop reconnue, Et si vous n'avez plus mon service à mépris, Un favorable Hymen conjoindra nos esprits.
EROTIE.	EROTIE.
Que ie benis œiour, & que ieſuis rauie, De voir ce changement conforme à voſtre en uie, Qu’vn extréme rapport à vos yeux abuſez, Et que i’auray failly ſi vous ne m’excuſez;	Que ici bénis œiour, et que iesuis ravie, De voir ce changement conforme à votre en vie, Qu'H extrême rapport à vos yeux abusez, Et que j'aurai failly si vous ne m'excusez;
Ie tiendray pour faueur qu’vn heureux mariaSous vn méme deſtin nos deux ames ingage, Et que cette vnion calme nos differends, Quand i’auray là deſſus conſulté mesparent;	Je tiendrai pour faveur qu'un heureux mariaSous un même destin nos deux âmes ingage, Et que cette imion calme nos différends, Quand j'aurai là dessus consulté méparent;
Il eſt en mon pouuoir d’engager ma franchiſe, Ie ſuis veſue, & ce titre en ce point m’autho:	Il est en mon pouvoir d'engager ma franchise, Je suis veue, et ce titre en ce point m'auteur:
13 Mais ie dois ce reſpect à leur authorité, Qui ne centredis point te que i’ay proietté.	13 Mais vertu dois ce respect à leur autorité, Qui ne centredis point te que j'ai proietté.
MENECHME.	MENCHME.
Qu'vn fauorable port m'a mis en cette RiueQue ie ſeray content, ſi cet honneur m’arriue, Mais mon frere qu’un mot à ce bon-heur ſoit ioiut, Ma curioſité ne veut plus que ce point, Ayaut été rauy, quelle heureuſe fortune Apû vous exempter d’vne vie importune, Ie vous croyois plus mal, vn captif, rarement, Areseu de ſon maiſtre un pareil traittement.	Qu'un favorable port m'a mis en cette RiveQue ie serai content, si cet honneur m'arrive, Mais mon frère qu'un mot à ce bonheur soit joiut, Ma curiosité ne veut plus que ce point, Aaut été ravi, quelle heureuse fortune Apû vous exempter d'une vie importune, Je vous croyais plus mal, un captif, rarement, Un de son traître un pareil traitement.
MENECHME rauy.	MENCHME ravi.
Celuy qui me rauit fut touché de ma peine, Ie n’éprouuay iamais ſa rigueur, ny ſa haine, Il m’obligea touſiours de ſon aſſection, Et is fus hoooré de ſa ſucceßion, Ie meſuis marié, i’ay vécu dans cette Iſle, Auec deſſein pourtant de reuoir la Sicile, C’eſt à vous maintenant de m’oſter de ſoucy, Que font tout nos parens?	Celui qui me ravit fut touché de ma peine, Je n'éprouvai jamais sa rigueur, ni sa haine, Il m'obligea toujours de son assection, Et is fus hooré de sa succès, Je mes marié, j'ai vécu dans cette Isle, Avec dessein tant de révoir la Sicile, C'est à vous maintenant de m'ôter de souci, Que font tout nos parents?
& qui vous meme i9?	et qui vous -même ici?
MENECHME.	MENCHME.
Ie vous compteray tout , ſois libre Meſſenu, Ie i’accorde ce don.	Je vous compterai tout , sois libre Messenu, Je j'accorde ce don.
MESSENIE O faueug infinie!	MESSENIE Ô faveug infinie!
MENECHME:	MENCHME:
Vn ſi rarebon-beurſuccede à mes ennuis, Que ie donnerois tout en l’humeur où ie ſuis.	Un si rarebon-beursucède à mes ennuis, Que avoir donnerais tout en l'humeur où tu suis.
ERGASTE.	ÉRGASTE.
Suis-ie ſeul mal-heureux, en vn bon-heur ſi rare, Ce iourreünit tout, faut-il qu’il nous ſepare?	Suis-je seul malheureux, en un bonheur si rare, Ce jourreunit tout, faut-il qu'il nous sépare?
Pardonnez à ma faim qui m’a fait vous trahir, Tout le monde i’aymant, pourriez-vous me hayri	Pardonnez à ma faim qui m'a fait vous trahir, Tout le monde j'aimant, pourriez-vous me haïri
MENECHME rauy.	MENCHME ravi.
Quepuis ie refuſer apres tant de merueilles, Leuetoy, ſuy nospas, & vuide cent bouteilles.	Quepuis ici refuser après tant de merveilles, Luvetoy, zvi nospas, et vide cent bouteilles.
ERGASTE.	ÉRGASTE.
O pardon fauerable!	Ô pardon favérable!
heureux commandeméls, Mais que deſi a n’enſuis-ie à l’accompliſſement, Haſtoninous Meſſerie, allons prendre les armes, Et noyer tous nos maux dans vn ius ſi diuin, Sdaſoif ce ;	heureux commandemls, Mais que dé a n'ensuis-je à l'accomplissement, Hâtoninous Messerie, allons prendre les armes, Et noyer tous nos maux dans un jus si divin, Sdasoif ce ;
matin m'a fait verſer des larmus Q'elle me va te ſoir faire verſer de via,	matin m'a fait verser des larmus Q-elle me va te soir faire verser de via,
