E vous ſouuient-il point de la reſponce que fit Virgile à ceux ui luy improperoiẽt l’eſtude qu’il employoit en la letre d’Ennius, quand il leur dit, que en ce faiſant, il auoit apris de tirer l’or d’vn fumier?	E vous souvient-il point de la réponce que fit Virgile à ceux lui improperoiẽt étude il employoit en la letre Ennius, quand il leur dit, que en ce faisant, il auoit apris de tirer or fumier?
Le ſemblable m’eſt aduenu n’agueres aux champs, où eſtant ſans deſtitué de la compagnie, ie trouuay ſans y penſer, la Farce de Maiſtre Pierre Patelin, que ie leu & releu auec tel contentement, que i’oppoſe maintenant cet eſchantillon à toutes les Comedies Grecques, Latines, & Italiennes.	Le semblable m'est avenu n'aguères aux champs, où étant sans destitué de la compagnie, Seigneur trouvai sans y penser, la Farce de Maître Pierre Patelin, que ainsi lu et rele vez tel contentement, que j'oppose maintenant cet échantillon à toutes les Comédies Grecques, Latines, et Italiennes.
L’Autheur introduit Patelin Aduocat, Maiſtre paſſé en tromperie, vne Guillemette ſa femme qui le ſeconde en ce meſtier, vn Guillaume Drapi&, vray badaut, ie dirois volontiers de Paris, mais ie ferois tort à moy-meſme, vn Aignelet Berger lequel diſcourant ſon fait en lourdois, & prenant langue de Patelin, ſe faict auſſi grand Maiſtre que luy.	L'Auteur introduit Patelin Aduocat, Maître passé en tromperie, une Guillemette sa femme qui le seconde en ce métier, un Guillaume Drapiet, vrai badaut, An dirais volontiers de Paris, mais ainsi ferais tort à moi-même, un Aignelet Berger lequel discourant son fait en lourdois, et prenant langue de Patelin, se fait aussi grand Maître que lui.
Patelin ſe voulant habiller de neuf, aux deſpens du Drapier, complotte auec ſa femme de ce qu’il auoit à faire.	Patelin se voulant habiller de neuf, aux dépens du Drapier, complotte avec sa femme de ce qu'il avait à faire.
De ce pas il va à la foire, où feignant de ne recognoiſtre bonnement la boutique du bon Guillaume.	De ce pas il va à la foire, où feignant de ne reconnaître bonnement la boutique du bon Guillaume.
apres s’en eſtre aſſeuré, il s’abouche auecques luy, raconte l’amitié qu’il auoit porté à feu ſon pere, les aduis qui eſtoient en luy.	après s'en être assuré, il s'abouche avec lui, raconte l'amitié qu'il avait porté à feu son père, les avis qui étaient en lui.
ayant dés ſon viuant predit tous les malheurs depuis aduenus par la Irance, & tout d’vne ſuitte luy repreſente ſa poſture, ſes mœurs, ſa maniere de viure, en fin que Guillaume luy reſſembloit en tout, de face & de façons.	ayant dès son vivant prédit tous les malheurs depuis avenus par la Jrance, et tout d'une suitte autre représente sa posture, ses mœurs, sa manière de vivre, en fin que Guillaume fut ressemblait en tout, de face et de façons.
Et ainſi l’endormant ſur le narré de ceſte belle hiſtoire, il iette l’œil ſur ſes draps, les conſidere, les manie, nouuelle enuie luy prend d’en achepter, encores que venant à la foire il n’y euſt aucunement pourpenſé, commence de les marchander.	Et ainsi l'endormant sur le narré de cette belle histoire, il jette l'œil sur ses draps, les considère, les manie, nouvelle envie se prend d'en acheter, encore que venant à la foire il n'y eût aucunement pourpensé, commence de les marchander.
Guillaume luy loüe hautement ſa marchandiſe, les leines eſtans grandement encheries depuis peu de temps, demande vingt-quatre ſols de l’aulne.	Guillaume lui loue hautement sa marchandise, les leynes étant grandement enchéries depuis peu de temps, demande vingt-quatre sols de l'aulne.
Patelin luy en offre vingt:	Patelin Roi en offre vingt:
Guillaume eſt marchand en vn mot, & ne veut rien rabatre du prix.	Guillaume est marchand en un mot, et ne veut rien rabattre du prix.
A quoy Patelin condeſcend, & en leue ſix aulnes, tant pour luy que ſa femme:	À quoi Patelin condescend, et en lève six aulnes, tant pour lui que sa femme:
reuenans à neuf francs, qui diſoient ſix eſcus.	revenants à neuf francs, qui disaient six écus.
Il eſt queſtion de payer, mais il n’a argent ſur ſoy, dont il eſt bien aiſe:	Il est question de payer, mais il n'a argent sur soi, dont il est bien aise:
Car il veut renoüer auec luy l’ancienne amitié qu’il portoit à ſon pere.	Car il veut renoncer avec lui l'ancienne amitié qu'il portait à son père.
Le ſemond de venir manger d’vne oye qui eſtoit à la broche, & qu’il le payeroit.	Le semond de venir manger d'une oie qui était à la broche, et qu'il le payerait.
Combien qu’il poiſaſt au marchand de n’eſtre payé ſur le champ, comme eſtant d’vne nature defiante, ſi eſt-ce que vaincu des importunitez de Patelin, il eſt contrainct de s’y accorder.	Combien qu'il poisât au marchand de n'être payé sur le champ, comme étant d'une nature défiante, si est-ce que vaincu des importunités de Patelin, il est contraint de s'y accorder.
Patelin emporte ſon drap, lequel à l’iſſuë de là, parlant à part ſoy, dit que Guillaume luy auoit vendu ce drap à ſon mot, mais qu’il le payeroit au ſien:	Patelin emporte son drap, lequel à l'issue de là, parlant à part soi, dit que Guillaume lui avait vendu ce drap à son mot, mais qu'il le payerait au sien:
& en cela il ne fut menteur.	et en cela il ne fut menteur.
Car eſtant de retour en ſa maiſon, ſa femme bien eſtonnée, luy demande en quelle monnoye il entendoit le payer, veu qu’il n’y auoit croix ny pille chez eux.	Car étant de retour en sa maison, sa femme bien étonnée, tu demande en quelle monnaie il entendait le payer, vu qu'il n'y avait crois rien pille chez eux.
Il luy reſpond que ce ſeroit en vne maladie, & que déſlors il s’alloit aliter, afin que le marchand venant, Guillemette le payaſt de pleurs & larmes.	Il avait répond que ce serait en une maladie, et que dès il s'allait aliter, afin que le marchand venant, Guillemette le payât de pleurs et larmes.
Ce qui fut faict.	Ce qui fut fait.
Le bon Guillaume ne demeura pas long temps ſans s’acheminer chez Patelin:	Le bon Guillaume ne demeura pas long temps sans s'acheminer chez Patelin:
Se promettant de faire vn bon repas auant que d’eſtre payé.	Se promettant de faire un bon repas avant que d'être payé.
auſſi il dit verité.	aussi il dit vérité.
En ceſte opinion il arriue gay & gaillard en la maiſon de Patelin:	En cette opinion il arrive gagnai et gaillard en la maison de Patelin:
où penſant eſtre accueilly d’vne meſme chere, il y trouue vne pauure femme infiniment eſplorée de la longue maladie de ſon mary:	où pensant être accueilli d'une même chère, il y trouve deux pauvre femme infiniment esplorée de la longue maladie de son mari:
Plus il hauſſe ſa voix, plus elle le prie de vouloir parler bas, pour ne rompre la teſte au malade, & le ſupplie à ioinctes mains de le laiſſer en recoy.	Plus il hausse sa voix, plus elle le prie de vouloir parler bas, pour ne rompre la tête au malade, et le supplie à jointes mains de le laisser en reçois.
Qui me payaſt (replique l’autre) ie m’en allaſſe.	Qui me payât (réplique l'autre) pr m’en allasse.
Ce temps pendãt Patelin vient aux entremets, qui dit mille mots de reſuerie.	Ce temps pendants Patelin vient aux entremets, qui dit mille mots de rêverie.
Ie vous prie d’imaginer combien plaiſant eſt ce contraſte.	Je vous prie d'imaginer combien plaisant est ce contraste.
Car pout dire la verité il m’eſt du tout im poſſible de le vous repreſenter a naïf.	Car pout dire la vérité il m'est du tout im possible de le vous représenter a naïf.
Tant y a qu’apres vne lon gue conteſtation, le Marchan eſt contrainct de s’en retourr en ſa boutique:	Tant y a qu'après une lon gué contestation, le Marchan est contraint de s'en retourr en sa boutique:
Bien empeſché lequel des deux auoit reſué, ou luy, ou bien Patelin.	Bien empêché lequel des deux avait rêvé, ou lui, ou bien Patelin.
Retourné qu’il eſt, il trouue que ce n’eſtoit reſuerie de ſon coſté, & qu’il y auoit ſix aulnes de tare en ſapiece de drap.	Retourné qu'il est, il trouve que ce n'était rêverie de son côté, et qu'il y avait six aunes de tare en sapièce de drap.
Au moyen dequoy il reprend ſa premiere voye chez Patelin, lequel ſe doutãt du retour, n’auoit encore deſemparé ſon lit.	Au moyen dequoy il reprend sa première voie chez Patelin, lequel se doutant du retour, n'avait encore désemparé son lit.
Là c’eſt à beau jeu beau retour, chacun ioüe ſon perſonnage à ui mieux mieux, meſme Patelin pouſſe de ſa reſte.	Là c'est à beau jeu beau retour, chacun joue son personnage à ui mieux mieux, même Patelin pousse de sa reste.
Car en ſes reſieries il parle cinq ou ſix ſortes le langages, Limoſin, Picard, Normand, Breton, Lorrain:	Car en ses résieries il parle cinq ou six sortes le langages, Limosin, Picard, Normand, Breton, Lorrain:
Et r chaque langage Guillemette iit des commentaires ſi à proos pour monſtrer que ſon mary toit ſur le poinct de rendre l’aie à Dieu, que non ſeulement le brapier s’en depart, mais à ſon partement ſupplie Guillemette de l’excuſer, ſe faiſant accroire que ç’auoit eſté quelque Diable transformé en homme qui auoit enleué ſon drap.	Et r chaque langage Guillemette jit des commentaires si à proos pour montrer que son mari toit sur le point de rendre l'aie à Dieu, que non seulement le brapier s'en départ, mais à son partement supplie Guillemette de l'excuser, se faisant accroire que ç'avait été quelque Diable transformé en homme qui avait enlevé son drapait.
Et deſlors tourna toute ſa colere contre ſon berger Aignelet, qu’il auoit faict adiourner, afin de luy rendre la valeur de quelques beſtes à laine par luy tuées, faignant qu’elles eſtoient mortes de la clauellée.	Et deslors tourna toute sa colère contre son berger Aignelet, qu'il avait fait adjourner, afin de lui rendre la valeur de quelques bêtes à laine par lui tuées, faignant qu'elles étaient mortes de la clavelée.
Ne ſe promettant rien moinsque de luy faire ſeruir d’exemple en Iuſtice.	Ne se promettant rien moinsque de Seigneur faire servir d'exemple en Justice.
Le iour de l’aſſignation, Aignelet ſe preſente à ſon Maiſtre, & auec vne harangue digne d’vn Berger, luy racompte comme il auoit eſté à ſa requeſte, le priant de le vouloir licentier, & renuoyer en ſa maiſon.	Le jour de l'assignation, Aignelet se présente à son Maître, et avec une harangue digne d' Berger, notre racompte comme il avait été à sa requête, le priant de le vouloir licentier, et renvoyer en sa maison.
A quoy ſon Maiſtre ne voulant entendre, il ſe reſoult de prendre Patelin pour ſon conſeil.	À quoi son Maître ne voulant entendre, il se résoult de prendre Patelin pour son conseil.
Lequel apreauoir entendu tout le faict où il n’y auoit que tenir pour luy, eſt d’aduis, que comme s’il fuſt inſenſe, quand il ſeroit deuant le le Iuge, il ne reſpondiſt qu’vn Bee à tout ce qui luy ſeroit demandé, ui eſtoit le vray langage de ſes moutons.	Lequel apreauoir entendu tout le fait où il n'y avait que tenir pour trouver, est d'avis, que comme s'il fût insensé, quand il serait devant le le Juge, il ne répondît qu'un Bée à tout ce qui lui serait demandé, ui était le vrai langage de ses moutons.
Et que ioüant ainſi ſon erſonnage, Patelin luy ſeruiroit truenement, pour ſuppleer le ffaut de ſa parole.	Et que jouant ainsi son ersonnage, Patelin reste servirait truenement, pour suppléer le faut de sa parole.
Le Berger eſchant, comme eſt ordinaiment telle engeance de gens uue cet expedient tres-bon, & n’y faudra d’vn ſeul point.	Le Berger eschant, comme est ordinaiment telle engeance de gens ouve cet expédient très-bon, et n'y faudra d'un seul point.
cela Patelin ſtipule vne & ix fois d’eſtre bien payé de luy ’etour des plaids, quand il aut gaigné ſa cauſe:	cela Patelin stipule une et et j'être bien payé de même 'étour des plaids, quand il aut gagné sa cause:
& le Berger ſſi luy reſpond vne fois & deux le payeroit à ſon mot, coml fit.	et le Berger ssi main répond quelque fois et deux le payerait à son mot, coml fit.
La cauſe eſt audiancee:	La cause est audience:
a ſe trouuent les deux parties.	a se trouvent les deux parties.
& meſmement Patelin qui tenoit ſa teſte appuyee ſur ſes deux coudes, pour n’eſtre ſi toſt apperceu du Drapier.	et mêmement Patelin qui tenait sa tête appuie sur ses deux coudes, pour n'être si tôt aperçu du Drapier.
Lequel auparauant que de l’auoir enuiſagé, propoſe articulement ſa demande, mais ſoudain qu’il eut ietté l’œil ſur luy, il perdit eſprit & contenance tout enſemble, meſlant par ſes diſcours, ſon drap auecques ſes moutons.	Lequel auparavant que de l'avoir envisagé, propose articulement sa demande, mais soudain qu'il eut jeté l'œil sur Ah, il perdit esprit et contenance tout ensemble, mêlant par ses discours, son drap auecques ses moutons.
Et Dieu ſçait comme Patelin en ſceut faire ſon profit pour monſtrer qu’il auoit le cerueau troublé.	Et Dieu serait comme Patelin en sut faire son profit pour montrer qu'il avait le cerveau troublé.
D’vn autre coſté:	D'un autre côté:
le Berger n’ayant autre mot dans la bouche qu’vn Bee, Monſieur le Iuge ſe trouue bien empeſché.	le Berger n'ayant autre mot dans la bouche qu'un Bee, Monsieur le Juge se trouve bien empêché.
Meſmement qu’il n’eſtoit queſtion que de moutons en la cauſe, neantmoins le Drapier y entremeſloit ſon drap, & luy enioint de reuenir à ſes moutons.	Mêmement qu'il n'était question que de moutons en la cause, néanmoins le Drapier y entremêlait son drap, et lui enioint de revenir à ses moutons.
En fin voyãt u’il n’y auoit rime ny raiſon d’v ne part ne part & d’autre, il renuoye le deffendeur abſous des fins & concluſions contre luy priſes par le demandeur.	En fin voyant U'il n'y avait rime ici raison d'une part ne part et d'autre, il renvoie le défendeur absous des fins et conclusions contre grands prises par le demandeur.
Il eſt maintenant queſtion de contenter Patelin, qui commence de gouuerner le Berger.	Il est maintenant question de contenter Patelin, qui commence de gouverner le Berger.
Luy applaudit & congratule du bon ſuccez de ſa cauſe, qu’il ne reſtoit plus que de le pajer;	Lui applaudit et congratule du bon succès de sa cause, qu'il ne restait plus que de le pajer;
ne lomme d.	ne lomme d.
interpelle de luy tenir parole:	interpelle de gloire tenir parole:
mais à toutes ſes ſommations, le Berger le paye ſeulement d’vn Bee.	mais à toutes ses sommations, le Berger le paie seulement d'un Bee.
Et à vray dire, il luy tint en cecy ſa promeſſe.	Et à vrai dire, il lui tint en ceci sa promesse.
Car il auoit promis de payer Patelin à ſon mot, qui eſtoit celuy de Bee.	Car il avait promis de payer Patelin à son mot, qui était celui de Bee.
Ce grand perſonnage ſe voyant ainſi eſcorné par ſon client, vient des prieres aux menaces:	Ce grand personnage se voyant ainsi écorné par son client, vient des prières aux menaces:
mais pour cela il n’aduance de rien ſon faict, n’eſtant payé en autre monnoye que d’vn Bee.	mais pour cela il n'avance de rien son fait, n'étant payé en autre monnaie que d'un Bee.
Que Bee (dit Patelin) l’on me puiſſe pendre, Si ie ne feray venir Vn Sergent, meſauenir Luy puiſſe s’il ne t’empriſonne.	Que Bee dit Patelin) l'on me puisse pendre, Si fait ne ferai venir Un Sergent, mesavenir Lui puisse s'il ne t'emprisonne.
A quoy le Berger luy reſpond.	À quoi le Berger ainsi répond.
S’il me trouue, ie luy pardonne.	S'il me trouve, ie luy pardonne.
Et en ce vers eſt la cloſture de La farce:	Et en ce vers est la clôture de La farce:
dont on peut dire pour fin de compte, qu’à trompeur, trompeur & demy.	dont on peut dire pour fin de compte, qu'à trompeur, trompeur et demi.
Voila en ſomme tout le ſujet de ceſte farce.	Voilà en somme tout le sujet de cette farce.
Mais en bonne foy dites moy, ay-ie eſté de plus grãd loiſir la liſant, ou bien en la vous diſcourant?	Mais en bonne foi dites -moi, ai-je été de plus grands loisir la lisant, ou bien en la vous discourant?
Il n’y a remede, encore me veux-ie eſtancher.	Il n'y a remède, encore me veux-je étancher.
Car s’il vous plaiſt examiner les pieces particulieres de ce petit œuure, vous y trouuerez en entregent adinirable:	Car s'il vous plaît examiner les pièces particulières de ce petit œuvre, vous y trouverez en entregent adinirable:
mais ſur tout en la harangue que le Berger fit à ſon Maiſtre lors qu’il luy vint re	mais sur tout en la harangue que le Berger fit à son Maître lors qu'il avait vint re
auoit fait.	avait fait.
Mais qu’il ne vous vueille deſplaire Ne ſçay quel veſtu deſuoyé.	Mais qu'il ne vous veuille déplaire Ne sais quel vêtu dévoyé.
Mon bon Seigneur, tout deſroyé, Qui tenoit vn foüet ſans corde, M’a dit, mais ie ne me recorde, Pour bien au vray que ce peuſt eſtre, Il m’a parlé de vous mon maiſtre, Rm fpay qu'ent haicurnerie.	Mon bon Seigneur, tout desroyé, Qui tenait un fouet sans corde, M'a dit, mais quelque ne me recorde, Pour bien au vrai que ce pût être, Il m'a parlé de vous mon maître, Rm spay qu'èn haicurnerie.
Quant à moy par ſaincte Marie, Ie n’y entens ny gros, ny greſle, Il m’a broüillé vn peſle meſle, De brebis, & de releuee, Et m’a fait vne grande leuce, De vous, mon Maiſtre, de boucler.	Quant à moi par sainte Marie, Je n'y entends ni gros, ni grêle, Il m'a brouillé un pèle -mêle, De brebis, et de relève, Et m'a fait une grande leuce, De vous, mon Maître, de boucler.
Repaſſez par toutes les Co medies, tant anciennes que modernes, il n’y en a vne toute ſeule où ſe trouue vne harangue plus bruſque & naïfue que ceſte cy.	Repassez par toutes les Co medies, tant anciennes que modernes, il n'y en a toujours seule où se trouve une harangue plus brusque et naïve que cette cy.
Dans laquelle vous remarquerez en paſſant que le Berger en ſon lourdois remarque la verge du Sergent, vn foüet ſans corde.	Dans laquelle vous remarquerez en passant que le Berger en son lourdois remarque la verge du Sergent, un fiel sans corde.
Or ſi l’Autheur a gardé vne merueilleuſe bien-ſeance en cet honneſte homme:	Or si l'Auteur a gardé une merveilleuse bienséance en cet honnête homme:
encore l’a il obſeruce, autant & plus à propos, quaud il introduit Guillaume troublé en ſon ame par la preſence de Patelin, qu’il penſoit eſtre malade en extremité.	encore l'a il observée, autant et plus à propos, quaud il introduit Guillaume troublé en son âme par la présence de Patelin, qu'il pensait être malade en extrémité.
Car apres auoir pluſieurs fois entreueſché ſa matiere, tantoſt de ſon drap, tantoſt deſes moutons, le Iuge luy ayant commandé de laiſſer ſon drap en arriere, & reuenir aux moutons, dont il eſtoit queſtion, le Drapier continuë ſon theme en ceſte façon.	Car après avoir plusieurs fois entreuesché sa matière, tantôt de son drap, tantôt deses moutons, le Juge avait ayant commandé de laisser son drap en arrière, et revenir aux moutons, dont il était question, le Drapier continue son thème en cette façon.
Monſcigneur, mais le cas me touche, Toutesfeis parma foy, ma bouche Meshuy vn ſeul mot n'en dira, Vne autre ſois il en ira Ainſi comme il en pourra aller.	Monsieur, mais le cas me touche, Toutesfis parma foi, ma bouche Meshui un seul mot n'en dira, Une autre sois il en ira Ainsi comme il en pourra aller.
Il me le conuient aualer Sans maſcher:	Il me le convient avaler Sans mâcher:
Or ça ie diſoye A mon propos, comine i’auoye Baillé ſix aulnes, dois-ie dire Mtes brebis, ie vous prie, Sire Pardonné-moy, ce gentil maiſtre Aton berger, quand il deuoit eſtre Aux champs, il me dit que i’aurois Six eſcus d’or, quand ie voudrois:	Or ça peine disoie A mon propos, comine j'avoie Baillé six aulnes, dois-je dire Mtes brebis, je vous prie, Sire Pardonné-moi, ce gentil maître Aton berger, quand il devait avoir Aux champs, il me dit que j'aurais Six écus d'or, quand notre voudrais:
Dy-ie de puis trois iours en ça, Mon berger m’enconuenança Que loyaument me garderoit Mtes brebis, & ne m’y feroit N dommage, ni vilennie, Et puis maintenant il me nie Et drap & argent plainement.	Dis-je de puis trois jours en ça, Mon berger m'enconuenança Que loyaument me garderait Mtes brebis, et ne m'y ferait N dommage, ni vilennie, Et puis maintenant il me nie Et drap et argent plainement.
Ha maiſtre Pierre vrayement Ce ribault ci embloit mes laines De mes beſtes, & toutes ſaines Les faiſoit mourir & perir, Par les aſſommer & ferir De gros baſtons ſur la ceruelle.	Ha maître Pierre vraiment Ce ribault cy emblait mes laines De mes bêtes, et toutes saines Les faisait mourir et périr, Par les assommer et férir De gros bâtons sur la cervelle.
Qand mon drap fut ſous ſon eſſelle Il ſe mit en chemin grand erre, Et me dit que i’allaſſe querre Six eſcus d’oren ſa maiſon,	Quand mon drap fut sous son esselle Il se mit en chemin grand erre, Et me dit que j'allasse querre Six écus d'oren sa maison,
Y euſt-il iamais vn plus bel entrelas de matiere en vn eſprit foible, combatu de deux diuerſes paſſions?	Y eût-il jamais un plus bel entrelas de matière en un esprit faible, combattu de deux diverses passions?
Ne penſez pas que par vne opinion particuliere, ie ſois ſeul auquel ait pleu ce petit ouurage.	Ne pensez pas que par une opinion particulière, Elle sois seul auquel ait pleu ce petit ouvrage.
Car au contraire nos anceſtres trouuerent ce Maiſtre Pierre Patelin auoir ſi bien repreſenté le perſonnage pour lequel il eſtoit introduit, qu’ils meirent en vſage ce mot de Pateliν, pour ſignifier celuy qui par heaux ſemblans enjauloit, & de Iuy firent vns Pateliuer & Pateliπαgς, pour meſme ſuiet.	Car au contraire nos ancêtres trouvèrent ce Maître Pierre Patelin avoir si bien représenté le personnage pour lequel il était introduit, qu'ils meirent en usage ce mot de Pateli, pour signifier celui qui par heaux semblants enjaulait, et de Jui firent uns Pateliver et Pateliπαgς, pour même sujet.
Et quand il aduient qu’en commun deuis quelqu’vn- extranague de ſon premier pro os celuy qui le veut umettre ſur ſes premieres brizees, luy dit.	Et quand il advient qu'en commun devis quelqu'un- extranague de son premier pro os celui qui le veut umettre sur ses premières brises, tu dit.
Reuenei à vos moutons, Dont a vſé à meſme effect Rabelais en ſon premier liure de Gargantua.	Revenéi à vos moutons, Dont a usé à même effet Rabelais en son premier livre de Gargantua.
Il n’eſt pas que de fois à autres quand on tire vn payement en longueur, nous ne diſions, Qui me payaſt, ie m’en allaſſe:	Il n'est pas que de fois à autres quand on tire un paiement en longueur, nous ne disions, Qui me payât, Seigneur m'en allasse:
Et en autre ſujet contre les gens de mauuaiſe foy, auoir drap C aigem enſemple:	Et en autre sujet contre les gens de mauvaise foi, avoir drap Ç aigem ensemple:
Tous prouerbes que nous auons puiſez de la fontaine de Patelin.	Tous proverbes que nous avons puisés de la fontaine de Patelin.
Ie ſeray encore plus hardy.	Je serai encore plus hardi.
Car i’ayme mieux recognoiſtre dé luy le mot de Baye, que nous diſons Repaiſtre vn homme de Bayes, c’eſt à dire de diſcours friuoles, par vn eſchange de Bée en Baye, que de paſſer les montagnes pour le mendier le l’Italien.	Car j'aime mieux reconnaître déjà lui le mot de Baie, que nous disons Repaistre un homme de Bayes, c'est à dire de discours frivoles, par un échange de Bée en Baie, que de passer les montagnes pour le mendier le l'Italien.
I’adiouſteray que notre gentil Rabelais le voulut imiquand pour ſe donner carrieintroduiſit Panurge, parler ſept ou huict langages diuers, au premier abouchement de luy auec Pantagruel, le tout en la meſme façon qu’auoit faict Patelin, contre le reſueur.	J'ajouterai que notre gentil Rabelais le voulut imiquand pour se donner carrieintroduisit Panurge, parler sept ou huit langages divers, au premier abouchement de m auec Pantagruel, le tout en la même façon qu'avait fait Patelin, contre le rêveur.
Dauantage ie recueille quelques ancienuetez qui ne doiuent eſtre negligees.	Davantage ici recueille quelques ancienvetés qui ne doivent être négligées.
Car quand vous voyez le Drapier vendre ſes ſix aulnes de drap, neuf francs, & qu’à l’inſtant meſme il dit que ce ſont ſix eſcus, il faut neceſſairement conclurre qu’en ce tempst ſols.	Car quand vous voyez le Drapier vendre ses six aunes de drap, neuf francs, et qu'à l'instant même il dit que ce sont six écus, il faut nécessairement conclurre qu'en ce tempst sols.
Mais comme accorderons nous les paſſages?	Mais comme accorderons nous les passages?
En ce qu’en tous les endroicts où il eſt parlé du prix de chaque aulne, on ne parle que de vingt & quatre ſolsQui n’eſt pas ſomme ſuffiſante pour faire reuenir les ſix aulnes à neuf francs, ains à ſept liures quatre ſols ſeulement.	En ce qu'en tous les endroits où il est parlé du prix de chaque aulne, on ne parle que de vingt et quatre solsQui n'est pas somme suffisante pour faire revenir les six aulnes neuf francs, ains à sept livres quatre sols seulement.
C’eſt entore vne autre ancienneté digne d’eſtre conſideree, qui nous enſeigne qu’en la ville de Paris, où ceſte farce fut faicte, & paraduanture repreſentee ſur l’eſchaffaut, quand on parloit du ſols ſimplement;	C'est entore un autre ancienneté digne d'être considérée, qui nous enseigne qu'en la ville de Paris, où cette farce fut faite, et paraduanture représente sur l'échaffaut, quand on parlait du sols simplement;
on l’entendoit Pariſi, qui valoit quinze deniers tournois (car auſſi eſtoit-il de Paris) & à tant que les 24.	on l'entendait Parisi, qui valait quinze deniers tournais (car aussi était-il de Paris) et à tant que les 24.
Iois faiſoient les 30.	Jois faisaient les 30.
ſols tournois.	sols tournais.
A ce propos il me ſouuient qu’en ce grand & ſolemnel teſtament de la Royne Ieãne femme de Philippes le Bel, qui fut du 24.	À ce propos il me souvient qu'en ce grand et solennel testament de la Royne Je donne de Philipes le Bel, qui fut du 24.
Mars 1304.	Mars 1304.
par lequel elle fonda le College de Champagne, dit de Nauarre, faiſant vne infinité de legs à vns & autres ſiens Gentilshommes & ſeruiteurs, elle declara ne vouloit que les ſommes par elle leguees fuſſent eſtimees au Parifi, ſinon aux legs, où elle en feroit mention expreſſe.	par lequel elle fonda le Collège de Champagne, dit de Navarre, faisant une infinité de legs à uns et autres siens Gentilshommes et serviteurs, elle déclara ne voulait que les sommes par elle léguées fussent estimées au Parifi, sinon aux legs, où elle en ferait mention expresse.
Depuis par ſuccez de temps, tout ainſi qu’il ne ſe trouue plus de la monnoye du Pariſi, auſſi quand nous la voulons exprimer nous y adiouſtons par exprez le mot de Pariſi en queuë, autrement ſoit à Paris ou ailleurs nous n’entendons parler que de ſols tournois.	Depuis par succès de temps, tout ainsi qu'il ne se trouve plus de la monnaie du Parisi, aussi quand nous la voulons exprimer nous y ajoutons par exprez le mot de Parisi en queue, autrement soit à Paris ou ailleurs nous n'entendons parler que de sols tournois.
Ie ne veux pas auſſi oublier qu’en ce temps là les Sergens exploictans portoient leurs manteaux bigarrez, ainſi que nous recueillons de ces mote, Ne ſcay quel veſtu deſuoyé, & encore eſtoient tenus de porter leurs verges:	Je ne veux pas aussi oublier qu'en ce temps là les Sergents exploits portaient leurs manteaux bigarrez, ainsi que nous recueillons de ces motte, Ne sais quel vêtu dévoyé, et encore étaient tenus de porter leurs verges:
Et c’eſt ce que le Berger veut dire quand il parle d’vn foüet ſans cor	Et c'est ce que le Berger veut dire quand il parle d'un fouet sans cor
de.	de.
De cela nous pouuons apprendre que ce n’eſt ſans raiſon que l’on appelloit les Sergens de pied, Sergens à verge.	De cela nous pouvons apprendre que ce n'est sans raison que l'on appelait les Sergents de pied, Sergents à verge.
Couſtume que l’on voulut faire reuiure par l'Edit d’Orleans, fait à la poſtulation des trois Eſtats en l’an 1560.	Coutume que l'on voulût faire revivre par l'Édit d'Orleans, fait à la postulation des trois États en l'an 1560.
quand par article expres on ordonna que fuſſions contraints d’obeïr aux commandemens d’vn Sergent & de le ſuiure:	quand par article exprès on ordonna que fussions contraints d'obéir aux commandements d'un Sergent et de le suivre:
voire en priſon, lors qu’il nous toucheroit de ſa verge.	voire en prison, lors qu'il nous toucherait de sa verge.
Ie diray encore ce mot, & puis plus.	Je dirai encore ce mot, et puis plus.
Nous auons deux noms, deſquels nous baptizons en commun propos ceux qu’eſtimons de peu d’effect, les nommans Ieans, ou Guillaumes.	Nous avons deux noms, desquels nous baptisons en commun propos ceux qu'estimons de peu d'effet, les nommants Jeants, ou Guillaumes.
Dont ſoit cela prouenu, ie m’en rapporte à ce qui en eſt.	Dont soit cela provenu, ie m'en rapporte à ce qui en est.
Bien vous diray-ie que dés le temps que ceſte farce fut compoſee, on ſe mocquoit des Guillaumes.	Bien vous dirai-je que dès le temps que cette farce fut compose, on se moquait des Guillaumes.
Et parauanture l’Autheur pour ceſte meſme raiſon appella le Drapier Guillaume.	Et paraventure l'Auteur pour cette même raison appela le Drapier Guillaume.
Car Guillemette voulant ſçauoir ſon nom, Patelin luy reſpond.	Car Guillemette voulant savoir son nom, Patelin lui répond.
C’eſt vn Guillaume ui a le ſurnom da Iouceaulme.	C'est un Guillaume ui a le surnom da Jouceaume.
Et en vn autre paſſage, le Dra pier ſe meſcontentant à part ſo de Patelin.	Et en un autre passage, le Dra pier se mécontentant à part sou de Patelin.
Il eſt Aduocat potatif A trois Leçons, & trois Pſeaumes, Et tient-il les gens pourGuillaumes?	Il est Aduocat potatif A trois Leçons, et trois Pseaumes, Et tient-il les gens pourGuillaumes?
Il eſt meshuy temps que ſonne icy la retraite, à la charg que peut eſtre ſeray-ie eſtimé e grand loiſir, d’auoir employ mon loiſir au diſcours du preſen chapitre.	Il est meshui temps que sonne ici la retraite, à la charg que peut -être serai-ie estimé e grand loisir, d'avoir emploi mon loisir au discours du présen chapitre.
Il n’eſt point mal ſeant à tout homme qui fait profeſſion des lettres, de faire ſon profit de tous les liures qu’il lit.	Il n'est point mal séant à tout homme qui fait profession des lettres, de faire son profit de tous les livres qu'il lit.
LES CCTEVRI.	LES CCTEURI.
LA SCENE.	LA SCÈNE.
A Paris pres ſaint Innocent.	À Paris pres saint Innocent.
COMEDIE DE MAISTRE Pierre Patelin.	COMÉDIE DE MAÎTRE Pierre Patelin.
Maiſtre Pierre Patelin commence	Maître Pierre Patelin commence
’Ainte Marie, Guillemette, DPour quelque peine que ſnette A cabaſſer n’à ramaſſer, Nous ne pouuons rien amaſſer, Or vy-ie que i’auocaſſoye.	Ainte Marrie, Guillemette, DPour quelque peine que sette A cabasser n'à ramasser, Nous ne pouvons rien amasser, Or vi-je que j'avocassoie.
Guillemette.	Guillemette.
Par noſtre Dame i’y penſoye Dont on chante en auocaſſaige:	Par notre Dame j'y pensaie Dont on chante en avocassaige:
Mais on ne vous tient pas ſaige Des quatre parts, comme ou ſouloit.	Mais on ne vous tient pas saise Des quatre parts, comme ou soûlait.
Ie vy que chacun vous vouloit, Auoir, pour gaigner ſa querelle.	Je vis que chacun vous voulait, Avoir, pour gagner sa querelle.
Maintenant chacunvous appelle Par tout Auocat deſſouz l’orme.	Maintenant chacunvous appelle Par tout Avocat dessouz l'orme.
Patelin.	Patelin.
Encor' ne le dy-ie pas pour me Vanter:	Encor' ne le dis-je pas pour me Vanter:
mais n’a au territoire Ou nous tenons noſtre auditoire Homme plus ſaige, fors le Maire.	mais n'a au territoire Ou nous tenons notre auditoire Homme plus saisge, fors le Maire.
Guillemette.	Guillemette.
Auſſi a il leu le grimaire, Et aprins à clerc longue piece.	Aussi a il lu le grimaire, Et apprins à clerc longue pièce.
Patelin.	Patelin.
A qui veez-vous que ne deſpiece Sa cauſe:	À qui vez-vous que ne despiece Sa cause:
ſi ie m’y vueil mettre?	si ici m'y veuil mettre?
Et ſi n’aprins onques à lettre Qu’vn peu:	Et si n'apprins onques à lettre Qu'un peu:
mais ie m’oſe vanter, Que ie ſçay auſſi bien chanter Au liure auecques noſtre prebſtre, Comme ſi i’euſſe eſté à maiſtre Autant que Charles en Eſpaigne.	mais était m'ose vanter, Que on sais aussi bien chanter Au livre avec notre prébstre, Comme si j'eusse été à maître Autant que Charles en Espagne.
Guillemette.	Guillemette.
Que nous vault cecy?	Que nous vault ceci?
pas ẽpaigne, Nous mourons de fine famine, Nos robes ſont plus qu’eſtamine Raiſes, & ne pouuons ſçauoir Comment nous en peuſſons auoir Et que nous vault voſtre ſcience?	pas ẽpaigne, Nous mourons de famine famine, Nos robes sont plus qu'étamine Raises, et ne pouvons savoir Comment nous en pussons avoir Et que nous vault votre science?
Patelin.	Patelin.
Taiſez vous, par ma conſcience, Si ie vueil mon ſens eſprouuer, Ie ſçauray bien ou en trouuer Des robes, & des chaperons.	Taisez -vous, par ma conscience, Si on veuil mon sens éprouver, Je saurai bien ou en trouver Des robes, et des chaperons.
Si Dieu plaiſt nous eſchaperons, Et ſeront remis ſus en l’heure.	Si Dieu plaît nous échapperons, Et seront remis sus en l'heure.
Dea en peu d’heure Dieu labeure:	Dea en peu d'heure Dieu labure:
Car s’il conuient que ie m’aplique A bouter auant ma pratique, On ne ſçaura trouuer mon per.	Car s'il convient que ainsi m'applique A bouter avant ma pratique, On ne saura trouver mon per.
Guillemette.	Guillemette.
Par ſaint laques uon de tromper Vous en eſtes vn fin droit maiſtre.	Par saint laques uon de tromper Vous en êtes un fin droit maître.
Patelin.	Patelin.
Par celuy Dieu qui me fiſt naiſtre Mais de droite auocaſſerie.	Par celui Dieu qui me fît naître Mais de droite avocasserie.
Guillemette.	Guillemette.
Par ma foy, mais de tromperie:	Par ma foi, mais de tromperie:
Combien vrayement quant m’auiſe, Pour à vray dire, ſanaclergiſe Et ſans ſens naturel, vous eſtes Ienu Ivne des ſaiges teſtes Qui ſoit en toute la paroiſſe,	Combien vraiment quant m'avise, Pour à vrai dire, sanaclergise Et sans sens naturel, vous êtes Jenu Ivre des saisges têtes Qui soit en toute la paraisse,
Patelin.	Patelin.
Il n’y a nul qui ſe cognoiſſe Si nauit en auocaſſion.	Il n'y a nul qui se connaisse Si navit en avocassion.
Guillemette.	Guillemette.
M’aiſt dieux, mais en trompation, Aumoins en auez-vous le loz.	M'aît dieux, mais en trompation, Aumoins en avez-vous le loz.
Patelin.	Patelin.
Si ont ceulx qui de cameloz Sont veſtus, & de camocas, Qui dient qu’ilz ſont Auocatz:	Si ont ceulx qui de camelés Sont vêtus, et de camocas, Qui dient qu'ils sont Avocatz:
Mais pour tant ne le ſont ilz mye, Laiſſons en paix ceſte bauerie Ie m’en vueil aller à la foire.	Mais pour tant ne le sont ils mye, Laissons en paix cette baverie Je m'en veuil aller à la foire.
Guillemette.	Guillemette.
A la foire?	À la foire?
Patelin.	Patelin.
Par ſaint Iean voire, A la foire, gentil' marchande.	Par saint Jean voire, À la foire, gentil' marchande.
Vous deplaiſt il ſi ie marchande Du drap, ou quelque autre ſuffrage Rous n’auons robe qui rien v	Vous déplaît il si ici marchande Du drap, ou quelque autre suffrage Rous n'avons robe qui rien 
Gailſemette;	Gailamette;
vous n’auez ne denier ne maille d’y ferez vous?	vous n'avez ne denier ne maille d'y ferez -vous?
Patelis.	Patelis.
Vous neſçauez Aelle dame, ſi vour n’anex Du dtas A pour nous deux larg Sine deſimentez hardiment:	Vous nesçauez Aelle dame, si vour n'anex Du dtas A pour nous deux larg Sine desimentez hardiment:
Quel couleurvous ſemble plus be D'ungris var ded’vn fin debrucell Oud’autreZ il le me fault ſçauoir.	Quel couleurvous semble plus be D'ungris var déd'une fin débrucell Oud'autre il le me sault avait.
Gvillemetie.	Guillemetie.
Tel que vous le pourrez auoir.	Tel que vous le pourrez avoir.
Qui emprunte ny choyſiſt mye.	Qui emprunte ici choisît mye.
Parelin tn cuntant ſurſes doigir Pour vous deux aulnes & demye:	Parelin t untant surses doigir Pour vous deux aulnes et demie:
E pour moi trois, voire biẽ quarre Ce ſont,	E pour moi trois, voire bien quarre Ce sont,
Guilemette:	Guilemette:
Fous comtez ſans tabatre, tui dyable les vous preſtera?	Fous comptez sans tabattre, tui diable les vous prêtera?
Patelin.	Patelin.
Que vous en chault qui ſe ſera, On les me preſtera vrayement A rendre au iour du iugement:	Que vous en chault qui se sera, On les me prêtera vraiement A rendre au jour du jugement:
Car plus toſt ne ſera-ce point.	Car plu tôt ne sera-ce point.
Guillemette.	Guillemette.
Auant, mon amy en ce poinct qui que ſoit en iera couuert,	Avant, mon ami en ce point qui que soit en jera couvert,
Patelin.	Patelin.
I’achateray, ou gris, ou verd, Et pour vn blanchet, Guillemette, Me faut trois quartiers de brunette Ou vne aulne.	J'achèterai, ou gris, ou verd, Et pour un blanchet, Guillemette, Me faut trois quartiers de brunette Ou une aulne.
,	,
Guillemette.	Guillemette.
Se m’aiſt dieu voire.	Se m'ait dieu voire.
Allez n’oubliez pas à boire Si vous trouuez Martin garant.	Allez n'oubliez pas à boire Si vous trouvez Martin garant.
Patelis.	Patelis.
Gardez tout	Gardez tout
Cuilemette.	Cuilemette.
Hé dieux quel allant P.	Hé dieux quel allant P.
euſt ot à Neu qu’il ny viſt goute.	Est ot à Neu qu'il niprît goute.
Patelin.	Patelin.
N'eſt, ce pas y là, i’en fais d Et ſi eſt, par ſainte Marie, Il ſe meſle de draperie.	N'est, ce pas y là, j'en fais d Et si est, par sainte Marie, Il se mêle de draperie.
Dieu y ſoit.	Dieu y soit.
Le Drapier.	Le Drapier.
Et dieu vous doint ioye.	Et dieu vous doint joie.
Patelin.	Patelin.
Or ainſi m’aiſt dieux que i’auoye De vous voir grande volunté:	Or ainsi m'ait dieux que j'avoie De vous voir grande volunté:
Comment ſe porte la ſanté?	Comment se porte la santé?
Eſtes vous ſain & dru.	Êtes vous sain et dru.
Guillaume	Guillaume
Le Drapier.	Le Drapier.
Ouy, par Dieu.	Oui, par Dieu.
Patelin.	Patelin.
Cà ceſte paulme, Comment vous va?	Çà cette paume, Comment vous va?
Le Drapier.	Le Drapier.
Et bien vrayement A voſtre commendement.	Et bien vraiment A votre commendement.
Et vous?	Et vous?
Patelin.	Patelin.
Par ſaint Pierre l’Apoſtre Comme celuy qui eſt tout voſtre.	Par saint Pierre l'Apôtre Comme celui qui est tout votre.
Iinſi vous esbatez?	Jinsi vous ébattez?
it voire.	it voire.
Le Drãpier.	Le Drangier.
croire es marchants, ce deuez vous e font pas touſiours à leur guiſe.	croire es marchants, ce devez -vous e ont pas toujours à leur guise.
Patelin.	Patelin.
omment ſe porte marchandiſe?	omment se porte marchandise?
enpeuiommonigder nepaiſtre?	enpeuiommonigéder nepaître?
Le Drapier.	Le Drapier.
Et ſe m’aiſt dieux mõ doux maiſtre e ne ſçay, touſiours hay auant.	Et se m'ait dieux mon doux maître ne sais, toujours ha auant.
Patelin.	Patelin.
Aht que c’eſtoit vn hõme ſçauant:	Aht que c'était un homme Savant:
le requiers Dieu qu’il en ait l’ame De voſtre pere, douce dame, Il m’eſt auis tout clerement Que c’eſt il de vous proprement, Qu’eſtoit vn bon marchãt & ſaige.	le requiers Dieu qu'il en ait l'âme De votre père, douce dame, Il m'est avis tout clèrement Que c'est il de vous proprement, Qu'était un bon marchant et saise.
Vous luy reſſemblez de viſaige, Par Dieu, comme droite painture.	Vous avait ressemblez de visaige, Par Dieu, comme droite painture.
Si Dieu eut oncq' de creature Mercy, Dieu vray pardon luy face A l’ame.	Si Dieu eut oncq' de créature Merci, Dieu vrai pardon était face À l'âme.
Le Drapier.	Le Drapier.
Amen, par ſa grace, Et de nous quand il luy plaira.	Amen, par sa grâce, Et de nous quand il lui plaira.
Patelin.	Patelin.
Par ma foy il me declara Maintesfois, & bien largement le temps qu’on void preſenteme, moult de fois m’en eſt ſouuenu:	Par ma foi il me déclara Maintesfois, et bien largement le temps qu'on void présente, moult de fois m'en est souvenu:
Car pour lors il eſtoit tenu Vn des bons.	Car pour lors il était tenu Un des bons.
Le Drapien Séez vous, beau ſire.	Le Drapien Séez -vous, beau sire.
Il eſt bien temps de le vous dire:	Il est bien temps de le vous dire:
Mais ie ſuis ainſi gracieux.	Mais ici suis ainsi gracieux.
Patelin.	Patelin.
Ie ſuis bien, par Dieu, precieux, Il auoit.	Je suis bien, par Dieu, précieux, Il avait.
Le Drupier.	Le Drupier.
Vrayement vous ſerrez.	Vraiment vous seriez.
Patelin.	Patelin.
Voluntiers:	Voluntiers:
que vous verrez ( Cõme il me diſt de grãds meru	que vous verrez ( Comme il me dît de grands merv
Ainſi m’aiſt dieux que des oreilles.	Ainsi m'ait dieux que des oreilles.
Du nez, de la bouche, des yeux, Oncq' enfant ne reſſembla mieux A’pere.	Du nez, de la bouche, des yeux, Oncq' enfant ne ressembla mieux Apère.
Quel menton fourché?	Quel menton fourché?
Vrayemẽt c’eſtes vous tout poché.	Vraiment c'êtes vous tout poché.
Et qui diroit à voſtre mere, Que ne fumez filz voſtre pere65212 grand fain de tancer.	Et qui dirait à votre mère, Que ne fumés fils votre père65212 grand sain de tancer.
Sans faulte ie ne puis penſer.	Sans faulte grande ne puis penser.
Commẽt Nature en ſes ouuraiges Forma deux ſi pareilz viſaiges.	Commont Nature en ses ouvraiges Forma deux si pareils visaiges.
Et l’vn comme l’autre tache:	Et l'un comme l'autre tache:
Car quoy?	Car quoi?
qui vous auroit craché Tous deux encontre la parroy, D’vne maniere & d’vn arroy Eſtes vous & ſans difference.	qui vous aurait crêché Tous deux encontre la parroy, D'une manière et d'un arrois Êtes vous et sans différence.
Or, ſire, la bonne Laurence Voſtre belle ante mourut elle?	Or, sire, la bonne Laurence Votre belle ante mourut -elle?
Le Drapier.	Le Drapier.
Nenny dea.	Nenni dea.
Patelin.	Patelin.
Que ie la vy belle.	Que ici la vi belle.
Et grande, & droite, & gracieuſe.	Et grande, et droite, et gracieuse.
Par la mex Dieu precieuſe Vous luy reſemblez de corſaige Cõme qui vous euſt fait de ni En ce pais n’a, ce me ſemble, Lignage qui mieux ſe reſſemble.	Par la mex Dieu précieuse Vous-même résemblés de corsaige Comme qui vous eût fait de ni En ce pais n'a, ce me semble, Lignage qui mieux se ressemble.
Hé dieux tant bien ie vous apere:	Hé dieux tant bien Madame vous apère:
Véez vouslà, véez vous voſtre per Vous luy reſſemblez mieux, q goute D’eau, ie n’en fais nulle doute.	Véez -vouslà, véez -vous votre per Vous lui ressemblez mieux, q goute D'eau, notre n'en fais nulle doute.
Quel vaillant Bachelier c’eſtoit, Ses denrées, à qui les vouloit.	Quel vaillant Bachelier c'était, Ses denrées, à qui les voulait.
Dieu luy pardoint, il me ſouloit Touſiours de ſi tresbon cueur rirt Pleuſt à leſus Chriſt, que le pire De ce monde luy reſſemblaſt.	Dieu me pardoint, il me soûlait Toujours de si tresbon cueur rirt Plût à lesus Christ, que le pire De ce monde lui ressemblât.
On ne tolliſt pas ny emblaſt L’vn à l’autre comme l’on fait.	On ne tollît pas ainsi emblât L'un à l'autre comme l'on fait.
Que ce drap icy eſt bien fait:	Que ce drap ici est bien fait:
Qu’eſt il ſoef, doux & traitis,	Qu'est il soef, doux et traitis,
Le Drapier.	Le Drapier.
Ie l’ay fait faire tout faitis Ainſi, des laines de mes beſtes.	Je l'ai fait faire tout fait Ainsi, des laines de mes bêtes.
Patelin.	Patelin.
Henhen, quel meſnagier vous eſtes Vous n’en yſtriez pas de l’orine Du pere, voſtre corps ne fine Touſiours touſiours de beſongner	Henhen, quel ménagier vous êtes Vous n'en ystriez pas de l'orine Du père, votre corps ne fine Toujours tousiours de besongner
Le Drapier.	Le Drapier.
Que voulez vous il fault ſoingner Qui veult viure & ſouſtenir peine,	Que voulez -vous il sault soingner Qui veult vivre et soutenir peine,
Taicnn.	Taicnous.
Ceſtuy cy eſt il taint en laine?	Cestuy cy est il taint en laine?
Il eſt fort comme vn Cordouen.	Il est fort comme un Cordouen.
Le Drapier.	Le Drapier.
C’eſt vn tresbon drap de Rouen Ie vous prometz, & bien drapé.	C'est un tresbon drap de Rouen Je vous prometz, et bien drapé.
Patelin.	Patelin.
Or vrayement i’en ſuis atrapé, Car ie n’auoys intention D’auoir drap.	Or vraiment j'en suis atrapé, Car ie n'avais intention D'avoir drap.
Par la paſſion De noſtre Seigneur, quand ie vins auoys mis à part quatre vingts eſcuz, pour retraire vne rente:	Par la passion De notre Seigneur, quand on vins auoys mis à part quatre vingts écuz, pour retraire une rente:
lis vous en aurez vingt ou trente Ie le voy bien:	lis vous en aurez vingt ou trente -je le vois bien:
car la couleur M’ẽ plaiſt treſtãt, que c’eſt doule	car la couleur M'étendre plaît trestãt, que c'est doule
Le Drapier.	Le Drapier.
Eſcuz?	Écuz?
dea;	dea;
ce pourroit il faire, Que ceulx dõt vous deuez retra Ceſte rente, prinſent monoye?	ce pourrait -il faire, Que ceulx dont vous devez retra Cette rente, prinsent monoie?
Patelin.	Patelin.
Et ouy bien, ſi ie vouloye:	Et oui bien, si ici vouloie:
Tout m’en eſt vn en payement.	Tout m'en est un en paiement.
Quel drap eſt cecy?	Quel drap est ceci?
vrayement Tant plus le voy & plus m’aſſote.	vraiment Tant plus le vois et plus m'assote.
Il m’en fault auoir vne cote Brief:	Il m'en sault avoir une cote Brief:
& à ma femme de meſme.	et à ma femme de même.
Le Drapier.	Le Drapier.
Cettes drap eſt cher cõme creſn Vous en aurez ſi vous voulez.	Certtes drap est cher comme crê Me en aurez si vous voulez.
Dix ou vingt francz y ſont coule Si toſt.	Dix ou vingt francs y sont coule Si tôt.
Patelin.	Patelin.
Il ne m’en chault, couſte & vaill Encor' ay ie denier & maille, Qu'oncq' ne virent pere ne mere	Il ne m'en chault, coûte et vaill Encor ai Roi denier et maille, Qu'oncq ne virent père ne mère
Le Drapier.	Le Drapier.
Deu en foit loué, par faint Per Il ne m’en deſplairoit en piece.	Devu en soit loué, par saint Per Il ne m'en déplairait en pièce.
Patelin.	Patelin.
Brief, ie ſuis gros de ceſte piece:	Brief, Seigneur suis gros de cette pièce:
trmei sondſent auoir.	tramei sondsent avoir.
Lt niapier, Or bien.	Lt niapier, Or bien.
Il conuient auiſer combien Vous en voulez premierement:	Il convient aviser combien Vous en voulez premièrement:
Tout à voſtre commandement Ce qu’il en ya en la pille, Et n’euſſiez vous ne croix ne pille.	Tout à votre commandement Ce qu'il en ya en la pille, Et n'eussiez -vous ne crois ne pille.
Patelin.	Patelin.
Ie le ſçay bien, voſtre mercy.	Je le sais bien, votre merci.
Le Drapier.	Le Drapier.
Voulez vous de ce pers cler cy?	Voulez -vous de ce pers cler cy?
Patelin.	Patelin.
Auant, combien me couſtera La premiere aulne?	Avant, combien me coûtera La première aulne?
Dieu ſera Paye' des premiers, c’eſt raiſon.	Dieu sera Paie' des premiers, c'est raison.
Voicy vn denier, ne faiſon Rien qui ſoit ou Dieu ne ſe nõme.	Voici un dénier, ne saison Rien qui soit ou Dieu ne se nomme.
Le Drapier.	Le Drapier.
Par Dieu vous dites que bon hõme	Par Dieu vous dites que bon homme
D Et m’en auez bien reſiouy.	 Digne m'en avez bien réjoui.
Voulez vous à vn mot?	Voulez -vous à un mot?
OuyPatelin.	OuiPatelin.
Ie Drapier.	Je Drapier.
Chacune aulne vous couſtera Vingt & quatre ſolz.	Chacune aulne vous coûtera Vingt et quatre solz.
Non fera.	Non fera.
Patelin.	Patelin.
Vingt & quatre ſolz?	Vingt et quatre solz?
ſainte Dan	sainte Dan
Le Drapier.	Le Drapier.
Il le m’a couſté, par ceſte ame:	Il le m'a coûté, par cette âme:
Et tant m’en fault, ſi vous l’auez.	Et tant m'en sault, si vous l'avez.
Patelin.	Patelin.
Dea c’eſt trop.	Dea c'est trop.
Ah!	Ah!
vous ne ſçauez Le Drapier.	vous ne savez Le Drapier.
Comment le drap eſt enchery, Treſtout le beſtail eſt pery, Ceſt yuer, par la grand' froydure.	Comment le drap est enchéri, Trestout le bétail est péri, Cest uer, par la grand froidure.
Patelin.	Patelin.
Vingt ſolz?	Vingt solz?
vingt ſolz?	vingt solz?
Le Drapier.	Le Drapier.
Et ie vous iure hhumjce que ie dy, Si venez au marché Ieudy Vous verrez que vault la toyſon, Dont il ſouloit eſtre foyſon, Me couſta à la Magdaleine Huict blãs, par mõ ſermẽt, de laine Que ie ſoulois auoir pour quatre.	Et grands vous jure hhumce que ici dis, Si venez au marché Jeudi Vous verrez que vault la toison, Dont il soûlait être foison, Me coûta à la Magédaleine Huit blants, par mon serment, de laine Que quelque soulois avoir pour quatre.
Patelin.	Patelin.
Par le ſang bieu, ſans plus debatre, Puis qu’ainſi va, doncq’ie marchãde Sus aulnez.	Par le sang bieu, sans plus débattre, Puis qu'ainsi va, doncq’ie marchamède Sus lés.
Le Drapier.	Le Drapier.
Et ie vous demande, Combien vous en fault il auoir?	Et grands vous demande, Combien vous en sault il avoir?
Patelin.	Patelin.
Il eſt bien ayſé à ſçauoir Quel lé a il?	Il est bien aisé à savoir Quel lé a il?
Le Drapier.	Le Drapier.
Lé de Brucelle.	Lé de Brucelle.
Patelin.	Patelin.
Trois aulnes pour moy, & pour elle Elle eſt haulte) deux & demye:	Trois aulnes pour moi, et pour elle Elle est haute) deux et demie:
Ce ſont ſix aulnes:	Ce sont six aulnes:
ne ſont mye?	ne sont mie?
Et non ſont, que ie ſuis beiaune;	Et non sont, que toutefois suis beiaune;
Le Drapier.	Le Drapier.
Il ne s’en fault que demye aulne Pour faire le ſix iuſtement.	Il ne s'en sault que demie aulne Pour faire le six justement.
Patelin.	Patelin.
I’en prendray ſix tout rondeme Auſſi me fault il chaperon.	J'en prendrai six tout rondeme Aussi me sault il chaperon.
Le Drapier.	Le Drapier.
Prenez là, nous les aulneron Si ſont elles cy ſans rabatre.	Prenez là, nous les aulneron Si sont elles cy sans rabattre.
Empreu, & deux, & trois, & c Et cinq, & ſix.	Empreu, et deux, et trois, et ç Et cinq, et six.
Patelin.	Patelin.
Ventre ſaint Pere!	Ventre saint Père!
Ric à ric.	Ric à ric.
Le Drapier.	Le Drapier.
Aulneray-ie arriere?	Aulnerai-je arrière?
Patelin.	Patelin.
Nenny, tant de peine m’engaig Il ya plus perte, ou plus gaigne En la marchandiſe:	Nenni, tant de peine m'engaigne Il ya plus perte, ou plus gagne En la marchandise:
combien Monte tout?	combien Monte tout?
Le Drapier.	Le Drapier.
Nous le ſçaurons bien.	Nous le saurons bien.
A vingt & quatre ſolz chacune, Les fix, neuf frans.	À vingt et quatre solz chacune, Les six, neuf frans.
Patelin.	Patelin.
mape poar ine, Ce ſont ſix eſcuz.	mape poar ine, Ce sont six écuz.
Le Drapier.	Le Drapier.
M’aiſt dieux voire.	M'aît dieux voire.
Patelin.	Patelin.
Or, fire, les voulez vous croire Iuſques à ia:	Or, sire, les voulez -vous croire Jusques à ja:
quand vous viendrez, Non pas croire:	quand vous viendrez, Non pas croire:
vous les prendrez Chez moy, en or, ou en monnoye.	vous les prendrez Chez moi, en or, ou en monnoie.
Le Drapier.	Le Drapier.
Noſtre Dame ie me tordroye.	Notre Dame ie me tordroie.
De beaucoup, à aller par là.	De beaucoup, à aller par là.
Patelin.	Patelin.
Hée voſtre bouche ne parla Depuis, par mõ ſeigeur ſaint Gille, Qu'el’ ne diſoit pas euangille.	Hée votre bouche ne parla Depuis, par mon seigeur saint Gille, Qu'elle ne disait pas euangille.
C’eſt treſbiẽ dit vous vous tordriez Mais c’eſt celà vous ne voudriez lamais trouuęr nulle achoiſon Ev De venir boire en ma maiſon Or y burez vous ceſte fois.	C'est tresbiẽ dit vous cette tordriez Mais c'est celà vous ne voudriez lamais trouuęr nulle achaison Év De venir boire en ma maison Or y burez vous cette fois.
Le Drapier.	Le Drapier.
Et par ſaint Iaques ie ne fois Gueres autre choſe que boire.	Et par saint Jaques ici ne fois Guères autre chose que boire.
Ie iray:	Je irai:
mais il fait mal d’acroire, Ce ſçauez-vous bien, à l’eſtraine.	mais il fait mal d'acroire, Ce Savez-vous bien, à l'étraine.
Patelin.	Patelin.
Suffiſt il ſi ie vous eſtraine D’eſcuz d’or, nõ pas de monnoy Et ſi mangerez de mon oye Par Dieu, que ma femme rotiſt	Suffit -il si ici vous étraine D'écuz d'or, nom pas de monnoi Et si mangerez de mon oie Par Dieu, que ma femme rotist
Le Drapier.	Le Drapier.
Vrayment ceſt homme m’aſſotiſt.	Vraiment cet homme m'assotist.
Allez deuant, ſus ie iray donques Et le porteray.	Allez devant, sus On irai donques Et le porterai.
Pathelin.	Pathelin.
Rien quiconques.	Rien quiconques.
H Que me greuera il?	H Que me grèvera il?
pas maille, Souz mon eſſelle.	pas maille, Souz mon esselle.
Le Drapier.	Le Drapier.
Ne vous chaille, Il vault mieux pour le plus hõne Que ie le porte.	Ne vous chaille, Il vault mieux pour le plus hõne Que tu le porte.
male lelte Patelin.	male lelte Patelin.
M’enuoye Marie Magdaleine?	M'envoie Marie Magédaleine?
Si vous en prenez la peine Ah ſire, que c’éſt bien alle?	Si vous en prenez la peine Ah sire, que c'été bien allé?
Il y aura beu & galle?	Il y aura bu et galle?
Chez moy, ains que vous en allez.	Chez -moi, ains que vous en allez.
Le Drapier.	Le Drapier.
Ie vous prie que rous me baillez Mon argent des que i’y ſeray.	Je vous prie que rous me baillez Mon argent des que j'y serai.
Patelin.	Patelin.
Feray?	Ferai?
& par Dieu non feray, Que n’ayez prins voſtre repas Tresbien:	et par Dieu non ferai, Que n'ayez prins votre repas Tresbien:
& ſi ne voudrois pas Auoir ſur moy dequoy payer.	et si ne voudrais pas Auoir sur moi dequoy payer.
Aumoins viendriez-vous eſſayer Quel vin ie boy.	Aumoins viendriez-vous essayer Quel vin ie boy.
Voſtre feu pere En paſſant huchoit bien:	Votre feu père En passant huchait bien:
compere?	compère?
Ou, que dis tu?	Ou, que dis -tu?
ou que fais tu?	ou que fais tu?
Mais vous ne priſez vn feſtu Entre vous riches pauures hõmes.	Mais vous ne prisez un fétu Entre vous riches pauvres hommes.
Le Drapier.	Le Drapier.
Nõ?	Nom?
& par le ſang bieu nous ſõn Plus pauures.	et par le sang bieu nous so Plus pauvres.
Patelin.	Patelin.
Voire?	Voire?
à Dieu, à Dieu.	à Dieu, à Dieu.
Rendez vous tantoſt audit lieu Et nous beuron bien, ie m’en vai	Rendez -vous tantôt audit lieu Et nous beuron bien, Elle m'en vais
Le Drapier.	Le Drapier.
Si feray-ie, allez deuant, Et que i’aye or.	Si ferai-je, allez devant, Et que j'aie or.
Patelin.	Patelin.
Or?	Or?
& quoy doncques?	et quoi donc?
Or dyable ie n’y failly oncques, Non ou qu’il peult eſtre pendu.	Or diable Seigneur n'y failly oncques, Non ou qu'il peulét être pendu.
Or dea, il ne m’a pas vendu A mon mot, ce a eſté' au ſien:	Or dea, il ne m'a pas vendu À mon mot, ce a été au sien:
Mais il ſera payé au mien, Il luy fault or:	Mais il sera payé au mien, Il Seigneur sault or:
on le luy fourre.	on le Seigneur fourre.
Pleuſt à dieu, qu’il ne fiſt que ce Sans ceſſer, iuſque à fin de poye, Saint lean il feroit plus de voye Qu’il n’y a iuſque à Pampelune.	Plût à dieu, qu'il ne fît que ce Sans cesser, jusqu' ic fin de poie, Saint léan il ferait plus de voie Qu'il n'y a jusque à Pampelune.
Le Drapier.	Le Drapier.
Ilz ne verront Soleil, ne Lune Les eſcuz qu’il me baillera De l’an, qui ne les m’emblera.	Ils ne verront Soleil, ne Lune Les écuz qu'il me baillera De l'an, qui ne les m'emblera.
Or n’eſt il ſi fort entendeur Qui ne treuue plus fort vendeur.	Or n'est il si fort entendeur Qui ne trouve plus fort vendeur.
Ce trompeur là eſt bien beiaune, Quand pour vingt & quatre ſolz I’aulne, A prins drap qui n’en vault pas vingt	Ce trompeur là est bien beiaune, Quand pour vingt et quatre solz J'aulne, A prins drap qui n'en vault pas vingt
En ay-ie?	En ai-je?
Patelin.	Patelin.
Dequoy.	Dequoy.
Guillemette.	Guillemette.
Que deuint Patelin.	Que devint Patelin.
Voſtre vieille cote hardie?	Votre vieille cote hardie?
Guillemette.	Guillemette.
Il eſt grand beſoing qu’on le die, Qu'en voulez vous faire.	Il est grand besoin qu'on le die, Qu'en voulez -vous faire.
Rien rien.	Rien rien.
Patelin.	Patelin.
En ay-ie?	En ai-je?
ie le diſois bien.	Hé le disais bien.
Eſt il ce drap cy	Est -il ce drap cy
Cuillemette.	Cuillemette.
Sainte Dame!	Sainte Dame!
Or par le peril de mon ame Il vient d’aucune couuerture.	Or par le péril de mon âme Il vient d'aucune couverture.
Dieu!	Dieu!
dõt nous vient ceſte auãture Helas qui le payera?	dont nous vient cette aventure Hélas qui le payera?
Patelin.	Patelin.
Demandez vous qui ſe ſera?	Demandez -vous qui se sera?
Par ſaint Iean il eſt ia payé, Le marchant n’eſt pas deuoyé, Belle ſœur, qui le m’a vendu.	Par saint Jean il est ja payé, Le marchant n'est pas devoyé, Belle sœur, qui le m'a vendu.
Parmy le col ſoye pendu S’il n’eſt blãc cõmevn ſac de plaſtre Le meſchant vilain challemaſtre En eſt ceint par le culs	Parmi le col soie pendu S'il n'est blãc homme sac de plâtre Le méchant vilain challemâtre En est ceint par le culs
Combien Guillemette.	Combien Guillemette.
Couſte il doncques?	Coute il donc?
Patelin.	Patelin.
Ie n’en doy rien.	Je n'en dois rien.
Il eſt payé, ne vous en chaille.	Il est payé, ne vous en chaille.
Guillemette.	Guillemette.
Et vous n’auiez denier ne maille?	Et vous n'aviez denier ne maille?
l eſt payé en quel' monnoye?	l est payé en quel' monnoie?
Patelie.	Patelie.
Et par le ſang bieu ſi auoye, 6njauois vn pariſi.	Et par le sang bieu si avoie, 6njavais un parisi.
Guillemette.	Guillemette.
C’eſt bien allé, le beau niſi, Du vn breuet y ont ouuré.	C'est bien allé, le beau nisi, Du un brevet y ont ouvré.
Ainſi l’auez-vous recouuré, Et quand le terme paſſera, on viendra, on nous gaigera Le que auons nous ſera oſté.	Ainsi l'avez-vous recouvré, Et quand le terme passera, on viendra, on nous gaigera Le que avons nous sera ôté.
Patelin.	Patelin.
Par la mort bieu il n’a couſté.	Par la mort bieu il n'a coûté.
Qu’vn denier quand qu’il en y a,	Qu'un denier quand qu'il en y a,
Guillemette.	Guillemette.
Benedicite Maria!	Bénédicite Maria!
111 Q'vn denier?	111 Q'un denier?
il ne ſe peult faire.	il ne se peult faire.
Patelin.	Patelin.
le vous donne ceſt œil à traire ’’il en a plus eu, ne n’aura, a ſi bien chanter ne ſçaura.	le vous donne cet œil à traire 'il en a plus eu, ne n'aura, a si bien chanter ne saura.
Guillemette.	Guillemette.
qui eſt il	qui est il
Patelin.	Patelin.
C’eſt vn Guillaume, Qui a ſurnom de Ioceaume, Puis que vous le voulez ſçauoit,	C'est un Guillaume, Qui a surnom de Joceaume, Puis que vous le voulez sçauoit,
Guillemette.	Guillemette.
Mais la maniere de l’auoir Pour vn denier?	Mais la manière de l'avoir Pour un denier?
& à quel ieu?	et à quel jeu?
Patelin.	Patelin.
Ce fut pour le denier à DieuEt encore ſi i’euſſe dit, La main ſut le pot, par ce dit, Mon denier me fuſt demouré.	Ce fut pour le dénier à DieuEt encore si j'eusse dit, La main sut le pot, par ce dit, Mon denier me fût demouré.
Au fort, eſt ce bien labouré?	Au fort, est ce bien labouré?
Dieu & luy partiront enſemble Car c’eſt tout ce qu’ilz en auront, Ia ſi bien chanter ne ſçauront, Ne pour crier ne pour breſter.	Dieu et notre partiront ensemble Car c'est tout ce qu'ils en auront, Ia si bien chanter ne sauront, Ne pour crier ne pour brester.
Guillemette.	Guillemette.
Comment l’a il voulu preſter, Luy, qui eſt homme ſi rebelle?	Comment l'a il voulu prêter, Lui, qui est homme si rebelle?
Patelin.	Patelin.
Par ſainte Marie la belle,	Par sainte Marie la belle,
Ie l’ay armé, & blaſonné, Si qu’il le m’a pres que donné:	Je l'ai armé, et blasonné, Si qu'il le m'a pres que donné:
Ie luy diſois que ſon feu pere Fut ſi vaillant:	Je te disais que son feu père Fut si vaillant:
ha, fais ie, frere, Qu'eſtes vous de bon parentaige, Vous eſtes, dy ie, de lignaige D’icy entour plus à louer:	ha, fais assez, frère, Qu'êtes -vous de bon parentaige, Vous êtes, dis sent, de lignaige D'ici entour plus à louer:
Mais ie puiſſe Dieu auouer, ’il n’eſt atrait d’vne peautraille La plus rebelle villenaille Qui ſoit, ce croy ie, en ce royaume.	Mais personne puisse Dieu avouer, 'il n'est atrait d'une peautraille La plus rebelle villaille Qui soit, ce croyait, en ce royaume.
h!	h!
fais-ie, mon amy Guillaume, Que reſſẽblez-vous bien de chere, Et de tout à voſtre feu pere.	fais-je, mon ami Guillaume, Que ressblez-vous bien de chère, Et de tout à votre feu père.
doys Dieu ſçait comment i’eſchauffauEt à la foys i’entrelardoys en parlant de ſa draperie:	dois Dieu sait comment j'eschauffauEt à la fois j'entrelardais en parlant de sa draperie:
Et puis fais-ie, ſainte Marie!	Et puis fais-je, sainte Marie!
Comment preſtoit il doucement es denrées ſi humblement?	Comment prêtait -il doucement es denrées si humblement?
l'eſtes vous dy-ie, tout craché:	l'êtes -vous dis-je, tout craché:
outesfois on euſt arraché es dents du villain Marſouin Son feu pere, & du babouin Le filz, ains que cecy preſtaſſent, Ne que iamais beau mot parlaſsẽt Mais au fort ay-ie tant bretté, Et parlé, qu’il m’en a preſté Six aulues.	outefois on eût arraché es dents du villain Marsouin Son feu père, et du babouin Le fils, ains que ceci prêtassent, Ne que jamais beau mot parlassẽt Mais au fort ai-je tant breté, Et parlé, qu'il m'en a prêté Six aulues.
Guillemette.	Guillemette.
Voire à iamais rendre.	Voire à jamais rendre.
Patelin.	Patelin.
Ainſi le deuez-vous entendre, Rendre?	Ainsi le devez-vous entendre, Rendre?
on luy rendra le diable,	on avait rendra le diable,
Guillemette.	Guillemette.
Il m’eſt ſouuenu de la fable Du Corbeau qui eſtoit aſſis Sur vne croix de cinq à ſix Toyſes de hault, lequel tenoit Vn fromaige au bec:	Il m'est souvenu de la fable Du Corbeau qui était assis Sur une croix de cinq à six Toises de hault, lequel tenait Un fromagne au bec:
là venoit Vn Renard qui vid ce fromage, Penſa à luy comment l’auray-ie?	là venait Un Renard qui vit ce fromage, Pensa à lui comment l'aurai-je?
Lors ſe miſt deſſouz le Corbeau, Ha, fiſt il, tant as le corps beau, Et ton chant plein de melodie!	Lors se mit dessouz le Corbeau, Ha, fît -il, tant as le corps beau, Et ton chant plein de mélodie!
Le Corbeau par ſa cornardie, Dyant ſon chant ainſi vanter i'ouurit le bec pour chanter.	Le Corbeau par sa cornardie, Dyant son chant ainsi vanter j'ouvrit le bec pour chanter.
et ion fromaige chet à terre:	et ion fromaige chet à terre:
t maiſtre Renard le vous ſerre A bonnes dents, & ſi l’emporte.	t maître Renard le vous serre A bonnes dents, et si l'emporte.
Ainſi eſt il, ie m’en fais forte, De ce drap, vous l’auez hapé Par blaſoinie;	Ainsi est il, Seigneur m'en fais forte, De ce drap, vous l'avez hapé Par blasoin;
& atrapé En luy vſant de beau langaige, Comme fiſt Renard du fromaige, ous l’en auez prins par la mouë.	et atrapé En même usant de beau langaige, Comme fît Renard du fromaige, ous l'en avez prins par la moue.
Patelin.	Patelin.
l doit venir menger de l’Ouë.	L doit venir menger de l'Oue.
Mais voicy qu’il nous fauldra faire le ſuis certain qu’il viendra braire Pour auoir argent promptement, ay penſé bon apointement.	Mais voici qu'il nous fauldra faire le suis certain qu'il viendra braire Pour avoir argent promptement, ai pensé bon apointement.
Car il conuient que ie me couche Comme malade ſur ma couche.	Car il convient que personne me couche Comme malade sur ma couche.
Et quand il viendra vous direz:	Et quand il viendra vous direz:
hl parlez bas, & gemirez, en faiſant vne chere ſade.	hl parlez bas, et gémirez, en faisant une chère sade.
as!	as!
ferez-vous, il eſt malade, Paſsé deux mois, ou ſix ſemaines Et s’il vous dit, ce ſont trudaines Il vient d’auecq' moy tout venant Helas!	ferez-vous, il est malade, Passé deux mois, ou six semaines Et s'il vous dit, ce sont trudaines Il vient d'avecq moi tout venant Hélas!
ce n’eſt pas maintenant, Ferez vous, qu’il fault rigoler, Et le me laiſſer flageoler:	ce n'est pas maintenant, Ferez -vous, qu'il sault rigoler, Et le me laisser flageoler:
Car il n’en aura autre choſe.	Car il n'en aura autre chose.
Guillemette.	Guillemette.
Par l’ame qui en moy repoſe Ie feray tresbien la maniere:	Par l'âme qui en moi repose Je ferai tresbien la manière:
Mais ſi vous renchéez arriere Que iuſtice vous en reprene, Ie me doute qu’il ne vous prene Pis la moitié qu’à l’autre foys.	Mais si vous renchéez arrière Que justice vous en reprène, Je me doute qu'il ne vous prenée Pis la moitié qu'à l'autre fois.
Patelin.	Patelin.
Or paix, ie ſçay bien que ie fais, Il fault faire ainſi que ie dy.	Or paix, Seigneur sais bien que je fais, Il sault faire ainsi que je dis.
Guillemette.	Guillemette.
Souuienne-vous du ſamedy Pour Dieu qu’on vous pillotia.	Souvienne-vous du samedi Pour Dieu qu'on vous pillotia.
Vous ſçauez que chacun cria Sur vous pour voſtre tromperie,	Vous Savez que chacun cria Sur vous pour votre tromperie,
Patelin.	Patelin.
Or laiſſez celle bauerie, Iviendra nous ne gardõs l’heure.	Or laissez celle baverie, Iviendra nous ne gardons l'heure.
ll fault que ce drap nous demeure e hruuroicoacher.	loul sault que ce drap nous demeure é hruroicocher.
Guillemette.	Guillemette.
Allez doncques.	Allez donc.
Patelin.	Patelin.
Or ne riez point.	Or ne riez point.
Guillemette.	Guillemette.
Aien quiconques:	Aien quiconques:
ſais pleureray à chauldes larmes.	sais pleurerai à chauldes larmes.
Patelin.	Patelin.
nous fault eſtre tous deux fermes fin qu’il ne s’en aperçoiue.	nous sault être tous deux fermes fin qu'il ne s'en aperçoive.
Le Drapier.	Le Drapier.
croy qu’il eſt temps que ie boyue our m’en aller, hé non feray, edoy boire, & ſi mengeray e l’Ouë, par ſaint Mathelin, hez maiſtre Pierre Pathelin:	crois qu'il est temps que ainsi boive our m'en aller, hé non ferai, édoi boire, et si mengerai eût l'Oue, par saint Mathelin, hé maître Pierre Pathelin:
là receuray-ie pecune.	là recevrai-je pecune.
laperay là vne prune, out le moins, ſans riẽ deſpẽdre.	laperai là une prune, out le moins, sans rien dépendre.
I’y vois, ie ne puis plus rienvendr Hau?	J'y vois, Madame ne puis plus rienvendr Hau?
qu’eſt ceans?	qu'est céans?
Guillemette.	Guillemette.
Helas!	Hélas!
fire, Pour Dieu, ſi vous voulez riẽ dir Parlez plus bas.	sire, Pour Dieu, si vous voulez rion dir Parlez plus bas.
Le Drapier.	Le Drapier.
Dieu vous gard, dame.	Dieu vous gard, dame.
Guillemette.	Guillemette.
Ho plus bas.	Ho plus bas.
Le Drapier.	Le Drapier.
Et quoy?	Et quoi?
Guillemette.	Guillemette.
Bon gré m’ame!	Bon gré m'âme!
Ou eſt il?	Ou est -il?
Le Drapier.	Le Drapier.
Guillemette.	Guillemette.
Làs!	Làs!
ou doit il eſtre?	ou doit il être?
Le qui?	Le qui?
Le Drapier.	Le Drapier.
Guillemette.	Guillemette.
Ah!	Ah!
c’eſt mal dit, mon maiſtre, Ou il eſt?	c'est mal dit, mon maître, Ou il est?
Dieu par ſa grace Le ſçache, il garde la place Ou il eſt, le pauure martyr Vnze ſemaines ſans partir.	Dieu par sa grâce Le sache, il garde la place Ou il est, le pauvre martyr Vnze semaines sans partir.
Le qui?	Le qui?
Le Drapier.	Le Drapier.
Guillemette.	Guillemette.
Pardonnez moy, ie n’oſe Parler hault, ie croy qu’il repoſe.	Pardonnez -moi, je n'ose Parler haut, Elle crois qu'il repose.
Il eſt vn petit aplommé:	Il est un petit applommé:
Helas il eſt aſſommé Le pauure homme.	Hélas il est assommé Le pauvre homme.
Le Drapier.	Le Drapier.
Guillemette.	Guillemette.
Maiſtre Pierre.	Maître Pierre.
Le Drapier.	Le Drapier.
Quoy?	Quoi?
n’eſt il pas venu querre Six aulnes de drap maintenant.	n'est il pas venu querre Six aulnes de drap maintenant.
luy?	On?
Guillemette.	Guillemette.
Le Drapier.	Le Drapier.
Il en vient tout venant tre N’a pasla moitié d’vn quart d’heuDeliurez moy dea, ie demeure Beaucoup, çà ſans plus flageoler Mon argent.	Il en vient tout venant tre N'a pasla moitié d'un quart d'heuDélivrez moi dea, ie demeure Beaucoup, çà sans plus flageoler Mon argent.
Cuillemette.	Cuillemette.
Hé ſans rigoler, Il n’eſt pas temps que l’on rigole.	Hé sans rigoler, Il n'est pas temps que l'on rigole.
Le Drapier.	Le Drapier.
Cà mon argent, eſtes vous fole?	Çà mon argent, êtes -vous sole?
Il me fault neuf frans.	Il me sault neuf frans.
Guillemette.	Guillemette.
Ha?	Ha?
Guillaume.	Guillaume.
Il ne fault point couurirde chaum Icy, ne bailler ces brocardz.	Il ne sault point couvrirde chaum Ici, ne bailler ces brocards.
Allez ſorner à voz coquardz A' qui vous cuydez-vous iouer?	Allez sorner à vocz coquardz qui -vous cuydez-vous jouer?
Le Drapier.	Le Drapier.
Ie puiſſe Dieu delauouer.	Je puisse Dieu délavouer.
Si ie n’ay neuf frans.	Si ici n'ai neuf frans.
Gu llemette.	Gu lélémette.
Helas!	Hélas!
ſire, Chacun n’a pas ſi fain de rire Comme vous, ne de flagorner.	sire, Chacun n'a pas si sain de rire Comme vous, ne de flagorner.
Le Drapier.	Le Drapier.
Dites, ie vous pry', ſans ſorner, lar amour, taites moy venir ſaiſtre Pierre.	Dites, Seigneur vous pry', sans sorner, lar amour, taites -moi venir saistre Pierre.
211 Guillemette.	211 Guillemette.
delauenit Ious puiſt il:	délavenit Ious puist -il:
& eſt ce à meshuy?	et est -ce à meshui?
Le Drapier.	Le Drapier.
N’eſt ce pas ceans que ie ſuy Chez maiſtre Pierre Pathelin?	N'est ce pas céans que ici su Chez maître Pierre Pathelin?
Guillemette.	Guillemette.
Juy, le mal ſaint Mathelin, ans mõ peché, au cueur vous tiẽne arlez bas.	Jui, le mal saint Mathelin, ans mon péché, au cueur vous tienne arlez bas.
Le Drapier.	Le Drapier.
Le dyable y auienne, Je l’oſerois-ie demander?	Le diable y avait, Je l'oserais-je demander?
Guillemette.	Guillemette.
I Dieu me puiſſe commander las, ſi voulez, qu’il ne s’eſueille.	I Dieu me puisse commander las, si voulez, qu'il ne s'éveille.
Le Drapier.	Le Drapier.
Quel bas!	Quel bas!
voulez vous en l’oreille?	voulez -vous en l'oreille?
lu fons du puys?	lu fonds du puis?
ou de la caue?	ou de la cave?
Guillemette.	Guillemette.
Hé Dieu!	Hé Dieu!
que vous auez de bauel Au fort c’eſt touſiours voſtre guil	que vous avez de bavel Au fort c'est toujours votre guil
Le Drapier.	Le Drapier.
Le dyable y ſoit, quand ie m’auiſe Si voulez que ie parle bas Dites çà:	Le diable y soit, quand on m'avise Si voulez que ici parle bas Dites çà:
quant eſt de debas Itelz, ie ne l’ay point aprins.	quant est de bas Itelés, on ne l'ai point apprins.
Vray eſt que maiſtre Pierre a prin Six aulnes de drap auiourd’huy.	Vrai est que maître Pierre a prin Six aulnes de drap iourd'hui.
Guillemette.	Guillemette.
Et qu’eſt cecy?	Et qu'est ceci?
eſt ce à meshuy?	est -ce à meshui?
Dyable y ait part, aga quel prẽdre Ah, ſire, que l’on le puiſt pendre Qui ment, il eſt en tel party, Le pauure homme, qu’il n’a part Du lict ya vnze ſemaines.	Dyable y ait part, aga quel prendre Ah, sire, que l'on le puist pendre Qui ment, il est en tel parti, Le pauvre homme, qu'il n'a part Du lit ya unse semaines.
Nous baillez vous de voz trudaines Maintenant?	Nous baillez -vous de vœux train Tenant?
en eſt ce raiſon?	en est ce raison?
Vous vuiderez de ma maiſon, Par les angoiſſes Dieu, moy laſſe,	Vous viderez de ma maison, Par les angoisses Dieu, moi lasse,
Le Drapier.	Le Drapier.
Dea, vous diſſiez que ie parlaſſe Si bas, ſainte benoiſte Dame!	Dea, vous dissiez que ici parlasse Si bas, sainte bénite Dame!
vous eriez?	vous eriez?
Cuillemette.	Cuillemette.
C’eſtes vous, par m’ame, Qui ne parlez fors que de noiſe.	C'êtes -vous, par m'âme, Qui ne parlez fors que de noise.
Le Drapier.	Le Drapier.
Dites, à fin que ie m’en voiſe, biiſlez moy.	Dites, à fin que ainsi m'en voise, biislez -moi.
Guillemette.	Guillemette.
Parlez bas, ferez?	Parlez bas, ferez?
Le Drapier.	Le Drapier.
Mais vous meſmes l’eſueillerez, Vous parlez plus hault quatre fois, Par le ſang bieu, que ie ne fois.	Mais vous mêmes l'éveillerez, Vous parlez plus haut quatre fois, Par le sang bieu, que ie ne fois.
e vous requiers qu’on me deliure,	Je vous requiers qu'on me délivre,
Guillemette.	Guillemette.
Et qu’eſt ce cy?	Et qu'est ce cy?
eſtes vous yure?	êtes -vous ivre?
Ou hors du ſens?	Ou hors du sens?
Dieu noſtre pere!	Dieu notre père!
Le Drapier.	Le Drapier.
Iure?	Jure?
maugré en ayt ſaint Pere:	maugré en ait saint Père:
Ioicy vne belle demande.	Joici une belle demande.
Guillemette.	Guillemette.
delas!	délas!
plus bas.	plus bas.
Le Drapier.	Le Drapier.
Ie vous demande Pour ſix aulnes, bõ gré ſaint Geor.	Je vous demande Pour six aulnes, bonne gré saint Geor.
De drap, dame.	De drap, dame.
Guillemette.	Guillemette.
On le vous forge, Et à qui l’auez-vous baillé?	On le vous forge, Et à qui l'avez-vous baillé?
Le Drapier.	Le Drapier.
A luy meſme.	A lui même.
Guillemette.	Guillemette.
Il eſt bien taillé D’auoir d’rap:	Il est bien taillé D'avoir d'rap:
helas!	hélas!
il ne hobe, Il n’a nul meſtier d’auoir robe Iamais robe ne veſtira Que de blanc, ne ne partira Dont il eſt, que les piedz deuant,	il ne hobe, Il n'a nul métier d'avoir robe Jamais robe ne vêtira Que de blanc, ne ne partira Dont il est, que les pieds devant,
Le Drapier.	Le Drapier.
C’eſt doncq' depuis Soleil leuant Car i’ay à luy parlé ſans faulte.	C'est doncq' depuis Soleil levant Car j'ai à lui parlé sans faute.
Guillemette.	Guillemette.
Vous auez la voix ſi treshaulte, Parlez plus bas, en charité.	Vous avez la voix si tréshaute, Parlez plus bas, en charité.
Le Drapier.	Le Drapier.
C’eſtes vous, par la verité, Vous meſmes en ſenglãte eſtreine.	C'êtes -vous, par la vérité, Vous mêmes en senglãte estreine.
Par le ſang bieu, voicy grãd' peine, Qui me payaſt ie m’en allaſſe.	Par le sang bieu, voici grãd' peine, Qui me payât ie m'en allasse.
Par Dieu oncques que ie preſtaſſe Ie n’en trouuay guere autre choſe:	Par Dieu oncques que Dieu prêtasse Je n'en trouvai guère autre chose:
Patelin.	Patelin.
Gaillemette:	Gaillemette:
vn peu d’eau Roſe, Hauſſez moy, ſerrez moy derriere:	Un peu d'eau Rose, Haussez -moi, serrez moi derrière:
Trut, à qui parlay-ie?	Trut, à qui parlai-je?
l’eſguiere A boire, frotez moy la plante.	l'esguiere À boire, frottez -moi la plante.
Ie l’oy là.	Je l'oi là.
Le Drapier.	Le Drapier.
Voire.	Voire.
Guillemette.	Guillemette.
Patelin, Ah!	Patelin, Ah!
meſchante, Vien çà, t’auois-ie fait ouurir Ces feneſtres?	méchante, Viens çà, t'avais-je fait ouvrir Ces fenêtres?
vien moy couurir.	viens -moi couvrir.
Oſtez ces gents noirs, marmata, Carimari, carimara.	Ostez ces gents noirs, marmata, Carimari, carimara.
Amenez les moy, amenez.	Amenez -les moi, amenez.
Guillemette.	Guillemette.
l’eſt ce?	l'est ce?
cõment vous demenez?	commment vous démenez?
Eſtes vous hors de voſtre ſens?	Êtes -vous hors de votre sens?
Patelin.	Patelin.
Tu ne vois pas ce que ie ſens.	Tu ne vois pas ce que ici sens.
Voy là vn moine noir qui vole.	Vois là un moine noir qui vole.
Prens le, baille luy vne eſtole.	Prends le, baille était vne étole.
Au chat au chat, cõment il monte	Au chat au chat, commment il monte
Cuillemette.	Cuillemette.
Et qu’eſt ce cy?	Et qu'est ce cy?
n’a vous pas honte Par mon ſerment c’eſt trop reſue	n'a vous pas honte Par mon serment c'est trop rêve
Patelin.	Patelin.
Les Phiſiciens m’ont tué De ces brouilliz qu’ilz m’ont fi boire, Et toutesfois les fault il croire Ilz en ouurent comme de cire.	Les Phisiciens m'ont tué De ces brouillis qu'ils m'ont fi boire, Et toutefois les sault il croire Ils en ouvrent comme de cire.
Guillemette.	Guillemette.
Helas!	Hélas!
venez le voir, beau ſi re, Il eſt ſi treſmal pacient.	venez le voir, beau si re, Il est si très pacient.
Le Drapier.	Le Drapier.
Eſt il malade, à bon eſſient, Puys orains qu’il vint de la foire	Est il malade, à bon essient, Puis orains qu'il vint de la foire
Guillemette.	Guillemette.
De la foire?	De la foire?
Le Drapier.	Le Drapier.
Par ſaint Iean voire, le ſçay qu’il y a eſté:	Par saint Jean voire, le sais qu'il y a été:
Du drap que ie vous ay preſté, Il m’en fault l’argẽt, maiſtrePierre.	Du drap que je vous ai prêté, Il m'en sault l'argent, maîtrePierre.
Patelis.	Patelis.
Ahmaiſtre leã, plus dur que pierre I’ay chié deux petites crotes, Noires, rondes comme pelotes:	Ahmaître letant, plus dur que pierre J'ai chié deux petites crotes, Noires, rondes comme pelotes:
Depn prenure tnutre cliſtere?	Dépn prenure tenutre clystère?
Le Drapier.	Le Drapier.
Et que ſçay-ie?	Et que sais-je?
qu’en ay-ie à faire?	qu'en ai-je à faire?
leuf frans m’y fault, ou ſix eſcuz	Leuf frans m'y sault, ou six écuz
Patelin.	Patelin.
Ces trois morceaux noirs & becuz Les m’apellez-vous pilloueres?	Ces trois morceaux noirs et becz Les m'appelez-vous pillouères?
llz m’ont gaſté les machoueres, Pour dieu ne m’en faites plus prendre (rendre aiſtre Iean, ilz m’ont fait tou lh!	llz m'ont gâté les machouères, Pour dieu ne m'en faites plus prendre (rendre aître Jean, ils m'ont fait tou lh!
il n’eſt choſe plus amere.	il n'est chose plus âme.
Le Drapier.	Le Drapier.
Non ont par l’ame de mon pere 1 Mes neuf frãs ne ſont point rẽduz	Non ont par l'âme de mon père 1 Mes neuf francs ne sont point rẽduz
Guillemette.	Guillemette.
Parmy le col ſoient ilz penduz Telz gẽts qui ſont ſi empeſchables Allez vous en de par les dyables Puis que de par Dieu ne peult eſtre.	Parmi le col soient ils penduz Telz gents qui sont si empêchables Allez vous en de par les diables Puis que de par Dieu ne peult être.
Le Drapier.	Le Drapier.
Par celuy Dieu qui me fiſt naiſtre, I’auray mon drap ains que ie fine, On mes neuf frans.	Par celui Dieu qui me fît naître, J'aurai mon drap ains que personne fine, On mes neuf frans.
Patelin.	Patelin.
Et mon vrine, Vous dit elle point que ie meure?	Et mon vrine, Vous dit -elle point que tu meure?
Helas pour Dieu, qu’il me demeure, Que ie ne paſſe point le pas.	Hélas pour Dieu, qu'il me demeure, Que tu ne passe point le pas.
Gaillemette.	Gaillemette.
Allez vous en, & n’eſt ce pas Mal fait de luy tuer la teſte?	Allez -vous en, et n'est ce pas Mal fait de Seigneur tuer la tête?
Le Drapier.	Le Drapier.
Dame, Dieu en ayt male feſte:	Dame, Dieu en ait male fête:
Six aulnes de drap maintenant Dites, eſt ce choſe auenant, Par voſtre foy, que ie les perde	Six aunes de drap maintenant Dites, est ce chose avenant, Par vôtre foi, que ie les perde
Patelin.	Patelin.
Si peuſſiez eſclarcir ma merde.	Si peussiez éclarcir ma merde.
Maiſtre Iean, elle eſt ſi treſdure Que ie ne ſçay comme ie dure, Quand elle eſt hors du fondement.	Maître Jean, elle est si tresdure Que on ne sais comme ici dure, Quand elle est hors du fondement.
Le Drapier.	Le Drapier.
Il me fault neuf frans rondement, Que bõ gre' ſaint Pierre de Rõme.	Il me sault neuf fran rondement, Que bien gré saint Pierre de Romme.
Guillemette.	Guillemette.
Helas!	Hélas!
anisaihantez ceſt hõme Et comment eſtes-vous ſi rude?	anisaihantez cet homme Et comment êtes-vous si rude?
Vous voyez clerement qu’il cude Que vous ſoyez Phiſicien.	Vous voyez clèrement qu'il cude Que vous soyez Phisicien.
Helas!	Hélas!
le pauure Chreſtien A aſſez de male meſchance:	le pauvre Chrétien A assez de male méchance:
Vnze ſemaines ſans laſchance A eſté illecq' le pauure homme.	Unse semaines sans lâchance A esté illecq le pauvre homme.
Le Drapier.	Le Drapier.
Par le ſang bieu ie ne ſçay comme Ceſt accident luy eſt venu:	Par le sang bieu Madame ne sais comme Cest accident apprendre est venu:
Car il eſt auiourd’huy venu, Et auons marchandé enſemble I tout le moins cõme il me ſemblo 1- Ou ie ne ſçay que ce peult eſtre.	Car il est aujourd'hui venu, Et avons marchandé ensemble I tout le moins commandé il me semblo 1- Ou G ne sais que ce peult être.
Guillemette.	Guillemette.
Par noſtre Dame, mõ doux maitre Vous n’eſtes pas en bon memoire.	Par notre Dame, mon doux maître Vous n'êtes pas en bon mémoire.
Sans faulte, ſi me voulez croire, Vous irez vn peu repoſer.	Sans faute, si me voulez croire, Vous irez un peu reposer.
ſer Car moult de gẽts pourroient gloQue vous venez pour moy ceans.	ser Car moult de gents pourraient gloQue vous venez pour moi céans.
Allez hors, les Phiſiciens Viendront icy tout en preſence:	Allez hors, les Phisiciens Viendront ici tout en présence:
Ie n’ay cure que l’on y penſe A' mal:	Je n'ai cure que l'on y pense A' honneur:
car ie n’y penſe point.	car notre n'y pense point.
Le Drapier.	Le Drapier.
Etmaulgré bieu, ſuis-ie en ce point Par la feſte Dieu ie cuidoye Encor', & n’auez vous point d’Oye Au feu?	Etmaulgré bieu, suis-je en ce point Par la fête Dieu tu cuidoie Encor', et n'avez vous point d'Oye Au feu?
Guillemette.	Guillemette.
C’eſt tresbelle demande.	C'est tresbelle demande.
Ah, ſire, ce n’eſt pas viande Pour malades:	Ah, sire, ce n'est pas viande Pour malades:
mengez voz ouës, Sans nous venir iouer des mouës Par ma foy vous eſtes trop aiſe,	mengez vos oues, Sans nous venir jouer des moues Par ma foi vous êtes trop aise,
Le Drapier.	Le Drapier.
Ie vous pry qu’il ne vous deſplaiſe Cat ie cuydoye fermement Encot' par le ſaint ſacrement Dieu:	Je vous pri qu'il ne vous déplaise Cat où cuydoye fermement Encot' par le saint sacrement Dieu:
dea or y vois-ie ſçauoir.	dea or y vois-je savoir.
Ie ſçay bien que ie doy auoir Six aulnes tout en vne piece:	Je sais bien que Dieu dois avoir Six aunes tout en une pièce:
Mais ceſte femme me deſpiece De tous poincts mõ entendement n’les acues viaycinent Non a dea, il ne ſe peult ioindre.	Mais cette femme me despiece De tous points mõ entendement n'les acues viaiscinent Non a dea, il ne se peult joindre.
I’ay veu la mort qui le viẽt poindre Au moins, ou il le contrefait.	J'ai vu la mort qui le vient poindre Au moins, ou il le contrefait.
Et ſi a, il les print de fait, Et les miſt deſſouz ſon eſſelle.	Et si a, il les prînt de fait, Et les mit dessouz son esselle.
Par ſainte Marie la belle, Non a, ie neſçay ſi ie ſonge, Ie n’ay point aprins que ie donge Mes drapz en dormant, ne veillant A’ nul tãt ſoit mon bien vueillant:	Par sainte Marie la belle, Non a, je nesçai si tu songe, Je n'ai point apprins que ie donge Mes drapz en dormant, ne veillant A nul ant soit mon bien veillant:
Ie ne les euſſe point acreuës.	Je ne les eusse point acreues.
Par le ſang bieu, il les a euës.	Par le sang bieu, il les a eues.
Et par la mort non a, ſi tiens-ie, Nõ a, mais à quoy doncq' enviẽs!	Et par la mort non a, si tiens-je, Comme a, mais à quoi doncq' enviens!
Si a par le ſang noſtre Dame:	Si a par le sang notre Dame:
me Meſcheoir puiſt il de corps & d’a Si ie ſçay qui ſçauroit à dire Qui a le meilleur, ou le pire (te D’eulx, ou de moy, ie n’y voy gou	me Mêcheoir puist -il de corps et d'a Si apprendre sais qui saurait à dire Qui a le meilleur, ou le pire (te D'eul, ou de moi, elle n'y vois goul
Patelin.	Patelin.
S’en eſt il allé?	S'en est il allé?
Guillemette.	Guillemette.
Paix, i’eſcoute Ne ſçay quoy qu’il va flageolant, Il s’en va ſi fort grumelant, Qu’il ſemble qu’il doyue deſuer.	Paix, j'écoute Ne sais quoi qu'il va flageolant, Il s'en va si fort grumelant, Qu'il semble qu'il doive desuer.
Patelin.	Patelin.
Il n’eſt pas temps de me leuer Il eſt comme arriué à poinct.	Il n'est pas temps de me lever Il est comme arrivé à point.
Guillemette.	Guillemette.
Ie ne ſçay s’il reuiendra point, Ou non, dea ne bougez encore:	Je ne sais s'il reviendra point, Ou non, dea ne bougez encore:
Noſtre fait ſeroit tout frelore, S’il vous trouuoit eſtre leué.	Notre fait serait tout frêlore, S'il vous trouvait être lué.
Patelin.	Patelin.
Saint George!	Saint George!
Q’eſt il venu à bonne forge Luy qureſt itreſmeſcreant:	QU'est il venu à bonne forge Lui qurêt itresmescreant:
Il eſt en luy trop mieux ſeant Qi’vn crucifix en vn mouſtier.	Il est en était trop mieux séant Qi’rs crucifix en un moustier.
Guillemette.	Guillemette.
En vn tel ord vilain brutier Oncq' lard es pois n’eſcheut ſi bien Au moins dea, s’il ne faiſoit rien Aux dimenches.	En un tel ord vil brutier Oncque lard es pois n'écheut si bien Au moins dea, s'il ne faisait rien Aux dimenches.
Patelin.	Patelin.
Pour Dieu ſans rire, I’il venoit il pourroit trop nuire, e m’en tiens fort qu’il reuiendra.	Pour Dieu sans rire, J'il venait il pourrait trop nuire, eu m'en tiens fort qu'il reviendra.
Guillemette.	Guillemette.
Par mon ſerment il s’en tiendra di voudra:	Par mon serment il s'en tiendra di voudra:
mais ie ne pourroye.	mais ici ne pourroie.
Le Drapier.	Le Drapier.
Et, par le ſaint Soleil qui roye, e retourneray qui qu’en grouſſe Chez ceſt Auocat d’eau douce.	Et, par le saint Soleil qui roye, retournerai qui qu'en grousse Chez cet Avocat d'eau douce.
lé Dieu quel retrayeur de rentes!	lé Dieu quel retrayeur de rentes!
Que ſes parents, ou ſes parentes luroient vendu.	Que ses parents, ou ses parentes luraient vendu.
Or par S.	Or par S.
Pierre 2 Il a mon drap, le faux tromperre Ie luy baillé en ceſte place.	Pierre 2 Il a mon drap, le faux tromperre Je te baillé en cette place.
Guillemette.	Guillemette.
Quand me ſouuient de la grimaQu’il faiſoit en vous regardant Ie ry, il eſtoit ſi ardant De demander.	Quand me souvient de la grimaQu'il faisait en vous regardant Je ri, il était si ardant De demander.
Patelis.	Patelis.
Or paix, riace.	Or paix, riace.
Ie renie bieu, que ia ne face, S’il auenoit qu’on vous ouyſt Autant vaudroit qu’on s’en fouyſ Il eſt ſitres rebarbatif.	Je renie bieu, que ja ne face, S'il avenait qu'on vous ouït Autant vaudrait qu'on s'en fouis Il est sières rébarbatif.
Le Drapier.	Le Drapier.
Il eſt Auocat potatif A trois leçons, & trois pſeaumes.	Il est Avocat potatif A trois leçons, et trois paumes.
Et tient il les gẽs pour Guillaume Il eſt, par Dieu, auſſi pendable:	Et tient il les gens pour Guillaume Il est, par Dieu, aussi pendable:
Comme ſeroit vn blanc prenable Il a mon drap, ie regnie bieu, Et m’a il ioué de ce ieu?	Comme serait un blanc prenable Il a mon drap, tu régnie bieu, Et m'a il joué de ce jeu?
Holà, ou eſtes-vous fuye?	Holà, ou êtes-vous fuie?
Guillemette.	Guillemette.
Par mon ſerment, il m’a ouye Il ſemble qu’il doyue deſuer.	Par mon serment, il m'a ouïe Il semble qu'il doive desuer.
Patelin.	Patelin.
Ie feray ſemblant de reſuer, Allez là.	Je ferai semblant de rêver, Allez là.
Guillemeite.	Guilleite.
Comment vous criez?	Comment vous criez?
Le Drapier.	Le Drapier.
Bon gré en ayt Dieu, vous riez?	Bon gré en ait Dieu, vous riez?
Cà mon argent.	Çà mon argent.
Guillemette.	Guillemette.
Sainte Marie!	Sainte Marie!
Dequoy cuydez-vous que ie rle?	Dequoy cuidez-vous que ici rèle?
n’a ſi dolent en la feſte.	n'a si dolent en la fête.
i’en va, oncq' telle tempeſte ouyſtes, ne telle frenaiſie:	j'en va, onc telle tempête ouïstes, ne telle frénaisie:
eſt encor' en reſuerie, reſue, il chante il fatrouille int de langaiges, & barbouille.	est encore en rêverie, rêve, il chante il fatrouille int de langaiges, et barbouille.
ne viura pas demye heure, ir ceſte ame, ie ris & pleure emble.	ne vivra pas demie heure, ir cette âme, on ris et pleure emble.
Le Drapier.	Le Drapier.
Ie ne ſçay quel rire, Ne quel pleurer:	Je ne sais quel rire, Ne quel pleurer:
à bref vous dire Il fault que ie ſoye payé.	à bref vous dire Il sault que Seigneur soie payé.
Guillemette.	Guillemette.
Dequoy?	Dequoy?
eſtes vous deſuoyé?	êtes -vous dévoyé?
Recommencez vous voſtre verue?	Recommencez vous votre verve?
Le Drapier.	Le Drapier.
Ie n’ay point aprinsqu’on me ſerue De telz motz en mon drap vendãt Me voulez vous faire entendant De vecies, que ſont lanternes?	Je n'ai point apprinsqu'on me serve De telz mots en mon drap vendant Me voulez -vous faire entendant De vecies, que sont lanternes?
Patelin.	Patelin.
Sus toſt la Royne des guyternes A' coup que me ſoit aprochée:	Sus tost la Royne des guyternes A' coup que me soit approchée:
Ie ſçay bien qu’elle eſt acouchée De vingt & quatre guyterneaux Enfants à l’Abé d’Iuerneaux, Il me fault eſtre ſon compere.	Je sais bien qu'elle est acouchée De vingt et quatre guyterneaux Enfants à l'Abé d'Iuerneaux, Il me sault être son compère.
Guillemette.	Guillemette.
Helas!	Hélas!
penſez à Dieu le pere, Mon amy, non pas en guyternes.	pensez à Dieu le père, Mon ami, non pas en guiternes.
Le Drapier.	Le Drapier.
Hé!	Hé!
quel bailleur de baliuernes Sont ce cy?	quel bailleur de balivernes Sont ce cy?
or toſt que ie ſoye Payé, en or, ou en monnoye, De mon drap que vous auez prins.	or tôt que personne soie Payé, en or, ou en monnaie, De mon drap que vous avez prins.
Guillemette.	Guillemette.
Hé dea, ſi vous auez meſprins Vne foys ne ſuffiſt il mye?	Hé dea, si vous avez méprins Une foi ne suffît il mye?
Le Drapier.	Le Drapier.
Sçauez-vous qu’il eſt?	Savez-vous qu'il est?
belle amye:	belle amie:
M’aiſt dieu ie ne ſçay quel meſprendre (pendre Mais quoy il conuient rendre ou Quel tord vous fais-ie, ſi ie vien Ceans pour demander le mien?	M'ait dieu Madame ne sais quel méprendre (pendre Mais quoi il convient rendre ou Quel tord vous fais-je, si belle viens Ceants pour demander le mien?
Que bõ gré ſaint Pierre de Rõme,	Que bõ bonne saint Pierre de Romme,
Guillemette.	Guillemette.
Helas!	Hélas!
tant tourmentez ceſt hõmẽ, Ie voy bien à voſtre viſaige Certes, que vous n’eſtes pas ſaige.	tant tourmentez cet homme, Je vois bien à votre visaige Certes, que vous n'êtes pas saisge.
Par ceſte pechereſſe laſſe, Si i’euſſe ayde, ie vous liaſſe.	Par cette pécheresse lasse, Si j'eusse aide, tu vous liasse.
Vous eſtes treſtout forcené.	Vous êtes trestout forcené.
Le Drapier.	Le Drapier.
Corbieu i’enraige que ie n’ay Mon argent.	Corbieu j'enraige que je n'ai Mon argent.
Guillemette.	Guillemette.
Ah!	Ah!
quel' niceté!	quel niceté!
Seignez vous, benedicité, Faites le ſigne de la croix.	Seignez -vous, bénédicité, Faites le signe de la croix.
Le Drapier.	Le Drapier.
Or regnie-ie bieu ſi i’acrois De ceſt an drap:	Or régnie-je bieu si j'acrais De cette an drap:
hen quel mal	hen quel mal
Patelin.	Patelin.
Mere de Diou la coronade, Par fye y m’en voul anar:	Mère de Diou la coronade, Par fie y m'en voul anar:
Or renague biou oultre mar.	Or renue biou oultre martre.
Ventre de diou zen ditgigone, Caſtuy carrible, & res ne donne De carrilaine fuy ca none.	Ventre de diou zen ditgigone, Castui carrible, et rés ne donne De carrilaine fui ca none.
Que de l’argent il me ſone Auez entendu?	Que de l'argent il me sone Vez entendu?
beau couſin.	beau cousin.
Guillemette.	Guillemette.
Il eut vn oncle Lymoſin, Oui fut frere de ſa belle ante:	Il eut un oncle Lymosin, Oui fut frère de sa belle ante:
C’eſt ce qu’il le fait, ie me vante, Gergonner en Lymoſinois.	C'est ce qu'il le fait, on me vante, Gergonner en Lymosinois.
Le Drapier.	Le Drapier.
Dea, il s’en vint en tapinois, A' tout mon drap ſouz ſon eſſelle.	Dea, il s'en vint en tapinais, A' tout mon drap souz son esselle.
Patelin.	Patelin.
Venez ens, douce damiſelle, Et que vault ceſte crapaudaille?	Venez ens, douce damiselle, Et que vault cette crapaudaille?
Allez en arriere merdaille, Cà toſt ie vueil deuenir Prebſtre, Or ça que le dyable y puiſt eſtre En celle vieille Prebſterie Et fault il que le Prebſtre rie Alors qu’il deuſt chanter ſa meſſe?	Allez en arrière merdaille, Cà tôt a pueil devenir Prébstre, Or ça que le diable y puist être En celle vieille Prébsterie Et sault il que le Prébstre rie Alors qu'il dût chanter sa messe?
Guillemette.	Guillemette.
Helas!	Hélas!
helas!	hélas!
l’heure s’apreſſe Qu’il fault ſon dernier ſacrement.	l'heure s'appresse Qu'il sault son dernier sacrement.
Le Drapier.	Le Drapier.
Mais cõment?	Mais commment?
parle il proprement Picard?	parle il proprement Picard?
dont vient tel' coquardie?	dont vient tel coquardie?
Guillemette.	Guillemette.
Samere fut de Picardie, Pource le parle il maintenant.	Same fut de Picardie, Pource le parle il maintenant.
Patelin.	Patelin.
Dont viens-tu careſme prenant?	Dont viens-tu carême prenant?
Juacarme lief godemen Etlbelic becq iglughe golan Henriey benrien con ſela pen Ych ſalgneb nede que maignen Grile grile ſcohehonden Zilop zilop en' nom que bouden Diſticlien vnen deſen verſen Mat groet feſtat ou truit dẽherſe En vuacte viulle comme trie Cha à dringuer, ie vous en prie Quoy?	Juacarme lief godemen Etlbelic becq iglughe golan Henrie benrien con sela pen Ychet salègne nede que maignen Grile grile scohehonden Zilop zilop en' nom que bouden Disticlien un desen versen Mat groète fêtât ou truit dẽherse En vacte vivlle comme trie Cha à dringuer, je vous en prie Quoi?
act ſemigot yaue Et qu’on m’y mette vn peu d’eau Vuſte vuille pour le frimas, Faites venir ſire Thomas Tantoſt qui me confeſſera.	act semigot yave Et qu'on m'y mette un peu d'eau Vite ville pour le frimas, Faites venir sire Thomas Tantôt qui me confessera.
Le Drapier.	Le Drapier.
Qu’eſt cecy?	Qu'est ceci?
il ne ceſſera Huy de parler diuers langaige.	il ne cessera Hui de parler divers langagne.
Au moins qui me baillaſt vn gaige:	Au moins qui me baillât un gaige:
Guillemette.	Guillemette.
Par les angoyſſes Dieu moy laſſe Vous eſtes vn bien diuers homme, que voulez vous die ne ſçay cõn Vous eſtes ſi fort obſtiné.	Par les angoisses Dieu moi lasse Vous êtes un bien divers homme, que voulez -vous die ne sais comn Vous êtes si fort obstiné.
Patelin.	Patelin.
Or cha renouart ou tiné, Bé dea que ma couille eſt pelouſe?	Or cha renvart ou tiné, Bé dea que ma couille est pelouse?
El' ſemble vne cate pelouſe Ou à vne mouſque à miel.	Él' semble une cate pelouse Ou à une mousque à miel.
Bé parlez à moy Gabriel:	Bé parlez à moi Gabriel:
Playes Dieu!	Playes Dieu!
qu’eſt ce qui s’ataque A m’en cul?	qu'est ce qui s'ataque A m'en cul?
eſt ce vne Vaque?	est ce une Vaque?
Vne Mouque?	Une Mouque?
ou vn Eſcarbot?	ou un Escarbot?
Bé dea, i’ay le mau ſaint Garbot, Suis-ie des foyreux de Bayeux, Iean du Quemin ſera ioyeux:	Bé dea, j'ai le mau saint Garbot, Suis-je des foireux de Bayeux, Jean du Quemin sera joyeux:
Mais qu’il ſçache que ie le ſée.	Mais qu'il sache que ainsi le zée.
Bé, par ſaint Miquel, ie berée Voluntiers à luy vne fes.	Bé, par saint Miquel, Seigneur berée Voluntiers à lui se fes.
Le Drapier.	Le Drapier.
Comment peult il porter le fes De tant parler?	Comment peult il porter le fes De tant parler?
ah il s’afole.	ah il s'afole.
Guillemette.	Guillemette.
Celuy qui l’aprint à l’eſcole Eſtoit Normand, ainſi auient du’en la fin il luy en ſouuient, Il s’en va.	Celui qui l'apprînt à l'école Était Normand, ainsi avient du'en la fin il lui y souvient, Il s'en va.
Le Drapier.	Le Drapier.
Ah ſainte Marie!	Ah sainte Marie!
Voicy la plus grand' reſuerie Ou ie fuſſe oncques mes bouté Iamais ne me fuſſe douté Qu’il n’euſt huy eſté à la foire.	Voici la plus grand rêverie Ou tu fusse oncques mes bouté Iamais ne me fusse douté Qu'il n'eût hui été à la foire.
Guillemette, Vous le cuydez?	Guillemette, Vous le cuidez?
Le Drapier.	Le Drapier.
Saint laques voire, Mais i’aperçoy bien le contraire	Saint la voire, Mais j'aperçois bien le contraire
Patelin.	Patelin.
Sont il vn Aſne que i’oy braire Allaſt allaſt couſin à moy, Ilz le ſeront en grand’ eſmoy.	Sont il un Âne que j'oi braire Allast allât cousin à moi, Ils le seront en grand émoi.
Le iour quand ne te reuerray, Il conuient que ie te hairay:	Le jour quand ne te réverrai, Il convient que Ne te haïrai:
Car tu m’as fait grand' trichery Ton fait il ſont tout trompery Ha oul danda oul en raueze ye Corf ha en œuf.	Car tu m'as fait grand' icheri Ton fait il sont tout tromperi Ha oul danda oul en raveze ie Corf ha en œuf.
Guillemette.	Guillemette.
Dieu vous benie.	Dieu vous bénie.
Patelin Huis os bez ou dronc nos babou Digaut an tan en holmadou Empediſdich guichebnuan Quelz queuiẽt ob odre dochan an M’en ezcahret hozbouzelou Eny obet grande canou Maz rechet crux dan hol con:	Patelin Huis os bez ou dronc nos babouou Digau an tan en holmadou Empédisdich guichebnuan Quelz queuience entendre odre dochan an M'en ezcahret hozbouzelou Eni objet grande canou Maz rechet crux dan hol con:
So oloz merueil grand nacon Aluzen archete pyſi Har calas amour ha courteyſi.	So olos merveil grand nacon Aluzen archète pysi Har calas amour ha courteysi.
Le Drapier.	Le Drapier.
Il s’en va comment il guargouille:	Il s'en va comment il gargouille:
Mais que dyable eſt ce qu’il barbouille Sainte Dame:	Mais que diable est -ce qu'il barbouille Sainte Dame:
comme il barbote.	comme il barbote.
Par le corps il barbelote, Ses motz tãt qu’on n’y entend rien Il ne parle pas Chreſtien Ne nul langaige qui apere.	Par le corps il barbelote, Ses motz toujours qu'on n'y entend rien Il ne parle pas Chrétien Ne nul langaige qui apère.
Guillemette.	Guillemette.
Ce fut la mere de ſon pere Qui fut atraite de Bretaigne.	Ce fut la mère de son père Qui fut atraite de Bretagne.
Il ſe meurt, cecy nous enſeigne Qu’il fault ſes derniers ſacremer	Il se meurt, ceci nous enseigne Qu'il sault ses derniers sacremer
Patelie.	Patelie.
Hé par ſaint Gigon tu ne meus Vuaux ce deu couille de Loraine Dieu te mette en bonne ſemaine, Tu ne vaux mie vne vielz nat.	Hé par saint Gigon tu ne meus Vuaux ce dev couille de Loraine Dieu te mette en bonne semaine, Tu ne vaux mie quelque vielz nat.
Va ſanglante bote ſanat, Va foutre, va ſanglant paillard:	Va sanglante bote sanat, Va foutre, va sanglant paillard:
Par la mort bieu vien t’en boire, Et baille moy ſtan grain de poire Car vrayement il le mengera.	Par la mort bieu viens t'en boire, Et baille moi stan grain de poire Car vraiement il le mengera.
Et par ſaint George il bura A' ty que veux-tu que ie dié?	Et par saint George il bura A' y que veux-tu que je dié?
Dy?	Dis?
viens tu nient de Picardie?	viens tu nient de Picardie?
Iaques nient ſe ſont ebobis, Et bona dies ſit vobis Magiſter amantiſſime.	Jaques nient se sont ébobis, Et bon dies sit vobis Magister amantissime.
Pater reuerendiſſime Quomodo brulis?	Pater reuerendissime Quomodo brûlis?
quæ noua?	quæ noua?
Pariſius non ſunt oua.	Parisius non sunt oua.
quid petit ille Mercator?	quid petit ille Mercator?
Jicat ſibi quod trefator, le qui miectò iacet, Iult ei dare, ſi placet, Je oça ad comedendum:	Jicat sibi quod trefator, le qui miect jacet, Jult ei dare, si placet, Je oça ad comédendum:
ii ſit bona ad edendum lete ſibi ſine mora.	ji sit bona ad édendum lette sibi sine mora.
Le Drapier.	Le Drapier.
lalihon feriiene, ia le mourra tout parlant:	lalihon feriene, ja le mourra tout parlant:
comment il eſcume?	comment il écume?
léez vous pas cõme il iete eſcume lautement, la diuinite!	léez -vous pas comme il jette écume lautement, la divinité!
Guillemette.	Guillemette.
Or s’en va ſon humanité it demoureray pauure & laſſe.	Or s'en va son humanité it démourerai pauvre et lasse.
Le Drapier.	Le Drapier.
l fut bon que ie m’en allaſſe luant qu’il euſt paſſé le pas.	l fut bon que Dieu m'en allasse luant qu'il eût passé le pas.
e doute qu’il ne vouſiſt pas ous dire à ſon treſpaſſement Jeuant moy, ne ſi priuément lucuns ſecretz par auanture.	Je doute qu'il ne vousît pas ous dire à son trépassement Jeuant moi, ne si privément lucuns secrets par aventure.
ardonnez moy:	ardonnez -moi:
car ie vous iure Que ie cuydois, par ceſte ame, Qu’il euſt mõ drap.	car je vous jure Que ainsi cuydois, par cette âme, Qu'il eût mon drap.
A Dieu, Dan Pour Dieu qu’il me ſoit pardonn	À Dieu, Dan Pour Dieu qu'il me soit pardonn
Guillemette.	Guillemette.
Le benoiſt iour vous ſoit donné, Si ſoit à la pauure dolente.	Le benoît jour vous soit donné, Si soit à la pauvre dolente.
Le Drapier.	Le Drapier.
Par ſainte Marie la gente, Ie me tiens plus esbaubely Qu’oncques, le dyable en lieu de A prins mon drap pour me tente Benedicité, atenter Ne puiſt il ia à ma perſonne, Et puis qu’ainſi va ie le donne Pour Dieu à quiconques l’a prins	Par sainte Marie la gente, Je me tiens plus ébaubeli Qu'oncques, le diable en lieu de A prins mon drap pour me tente Bénédicité, atenter Ne puist il ja à ma personne, Et puis qu'ainsi va ie le donne Pour Dieu à quiconques l'a prins
Patelin.	Patelin.
Auant, vous ay-ie bien aprins?	Avant, vous ai-je bien aprins?
Or s’en va il le beau Guillaume.	Or s'en va il le beau Guillaume.
Dieu!	Dieu!
qu’il a deſſouz ſon heaum Moult luy viendra d’auiſions Par nuict quand il ſera couché,	qu'il a dessouz son heau Moult avait viendra d'avisions Par nuit quand il sera couché,
Cuillemette.	Cuillemette.
Comment il a eſté mouché:	Comment il a été mouché:
ay-ie pas bien fait mon deuoir?	ai-je pas bien fait mon devoir?
Patelin.	Patelin.
Par le corps bieu à dire voir Vous y auez tresbien ouuré, Aumoins auons nous recouuré Aſſez drap pour faire des robes.	Par le corps bieu à dire voir Vous y avez tresbien ouvré, Aumoins avons nous recouvré Assez drap pour faire des robes.
Le Drapier.	Le Drapier.
Quoi?	Quoi?
dea, chacũ me paiſt de lobes, Cloun Hremporte mion auoir, Et prend ce qu’il en peult auoir:	dea, chacũ me paît de lobes, Cloun Hremporte myon avoir, Et prend ce qu'il en peult avoir:
Dr ſuis-ie le Roy des meſchants, ſeſmemẽt les Bergers des champs lle cabuſent ores le mien qui i’ay touſiours fait du bien.	Dr suis-je le Roi des méchants, sesmemẽt les Bergers des champs lèle cabusent ores le mien qui j'ai toujours fait du bien.
ne m’a pas pour neant gabé, en viendra au pié l’Abé ar la benoiſte coronnée	ne m'a pas pour néant gabé, en viendra au pié l'Abé ar la benoîte coronnée
Tibault l’Aignelet Berger.	Tibault l'Aignelet Berger.
lieu vous doint benoiſte iournée, tbon veſpre, mon ſeigneur doux.	lieu vous doint benoîte journée, tombon vespre, mon seigneur doux.
Le Drapier.	Le Drapier.
es-tu la truant mer doux?	es-tu la truant mer doux?
Quel bõ varlet?	Quel bonne varlet?
mais à quoy faire	mais à quoi faire
Le Berger.	Le Berger.
Mais qu’il ne vous vueille deſplait Ne ſçay quel veſtu deſuoyé, Mon bon ſeigneur, tout deſroyé, Qui tenoit vn fouet ſans corde M’a dit:	Mais qu'il ne vous veuille déplaît Ne sais quel vêtu desuoyé, Mon bon seigneur, tout desroyé, Qui tenait un fouet sans corde M'a dit:
mais ie ne me recorde Point biẽ au vray que ce peult eſti Il m’a parlé de vous, mon maiſtre, Ie ne ſçay quelle aiournerie.	mais personne ne me recorde Point bien au vrai que ce peult éti Il m'a parlé de vous, mon maître, Je ne sais quelle aiournerie.
Quant à moy, par ſainte Marie, Ie n’y entens ne gras ne greſle.	Quant à moi, par sainte Marie, Je n'y entends ne gras ne le.
Il m’a b-ouillé de peſle meſle De Brebis à de releuée Et m’a fait vne grand' leuée De vous, mon maiſtre, de bouclet	Il m'a bouillé de pèle -mêle De Brebis à de relevée Et m'a fait une grand leuée De vous, mon maître, de bouclet
Le Drapier.	Le Drapier.
Se ie ne te ſçay emboucler Tout maintenant deuant le lug Ie prie à Dieu que le deluge Coure ſur moy, & la tempeſte.	Se ie ne te sais emboucler Tout maintenant devant le lug Je prie à Dieu que le déluge Coure sur moi, et la tempête.
Iamais tu n’aſſommeras beſte, Par ma foy qu’il ne t’en ſouuit Tu me rendras, quoy qu’il auienne Six aulnes, dy ie, l’aſſommaige De mes beſtes, & le dommaige re tu m’as fait depuys dix ans.	Jamais tu n'assommeras bête, Par ma foi qu'il ne t'en souvit Tu me rendras, quoi qu'il avienne Six aulnes, dis -je, l'assommaige De mes bêtes, et le dommaige re tu m'as fait depuis dix ans.
Le Berger.	Le Berger.
Ne croyez pas les meſdiſants, Mon bõ ſeigneur:	Ne croyez pas les médisants, Mon bien seigneur:
car par ceſte ame	car par cette âme
Le Drapier.	Le Drapier.
Et par la Dame qu’on reclame Tuleo renuruu du lainedy Mes ſix aulnes de drap, ie dy Ce que tu as prins ſur mes beſtes.	Et par la Dame qu'on réclame Tuleo renuru du lainedi Mes six aulnes de drap, une d Ce que tu as prins sur mes bêtes.
Le Berger.	Le Berger.
Quel drap!	Quel drap!
ah mon ſeigneur vous eſtes 2 Ce croy, courrouſſé d’autre choſe.	ah mon seigneur vous êtes 2 Ce crois, courroussé d'autre chose.
Par ſaint Leu, mõ maiſtre ie n’oſe, Riens dire quand ie vous regarde.	Par saint Leu, mon maître Roi n'ose, Riens dire quand ie vous regarde.
Le Drapier.	Le Drapier.
Laiſſe m’en paix, va t’en, & garde Ta iournée, ſi bon te ſemble.	Laisse m'en paix, va -t-en, et garde Ta journée, si bon te semble.
Le Berger.	Le Berger.
lon ſeigneur acordons enſemble Pour Dieu que ie ne plaide point.	Lon seigneur acordons ensemble Pour Dieu que je ne plaide point.
Le Drapier.	Le Drapier.
Va, ta beſongne eſt en bon poinct Va t’en ie n’en acorderay, Par Dieu, ie n’en apointeray Que ainſi que le luge fera A voir, chacun me trompera Meſouen ſe ie n’y pouruoye.	Va, ta besongne est en bon point Va t'en On n'en acorderai, Par Dieu, notre n'en apointerai Que ainsi que le luge fera A voir, chacun me trompera Mésouen se rendre n'y pourvoie.
Le Berger.	Le Berger.
A Dieu, ſire, qui vous doint ioye Il fault doncq' que ie me defende A il ame là?	À Dieu, sire, qui vous doint joie Il sault donc que je me défende A il âme là?
PatelinOn me pende, S’il ne reuient, pat my la gorge.	PatelinOn me pende, S'il ne revient, pat mi la gorge.
Guillemette.	Guillemette.
Et non fait, que bon gré ſai George, Ce ſeroit bien au pis venir	Et non fait, que bon gré sais George, Ce serait bien au pis venir
Le Berger.	Le Berger.
Dieu yſt, Dieu y puiſt auenir.	Dieu yst, Dieu y puist enir.
Patelin.	Patelin.
Dieu te gard cõpain, que te fa	Dieu te gard comain, que te fa
Out paſata en deffault, si ie ne vois à ma iournée, Monſeigneur, à de releuée:	Out pasata en défaut, si ici ne vois à ma journée, Monseigneur, à de relevée:
Et s’il vous plaiſt vous y viendrez, Mõ doux maiſtre, & me defendrez Ma cauſe:	Et s'il vous plaît vous y viendrez, Mon doux maître, et me défendrez Ma cause:
car ie n’y ſçay rien, Et ie vous payeray tresbien Pourtant ſi ie ſuis mal veſtu.	car ici n'y sais rien, Et je vous payerai tresbien Pourtant si tu suis mal vêtu.
TAreeter.	TAreéter.
Or vien çà, & parle, qu’es tu?	Or vien çà, et parle, qu'es tu?
Ou demandeur, ou defendeur?	Ou demandeur, ou défendeur?
Le Berger.	Le Berger.
ay à faire à vn entendeur, Entẽdez vous biẽ mõ doux maiſtre I' qui i’ay long tẽps mené paiſtre jes brebiz, & les luy gardoye, lar mon ſerment ie regardoye Qu’il me payoit petitement:	ai à faire à un entendeur, Entiendez -vous bien mõ doux maître J' qui j'ai long temps mené paître jes brebiz, et les rendre gardoie, lar mon serment ainsi regardoie Qu'il me payait petitement:
Diray-ieitout?	Dirai-jeitout?
Patelin.	Patelin.
Dea ſeurement.	Dea sûrement.
ſon conſeil doit-on tout dire.	son conseil doit-on tout dire.
H ii	H Hi
Le Berger.	Le Berger.
Il eſt vray & verité, ſire, Que ie les y ay aſſommées Tãt, que pluſieurs ſe ſont paſmés, Maintesfois, & sõt cheuës mortes Tant fuſſent el' ſaines & fortes.	Il est vrai et vérité, sire, Que on les y ai assommées Tant, que plusieurs se sont pâmés, Maintesfois, et et sues mortes Tant fussent elle saines et fortes.
Et puis ie luy faiſois entendre, A' fin qu’il ne m’en peuſt reprẽdr Ah!	Et puisque tu faisais entendre, A fin qu'il ne m'en pût reprendr Ah!
fait il ne ſoit plus meſlée Auecques les autres, iete la.	fait il ne soit plus mêlée Avecques les autres, jette la.
Voluntiers, fais-ie, mais celà Se faiſoit par vne autre voye, Car par ſaint Ieanie les mengeoj Qui ſçauois bien la maladie.	Voluntiers, fais-je, mais celà Se faisait par autre voie, Car par saint Jeanie les mengeoj Qui savais bien la maladie.
Que voulez-vous que ie vous die?	Que voulez-vous que croire vous die?
I’ay cecy tant continué, I’en ay aſſommé & tué Tant qu’il s’en eſt bien aperceu.	J'ai ceci tant continué, J'en ai assommé et tué Tant qu'il s'en est bien aperçu.
Et quand il s’eſt trouué deceu, M’aiſt dieux il m’a fait eſpier:	Et quand il s'est trouvé déçu, M'ait dieux il m'a fait épier:
Car on les ouyt bien crier, Entendez vous, quand on le fait.	Car on les ouit bien crier, Entendez -vous, quand on le fait.
Or ay-ie eſté prins ſur le fait, le ne le puis iamais nier.	Or ai-je été prins sur le fait, le ne le puis jamais nier.
Si vous voudrois-ie bien prier Pour du mien (i’ay aſſez finance) Que nous deux luy baillõs l’auãce Ie ſçay bien qu’il a bonne cauſe:	Si vous voudrais-je bien prier Pour du mien (j'ai assez finance) Que nous deux lui bailleurs l'avance Je sais bien qu'il a bonne cause:
Mais vous y trouuerez bien clauſe, Si voulez, qu’il l’aura mauuaiſe.	Mais vous y trouverez bien clause, Si voulez, qu'il l'aura mauvaise.
Patelin.	Patelin.
Par ta loy, ſeras-tu bien ayſe?	Par ta loi, seras-tu bien aise?
Que donras-tu, ſi ie renuerſe Le droit de ta partie auerſe, Et ſi l’on t’enuoye abſoulz?	Que doncras-tu, si belle renverse Le droit de ta partie averse, Et si l'on t'envoie absoulés?
Le Berger.	Le Berger.
e ne vous paieray point en ſolz, ſais en bel or à la coronne,	Je ne vous paierai point en solz, sais en bel or à la coronne,
Patelin.	Patelin.
Doncq’auras-tu ta cauſe bonne:	Doncques auras-tu ta cause bonne:
Et fuſt elle la moytié pire.	Et fût -elle la moytié pire.
pire ſant mieux vault, & plus toſt l’emquand ie veux mon ſens apliquer, uie tu me orras bien deſcliquer uand il aura fait ſa demande.	pire sant mieux vault, et plu tôt l'emquand tu veux mon sens appliquer, tu me orras bien descliquer uand il aura fait sa demande.
E6.	E6.
Or vien çà ie te demande, Par le ſaint ſang bieu precieux, Tu es aſſez malicieux Pour entendré bien la cautelle.	Or vien çà ie te demande, Par le saint sang bieu cieux, Tu es assez malicieux Pour entendré bien la cautelle.
Comment eſt ce que l’on t’apelle?	Comment est ce que l'on t'appelle?
Le Berger.	Le Berger.
Par ſaint Mor, Thibaud l’Aignelet	Par saint Mor, Thibaud l'Aignelet
Patelin.	Patelin.
L’Aignelet?	L'Aignelet?
maint Aigneau de lait Tu as cabaſſé à ton maiſtre	maint Aigneau de lait Tu as cabassé à ton maître
Le Berger.	Le Berger.
Par mõ ſerment il peut bien eſtre, Que i’en ay mangé plus de trente En trois ans.	Par mon serment il peut bien être, Que j'en ai mangé plus de trente En trois ans.
Patelin.	Patelin.
Ce ſont dix de rente, Pour tes dez, & pour ta handelle.	Ce sont dix de rente, Pour tes dé, et pour ta handelle.
Ie croy que luy bailleray belle.	Je crois que Seigneur baîllerai belle.
Penſes-tu qu’il puiſſe trouueSur piedz ſes faitz par qui prouu C’eſt le chef de la plaiderie.	Penses-tu qu'il puisse trouveSur pieds ses faits par qui prenez C'est le chef de la plaiderie.
Le Berger.	Le Berger.
Prouuer, ſire, ſainte Marie!	Prouver, sire, sainte Marie!
Par tous les ſaintz de Paradis.	Par tous les saints de Paradis.
Pour vn il en trouuerra dix, Qui contre mõy depoſeront.	Pour un il en trouvera dix, Qui contre moni déposeront.
Patelin.	Patelin.
C’eſt vn cas qui biẽ fort deſrompt Ton fait, vecy que ie penſoye:	C'est un cas qui bien fort dérompt Ton fait, veci que je pensoie:
Ie ne faindray point que ie ſoye Des tiens, ne que ie teviſſe oncques	Je ne faindrai point que ainsi soie Des tiens, ne que Il tevisse oncques
Le Berger.	Le Berger.
Ne ferez!	Ne ferez!
dieux.	dieux.
Patelin.	Patelin.
Non rien quelconques:	Non rien quelconques:
Mais vecy qu’il y conuiendra.	Mais veci qu'il y conviendra.
Si tu parles on te prendra Coup à coup aux poſitions, Et en telz cas confeſſions Sont ſi treſpreiudiciables, Et nuyſent tãt, que ce ſont diables ource voicy qu’on te fera:	Si tu parles on te prendra Coup à coup aux positions, Et en tels cas confessions Sont si trespreiudiciables, Et naissent toujours, que ce sont diables ource voici qu'on te fera:
a toſt quand on t’apellera Pour comparoir en iugement, Tu ne reſponderas nullement, lors bée, pour rien que l’on te die.	a tôt quand on t'appelera Pour comparoir en jugement, Tu ne réponderas nullement, lors bée, pour rien que l'on te die.
Et s’il auient qu’on te maudie En diſant:	Et s'il avient qu'on te maudie En disant:
bé cornard puant, Dieu vous mette en mal an truan Vous moquez-vous de la iuſtice?	bé cornard puant, Dieu vous mette en mal an truan Vous moquez-vous de la justice?
Dy bée:	Dis bée:
ah, feray-ie, il eſt nice.	ah, ferai-je, il est nice.
Il cuyde parler à ſes beſtes:	Il cuide parler à ses bêtes:
Mais s’ilz deuoiẽt rõpre leurs teſts Qu’autre mot n’yſſe de ta bouche Garde t’en bien.	Mais s'ils dévoyaient rõpre leurs tests Qu'autre mot n'isse de ta bouche Garde t'en bien.
Le Berger.	Le Berger.
Le fait me touche, Ie m’en garderay vrayement, Et le feray bien proprement, Ie le vous prometz & afferme.	Le fait me touche, Je m'en garderai vraiment, Et le ferai bien proprement, Je le vous prometz et afferme.
Patelin.	Patelin.
Or t’y garde, tiens toy bien ferme A' moymeſme, pour quelque chol Que ie te die, ne propoſe, Si ne reſponds point autrement.	Or t'y garde, tiens toi bien ferme A' moymesme, pour quelque chol En ie te die, ne propose, Si ne réponds point autrement.
Le Berger.	Le Berger.
Moy?	Moi?
nenny par mon ſacrement, Dites hardiment que i’afole Se ie dy huy autre parole A' vous, ne à quelque autre perlonne (ſonne Pour quelque mot que l’on me Fors bée, que vous m’auez aprins.	nenni par mon sacrement, Dites hardiment que j'afole Se ie dis hui autre parole A' vous, ne à quelque autre perlonne (sonne Pour quelque mot que l'on me Fors bée, que vous m'avez apprins.
Patelin.	Patelin.
Par ſaint Iean ainſi ſera prins Ton auerſaire par la mouë, Mais auſſi fay que ie me louë, Quand ce ſera fait, de la paye.	Par saint Jean ainsi sera prins Ton aversaire par la moue, Mais aussi fais que ici me loue, Quand ce sera fait, de la paie.
Le Berger.	Le Berger.
Mon ſeigneur, ſi ie ne vous paye A' voſtre mot, ne me croyez hmais:	Mon seigneur, si belle ne vous paie A' H mot, ne me croyez hmais:
mais ie vous pry voyez Diligemment à ma beſongne.	mais ici vous pri voyez Diligemment à ma besongne.
Patelin.	Patelin.
Par noſtre Dame de Boulongne, Ie tiens que le Iuge eſt aſſis:	Par notre Dame de Boulongne, Je tiens que le Juge est assis:
Car il ſe ſiet touſiours à ſix Heures, ou illec enuiron Or vien apres moy, nous n’yron Nous deux enſemble pas en voye.	Car il se siète toujours à six Heures, ou illec environ Or vien après moi, nous n'iron Nous deux ensemble pas en voie.
Le Berger.	Le Berger.
C’eſt bien dit à fin qu’onne vy Que vous ſoyez mon Auocat.	C'est bien dit à fin qu'onne vis Que vous soyez mon Avocat.
Patelin.	Patelin.
Noſtre Dame, moquin moquat Si tu ne payes largement.	Notre Dame, moquin moquât Si tu ne payes largement.
Le Berger.	Le Berger.
Dieu!	Dieu!
à voſtre mot vrayement.	à votre mot vraiment.
Monſeigneur n’en faites nul dout	Monseigneur n'en faites nul dout
Patelin.	Patelin.
Hé dea, s’il ne pleut, il degoute.	Hé dea, s'il ne pleut, il dégoute.
Aumoins auray-ie vn eſpinoche, I’auray de luy, s’il chet en coche, Vn eſcu, ou deux pour ma peine.	Aumoins aurai-je un épinoche, J'aurai de parler, s'il chet en coche, Un écu, ou deux pour ma peine.
Sire, Dieu vous doint bõne étreint Et ce que voſtre cueur deſire.	Sire, Dieu vous doint bonne êtreint Et ce que votre cueur désire.
Le luge.	Le luge.
Vous ſoyez le bien venu, ſire, Or vous couurez, çà prenez place.	Vous soyez le bien venu, sire, Or vous couvrez, çà prenez place.
Patelin.	Patelin.
Dea ie ſuis bien, ſauf voſtre grace, Ie ſuis icy plus à deliure.	Dea été suis bien, sauf votre grâce, Je suis ici plus à délivre.
Le Iuge.	Le Juge.
S’il ya riens qu’on ſe deliure Tantoſt, à fin que ie me lieue.	S'il ya riens qu'on se délivre Tantôt, à fin que je me lieue.
Le Drapier.	Le Drapier.
Mon Auocat vient qui acheue Vn peu de choſe qu’il faiſoit, Monſeigneur, & s’il vous plaiſoit Vous feriez bien l’atendre.	Mon Avocat vient qui achève Un peu de chose qu'il faisait, Monseigneur, et s'il vous plaisait Vous feriez bien l'atendre.
Le Iuge.	Le Juge.
Hé dea, i’ay ailleurs à entendre, Si voſtre partie eſt preſente, Deliurez vous ſans plus d’atente.	Hé dea, j'ai ailleurs à entendre, Si votre partie est présente, Délivrez -vous sans plus d'atente.
Et n’eſtes vous pas demandeur?	Et n'êtes -vous pas demandeur?
Si ſuis.	Si suis.
Le Drapier.	Le Drapier.
Le luge.	Le luge.
Ou eſt le defendeur?	Ou est le défendeur?
Eſt il cy preſent en perſonne?	Est -il cy présent en personne?
Le Drapier.	Le Drapier.
Ouy, véez le là qui ne ſonne Mot, mais Dieu ſçait qu’il en pẽſe.	Oui, véez le là qui ne sonne Mot, mais Dieu sait qu'il en se.
Le luge.	Le luge.
Puis que vous eſtes en preſence Vous deux, faites voſtre demande.	Puis que vous êtes en présence Vous deux, faites votre demande.
Le Drapier.	Le Drapier.
Ioicy doncq' que ie luy demande, Monſeigneur, il eſt verité, Que pour Dieu, & en charité, Ie l’ay nouriy en ſon enfance:	Ioici donc' que ainsi ainsi demande, Monseigneur, il est vérité, Que pour Dieu, et en charité, Je l'ai nouri en son enfance:
Et quand ie vy qu’il eut puiſſance D’aller aux champs, pour abreg Ie le fis eſtre mon Berger, Et le mis à garder mes beſtes.	Et quand ici vi qu'il eut puissance D'aller aux champs, pour abrég Je le fis être mon Berger, Et le mis à garder mes bêtes.
Mais auſſi vray comme vous eſtes Là aſſis, monſeigneur le Iuge Il en a fait vn tel deluge De Brebiz, & de mes Moutons Que ſans faulte.	Mais aussi vrai comme vous êtes Là assis, monseigneur le Juge Il en a fait un tel déluge De Brebis, et de mes Moutons Que sans faute.
Le Iage.	Le Jage.
Or eſcoutons, Eſtoit il point voſtre aloué?	Or écoutons, Était -il point votre aloué?
Patelin.	Patelin.
Voire, car s’il s’eſtoit ioué A' le tenir ſans alouer.	Voire, car s'il s'était joué A le tenir sans alouer.
Le Drpiez Ie puiſſe Dieu deſauouer Si n’eſtes vous nulle faulte.	Le Drpiez -Je puisse Dieu désavouer Si n'êtes vous nulle faute.
Le Iage.	Le Jage.
Cõment vous tenez la mair Y vous mal aux dents, maiſtre Pierre.	Comment vous tenez la mair Y vous mal aux dents, maître Pierre.
Patelin.	Patelin.
Ouy, el’ me font telle guerre Qu’oncques mais ne ſenty tel' rage le n’oſe leuer le viſaige Pour Dieu faites les proceder.	Oui, elle me font telle guerre Qu'oncques mais ne senti tel rage le n'ose le le visaige Pour Dieu faites les procéder.
Le Iuge.	Le Juge.
Auant, acheuez de plaider, pus concluez apertement.	Avant, achevez de plaider, pus concluez apertement.
Le Drapier.	Le Drapier.
C’eſt il ſans autre vrayement, Par la croix ou Dieu s’eſtendy:	C'est il sans autre vraiment, Par la crois ou Dieu s'étendi:
L’eſt à vous à qui ie vendy ix aulnes de drap, maiſtre Pierre.	L'est à vous à qui ici vendi jx aunes de drap, maître Pierre.
Le Iuge.	Le Juge.
D’eſt ce qu’il dit de drap?	D'est ce qu'il dit de drap?
erre.	erre.
Patelin.	Patelin.
cuyde à ſon propos venir:	cuyde à son propos venir:
t il n’y ſçait plus auenir, ource qu’il ne l’a pas aprins.	t il n'y sait plus avenir, ource qu'il ne l'a pas apprins.
Le Drapier.	Le Drapier.
Pendu ſois, ſi autre l’a prins Mon drap, par la ſanglante gor	Pendu sois, si autre l'a prins Mon rap, par la sanglante gor
Patelin.	Patelin.
Comme le meſchaut homme fos De loing, pour fournir ſon libe Il veult dire, eſt il bien rebelle?	Comme le méchaut homme fos De loin, pour fournir son libe Il veult dire, est il bien rebelle?
Que ſon Berger auoit vendu La laine, ie l’ay entendu, Dont fut fait le drap de ma robe Comme s’il diſt qu’il le deſrobe, Et qu’il luy a emblé les laines De ſes Brebiz.	Que son Berger avait vendu La laine, je l'ai entendu, Dont fut fait le drap de ma robe Comme s'il dît qu'il le dérobe, Et qu'il lui a emblé les laines De ses Brebiz.
Le Drapier.	Le Drapier.
Male ſemaine M’enuoye Dieu, ſi vous ne l’auez	Male semaine M'envoie Dieu, si vous ne l'avez
Le Iuge.	Le Juge.
Paix, par le dyable, vous bauez:	Paix, par le diable, vous bavez:
Et ne ſçauez vous reuenir A’ voſtre propos, ſans tenir La court de telle baucrie?	Et ne savez -vous revenir A' vôtre propos, sans tenir La court de telle baucrie?
Patelin.	Patelin.
Ie ſens mal, & fault que ie rie, Il eſt deſia ſi empreſſé Qu’il ne ſçait ou il a laiſſé, Il fault que nous luy reboutons.	Je sens mal, et sault que sans rie, Il est déjà si empressé Qu'il ne sait ou il a laissé, Il sault que nous lui reboutons.
Le Iuge.	Le Juge.
Sus reuenons à ces Moutons:	Sus revenons à ces Moutons:
Reen iuen.	Reen juen.
Le Drapier.	Le Drapier.
Il en print ſix aulnes De neuf frans.	Il en prînt six aulnes De neuf fran.
Le Iuge.	Le Juge.
Sommes nous beiaunes?	Sommes nous beiaunes?
Du cornards?	Du cornards?
ou cuydezvous eſtre?	ou cuydezvous être?
Patelin.	Patelin.
Par le ſang bieu il nous fait paiſtre, Qu’eſt il bon homme par ſa mine, Mais ie vous pry', qu’on examine Vn bien peu ſa partie auerſe.	Par le sang bieu il nous fait paître, Qu'est il bon homme par sa mine, Mais ie vous pri', on examine Un bien peu sa partie averse.
Le luge.	Le luge.
Vous dites bien, il le conuerſe, Ine peult, qu’il ne le cognoiſſe:	Vous dites bien, il le converse, Ine peult, qu'il ne le connaisse:
lien çà dy.	lien çà dis.
bée Le Berger.	bée Le Berger.
Le Iuge.	Le Juge.
Voicy angoiſſe, Quel bée eſt ce cy, ſuis-ie Cheure Parle à moy.	Voici angoisse, Quel bée est ce cy, suis-je Cheure Parle à moi.
Bée.	Bée.
Le Berger.	Le Berger.
Le Iuge.	Le Juge.
Sanglante fieure Te doint Dieu, & te moques.	Sanglante fièvre Te doint Dieu, et te moques.
tu?	tu?
Patelin.	Patelin.
Croyez qu’il eſt fol, ou teſtu, Ou qu’il cuide étre entre ſes beſtes	Croyez qu'il est fol, ou têtu, Ou qu'il cuide être entre ses bêtes
Le Drapier.	Le Drapier.
Or regnie-ie bieu, ſi vous n’eſtes Celuy ſans autre qui auez Eu mon drap:	Or régnie-je bieu, si vous n'êtes Celui sans autre qui avez Eu mon drap:
ah vous ne ſçauez, Monſeigneur, par quelle malice.	ah vous ne savez, Monseigneur, par quelle malice.
Le Iuge.	Le Juge.
Et taiſez vous, eſtes vous nice?	Et taisez -vous, êtes -vous nice?
Laiſſez en paix ceſte aſſeſſoire, Et venons au principal.	Laissez en paix cette assessoire, Et venons au principal.
Voire, Le Drapier.	Voire, Le Drapier.
Mõſeigneur:	Monseigneur:
mais le cas me touche CAC	mais le cas me touche CAC
Toutesfois, par ma foy, ma bouche Meshuy vn ſeul mot n’en dira, Vne autresfois il en yra Ainſi qu’il en pourra aller.	Toutefois, par ma foi, ma bouche Meshui un seul mot n'en dira, Vaine autrefois il en y Ainsi qu'il en pourra aller.
Il le me conuient aualler Sans maſcher:	Il le me convient avaller Sans mâcher:
Or çà ie diſoye A' mon propos comment i’auoye Baillé ſix aulnes, doy-ie dire, Mes Brebiz, ie vous en prie, ſire, aruomez moy:	Or çà peine disoye A' mon propos comment j'avoie Baillé six aulnes, dois-je dire, Mes Brebis, je vous en prie, sire, arromez -moi:
ce gent il maiſtre Mon Berger quand il deuoit eſtre Aux champs, il me diſt que i’aurois six eſcus d’or quand ie viendrois.	ce gent il maître Mon Berger quand il devait être Aux champs, il me dît que j'aurais six écus d'or quand ici viendrais.
Dy-ie, depuis trois ans en ça, Mon Berger m’enconuenança Que loyaument me garderoit dles Brebiz, & ne m’y feroit, Ne dommaige ne vilenie:	Dis-je, depuis trois ans en ça, Mon Berger m'enconuenança Que loyaument me garderait dles Brebis, et ne m'y ferait, Ne dommaige ne vilenie:
Et puis maintenam il me nie Et drap, & argent plainement.	Et puis maintenam il me nie Et drap, et argent plainement.
lh, maiſtre Pierre, vrayement Ce ribauld cy m’embloit les laines.	lh, maître Pierre, vraiment Ce ribauld cy m'emblait les laines.
le mes beſtes, & toutes ſames Les faiſoit mourir & perir, Par les aſſommer & ferir De gros baſtons ſur la ceruelle.	le mes bêtes, et toutes sames Les faisait mourir et périr, Par les assommer et férir De gros bâtons sur la cervelle.
Quãd mõ drap fut ſouz ſon eſſelle Il ſe miſt au chemin grand erre, Et me diſt que ie allaſſe querre Six eſcus d’or en ſa maiſon.	Quand momme drap fut souz son esselle Il se mit au chemin grand erre, Et me dît que ici allasse querre Six écus d'or en sa maison.
Le Iuge.	Le Juge.
Il n’y a rime ne faiſon A' tout ce que vous rafardez.	Il n'y a rime ne saison A tout ce que vous fardez.
Qu’eſt cecy?	Qu'est ceci?
vous entrelardez Puis d’vn, puis d’autre, sõme toute Par le ſang bieu ien’y voy goute Il broüille du drap & babille, Puis de Brebiz au coup la quille:	vous entrelardez Puis d'une, puis d'autre, somme toute Par le sang bieu iency en goute Il brille du drap et babille, Puis de Brebis au coup la quille:
Choſe qu’il dit ne s’entretient.	Chose qu'il dit ne s'entretient.
Patelin.	Patelin.
Or ie m’en fais fort qu il retient Au pauure Berges ſon ſalaire.	Or ici m'en fais fort qu' il retient Au pauvre Berges son salaire.
Le Drapier.	Le Drapier.
Par Dieu vous en peuſſiez biẽ raire, Mon drap, auſſi vray que la meſſe, Ie ſçay mieux ou le basm’en bleſſe, Que vous, ne vn autre ne ſçauez:	Par Dieu vous en peussiez biẽ raire, Mon rap, aussi vrai que la messe, Je sais mieux ou le bâm'en blesse, Que vous, ne un autre ne savez:
Par la teſte bieu vous l’auez.	Par la tête bieu vous l'avez.
Le Inge.	Le Inge.
gencequna:	gencequa:
Le Drapier.	Le Drapier.
Par mon ſerment c’eſt le grigneur Trompeur:	Par mon serment c'est le igneur Trompeur:
holà ie m’en tairay, Si ie puis, & n’en parleray Meinuſ puuuuumlt u’il auienne.	holà assez m'en tairai, Si tu puis, et n'en parlerai Meinus puuuuumlt il auienne.
Le Iuge.	Le Juge.
Et nõ, mais qu’il vous en ſouuienne Or concluez apertement.	Et notre. mais qu'il vous en souvienne Or concluez apertement.
Patelin.	Patelin.
Ce Berger ne peult nullement Reſpõdre aux faitz que l’õ propoſe S’il n’a du conſeil, & il n’oſe, Ou il ne ſçait, en demander:	Ce Berger ne peult nullement Respendre aux faits que l'on propose S'il n'a du conseil, et il n'ose, Ou il ne sait, en demander:
S’il vous plaiſoit moy commander Que ie fuſſe à luy ie y ſeroye.	S'il vous plaisait moi commander Que tu fusse à Ma ie y seroie.
Le Iuge.	Le Juge.
Auecques luy ie cuyderoye Que ce fuſt treſtoute froydure:	Avec ici ce cuyderoye Que ce fût trestoute froidure:
C’eſt peu d’aqueſt.	C'est peu d'aquêt.
Pateliu.	Pateliv.
Moy?	Moi?
ie vous iure Qu’auſſi n’en veux-ie rien auoir Pour Dieu ſoit:	Hé vous jure Qu'aussi n'en veux-je rien avoir Pour Dieu soit:
Or ie vois ſçanoir Au pauuret qu’il me voudra dire, Et s’il me ſçaura point inſtruire Pour reſpondre aux faitz de partie Il auroit dure departie De ce qui ne le ſecourroit, Vien ça mon amy, qui pourroit Trouuer, entens.	Or ici vois sçanoir Au pauvret qu'il me voudrait dire, Et s'il me saura point instruire Pour répondre aux faits de partie Il aurait dure départie De ce qui ne le secourrait, Viens ça mon ami, qui pourrait Trouver, entends.
Bée.	Bée.
Le Berger.	Le Berger.
Patelis.	Patelis.
Quel bée?	Quel bée?
dea:	dea:
Par le ſaint ſang que Dieu crea, Es-tu fol?	Par le saint sang que Dieu créa, Es-tu fol?
dy moy tou affaire.	dis -moi tou affaire.
Bée.	Bée.
Le Berger.	Le Berger.
Patelin.	Patelin.
Quel bée, oys-tu tes brebis braire?	Quel bée, ois-tu tes brebis braire?
C’eſt pour ton prouffit entends y.	C'est pour ton profit entends y.
bée.	bée.
Le Berger.	Le Berger.
Patelin.	Patelin.
Et dy ouy, ou nenuy:	Et dis oui, ou nenvi:
C'eſt bien ſait, dy touſiours, feras?	C'est bien sait, dis toujours, feras?
nec.	nec.
Le Berger.	Le Berger.
Patelin.	Patelin.
Plus hault, ou t’en trouuerras En grãds deſpens, & ie m’en doute.	Plus hauts, ou t'en trouverras En grands dépens, et notre m'en doute.
Dée.	Dée.
Le Berger.	Le Berger.
Patelin.	Patelin.
Dr eſt il bien plus fol qui boute el fol naturel en proces.	Dr est il bien plus fol qui boute elle fol naturel en procès.
h, ſire, renuoyez le à ſes ebiz, il eſt fol de nature.	h, sire, renvoyez le à ses ébiz, il est fol de nature.
Le Drapier.	Le Drapier.
ſt il fol?	st -il fol?
ſaint Sauueur d’Eſture?	saint Sauveur d'Éture?
eſt plus ſaige que vous n’eſtes.	est plus saise que vous n'êtes.
Patelin.	Patelin.
ioyez le garder ſes beſtes s iour, que iamais ne retourne.	joyez le garder ses bêtes s our, que jamais ne retourne.
ie maudit ſoit il qui aiourne Telz folz ou a fait aiourner.	ie maudit soit il qui aiourne Tels folés ou a fait aiourner.
Le Drapier.	Le Drapier.
Et l’en fera l’on retourner Auant que ie puiſſe eſtre ouy?	Et l'en fera l'on retourner Avant que tu puisse être oui?
Le Iuge.	Le Juge.
M’aiſt Dieu, puis qu’il eſt fol, ouy Pourquoy ne fera?	M'ait Dieu, puis qu'il est fol, oui Pourquoi ne fera?
Le Drapier.	Le Drapier.
Hé dea, ſire, Au moins laiſſez moy auant dire Et faire mes concluſions:	Hé dea, sire, Au moins laissez -moi avant dire Et faire mes conclusions:
Ce ne ſont pas abuſions ne ie vous dy, ne moqueries.	Ce ne sont pas abusions ne ie vous dis, ne moqueries.
Le Iuge.	Le Juge.
Ce ſont toutes tribouilleries e de plaider à folz ne à foles, Eſcoutez, à moins de paroles La court n’en ſera plus tenue.	Ce sont toutes tribouilleries eu de plaider à folés ne à soles, Écoutez, à moins de paroles La court n'en sera plus tenue.
Le Drapier.	Le Drapier.
S’en yront ilz ſans retenue De plus reuenir?	S'en iront -ils sans retenue De plus revenir?
Le Iuge.	Le Juge.
Et quoy doncques?	Et quoi donc?
Patelin.	Patelin.
teuenir?	tenir?
vous ne viſtes oncques Plusfol, n’en faites neant reſponſe:	vous ne vîtes onc Plusfol, n'en faites néant réponse:
Et ſi ne vault pas mieux vne once L’autre:	Et si ne vault pas mieux une once L'autre:
deux folz sõt ſans ceruelle Par ſainte Marie la belle Eulx deux n’en ont pas vn quarat.	deux folz sont sans cervelle Par sainte Marie la belle Eulx deux n'en ont pas un quarat.
Le Drapier.	Le Drapier.
Vous l’emportaſtes par barat (re, Mon drap, ſans payer, maiſtre PierPar la chair bieu, moy las pecherre!	Vous l'emportâtes par barat (re, Mon drap, sans payer, maître PierPar la chair bieu, moi las pécherre!
Ce ne fut pas fais de preud’hõme.	Ce ne fut pas fais de prud'homme.
Patelin.	Patelin.
e reny ſaint Pierre de Romme il n’eſt fin fol, ou il affole.	E ren saint Pierre de Romme il n'est fin fol, ou il affole.
Le Drapier.	Le Drapier.
e vous cognois à la parole et à la robe, & au viſaige e ne ſuis pas fol, ie ſuis ſaige, our cognoiſtre qui bien me fait vous conteray tout le fait, onſeigneur, par ma conſcience.	Je vous connais à la parole et à la robe, et au visaige e ne suis pas fol, votre suis saisge, our connaître qui bien me fait vous conterai tout le fait, onseigneur, par ma conscience.
Patelin.	Patelin.
Hée, ſire, impoſez luy ſilence, N’auons honte de tant debatre A' ce berger pour trois ou qua Vieilz Brebiailles, ou Moutons Qui ne valent pas deux boutont Il en fait plus grand Kirielle,	Hée, sire, imposez même silence, N'avons honte de tant débattre A' ce berger pour trois ou qua Vieils Brebiailles, ou Moutons Qui ne valent pas deux bout Il en fait plus grand Irielle,
4 Le Drapier.	4 Le Drapier.
Quelz moutons?	Quels moutons?
c’eſt vne vielle C’eſt à vous meſme que ie parle A' vous, & le me rendrez par le Dieu qui au beau Noël fut né	c'est une vielle C'est à vous -même que sans parle À vous, et le me rendrez par le Dieu qui au beau Noèle fut né
Le Iuge.	Le Juge.
Véez-vous, ſuis-ie bien aſſene?	Véez-vous, suis-je bien assène?
Il ne ceſſera huy de braire.	Il ne cessera hui de braire.
Le Drapier.	Le Drapier.
Ie luy demande.	Je te demande.
Patelin.	Patelin.
Faites le taire:	Faites le taire:
Et par Dieu c’eſt trop ſlageolé, Prenons qu’il en ayt affolé Six, ou ſept, ou vne douzaine:	Et par Dieu c'est trop slageolé, Prenons qu'il en ait affolé Six, ou sept, ou une douzaine:
Et mengez en ſanglante eſtiVous en eſtes bien mehaigné.	Et mengez en sanglante estiVous en êtes bien mehaigné.
Vous auez plus que tant gaigné Au temps qu’il les vous a gatdez.	Vous avez plus que tant gagné Au temps qu'il les vous a gatdez.
Le Drapier.	Le Drapier.
Regardez, ſire, regardez, le luy parle de draperie, Et il reſpond de bergerie:	Regardez, sire, regardez, le lui parle de draperie, Et il répond de bergerie:
Six aulnes de drap, ou ſont elles?	Six aunes de drap, ou sont elles?
Que vous miſtes ſouz voz eſſelles, renler touspomieneles me rédre?	Que vous mîtes souz v esselles, renler touspomieneles me rédre?
Patelim Ah!	Patelim Ah!
ſire, le ferez-vous pendre Pour ſix ou ſept beſtes à laine?	sire, le ferez-vous pendre Pour six ou sept bêtes à laine?
Au moins reprenez voſtre aleine:	Au moins reprenez votre alène:
Ne ſoyez pas ſi rigoureux, Au pauure Berger douloureux, Qui eſt auſſi nu comme vn ver.	Ne soyez pas si rigoureux, Au pauvre Berger douloureux, Qui est aussi nu comme un ver.
Le Drapier.	Le Drapier.
Ceſt tresbien retourner le ver, Le diable me fiſt bien vendeur De drap à vn tel entendeur, Dea, monſeigneur, ie luy demande.	Cest tresbien retourner le ver, Le diable me fît bien vendeur De drap à un tel entendeur, Dea, monseigneur, ie luy demande.
Le Iuge K ij.	Le Juge .
Ie l’abſoulz de voſtre demande Et vous defends le proceder C’eſt vn bel honneur de plaider A' vn fol, va dire à tes beſtes.	Je l'absoulés de votre demande Et vous défends le procéder C'est un bel honneur de plaider A' fol, va dire à tes bêtes.
Bée.	Bée.
Le Berger.	Le Berger.
Le luge.	Le luge.
Vous monſtrez qui vous eſtes, Sire, par le ſang noſtre Dame,	Vous montrez qui vous êtes, Sire, par le sang notre Dame,
Le Drapier.	Le Drapier.
Hé dea, mõſeigneur, bõ gré m’ame Ie luy vueil.	Hé dea, mõseigneur, bo gré m'âme Je lui veuveil.
Patelin.	Patelin.
Se pourroit il taire?	Se pourrait -il taire?
Le Drapier.	Le Drapier.
Et c'eſt à vous que i’ay à faire.	Et c'est à vous que j'ai à faire.
Vous m’auez trompé faulſement, Et emporté furtiuement (ge.	Vous m'avez trompé faulsement, Et emporté furtivement (ge.
Mon drap, par voſtre beau langar	Mon drap, par votre beau langar
Patelin.	Patelin.
Or i’en apelle en mon courage, Et vous l’oyez bien, monſeigneur	Or j'en apelle en mon courage, Et vous l'oyez bien, monseigneur
Le Drapier.	Le Drapier.
M'aiſtdieu vous eſtes le grigneur Trompeur, mõſeigneur, que ie die	M'aistdieu vous êtes le grigneur Trompeur, mõseigneur, que je die
Le Iuge.	Le Juge.
C’eſt vne droite cornardie (ſe Que de vous deux, ce n’eſt que noiIl’aiſtdieu ie l’oy, que ie m’envoiſe Va t’en mon amy, ne retourne lmais pour Sergent qui t’aiourne, La court t’abſoult, entens-tu bien?	C'est une droite cornardie (se Que de vous deux, ce n'est que noiIl'ait donc l'ois, que sans m'envoise Va t'en mon ami, ne retourne lmais pour Sergent qui t'aiourne, La court t'absoult, entends-tu bien?
Dy, grand mercy.	Dis, grand merci.
ée.	ée.
Le Perger.	Le Perger.
Le luge.	Le luge.
Dy-ie bien?	Dis-je bien?
*.	*.
la t’en, ne te chault, autant vaille,	la t'en, ne te chault, autant vaille,
Le Drapier.	Le Drapier.
lis eſt ce raiſon qu’il s’en aille nſi?	lis est ce raison qu'il s'en aille nési?
Le Iage.	Le Jage.
iy, i’æy à faire ailleurs,  ous eſtes par trop grãds railleurs us ne m’y ferez plus tenir, Ie m’en vois:	ji, j'æi à faire ailleurs, ous êtes par trop grands railleurs us ne m'y ferez plus tenir, Je m'en vois:
voulez vous venir Souper auecq' moy?	voulez -vous venir Souper auecq'ours?
maiſtre Pies	maître Pies
Ie ne puis.	Je ne puis.
Patelis.	Patelis.
Le Drapier.	Le Drapier.
Ah qu’es tu fort lierre!	Ah qu'es tu fort lierre!
Dites, ſeray-ie point payé?	Dites, serai-je point payé?
Patelin.	Patelin.
Dequoy?	Dequoy?
eſtes-vous deſuoyé?	êtes-vous dévoyé?
Mais qui cuidez vous que ie ſoys?	Mais qui cuidez -vous que ici sois?
Par le ſang de moy ie penſois Pour qui c’eſt que vous me prenez	Par le sang de moi venir pensais Pour qui c'est que vous me prenez
Bée dea.	Bée dea.
Le Drapier.	Le Drapier.
Patelin.	Patelin.
Beau fire, or vous tenez, Ie vous diray ſans plus atendre Pour qui vous me cuidriez prẽdre, Eſt ce point pour Eceruellé?	Beau sire, or vous tenez, Je vous dirai sans plus atendre Pour qui vous me cuidriez prendre, Est ce point pour Écervelé?
Voy, nenny, il n’eſt point pelé Comme ie fuis deſſus la teſte.	Vois, nenni, il n'est point pelé Comme ici fuis dessus la tête.
111 Le Drapier.	111 Le Drapier.
Me voulez vous tenir pour beſte C’eſtes vous en propre perſonne:	Me voulez -vous tenir pour bête C'êtes -vous en propre personne:
Vous, de vous, voſtre voix le ſonne Et ne le croyez autrement.	Vous, de vous, votre voix le son Et ne le croyez autrement.
Patelin.	Patelin.
Moy de moy:	Moi de moi:
non ſuis vrayement.	non suis vraiment.
Oltez en vontfe opinion:	Oltez en vontée opinion:
Seroit ce point lean de Noyon?	Serait ce point léan de Noyon?
Il me reſſemble de corſaige.	Il me ressemble de corsaige.
Le Drapier.	Le Drapier.
Hé dea, il n’a pas le viſaige Ainſi potatif, ne ſi fade Ne vous laiſſé-ie pas malade, Or ains dedans voſtre maiſon?	Hé dea, il n'a pas le visaige Ainsi potatif, ne si fade Ne vous laissé-je pas malade, Or ains dedans votre maison?
Patelin.	Patelin.
Ah!	Ah!
que vecy bonne raiſon.	que veci bonne raison.
Mlalade?	Mlalade?
& quelle maladie?	et quelle maladie?
Confeſſez voſtre cornardie daintenant elle eſt bien clere.	Confessez votre cornardie daintenant elle est bien clère.
Le Drapier.	Le Drapier.
C’eſt vous, ie renie ſaint Pere:	C'est vous, Seigneur renie saint Père:
ous ſans autre, ie le ſçay bien aur tout vray.	ous sans autre, Seigneur le sais bien aur tout vrai.
PatelinOr n’en croyez rien Car certes ce ne ſuis-je myeDe vous oncq’aulnne ne demye Ne prins, ie n’ay pas le los tel.	PatelinOr n'en croyez rien Car certes ce ne suis-je myeDe vous oncques aunne ne demie Ne prins, ie n'ai pas le los tel.
Le Drapier.	Le Drapier.
Ah!	Ah!
ie vois voir en voſtre hoſtel Par le ſang bieu ſi vous y eſtes.	Ne vois voir en votre hôtel Par le sang bieu si vous y êtes.
Nous n’en debatrõs plus noz teſte Icy, ſi ie vous trouue là	Nous n'en debatrõs plus nolés tête Ici, si je vous trouve là
Bée.	Bée.
Pateliu.	Pateliv.
Vien ça, vien, Ta beſongne eſt elle bien faire?	Viens ça, viens, Ta besongne est -elle bien faire?
Bée.	Bée.
Le Berger.	Le Berger.
Patt lin.	Pat lin.
Ta partie eſt retraite Ne dy plus bée, il n’y a force Luy ay-ie baillé belle eſtorſe?	Ta partie est retraite Ne dis plus bée, il n'y a force Lui ai-je baillé belle étorse?
T’ay ie point conſeillé à poinct?	T'ai assez point conseillé à point?
Le Berger	Le Berger
Dec.	Dec.
Patelin.	Patelin.
dé dea on ne t’orra point:	 dea on ne t'orra point:
Parle hardiment, ne te chaille.	Parle hardiment, ne te chaille.
Bée.	Bée.
Le Berger.	Le Berger.
Patelin.	Patelin.
eſt ia temps que ie m’en aille Jameji Le Berger.	est ja temps que personne m'en aille Jamèj à Berger.
Dée.	Dée.
Patelin.	Patelin.
A dire voir Iu as tresbien fait ton deuoir Et auſſi bonne contenance.	À dire voir Ju as trèsbien fait ton devoir Et aussi bonne contenance.
Le qui luy a baillé l’auance L'eſt que tu t’es tenu de rite.	Le qui lui a baillé l'avance L'est que tu t'es tenu de rite.
ée.	ée.
Le Berger.	Le Berger.
Pateliu.	Pateliv.
Del bée, il ne le fault plus dire, aye moy bien & doucement.	Del bée, il ne le sault plus dire, aie moi bien et doucement.
e.	e.
Patelin.	Patelin.
uel bée, or parle ſaigefuent me paye ſi m’en iray.	Elle bée, or parle saisefuent me paye si m'en irai.
Le Berger.	Le Berger.
Patelin.	Patelin.
Sçais-tu que ie te diray?	Sais-tu que Seigneur te dirai?
Ie te pry', ſans plus m’abayer, Que tu penſes de me payer Ie ne vueil plus de bauerie Paye moy.	Je te pri', sans plus m'abayer, Que tu penses de me payer Je ne veuil plus de baverie Paye moi.
Bée.	Bée.
Le Berger.	Le Berger.
Eſt ce moquerie?	Est ce moquerie?
Patelin.	Patelin.
Eſt ce ce que tu en ſeras?	Est -ce ce que tu en seras?
Par mon ſerment tu me payeras Entens-tu, ſi tu ne t’en voles, Cà argent.	Par mon serment tu me payeras Entends-tu, si tu ne t'en voles, Cà argent.
Bée.	Bée.
Tu te rigoles, Le Berger.	Tu te rigoles, Le Berger.
Patelin.	Patelin.
Cõment n’en auray-ie autre cho	Comment n'en aurai-je autre cho
Bée.	Bée.
Le Berger.	Le Berger.
Patelin.	Patelin.
Quoy?	Quoi?
tu fais le rimeur en pro Et à qui vends-tu tes coquilles?	tu fais le rimeur en pro Et à qui vends-tu tes coquilles?
Sçais-tu qu’il eſt, ne me babilles Meshuy de ton bée:	Sais-tu qu'il est, ne me babilles Meshui de ton bée:
& me paye	et me paie
Bée.	Bée.
Le Benger.	Le Bénéger.
Patelin.	Patelin.
N’en auray-ie autre monnoye:	N'en aurai-ie autre monnoie:
A' qui te cuydes tu iouer?	À' qui te cuides tu jouer?
Et le ine deuois tant louer De toy?	Et le ine devais tant louer De toi?
Or fay que ie m’en loue,	Or fais que personne m'en loue,
Le Berger.	Le Berger.
Bée.	Bée.
Patelin.	Patelin.
Me fais tu cy menger de l’oue?	Me fais tu cy menger de l'oue?
Maugré bieu ay-ie tant veſcu, Qu’vn Berger, vn Mouton veſtu Vn vilain paillard me rigole?	Maugré bieu ai-je tant vécu, Qu'un Berger, un Mouton vêtu Vn vilain paillard me rigole?
Bée.	Bée.
Le Berger.	Le Berger.
Patelin.	Patelin.
N’en auray-ie autre parole?	N'en aurai-je autre parole?
Si tu le fais pour toy esbatre, Dy le, ne m’en fais plus debatre, Vien t’en ſouper a ma maiſon.	Si tu le fais pour toi ébattre, Dis le, ne m'en fais plus débattre, Viens t'en souper à ma maison.
Bée.	Bée.
Le Berger.	Le Berger.
Patelin.	Patelin.
Par ſaint Iean tu as bien raiſon, Les Oysõs mainẽt les Oyes paiſtre Or cuidois eſtre ſur tous maiſtre Des trompeurs d’icy & d’ailleurs, Des fors coureurs, & des bailleurs De paroles en payement A' rendre au iour du iugement:	Par saint Jean tu as bien raison, Les Oysõs mainment les Oyes paître Or cuidais être sur tous maître Des trompeurs d'ici et d'ailleurs, Des fors coureurs, et des bailleurs De paroles en paiement A rendre au jour du jugement:
Et vn Berger des champs me pa Par ſaint laques, ſi ie trouuaſſe Vn Sergent, ie te fiſſe prendre.	Et un Berger des champs me pa Par saint laques, si tu trouvasse Un Sergent, Seigneur te fisse prendre.
Bée.	Bée.
Le Berger.	Le Berger.
Patelin.	Patelin.
Quel bée!	Quel bée!
l’on me puiſſe pendre, Si ie ne vois faire venir Vn bon Sergent:	l'on me puisse pendre, Si ici ne vois faire venir Un bon Sergent:
meſauenir Luy puiſſe il, s’il ne t’empriſonne	mesauenir Lui puisse il, s'il ne t'emprisonne
Le Berger.	Le Berger.
S’il me trouue ie luy pardonne.	S'il me trouve a luy pardonne.
A' rendre au iour du iugement:	A' rendre au jour du jugement:
Et vn Berger des champs me pa Par ſaint laques, ſi ie trouuaſſe Vn Sergent, ie te fiſſe prendre.	Et un Berger des champs me pa Par saint laques, si tu trouvasse Un Sergent, Seigneur te fisse prendre.
Bée.	Bée.
Le Berger.	Le Berger.
Patelin.	Patelin.
Quel bée!	Quel bée!
l’on me puiſſe pendre, Si ie ne vois faire venir Vn bon Sergent:	l'on me puisse pendre, Si ici ne vois faire venir Un bon Sergent:
meſauenir Luy puiſſe il, s’il ne t’empriſonne	mesauenir Lui puisse il, s'il ne t'emprisonne
Le Berger.	Le Berger.
S’il me trouue ie luy pardonne.	S'il me trouve a luy pardonne.
