Chez ANTHOINE DE SOMMAVILLE, Palais dans la Gallerie des Merciers à l’Eſcu de France	Chez ANTHOINE DE SOMAVILLE, Palais dans la Gallerie des Merciers à l'Écu de France
A ERDEVSEE LC MONSTEVE I LE COMTE DE VLDARXAXEVE MARESCHAL DES CAMPS ET ARME'ES DV ROY.	À ERDEUSE LC MONSTEUE I TE COMTE DE VLDARXAXEUE MARÉCHAL DES CAMPS ET ARMEES DU ROY.
AIJSIAD.	ÀISIAD.
nommée fait de voſtre Nom, & que ie n’appriſſe de quelbras vous ſeruez le Roy, & de quelle ſorte vous traictés ſes ennemys;	nommée fait de votre Nom, et que je n'apprisse de quelbras vous servez le Roi, et de quelle sorte vous traitez ses ennemis;
Ce n’eſt pas vne gloire particuliere à noſtre ſiecle, que d’auoir porté de grands hommes, il s’eſt veu de tout temps des perſonnes qui ſe ſont renduës celebres parleur courage, & par leur vertu;	Ce n'est pas une gloire particulière à notre siècle, que d'avoir porté de grands hommes, il s'est vu de tout temps des personnes qui se sont rendues célèbres parleur courage, et par leur vertu;
mais il faut auoüer, Monſieur, qu’il ne s’en eſt point treuué à qui vne ſi haute valeur, & vne ſi iuſte reputation que la voſtre, ayent ſi peu couſté qu'à vous & qu’il falloit autrefois plus de temps à la bonne naiſſance, & à l’exercice des armes, pour faire des Ceſars & des Alexandres.	mais il faut auoüer, Monsieur, qu'il ne s'en est point trouvé à qui une si haute valeur, et une si juste réputation que la vôtre, aient si peu côté qu'à vous et qu'il fallait autrefois plus de temps à la bonne naissance, et à l'exercice des armes, pour faire des Césars et des Alexandres.
Mais voſtre Hiſtoire eſt trop cogneuë, & trop de la ſaiſon, pour me meſler de l’écrire, & ie ſerois plus long-temps à parler de vos progrez que vous n’auez eſté a les faire:	Mais votre Histoire est trop connue, et trop de la saison, pour me mêler de l'écrire, et été serais plus longtemps à parler de vos progrès que vous n'avez été a les faire:
C’eſt vne matiere trop delicate pour mon eſprit, & vne tâche dont ie prendray ma diſpenſe de ma foibleſſe:	C'est une matière trop délicate pour mon esprit, et une tâche dont personne prendrai ma dispense de ma faiblesse:
Souſfrés ſeulement, Monſieur, que ie ſois vn des premiers de ma profeſſion qui rende ſes deuoirs à voſtre merite, & que ce témoignage m’en ſoit vn, de l’intereſt que ie prends dans le ſuccés des armes du Roy.	Sousfrez seulement, Monsieur, que je sois un des premiers de ma profession qui rende ses devoirs à votre mérite, et que ce témoignage m'en soit un, de l'intérêt que ainsi prends dans le succès des armes du Roi.
Comme ie ſuis vn de ſes plus paſſionnez ſujets;	Comme ici suis un de ses plus passionnez sujets;
ſa gloire & ſon contentement, ſont auſſi la plus forte de mes paſſions, tandis que vous aydés à luy acquerir l’vne, ie m’eſtudie à luy cauſer l’autre, durant que vous le ſerués, ie le diuertis, & ie faits voir à ſa Majeſté leſiege de Thebes, cepẽdant que vous trauaillés à celuy de Brizac, C’eſt à dire que ie luy mon---- » ſtre en figure ce que vous faites en verité, Auſſi (Monſieur) quand i’ay voulu chercher de la recommendation, & de la protection à ce Poëme, j’ay d’abord jetté les yeux ſur vous, & j’ay creuqu’ayant tant répandu deſang en Allemagne, vous prendriés plaiſir à voir celuy que j’ay fait verſerſur le Theatre de Sainct Germain.	sa gloire et son contentement, sont aussi la plus forte de mes passions, tandis que vous aidez à son acquérir l'une, je m'étudie à lui causer l'autre, durant que vous le servez, je le divertis, et ainsi faits voir à sa Majesté lesiege de Thébes, cepẽdant que vous travaillez à celui de Bris, C'est à dire que mille hommes mon- » stre en figure ce que vous faites en vérité, Aussi (Monsieur) quand j'ai voulu chercher de la recommendation, et de la protection à ce Poème, j'a yabord jeté les yeux sur vous, et j'ai jusqu'a tant répandu desang en Allemagne, vous y la voir celui que 'a fait versersur le Ta de Sainct Germain.
C’eſt vne guerre qui n’eſt point funeſte, & qui vous delaſſera de l’autre, i’eſpere que vous me ferés l’honneur d’agreer ce mauuais preſent, & qu’il m’ob tiendra de vous la permiſſionde me dire, ---- C.	C'est assez guerre qui n'est point funeste, et qui vous délassera de l'autre, j'espère que vous me ferez l'honneur d'agréer ce mauvais présent, et qu'il m'ob tiendra de vous la permissionde me dire, -- Ç.
MONSIEVR;	MONSIEUR;
Voſtre tres-humble & tres-obeïſſant ſeruiteur,	Votre très-humble et très-obeïssant serviteur,
ROTROV.	ROTROU.
IICEEVRO IOCASTE, ÆTEOCLE, POLTACE, mere d’Antigone.	IICEURO IOCASTE, TTEOCLE, POLTACE, mère d'Antigone.
Roy de Thebes, & frere d’Antigone.	Roi de Thebes, et frère d'Antigone.
frere d’Antigone.	frère d'Antigone.
ANTIGONE,	ANTIGONE,
ISMENE,	ISMENE,
ARGIE,	ARGIE,
ADRASTE,	ADRASTE,
MENETTE,	MENTTE,
CREON,	CREON,
HEMON,	HÉMON,
CHEFS DES, GRECS.	CHEFS DES, GRECS.
Sucur d'hatigone.	Sucur d'hatigone.
Beaupere de Polynice.	Beaupère de Polynice.
Femme de Polynice.	Femme de Polynice.
Gentil-homme d’Argie.	Gentilhomme d'Argie.
Pere d’Hemon, & Roy de Thebes.	Père d'Hémon, et Roi de Thebes.
	
Seruiteur d’Antigone.	Serviteur d'Antigone.
Seigneur de Thebes,	Seigneur de Thebes,
AN 1 Mee.	AN 1 Mee.
I LANRCEIIE 2	I LANRCEIIE 2
A I SCENE PREMIERE 4 IOCASTE, ISMENE, IOCASTE, dans vne chambre acheuant de s’habiller ILS ont bien à propos vſé de mon ſommeil!	À I SCÈNE PREMIÈRE 4 JOCASTE, ISMENE, JOCASTE, dans une chambre achevant de s'habiller ILS ont bien à propos usé de mon sommeil!
Ils n'ont pas appellé ma voix à leur conſeil;	Ils n'ont pas appelé ma voix à leur conseil;
Et lors qu’ils ont voulu tenter cette ſortie, On a bienſçeu garder que i’en fuſſe aduertie:	Et lors qu'ils ont voulu tenter cette sortie, On a biensçeu garder que j'en fusse avertie:
C’eſt bien, ô nuit, c’eſt bien de tes plus noirs pauots, Que tu m’as diſtilé ce funeſte repos:	C'est bien, ô nuit, c'est bien de tes plus noirs pauots, Que tu m'as distilé ce funeste repos:
Mais quel Chef les conduit?	Mais quel Chef les conduit?
ISMENE.	ISMENE.
Eteocle, luy-meſme,	Éteocle, Seigneur-même,
IOCASTE.	JOCASTE.
Allons tost, c’eſt trop d’ordre, en ce deſordre extréme:	Allons tôt, c'est trop d'ordre, en ce désordre extrême:
Ce poil mal ordonné, cette confuſion, Me ſerabien ſeante en cette occaſion;	Ce poil mal ordonné, cette confusion, Me serabien séante en cette occasion;
Nature, confonds-les, c’eſt icy ton office, Tout deſpend de toy ſeule, & rien de l’artifice:	Nature, confonds-les, c'est ici ton office, Tout dépend de toi seule, et rien de l'artifice:
Vient te montrer, monſein, qui les as allaiteZ Auancez-vous, mes bras, qui les auez portez:	Vient te montrer, monsein, qui les as allaitez Avancés-vous, mes bras, qui les avez portez:
Toy, flanc inceſtueux, dontils ont pris naiſſance, Vien, s’ils ont du reſpect, faire voir ta puiſſance.	Toi, flanc incestueux, dontils ont pris naissance, Viens, s'ils ont du respect, faire voir ta puissance.
DSLNE II ANTIGONE, IOCASTE, ISMENE.	DSLNE II ANTIGONE, JOCASTE, ISMENE.
ANTIGONE.	ANTIGONE.
ADAME, il n’eſt plus temps:	ADAME, il n'est plus temps:
IOCASTE.	JOCASTE.
Comment, ces enragez, Giſent-ils deſia morts, l’vn par l’autre égorge!	Comment, ces enragés, Gisent-ils déjà morts, l'un par l'autre égorge!
Ou la troupe Thebaine a-t’elle eſté défaite?	Où la troupe Thaine a-t-elle été défaite?
ANTIGONE.	ANTIGONE.
Non, mais le combat ceſſe, & le Roy fait retraite.	Non, mais le combat cesse, et le Roi fait retraite.
C’eſt ce que de la tour, i'ay clairement pù voir, Et ſonretour dans peu vous le fera ſçauoir.	C'est ce que de la tour, j'ai clairement pù voir, Et sonretour dans peu vous le fera sçauoir.
C.	Ç.
3	3
IOCASTE.	JOCASTE.
Ce cœur dénaturé, teint du ſang de ſon frere, Se vient-il rafraichir dans les bras de ſa mere?	Ce cœur dénaturé, teint du sang de son frère, Se vient-il rafraîchir dans les bras de sa mère?
	
A ij S’y vient-ilréjoüir de cét acte inhumain?	À ij 'y vient-ilréjoüir de cet acte inhumain?
Et ne pretend-il point des lauriers de ma main?	Et ne prétend-il point des lauriers de ma main?
Oüy, le coup en merite, il part d’vn grand courage, Ils eſt ſouſtrait d'adreſſe, & pour vn bel ouurage,	Oui, le coup en mérite, il part d'un grand courage, Ils est soustrait d'adresse, et pour un bel ouvrage,
ISMENE.	ISMENE.
Peut-eſtre que le Ciel qui preſide aux combats En diſpoſera mieux que vous n'eſperez, pas.	Peut-être que le Ciel qui préside aux combats En disposera mieux que vous n'espérez, pas.
ANTIGONE.	ANTIGONE.
Vn inſtant a ſouuent changé l’ordre des choſes, Beaucoup d’euenemens ont demanti leurs cauſes:	Un instant a souvent changé l'ordre des choses, Beaucoup d'événements ont demanti leurs causes:
Mais attendant l’entree, & l’entretien du Roy, Oyez un accident qui me tranſit d’effroy;	Mais attendant l'entre, et l'entretien du Roi, Oyez un accident qui me transit d'effroi;
Ie voyois de la tour le choc des deux armees, L’vne & l’autre au combat aſprement animees, Alors que Menecaarriuant en ce lieu, Adieu, m’a t’il crié, chere Antigone, adieu:	Je voyais de la tour le choc des deux armées, L'une et l'autre au combat âprement animées, Alors que Menecaarriuant en ce lieu, Adieu, m'a t'il crié, chère Antigone, adieu:
Le Ciel ſe laſſe en fin de vous eſtre contraire, Toüis d’vn l’ong repos dans les bras de mon frere, Moyt qui me voyois ſeule, & qui ne ſçaucis pas Le genereux deſſein qui portoit là ſes pus:	Le Ciel se lasse en fin de vous être contraire, Touis d'un l'ong repos dans les bras de mon frère, Moit qui me voyais seule, et qui ne saucis pas Le généreux dessein qui portait là ses pus:
Pour la fuite deſia, i'auoistourné laveuë, Quand luy la face ouuerte, & nullement eſmeuë, Hardy, s’eſtant planté ſur le bord de latour, Et voyant, ſans frayeur les bas lieux d’alentour, A regardé le camp, & d’vnc voix profonde  EE-d-  MA-- N	Pour la fuite déjà, j'auoistourné lave, Quand lui la face ouverte, et nullement émue, Hardi, s'étant planté sur le bord de latour, Et voyant, sans frayeur les bas lieux d'alentour, A regardé le camp, et d'vnc voix profonde CE-d- MA- N
A fait tourner vers luy les yeux de tout le monde;	A fait tourner vers lui es yeux de tout le monde;
ArreſteZ, a-t’il dit, d’vn tonimperieux, ArreſteZ, ie l’ordonne & de la part des Dieux:	Arrêtez, a-t-il dit, d'un tonimpérieux, Arrêtez, toujours l'ordonne et de la part des Dieux:
Arreſtez;	Arrêtez;
cette voix eſt à peine entenduë, Que la main aux ſoldats demeure ſuſpenduë:	cette voix est à peine entendue, Que la main aux soldats demeure suspendue:
Chacun reſte interdit, l’œil & le bras leué, Le coup demeure enl’air, & n’eſt point acheué:	Chacun reste interdit, l'œil et le bras leué, Le coup demeure enl'air, et n'est point achevé:
Là, ce ieune Heros pouſſe vne voix moins forte, Et d’vn accent égal, leur parle encette ſorte, Thebes, gouſte la paix que ie vais t'achepter, Mon ſang en eſt le prix, ie viens te l’apporter;	Là, ce jeune Héros pousse une voix moins forte, Et d'un accent égal, leur parle te sorte, Thebes, goûte la paix que Un vais t'achepter, Mon sang en est le prix, je viens te l'apporter;
Repouſſe loin de toy, cet orage de guerre Qu'excite vn inſolent ſur ſa natale terre, Poſſede en paix tes champs, tes temples, tes maiſons, Sans autre changement, que celuy des ſaiſons, Qu'Hymen mettant tes fils, dans les bras de tes filles, De liens eternels vniſſent tes familles, Regne enfin, careſſee & du Ciel, & du ſort, La promeſſe des Dieux, doit ce prix à mamort:	Repousse loin de toi, cet orage de guerre Qu'excite un insolent sur sa natale terre, Possède en paix tes champs, tes temples, tes maisons, Sans autre changement, que celui des saisons, Qu'Hymen mettant tes fils, dans les bras de tes filles, De liens éternels unissent tes familles, Re enfin, caresse et du Ciel, et du sort, La promesse des Dieux, doit ce prix à mamort:
Il tire apres ces mots vne brillante eſpee, Et ſe l’eſtant au ſein iuſqu’aux gardes trempee, Se lance de la tour, le ferencor en main, Noble victime aux Dituui, pourt peupa Thebain:	Il tire après ces mots une brillante espée, Et se l'étant au sein jusqu'aux gardes trempe, Se lance de la tour, le ferencor en main, Noble victime aux Dituvi, pourt peupa Thebain:
A cét obiet d’horreur, l’œiliroublé, le teint bleſme, I'ay demeuré long-temps plus morte que luy meſme Et de frayeur encor tout mon ſang eſt glacé, Mais vous allez ſçauoir comme tout s’eſt paſſé.	À cet objet d'horreur, l'œiliroublé, le teint blême, J'ai demeuré longtemps plus morte que lui -même Et de frayeur encor tout mon sang est glacé, Mais vous allez savoir comme tout s'est passé.
A ii	À ji
C 2 122y d a ÆTEOCLE CREON HEMON 2.	Ç 2 1222i d ' ÆTEOCLE CREON HEMON 2.
Capit.	Capit.
IOCASTE, ISMENE, ANTIGONE.	JOCASTE, ISMENE, ANTIGONE.
ÆTEOCLE.	NETEOCLE.
hhuumt, cuntmie, eyauns cette retraite NVILa victoire est commune, ou plutost la défaite:	hhuumt, cuntie, eyauns cette retraite NVILa victoire est commune, ou plutôt la défaite:
Le ſort est bienégal, il ſe declare tard, Et beaucoup ſont à dire, & d’vne, & d’autre-part.	Le sort est bienégal, il se déclare tard, Et beaucoup sont à dire, et d'une, et d'autre-part.
IOCASTE.	JOCASTE.
Maudite ambition, N abhominable peſte!	Maudite ambition, N' hominable peste!
Monſtre, alteré de ſang, que ton fruit eſt funeſte:	Montre, altéré de sang, que ton fruit est funeste:
ÆTEOCLE.	NETEOCLE.
Sur le deſir des miens, mon troſne ſe ſouſtient, Ie luy cedois l’Eſtat, mais l’Eſtat me retient:	Sur le désir des miens, mon trône se soutient, Je teint cédais l'État, mais l'État me retient:
I'eſtois preſt à quiter le Sceptre qu'onluy nie, Le peuple aime monregne, & craint ſa tyrame:	J'étais prêt à quitter le Sceptre qu'onlui nie, Le peuple aime monregne, et craint sa tyrame:
*T*:	*T*:
te--Ie le poſſede auſsi, moins que ie ne ſers, Les honneurs qu’il me rend, ſont d’honnorables fers.	te-Ie le possède aussi, moins que ieans sers, Les honneurs qu'il me rend, sont d'honorables fers.
Au reſte un fondement, reſte à noſtre eſperance, Si l’Oracle rendu, nous tient lieu d’aſſeurance;	Au reste un fondement, reste à notre espérance, Si l'Oracle rendu, nous tient lieu d'assurance;
Thebes, lors joüira d’vn paiſible repos, Quand des dents:	Thebes, lors jouira d'un paisible repos, Quand des dents:
de Python, la ſemence derniere Satisfera pourtons, & perara la lumiere.	de Python, la semence dernière Satisfera pourtons, et pérara la lumière.
Telle est l’arreſt des Dieux.	Telle est l'arrêt des Dieux.
CREON.	CREON.
O rigoureuſe loy!	Ô rigoureuse loi!
ÆTEOCLE.	NETEOCLE.
Le jeune Mœnecee, a pris ces mots pour ſoy, Se voyant, comme il eſt, dernier de noſtre race, Sur qui, par conſe quent, tomboit cette diſgrace:	Le jeune Mœnece, a pris ces mots pour soi, Se voyant, comme il est, dernier de notre race, Sur qui, par consé quent, tombait cette disgrâce:
Il s’eſt ſoustrait de nous & du haut de la tour, Rauy, que ſon mai-neur nous prouuast ſon amour;	Il s'est soustrait de nous et du haut de la tour, Ravi, que son mai-neur nous prouvât son amour;
Et porté d’vne ardeur à nule autre ſeconde, S’eſt immõlé luy-meſme aux yeux de tout le monde:	Et porté d'une ardeur à nule autre seconde, S'est immõlé lui-même aux yeux de tout le monde:
Heureux, certes cent fois, qui meurt ſi glorieux, Et qui ſe pourra ſeuldire victorieux.	Heureux, certes cent fois, qui meurt si glorieux, Et qui se pourra seuldire victorieux.
CREON.	CREON.
Mais plus heureux encor, à qui ſa mort profite, Et qui ſe couurira des lauriers qu’ilmerite;	Mais plus heureux encor, à qui sa mort profite, Et qui se couvrira des lauriers qu'ilmerite;
Quelle haine des Dieux, iette le ſort ſur luy,	Quelle haine des Dieux, jette le sort sur lui,
Et le fait trébucher, pour ſouſtenir autruy:	Et le fait trêbucher, pour soutenir autrui:
Fauſſes DiuiniteZ, eſtres imaginaires, Beaux abus des eſprits, immortelles chymeres, Que vous a fait mon ſang pour vous eſtre immolé?	Fausses Divinitez, êtres imaginaires, Beaux abus des esprits, immortelles chimères, Que vous a fait mon sang pour vous être immolé?
Quel droit de la Nature auons-nous violé?	Quel droit de la Nature avons-nous violé?
Ai-je autre Oedipe, entré dans le lit de mamere, Luy ſuis-je eſpoux & fils, mon fils fut-il mon frere?	Ai-je autre Oedipe, entré dans le lit de mamère, Lui suis-je époux et fils, mon fils fut-il mon frère?
Voila que les ſurgeons d’vn ſanginceſtueux Portent le diadeſme, & vous estes poureux:	Voila que les surgeons d'âme sangincestueux Portent le diadème, et vous êtes poureux:
Nous, vous nous deſtinez, innocentes victimes, A perir pourleurgloire, & payer pourleurs crimes.	Nous, vous nous destinez, innocentes victimes, À périr pourleurgloire, et payer pourleurs crimes.
AMells Pas O re proche honteux!	AMells Pas Ô re che honteux!
que renouuelles-tu?	que renouvelles-tu?
AſſeZ ſans toy le ſort exerce ma vertu.	AsseZ sans toi le sort exerce ma vertu.
ÆTEOCLE.	NETEOCLE.
Ie pardonne, Creon, cette plainte inſenſee Aux recentes douleurs du ſort de Manecee:	Je pardonne, Creon, cette plainte insensée Aux récentes douleurs du sort de Manecee:
Ie ſçay qu'vn fils qu'on perd afflige viuement, Mais il faut vne borne à ce reſſentiment, Onaaqule quaa Min Emio, La guerre, des Eſtats n’exclud pas la Iuſtice, Et n'excuſeroit pas vn outrage pareil:	Je sais qu'un fils qu'on perd afflige vivement, Mais il faut une borne à ce ressentiment, Onaqule qua Min Émio, La guerre, des États n'exclud pas la Justice, Et n'excuserait pas un outrage pareil:
Entrons, & m’aßiſtez, d’vne heure de conſeil.	Entrons, et m'assistés, d'une heure de conseil.
Tous entrent horſmis Hemon & Antigone.	Tous entrent hormis Hémon et Antigone.
SCENE	SCÈNE
DOSIE ANTIGONE, CV HEMON,	DOSIE ANTIGONE, CV HEMON,
ANTIGONE.	ANTIGONE.
TOyeZ mon cher Hemon, comme ſa violence Va iuſques à l’outrage & iuſquel à l’inſolence:	TOyez mon cher Hémon, comme sa violence Va jusques à l'outrage et iusquel 'insolence:
I'approuue ſa douleur, mais pour quelle raiſon Luy fait-elle offencer toute noſtre maiſon?	J'approuve sa douleur, mais pour quelle raison Lui fait-elle offenser toute notre maison?
Et ſuiuant, ſans reſpect, ſabrutale colere Troubler iuſqu’aux Enfers, le repos de mon pere:	Et suivant, sans respect, sabrutale colère Troubler jusqu'aux Enfers, le repos de mon père:
Oedipe, quoy?	Oedipe, quoi?
tes yeux par tes mains arrachez, Teymunt,, purrumurt que voncorps détacheZ Ton Sce ptre abandonné, tout ton Royaume en armes, Tes enfans diuiſeZ, nos ſoupirs & nos larmes Ne peuuent fainencor qu’uninnocent peché, Moins de toy, que du ſort ne teſoit reproché?	tes yeux par tes mains arrachez, Teinmunt, purrhumurt que voncorps détachez Ton Sce ptre abandonné, tout ton Royaume en armes, Tes enfants divisez, nos soupirs et nos larmes Ne peuvent favainencor qu'uninnocent péché, Moins de toi, que du sort ne tes reproché?
HEMON.	HÉMON.
Ce mal-heur m’eſt commun auec voſtre miſere, De rougir comme vous des ſautes de mon pere, Qui forçant tout reſpect, oſebien à vos yeux, -	Ce malheur m'est communeste votre misère, De rougir comme vous des sautes de mon père, Qui forçant tout respect, osebien à vos yeux, -
Ces astres qui pourroient enimpoſer aux Dieux, Paſſer inſolemment iuſqu'a cette licence, (L’Amour à derohé ce mot à la naiſſance) Mais, Madame, mon ſens ne s’est point démenty Et ie ne puis tenir pour vn mauuais party.	Ces astres qui pourraient enimposer aux Dieux, Passer insolemment jusqu'a cette licence, (L'Amour à derohé ce mot à la naissance) Mais, Madame, mon sens ne s'est point démenti Et ie ne puis tenir pour un mauvais parti.
Cét eſprit violent, ſi ma crainte n’eſt vaine, Pourles ſiens, & pourſoy, promet beaucoup de peine:	Cet esprit violent, si ma crainte n'est vaine, Pourles siens, et poursoi, promet beaucoup de peine:
Et ie n'oſe vous dire vne ſecrette peur Que m’imprime en l’eſprit cette mauuaiſe humeur.	Et ici n'ose vous dire une secrète peur Que m'imprime en l'esprit cette mauvaise humeur.
ANTIGONE.	ANTIGONE.
Quoy?	Quoi?
touchant noſtre Hymen?	touchant notre Hymen?
HEMON.	HÉMON.
Ma paſsion, Madame, M’abien pû, ſans ſuiet, mettre ces peurs en l’ame:	Ma passion, Madame, M'abien pu, sans sujet, mettre ces peurs en l'âme:
Non, vn ſi beau deſſein, ne peut mal ſucceder, Le Ciel qui de ſa main, daigna nous accorder, Doit faire que l’effet à l’attente reſponde, La premiere faueur, l’oblige à la ſéconde:	Non, un si beau dessein, ne peut mal succéder, Le Ciel qui de sa main, daigna nous accorder, Doit faire que l'effet à l'attente réponde, La première faveur, l'oblige à la séconde:
De ma part, ie proteſte, en ces diuines nains, Qu’au moins ie forcerois toutobſtacles humains;	De ma part, Seigneur proteste, en ces divines nains, Qu'au moins Seigneur forcerais toutobstacles humains;
Et que m'oſter à vous, ſeroit vne auanture, Pour qui ie ſerois ſourd à toute la Natute:	Et que m'ôter à vous, serait une aventure, Pour qui ie serois sourd à toute la Nattute:
Que mon pere, à mes vœux s’oppoſaſt mille fois, I'exce pterois ce point de ce que ie luy dois:	Que mon père, à mes vœux s'opposât mille fois, J'exce pterais ce point de ce que ie lui mme.
Nulle raiſon d’Eſtat, nul reſpect de Couronne, Ne pourroient ébranler la foy que ie vous donne:	Nulle raison d'État, nul respect de Couronne, Ne pourraient ébranler la foi que après vous donne:
A toute authorité, ie fermerois les yeux, Etie ferois beaucoup de reſpecter les Dieux.	À toute autorité, ie fermerais les yeux, Etie ferais beaucoup de respecter les Dieux.
ANTIGONE.	ANTIGONE.
Quoy que la meſme foy, que ie vous ay donnee, Me permit de parler, touchant noſtre Hymenee, L’orage prest à choir deſſus noſtre maiſon, Me dé fend ce diſcours, comme hors de ſaiſon:	Quo que la même foi, que je vous ai donnée, Me permit de parler, touchant notre Hymène, L'orage prêt à choir dessus notre maison, Me de fend ce discours, comme hors de saison:
Outre, qu'ainſi qu'à vous, certaine voix ſecrette, Comme noſtre genie, est quelque-fois prophete:	Outre, qu'ainsi qu'à vous, certaine voix secrète, Comme notre génie, est quelque-fois prophète:
D’vne aueugle frayeurtout le ſein me remplit, Et me parlebien plus d’vn tombeau que d’un lit:	D'une aveugle frayeurtout le sein me remplit, Et me parlebien plus d'amour tombeau que d'un lit:
Ponrnons donc nos penſees au coſe det'ofage, Qui menace l'Eſtat d’vn ſi proche naufrage:	Ponrnons donc nos pensées au cose dét-ofage, Qui menace l'État d'Homme si proche naufrage:
Ce combat, cher Hemon, au moins s’eſt il paſſé Sans lamort de mon frere, ou ſans qu’il ſoit bleſſé.	Ce combat, cher Hémon, au moins s'est il passé Sans lamort de mon frère, ou sans qu'il soit blessé.
HEMON.	HÉMON.
Madame, c’est icy que ie vous ayſeruie, Polynice eſt viuant, mais il vous doit la vie:	Madame, c'est ici que je vous aiservie, Polinice est vivant, mais il vous doit la vie:
Certes, tamais Lyon, par vn autre irrité Au combat plus ardent ne s’est precipité, Que ce ieune Lyon, chefdes troupes de Grece, N'a fait voir, contre nous, de courage, & d’adreſſe, Son cœur, payoit d’unbras, dont les coups furieux, A peine s'aqueroient la creance des yeux:	Certes, tamais Lyon, par un autre irrité Au combat plus ardent ne s'est précipité, Que ce jeune Lyon, chefdes troupes de Grèce, N'a fait voir, contre nous, de courage, et d'adresse, Son cœur, payait d'unbras, dont les coups furieux, À peine s'aqueraient la créance des yeux:
I P.	I P.
Bij	Bijj
Seul il force nos rangs,& de taille, & de pointe, Ne treuue armet ſi fort, ny l’ame ſi bieniointe, Qu’il ne faſſe paſſage au fer qu’il a pouſſe, Et ne voye un ſoldat à ſes pieds renuerſé:	Seul il force nos rangs,et de taille, et de pointe, Ne trouve armet si fort, ni l'âme si bienjointe, Qu'il ne fasse passage au fer qu'il a pousse, Et ne voie un soldat à ses pieds renversé:
Il donne iuſqu’â nous, moins effrayé du nombre, Que s’il ne combattoit, ny voyoit que ſon ombre:	Il donne jusqu'â nous, moins effrayé du nombre, Que s'il ne combattait, ni voyait que son ombre:
Se iette furieux au plus fort du danger, Et prodigue ſon ſang comme vnbien eſtranger, Sous ſa main touſiours haute, & touſiours occupee, Son corps ſemble à deſſein s’offrir à moneſpee:	Se jette furieux au plus fort du danger, Et prodigue son sang comme un étranger, Sous sa main toujours haute, et toujours occupée, Son corps semble à dessein s'offrir à monespee:
Mais loin d’oſer ſur luy tenter aucune effort, I'ay paré mille coups qui luy portoient lamort:	Mais loin d'oser sur lui tenter aucune effort, J'ai par mille coups qui lui portaient lamort:
L'amitié qui vous ioint autant que la naiſſance, M'a fait contre nous meſme embraſſer ſa deffenſe.	L'amitié qui vous joint autant que la naissance, M'a fait contre nous même embrasser sa défense.
Ilconſerne enſade onvien qui vonsest deu, Bien mieux que ſa valeur vous l’auez, defendu, Vous eſtiez ſon bouclier au milieu des alarmes, Et vous l'auez, ſauué, ſeule, abſente, & ſans armes	Ilconserne ensade onvien qui vonsest devêt, Bien mieux que sa valeur vous l'avez, défendu, Vous étiez son bouclier au milieu des alarmes, Et vous l'avez, sauvé, seule, absente, et sans armes
ANTIGONE.	ANTIGONE.
Helas!	Hélas!
joindre ſa mort a mon cruel ennuy.	joindre sa mort a mon cruel ennui.
S'eroit bien, cher Hemon, me tuer plus queluy;	S'erait bien, cher Hémon, me tuer plus quelui;
A moy bien plus qu’à luy vous rendiez cet office, Vous ſauuiez, Antigone en ſauuant Polynice:	À moi bien plus qu'à cause vous rendiez cet office, Vous sauviez, Antigone en sauvant Polynice:
Eneffet, & vos yeux peut-eſtre enſont teſmoins, Vne eſtroite amitié de tous temps nous aioints, Qui paſſe de bien loincét inſtinct ordinaire, Par qui la ſœur s’attache aux intereſts du frere:	Éneffet, et vos yeux peut-être ensont témoins, Vaine étroite amitié de tous temps nous aioints, Qui passe de bien loincet instinct ordinaire, Par qui la sœur s'attache aux intérêts du frère:
Et ſi la verité ſe peut dire ſans fard, Æteocle en mon cœur n’eut iamais tant de part, Quoy qu'vn méme deuoir pour tous deux m'intereſſe I’ay touſiours chery l’autre auec plus de tendreſſe, Iamais nos volontez, ne faiſoient qu'vn party.	Et si la vérité se peut dire sans fard, Éteocle en mon cœur n'eût jamais tant de part, Quoi qu'H méme devoir pour tous deux m'intéresse J'ai toujours chéri l'autre avec plus de tendresse, Jamais nos volontés, ne faisaient qu'à parti.
Mais ie ſuis touſiours meſme, & luy s'eſt dementy.	Mais ici suis toujours même, et lui s'est démenti.
SSEN B LE PAGE, ANTIGONE, HEMON.	SSEN B LE PAGE, ANTIGONE, HÉMON.
LE PAGE ONSIEVN, vn'uen tonſeil, & le Roy VI vous demande.	LE PAGE ONSIEUN, une veuen tonseil, et le Roi VI vous demande.
HEMON.	HÉMON.
AgreeZ ce deuoir qu’il faut que ie luy rende.	Agréz ce devoir qu'il faut que sans lui rende.
ANTIGONE.	ANTIGONE.
Allez, mais ſur tout autre, opinez pour la paix, Et ſoient vos bons aduis ſuiuis de bons effets.	Allez, mais sur tout autre, opinez pour la paix, Et soient vos bons avis suivis de bons effets.
Biij	Bijà
SCENE VI POLYNICE, ADRASTE, ARGIE.	SCÈNE VI POLYNICE, ADRASTE, ARGIE.
POLYNICE fous vne tente.	POLYNICE fous une tente.
Eſte lâche, & honteux de tant de compagnies, Que ſous vos eſtendars la Grece m'a fournies, Et dernier de cent Rois, en ma faueurarmez, Autant, & plus que moy!	Este lâche, et honteux de tant de compagnies, Que sous vos étendards la Grèce m'a fournies, Et dernier de cent Rois, en ma faveur, Autant, et plus que moi!
pour moy-meſme animez Enfin, i’ouuré l’vreille au conſeil de la rage, Piqué de deſeſpoir, bien plus que de courage Et ie viens, mais plus tard, que l’hõneur n’eut voulu, Vous ex poſer en fin ce que i’ay reſolu:	pour moi-même animez Enfin, j'ouvré l'évreille au conseil de la ré, Piqué de désespoir, bien lu que de courage Et ie viens, mais plus tard, que hõneur eut voulu, Vous ex poser en fin ce que ay résolu:
C’eſt, mon pere, un deſſein que ie deuois éclore, Lors qu’aux vaines des Grecs le ſang boülloit encore:	C'est, mon père, un dessein que Seigneur devais éclore, Lors qu'aux vaines des Grecs le sang boullait encore:
Les Manes indignez de tant de bons ſoldats, Contre ma lâcheté ne miurmureroient pas:	Les Manes indignés de tant de bons soldats, Contre ma lâcheté ne miurmureroient pas:
Et i’aurois épargné tant d’illuſtres perſonnes, Dont, pour me couronher, i’ay mis bas les couronnes:	Et j'aurais épargné tant d'illustres personnes, Dont, pour me couronher, j'ai mis bas les couronnes:
Mais puis que cét aduis me vient de mon deuoir Quelque tard qu’il arriue il le faut receuoir:	Mais puis que cet avis me vient de mon devoir Quelque tard qu'il arrive il le faut recevoir:
Et vous trouuereZ bon, que ie paye à la Grece Le ſang de tant de peuple, & de tant de nobleſſe:	Et vous trouverez bon, que ainsi paie à la Grèce Le sang de tant de peuple, et de tant de noblesse:
Vous auez, (quoi que ſage, ence commun malheur, dta- ----o-	Vous avez, (quoi que sage, ence commun malheur, dita- -a-ô-
Vous ne témoignieZ pas voſtre iuſte douleur:	Vous ne témoigniez pas votre juste douleur:
Vous auez pris, mon pere, en l’intereſt d’vngendre, Plus de part, en effet, que vous ne deuiez prendre:	Vous avez pris, mon père, en l'intérêt d'ungendre, Plus de part, en effet, que vous ne deviez prendre:
C’eſt moy, chetif, c’eſt moy, qui dedans vos Eſtats Où vous regniez, en paix ſur tant de Potentats, Mauuais hoſte, ay porte de ces maudites terres Deſſous vn front d’amour des ſemences de guerres, Le flambeau de l’Hymen, qui m'allia chez vous, Eſt le tiſon fatal qui vous conſomme tous;	C'est moi, chétif, c'est moi, qui dedans vos États Où vous régniez, en paix sur tant de Potentats, Mauvais hôte, a porte de ces maudites terres Dessous un front d'amour des semences de guerres, Le flambeau de l'Hymen, qui m'allia chez vous, Est le tison fatal qui vous consomme tous;
Vous mettieZ vn ſerpent au ſein de voſtre fille, Qui deuoit etouffer toute voſtre famille:	Vous mettiez un serpent au sein de votre fille, Qui devait étouffer toute votre famille:
I’ay trop, certes, i’ay trop fait voir de lâcheté, Pour tant de patience, & pour tant de bonté:	J'ai trop, certes, j'ai trop fait voir de lâcheté, Pour tant de patience, et pour tant de bonté:
nnuimeun uoinm uommu yuono cenn puis de grace, Il eſt temps, ou iamais, que ie vous ſatisfaſſe, Et qu'vn duelen fin, entre mon frere & moy, Qu'auez vous à pâlir, & d’où n’aiſt cét efroy?	nnuimeun uoinm uommu yvono cenn puis de grâce, Il est temps, ou jamais, que je vous satisfasse, Et qu'un duelen fin, entre mon frère et moi, Qu'avez -vous à pâlir, et d'où n'ait cet Efroi?
ADRASTE.	ADRASTE.
Dieux!	Dieux!
que propoſez-vous, quelle horrible auanture ?	que proposez-vous, quelle horrible aventure ?
ARGIE, Hé!	ARGIE, Hé!
Monſieur, eſcoutez la voix de la Nature, SongeZ queleſt le ſang que vous voulez verſer, Sans honte & ſans frayeur y pouuez-vous penſer?	Monsieur, écoutez la voix de la Nature, Songez quelle le sang que vous voulez verser, Sans honte et sans frayeur y pouvez-vous penser?
POLYNICE La choſe eſt reſoluë, & la Nature meſme Souſcrit à cet arreſt de ma fureur extreſme Outre qu'elle eſt muette, où parle la raiſon,:	POLYNICE La chose est résolue, et la Nature même Souscrit à cet arrêt de ma fureur extrême Outre qu'elle est muette, où parle la raison,:
Elle ne s’entend pas auec la trahiſon:	Elle ne s'entend pas avec la trahison:
Au contraire, elle enſeigne à repou ſer l’iniure, Et condamne ſur tout, lafraude, & la pariure:	Au contraire, elle enseigne à repou serv l'injure, Et condamne sur tout, lafraude, et la parjure:
Que doit plus la Nature a mon frere qu’à moy, nlandundomumemuquueuquunp jafoys Et pour vouloir que i'erre, & que ie me retire Quand monannée arriue, & m'appelle à l’Empire.	Que doit plus la Nature a mon frère qu'à moi, nlandundomumemuqueuquunp jasais Et pour vouloir que j'erre, et que je me retire Quand monannée arrive, et m'appelle à l'Empire.
ADRASE.	ADRASE.
Quelle rage, bons Dieux!	Quelle rage, bons Dieux!
vous occupe le ſein?	vous occupe le sein?
Ha!	Ha!
mon fils, eſtouffez ce damnable deſſein, Si vostre ambition ne va qu'à la Couronne, Ie de poüille pour vous l’eſclat qui m'enuironne, Venez prendre, & donner vn paiſible repos Surle tronne de Lerne, ou ſurceluy d’Argos, Là, Monarque abſolu, vous n’aurez pointde frere Qui vous rompe de pacte, & qui vous ſoit contraire, La, voſtre eſpouſe, & moy, deuenus vos ſubiets, De nos fideles ſoins appuyrons vos projets, Et voſtre authorité n’y ſera diuiſee Par aucune puiſſance à la voſtre oppoſee.	mon fils, étouffez ce damnable dessein, Si votre ambition ne va qu'à la Couronne, Je de pouille pour vous l'éclat qui m'environne, Venez prendre, et donner un paisible repos Surle tronne de Lerne, ou surcelui d'Argos, Là, Monarque absolu, vous n'aurez point frère Qui vous rompe de pacte, et qui vous soit contraire, La, votre épouse, et moi, devenus vos sujet, Et vos fidèles De nos fidèles soins, Et vos authorité n'y sera divise Par aucune puissance à la vôtre oppose.
DI- T ------- ---	DI- T -h- --elle
POLYNICE	POLYNICE
POLYNICE.	POLYNICE.
Non, nõ, ne point regner, les Dieux m’ensõt teſmoins, Eſt le reſſentiment qui me touche le moins.	Non, notre, ne point régner, les Dieux m'ennont témoins, Est le ressentiment qui me touche le moins.
Et iamais ma Couronne entre mes mains remiſe, N’auroit d’authorité qui ne vous fuſt ſouſmiſe:	Et jamais ma Couronne entre mes mains remise, N'aurait d'autorité qui ne vous fût soumise:
Mais qu'vn traiſtre viole auec impunite Le reſpect de l’accord entre nous arreſté.	Mais qu'un traître viole avec impunité Le respect de l'accord entre nous arrêté.
Et que i’obſerue apres celuy de la naiſſance, Vne vertu ſi lâche excede ma puiſſance:	Et que j'observe après celui de la naissance, Une vertu si lâche excède ma puissance:
Il faut trop de foibleſſe à pouuoir l’exercer, On étouffe aiſément qui ſe laiſſe preſſer;	Il faut trop de faiblesse à pouvoir l'exercer, On étouffe aisément qui se laisse presser;
Non, mamere elle-meſme au milieu de nos armes, Ny mes ſœurs à mes pieds les yeux baignez de larmes Quelque droit qu'Antigone ait deſſus mes eſprit:	Non, mamère elle-même au milieu de nos armes, Ny mes sœurs à mes pieds les yeux baignés de larmes Quelque droit qu'Antigone ait dessus mes esprit:
Ne deſtourneroient pas le deſſein que i’ay pris, Ou ſa vie ou la mienne, importunes ſangſuës, Doiuent creuer du ſang dont elles ſont repeuës, Menreſte-il à boire, & ne voudriez-vous point.	Ne détourneraient pas le dessein que j'ai pris, Ou sa vie ou la mienne, importunes sangsues, Doivent creuer du sang dont elles sont repues, Menreste-il à boire, et ne voudriez-vous point.
Qu’à ce que i’en ay pris le voſtre encorfuſt joint:	Qu'à ce que j'en ai pris le vôtre encorfût joint:
Tydée, de tes iours i’ay la courſe borne, Des tiens, Hyppomedon, & des tiens, Cappanée:	Tydée, de tes jours j'ai la course borne, Des tiens, Hypomédon, et des tiens, Cappanée:
Par moy, braues Heros, ſont veſues à la fois Vos femmes de maris, & vos villes de Rois:	Par moi, braves Héros, sont vesues à la fois Vos femmes de maris, et vos villes de Rois:
Et ſans confuſion, ie verrois leur vefuage, Non, non, trop de iuſtice à ce deuoir m'engage Et trop de honte eſt iointe à mon retardement:	Et sans confusion, ie verrais leur veuage, Non, non, trop de justice à ce devoir m'engage Et trop de honte est juste à mon retardement:
A	À
Baiſant Argie.	Baisant Argie.
A dieu, vous que moncœur aima ſi tendrement Et que le Ciel doüa d’une vertu ſi rare, Vneternel adieu peut-eſtre nous ſepare:	À dieu, vous que moncœur aima si tendrement Et que le Ciel doüa 'une vertu si rare, Vénéternel adieu peut-être nous sépare:
Mals monſtres voſtre fonce à dompter vos douleurs Et ne m'obligeZ point a la honte des pleurs;	Mals monstres votre fonce à dompter vos douleurs Et ne m'obligez point à la honte des pleurs;
Et vous, ſage vieillard, digne d’unautre gendre, Ayez ſoin, que la terre, aumoins, couure ma cendre, Et m'ouurez le paſſage à l’empire des morts, Dérobant aux corbeaux le butin de mon corps:	Et vous, sage vieillard, digne d'unautre gendre, Ayez soin, que la terre, aumoins, couvre ma cendre, Et m'ouvrez le passage à l'empire des morts, Dérobant aux corbeaux le butin de mon corps:
Apres, pour voſtre fille, employez, voſtre zele, Prenne Sus Jungaaa gnetty iomparty digne dielle, Et que cét autre Hymenluy puiſſe eſtre auſſi doux, Que le premierfut triſte, & pourelle, & pourvous.	Après, pour votre fille, employez, votre zèle, Prenne Sus Junga gnetty jomparti digne dielle, Et que cet autre Hymenlui puisse chang aussi doux, Que le premierfut triste, et pourelle, et pourvous.
F GII .	F GII .
lls en va¬u Polynice, hé!	lois en va¬u Polinice, hé!
mon pere, arreſtez, ce barbare, Qu’il differe on moment la mort qu’il me prepare Et qu'il recõiue, au moins, l'adieu que ie luy dois;	mon père, arrêtez, ce barbare, Qu'il diffère on moment la mort qu'il me prépare Et qu'il recõiue, au moins, l'adieu que m luy dois;
1i CeſſeZ, pleura, & fouſpirs, qui m'eſtouffeZ la voix.	1i Cessez, pleura, et fouspirs, qui m'étouffés la voix.
A 2 s6 N.	A 2 s6 N.
B.	B.
ML SCENE PREMIERE.	ML SCÈNE PREMIÈRE.
POuincreui Ieipec a ia main aux pieds des Murailles de Thebes 1.	POuincreui -Jeipec a ja main aux pieds des Murailles de Thebes 1.
CHEF DES GRECS.	CHEF DES GRECS.
ROLYNICE.	ROLYNICE.
A, ſi ton lâche cœur, enfin ſe peut reſoudre Tu laiſſeras la vie, oui'y mordray la poudre:	À, si ton lâche cœur, enfin se peut résoudre Tu laisseras la vie, ouj'y mordrai la poudre:
Là ton ſang, ou le mien ſignera noſtre foy, Là, de la main des Dieux, Thebes prendraſon Roy.	Là ton sang, ou le mien signera notre foi, Là, de la main des Dieux, Thebes prendrason Roi.
Sorts donc, traiſtre, l’honneur à ce deuoir t’engage, La diligence icy doit prouuer le courage, Et depuis le defſt que mes traits t'ont porté,	Sorts donc, traître, l'honneur à ce devoir t'engage, La diligence ici doit prover le courage, Et depuis le défst que mes traits t'ont porté,
C Chaque inſtant qui ſe perd marque talâcheté:	Ç Caque instant qui se perd que talâcheté:
Ha!	Ha!
qu'un facheux deuoir de ta ville t’arrache!	qu'un fâcheux devoir de ta ville t'arrache!
Qu'vn traiſtre a peu de cœur, & qu’vn perfide est lâche?	Qu'un traître a peu de cœur, et qu'un perfide est lâche?
Quel employ t’a deſia tant de fois retenu?	Quel emploi t'a déjà tant de fois retenu?
Il ne faut point d’aprest, à paroiſtre tout nit.	Il ne faut point d'apprêt, à paraître tout nit.
L CHEF DES GRECS.	 CHEF DES GRECS.
En ces effets, bien moins de valeur, que de rage:	En ces effets, bien moins de valeur, que de rage:
La nature, Seigneur, diſpenſe le courage,  Vous auriez, plus de cœur, ſi vous en auiez moins.	La nature, Seigneur, dispense le courage, Vous auriez, plus de cœur, si vous en aviez moins.
POLYNICE.	POLYNICE.
LaiſſeZ iuger aux Dieux, ne ſoyez que teſmoins.	Laissez juger aux Dieux, ne soyez que témoins.
IiEEa II ANTIGONE, ſur les murailles.	JiEa II ANTIGONE, sur les murailles.
POLYNICE.	POLYNICE.
ANTIGONE.	ANTIGONE.
Olynice, aduancez, portez icy la veuë;	Olynice, avancez, portez ici la vue;
Souffrez qu'apres vn an voſtre ſœur vous ſaluë:	Souffrez qu'après un an votre sœur vous salue:
Mal-heureuſe:	Malheureuse:
hé!	hé!
pourquoy ne le puis-ie autremẽtl » -i-e-s -	pourquoi ne le puis-je autrement » -y, "
Quel destinentre nous met cet eſloignement?	Quel destinentre nous met cet éloignement?
Apres un ſi long temps, la ſœur reuoit ſonfrere, Et ne luy peut donner le ſalut ordinaire, Vn ſeul embraſſement ne nous eſt pas permis, Nous parlons ſepareZ comme deux ennemis:	Après un si long temps, la sœur rêvait sonfrere, Et ne le peut donner le salut ordinaire, Un seul embrassement ne nous est pas permis, Nous parlons séparés comme deux ennemis:
Hé, mon frere, a quoybon cét appareil de guerre, A quoy ces pauillons ſurvoſtre propre terre?	Hé, mon frère, a quoibon cet appareil de guerre, A quoi ces pavillons survotre propre terre?
Contre quel ennemy vous eſtes vous armé, Ne trembleriez-vous pas, ſi ie l’auois nommé?	Contre quel ennemi vous êtes vous armé, Ne trembleriez-vous pas, si toujours l'avais nommé?
Accordez quelque choſe à la loy naturelle, Le Soleil s’eſt caché pour ſemblable querelle:	Accordez quelque chose à la loi naturelle, Le Soleil s'est caché pour semblable querelle:
Vous vous plaigneZ, armez, & frapez à la fois, Eſt-ce de la façon qu’on demande ſes droitsa Eſtoit-il d’vn bon frexe, & d’vn Prince modeſte:	Vous vous plaignez, armez, et frappez à la fois, Est-ce de la façon qu'on demande ses droitsa Était-il d'un bon frèrexe, et d'un Prince modeste:
De paroistre d’abord en cet eſtat funeste?	De paraître d'abord en cet état funeste?
Et de fouler aux pieds ſur vn ſimple refus Tout reſpect de nature, & ne l’écouter plus;	Et de fouler aux pieds sur un simple refus Tout respect de nature, et ne l'écouter plus;
Mon frere, au nom des Dieux protecteurs de laGrece, Car vers eux maintenant voſtre zele s’adreſſe, Et vous n'en gardez plus pour les Dieuz des Thebains, Aus nom d'’Argie, encor, que t'ayme, & que ie plains:	Mon frère, au nom des Dieux protecteurs de laGrece, Car vers eux maintenant votre zèle s'adresse, Et vous n'en gardez plus pour les Dieuz des Thébains, Aus nom d'Argie, encor, que t'aime, et que je crains:
Voyant qu'on luy prepare vn ſi proche vefuage, Au nom d’Adraſte, enfin, domptes ce grand courage;	Voyant qu'on lui prépare un si proche vefuage, Au nom d'Andraste, enfin, domptes ce grand courage;
Ne vous acquerez, pas, par voſtre dureté:	Ne vous acquérez, pas, par votre dureté:
C1 O Nature, toyomeſme, à toy meſme contraire, Voy, que le feren main, vn frere attend ſon frere:	C1 Ô Nature, toiomesme, à toi autre contraire, Vois, que le seren main, une frère attend son frère:
Cruel, hé!	Cruel, hé!
quel effet pretend vostre courroux?	quel effet prétend votre courroux?
Duquel, que le ſangcoule, il coulera de vous:	Duquel, que le sangcoule, il coulera de vous:
L’vn ne le peut verſer, ſans la perte de l’autre, En reſpandant le ſien, vous repandrez, le voſtre;	L'un ne le peut verser, sans la perte de l'autre, En répandant le sien, vous répandrez, le vôtre;
Il ne differe point, ce n’eſt qu'vn meſme ſang, Que vous aueZ puisé dedans vn meſme flanc,	Il ne diffère point, ce n'est qu'un autre sang, Que vous avez puisé dedans un même flanc,
POEYNICE.	POEYNICE.
C’eſt d’où nous vient außi, meſme droit à l’Empire.	C'est d'où nous vient aussi, même droit à l'Empire.
Que ſon ambition pretend de m'interdire:	Que son ambition prétend de m'interdire:
Et ce qui l’obligeoil à me cardan ſafoy, (nouey;	Et ce qui l'obligeoil à me cardan safoi, (nouei;
Comme digne action, & d’vnfrere & d'vn Roy.	Comme digne action, et d'vnfrere et d'un Roi.
Pour vous, mãchere ſœur, pieuſe, & ſage fille, Gloire du ſang d'Oedipe, honneur deſafamille:	Pour vous, mère sœur, pieuse, et sage fille, Gloire du sang d'Oedipe, honneur desafamille:
Croyez, qu'il me, déplaiſt, & treseſenſiblement, De vous deuoir dedire vne fois ſeulement:	Croyez, qu'il me, déplaît, et tresesensiblement, De vous devoir dédire quelque fois seulement:
Mais, par cette amitié, ſt parfaite, & ſi tendre.	Mais, par cette amitié, st parfaite, et si tendre.
Par où ie connois bien que vous me voulez, prendre;	Par où grands connais bien que vous me voulez, prendre;
Et pour qut i'aurois peinecà vous rien refuſarne;	Et pour qu 'aurais peinecà vous rien refusarne;
De moy meſme aujourd’huy, laiſſés moy diſpoſer;	De moi -même aujourd'hui, laissez moi disposer;
L.	L.
Outres moninterest,, & celuy:	Outres moninterest, et celui:
de la Girace,s qun pi.	de la Girace,s qun pi.
Mon honneur, pluxque toub, ace deuais me preſſe:	Mon honneur, pluxque toub, ace devais me presse:
I:	I:
arme pourle hondroit, luxſoour las trabiſon ,s pllu Il tient pourhiniuſtica, & moypour la raiſone* Vs	arme pourle hondrait, luxsoour las trabison ,s plu Il tient pourhiniustica, et moipour la raisone* Vs
ANTIGONE.	ANTIGONE.
Voila donccette ſœur qui vous eſtoit ſi chere, Econduite aujourd’huy d’vne ſeule priere.	Voilà donccette sœur qui vous était si chère, Éconduite aujourd'huite d'une seule prière.
Hé quoy!	Hé quoi!
ceite amitié, qui n'aſquit auec nous, De' qui non ſans raiſon, Æteocle eſt jaloux:	cite amitié, qui n'asquit avec nous, De' qui non sans raison, Æteocle est jaloux:
Et par qui ie voy bien, que ie luyſuis ſuſpecte, Ne pouuant l’honorer, comme ie vous reſpecte;	Et par qui ici vois bien, que ainsi luysuis suspecte, Ne pouuant l'honorer, comme ie vous respecte;
Cette tendre amitié, reçoit donc vn refus, Elle a perdu ſon droit, & ne vous touche plus:	Cette tendre amitié, reçoit donc un refus, Elle a perdu son droit, et ne vous touche plus:
Au meine, ſi de ſi loin, vuous pouuiez, voir mes larmes, Peut-eſtre, en leur faüeur, mettrieZ vous bas les armes:	Au mène, si de si loin, vous pouviez, voir mes larmes, Peut-être, en leur feueur, mettriez -vous bas les armes:
Car ie n’oſerois pas encor vous reprocher, Que vous ſoyez plus dur, & plus ſourd qu’vn rocher.	Car ie n'oserais pas encor vous reprocher, Que vous soyez plus dur, et plus sourd 'un rocher.
Encore à la Nature, Eteocle deffere, Iliſe liſſſ gagner aux plaihté?	Encore à la Nature, Éteocle défère, Ilise lisss gagner aux plaihé?
lde mu piere:	lède mu pière:
I'n a pas de poüillé tous ſentimens humains, Et la fereſt tout preſt atomber de ſes mains!	Yn a pas de pillé tous sentiments humains, Et la ferêt tout prêt atomber de ses mains!
Et vous plus inhumain, &, plus inacceßible, Conſeruez contre moy le titre d’inuincible;	Et vous plus inhumain, et, plus inaccesible, Conservez contre moi le titre d'invincible;
.	.
a Moy, dont lannm tout ſaul, & oux doustfauoir touché, Dont depuis voſtre exil, les yeux n'ont point ſeché, Moy, qui ſans vvousmentir, trouuerois tropaiſeẽ Quelque mort qui pourvou puſt m'eſtre propoſee?	à Moi, dont lannm tout saul, et oux doutfavoir touché, Dont depuis votre exil, les yeux n'ont point séché, Moi, qui sans vvousmentir, trouverais tropaiseẽ Quelque mort qui pourvou pût m'être propose?
Moy, mulmheureuſe enfin, qui vous prie a genbiex,  6 Moine pour l'amour de moy, que pour l’ambur de domo.	Moi, mulmheureuse enfin, qui vous prie a genbiex, 6 Moine pour l'amour de moi, que pour l'ambur de domo.
POLYNICE.	POLYNICE.
Si quelque ſentiment demeure apres la vie, Que ie vous ſçaurois gré, de me l'auoir rauie, Piutoſt, ma chere ſœur, que de me commander Ce que ma paßion ne vous peut accorder, VeneZ m’oſter ce fer, oüy veneZ, mais ſur l’heure, Plongez-le dans mon ſein, & faites que ie meure;	Si quelque sentiment demeure après la vie, Que ie vous saurais gré, de me l'avoir ravie, Piutôt, ma chère sœur, que de me commander Ce que ma passion ne vous peut accorder, VeneZ m'ôter ce fer, oui veneZ, mais sur l'heure, Plongez-le dans mon sein, et faites que votre meure;
Pour vous ma deference ira juſqu' au trépas, Mais ie ne ſçaurois viure, & ne me venger pas.	Pour vous ma déférence ira jusqu' au trépas, Mais tu ne saurais vivre, et ne me venger pas.
ÆTEOCLE CREON POLYNICE.	NETEOCLE CREON POLYNICE.
Les 2.	Les 2.
Capit.	Capit.
TEOCLE, ſortant deſarmé.	TEOCLE, sortant désarmé.
23 E viens, enfin, ie viens, preſt à te ſatisfaire, A Et croy que ſi plutoſt i'auois pû me ſouſtraire, L-.	23 E viens, enfin, une viens, prêt à te satisfaire, A Et crois que si tôt j'avais pu me soustraire, L-.
Plutoſt, deſſuc los lieux, tu m'aurois veu rendus Et n’aurois pas l’honneur de m’auoir attendit:	Plutôt, dessuc los lieux, tu m'aurais vu rendus Et n'aurais pas l'honneur de m'avoir attendit:
Ma mere, à mon deceu, par Ephite aduertie, Auec tous ſes efforts, empeſchoit ma ſortie, Dont ilm’a biendéplû, car ie n’ay pas douté Que mon retardement n'enflaſt ta vanité:	Ma mère, à mon déçu, par Éphite avertie, Avec tous ses efforts, empêchait ma sortie, Dont ilm'a biendéplû, car tu n'ai pas douté Que mon retardement n'enflât ta vanité:
Ton appeleſt au reſte vnbien que ie t’enuie, I'en pretendois la gloire, & tu me l’as rauie:	Ton appelest au reste unbien que je t'envie, J'en prétendais la gloire, et tu me l'as ravie:
Cent fois de ce deſſein mon cœur m’auoit preſſé, Et ce n’eſt que du temps que tu m'as deuancé;	Cent fois de ce dessein mon cœur m'avait pressé, Et ce n'est que du temps que tu m'as devancé;
Thebes, ſur qui iamais nulne regna ſans crime, Le ſort te madonner vn Prince legilime:	Thebes, sur qui jamais nulne régna sans crime, Le sort te madonner un Prince légilime:
Voyonss'ilm'oſtera le nom que i'en ay pris, Que lechamp du combat enſoit außi le prix.	Voyonss' ilm' ôtera le nom que j'en ai pris, Que léchamp du combat ensait aussi le prix.
ANTIGONE.	ANTIGONE.
Ils s'approchent, ô Dieux!	Ils s'approchent, ô Dieux!
& nul n’y met d’obſtacle.	et nul n'y met d'obstacle.
Fuyons;	Fuyons;
ne voyons pas céthorrible fpectacle.	ne voyons pas cethorrible spectacle.
POLYNICE En ſin quelque remords t’a donc fait ſouuenir Que ta foy s’eſt donnée, & qu’il la faut tenir?	POLYNICE En sin quelque remords t'a donc fait souvenir Que ta foi s'est donnée, et qu'il la faut tenir?
Tuim'es donc frere, enfin, car ce n’eſtoit pas l’eſtre, Que de te pariurer,& de traiter en traiſtre;	Tuim'es donc frère, enfin, car ce n'était pas l'être, Que de te parjurer,et de traiter en traître;
Pour nous mieux obliger;	Pour nous mieux obliger;
vien, ſignons nos accords De nostrapropreſang;	viens, signons nos accords De nostrapropresang;
& ſur nos propres corps.	et sur nos propres corps.
Ay I IOCASTE, CREON, HEMON, Les 2.	A I IOCASTE, CREON, HEMON, Les 2.
Chels Grecs.	Chels Grecs.
ATEOCLE,	ATECLE,
POLYNICE,	POLYNICE,
OREON.	OREN.
VE veut, hors de ſaiſon, cette femme impor:	VE veut, hors de saison, cette femme impor:
tune?	tune?
Sadaale Nes Deſtourners’il ſe peut, vune eſtrange infortune:	Sadaale Nes Destournersil se peut, vune étrange infortune:
*0	*0
2.	2.
CHEF GRECS.	CHEF GRECS.
C’eſt leurmere, ô Nature, aßiſte ſon deſſein.	C'est leurmère, ô Nature, assiste son dessein.
IOCASTE.	JOCASTE.
Plongez, plongez, cruels, vos armer dans mon ſein, Déployez, contre moy voſtre aueugle cholere Contre moy, qui donnay des freresà leur TTR irecet Jetetrn 3 lir	Plongez, plongez, cruels, vos armer dans mon sein, Déployez, contre moi votre aveugle colère Contre moi, qui donnai des frèresà leur TTR irecet Jetetrn 3 lir
Ou ſi vous m’épargnez, ne verſez pas le ſang Que vous aueZ puisé dans ce coupable flanc:	Ou si vous m'épargnez, ne versez pas le sang Que vous avez puisé dans ce coupable flanc:
Accordez-le moy tout, ou ne m’en laiſſés goutte, Perdez-moy toute entiere, ou conſeruez-moy toute.	Accordez-le moi tout, ou ne m'en laissez goutte, Perdez-moi toute entière, ou conservez-moi toute.
Quoy?	Quoi?
nul de vous encorn'amis les armes bas, Ie parle & de vos mains, elles ne tombent pas?	nul de vous encorn'amis les armes bas, Je parle et de vos mains, elles ne tombent pas?
Si quelque pieté regne chez, vous encore, Conſentez, à la paix que vostre mere implore;	Si quelque piété règne chez, vous encore, Consentez, à la paix que votre mère implore;
Si le crime vous plaiſt, vn plus grand s’offre à vous, Ce flanc, dont vous ſorteZ eſt enbutte à vos coups;	Si le crime vous plaît, un plus grand s'offre à vous, Ce flanc, dont vous sortez est enbute à vos coups;
CeſſeZ donc cette guerre, ou ceſſez-en la tréue, Faite qu'elle s’eſteigne, ou bien qu'elle s’acheue;	Cessez donc cette guerre, ou cessez-en la trêve, Faite qu'elle s'éteigne, ou bien qu'elle s'achève;
Ou n’allez pas plus outre, ou paſſez iuſqu'au bout.	Ou n'allez pas plus outre, ou passez jusqu'au bout.
Ne conſidereZ rien, ou conſidereZ tout.	Ne considérez rien, ou considérez tout.
Sus, voyons, queleffet obtiendront mes prieres, Car mes commandemens n’en obtiendroient plus gueres:	Sus, voyons, queleffet obtiendront mes prières, Car mes commandements n'en obtiendraient plus guères:
Ie n’aduancerois rien, en vous contrediſant, I'ordonnois autrefois, & ie prie à preſent:	Je n'avancerais rien, en vous contredisant, J'ordonnais autrefois, et toujours prie à présent:
A qui s'’adreſſeront mes premieres careſſes, Tous deux également partagent mes tendreſſes:	À qui s'adresseront mes premières caresses, Tous deux également partagent mes tendresses:
Celuy-la ſut abſent, maïs ſt le pacte tient, Celuy-cy le ſera, puis que.	Celui-la sut absent, maî st le pacte tient, Celui-cy le sera, puis que.
l’autre reuient:	l'autre revient:
Ainſi ie perds l’eſpoir de vous reuoirenſemble, Si ce n'est que la guerre encore vous aſſemble;	Ainsi ie perds l'espoir de vous revoirensemble, Si ce n'est que la guerre encore vous assemble;
L'heur de uou entreuoir ne vous eſt pas permis Si vous ne vous ſuyez, vous eſtes ennemis:	L'heur de ouvou entrevoir ne vous est pas permis Si vous ne vous suivez, vous êtes ennemis:
Di	Dis
Vous eſtet diuiſez, ou decœur, ou d’eſpace, La haine vous approche, & l’amitié vous chaſſe à Polynice.	Vous estet divisez, ou décœur, ou d'espace, La haine vous approche, et l'amitié vous chasse à Polynice.
C’a, mes premiers baiſers s’adreſſeront à vous, Qu'vne ſi longue abſence a ſeparé de nous:	C'a, mes premiers baisers s'adresseront à vous, Qu'une si longue absence a séparé de nous:
VeneZ les receuoir, d’vne approche ciuile, Et déchargeZ vos mains de ce faix inutile!	VeneZ les recevoir, d'une approche civile, Et déchargés vos mains de ce faix inutile!
Hé!	Hé!
quel eſt cét abord?	quel est cet abord?
qu’il eſt peu gracieux, Rourquoy ſur voſtre frere attachez-vous les yeux?	qu'il est peu gracieux, Rourquoi sur votre frère attachez-vous les yeux?
u vous coituriray tout, & pour vvmjuire outrage, Il faudroit que parmoy, ſon fer ſe fit paſſage;	Elle vous coiturirai tout, et pour vumjuire outrage, Il faudrait que parmoi, son fer se fit passage;
ChaſſeZ de vostre eſprit ce deffiant ſoucy, Si ce n’eſt que ma foy vous ſoit ſuſpecte außi.	Chassez de votre esprit ce défiant souci, Si ce n'est que ma foi vous soit suspecte aussi.
OLYNICE.	OLYNICE.
Ne deſirez-vous point, que ie vous dißsimule, Ma ſeureté depend de n'eſtre plus credule;	Ne désirez-vous point, que je vous dissimule, Ma sûreté dépend de n'être plus crédule;
mimaspn umamn De ſon propre intereſt chacun ſe fait desloix:	mimaspn amn De son propre intérêt chacun se fait déloix:
Et l'epreuue m'apprend que du pur artiſice, Nature ſon contraire, auiourd’huy fait l’office:	Et l'épreuve m'apprend que du pur artisice, Nature son contraire, aujourd'hui fait l'office:
Voſtre parole, en fin, m’eſt ſuſpecte en effet Ma mere pourroit bien ce que mon frere a fait.	Votre parole, en fin, m'est suspecte en effet Ma mère pourrait bien ce que mon frère a fait.
IOCASTE.	JOCASTE.
Soupconnés voſtre mere, ouy, i'aprouue qu'enelle housredouties d'auonr vne carde inſidele - 9 De cét indigne fais ne dechargez, ce bras, Qapres, qu'en ma jaueur, le-Roy l’auras mis bas.	Soupconnez votre mère, oui, j'aprouve qu'enelle houredouties d'avonr carde insidele - 9 De cet indigne fais ne déchargez, ce bras, Qapres, qu'en ma javeur, le-Roi l'auras mis bas.
POLYNICE.	POLYNICE.
Le Roy?	Le Roi?
quoy, le perfide exige encor ce titre, Omanceuiſſenena, dont ie forteſ arbitre:	quoi, le perfide exige encor ce titre, Omanceuissena, dont toujours fortes arbitre:
Vous, & ſa trahiſon l’auez donc couronné?	Vous, et sa trahison l'avez donc couronné?
ATEOCLE.	ATECLE.
Bien toſt, bien toſt, les Dieux en auront ordonné.	Bien tôt, bien tôt, les Dieux en auront ordonné.
IOCASTE.	JOCASTE.
Helas!	Hélas!
qu’en la fureur dont voſtre ame eſt preſſee, Vous preneZ tout, d’vn ſens contraire à ma penſee;	qu'en la fureur dont votre âme est pressée, Vous preneZ tout, d'un sens contraire à ma pensée;
Ie ne viens pas icy pour aigrir vos debats, Ie luy donne ce titre, & ne vous l’oſte pas.	Je ne viens pas ici pour aigrir vos débats, Je lui donne ce titre, et ne vous l'ôte pas.
à Æteocle.	à Æteocle.
Pour vous la pieté, peut-eſtre, a plus de charmes:	Pour vous la piété, peut-être, a plus de charmes:
Approche Z Æteocle, & metteZ has les armes;	Approche Z Éteocle, et mettez has les armes;
CacheZ a mes regards leur flamhoyant acier, Vous lesfiſtes leuer, poſez-les le premier.	Cachez à mes regards leur flammhoyant acier, Vous lesfîtes lever, posez-les le premier.
Il mét l’eſpée à terre.	Il met l'épée à terre.
Vous vous craigneZ l'ontaune, & muy tous deux enſemble, Mau tous deux, pour tous deux, c'eſt pour vous que ietremble Le--C 32	Vous vous craignez l'ontaune, et mui tous deux ensemble, Mau tous deux, pour tous deux, c'est pour vous que jetremble Le-Ç 32
à Polynice.	à Polynice.
Mais voſtre deffiance à la fin doit ceſſer, Le voyla deſarmé:	Mais votre défiance à la fin doit cesser, Le voilà désarmé:
puis-ie vous ambraſſer;	puis-je vous ambrasser;
Faites icy, mes pleurs, l’office de la langue, Mes ſanglots, mes ſoupirs, commenceZ ma harangue.	Faites ici, mes pleurs, l'office de la langue, Mes sanglots, mes soupirs, commencez ma harangue.
Enfinles Dieux, monfils, ont exaucé mes vœux, I'obtiens, en ces baiſers, la faueur que ie veux;	Enfinles Dieux, monfils, ont exaucé mes vœux, J'obtiens, en ces baisers, la faveur que de veux;
Mais, faſſe, leur bonté, faſſent mes deſtinées, Que ce bon-heur me dure encor quelques années:	Mais, fasse, leur bonté, fassent mes destinées, Que ce bonheur me dure encor quelques années:
Vous faites le mon fils,puis que vous le pouuez, Car il me durera, ſi voüs vous conſeruez, Les bruits nous ont appris auec quelle allegreſſe, Et quel honneſte accueil vous areceu la Grece:	Vous faites le mon fils,puis que vous le pouvez, Car il me durera, si vouds vous conservez, Les bruits nous ont appris auec quelle allégresse, Et quel honnête accueil vous areçu la Grèce:
Voùs y viſtes Adraſte, & l’ondit qu’en ſa Cour Vous auez fait vnchoix digne de voſtre amour;	Voùs y vîtes Adaste, et l'ondit qu'en sa Cour Vous avez fait vnchoix digne de votre amour;
Mais qui dans voſtre lit conduiſit voſtre epouſe?	Mais qui dans votre lit conduisit votre épouse?
C’eſt vndroit qu’on m’oſtoit, & dont ie ſuis ialouſe:	C'est vndroit qu'on m'ôtait, et dont tu suis jalouse:
Vous ſongeaſtes, ſans doute, en cette élection;	Vous songeâtes, sans doute, en cette élection;
En quel lieu s'adreſſoit vostre inclination;	En quel lieu s'adressait votre inclination;
Mais, ſçeuſtes-vous iuger, que par cette alliance;	Mais, Sûtes-vous juger, que par cette alliance;
Vous nous donnieZ fujet de iuſte dé ſiance?	Vous nous donniez sujet de juste dé siance?
Sçauez-vous ſous quel jougcét Hymen voüs amis!	Savez-vous sous quel jougcét Hymen vous amis!
De nos plus enrageZ, & mortels ennemïs, Qui ne vous ont ouuert, ny leurs bras, ny leur teir Que pour auoir pretexte à nous faire la ellert Sur ce ſimple doüaire, ils vous ont accorde 3 6	De nos plus enragez, et mortels ennemis, Qui ne vous ont ouvert, ni leurs bras, ni leur te Que pour avoir prétexte à nous faire la élert Sur ce simple doüaire, ils vous ont accorde 3 6
Außi portiez-vous trop, leur portant les ſemences De ces diuiſions, & de ces violences:	Aussi portiez-vous trop, leur portant les semences De ces divisions, et de ces violences:
Car quelle eſt cette guerre!	Car quelle est cette guerre!
& quels ſont ſes objets, Vos parens, vos amis, vos païs, vos ſubjets;	et quels sont ses objets, Vos parents, vos amis, vos pays, vos sujets;
C’eſt ce qu'on peut nommer vostre party contraire, De ce funeſte Hymen nous ſommes le doüaire:	C'est ce qu'on peut nommer votre parti contraire, De ce funeste Hymen nous sommes le douaire:
Encor ſuis-je obligee à vos mauuais deſſeins.	Encor suis-je oblige à vos mauvais desseins.
Et i’ayme cette guerre, autant que ie la crains, Puis qu’elle m'a rendu le bien de vostre veuë, Et que cette faueur luy deuoit eſtre deuë;	Et j'aime cette guerre, autant que je la crains, Puis qu'elle m'a rendu le bien de votre vue, Et que cette faveur lui devait être due;
Tout vnpeuple ennemy marche deſſus vos pas, Vous luy ſacrifiez, voſtre natale terre, Enfin, ſans vous, mon fils, ie n’aurois pas la guerre, Mais, ſans la guerre außi, ie ne vous aurois pas	Tout vnpeuple ennemi marche dessus vos pas, Vous Seigneur sacrifiez, votre natale terre, Enfin, sans vous, mon fils, ie n'aurais pas la guerre, Mais, sans la guerre aussi, ainsi ne vous aurais pas
POLYNICE Tout vn peuple allié marche deſſus mes pas, Pourme rendre mes droits,& ma natale terre:	POLYNICE Tout un peuple allié marche dessus mes pas, Pourme rendre mes droits, notre natale terre:
Ileſt vray que ſans moy, vous n’auriez pas laguerre, Mais, ſans laguerre außi, ie ne vous aurois pas.	Ilest vrai que sans moi, vous n'auriez pas laguerre, Mais, sans laguerre aussi, quelque ne vous aurais pas.
ÆTEOCLE.	NETEOCLE.
Tout un peuple ennemy martne ueſſus vos pas;	Tout un peuple ennemi martne us vos pas;
Et ne vous rendra point vostre natale terre, Il est vray, que ſans vous, Thebes ſeroit ſans guerre, Mais elle aura la guerre, & vous ne l’aurez pas.	Et ne vous rendra point votre natale terre, Il est vrai, que sans vous, Thebes serait sans guerre, Mais elle aura la guerre, et vous ne l'aurez pas.
7 ſ cO--- l	7 s Ô- l'
IOCASTE.	JOCASTE.
Tout monſang, de frayeur, en mes veines ſe glaſſe:	Tout monsang, de frayeur, en mes veines se glasse:
Ma priere, cruels, n'obtient donc point de grace:	Ma prière, cruels, n'obtient donc point de grâce:
Dlrey peanou sucumamuaune, ayvanx, Et ne puis accorder'mon ſang, auec mon ſang.	Dléirey péanou sucumamuaune, aivanx, Et ne puis accorder'mon sang, auec mon sang,
POLYNICE.	POLYNICE.
Ne vous ſemble-t’il point, que la gloire d’vn Prince Soit d’errer vagabond, de prouince, en prouince, Chaſſé de mes païs, de mes biens, de ma cour;	Ne vous semble-t-il point, que la gloire d'un Prince Soit d'errer vagabond, de province, en province, Chassé de mes pays, de mes biens, de ma cour;
De mon partage encor, dois-ie point de retour?	De mon partage encor, dois-je point de retour?
Que pourroi-ie auoir pis, ſi i'eſtois le parjure, Si j’aüois violé les droits de la nature:	Que pourrais-je avoir pis, si j'étais le parjure, Si j'aüois violé les droits de la nature:
Il faut qu'vn traiſtre regne, & que ie ſois banny, Ajeimte vonpaute, & ue poray puny:	Il faut qu'un traître règne, et que sans sois banni, Aimte vonpaute, et ue porai puni:
Non, non le droit ordonne, en premiere maxime, Le prix à l’innocence, & le ſuplice au crime, Ie dois ſouſtenir l'vne, & l’aûtre l’eſtouffer.	Non, non le droit ordonne, en première maxime, Le prix à l'innocence, et le suplice au crime, Je dois soutenir l'une, et l'aûtre l'étouffer.
Et le droit que ie veux eſt au bout dece fer.	Et le droit que personne veux est au bout dece fer.
ÆTEOCLE.	NETEOCLE.
Qu'unbraüe parléhaut!	Qu'unbraue parléhaut!
OLYNICE.	OLYNICE.
u'vn traſſtre tard ſefachel	Ju'un trasstre tard sefachel
ÆTEOCLE.	NETEOCLE.
Souuent telbraue tremble,	Souvent telbrave tremble,
POLYNICE.	POLYNICE.
Et plus ſouuent un lâche.	Et plus souvent un lâche.
2	2
EPDOOLE, Ce cœur ſi haut m'eſtonne,	ÉPDOLE, Ce cœur si haut m'étonne,
POLYNICE.	POLYNICE.
Et moy, le tienſibas,	Et moi, le tiensibas,
ÆTEOCLE.	NETEOCLE.
L'effet le monſtrera:	L'effet le montrera:
POLYNICE.	POLYNICE.
Tu ne te haſtespas.	Tu ne te hâtespas.
IOCASTE.	JOCASTE.
Quelle gloire, bons Dieux I'ou pluſtot, quelle rage, A faillir le premier met le plus de courage?	Quelle gloire, bons Dieux J'ou plutôt, quelle rage, A faillir le premier met le plus de courage?
La valeur eſt honteuſe en pareil differend, Et lagloire appartient à celuy qui ſe rend:	La valeur est honteuse en pareil différend, Et lagloire appartient à celui qui se rend:
22.	22.
Ie ſçay qu’à voſtre teſte il faut vne couronne, Mais quehora de chez nous uôtre main vous la dõne:	Je sais qu'à votre tête il faut une couronne, Mais quehora de chez nous uôtre main vous la dõne:
Paut-il que d''un ſeullieu vos deſſeins ſoientbornez:	Paut-il que d''un seullieu vos desseins soientbornés:
E Et ne ſçaurois-ie auoir deux enfans couronnez?	 Et ne saurais-je avoir deux enfants couronnés?
Montez, le ferenmain, les rochers de Tymole,!	Montez, le ferenain, les rochers de Tymole,!
Soumettez-vous les lieux que dore le Ractole:	Soumettez-vous les lieux que dore le Ractole:
Oſez, ce qu'ont oſé tant, d’autres conquerans, Tenez, tout de vous ſeul, & rien de vos parens;	Osez, ce qu'ont osé tant, d'autres conquérants, Tenez, tout de vous seul, et rien de vos parents;
Encor, en tiendrez-vous, ce grand cœur en partage, Ce cœur qui vous peut faire un ſubel heritage, Qui vous peut aubeſoin donner vnſi beau rang, Sans, que vous le cherchiez, dans voſtre propre ſang.	Encor, en tiendrez-vous, ce grand cœur en partage, Ce cœur qui vous peut faire un subel héritage, Qui vous peut aubesoin donner un beau rang, Sans, que vous le cherchiez, dans votre propre sang.
POLINICE Que Thebes luy demeure, & que ie me retire!	POLINICE Que Thebesîle demeure, et que tu me retire!
duel.	duel.
dndo lll.	dndo lll.
Thebes, vous le ſçaueZ, eſt vnfatal Empire:	Thebes, vous le savez, est unfatal Empire:
Et ſontroſne eſt on neu bien funeſte à ſon Roy, Les exemples de Laye, & d'Oedipe en font foy.	Et sontrône est on neu bien funeste à son Roi, Les exemples de Laye, et d'Oedipe en font foi.
POLYNIGE Vn autre encorbien toſt le fera mieux paroiſtres	POLYNIGE Un autre encorbien tôt le fera mieux paraîtrez
IOCASTE.	JOCASTE.
Cruell de voſtre frerer	Cruell de votre frérer
IOCASTE.	JOCASTE.
Quelle obstination?	Quelle obstination?
POLYNICE.	POLYNICE.
Quelle infidelité!	Quelle infidélité!
IOCASTE.	JOCASTE.
Mais quoy?	Mais quoi?
ſonregne plaist, le vostre eſt redouté .	sonregne plaît, le vôtre est redouté .
Ila gagné les cœurs,	Ila gagné les cœurs,
POLYNICE.	POLYNICE.
Et moy, moins põpulaire.	Et moi, moins pouvulaire.
Ie tiens indifferend, d’eſtre craint, ou de plaire Quiregne, aymé des ſiens, en est moins abſolu:	Je tiens indifférend, d'être craint, ou de plaire Quiregne, aimé des siens, en est moins absolu:
Oer timuiuntampt ſouuent ce qu’ilareſolu:	Oer timuiuntampt souvent ce qu'ilarésolu:
Plus est permis aux Roys, à qui plus on s’oppoſe, Vne lâche douceur aux mépris les expoſe;	Plus est permis aux Rois, à qui plus on s'oppose, lâche douceur aux mépris les expose;
Le peuple, trõp aiſé, les lie enles amant, Il faut, pour estre aimé, regner trop mollement.	Le peuple, tromme aisé, les lie enles amant, Il faut, pour être aimé, régner trop mollement.
IOCASTE.	JOCASTE.
L’amour de ſes ſubjets, est on joit gurde.	L'amour de ses sujets, est on jait gurde.
POLYNICE.	POLYNICE.
Souuent qui trop ſe fie, außi trop ſe hazarde:	Souvent qui trop se fie, aussi trop se hasarde:
Mais ne m'oppoſeZ plus d’inutiles àuis;	Mais ne m'opposez plus d'inutiles àuis;
L-.	L-.
.	.
Parle, ma paßion, les tiens ſeront ſuiuis:	Parle, ma passion, les tiens seront suivis:
Paſſe au dernierexcés que peut faire paroiſtre L’amour d’vne Couronne, & la haine d’un traiſtre;	Passe au dernierexcés que peut faire paraître L'amour d'une Couronne, et la haine d'un traître;
Ie ne puis d’aucun prix, tant fut-il inſiny, Voir l’vne trop payée, & l’autre trop puny.	Je ne puis d'aucun prix, tant fut-il insiny, Voir l'une trop payée, et l'autre trop puni.
IOCASTE.	JOCASTE.
Bien, puis que ny ſanglots;	Bien, puis que ici sanglots;
ny prieres, ny larmes, Ne peuuent de vos mains faire tomberles armes:	Il prières, Seigneur larmes, Ne peuvent de vos mains faire tomberles armes:
Et, qu'auecques raiſon, ie vous puis reprocher, Que vous porteZ vn cœur außi dur qu'vn rocher:	Et, qu'avec raison, je vous puis reprocher, Que vous portez un cœur aussi dur qu'un rocher:
Ie conjure, des Dieux ila puiſſance ſupréme, De me faire venger par vostre reſus méme;	Je conjure, des Dieux ila puissance suprême, De me faire venger par votre ressus même;
Et vous ſouhaite encor quelque mal-heur plus grand, Que celuy que promet ce mortel differend.	Et vous souhaite encor quelque malheur plus grand, Que celui que promet ce mortel différend.
Vne inuincible ardeur en mes veines s’allume, Qui d'vn ſecret effort, iuſqu'aux os me conſume:	Une invincible ardeur en mes veines s'allume, Qui d'Un secret effort, jusqu'aux os me consume:
Ma conſtance eſt à bout, la Nature junruiſt, uquremip peques & ummui-heur me plaiſt.	Ma constance est à bout, la Nature junruist, uquremip péques et ummuiheur me plaît.
Adieu, non plus mes fils, mait odieuſes pestes, Et deteſtables fruits de meurtres & d’inceſtes:	Adieu, non plus mes fils, mait odieuses pestes, Et détestables fruits de meurtres et d'incestes:
Vous ne mourez pas ſeuls, & ie ſuiuray vos pas, Pour vous perſecuter, meſme apres le trépas,	Vous ne mourez pas seuls, et Seigneur suivrai vos pas, Pour vous persécuter, Seigneur après le trépas,
1.	1.
CHEF DES GRECS.	CHEF DES GRECS.
Son entremiſe eſt vain .	Son entremise est vain .
an	an
HEMON.	HÉMON.
O constance barbare!	Ô constance barbare!
CREON á ÆTEOCLE.	CRE ÆTEOCLE.
Enfin, le champ eſt libre, & rien ne vous ſepare.	Enfin, le champ est libre, et rien ne vous sépare.
Qui ne preſſe affoiblit l’effet des grands projets, Vengez,nous, vengez-vous, & vengéz vos ſujets.	Qui ne presse affaiblit l'effet des grands projets, Vengez,nous, vengez-vous, et vengéz vos sujets.
ÆTEOCLE.	NETEOCLE.
Vostre intereſt, Creon, vous meut plus que magloire, Vous preſſeZ le combat, & craigneZ la victoire:	Votre intérêt, Creon, vous meut plus que magloire, Vous priez le combat, et craignez la victoire:
Vous ſçauez qu’apres nous, le Sceptre des Thebains, Par ordre, & droit de ſang, doit tomber en vos mains:	Vous savez qu'après nous, le Sceptre des Thébains, Par ordre, et droit de sang, doit tomber en vos mains:
Mais les garde le Ciel de voſtre tyranie, Voicy parquoy ſera voſtre attente banie;	Mais les garde le Ciel de votre tyranie, Voici parquoi sera votre attente banie;
Omiquiesis pree ymcunmt pins ſpacieux, D’ou l vn, & l’autre camp nous conſidere mieux, Et que le ſort apres conduiſe l’auanture?	Omiquiesis pree ymcunt pins spacieux, D'ou l un, et l'autre camp nous considère mieux, Et que le sort après conduise l'aventure?
Faiſons toſt.	Faisons tôt.
POLYNICE.	POLYNICE.
HEMON Les ſuiuant.	HÉMON Les suivant.
O journée, honteuſe à la nature;	Ô journée, honteuse à la nature;
E iij	 Ejà
24 mſXI SCENE PREMIERE.	24 mXI SCÈNE PREMIÈRE.
ANTIGONE, En deuil dans ſa chambre.	ANTIGONE, En deuil dans sa chambre.
Nconſtante Reyne du monde, Qui faits tout par aueuglement, Sans deſſein, & ſans fondement, Et ſur qui toutefois, toute choſe ſe fonde:	Néconstante Reine du monde, Qui faits tout par aveuglement, Sans dessein, et sans fondement, Et sur qui toutefois, toute chose se fonde:
Pouſſe tarouë, & ne te laſſe pas, Fais que ſon tour s’acheue, Il faudra qu’elle nous releue, Apres nous auoir mis ſi bas.	Pousse taroue, et ne te lasse pas, Fais que son tour s'achève, Il faudra qu'elle nous relève, Apres nous avoir mis si bas.
Tels, que d’vne mer agitée, On voit les flots s’entre-ſuiuans, Se fuir apres, au gré des vents,	Tels, que d'une mer agitée, On voit les flots s'entre-suivants, Se fuir après, au gré des vents,
Et ne tenir iamas vne aßiette arreſtée:	Et ne tenir jamas une assiste arrêtée:
Tel eſt ton ordre:	Tel est ton ordre:
aux biens que tu nous faits, Tu nous careſſes, tu nous frappes, Tu viens à nous, tu nous echappes, Et tune t'arreſtes iamais:	aux biens que tu nous faits, Tu nous caresses, tu nous frappes, Tu viens à nous, tu nous échappes, Et tune t'arrêtes jamais:
Mais, pourquoy, trompeuſe Deeſſe, S’il eſt vray que tu n'as point d’yeux;	Mais, pourquoi, trompeuse Déesse, S'il est vrai que tu n'as point d'yeux;
Est-ce plutoſt a de hauts lieux, Qu'à des toicts de Bergers que ta rigueur s'’adreſſe, Tu ne peux voir ſur la teſte d’vn Roy, L’éclat que tu luy donnes, Et qui tient de toy des Couronnes, A touſiours guerre auecques toy.	Est-ce plutôt a de hauts lieux, Qu'à des toits de Bergers que ta rigueur s'adresse, Tu ne peux voir sur la tête d'un Roi, L'éclat que tu lui donnes, Et qui tient de toi des Couronnes, A toujours guerre avec toi.
HEMON.	HÉMON.
ANTIGONE.	ANTIGONE.
Al.	Al.
ANTIGONE.	ANTIGONE.
V reuiens ſeul, Hemon, ô ſiniſtre preſage!	V reviens seul, Hémon, ô sinistre présage!
Qenmanjommanntraits de tonviſage,	Quenmanjommanntraits de tonvisage,
HEMON, Il vous faut diuertir par vn autre entretien;	HÉMON, Il vous faut divertir par un autre entretien;
ANTIGONE, Helas!	ANTIGONE, Hélas!
tu me dis tout, enne me diſant rien.	tu me dis tout, enne me disant rien.
HEMON.	HÉMON.
Madame, ie croyois que la commune plainte Vous euſt deſialiuré cette ſenſible attainte, Et fut cauſe du deüil que ie rencontre icy.	Madame, Seigneur croyais que la commune plainte Vous eût desialiuré cette sensible attainte, Et fut cause du deuil que Seigneur rencontre ici.
ANTIGONE.	ANTIGONE.
Eteocle est doncmort?	Éteocle est doncmort?
HEMON.	HÉMON.
HEMON.	HÉMON.
Et Polynice außi.	Et Polynice aussi.
Faites, à ce grand cœur, faire vn effort extreſme, Oppoſez la Nature à la Nature meſme:	Faites, à ce grand cœur, faire un effort extrême, Opposez la Nature à la Nature même:
Lemuy don tet mamune peur eſſre leger, Mais la part que i'y prens le doit bien alleger.	Lemuy don tet mamune peur essre léger, Mais la part que j'y prends le doit bien alléger.
ANTIGONE.	ANTIGONE.
O prodige!	Ô prodige!
ô combat!	ô combat!
digne de ſon yſſuë, Ou plus que les vaincus, la Nature eſt vaincuë.	digne de son issue, Ou plus que les vaincus, la Nature est vaincue.
Ou le crime s'eſt vù par le crime étouffer, Ou l’impieté ſeule a droit de triompher:	Ou le crime s'est vù par le crime étouffer, Ou l'impiété seule a droit de triompher:
Paſes-men le reln,	Pases-men le relân,
HEMON.	HÉMON.
Voſtre douleur, peut-eſtre	Votre douleur, peut-être
ANTIGONE.	ANTIGONE.
Non, elle eſt en vn poinct, où rien ne peut l’accroitre, Mes ſens, parſonexcez, ſont demeureZ perclus, Pour la trop reſſentir, ie ne la reſſens plus.	Non, elle est en un point, où rien ne peut l'accroître, Mes sens, parsonexcès, sont demeurez perclus, Pour la trop ressentir, je ne la ressens plus.
HEMON.	HÉMON.
Quand leur haine obſtinée, eut rendu de la Reyne Le pouuoir ſans effet, & la priere vaine:	Quand leur haine obstinée, eut rendu de la Reine Le pouvoir sans effet, et la prière vaine:
Et qu’au champ du combat, chacun d’eux conſentit, Larage s'y vint rendre, & Nature en ſortit;	Et qu'au champ du combat, chacun d'eux consentit, Larage s'y vint rendre, et Nature en sortit;
Pareils à deux lyons, & plus cruels encore, Du geſte, chacun d’eux, l’vn l’autre ſe deuore:	Pareils à deux lions, et plus cruels encore, Du geste, chacun d'eux, l'vn l'autre se dévore:
Auant qu’en eſtre aux mains, ils combattẽt des yeux, Et ſe lancent, d’abord, cent regards furieux:	Avant qu'en être aux mains, ils combattent des yeux, Et se lancent, d'abord, cent regards furieux:
Enfin, d’vnmaintien graue, & d’vne voix altiere:	Enfin, d'unmaintien grave, et d'une voix altière:
Polyniçe, tout haut pouſſe cette priere:	Polyniçe, tout haut pousse cette prière:
O Dieux!	Ô Dieux!
ſi quelque-fois vous conſenteZ au mal, Quand il ſemble ordonné par vn decret fatal, Et qu’onen peut nommer lacauſe legitime, Guidez ce bras vengeur, & ſouſteneZ mon crime:	si quelquefois vous consentez au mal, Quand il semble ordonné par un décret fatal, Et qu'on peut nommer lacause légitime, Guidez ce bras vengeur, et soutensez mon crime:
Apres, pour l’expier à moy-meſme inhumain, Dedans mon propre ſang ie laueray ma main:	Après, pour l'expier à moi-même inhumain, Dedans mon propre sang toujours lauerai ma main:
Si ce traiſtre y peut voir leſcentre qu’il me nie, Auant que de ſon corps ſon ame ſoit bannie:	Si ce traître y peut voir lescentre qu'il me nie, Avant que de son corps son âme soit bannie:
Et s’il peut, enmourant, emporter auec ſoy, Le regret de ſçauoir que ie ſuruïue Roy.	Et s'il peut, enmourant, emporter avec soi, Le regret de Savoir que ici suruïue Roi.
Là commence l’apt roche, où l’ardeur qui les preſſe, Pratique aux premiers coups quelque art & quelque adreſſe, Ils paſſent ſans effet, & d’vne, & d’autre part, Mais bien toſt la fureur l’emporte deſſus l’art, Chacun voulant porter, & chacunvoulant rendre:	Là commence l'apt roche, où l'ardeur qui les presse, Pratique aux premiers coups quelque art et quelque adresse, Ils passent sans effet, et d'une, et d'autre part, Mais bien tôt la fureur l'emporte dessus l'art, Chacun voulant porter, et chacunvoulant rendre:
Quitte, pourattaquer le ſoin de ſe deffendre, Et tous deux, tout danger à leur rage ſouſmis, S’ex poſent außi nuds que s’ils eſtoient amis:	Quitte, pourattaquer le soin de se défendre, Et tous deux, tout danger à leur rage soumis, S'ex posent aussi nus que s'ils étaient amis:
Mais apres que pareils;	Mais après que pareils;
de force,& de courage, Ils ont gardé long-temps un égal aduantage, De Polynice, en fin, le ſort guide le bras, at pouſſe ontougmoret, qui porte l’autre à bas.	de force,et de courage, Ils ont gardé longtemps un égal avantage, De Polynice, en fin, le sort guide le bras, at ousse ontougmoret, qui porte l'autre à bas.
ANTIGONE.	ANTIGONE.
Et le Ciel, à ce crime, a preſté ſa lumiere!	Et le Ciel, à ce crime, a prêté sa lumière!
HEMON.	HÉMON.
Le Roy tombe, & ſon ſang coule ſur la pouſiere, Mais en ſa cheute encor ſa haine ſe ſoutient Et ſon cœur veut eclore vn eſpoir qu’il retient:	Le Roi tombe, et son sang coule sur la pousière, Mais en sa chute encor sa haine se soutient Et son cœur veut éclore un espoir qu'il retient:
Couleur, ny mouuement ne reſte à ſon viſage, Il ſemble que des ſens ilait perdu l’vſage:	Couleur, ni mouuement ne reste à son visage, Il semble que des sens ilait perdu l'usage:
Ille reſerue tout pour un dernier effort, Et ſçait encor tromper dans les bras de la mort, Polynice, rauy d’vne fauſſe victoire, Dont bien toſt ſa deffaite effacera la gloire, Leuant les mains au Ciel, s’écrie à haute voix, SoyeZ benis, ô Dieux, iuſtes iuges des Roys:	Ille réserve tout pour un dernier effort, Et sait encor tromper dans les bras de la mort, Polynice, ravi d'une fausse victoire, Dont bien tôt sa défaite effacera la gloire, Leuant les mains au Ciel, s'écrie à haute voix, Soyez bénis, ô Dieux, jusqu' ices des Rois:
Thebes, deſſus mateſte, apporte ta Couronne, Elle eſt mienne, & le ſang par deux fois me la donne;	Thebes, dessus mateste, apporte ta Couronne, Elle est mienne, et le sang par deux fois me la donne;
Apporte, ceſte veuë haſtera ſon treſpas, Ma teſte acheuera l’office de mon bras.	Apporte, cette vue hâtera son trépas, Ma tête achèvera l'office de mon bras.
Il s’approche à ces mots, luy veut oſter l’eſpée, Mais ſa maineſt à peine, à cette œuure occupéc:	Il s'approche à ces mots, lui veut ôter l'épée, Mais sa mainest à peine, à cette œuvre occupéc:
Que l’autre ramaſſant vnreſte de vigueur, Que la haine entretient à l’entour de ſon cœur:	Que l'autre ramassant après de vigueur, Que la haine entretient à l'entour de son cœur:
Retire vn peu le bras, puis le pouſſant d’adreſſe,	Retire un peu le bras, puis le poussant d'adresse,
Pagination incorrecte - date incorrecte NF 2 43-120-12	Pagination incorrecte - date incorrecte N 2 43-120-12
Luy met le fer au ſein, que mourant il y laiſſe;	Lui met le fer au sein, que mourant il y laisse;
Polynice, à ce coup, mortellement atteint, Vne froide pâleur s'emparant de, ſonteint:	Polynice, à ce coup, mortellement atteint, froide pâleur s'emparant de, sonteint:
Quoy, tarage, dil-il;	Quoi, tarage, dil-il;
n’eſt donc pas aſſouuie, Et tes deſloyautez, ont ſuruécu ta vie, Ta perfidie arreſte où ton ame n’eſt pas:	n'est donc pas assouuie, Et tes déloyautés, ont survécu ta vie, Ta perfidie arrête où ton âme n'est pas:
Atten-moy, traiſtré, atten, ie vais ſuiure tes pas:	Atten-moi, traistré, atten, votre vais suivre tes pas:
Et plus ton ennemy que ie ne fus enterre, Te porter chés les morts vne immortelle guerre, Là nos ames feront, ce qu'icy font nos corps, Nous nous battõs viuans, & nous nous batrõs morsAuecque ce diſcours, il acheue ſa vie, Lalumiere, à ſes yeux, eſt pour iamais rauie;	Et plus ton ennemi que ainsi ne fus enterre, Te porter chez les morts une immortelle guerre, Là nos âmes feront, ce qu'ici font nos corps, Nous nous battõs vivants, et nous nous mors morsAuecque ce discours, il achève sa vie, Lalumiere, à ses yeux, est pour jamais ravie;
Et nous, le cœur tranſi de frayeur, & d’ennuy, Demeurons, ſur le champ, preſque außi morts que luy.	Et nous, le cœur transi de frayeur, et d'ennui, Demeurons, sur le champ, presque aussi morts que mille.
ANTIGONE, Que voſtre mort, ma mere, eſt vnbien que i’enuie, Et qu’il me ſeroit doux de vous auoir ſuiuie:	ANTIGONE, Que votre mort, ma mère, est vnbien que j'envie, Et qu'il me serait doux de vous avoir suivie:
VeneZ voir, cher Hemon, ſi le Cielen courroux, Peut lâcher quelque trait, qu’il n’ait lâché ſur nous EntreZ en cette chambre.	VeneZ voir, cher Hémon, si le Cielen courroux, Peut lâcher quelque trait, qu'il n'ait lâché sur nous Entrez en cette chambre.
.	.
	
TORNA XII ISMENE, ANTIGONE,	TORNA XII ISMENE, ANTIGONE,
ISMENE.	ISMENE.
Barbare ſentence!	Barbare sentence!
ANTIGONE.	ANTIGONE.
Quel ennuy doit encor éprouuer ma conſtance.	Quel ennui doit encor éprouver ma constance.
ROMMENE.	ROMMENE.
Sçauez-vous du combat le ſucceZ mal-heureux?	Savez-vous du combat le succès malheureux?
ANTIGONE.	ANTIGONE.
Oüy, digne de leur rage, & funeſte à tous deux.	Oui, digne de leur rage, et funeste à tous deux.
ISMENE.	ISMENE.
SçaueZ-vous que Creon ſuccede à la Couronne;	Savez-vous que Creon succède à la Couronne;
	
F iij	 Fij
ANTIGONE.	ANTIGONE.
2 C est vnbien qu'onluy doit, & que le ſang luy donne.	2 Ç est vnbien qu'onlui doit, et que le sang lui donne.
ISMENE.	ISMENE.
Sçauez-vous la rigüeur de ſon premier Edit?	Savez-vous la rigueeur de son premier Édit?
43 ANTACONE.	43 ANTACONE.
Non, Hemon eſt icy, qui ne m’en a rien dit.	Non, Hémon est ici, qui ne m'en a rien dit.
ISMENE.	ISMENE.
Il fait d’vn acte impie vn acte de iuſtice, Il deffend d’inhumer le corps de Polynice:	Il fait d'un acte impie un acte de justice, Il défend d'inhumer le corps de Polynice:
Er atciuran ce Printe cuncmyuet Epas, Condamne l’infracteur, comme d’vn attentat:	Er atciuran ce Prinîte cuncmiuet Épas, Condamne l'infrateur, comme d' attentat:
DGEEE IV HEMON, ISMENE, ANTIGONE.	DGE IV HEN, ISMENE, ANTIGONE.
HEMUN.	HÉMUN.
ERTES, jamais le ſort n’a ſur humaine race Tant verse, pour vn iour, de peine & de diſ grace.	ERTES, jamais le sort n'a sur humaine race Tant verse, pour un jour, de peine et de dis grâce.
sume Him Jel siesiinei.	sume Him Jel siesiinei.
ANTIGONE.	ANTIGONE.
Vous voyez enſa mort, vne œuure de ſa main:	Vous voyez ensa mort, une œuvre de sa main:
Heureuſe, & douce mort, puis qu’elle à ſceu parelle, De celle de ſes fils, préuenir la nouuelle:	Heureuse, et douce mort, puis qu'elle à su parelle, De celle de ses fils, prévenir la nouvelle:
VoyeZ ſi ma conſtance a dequoy s’exercer, Mais ma peine, ou ma vie, enfin pourra ceſſer:	VoyeZ si ma constance a dequoy s'exercer, Mais ma peine, ou ma vie, enfin pourra cesser:
Cette raiſon, au moins, en mon mal me conforte, Que s’il n’eſt ſupportable, il faudra qu’il m’emporte:	Cette raison, au moins, en mon mal me conforte, Que s'il n'est supportable, il faudra qu'il m'emporte:
11.	11.
e Qine yeigumquobormmis uujourd huy Vn peu de ſolitude à ce cruel ennuy, Et me prouuez la part que vous y daigneZ prendre, En laiſſant à mes pleurs le temps de ſe répandre,	 Qine yéigumquobormis ujourd' hui Ven peu de solitude à ce cruel ennui, Et me prouvez la part que vous y daignez prendre, En laissant à mes pleurs le temps de se répandre,
HEMON.	HÉMON.
Ie ſerois plus cruel que vos propres douleurs, Si ie vous deſniois la liberté des pleurs.	Je serais plus cruel que vos propres douleurs, Si ie Vous déniais la liberté des pleurs.
Adieu;	Adieu;
mais treuuez bon qu’ence mal-heur extréme, Ie vous laiſſe vous-meſme à garder à vous-méme:	mais trouvez bon qu'ence malheur extrême, Je vous laisse vous-même à garder à vous-même:
Domptez de voſtre ſort l’implacable courroux, Et que voſtre vertu me reſponde de vous.	Domptez de votre sort l'implacable courroux, Et que votre vertu me réponde de vous.
C- ---.	Ç- -mo-.
SCLNVE ANTIGONE, ISMENE.	SCLNVE ANTIGONE, ISMENE.
ANTIGONE.	ANTIGONE.
NESTbien viſiblement, ma ſœur, ma chere Iſmene, Que le Ciel aujourd’huy nous declare ſa haine, Et que ſon bras vengeur, pouſsé parſoncourroux, Pourſuit encore Oedipe, & le punit en nous;	NESTbien visiblement, ma sœur, ma chère Ismene, Que le Ciel aujourd'hui nous déclare sa haine, Et que son bras vengeur, poussé parsoncourroux, Poursuit encore Oedipe, et le punit en nous;
Sa parricide erreur nous fut vn coup funeſte, Et Vierges, nous portons la peine d’vn inceſte, Nos deux freres ſont morts, ma mere ſuit leurs pas, Et le Ciel toutefois ne ſe ſatisfait pas, Il ſuſcite vn Tyran, eſleué par leur cheute, Dont le regne inſolent deſia nous perſecute, Qui veut priuer les morts du repos des tombeaux, Et vouer noſtre ſang à la ſoif des corbeaux.	Sa parricide erreur nous fut un coup funeste, Et Vierges, nous portons la peine d'un inceste, Nos deux frères sont morts, ma mère suit leurs pas, Et le Ciel toutefois ne se satisfait pas, Il suscite un Tyran, élevé par leur chute, Dont le règne insolent déjà nous persécute, Qui veut priver les morts du repos des tombeaux, Et vouer notre sang à la soif des corbeaux.
ISMENE.	ISMENE.
On dreſſe, par ſon ordre, vn appareil celebre, Pour honorer le Roy de la pompe funebre U Et comme vn deffenſeur, de l’Eſtat, & des ſiens, Illuy fait decerner les honneurs anciens:	On dresse, par son ordre, un appareil célèbre, Pour honorer le Roi de la pompe funèbre V Et comme un défenseur, de l'État, et des siens, Illui fait décerner les honneurs anciens:
Mais il veut que cent ans l’autheur de cette guerre,  Ombre vaine, & plaintiue aux noirs riuages erre;	Mais il veut que cent ans l'auteur de cette guerre, Ombre vaine, et plainue aux noirs rivages erre;
Et deffend que ſon corps, ſans d’Oedipe & de nous, Ait d’autre monument que le ventre des loups:	Et défend que son corps, sans d'Oedipe et de nous, Ait d'autre monument que le ventre des loups:
Telle qu'eſt cette loy, telle eſt außi la peine, uu premtroveuuuple, Qnuuucep mhumaine.	Telle qu'est cette loi, telle est aussi la peine, u premtroveuuuple, Qnucep mhumaine.
Car entr'elles il met ce funeſte rapport, Qu'onenterrera vif, qui l’enterrera mort.	Car entr'elles il met ce funeste rapport, Qu'onenterrera vif, qui l'enterrera mort.
y	y
ANTIGONE.	ANTIGONE.
L’ordonnance auec ſoy, porte ſa fin ex preſſe;	L'ordonnance avec soi, porte sa fin ex presse;
C’eſt à nous qu'elle parle, à nous qu'elle s’adreſſe:	C'est à nous qu'elle parle, à nous qu'elle s'adresse:
La racine arrachée, & les arbres deſtruits, Le cruel veut encore exterminer les fruits.	La racine arrachée, et les arbres détruits, Le cruel veut encore exterminer les fruits.
Or il eſt temps, ma ſœur, de monſtrer qui nous ſommes, Et qui peut plus ſur nous, ou des Dieux, ou des hommes;	Or il est temps, ma sœur, de montrer qui nous sommes, Et qui peut plus sur nous, ou des Dieux, ou des hommes;
C’eſt icy que le ſang, & la condition Ne nous permettent pas vne lâche action, La vertu doit icy forcer la tyrannie, Peut-estre que plus foible elle ſera punie:	C'est ici que le sang, et la condition Ne nous permettent pas une lâche action, La vertu doit ici forcer la tyrannie, Peut-être que plus faible elle sera punie:
Mais de tant de tourmens, que nous liure le ſort, Il ne peut, apres tout, arriuer qu'vne mort:	Mais de tant de tourments, que nous livre le sort, Il ne peut, après tout, arriver qu'une mort:
Enfin, expres, ma ſœur, i'ay voulu qu'Hemon meſQui prend mes intereſts, & qui ſans feinte m’aime;	Enfin, exprès, ma sœur, j'ai voulu qu'Hémon mesQui prend mes intérêts, et qui sans feinte m'aime;
Pour ne s’oppoſer pas à ce triſte deuoir, Etoms imiſumiemen nore 5& neupan nen ſcauoir.	Pour ne s'opposer pas à ce triste devoir, Etoms imisumiemen nore 5 neupan nen savoir.
ISMENE.	ISMENE.
Dieux!	Dieux!
que propoſez-vous?	que proposez-vous?
& que pouuons-nous ſaasre , Qui ne ſoit inutile au repos de mon frere?	et que pouvons-nous saâtre , Qui ne soit inutile au repos de mon frère?
auls dAseNay Acquittons-nous, au moins, ſelon noſtre pouuoir.	auls dAseNai Acquittons-nous, au moins, selon notre pouvoir.
ISMENE.	ISMENE.
Mais, ma ſœur, l’impuiſſance excuſe le deuoir:	Mais, ma sœur, l'impuissance excuse le devoir:
ANTIGONE.	ANTIGONE.
Quoy, om deſenae &von a onſ puux ouurage:	Quoi, om désénae etvon a ons puux ouvrage:
ISMENE.	ISMENE.
qp'iumome pun quio mpun couraige.	Oqp'iumome pun quio mpun couraige.
ANTIGONE.	ANTIGONE.
Quand l’vne peut manquer, l’autre est bienimpar.	Quand l'une peut manquer, l'autre est bienimpar.
fait.	fait.
A	À
ISMENE.	ISMENE.
Que profite vneſpoir qui n’obtient point d’effet T.	Que profite unespoir qui n'obtient point d'effet T.
IE LLE ss-	JE LLE ss-
ANTIGONE.	ANTIGONE.
Ences precaulions la fomieſſe eſt viſible.	Ences précaulions la fomiesse est visible.
ISMENE.	ISMENE.
La promptitude außi, bien ſouuent eſt ſnuiſible.	La promptitude aussi, bien souvent est snuisible.
ANNTOONE.	ANNTONE.
Pour vn acte ſi iuste, auoir le cœur ſi bas:	Pour un acte si juste, avoir le cœur si bas:
ISMENE.	ISMENE.
IOnuuoj mipomuuomuy quua Creon ne l’eſt pas.	IOnvoj mer mi Creon ne u'est pas.
	
ANTIGONE.	ANTIGONE.
Et s’il eſt inhumain, ſereZ-vous inhumaine?	Et s'il est inhumain, serez-vous inhumaine?
	
ISMENE.	ISMENE.
I’abhorre l’ordonnance, & redoute la peine:	J'abhorre l'ordonnance, et redoute la peine:
ANTIGONE.	ANTIGONE.
Le deſſeinſans effet, eſt außi ſans merite.	Le desseinsants effet, est aussi sans mérite.
ISMENE.	ISMENE.
Mais le deſſeinſuffit, ſi l’effet ne profite.	Mais le desseinsuffit, si l'effet ne profite.
ANTIGONE.	ANTIGONE.
N’eſt-ce pas profiter, que d’inhumer les morts:	N'est-ce pas profiter, que d'inhumer les morts:
.	.
.	.
.	.
.	.
	
ISMENE.	ISMENE.
Non, car Creon, en fin, rendroit vains nos efforts,	Non, car Creon, en fin, rendrait vains nos efforts,
ANTIGONE.	ANTIGONE.
DemeureZ donc, Iſmene, & ſauuez-vous la vie, Comme vn treſorbienrare, & bien digne d’enuie;	Demeurez donc, Ismene, et sauvez-vous la vie, Comme un tresorbienrare, et bien digne d'envie;
Nos iours ſont, en effet, ſi bien traitez du ſort, Que vous aueZ raiſon de redouter la mort.	Nos jours sont, en effet, si bien traités du sort, Que vous avez raison de redouter la mort.
ISMENE.	ISMENE.
ConſidereZ ma ſœur, que reſtant ſans deffenſe, Le pur rebut du ſort, & la meſme impuiſſance;	Considérez ma sœur, que restant sans défense, Le pur rebut du sort, et la même impuissance;
Filles, pour dire aſſez que nous ne pouuons rien, tau peuu uouiſounom unjouru mij uom ſied bien;	Filles, pour dire assez que nous ne pouvons rien, tau peuv uouisounom unjouru mij ousied bien;
Ce n'eſt pas, qu'eneffet, noſtre ſoin ſe refuſe, Le ſang conuie aſſeZ, mais la foibleſſe excuſe:	Ce n'est pas, qu'eneffet, notre soin se refuse, Le sang convie assez, mais la faiblesse excuse:
Et deſia mon deuoir s'en ſeroit acquitté, S’il ne falloit ceder à la neceßité.	Et déjà mon devoir s'en serait acquitté, S'il ne fallait céder à la nécessité.
ANTIGONE.	ANTIGONE.
Quelque conſentement que vous puißiez produire, Ie vois qu’il pourroit moins me ſeruir, que me nuire, Qui n'eſt pas aſſeuré, trauaille mollement, Et ſonuent deſtruit tout, par le retardement:	Quelque consentement que vous pouviez produire, Je vois qu'il pourrait moins me servir, que me nuire, Qui n'est pas assuré, travaille mollement, Et sonuent détruit tout, par le retardement:
Seul, on s’acquite mieux d’vne grande entrepriſe, Le trauails affoiblit alors qu’il ſe diui EET Laiſſez m’en donc le ſoin, & ſage à vostre ſens, Menate-vons aiu fontt, & prenc Sioy du temps.	Seul, on s'acquite mieux d'une grande entreprise, Le travails affailit alors qu'il se divi CET Laissez m'en donc le soin, et sage à votre sens, Menate-vons aiva fontt, et prenc Sioi du temps.
ISMENE.	ISMENE.
A tumit, utt giunu ccnt, veune grunuc aſſeurance;	A tumit, ut giunu ccnt, veune grunuc assurance;
Mais pour les loix, enfin, i’ay plus de reuerence.	Mais pour les lois, enfin, j'ai plus de révérence.
ANTIGONE.	ANTIGONE.
I'en aurois comme vous, mais i’en vſerois mieux.	J'en aurais comme vous, mais j'en userais mieux.
Cmpouurou quouoiont emenffent pour les Dieux.	Cmpouvrou quouiront emenffent pour les Dieux.
ISMENE.	ISMENE.
Ha!	Ha!
que vous me cauſeZ vne frayeur ecétréme.	que vous me causez une frayeur ecétréme.
ANTIGONE.	ANTIGONE.
Ne m’eſpouuenteZ point, & tremblez pour vousmeſme, i] knt πu,	Ne m'espouuenteZ point, et tremblez pour vousmesme, j' ] kn,
ISMENE.	ISMENE.
Soyez, ſecrette au moins, comme ie vous promets, Que parmoy ce deſſein ne ſe ſauua jamais.	Soyez, secrète au moins, comme je vous promets, Que parmoi ce dessein ne se sauva jamais.
ANTIOSEVE.	ANTIOSEUE.
Si rien eſt à cacher, cachez, vostre foibleſſe, Ie fais gloire pour moy, que ma vertu paroiſſé.	Si rien est à cacher, cachez, votre faiblesse, Je fais gloire pour moi, que ma vertu paraissé.
O.	Ô.
I.	I.
	
ANTIGONE	ANTIGONE
ISMENE.	ISMENE.
Comme dans les dangeis vons vous precipitez.	Comme dans les dangeis vons vous précipitez.
ANTIGONE.	ANTIGONE.
Auec autant d’ardeur que vous les euitez.	Avec autant d'ardeur que vous les évitez.
IOMENE.	JOMENE.
Ie vous l’ay dit cent fois, cette œuure ſera vaine.	Je vous l'ai dit cent fois, cette œuvre sera vaine.
Omens AIg Mais ce n’eſt pas aſſeZ d’entreprendre ardemment.	Oments AIg Mais ce n'est pas assez d'entreprendre ardemment.
L’honneur de l’entrepriſe est enl’euenement.	L'honneur de l'entreprise est enl'événement.
	
ANTIGONE.	ANTIGONE.
Bien, mon pouuoir ceſſant fera ceſſer ma peine.	Bien, mon pouvoir cessant fera cesser ma peine.
ANTICONEI MNona Vos raiſons, comme vous, ſont de ſi peu de force, Que loin de m'arreſter, cét obſtacle m’amorce.	ANTICONEI MNona Vos raisons, comme vous, sont de si peu de force, Que loin de m'arrêter, cet obstacle m'amorce.
Laiſſez indifferend mon bon ou mauuais ſort, Voyez, ſi ie peris, mon nauffrage du port, Pour moy, ie tiens plus chere, & plus digne d’enuie, Vne honorable mort qu'vne honteuſe vie;	Laissez indifférend mon bon ou mauvais sort, Voyez, si je péris, mon nauffrage du port, Pour moi, ie tiens plus chère, et plus digne d'envie, Une honorable mort qu'une honteuse vie;
Et de mes ans, enfin, voir terminer le cours, Ne ſera qu'arriuer où ie vais tous les iours.	Et de mes ans, enfin, voir terminer le cours, Ne sera qu'arriver où a pais tous les jours.
.	.
.	.
.	.
.	.
4-- -:	4- - :
C- –	Ç- „
ISMENE.	ISMENE.
Allez donc, & le Ciel pour vous, & pour mon frere, Conduiſe ce deſſein mieux que ie ne l’eſpere:	Allez donc, et le Ciel pour vous, et pour mon frère, Conduise ce dessein mieux que votre ne l'espère:
Mais vos ſoins, ſi mon cœur ne m’abuſe aujourd’huy, Preparent vn cercueil, plus pour vous que pour luy.	Mais vos soins, si mon cœur ne m'abuse aujourd'hui, Préparent un cercueil, plus pour vous que pour lui.
TMTVE A ARGIE, MENETE, Vieillard, vne lanterne en main, ſur les ramparts où s’eſt fait le combat,	TMTUE A RGIE, MENTE, Vieillard, une lanterne en main, sur les ramparts où s'est fait le combat,
MENETE.	MENETE.
ADAME, vous chercheZ voſtre perte viſible;	ADAME, vous cherchez votre perte visible;
ARGIE.	ARGIE.
C’eſt bien ma perte, helas!	C'est bien ma perte, hélas!
elle m’eſt bien ſenſible.	elle m'est bien sensible.
Ie dis de voſtre vie, ------ o ------ MENETE.	Je dis de votre vie, -- ô --je MENTE.
	
ARGIE.	ARGIE.
Hé!	Hé!
le meſme treſpas Qui l’oste à mon eſpoux, ne m’en priue-t’il pas?	le même trépas Qui l'ôte à mon époux, ne m'en prive-t-il pas?
Menete, voulez-vous qu’en ce mal-heur extréme I'abandonne aux corbeaux la moitié de moy-méme!	Ménète, voulez-vous qu'en ce malheur extrême J'abandonne aux corbeaux la moitié de moi-même!
Et que l’iniuſte arreſt qu’on nous a rapporté, Iuſqu’au repos des morts porte ſa cruauté, Peut-eſtre que deſia Polynice m’accuſe De luy rendre ſi tard l’honneur qu’on luy refuſe:	Et que l'injuste arrêt qu'on nous a rapporté, Jusqu'au repos des morts porte sa cruauté, Peut-être que déjà Polynice m'accuse De avait rendre si tard l'honneur qu'on lui fois:
S’il ne l’a pas, i’ay tort, s’il l’ai’ay tort außi, Car c’eſt à mon deuoir qu'appartient ce ſoucy;	S'il ne l'a pas, j'ai tort, s'il l'aiay tort aussi, Car c'est à mon devoir qu'appartient ce souci;
C'eſt pour ce triſteſoin, dont mon deuoir me preſſe, Que ie me ſuis ſouſtraite aux trouppes de la Grece, Qui, le ſiege leué, par vn bonteux dé part, Souffre cette iniustice, & n'y prend point de part.	C'est pour ce tristesoin, dont mon devoir me presse, Que tu me suis soustraite aux troupes de la Grèce, Qui, le siège leué, par un bonteux dé part, Souffre cette injustice, et n'y prend point de part.
·	
MENETE.	MENETE.
Pour ne nous pus tromper, ne prenons autre voye Que celle des oyſeaux qui vont à cette proye:	Pour ne nous pus tromper, ne prenons autre voie Que celle des oiseaux qui vont à cette proie:
L’infection des corps vient deſia iuſqu à nous:	L'infection des corps vient déjà jusqu' à nous:
Icy furent portez, & rendus tant de coups:	Ici furent portez, et rendus tant de coups:
Voicy le champ fertile en tunt de funerailles, Thebes n'eſt pas fort loin, i’entreuois ſes murailles,	Voici le champ fertile en tunt de funérailles, Thebes n'est pas fort loin, j'entrevais ses murailles,
ARGIE.	ARGIE.
O Thebes!	Ô Thebes!
autrefois l’objet de mes deſirs,	autrefois l'objet de mes désirs,
Maintenant	Maintenant
Maintenant le ſujet de tous mes déplaiſirs, A qui, pourtant le Ciel, ſoit encore propice, Si ta pitié me rend le corps de Polynice:	Maintenant le sujet de tous mes déplaisirs, À qui, pourtant le Ciel, soit encore propice, Si ta pitié me rend le corps de Polynice:
Tu vois en queleſtat, femme, & ſœur de tes Roys, Ie me preſente à toy pour la premiere fois:	Tu vois en quelétat, femme, et sœur de tes Rois, Je me présente à toi pour la première fois:
Voy, perfide cité, quelle pompe enuironne, Celle qui iuſtement pretendoit ta couronne:	Vois, perfide cité, quelle pompe environne, Celle qui justement prétendait ta couronne:
Ce n’eſt pas elle außi qui guide icy mes pas, Et mon ambitionne te dé plaira pas;	Ce n'est pas elle aussi qui guide ici mes pas, Et mon ambitionne te dé plaira pas;
Ie ne cherche qu’vn mort ie ne veux que ſa cendre, Ie ne t’oste qu’vn ſoin que tu ne daignes prendre:	Je ne cherche qu'un mort ie ne veux que sa cendre, Je ne t'ôte qu'un soin que tu ne daignes prendre:
Me le deſnieras-tu?	Me le dénieras-tu?
Rends, cruelle, rends moy Celuy que tu chaſſois, comme indigne de toy;	Rends, cruelle, rends moi Celui que tu chassais, comme indigne de toi;
A qui tu fus perfide autant que legitime, Qui fut ton Roy ſans ſceptre, & tonbanny ſans crime:	À qui tu fus perfide autant que légitime, Qui fut ton Roi sans sceptre, et tonbanni sans crime:
Et toy, monchereſpoux, s’il reſte apres les morts Quelques manes errans allentour de leurs corps, Güide-moy parles tiens à ce funeste office, Que Polynice m'aide à treuuer Polynice, C’eſt toy ſeul que ie cherche ences funeſtes lieux, Daigné, encor vne fois, te monſtrer ames yeux.	Et toi, moncherespoux, s'il reste après les morts Quelques manche errants allentour de leurs corps, Guéride-moi parles tiens à ce funeste office, Que Polynice m'aide à trouver Polynice, C'est toi seul que sans cherche ences funestes lieux, Daigné, encor e fois, te montrer âmes yeux.
DLLIE ANTIGONE, MENETE, VR.	DLLIE ANTIGONE, MENTE, VR.
L ARGIE.	 LRGIE.
MENETE.	MENETE.
DfllE3 vomeneS la douleur qui uous preſſe, Nous ſommes apperçeus, quelqu’vn vers nous s’adreſſe.	DfllE3 vomèneS la douleur qui -vous presse, Nous sommes aperçus, quelqu'un vers nous s'adresse.
Quel deſſein temeraire adreſſe icy tes pare	Quel dessein téméraire adresse ici tes pare
MENETTE.	MENTTE.
Ce qui l’y fait uenir ne vous regarde pas?	Ce qui l'y fait ouvenir ne vous regarde pas?
ANTIGONE.	ANTIGONE.
Vient-elle oſteraux morts les larmes que ie verſe, Et mettre empeſchement à ce triſte commerce, Quelintereſt l’y pouſſe?	Vient-elle ôteraux morts les larmes que je verse, Et mettre empêchement à ce triste commerce, Quelinterest l'y pousse?
& quel eſt ſon ſoucy?	et quel est son souci?
Ce ſoir eſt tout à moy, ſeule i'ay droit icy.	Ce soir est tout à moi, seule j'ai droit ici.
ARGIE.	ARGIE.
Si quelqu’vn de ces morts vous cauſe de la peine, Et ſi, comme ie croy, meſme deſſein nous meine;	Si quelqu'un de ces morts vous cause de la peine, Et si, comme tu crois, même dessein nous mène;
Si meſme de Creon vous craigneZ le courroux, Ie pourray, ſans danger, me declarer à vous:	Si même de Creon vous craignez le courroux, Je pourrai, sans danger, me déclarer à vous:
ætiei femme ,unfoura uny vejue de Potinee, Ie venois, a ſon corps, rendre vn dernier office;	ætie femme ,unfoura uni véjue de Potine, Je venais, à son corps, rendre un dernier office;
Croyant qu'à la faueur du voile de la nuit:	Croyant qu'à la faveur du voile de la nuit:
ANTIGONE, L’embraſſant.	ANTIGONE, L'embrassant.
Eſt-ce Argie?	Est-ce Argie?
ô ma ſœur, quel bon-heur me conduit?	ô ma sœur, quel bonheur me conduit?
Ou plutoſt, quel deſtin à monbon-heur contraire, Fait, que quand ie vous vois, ie ne vois plus mon frere?	Ou plutôt, quel destin à monbon-heur contraire, Fait, que quand ie vous vois, toujours ne vois plus mon frère?
Tant qu’ileut ce plaiſir, ſes ſœurs ne l’eurent point, ot, ioms nous fepurount, & ſon treſpas nous ioint.	Tant qu'ileut ce plaisir, ses sœurs ne l'eurent point, ot, joms nous fepurount, et son trépas nous joint.
Quelque part, que pourvous, mon cœur prist en ſa flamme, Ie ne vois que ſa vefue, & n’ay point veu ſa femme, Enfin, vn meſme ſoin nous fait treuuer icy, Ce qui méne Antigone, ampge Migie außi.	Quelque part, que pourvous, mon cœur prît en sa flamme, Je ne vois que sa vefue, et n'ai point vu sa femme, Enfin, un même soin nous fait trouver ici, Ce qui mette Antigone, ampge Migie aussi.
ARGIE.	ARGIE.
Antigone, ma ſœur, quelle premiere veuë?	Antigone, ma sœur, quelle première vue?
Qui l’euſt imaginée, ou qui l’euſt attenduë?	Qui l'eût imaginée, ou qui l'eût attendue?
Que pour nous la fortune a de fauſſes douceurs,	Que pour nous la fortune a de fausses douceurs,
H ij	H ij
Commençant de nous voir, nous ceſſons d’eſtre ſœurs:	Commençant de nous voir, nous cessons d'être sœurs:
Ie n’ay pû vous monstrer la ſenſible allegreſſe, De me voir iointe à vous, que quand la cauſe en ceſſe;	Je n'ai pu vous montrer la sensible allégresse, De me voir jointe à vous, que quand la cause en cesse;
Encore, ence mal-heur, dois-je benir le ſort, Qui me monſtre laſœur, lors que le frere eſt mort;	Encore, ence malheur, dois-je bénir le sort, Qui me montre lasœur, lors que le frère est mort;
Au deffaut de l’objet, ſonimage, contente, Encorvoy-je de luy quelque choſe viuante:	Au défaut de l'objet, sonimage, contente, Encorvoi-je de soins quelque chose vivante:
puscorps ſurent ſoimeSueuuns on meſme ſlanc, Vous ne fuſtes qu'vn cœur, & qu'vname, & qu'vn ſang.	puscorps surent soimeSueus on même slanc, Vous ne fûtes qu'vn cœur, et qu'Hame, et qu'un sang.
ANTIGONE.	ANTIGONE.
Ce n’eſt pas ſans raiſon que ſa perte m’eſt dure, L'amitié nous ioignoit bien plus que la nature.	Ce n'est pas sans raison que sa perte m'est dure, L'amitié nous joignait bien plus que la nature.
ARGIE.	ARGIE.
Außi, ma chere ſœur, les Dieux m’en ſont teſmoins, Son troſne eſtoit l’Aimant qui l’attiroit le moins;	Aussi, ma chère sœur, les Dieux m'en sont témoins, Son trône était l'Aimant qui l'attirait le moins;
Nyrepos, ny païs, my mere, ny couronne, Ne luy fut en objet, à l’égal d'Antigone;	Nyrepos, ni pays, mi mère, ni couronne, Ne lui fut en objet, à l'égal d'Antigone;
Iour ny nuit n’ont paſſé qu’il ne parlast de vous, Et non ſans que mon cœur en fuſt vn peu jaloux:	Jour ici nuit n'ont passé qu'il ne parlât de vous, Et non sans que mon cœur en fût un peu jaloux:
Car, à voir quelle part, nous auions enſon ame, Ie paroiſſois ſa ſœur, & vous ſembliez, ſa femme:	Car, à voir quelle part, nous avions enson âme, Je paraissais sa sœur, et vous sembliez, sa femme:
Mille fois pour vous voir, il a de ces rempars Deuers Thebes ietté les yeux de toutes parts;	Mille fois pour vous voir, il a de ces rempars Deuers Thebes jeté les yeux de toutes parts;
Mais las!	Mais las!
ilvous a veuë, & cette veuë est vaine, ------ -- 2- tuatas Elle n'adiuerty ſa mort ny noſtre peine:	ilvous a veuë, et cette veuë est vaine, -- -- 2- vous a n'adiuerty et cette vue est vaine,
Nous n’eſperions qu’envous, & contre noſtre eſpoir, Ila pù, ſans fléchir, vous entendre, & vous voir:	Nous n'espérions qu'envous, et contre notre espoir, Ila pù, sans fléchir, vous entendre, et vous voir:
Ils eſt pü, cette fois, deffendre de vos charmes:	Ils est pu, cette fois, défendre de vos charmes:
ANTIGONE.	ANTIGONE.
Helas!	Hélas!
il conſultoit de mettre bas les armes;	il consultait de mettre bas les armes;
Et deſia ſoncourroux eſtoit preſque amorty, Mais, ſi mala propos, Æteocle eſt ſorty, Qu'ilm'a rauy le temps,	Et déjà soncourroux était presque amorti, Mais, si mala propos, Æteocle est sorti, Qu'ilm'a rauy le temps,
AIEMVDIL.	ÀIEMUDIL.
Craignant quelque ſurpriſe Allons chercher le mort, acheuons l’entrepriſe, Et faites qupupuvo nout, unecques vos douleurs.	Craignant quelque surprise Allons chercher le mort, achevons l'entreprise, Et faites quépupuvo nout, unecques vos douleurs.
ANTIGONE, Allons.	ANTIGONE, Allons.
deſſus ſon corps nous répandrons nos pleurs:	dessus son corps nous répandrons nos pleurs:
Son corps, ou fut mon ſang, -*·-	Son corps, ou fut mon sang, -êtr-
ARGIE.	ARGIE.
Son corps, où fut mon ame,:	Son corps, où fut mon âme,:
ANTIGONE.	ANTIGONE.
Quel employ pour ſa ſœur!	Quel emploi pour sa sœur!
ARGIE.	ARGIE.
Quelle nuit pourſa femme!	Quelle nuit poursa femme!
2I.	2I.
SCENE IREMTERE.	SCÈNE IREMTERE.
CREON Roy, CLEODAMAS, EPHYTE, Gentils-hommes du Roy.	CREON Roi, CLÉODAMAS, EPHYTE, Gentilshommes du Roi.
CREON.	CREON.
Nfin l’estat est calme, & les Dieux ont permis Que l’orage tombaſt deſſus nos ennemis:	Nfin l'état est calme, et les Dieux ont permis Que l'orage tombât dessus nos ennemis:
Enſin, Thebes, enfin, la voix de ton Prophete, Des volonteZ des Dieux, eſt fidele interprete, Son Oracle eſt ſuiuy de viſibles effets, La mort de Mænecee a produit cette paix:	Ensin, Thèbes, enfin, la voix de ton Prophète, Des volontés des Dieux, est fidèle interprète, Son Oracle est suivi de visibles effets, La mort de Mænecee a produit cette paix:
Par vnſort tout enſemble, & propice, & contraire, La ruine du fils a couronné le pere:	Par unsort tout ensemble, et propice, et contraire, La ruine du fils a couronné le père:
Pour profiter pourmoy, luy-meſme s'eſt perdu,	Pour profiter pourmoi, lui-même s'est perdu,
Pour eſleuer mon ſang, mon ſang s’eſt respandu;	Pour élever mon sang, mon sang s'est répandu;
Mais plaindre ſon treſpas, est alterer ſa gloire, Luy ſeul, tout mort qu’il est, nous gaigne la victoire:	Mais plaindre son trépas, est altérer sa gloire, Lui seul, tout mort qu'il est, nous gagne la victoire:
Le public intereſt condamne mes douleurs, Et rauit à mes yeux la liberté des pleurs;	Le public intérêt condamne mes douleurs, Et ravit à mes yeux la liberté des pleurs;
Sa mort, esteint du Ciel, la fureur vengereſſe, Chaſſe de ſon pays les forces de la Grece, Renuerſe Polynice, & ſa temerité, Et luy couſte vn tré pas iuſtement merité:	Sa mort, éteint du Ciel, la fureur vengeresse, Chasse de son pays les forces de la Grèce, Renverse Polinice, et sa témérité, Et cette coûte un tré pas justement mérité:
Etéocle aueccœur at us noſtre deffenſe, Außiſçay-ie des deux faire la difference:	Etéocle aueccœur at us nôtre défense, Aussisçay-je des deux faire la différence:
I’entens, qu’auec ma Cour, toute la ville en deüil, Demain, rende au dernierles honneurs du cercueil, Mais mon authorité ne peut ſans iniustice, Decernerces honneurs au corps de Polynice:	J'entends, qu'avec ma Cour, toute la ville en deuil, Demain, rende au dernierles honneurs du cercueil, Mais mon autorité ne peut sans injustice, Decernerces honneurs au corps de Polynice:
Ilimporte à l'Eſtat, qu'vn ennemy iuré, Qui s’est ouuertement contre luy declaré, De ſa rebellion, recoiue le ſupplice, Et demeure priué de ce funebre office.	Ilimporte à l'État, qu'un ennemi juré, Qui s'est ouvertement contre lui declaré, De sa rébellion, reçoive le supplice, Et demeure privé de ce funèbre office.
CLEODAMAS.	CLÉODAMAS.
Vngrand Roy peſe tour u entomeporus égal, Rend le bien pour le bien, & le mal pourle mal:	Ungrand Roi pèse tour u entomeporus égal, Rend le bien pour le bien, et le mal pourle mal:
Que Thebes auiourd’huy dreſſaſt des funerailles, A qui vouloit hierabatre ſes murailles, Qui marchoit ſur les ſiens peſle-meſle accablez, Qui fit auecle feu la moiſſon de ſes bleds, 4-.	Que Thebes aujourd'hui dressât des funérailles, À qui voulait hierabatre ses murailles, Qui marchait sur les siens pèle-mêle accable, Qui fit auecle feu la moisson de ses bleds, 4-lés.
.	.
Et qui demain, peut-estre, euſt pù voir auec ioyé, Embraſer, par les Grecs, cette ſeconde Troye:	Et qui demain, peut-être, eût pour voir avec joyé, Embraser, par les Grecs, cette seconde Troie:
Qu’elle luy decernaſt les honneurs du tombeau, Ce Zele est ſans exemple, & ſeroit tout nouueau.	Qu'elle avait décernât les honneurs du tombeau, Ce Zèle est sans exemple, et serait tout nouveau.
EPHYTE.	EPHITE.
C’eſt trop, Cleodamas, exagerer ſon crime, Que ſa pretention fuſt ou non legitime:	C'est trop, Cléodamas, exagérer son crime, Que sa prétention fut ou non légitime:
Encor ce traitement paroiſt-il inhumain, Il fut’homme, il fut noble, il fut Rrince & Thebain:	Encor ce traitement paraît-il inhumain, Il fut homme, il fut noble, il fut Reince et Thebain:
Ie veux qu’il ſoit coupable, il laiſſe en ſon offenſe Vne matiere au Roy d’exercer ſa clemence.	Je veux qu'il soit coupable, il laisse en son offense Vaine matière au Roi d'exercer sa clémence.
D’vn regne commençant la premiere action, Fait deſſus les eſprits beaucoup d’impreßion, Et la douceury trace vne ſecrette voye, Par ou le joug paſſant ſe reçoit auec joye:	D'un règne commençant la première action, Fait dessus les esprits beaucoup d'impression, Et la douceuri trace ra secrète voie, Par ou le joug passant se reçoit avec joie:
La rigueur, au contraire, ences euenemens, Iette, au pouuoir des Roys, de mauuais fondemens, A peine ils eſtablit, qu'on ſouhaitte qu’il ceſſe, o tout joug nous deſplaist, quand d’abord il nous preſſe.	La rigueur, au contraire, ences événements, Jette, au pendant des Rois, de mauvais fondements, À peine ils établit, qu'on souhaite qu'il cesse, ô tout joug nous déplaît, quand d'abord il nous presse.
Sire, outre ces raiſons que voſtre pieté.	Sire, outre ces raisons que votre piété.
Lie aujourd’huy les mains à voſtre authorité.	Lie aujourd'hui les mains à votre autorité.
Donnés à voſtre regne vn fauorableugure, Accordés la Iuſtice auecque la Nature:	Donnez à votre règne un favorableugure, Accordés la Justice auecque la Nature:
Regnez ſur les eſprits premier que ſur les corps, Faites hõneur aux Dieux, enfaiſant grace aux morts,	Regnez sur les esprits premier que sur les corps, Faites honneur aux Dieux, enfaisant grâce aux morts,
CREON.	CREON.
O fol raiſonnement!	Ô fol raisonnement!
ſpecienſe foibleſſe!	spéciense faiblesse!
Sur toute lâcheteff, ce faux zele me bleſſe:	Sur toute lâcheteff, ce faux zèle me blesse:
Quoy donc, pour vnimpie, il faut eſtre pieux, - Et faire grace au crime, eſt faire honneur aux Dieux:	Quoi donc, pour unimpie, il faut être pieux, - Et faire grâce au crime, est faire honneur aux Dieux:
Depuis quand, des deux poincts, d’où dépend la Iuſtice, A, leurſacré conſeil, retranché le ſupplice?	Depuis quand, des deux points, d'où dépend la Justice, A, leursacré conseil, retranché le supplice?
Et fait, par un deſordre, à leur gloire fatal, De la ſource du bien, la ſemence du mal;	Et fait, par un désordre, à leur gloire fatal, De la source du bien, la semence du mal;
Quoy?	Quoi?
venir embrazé d’vne aueugle furie, Verſer le ſang des ſiens, ruiner ſa patrie, La rage dans le cœur, & les armes au poing, Eſt eſtre cher aux Dieux,& meriter leur ſoing?	venir embrasé d'une aveugle furie, Verser le sang des siens, ruiner sa patrie, La rage dans le cœur, et les armes au poing, Est être cher aux Dieux,et mériter leur soingle?
2 Non, non, c’eſt de nos maux faire le Ciel complice, C’eſt, de la pieté, faire vn appaſt au vice;	2 Non, non, c'est de nos maux faire le Ciel complice, C'est, de la piété, faire un appât au vice;
Contredire ſon Roy, ſur vn ſi iuſte arreſt, C’eſt ne pouuoir, plier ſous vn ioug qui dé plaiſt;	Contredire son Roi, sur un si juste arrêt, C'est ne pouvoir, plier sous un joug qui dé plaît;
Et du Zele indiſcret, & partiſan du crime, Pallier le refus d’vn zele legitime:	Et du Zèle indiscret, et partisan du crime, Pallier le refus d'ils élè gitime:
Mais, où l’on m’oſtera la qualité de Roy, Ou mon authorité maintiendra cette loy.	Mais, où l'on m'ôtera la qualité de Roi, Ou mon autorité maintiendra cette loi.
Du corps de ce mutin, giſant ſur la poußiere, Le ventre des corbeaux ſera le cimetiere;	Du corps de ce mutin, gisant sur la poussiere, Le ventre des corbeaux sera le cimetière;
Et ſe tienne aſſeuré d’vn cruel chaſtiment, Quiconque luy deſtine vn autre monument.	Et se tienne assuré d'une cruel châtiment, Quiconque deux destine autre monument.
CLEQDAMAS.	CLÉQDAMAS.
Ouit, quel mal-heureux apres vu re deffenſe, Pour l’intereſt d’vn mort, prendroit cette licence?	Ouit, quel malheureux après vu re sensé, Pour l'intérêt d'un mort, prendrait cette licence?
CREON.	CREON.
Touſiours quelque rebelle en vnregne naiſſant, Croit faire vncoup d’eſtat en deſobeyſſant.	Toujours quelque rebelle en imprègne naissant, Croit faire vncoup d'état en désobéissant.
Et ſe iette, à clos yeux, au danger plus extréme, Au meſpris de ſon Prince, au meſpris de ſoy-meſme:	Et se jette, à clos yeux, au danger plus extrême, Au mépris de son Prince, au mépris de soi-même:
Mais ſon crime eſt vtile, & contient quelque fois De plus mutins que luy dans le reſpect des loix;	Mais son crime est utile, et contient quelque fois De plus mutins que lui dans le respect des lois;
Suffit, que ſi mon fils enfraignoit ma deffenſe, Sonſang, ſon propre ſang en laueroit l’offence;	Suffit, que si mon fils enfraignait ma défense, Sonsang, son propre sang en lauerait l'offense;
Et que i’ay des Argus aux coſteaux d’allentour, Qui feront leur deuoir, d’y veiller nuit & iour.	Et que j'ai des Argus aux costeaux d'allentour, Qui feront leur devoir, d'y veiller nuit et jour.
A.	A.
	
C 2VI.	Ç 2VI.
.	.
M i.	M y.
GARDE, CREON, CLEODAMAS, EPHYTE.	GARDE, CREON, CLEODAMAS, EPHYTE.
LE GARDE.	LE GARDE.
Vertu criminelle!	Vertu criminelle!
ô pieté funeſte:	ô piété funeste:
Du meſpris de lamort, preuue trop manifeſte!	Du mépris de lamort, preuve trop manifeste!
CREON.	CREON.
Qu’eſt-ce?	Qu'est-ce?
quelle nouuelle?	quelle nouvelle?
LE GARDE.	LE GARDE.
Ha:	Ha:
quel eſt mon mal-heur?	quel est mon malheur?
D’auoir eſté commis pour inſtrument du leur.	D'avoir été commis pour instrument du leur.
*LI	*LI
CREON.	CREON.
Quoy deſia mon Edict a treuué des rebelles?	Quoi déjà mon Édit a trouvé des rebelles?
LE GARDE.	LE GARDE.
Sire, pour faire oüir de mauuaiſes nouuelles;	Sire, pour faire ouïr de mauvaises nouvelles;
.	.
I Qu’il faut faire ſur ſoy de violens efforts, Et qu'ona de contrainte à les mettre dehors:	I Qu'il faut faire sur soi de violents efforts, Et qu'on de contrainte à les mettre dehors:
La Princeſſe Antigone;	La Princesse Antigone;
CREON.	CREON.
O mal-heureuſe fille!	Ô malheureuse fille!
Sur qui i’establiſſois l’eſpoir de ma famille:	Sur qui j'établissais l'espoir de ma famille:
Orace deteſtable!	Orace détestable!
& digne deſon ſort.	et digne déson sort.
LE GARDE.	LE GARDE.
Decondée, à ce ſoin, par la vefue du mort, Vient d’eſtre auprés du corps, deſſus l’heure ſurpriſe, De ſon funebre office, acheuant l’entrepriſe;	Decondée, à ce soin, par la veue du mort, Vient d'être auprès du corps, dessus l'heure surprise, De son funèbre office, achevant l'entreprise;
uu puu uomes compagnons, qui l’amenent icy, Vous la vont preſenter, & l'Eſtrangere außi.	uu puu omes compagnons, qui l'amènent ici, Vous la vont présenter, et l'Étrangère aussi.
EPHYTE.	EPHITE.
Le Ciela, iuſqu’au bout, verſé ſur cette race Diſgrace ſurmal-heur, & mal-heur ſur diſgracs:	Le Ciela, jusqu'au bout, versé sur cette race Disgrâce surmalheur, et mal-heur sur disgrâces:
CREON.	CREON.
O maſque de vertu!	Ô masque de vertu!
que ta fauſſe beauté Couure d’hypocriſie, & de deſloyauté!	que ta fausse beauté Couvre d'hypocrisie, et de déloyauté!
Quoy?	Quoi?
cette miſerable à mon fils destinée, Sur le poinst d’accomplir cét heureux Hymenée, Declare maintenant ſa haïne contre moy, Son refuge, ſon oncle, & ſonpere & ſon Roy:	cette misérable à mon fils destinée, Sur le poinst d'accomplir cet heureux Hyménée, Declare maintenant sa haine contre moi, Son refuge, son oncle, et sonpère et son Roi:
* 2τ 1Non, i’aurois plutost crû que toute vne Prouince Se deuſt monſtrer rebelle au vouloir de ſon Prince, mefevonen te vongac poncommunuement, Que iè n’euſſe eu pour elle vn ſoupçon ſeulement.	* 2 1Non, j'aurais plutôt crû que toute une Province Se dût montrer rebelle au vouloir de son Prince, mefevonen te vongac poncommunuement, Que j'eusse eu pour elle un soupçon seulement.
Auiſant les gardes.	Avisant les gardes.
AmentZ tent pesit, & qu'on cnertne vne peine Egale à ſon forfait & digne de ma haine.	AmentZ tent pesit, et qu'on cnertne une peine Égale à son forfait et digne de ma haine.
TR2 III CREON, CLEODAMAS, EPHYTE, LE 3.	TR2 III CREON, CLEODAMAS, EPHYTE, LE 3.
GARDE, ANTIC NE, ARGIE, MENETE.	GARDE, ANTIC NE, ARGIE, MENTE.
CREON.	CREON.
Oyez quelle aſſeurance en cét œileffronté?	Oyez quelle assurance en cet œileffronté?
Quel ſuperbe maintien, & quelle égalité?	Quel superbe maintien, et quelle égalité?
D’vn ſeulſigne d’effroy ce front eſt il capable?	D'un seulsigne d'effroi ce front est il capable?
Qui de nous ſemble mieux le Iuge ou le coupalle?	Qui de nous semble mieux le Juge ou le coupalle?
Parle, t’a t’on ſurpriſe en ce fatal deuoir, Qui ſi viſiblement contredit mon pouuoir.	Parle, t'a -t-on surprise en ce fatal devoir, Qui si visiblement contredit mon pouvoir.
.	.
.	.
iij:	jij:
ANTIGONE.	ANTIGONE.
Non, on m’a priſe, Sire, onne m’a pas ſurpriſe.	Non, on m'a prise, Sire, onne m'a pas surprise.
On ne ſçauroit ſurprendre enſi iuſte entrepriſe.	On ne saurait surprendre ensi juste entreprise.
ARGIE.	ARGIE.
I'ay ſeule transgreſſé, cét arreſt inhumain:	J'ai seule transgressé, cet arrêt inhumain:
Sire, elle n'a rien fait, que me preſter la main.	Sire, elle n'a rien fait, que me prêter la main.
MENEIE, QMSE C'eſt à moy, Sire, à moy, qu’en eſt deu le ſupplice, Ie ſuis autheur de tout, elle n’eſt que complice,	MENEIE, QMSE C'est à moi, Sire, à moi, qu'en est dû le supplice, Je suis auteur de tout, elle n'est que complice,
CREON.	CREON.
Et ne ſçauiez-vous pas que cét acte, en effet, Eſtoit contreuenant à l’arreſt que i’ay fait!	Et ne savez-vous pas que cet acte, en effet, Était contrevenant à l'arrêt que j'ai fait!
ANTIGONE.	ANTIGONE.
Ie n'en pouuois douter, puis qu'aucun ne l’ignore.	Je n'en pouvais douter, puis qu'aucun ne l'ignore.
ARGIE.	ARGIE.
Oüy, ie le ſtauois bien.	Oui, Seigneur le stavais bien.
MENETE.	MENETE.
Et moy mieux qu’elle encore T.	Et moi mieux qu'elle encore T.
T	T
CREONI.	CRENI.
Pous faiſieZ doncvertu de tranſgreſſer mes loix.	Pous faisiez doncvertu de transgresser mes lois.
ANTIGONE.	ANTIGONE.
Quy, pour ſeruir tes Duenx, qui ſont plus que des Roys.	Qui, pour servir tes Duenx, qui sont plus que des Rois.
ARGIE.	ARGIE.
Pour faire honneur au Ciel au meſpris de la terre.	Pour faire honneur au Ciel au mépris de la terre.
MENETE.	MENETE.
Et pour donner aux morts la paix apres la guerre.	Et pour donner aux morts la paix après la guerre.
	
CREON.	CREON.
Et tous pour meriter vnrigoureux treſpas.	Et tous pour mériter unrigoureux trépas.
	
Qu'il vienne:	Qu'il vienne:
ANNTIGUNE -.	ANNTIGUNE -.
.	.
.	.
	
ARGIE.	ARGIE.
Il tarde trop;	Il tarde trop;
MENETE.	MENETE.
Ien y recule pas.	Jen y recule pas.
.	.
J.	J.
J.	J.
DREON.	DREN.
yont qurur qund vnemeſme audacé, Fit la rebellion, & reçoit la menace!	yont qur qur vnemesme audacé, Fit la rébellion, et reçoit la menace!
ANTIGONE.	ANTIGONE.
Ie mets le plus haut troſne au deſſous des Autels, Et reuere les Dieux, ſans egard des mortels;	Je mets le plus haut trône au dessous des Autels, Et révère les Dieux, sans égard des mortels;
Ils ſont maistres des Roys, ils ſont pieux, auguſtes, Tous leurs arrests ſont ſaincts, toutes leurs loix ſont iuſtes:	Ils sont maîtres des Rois, ils sont pieux, augustes, Tous leurs arrêts sont saints, toutes leurs lois sont justes:
Ces eſprits dépoüilleZ de toutes paßions, Ne meſlent nien d’impur en leurs intentions:	Ces esprits dépouillez de toutes passions, Ne mêlent nien d'impur en leurs intentions:
Au lieu que l’intereſt, lacolere & la haine, Preſide bien ſouuent à la iustice humaine, Et n’obſeruant amoür, deuoir, ny pieté, N'y laiſſent qu'iniuſtice, & quinhumanité:	Au lieu que l'intérêt, lacolère et la haine, Preside bien souvent à la justice humaine, Et n'observant amour, devoir, notre piété, N'y laissent qu'injustice, et quinhumanité:
Quoy, vous oſez aux morts nier la ſepulture?	Quoi, vous osez aux morts nier la sépulture?
Et cette loy naſquit auecques la nature;	Et cette loi naquit avec la nature;
Voſtre regne commence, & deſtruit à la fois, Par ſa premiere loy, la premiere des loix:	Votre règne commence, et détruit à la fois, Par sa première loi, la première des lois:
Icy la faute eſt iuste, & la loy criminelle, Le Prince peche icy bien plus que le rebelle:	Ici la faute est juste, et la loi criminelle, Le Prince pèche ici bien plus que le rebelle:
I'offenſe iuſtement vn iniuſte pouuoir, Et ne crains point lamort qui punit le deuoir:	J'offense justement un injuste pouvoir, Et ne crains point lamort qui punit le devoir:
La plus cruelle mort me ſera trop humaine, Ie me reſous ſans peine, à la finde ma peïne;	La plus cruelle mort me sera trop humaine, Je me résous sans peine, à la finde ma péine;
Elle Elle m’affranchira de voſtre authorité, Elmapaanmtonferamanoerte.	Elle Elle m'affranchira de votre autorité, Elmapaanmtonferamanoerte.
EPHYTE.	EPHITE.
Ommpovaunun puog vura non commune!	Ommpovaun puog vura non commune!
Qui pourrien ne ſe rend aux coups de la fortune.	Qui pourrien ne se rend aux coups de la fortune.
CLEODAMAS.	CLÉODAMAS.
O ſexe dangereux!	Ô sexe dangereux!
eſtrange dureté!	étrange dureté!
Du crime, & du ſuplice elle fait vanité.	Du crime, et du supplice elle fait vanité.
CREON.	CREON.
On abaiſſe aiſement le cœur d’vne ſubiette Sous le propre fardeau du joug qu'elle rejette:	On abaisse aisément le cœur d'une sujet Sous le propre fardeau du joug qu'elle rejette:
L’orgueils aſſortit mal auec le mauuais ſort, Et tous deux inſolens font vn mauuais accord;	L'orgueils assortit mal avec le mauvais sort, Et tous deux insolents font un mauvais accord;
Quoy?	Quoi?
la rebellion deuiendralegitime?	la rébellion deviendralegitime?
Et pour me meſpriſer, on priſera le crime?	Et pour me mépriser, on prisera le crime?
A ſon premier outrage elle en joint vn ſecond.	À son premier outrage elle en joint un second.
En faiſant vanité de m'auoir fait affront, Plus ſonmeſpris me touche, & plus elle en eſt vaine, Ie ſemble ſonſubjet;	En faisant vanité de m'avoir fait affront, Plus sonmespris me touche, et plus elle en est vaine, Je semble sonsubjet;
y mtte mu nuine:	y mtte mu nuine:
Peut-eſtre que le rang qu’elle tint autrefois, Et les titres de ſœur, niepce, & fille de Rois, Font à ce cœur altier, douter de la menace, Et contre ſa frayeur, ſouſtiennent ſon audace:	Peut-être que le rang qu'elle tint autrefois, Et les titres de sœur, nièce, et fille de Rois, Font à ce cœur altier, douter de la menace, Et contre sa frayeur, soutiennent son audace:
Mais ſon extraction prouint-elle des Cieux?	Mais son extraction prouint-elle des Cieux?
Et ſe dit-elle, ſœur, niepce, & fille des Dieux:	Et se dit-elle, sœur, nièce, et fille des Dieux:
La iuſtice aujourd’huy-ſatisfera ma haine, Et quil aſecondée aura part en ſa peine.	La justice aujourd'hui-satisfera ma haine, Et quil asecondée aura part en sa peine.
ARGIE.	ARGIE.
D'vn friuole diſcours paſſez donc à l’effet, Ie le ferois encor ſi ie ne l’auois fait:	D'un frivole discours passez donc à l'effet, Je le ferais encor si apprendre ne l'avais fait:
Oüy, i’ay fait le deuoir d’vne ingratte prouince, Qui refuſe, ſans honte, vn cercueil à ſon Prince:	Oui, j'ai fait le devoir d'une ingrate province, Qui refuse, sans honte, un cercueil à son Prince:
Elle fut ſon Païs, ſes Terres & ſes Eſtats, Il n’y veut qu’vn ſepulchre, & ne l’y treuue pas:	Elle fut son Pays, ses Terres et ses États, Il n'y veut qu'un sépulcre, et ne l'y trouve pas:
Ie laiſſe indifferend en quel titre on m'ameine, Ous i’auois droit d’entrer en qualité de Reine, Et ie n’accuſe pas l’iniuſtice du ſort, Qui me aeuoit onſtepire, & m'appreſte la mort, Ie me plains ſeulement de ce païs barbare, Qui de ſix pieds de terre à ſon Prince eſt auare;	Je laisse indifférend en quel titre on m'amène, Us j'avais droit d'entrer en qualité de Reine, Et ie n'accuse pas l'injustice du sort, Qui me achevait onstepire, et m'apprête la mort, Je me plains seulement de ce pays barbare, Qui de six pieds de terre à son Prince est are;
Et veut qu’en meſmeiour, le corps de mon eſpoux, Paſſe, d’entre mes bras, dans le ventre des loups.	Et veut qu'en mesmeiour, le corps de mon époux, Passe, d'entre mes bras, dans le ventre des loups.
CREON.	CREON.
Ayant appris l’Edit, & la peine preueuë Vous aueZ enfraint l’vn & l’autre vous eſt deuë.	Ayant appris l'Édit, et la peine preuve Vous avez enfraint l'un et l'autre vous est due.
ANTIGONE.	ANTIGONE.
Faites donc, voſtre haine, agit trop mollement, La fureur s allentit par le retardement:	Faites donc, votre haine, agit trop mollement, La fureur s oient par le retardement:
T Peut-estre que le temps vous oſteroit l’enuie, Ou l’aſſeurance au moins de nous oſter la vie, Le murmure du peuple iroit iuſques à vous, Et pourroit deſarmer voſtre iniuſte courroux:	T Peut-être que le temps vous ôterait l'envie, Ou l'assurance au moins de nous ôter la vie, Le murmure du peuple irait jusques à vous, Et pourrait désarmer votre injuste courroux:
Car, enfin, ſi la peur ne luy fermoit la bouche, Vous ſçauriez, à quel poinct ce procedé le touche;	Car, enfin, si la peur ne lui fermait la bouche, Vous sauriez, à quel point ce procédé le touche;
Mais d’abord vn tyran) fait pout ce qui luy plaiſt, Onſouffre auec reſpect, on void, mais on ſe taist.	Mais d'abord un tyran) fait pout ce qui était plaît, Onsouffre avec respect, on voit, mais on se taît.
CREON.	CREON.
Et toy ſeule, entre tous, n’as pû voirſans te plaindre.	Et toi seule, entre tous, n'as pu voirsants te plaindre.
ANTIGONE, Rons tiemient, ious ont peur, moy ie n'ay rien à craindre.	ANTIGONE, Rons tièmient, jous ont peur, moi Seigneur n'ai rien à craindre.
CREON.	CREON.
Aumoins dois-tu rougir, d’auoir oſé plus qu'eux?	Aumoins dois-tu rougir, d'avoir osé plus qu'eux?
ANTIGONE.	ANTIGONE.
Qui fait honneuraux morts ne fait rien de honteux.	Qui fait honneuraux morts ne fait rien de honteux.
CREON.	CREON.
Vn mort qui fut des ſiens le mortel aduerſaire?	Un mort qui fut des siens le mortel adversaire?
ANTIGONE.	ANTIGONE.
Ilfut ce qui vous plaiſt, mais il eſtoit monfrere.	Ilfut ce qui vous plaît, mais il était monfrere.
CREON.	CREON.
Qui les armes en main, a ſonfrere aſſailly:	Qui les armes en main, a sonfrere assailli:
U ARGIE.	V ARGIE.
Ilest vray, mais ſon frere à le premier failly.	Ilest vrai, mais son frère à le premier failly.
4 CRRON.	4 CRRON.
, 2*2 Il tint noſtre party, l’autré tint le contraire.	, 2 Il tint notre parti, l'autré tint le contraire.
ARGIE.	ARGIE.
La couronne à tous deux eſtoit hereditaire;	La couronne à tous deux était héréditaire;
L’vn ſuiuit ſa fureur, mais l’autre l’embraza, Si l’vn vous aſſaillit, l’autre vous expoſa.	L'autre suivit sa fureur, mais l'autre l'embrasa, Si l'un vous assaillit, l'autre vous exposa.
t2n3	t2n3
CREON.	CREON.
Le regne du premier, comme il fut d’vn bon Prince, Se gaigna la faueur de toute la Prouince;	Le règne du premier, comme il fut d'un bon Prince, Se gagna la faveur de toute la Province;
Et noſtre heur, qui ſoüs l'autre, eust pû diminuer, Nous fit prendre interest à le bontinuer:	Et notre heur, qui sommés l'autre, eût pu diminuer, Nous fit prendre intérêt à le bontinuer:
L’intention des ſiens, plus que la ſienne meſme, Auoit deſſus ſon front laiſſé le diadeſme;	L'intention des siens, plus que la sienne même, Avait dessus son front laissé le dyades;
Et ſon ambition, bien moins que ſa bonté, Se pêt dire l’appuy de ſon authorité.	Et son ambition, bien moins que sa bonté, Se pêt dire l'appui de son autorité.
ARGIE, .	ARGIE, .
tF.	tF.
Mais, pour le retenir, ---au1Je 2 v.	Mais, pour le retenir, --Je 2 v.
ii vous choßſiez Polynic On fit faueur à l’un, mais à l’autre iuftice, iuiuſtice	ji vous chossiez Polinic On fit faveur à l'un, mais à l'autre justice, justice
ANTIGONE.	ANTIGONE.
Apres tout, ie l’aimois, & mon affection Entreprendroit encor cette ſaincte action.	Après tout, Seigneur l'aimais, et mon affection Entreprendrait encor cette sainte action.
CREON.	CREON.
Et bien;	Et bien;
ſuy les conſeils que cet amour t’inſpire, Aime-le cheZ les morts, mais non ſous mon Empire.	suiv les conseils que cet amour t'inspire, Aime-le chez les morts, mais non sous mon Empire.
S Lv L TOMEND, &c.	 SON LOMEND, etc.
I	I
PHYTE.	PHYTE.
Dieux!	Dieux!
en quel estat Iſmene vient icy?	en quel état Ismene vient ici?
CREON.	CREON.
Et toy, n’eus-tu point part en l’entrepriſe außi;	Et toi, n'eus-tu point part en l'entreprise aussi;
ISMENE.	ISMENE.
Oüy, plus que toutes deux, i’ay commence l’ouurage, – T.	Oui, plus que toutes deux, j'ai commence l'ouvrage, .
2-	2-
K ii ptmon txcmpit, one, catnuteut courje	UT ji pénon txcmpit, one, catnuteut courie
ANTIGONE.	ANTIGONE.
Fon, non, nop ueprujont v empura de ſonſein, Elle a le cœur trop bas, pour un ſi haut deſſein.	Fon, non, nop ueprujont v empura de sonsein, Elle a le cœur trop bas, pour un si haut dessein.
TSMENL.	TSMENL.
Ie vous l’ny conſeillé, i’en preſſay l’entre priſe	Je vous l'ni conseillé, j'en pressai l'entre prise
ANTIGONE.	ANTIGONE.
Tout au tontrane, one, eut m'en a repriſé.	Tout au tontrane, one, eut m'en a reprisé.
2-	2-
ISM INE.	ISM INE.
Oüey, pout vous eſprouuer:	Ouei, pout vous éprouver:
mais ie ſuiuois vos pas, fes	mais ici suivais vos pas, fes
ANTIGONE.	ANTIGONE.
Elle eſtoit trop timide, elle ne ſortit pas.	Elle était trop timide, elle ne sortit pas.
ISMENE.	ISMENE.
PriſeZ-vous à tel poinct voſtre triſte fortune, Que voüs ayéz regret qu’elle me ſoit commune.	Prisez-vous à tel point votre triste fortune, Que vus ayéz regret qu'elle me soit commune.
ANTIGONE.	ANTIGONE.
I'ayſeule aimé mon frere, il n'appelle que moy.	J'aiseule aimé mon frère, il n'appelle que moi.
ISMENE.	ISMENE.
euſſe, d voſtre deffaut, entrepris cét emplo i1.	eusse, d vôtre défaut, entrepris cet emplo i1.
di cat.	di cat.
Des	Des
ANTIGONE.	ANTIGONE.
Ie ſeruirois de cœur, & non pas de paroles, L’vn produit des effets, les autres ſont friuoles.	Je servirais de cœur, et non pas de paroles, L'un produit des effets, les autres sont frivoles.
ISMENE.	ISMENE.
Ma ſœur au nom des Dieux, ne me déniez pas La gloire de vous ſuiure en vn ſi beau treſpas.	Ma sœur au nom des Dieux, ne me déniez pas La gloire de vous suivre en un si beau trépas.
ANTIGONE.	ANTIGONE.
Non, non, ne prenez part à rien qui m’appartienne, L'ouurage fut tout mien, la mort esf toute mienne.	Non, non, ne prenez part à rien qui m'appartienne, L'ouvrage fut tout mien, la mort ès toute mienne.
ISMENE.	ISMENE.
Ne vous poſſedant plus, quel bien me ſera doux.	Ne vous possédant plus, quel bien me sera doux.
ANTTHONE.	ANTHONE.
Creon voſtre Seigneur, aura grand ſoin de vous.	Creon votre Seigneur, aura grand soin de vous.
ISMENE.	ISMENE.
Ha!	Ha!
ce reproche eſt iuſte, il eſt vray, ie fus lâche.	ce reproche est juste, il est vrai, Elle fus lâche.
ANTIGONE.	ANTIGONE.
I'ay regret de le dire, & honte qu'on le ſçache.	J'ai regret de le dire, et honte qu'on le sache.
ISMENE.	ISMENE.
Mais que vous a produit ce genereux effor.	Mais que vous a produit ce généreux essor.
{2-1 dts Diie	2-1 dits Diie
ANTIGONE.	ANTIGONE.
Tout ce que i'eſperois, il m'a produit la mort.	Tout ce que j'espérais, il m'a produit la mort.
ISMENE.	ISMENE.
I’auois bien ſceû préuoir le mal-heur qui vous preſſe.	J'avais bien su prévoir le malheur qui vous presse.
ANPIEQNE.	ANPIEQNE.
Et bien, viuez, heureuſe auec voſtre ſageſſe.	Et bien, vivez, heureuse avec votre sagesse.
MABOR.	MABOR.
L’orgueil à toutes deux a troublé la raiſon, Et leurextrauagance eſt-ſans comparaiſon.	L'orgueil à toutes deux a troublé la raison, Et leurextravagance est temps comparaison.
1.	1.
2 SMENE.	2 SMENE.
r ons meſmen vuſicpis, oun t'aueZ deſtinée, Voudriez-vous rompre, Sire, vn ſi bel hymenée?	 rons mémen vusicpis, oun t'avez destinée, Voudriez-vous rompre, Sire, si bel hyménée?
CNEON.	CNEON.
1.	1.
1 ?	1 ?
.	.
Il peut pour un manqué recouurer cent partis.	Il peut pour un manqué recouvrer cent partis.
ISMENE.	ISMENE.
Non pas qui vaillent tant, ny ſi bien aſſortis.	Non pas qui vaillent tant, ni si bien assortis.
CREON.	CREON.
Cherchant cette alliance, il cherchoit bien ſa perte, Ie la haïrois bien, ſt ie J’uuois ſoufferte.	Cherchant cette alliance, il cherchait bien sa perte, Je la haïrais bien, st ie Juois soufferte.
v.	v.
.	.
.	.
.	.
.	.
L.	L.
ANTIGONE.	ANTIGONE.
Viens icy, cher Hemon, & parcét entretien, Apprens le iugement que l’on y fait du tien.	Viens ici, cher Hémon, et parcêt entretien, Apprends le jugement que l'on y fait du tien.
ESMIENLe.	ESMIENLe.
VoudrieZ-vous ruïner vne amitié ſi forte?	Voudriez-vous ruiner une amitié si forte?
CREON.	CREON.
Pvrte, ou non,s ut eſpouſe, u l'eſpouſera morte.	Puvrte, ou non, ut épouse, l'épousera morte.
ISMENE.	ISMENE.
Si le Ciel n’eſt iniuſte, il vengera ſamort.	Si le Ciel n'est injuste, il vengera samort.
.	.
CREON.	CREON.
Profite de ſa perte, & crains vn meſme ſort.	Profite de sa perte, et crains un même sort.
ASAIENE.	ÀSAIENE.
Non, non, ne croyez, pas que voſtre tyrannie, Ny m'empeſche la voix, ny demeure impunie;	Non, non, ne croyez, pas que votre tyrannie, Ni m'empêche la voix, toujours demeure impunie;
Les Dieux ne ſont pus Dicux, ſt vien toſt leur courroux, Né prend nostre interest, & n’eſclate ſur vous.	Les Dieux ne sont pus Dicux, st viens tôt leur courroux, Né prend notre intérêt, et n'éclate sur vous.
.	.
4	4
CREON.	CREON.
AlleZ, oſtez d’icy ces objets de ma haine, Qu'enla tour du Palais, toutes deux on les meine:	Allez, ôtez d'ici ces objets de ma haine, Qu'enlà tour du Palais, toutes deux on les mène:
Veillez-les auec ſoin, que tout vous ſoit ſuſpect, Mais que l’on traicte Argie auec plus de reſpect, Dedans vne autre chambre;	Veillez-les avec soin, que tout vous soit suspect, Mais que l'on traite Argie avec plus de respect, Dedans quelque autre chambre;
auec gande fidelle, Cependant, qu’au Conſeil, on ordonnera d’elle:	avec gande fidèle, Cependant, qu'au Conseil, on ordonnera d'elle:
Car, ne releuant pas de mon authorité, Le crime qu'elle a fait, eſt d’autre qualité.	Car, ne relevant pas de mon autorité, Le crime qu'elle a fait, est d'autre qualité.
On les meine.	On les mène.
SCLIVE CREON, EPHYTE, CLEODAMAS.	SCLIVE CREON, EPHITE, CLÉODAMAS.
EPHYTE.	EPHITE.
IRE, à peſer bien tout d’vne égale balance, Ce protedé n'eſt pas ſans quelque violence, L’honneur qu’on rend aux morts eſt vne vieille loy, Par naiſſance, & par droict Polynice fut Roy:	IRE, à peser bien tout d'une égale balance, Ce protedé n'est pas sans quelque violence, L'honneur qu'on rend aux morts est une vieille loi, Par naissance, et par droit Polynice fut Roi:
Antigone eſt ſaſœur, elle est vostre parente, Vous én priueZ Hemon, Iſmene est innocente;	Antigone est sœur, elle est vôtre parente, Vous én privez Hémon, Ismene est innocente;
L'autre est vefue du mort:	L'autre est veuve du mort:
que vostre iugement, Sur toutes ces raiſons, paſſe vn peu murement.	que votre jugement, Sur toutes ces raisons, passe un peu mûrement.
17 t- --- –--	17 t- -ce- t-elle
CREON.	CREON.
De toutes ces raiſons, pour vne deſloyale, Pas vne ne deſtruit la puiſſance Royale;	De toutes ces raisons, pour ra déloyale, Pas une ne détruit la puissance Royale;
Epne impmamgensuuſo uſenmndpojer, Des autres, mon conſeil m'enjfera aiſpoſer.	Âne impmamgensuuso usenmndpojer, Des autres, mon conseil m'enjfera aisposer.
DOLEE V HEMON, CREON.	DOLE V VEMON, CREON.
I	I
CREON continuë.	CREON continue.
E aißimuleZ point la douleur qui vous preſſe, NElle eſt iuſte en l’amant qui perd vne maiſtreſſe:	E aisiulez point la douleur qui vous presse, NElle est juste en l'amant qui perd maîtresse:
Mais d’autre part, Hemon, elle eſt iniuſte außi, onpo puuuns, de ſon pere a ſoucy, Et qui, ſage, eſpouſant, ſon amour, & ſahaine, Se fait de ſés deſirs vne loy ſouueraine.	Mais d'autre part, Hémon, elle est injuste aussi, onpo puuns, de son père a souci, Et qui, sage, épousant, son amour, et sahaine, Se fait de sez désirs une loi souveraine.
HEMON.	HÉMON.
Ayant l’honneur que i’ay, d’eſtre ſorty de vous, Voſtre intereſt, Monſieur, ſur tout autre m'eſt doux;	Ayant l'honneur que j'ai, d'être sorti de vous, Votre intérêt, Monsieur, sur tout autre m'est doux;
I'ay tous les ſentimens que mon deuoir m'ordonne, ---.	J'ai tous les sentiments que mon devoir m'ordonne, --.
*2.	*2.
L ij Ie tiens de voſtre ſang, & de voſtre couronne, Et ſans me de partir de leur authorité, Me puismen eſpujer que same colome.	 Ie tiens de votre sang, et de votre couronne, Et sans me de partir de leur autorité, Me puismen épujer que same colome.
CREON.	CREON.
Außi, par la raiſon de la ſeule naiſſance, N’attendois-ie pas moins de voſtre obeïſſance:	Aussi, par la raison de la seule naissance, N'attendais-je pas moins de votre obéissance:
Ce que priſe unbon pere, eſt priſé d’vn bon fils, Ils ont meſmes amis & meſmes ennemis;	Ce que prise unbon père, est prisé d'Hommes bon fils, Ils ont mêmes amis et mêmes ennemis;
Mais le pere d’vn fils, aſes deſſeins contraire, S’est formé de ſoy-meſme un mortel aduerſaire;	Mais le père d'un fils, ases desseins contraire, S'est formé de soi-même un mortel adversaire;
Ils entretient la guerre, & nourrit vn poiſon, Doux à ſes ennemis, funeſte à ſa maiſon:	Ils entretient la guerre, et nourrit un poison, Doux à ses ennemis, funeste à sa maison:
Il ne faut pas, Hemon, que l’amour d’vne femme, Iuſqu'à ce point nous çaigne, & nous aueugle l’ame, Qu'alors que le mal preſſe on n'en puiſſe guerir, Et que nous nous perdions afin de l’acquerir.	Il ne faut pas, Hémon, que l'amour d'une femme, Jusqu'à ce point nous çaigne, et nous aveugle l'âme, Qu'alors que le mal presse on n'en puisse guérir, Et que nous nous perdions afin de l'acquérir.
L’intereſt de mon fils trop iuſtement me touche, Pour ſouffrir qu'il reçoiue un ſerpent en ſa couche;	L'intérêt de mon fils trop justement me touche, Pour souffrir qu'il reçoive un serpent en sa couche;
Vne mauuaiſe femme est vn méchant amy, Que veillant on doit craindre, & bien plus endormy Et quiconque, à ſa foy, iour & nuit ſe hazarde, Se met entre les mains d’vne mauuaiſe garde:	Une mauvaise femme est un méchant ami, Que veillant on doit craindre, et bien plus endormi Et quiconque, à sa foi, jour et nuit se hasarde, Se met entre les mains d'une mauvaise garde:
Cette ſeule rebelle, entre tous mes ſubjets, Cenſure mes Edicts, attaque mes proiets, Et trace des chemins à toute la prouince,	Cette seule rebelle, entre tous mes sujets, Censure mes Édits, attaque mes proiss, Et trace des chemins à toute la province,
Dans les deſſeins d’vn Roy, comme dans ceux des Dieux, De fidelles ſubjets doiuent fermer les yeux, Et ſouſmettant leurs ſens au pouuoir des couronnes, Quelles que ſoient les loix, croire qu’elles ſont bonnes,	Dans les desseins d'un Roi, comme dans ceux des Dieux, De fidèles sujets doivent fermer les yeux, Et sousmettant leurs sens au pouvoir des couronnes, Quelles que soient les lois, croire qu'elles sont bonnes,
HEMON.	HÉMON.
Les Dieux ne mettent pas en tous entendemens, Ny parreilles clartez, ny mémes ſentimens;	Les Dieux ne mettent pas en tous entendements, Ni parreilles clartés, Seigneur mêmes sentiments;
Ie veux que cette offenſe attaque voſtre gloire, Mais, qui l’oza commettre, a pû ne le pas croire:	Je veux que cette offense attaque votre gloire, Mais, qui l'osa commettre, a pu ne le pas croire:
En effet, qui croiroit aller contre vos loix, Suiuant celles des Dieux, qui ſont maiſtres des Roys?	En effet, qui croirait aller contre vos lois, Suivant celles des Dieux, qui sont maîtres des Rois?
Moy, Monſieur, qui ſans feinte, & vous priſe vous aime, Comme autheur de ma vie, & ſource de moy-feſme, Qui vous ſouhaitte vn regne, & glorieux, & doux, Et pourdire, en vnmot, qui ſoit digne de vous:	Moi, Monsieur, qui sans feinte, et vous prise vous aime, Comme auteur de ma vie, et source de moi-fême, Qui vous souhaite un règne, et glorieux, et doux, Et pourdire, en vnmot, qui soit digne de vous:
Ie cueille les aduis par tout où ie me treuuë, I'entends ce qu’on eſtime, & ce qu'on deſapreuue, Pour profiter pourvous, & vous en faire part, A vous, à qui moy ſeul, oZe parler ſans fard:	Je cueille les avis par tout où je me trouve, J'entends ce qu'on estime, et ce qu'on desapreuue, Pour profiter pourvous, et vous en faire part, À vous, à qui moi seul, oZe parler sans fard:
Iamais la verité, cette fille timide, Pour entrer chez les Roys, ne treuue qui la guide:	Jamais la vérité, cette fille timide, Pour entrer chez les Rois, ne trouve qui la guide:
Au lieu que le menſonge a mille partiſans, Et vous eſt preſenté par tous vos courtiſans;	Au lieu que le mensonge à mille partisans, Et vous est présenté par tous vos courtisans;
Seul, ie vous diray donc, que le commun murmure	Seul, Seigneur vous dirai donc, que le commun murmure
L iij	 Lijà
Accuſe voſtre arreſt d’offenſer la nature:	Accuse votre arrêt d'offenser la nature:
Qu'außi, l’on n’attend pas de vostre paßion L'iniuſte chaſtiment d’vne bonne action:	Qu'avez, l'on n'attend pas de votre passion L'injuste châtiment d'une bonne action:
Antigone, dit-on, prit vne honneſte audace;	Antigone, dit-on, prit -honnête audace;
Que le Roy punira de la ſeule menace;	Que le Roi punira de la seule menace;
Ce qu’elle a fait eſt iuſte, & dans tous les eſprits, Hors celuy de Creon, ſoncrime aura des prix:	Ce qu'elle a fait est juste, et dans tous les esprits, Hors celui de Creon, soncrime aura des prix:
C’eſt, à peu prés, Monſieur, ce que ie viens d’ẽtendre, Et ce que mon deuoir m’oblige à vous apprendre;	C'est, à peu prés, Monsieur, ce que je viens d'entendre, Et ce que mon devoir m'oblige à vous apprendre;
Déferez quelque choſe au ſentiment commun, Le plus ſçauant ſe trompe, & deux yeux font plus qu'vn;	Déférez quelque chose au sentiment commun, Le plus savant se trompe, et deux yeux font plus qu'un;
Vn changement d’auis, quand la ruiptirtn preſſe, N'est pas vne action contraire à la ſageſſe:	Un changement d'avis, quand la ruiptirtirn presse, N'est pas une action contraire à la sagesse:
Neur que par ſon ſens, est le propré des Dieux, Comme il l’est des mortels;	Neur que par son sens, est le propré des Dieux, Comme il l'est des mortels;
de voir par beaucoup d’yeux.	de voir par beaucoup d'yeux.
EPHYTE, La meſme verité vous parle par ſa bouche;	EPHYTE, La même vérité vous parle par sa bouche;
Sire, de cette part, ſouffrez qu’elle vous touche, D’autant plus, qu’elle tend à voſtre commun bien, Et que voſtre intereſt s’y treuue auec le ſien,	Sire, de cette part, souffrez qu'elle vous touche, D'autant plus, qu'elle tend à votre commun bien, Et que votre intérêt s'y trouve avec le sien,
CREON.	CREON.
O conſeil!	Ô conseil!
ô priere!	ô prière!
& ridicule, & folle, Que i’apprenne ſi vieil d’vne ſt ieune eſcolle.	et ridicule, et folle, Que j'apprenne si vieil d'une st jeune écolle.
HEMON.	HÉMON.
Ne regardez par l’âge, & peſez la raiſon:	Ne regardez par l'âge, et pesez la raison:
CREONLa raiſon n’eſt pas meure, en ſi verte ſaiſon:	CRENLa raison n'est pas meure, en si verte saison:
Aappeuconturuiſonat fuire honneur au crimes	Aapeuconturisonat fuire honneur au crimes
HEMON.	HÉMON.
Non, s’il paſſe pour tel, ailleürs.	Non, s'il passe pour tel, ailleurs.
qu’en voſtre eſtime.	qu'en votre estime.
CREON.	CREON.
Qut m'a deſobey, merite le treſpas.	Quit m'a désobéi, mérite le trépas.
HEMON.	HÉMON.
Le peuple, toutefois, ne le confeſſe pas.	Le peuple, toutefois, ne le confesse pas.
CAHOM.	CAHOM.
Luy-meſme est criminel, s'ilcenſure ſon Prince.	Lui-même est criminel, s'ilcendsure son Prince.
HEMON.	HÉMON.
Faites donc le procés à toute la Prouince.	Faites donc le procès à toute la Province.
CREON.	CREON.
Elle, & ſes habitans, ſont eſtiants ues Roys.	Elle, et ses habitants, sont étiants ues Rois.
HEMON.	HÉMON.
Oüy, ſi les Roys außi ſont eſclaues des loix.	Oui, si les Rois aussi sont esclaves des lois.
CREON.	CREON.
La folle paßion qui poſſede ton ame, Te fait infolemment parler pour une femme, Et de ſon intereſt, te rend ainſi jaloux.	La folle passion qui possède ton âme, Te fait insolemment parler pour une femme, Et de son intérêt, te rend ainsi jaloux.
3 ------ ----	3 --est -est-ce
HEMON.	HÉMON.
Vous ſeriez femme donc, car ie parle pour vous.	Vous seriez femme donc, car ie parle pour vous.
CREEII, Tu conteſtes, mutin, contre ton propre pere?	CREII, Tu contestes, mutin, contre ton propre père?
HEMON.	HÉMON.
I'ay crû vous conſeiller, & non pas vous déplaire.	J'ai cru vous conseiller, et non pas vous déplaire.
CREON.	CREON.
Ne m'est-npas permn ue conferuer mon droist?	Ne m'est-npas permn ue conserver mon drois?
HEMON.	HÉMON.
Non, s’il priueles Dieux de l’hõneur qu’onleur doit:	Non, s'il priveles Dieux de l'honneur qu'onleur doit:
.	.
	
CREON.	CREON.
Vil eſclaue de femme, eſprit lâche, & debile.	Vil esclaue de femme, esprit lâche, et débile.
HEMON.	HÉMON.
Ie n’ay fait action, ny lâche, ny ſeruile.	Je n'ai fait action, ni lâche, ni servile.
CREGN.	CRÉGN.
Parler pour vne fille, eſt ton plus digne employ.	Parler pour une fille, est ton plus digne emploi.
HEMON.	HÉMON.
Ie parle pourles Dieux, & pour vous, & pour moy.	Je parle pourles Dieux, et pour vous, et pour moi.
.	.
.	.
.	.
.	.
h	h
CREON.	CREON.
N'eſpere pas, enfin, lepouſer jamais viue,	N'espère pas, enfin, lepouser jamais vive,
HEMON.	HÉMON.
Elle ne mourra pas, qu’vnautre ne laſuiue,	Elle ne mourra pas, qu'autre ne lasuive,
CREON.	CREON.
M'ozes-tumenacer?	M'oses-thumenacer?
P.	P.
3 -22	3 22
HEMON.	HÉMON.
Ie n’auancerois rien;	Je n'avancerais rien;
Emtis quinyu vent, non peur faire hen.	Emtis quinyv vent, non peur faire hen.
CREON.	CREON.
Ce fol, à m'outrager, encore perſeuere,	Ce fol, à m'outrager, encore persévère,
MEMOR.	MEMOR.
Ie vons dirois bien pis, ſi vous n’eſtieZ mon pere.	Je vonds dirais bien pis, si vous n'étiez mon père.
CREON.	CREON.
Vacœureffeminé, va lâche, ſorts d’icy.	Vacœureffeminé, va lâche, sorts d'ici.
TIEMONV.	TIEMONV.
Vous vouleZ donc parler, ſans que l'onparle auſii.	Vous voulez donc parler, sans que l'onparle ausii.
CREON.	CREON.
Qüy traiſtre;	Qui traître;
ie le veux, es bien toſt le ſalaire M De ta preſomption, vat aprendre à te taire, Et ne cherir pas tant ce qui m’eſt odieux:	Elle le veux, es bien tôt le salaire M De ta présomption, vat apprendre à te taire, Et ne chérir pas tant ce qui m'est odieux:
Soldais, amenez-la, qu'on l'égorge à ſes yeux.	Soldais, amenez-la, qu'on l'égorge à ses yeux.
HEMON.	HÉMON.
Ce ne ſera iamais, au moins en ma preſence, Que l’on accomplira cette iniuſte ſentence:	Ce ne sera jamais, au moins en ma présence, Que l'on accomplira cette injuste sentence:
Faites à vos flateurs authoriſer vos loix, tjs doptajus pour la derniere fois.	Faites à vos flatteurs autoriser vos lois, tjs doptajus pour la dernière fois.
Seigneur, EPHYTE, le voulant retenir.	Seigneur, ÉPHITE, le voulant retenir.
CREON.	CREON.
Laiſſez, qu’ilaille, il ſçaura, ie le iure, Combien ſenſiblement me touche cette iniure, Combien il eſt fatat d’irriter mon pouuoir, Et, pour vn fol amour, oublier ſon deuoir.	Laissez, qu'ilaille, il saura, Elle le jure, Combien sensiblement me touche cette injure, Combien il est fat d'irriter mon pouvoir, Et, pour un fol amour, oublier son devoir.
*- * .	*- * .
	
B 10 SCENE PREMIERE.	B 10 SCÈNE PREMIÈRE.
HEMON ſeul.	HÉMON seul.
VON l’égorge à mes yeux!	VON l'égorge à mes yeux!
ô vertu ſans défence!	ô vertu sans défense!
Iuſtice ſans ſouſtien, ſupplice ſans offence!	Justice sans soutien, supplice sans offense!
O preſage fatal!	Ô présage fatal!
pour vnregne naiſſant, De s’arroſer de ſang, & de ſang innocent:	pour unregne naissant, De s'arroser de sang, et de sang innocent:
O belles fleurs ſans fruict:	Ô belles fleurs sans fruit:
accords ſans Hymenée, I'auois bien, malgré vous, ſenty ma deſtinee;	accords sans Hyménée, J'avais bien, malgré vous, senti ma destinée;
Et toy, mon cœur, & toy, qui m'en a aduerty, Ie te crûs iuſtement, tu ne m’as point menty.	Et toi, mon cœur, et toi, qui m'en a adverti, Je te crus iustement, tu ne m'as point menti.
Qu'on l’égorge à mes yeux, ô barbare ſentence:	Qu'on l'égorge à mes yeux, ô barbare sentence:
Contre la vertu méme, & la méme innocence;	Contre la vertu même, et la même innocence;
Souffrirez-vous, mes yeux, ce ſpectacle exposé?	Souffrirez-vous, mes yeux, ce spectacle exposé?
.	.
.	.
Ie vous arracherois, ſi vous l’auiezoZé:	Je vous arracherais, si vous l'aviezoZé:
Regne pernicieux!	Reine pernicieux!
ioug certes deteſtable, Qui, dós le premier iour, preſſe tant qu’il accable:	joug certes détestable, Qui, dès le premier jour, presse tant qu'il accable:
Qu’attendra-t’on d’un Roy, de qui l’authorité, Se declare d’abord contre la pieté?	Qu'attendra-t-on d'un Roi, de qui l'autorité, Se pare d'abord contre la piété?
Rompt les loix d’Hymenée, & celles de Nature, Oſte aux viuans l’eſpoir, aux morts la ſepulture.	Rompt les lois d'Hyménée, et celles de Nature, Oste aux vivants l'espoir, aux morts la sépulture.
I Antigone eſt pieuſe, & reuere les Dieux, Et c’eſt pourquoy l’on veut qu’on l’égorge à mes yeux:	I Antigone est pieuse, et révère les Dieux, Et c'est pourquoi l'on veut qu'on l'égorge à mes yeux:
Mais, peut-eſtre qu'Ephytes, aura par ſa priere Obtenu quelqn'effet meilleur que ie n'eſpere;	Mais, peut-être qu'Éphytes, aura par sa prière Obtenu queln'effet meilleur que personne n'espère;
Poßible crains-ie vn mal qui n'arriuera pas:	Posible crains-je un mal qui n'arrivera pas:
Le voila, qui penſif, adreſſe icy ſes pas.	Le voilà, qui pensif, adresse ici ses pas.
Hé bien, qu'as-tu gaigné ſur cette ame cruelle Ie lis enta tristeſſe vne triſte nouuelle.	Hé bien, qu'as-tu gagné sur cette âme cruelle Je lis enta tristesse une triste nouvelle.
**-*- -on.	**-*- on.
Elle.	Elle.
P	P
AET EPHYTE, HEMON.	AET EPHYTE, HÉMON.
2 Ah	2 Ah
EPHYTE.	EPHITE.
AVTRES, pour vous flater, d’vn inutile eſpoir, tousuuuien que lelemp, ie pouroit émouuoir, J.	AUTRES, pour vous flatter, d'un inutile espoir, tousuvien que lelemp, Seigneur pourrait émouvoir, J.
.	.
Mais moy qui ſuis ſenſible à tout ce qui vous touche, Qui mauuais courtiſan, ay le cœur ſur la bouche;	Mais moi qui suis sensible à tout ce qui vous touche, Qui mauvais courtisan, ai le cœur sur la bouche;
Ie ne vous puis farder ce funeſte rapport, C’eſt fait de la Princeſſe, il a ſigné ſa mort.	Je ne vous puis farder ce funeste rapport, C'est fait de la Princesse, il a signé sa mort.
HEMON.	HÉMON.
C’eſt fait de la Princeſſe, ha!	C'est fait de la Princesse, ha!
force ma colere, Force icy tout reſpect, & de puis, & depere:	force ma colère, Force ici tout respect, et de puis, et dépère:
VeneZ, rages, trans ports, ſi longtemps repouſſez,, Ce bourreau de ſon ſang vous authoriſe aſſez, Venez, & de ſa teſte arrachez, la couronne, Chaſſons d’autour de luy l’éclat qui l’enuironne;	Venez, rages, trans ports, si longtemps repoussés, Ce bourreau de son sang vous autorise assez, Venez, et de sa tête arrachez, la couronne, Chassons d'autour de lui l'éclat qui l'environne;
a O.	à Ô.
.	.
J ---.	J -vou-.
	
M.	M.
ii Faiſons tomberſon troſne, & perir ſon Eſtat, Si lâche partiſan d’vn ſi lâche attentat:	ji Faisons tomberson trône, et périr son État, Si lâche partisan d'amour si lâche attentat:
Pardonnés mes transports, reſpect, deuoir, naiſſance, Ie ſçay que ie m'emporte, & que ie vous offenſe:	Pardonnez mes transports, respect, devoir, naissance, Je sais que ie m'emporte, et que enfin vous offense:
Mais vous voyeZ qu’on meurt pour trop ſuiure vos loix, Qu’on en acquiert lagloire, & la mort à la fois;	Mais vous voyeZ qu'on meurt pour trop suivre vos lois, Qu'on en acquiert lagloire, et la mort à la fois;
L’honneur qu’on porte aux ſiens deuient illegitime, Et trop de naturel, paſſe aujourd’huy pour crime,	L'honneur qu'on porte aux siens devient illégitime, Et trop de naturel, passe aujourd'hui pour crime,
EPHYTE.	EPHITE.
I'attendois bien de vous ce premier mouuement, Ie ne puis condamner voſtre reſſentiment;	J'attendais bien de vous ce premier mouvement, Je ne puis condamner votre ressentiment;
Auuis, otigutur sia trintege entur pleine de vle;	Auuis, otigutur zia trinte entur pleine de veule;
N’a pas de ce cruella fureur aſſouuie.	N'a pas de ce cruela fureur assouuie.
HEMON.	HÉMON.
Quel eſt donc ſon arreſt?	Quel est donc son arrêt?
EPHYTE.	EPHITE.
Il commet à la faim, Inuiſible bourreau, cét office inhumain, Et deſſous Cyteron, l’a fait enfermer viue, Attendant qu’vne mort, de tant de morts la priue.	Il commet à la faim, Inuisible bourreau, cet office inhumain, Et dessous Cyteron, l'a fait enfermer vive, Attendant qu'une mort, de tant de morts la prive.
HEMON.	HÉMON.
Mais rien n'esbranle-t’il ſareſolution?	Mais rien n'ébranle-t-il saresolution?
.	.
.	.
.	.
.	.
	
N’as-tu rien oublié de ta commißion?	N'as-tu rien oublié de ta commission?
L’as-tu fait ſouuenir, que c’eſt de ſa main meſme, Que ie tiens cét objet de mon amour extréme;	L'as-tu fait souvenir, que c'est de sa main même, Que tu tiens cet objet de mon amour extrême;
Que ce qu’ila fait naiſtre, il d’euſt l’entretenir, Qu’il a luy meſme joint ce qu’il veut deſunir:	Que ce qu'ila fait naître, il d'eût l'entretenir, Qu'il a luiprendre joint ce qu'il veut désunir:
Sçait-il que ie m'auoüe vnpeu trop temeraire?	Sait-il que ici m'auoüe tuer trop téméraire?
Et que ie me veux mal d’auoir pu luy déplaire, Que ie n’ignore pas l’honneur que ie luy dois, Mais que le deſeſpoir luy parloit par ma voix:	Et que personne me veux mal d'avoir pu lui déplaire, Que tu n'ignore pas l'honneur que ie lui dois, Mais que le désespoir lui parloit par ma voix.
Qu'il doit conſiderer le feu qui me deuore, Et qu’il me veut rauir vn obiet que i’adore:	Qu'il doit considérer le feu qui me dévore, Et qu'il me veut ravir un objet que j'adore:
Enfin, L'as-fu prie, que ſi ny mon deuoir, Ny mes ſouſmißions ne peuuent l’émouuoir, Il m’accorde, du moins, cette derniere grace, Que ie meure pour elle, & ſeul luy ſatisfaſſe:	Enfin, L'as-fu prie, que si ici mon devoir, Ni mes sousmissions ne peuvent l'émouvoir, Il m'accorde, du moins, cette dernière grâce, Que mille meure pour elle, et seul seul satisfasse:
EFTTIE.	EFTTIE.
I'ay peint voſtre reſpect, voſtre amour, voſtre ennuy, Mais le plus dur rocher, eſt moins rocher que luy, Et ie l’ay moins touche, par ce que i'ay pu dire, Qu'un chefne n'eſt émeu du ſouffle d’vn Zephyre.	J'ai peint votre respect, votre amour, votre ennui, Mais le plus dur rocher, est moins rocher que Seigneur, Et un l'ai moins touche, par ce que j'ai pu dire, Qu'un chêne n'est ému du souffle d'H Zephyre.
HEMON.	HÉMON.
N’importe;	N'importe;
Sonde encor ce courage inhumain, Deuſt, ce dernier effort encor nous eſtre vain:	Sonde encor ce courage inhumain, Deût, ce dernier effort encor nous être vain:
Pardonne au ſoin -ingrat, que mon amour de donme, Et tante iuſqu’au bout, pour fauuer Antigone:	Pardonne au soin -ingrat, que mon amour de donme, Et tante jusqu'au bout, pour sauver Antigone:
.	.
.	.
.	.
3 ---.	3 --.
puey turuvuepaut, vumus-heureux amant,	puei turuvepaut, vumus-heureux amant,
EPHYTE.	EPHITE.
Ie vous vais obeir, mais inutilement.	Je vous vais obéir, mais inutilement.
ME e HEMON ſeul.	ME E HÉMON seul.
III Ar cette inuention deffait de ſa preſence, 2Autant que ie le ſuis de la vaine eſperance, De pouuoir profiter de cét abaiſſement, Secourons I’innocence, & genereuſement:	III Ar cette invention défait de sa présence, 2Autant que personne le suis de la vaine espérance, De pouvoir profiter de cet abaissement, Secourons J'innocence, et généreusement:
Ha!	Ha!
pourquoy n'eſt quelqu’autre autheur de cét outrage, Contre qui mon amour pût monſtrer mon courage:	pourquoi n'est quelqu'autre auteur de cet outrage, Contre qui mon amour pût montrer mon courage:
En quelle occaſion ne l’irois-je eſprouuer?	En quelle occasion ne l'irais-je éprouver?
Et que ne tanterois-je, afin de la ſauuer?	Et que ne tanterais-je, afin de la sauver?
Mais,ô loy, du deuoir!	Mais,ô loi, du devoir!
importune contrainte!	importune contrainte!
Le nom de l’ennemy deffend meſme la plainte:	Le nom de l'ennemi défend même la plainte:
On m’arrache la vie, & teleſt mon destin?	On m'attache la vie, et telest mon destin?
Qu’il faut encor baiſer le bras de l’aſſaßin:	Qu'il faut encor baiser le bras de l'assassin:
Il faut ſouffrir, ſant rendre, il faut voir, & ſe taire, L	Il faut souffrir, sant rendre, il faut voir, et se taire, L
Et --- Et, pour toute raiſon, qui m’attaque eſt mon pere, Ne puniſſons donc point, mais repouſſons les coups, Et ne l’attaquant pas, au moins deffendons nous:	Et -- Pas, pour toute raison, qui m'attaque est mon père, Ne punissons donc point, mais repoussons les coups, Et ne l'attaquant pas, au moins défendons nous:
Que ſonbras, s’il ſe peut, nous immole a ſa haine, Mais, s’ilſe peut außi, faiſons qu’elle ſoit vaine;	Que sonbras, s'il se peut, nous immole à sa haine, Mais, s'ilse peut aussi, faisons qu'elle soit vaine;
Forçons l’antre funeſte, ou l’on tient enfermé Ce miracle d’amour, ce chef-d’œuure animé:	Forçons l'antre funeste, ou l'on tient enfermé Ce miracle d'amour, ce chef'œuvre animé:
Pour vn ſi beau deſſein, il n’est porte trop cloſe:	Pour un si beau dessein, il n'est porte trop close:
Auons, ( ſ'qaium ansepons s oppoſe, Egalement épris de colere & d’amour, Ou faiſons qu’ily laiſſe, ou laiſſons y le iour.	Avons, ( s'qaium ansepons s oppose, Également épris de colère et d'amour, Ou faisons qu'ili laisse, ou laissons y le jour.
2	2
2DEE I CREON, EPHYTE.	E2DE I CREON, EPHYTE.
L CREON.	 CREON.
On, Ephyte, il importe au ſouſtien de ma gloire, I(Que de ce chaſtiment ie laiſſe la memoire:	On, Éphyte, il importe au soutien de ma gloire, IrEue de ce châtiment ie laisse la mémoire:
Monregne naist encore, & cette impunité, Porteroit conſequence à mon authorité:	Monregne naît encore, et cette impunité, Porterait conséquence à mon autorité:
Quels mutins, ſous mes loix, ſe laiſſeront reduire,	Quels mutins, sous mes lois, se laisseront réduire,
Si les miens les premiers taſchent de les deſtruire, Et ſi, qui contreuient à ce que ie deffends, Tnenue des parttfans en mes propres enfans.	Si les miens les premiers tâchent de les détruire, Et si, qui contrevient à ce que ie deffends, Tenue des parttfans en mes propres enfants.
EPHYTE, Sire, il eſt amoureux:	EPHYTE, Sire, il est amoureux:
v¬- .	vite- .
y------4:	y-4:
CREON.	CREON.
Moy, ie ſeray ſeuere.	Moi, Seigneur serai sévère.
EPHYTE,	EPHITE,
CREON, Il offençoit ſonpere .	CREON, Il offensait sonpère .
a	a
Il crût --.	Il crût --.
a B111 vous conſeiller, ---- LT	à B11 vous conseiller, -- 
CREON:	CREON:
Il prit trop de ſoucy.	Il prit trop de souci.
EPHYTE.	EPHITE.
Mais il la tient de vous –--	Mais il la tient de vous -
CREON.	CREON.
Ilen tient l’eſtre außi ------------ U.	Il tient l'être aussi -- V.
2	2
EPHYTE.	EPHITE.
Il s’auouë vun peu prompt:	Il s'avoue vun peu prompt:
CRÉON.	CRÉON.
I Qu'il ſouffre donc ſa peine.	I Qu'il souffre donc sa peine.
1.	1.
A	À
EPHITE.	EPHITE.
Mais, Sire, ſon amour?	Mais, Sire, son amour?
CREON.	CREON.
Mais, Ephyte, ma haine?	Mais, Éphyte, ma haine?
EPHYTE.	EPHITE.
Faites quelqu’indulgence à de ieunes eſprits!	Faites quelqu'indulgence à de jeunes esprits!
1.	1.
CREON.	CREON.
Ie pardonneray tout, excepté le m'eſpris.	Je pardonnerai tout, excepté le m'épris.
CLEODAMAS, Voicy le vieux Demu, uujai cpout miracles, En ce fatal Empire, ont ſuiuy les oracles.	CLÉODAMAS, Voici le vieux Demu, ujai cpout miracles, En ce fatal Empire, ont suivi les oracles.
EPHYTE.	EPHITE.
C’eſt Tyreſie, ô Ciel!	C'est Tyresie, ô Ciel!
ſois laſſé de nos pleurs, Et nous àpprehs par luy la fin de nos mal-heurs.	sois lassé de nos pleurs, Et nous àpprehs par lui la fois de nos malheurs.
1.	1.
SCEEVE V oua, grIDE, CREON, EPHYTE, CLEODAMAS.	SCEEVE V oua, grIDE, CREON, EPHYTE, CLÉODAMAS.
TYRESIE.	TYRÊIE.
A lumiere d’vnſeul, ſert à deux que nous ſommes, C’eſt aux hommes außi de conduire les hommes,	À lumière d'unseul, sert à deux que nous sommes, C'est aux hommes aussi de conduire les hommes,
CREON.	CREON.
Que nous apprendreg-vous, bon vieillard, qui ſans Jena 3, LiſeZ ſi clairenent dans le ſecret des Dieux?	Que nous apprendreg-vous, bon vieillard, qui sans Jena 3, Lisez si clairennent dans le secret des Dieux?
TYRESIE.	TYRÊIE.
Vnaduis qui regardk, & vous, & voſtre Empire, Mais peſez meurement ce que ie viens de dire?	Unaduis qui regardrk, et vous, et votre Empire, Mais pesez meurement ce que ie viens de dire?
* I'ay touſiours obex .	* J'ai toujours obex .
CREON vous touſiours ordonné:	CREON vous toujours ordonné:
TYRESIE.	TYRÊIE.
C’eſt l’vnique ſecret qui vous a couronné.	C'est l'unique secret qui vous a couronné.
CREON.	CREON.
Außi vous conſuitay-ie en tout ce qui me touche, Aſſeure que les Dieux parlent par voſtre bouche.	Aussi vous consuitai-je en tout ce qui me touche, Assure que les Dieux parlent par votre bouche.
EIREOISe.	EIREOIS.
Sur tout, pour voſtre bien, croyés moy deſormais, Car le beſoinen preſſe, ou n'en preſſa iamais.	Sur tout, pour votre bien, croyez moi désormais, Car le besoinen presse, ou n'en pressa jamais.
CREON.	CREON.
QDieux!	QDieux!
quelle frayeur m'excite ce langage?	quelle frayeur m'excite ce langage?
TYRESIE.	TYRÊIE.
Bienmoindre que ne doit ce funeſte preſage:	Bienmoindre que ne doit ce funeste présage:
Eſcoutez, ce matin ſur ces proches coſteaux, Nous obſeruions le chant, & le vol des oyſeaux, Lors que l’horrible cry d’vne troupe d’Orfrayes D’infaillibles mal-heurs, meſſageres trop vrayes, A remply d’vn grand bruit tous les lieux d’alentour, Et n'a point reſpecté la naiſſance du iour:	Écoutez, ce matin sur ces proches costeaux, Nous observions le chant, et le vol des oiseaux, Lors que l'horrible cri d'une troupe d'Orfraies D'infaillibles malheurs, messagères trop vraies, A rempli d'un grand bruit tous les lieux d'alentour, Et n'a point respecté la naissance du jour:
Vn nombre de Corbeaux außi funeſtes qu'ellese Leurs liurant vn combat, de becs, d’ongles & d’aiſles A quelque temps apres redouble mon emoy, Et quelques plumes m'eſme en ont tombé ſur moy	Un nombre de Corbeaux aussi funestes qu'ellese Leurs ivrant un combat, de becs, d'ongles et d'aisles A quelque temps après redouble mon émoi, Et quelques plumes m'esmé en ont tombé sur moi
N iij	 Nijà
Ie cours au Temple à lors, où la lampe allumée, Jette au lieu de lumiere vne noire fumée, Dont l’eſpaiſſeur corrompt la pureté de l’air, Et preſque m'eſtouffant, m'empéche de parler:	Je cours au Temple à lors, où la lampe allumée, Jette au lieu de lumière notre noire fumée, Dont l'épaisseur corrompt la pureté de l'air, Et presque m'étouffant, m'empêche de parler:
L’encens n’y peut bruſler quelqu'effort que i’eſſaye, La victime a l’hoſtel, n’y rendrien par ſa playe, Que quelque goutte, ou deux, d’vne iaune liqueur, Dont la corruptionm'a fait faillir le cœur:	L'encens n'y peut brûler quelqu'effort que j'essaie, La victime a l'hôtel, n'y rendrien par sa plaie, Que quelque goutte, ou deux, d'une jaune liqueur, Dont la corruptionm'a fait faillir le cœur:
Monguide, qu'à ceſoin, à mon deffaut i'employe, S’écrie eſpouuanté, qu’il n'y voit point de foye:	Monguide, qu'à cesoin, à mon défaut j'emploie, S'écrie épouvanté, qu'il n'y voit point de foie:
En fin, tout n'eſt qu’horreur, & que confuſion, Et tout, Creon, & tout, à voſtre occaſion:	En fin, tout n'est qu'horreur, et que confusion, Et tout, Creon, et tout, à votre occasion:
De vous, qui renuerſez les loix de la Nature, Qui, barbare, aux deffuncts niez la ſepulture:	De vous, qui renversez les lois de la Nature, Qui, barbare, aux défunts nés la sépulture:
De vous, qui vray Cerbere, oſtant ce droict aux corps, Empéchez le paſſage en l’empire des morts, Qui, cruel, attaquez qui ne ſe peut deffendre, Et commandeZ vn mal, que vous deuriez reprendre:	De vous, qui vrai Cerbère, ôtant ce droit aux corps, Empéchez le passage en l'empire des morts, Qui, cruel, attaquez qui ne se peut défendre, Et commandeZ un mal, que vous devriez reprendre:
Satisfaiteiles Dieux, par voſtre amandement, Et ſrachez-moy bon gré decét enſeignement.	Satisfaiteiles Dieux, par votre amandement, Et srachez-moi bon gré décet enseignement.
CREON.	CREON.
Sur tout autre, touſiours voſtre art me perſecute, Vous m’entre prenez, ſeul, ſeul ie vous ſuis en butte.	Sur tout autre, toujours votre art me persécute, Vous m'entre prenez, seul, seul Seigneur vous suis en butte.
Il faut bien que cét art ſainct & ſacré qu’il eſt;	Il faut bien que cet art saint et sacré qu'il est;
Parmy ſapureté meſle quelque intereſt:	Parmi sapureté mêle quelque intérêt:
Car le Cielllaiſſe agir l’ordre de lu nature Et n'a pas touſiours l’œil ſur vne creature:	Car le Cielllaisse agir l'ordre de lu nature Et n'a pas toujours l'œil sur une créature:
L’or eſt vn charme eſtrange, vn meſtail precieux, Qui corromp toute choſe, & tanteroit les Dieux:	L'or est un charme étrange, un métail précieux, Qui corromp toute chose, et tanterait les Dieux:
Mais ille faut gaigner parmoyens legitimes?	Mais ille faut gagner parmoyens légitimes?
Non pas en conſeillant l’impunité des crimes:	Non pas en conseillant l'impunité des crimes:
Non pas en abuſant du reſpect des Autels, Et faiſant fauſſement parler les immortels.	Non pas en abusant du respect des Autels, Et faisant faussement parler les immortels.
TYRESIE.	TYRÊIE.
Qui m'a repris que uous, d’en vſer de la ſorte.	Qui m'a repris que -vous, d'en user de la sorte.
CREONQue l’on vous en reprenne, ou ſe taiſe, qu'importe?	CRENQue l'on vous en reprenne, ou se taise, qu'importe?
TYRESIE.	TYRÊIE.
Vſez-en comme moy, le Cielſçait qui vit mieux,	Vsez-en comme moi, le Cielsait qui vit mieux,
CREON.	CREON.
Ie n’outrageray point unminiſtre des Dieux.	Je n'outragerai point unministre des Dieux.
TYRESIE.	TYRÊIE.
Vous m’outrageZ apoymuonpom u nuarice?	Vous m'outrage apoymuonpom u nuarice?
CREON.	CREON.
Peu de gens de voſtre art ſont exempt de ce vice.	Peu de gens de votre art sont exempt de ce vice.
a.	a.
.	.
.	.
.	.
.	.
a J.	a J.
	
TYRESIE.	TYRÊIE.
Et ies iprans emtor, uienmoins qu'eux, & que moy;	Et jes iprans emtor, ienmoins qu'eux, et que moi;
CLEODAMAS.	CLÉODAMAS.
Aueugle, ſpauez-vous que vous parleZ au Roy?	Aveugle, spavez-vous que vous parlez au Roi?
TYRESIE.	TYRÊIE.
Puis que ie l’ay fait tel, i'ay droit de le cognoiſtre.	Puis que ici l'ai fait tel, j'ai droit de le connaître.
Plus aueugle est que moy, te fuune croy pas l’eſtre.	Plus aveugle est que moi, te fuune crois pas l'être.
CREON.	CREON.
C eſt bien vous empoiter pour vn eſprit ſi ſain.	Ç est bien vous empoiter pour un esprit si sain.
TYRESIE.	TYRÊIE.
Enfin, ie diray plus que ie n’auois deſſein.	Enfin, Seigneur dirai plus que je n'avais dessein.
CREON.	CREON.
Parlez, car il importe au gain de voſtre vie:	Parlez, car il importe au gain de votre vie:
TYRESIE.	TYRÊIE.
Bien plus vostre intereſt que le mien m’y conuie:	Bien plus votre intérêt que le mien m'y convie:
Et vous l’allez apprendre, auant que le ſoleil Laiſſe en nostre horiſon la nuict & le ſommeil, Vous verreZ des effets du mal-heureux augure, Qui m'a ſi clairement marqué voſtre aduantule:	Et vous l'allez apprendre, avant que le soleil Laisse en notre horizon la nuit et le sommeil, Vous verrez des effets du malheureux augure, Qui m'a si clairement marqué votre avantule:
Le frere mort, priué des honneurs du cercueil,	Le frère mort, privé des honneurs du cercueil,
La	La
La ſœur viue enterrée, & tout le peuple en dueil:	La sœur vive enterrée, et tout le peuple en deuil:
Appellent d’vne voix, qui ne ſera pas vaine, La iuſtice du Ciel, ſur l’iniustice humaine:	Appellent d'une voix, qui ne sera pas vaine, La justice du Ciel, sur l'injustice humaine:
La mort de voſtre fils, ce Prince aimé de tous, eſt Sertt le premier fléau qui tombera ſur vous:	La mort de votre fils, ce Prince aimé de tous, est Sertt le premier fléau qui tombera sur vous:
D'effroyables remors, mégeres éternelles, Inuiſibles bourreaux des ames criminelles, Vous perſecuteront juſqu’aux derniers abois, Et s’il faut mettre hors tout ce que ie préuois;	D'effroyables remors, mégères éternelles, Invisibles bourreaux des âmes criminelles, Vous persécuteront jusqu'aux derniers abois, Et s'il faut mettre hors tout ce que ie préuois;
Vn bras victorieux que voſtre crime attire, Vous vabien toſt rauir & la vie & l’Empire:	Un bras victorieux que votre crime attire, Vous vabien tôt ravir et la vie et l'Empire:
Mais qu’en vous ce diſcours n’excite aucun ſcucj Et croyez, que le gainme junt panter ainſi;	Mais qu'en vous ce discours n'excite aucun scucj Et croyez, que le gainme junt panter ainsi;
Marche, enfant, ie luy laiſſe en ce triſte preſage, AſſeZ d’inſtruction pour en deuenir ſage.	Marche, enfant, ie lui laisse en ce triste présage, AsseZ d'instruction pour en devenir sage.
Creon demeure interdit.	Creon demeure interdit.
.	.
.	.
.	.
42 A M V.	42 A M V.
22 CREON, EPHYTE, CLEODAMAS;	22 CREON, EPHITE, CLEODAMAS;
EPHYTE.	EPHITE.
IRE, il peut s’abuſer;	IRE, il peut s'abuser;
mais depuis qu’en ces Ci Aeha, Sa voix rend aux mortels les reſponſes des Dieux:	mais depuis qu'en ces Ci Aéha, Sa voix rend aux mortels les réponses des Dieux:
Et qu’ilenuoye au Gielles encens de nos Temples, Les fautes de ſonart n'ont point encor d’exemples.	Et qu'ilenuoye au Gielles encens de nos Temples, Les fautes de sonart n'ont point encor d'exemples.
CREON.	CREON.
Ie tiempie, n premi, iedemtunc interdit, Et cét effet s’accorde auecce qu’il a dit?	Je tiempie, n premi, iedemtunc interdit, Et cet effet s'accorde avec uil a dit?
Oppoſons la prudence au coup, de cét orage;	Opposons la prudence au coup, de cet orage;
Mais d’ailleurs la prudence offenſe le courage;	Mais d'ailleurs la prudence offense le courage;
Me rendre lâchement au ſentiment d’autruy, Est trop honteux pourmoy, trop glorieux pour luy.	Me rendre lâchement au sentiment d'autrui, Est trop honteux pourmoi, trop glorieux pour lui.
CLEODAMAS.	CLÉODAMAS.
C’est à vous d’enreſoudre, auec voſtre ſageſſe:	C'est à vous d'enresoudre, avec votre sagesse:
27*.	27.
O.	Ô.
uf.	uf.
Lad.	Lad.
CREON.	CREON.
Ie ſuiuray vos aduis, mais toſt le beſoin preſſe.	Je suivrai vos avis, mais tôt le besoin presse.
·	
EPHYTE.	EPHITE.
Traitez le ſangd Oedipe autc plus de douceur, Mettez le frere enterre, & tirez-en laſœur.	Traitez le sangd Oedipe autc plus de douceur, Mettez le frère enterre, et tirez-en lasœur.
4	4
CLEODAMAS.	CLÉODAMAS.
Sire, à trop conſulter l’occaſion ſe paſſe, Le Ciel touche par fois außi toſt qu’il menaſſe.	Sire, à trop consulter l'occasion se passe, Le Ciel touche par fois aussi tôt qu'il menace.
CREON.	CREON.
Que i’ay de repugnance à cette lâcheté, Mais il faut obeyr à la neceßité:	Que j'ai de répugnance à cette lâcheté, Mais il faut obéir à la necemité:
Rendez donc ce deuoir au corps de Polynice, Qu’auec ſes ſœurs ſa vefue, aßiſte à cét office, Que l’on deliure Argie, & que ſa liberté, Soit le premier effet de cette impunité.	Rendez donc ce devoir au corps de Polynice, Qu'avec ses sœurs sa vefue, ausste à cet office, Que l'on délivre Argie, et que sa liberté, Soit le premier effet de cette impunité.
I.	I.
GARDE, &c.	GARDE, etc.
ÆA	ÆA
LE GARDE.	LE GARDE.
IRE, Sire, accoureZ 09	IRE, Sire, accourez 09
CREON.	CREON.
Quelle nouuelle ?	Quelle nouvelle ?
approche?	approche?
LE GARDE.	LE GARDE.
Hemon s'est fait paſſage en la funeſte roche, Où deuoit Antigone expier ſon forfait:	Hémon s'est fait passage en la funeste roche, Où devait Antigone expier son forfait:
Elle en eſt quitte, Sire, & c’en eſt deſia fait, Le Prince ſur ſon corps deteſte voſtre Empire, Et ie crains, & ie crains quelque choſe de pire:	Elle en est quitte, Sire, et c'en est déjà fait, Le Prince sur son corps deteste votre Empire, Et ainsi crains, et et ainsi quelque chose de pire:
I'en uoulois approcher, mais s’eſlancant ſur moy:	J'en uoulois approcher, mais s'élançant sur moi:
CREON.	CREON.
O tropcertain augure l ô miſerable Roy?	Ô tropcertain augure l ô misérable Roi?
Ce.	Ce.
E 0 - De quel triſte ſuccez eſt ma rage ſuiuie!	 0 - De quel triste succès est ma rage suivie!
Courons, ſauuons, mon fils, ou ceſt fait de ma vie.	Courons, sauvons, mon fils, ou cet fait de ma vie.
SLIVL VIII HEMON, ANTIGONE, ISMENE HEMON, prés ducorps d’Antigone, dans le tombeau de la rôche.	SLIVL VIII HEMON, ANTIGONE, ISMENE HÉMON, près ducorps d'Antigone, dans le tombeau de la rôche.
t Eau corps, ſacré debris du chef-d’œuure des Cieux;	t Eau corps, sacré débris du chef-d'œuvre des Cieux;
Beau reſte d’Antigone, ouureZ encor les yeux:	Beau reste d'Antigone, ouvrez encor les yeux:
Ieune ſoleil d’Amour, eſteint en ton aurore, Bel astre, honore-moy d’vn ſeul regard encore?	Jeune soleil d'Amour, éteint en ton aurore, Bel astre, honore-moi d'H seul regard encore?
Auant que ie te ſuiue en la nuict du tombeau, Tu crains, tu crains de voir le fils de ton bourreau:	Avant que Seigneur te suive en la nuit du tombeau, Tu crains, tu crains de voir le fils de ton bourreau:
Le cœur, plus que l’oreille, eſt ſourd à ma priere, Ton amours est eſteint auetquts iu tumiere;	Le cœur, plus que l'oreille, est sourd à ma prière, Ton amours est éteint auetquts ju tumière;
C’est en vaïn qu’aux Enfers ie vay ſuiure tes pas:	C'est en vaïn qu'aux Enfers jours vais suivre tes pas:
Tes manes offenſeZ ne m'y ſouffriront pas:	Tes mânes offensés ne m'y souffriront pas:
Autant que tu m'aymois, tu me ſeras contraire, Tu puniras le fils des cruautez du Pere;	Autant que tu m'aimais, tu me seras contraire, Tu puniras le fils des cruautés du Père;
Ie n’auance à mourir, non plus qu’à differér, F.	Je n'avance à mourir, non plus qu'à differér, F.
.	.
:	:
:	:
4-- h- Et ny viuant ny mort, ie n'ay plus qu’eſperer:	4- h- Vivant ici vivant ni mort, je n'ai plus qu'espérer:
Mais, Madame, arreſtez ces inutiles larmes, Et contez-moy ſa mort, où priſt-elle des armes:	Mais, Madame, arrêtez ces inutiles larmes, Et contez-moi sa mort, où prît-elle des armes:
ISMENE.	ISMENE.
Le ſoir qu’elle partit pour ce pieux deſſein, Elle tenoit caché ce poignard dans ſon ſein, Pour demeurer, parluy, maiſtreſſe de ſa vie, S’il deuoit arriuer qu’elle en fuſt pourſuiuie:	Le soir qu'elle partit pour ce pieux dessein, Elle tenait caché ce poignard dans son sein, Pour demeurer, parlui, maîtresse de sa vie, S'il devait arriver qu'elle en fût poursuivie:
A ce coup vainement, i’ay voulu reſiſter, Ie ne l’ay diuerty, ny n'ay pû l’éuiter:	À ce coup vainement, j'ai voulu résister, Je ne l'ai diverti, ni n'ai pu l'éviter:
Le ſang qu’elle a verſé, l’embellit, & me tache, Il l’a peint genereuſe, & me teſmoigne lâche;	Le sang qu'elle a versé, l'embellit, et me tache, Il l'a peint généreuse, et me témoigne lâche;
Vous l’offenſez, au reste, & ſoupçonneZ à tort, Que jon agettionjo mume par ja mon.	Vous l'offensez, au reste, et soupçonnés à tort, Que jon agettionjo mume par ja mon.
Elle ſçait à quel poinct ſa fortune vous touche Auec le nom d’Hemon, elle a fermé la bouche;	Elle serait à quel point sa fortune vous touche Avec le nom d'Hémon, elle a fermé la bouche;
C’est vn nom qu’elle emporte au delà du treſpas, Et que dans l’Oubly meſme, elle n’oubliera pas.	C'est un nom qu'elle emporte au delà du trépas, Et que dans l'Oubli même, elle n'oubliera pas.
HEMON.	HÉMON.
Allons donc, mon amour, où la ſienne m’inuite.	Allons donc, mon amour, où la sienne m'inuite.
Payons-luy cét honneur, qui paſſe mon merite:	Payons-lui cet honneur, qui passe mon mérite:
Ha!	Ha!
s’il plaiſoit aux Dieux, que pour mourir cent õis, Ie pûſſe, à ce beau corps, rendre l’ame & la voix, Que d’vn ſi bel effet, ie benirois les cauſes!	s'il plaisait aux Dieux, que pour mourir cent ouvis, Je pusse, à ce beau corps, rendre l'âme et la voix, Que d'un si bel effet, Seigneur bénirais les causes!
I'entrerois dans les feux, comme en vnlit de roſes, Le plus amer poiſon, & le plus furieux, Paſſeroit, à mon gouſt, pour breuuage des Dieux:	J'entrerais dans les feux, comme en unlit de roses, Le plus amer poison, et le plus furieux, Passerait, à mon goût, pour brevage des Dieux:
Ie me délaſſerois parmy les precipices, Et dans le ſeul repos trouuerois des ſupplices:	Je me délacerais parmi les précipices, Et dans le seul repos trouverais des supplices:
Mais depuis qu'vne vie eſt tombee entes mains, O mort, pour la rauir, tous nos efforts ſont vains:	Mais depuis qu'une vie est tombe entes mains, Ô mort, pour la ravir, tous nos efforts sont vains:
Cebutin t’eſt trop cher, & i’ay tort ſi i’eſpere Que tu rendes au fils ce que tu tiens du pere:	Célutin t'est trop cher, et j'ai tort si j'espère Que tu rendes au fils ce que tu tiens du père:
Sourde, tiens donc encore de ce dénaturé Le butin qu’il t’enuoye & qu’il t’a procuré;	Sourde, tiens donc encore de ce dénaturé Le butin qu'il t'envoie et qu'il t'a procuré;
Mais eſpargne ta faux, puis qu’ô prodige extréme!	Mais épargne ta faux, puis qu'ô prodige extrême!
La Nature, aujourd’huy, ſe deſtruit d’elle méme, Les plus proches parens ſont les plus ennemis, Le frere hait le frere, & le pere le fils:	La Nature, aujourd'hui, se détruit d'elle même, Les plus proches parents sont les plus ennemis, Le frère hait le frère, et le père le fils:
L’oncle au ſang de ſa niepce auec plaiſir ſe noye, Et tous font ton office, & te chargent de proye:	L'oncle au sang de sa niepce a paise se noie, Et tous font ton office, et te chargent de proie:
Il veut tirerſon eſpee, Iſmene le retient.	Il veut tirerson espée, Ismene le retient.
ISMENE.	ISMENE.
Hé!	Hé!
que feray-je, Hemon?	que ferai-je, Hémon?
ne m’abandonnez pas.	ne m'abandonnez pas.
C2 RXL.	C2 RXL.
CREON, EPHYTE, CLEODAMAS, HEMON, ISMENE.	CREON, EPHYTE, CLEODAMAS, HÉMON, ISMENE.
ANTIGONE.	ANTIGONE.
CREON.	CREON.
ON fils, quel deſeſpoir trouble voſtre penſee?	ON fils, quel désespoir trouble votre pensée?
IVTEt de quel vain regret eſt mon ame preſſee?	IUTEt de quel vain regret est mon âme pressée?
A quel poinct vous emporte vne funeſte amour!	À quel point vous emporte une funeste amour!
Faites grace à celuy dont vous teneZ le iour:	Faites grâce à celui dont vous teneZ le jour:
HEMON, titant ſon eſpee.	HÉMON, titant son épée.
Retirez vous barbare, éuitant ma colere, Ie n’ay plus de reſpect, ny cognoiſt plus mon pere;	Retirez -vous barbare, éuitant ma colère, Je n'ai plus de respect, toujours connaît plus mon père;
L’eſtat où ma reduit vostre inhumanité, Me peut faire paſſer à toüte extremité:	L'état où ma réduit votre inhumanité, Me peut faire passer à tendre extrémité:
Voyez, lyon regnant, affamé de carnages, Inhumain, cœurhumain, voila de vos ouurages;	Voyez, lyon régnant, affamé de carnages, Inhumain, cœurhumain, voilà de vos ouvrages;
Saoulez ce naturel aux meurtres acharné, Tenez, voila le ſang que vous m’aueZ donne:	Saoulez ce naturel aux meurtres acharné, Tenez, voilà le sang que vous m'avez donne:
Ce corps qui fut à vous reſte en vostre puiſſance, Et vous va, par ſamort, payer de ſa naiſſance.	Ce corps qui fut à vous reste en votre puissance, Et vous va, par samort, payer de sa naissance.
CREON.	CREON.
Barbare, acheue donc, acheue ton deſſein, De tup quumpuſuu, vune paſe en monſein, Ettu ne meurs pas tout, ſi le iour me demeure.	Barbare, achève donc, achève ton dessein, De tup quumpusuu, vune pase en monsein, Ettu ne meurs pas tout, si le jour me demeure.
HEMON.	HÉMON.
Bien toſt, bien-toſt le Ciel vous marquera voſtre heure:	Bien tôt, bientôt le Ciel vous marquera votre heure:
Cruel, ne doutez, pas que ſonbras tout-puiſſant, Ne s’arme toſt ou tard pour le ſanginnocent:	Cruel, ne doutez, pas que sonbras tout-puissant, Ne s'arme tôt ou tard pour le sanginnocent:
Le temps vous apprendra, que iamais tyrannie, Sur le troſne Thebain, ne demeure impunie:	Le temps vous apprendra, que jamais tyrannie, Sur le trône Thebain, ne demeure impunie:
Croyez que Cadme, Laye, Ædipe, & ſes enfans, Ne vous ont, en leurſort, precedé que du temps:	Croyez que Cadme, Laye, Édipe, et ses enfants, Ne vous ont, en leursort, précédé que du temps:
Quand des Dieux, Tyreſie, annonçoit la penſée, Elle parloit à vous, non pas à Manecée:	Quand des Dieux, Tyresie, annonçait la pensée, Elle parlait à vous, non pas à Manecée:
La race de Python, ne ceſſera qu'en vous, C’eſt ſur vous que du Cieldoit tomber le courroux, Mais puiſſent eſtre vains les maux qu’il vous prepare, Qu’il vous ſoit außi doux que vous m’eſtes barbare:	La race de Python, ne cessera qu'en vous, C'est sur vous que du Cieldait tomber le courroux, Mais puissent être vains les maux qu'il vous prépare, Qu'il vous soit aussi doux que vous m'êtes barbare:
A ma fureur, encor quelque reſpect eſt joint, Et ie ſeray content qu’il ne me venge point:	À ma fureur, encor quelque respect est joint, Et Elle serai content qu'il ne me venge point:
Toy, qui me fus rauie, außi-toſt que donnée, Vertueuſe beauté, Princeſſe infortunée!	Toi, qui me fus ravie, aussitôt que donnée, Vertueuse beauté, Princesse infortunée!
.	.
.	.
.	.
.	.
2.	2.
Allons vnis d’eſprit, ſans commerce de corps, Acheuer noſtre Hymen, en l’empire des morts?	Allons unis d'esprit, sans commerce de corps, Achever notre Hymen, en l'empire des morts?
CREON, tombant éuanoüy.	CREON, tombant évanoui.
O mortl joints mon treſpas aux efféts de ma rage!	Ô mortl joints mon trépas aux effets de ma rage!
S'orts, moname, & meteſin à ce tragique ouurage:	S'orts, monme, et metesin à ce tragique ouvrage:
135 ai d.	135 ai d.
a dn Il tombe éuanoüy, ſans force, & ſans chaleur, Tu deuois, vainregret, preceder ce mal-heur?	a dès Il tombe éuanoüy, sans force, et sans chaleur, Tu devais, vainregret, précéder ce malheur?
CLEODAMAS.	CLÉODAMAS.
O ciel!	Ô ciel!
qu’aux chaſtimens, ta iuſtice eſt ſeuere?	qu'aux châtiments, ta justice est sévère?
Et qu'il eſt dangereux d’exciter ta colere?	Et qu'il est dangereux d'exciter ta colère?
.	.
ISMENE.	ISMENE.
Lâche, ne puis-je dont faire un derniereffort:	Lâche, ne puis-je dont faire un dernièreffort:
Mourray-ie mille foit, pour la peur d’une mort?	Mourrai-je mille soit, pour la peur d'une mort?
OVIS par la grace de Dieu Roy de France & de	OUÏS par la grâce de Dieu Roi de France et de
Nauarre:	Navarre:
A nos amez & ſeaux Conſeillers, les gens.	A nos âmez et seaux Conseillers, les gens.
tenans nos Cours de Parlemens, Maiſtres des Requeſtes ordinaires de noſtre Hoſtel, Baillifs, Seneſchoux, Preuoſts, leurs Lieutenans, & à tous autres de nos luſticiers &x Officiers qu’il appartiendra, Salut;	tenants nos Cours de Parlements, Maîtres des Requêtes ordinaires de notre Hôtel, Baillifs, Seneschoux, Preuôts, leurs Lieutenants, et à tous autres de nos lûticiers etx Officiers qu'il appartiendra, Salut;
Noſtre cher & bien amé TOVSSAINT QVINET, Marchand Libraire de noſtre bonne ville de Paris, Nous a fait remonſtrer qu’il deſireroit faire imprimer vne Tragedie intitulée L’ANTIGONEN TRAGEDIE, DVSIEVR DE ROTROV:	Notre cher et bien amé TOUSSAINT QUINET, Marchand Libraire de notre bonne ville de Paris, Nous a fait remontrer qu'il désirerait faire imprimer une Tragédie intitulée L'ANTIGONEN TRAGÉDIE, DUSIEUR DE ROTROU:
Ce qu’il ne peut faire, ſans auoir lur ce nos Lertres humblement nous requerant icelles.	Ce qu'il ne peut faire, sans avoir lur ce nos Lertres humblement nous requérant icelles.
A CES CAVSES, deſitant traiter fauorablement ledit Expoſant, Nous luy auons permis & permettons, par ces preſentes, de faire imprimer, vendre & debiter en tous les lieux de noſtre obeyſſance ledit Liure, en telle matge, & tel caractere, & autant de fois que bon luy ſemblera, durant l'eſpace de ſix-ans entiers & accomplis, à compter du iour qu’elle ſera acheuée d’imprimer pour la premiete fois:	À CES CAUSES, desitant traiter favorablement ledit Exposant, Nous luitaît permis et permettons, par ces présentes, de faire imprimer, vendre et débiter en tous les lieux de notre obéissance ledit Livre, en telle matge, et tel caractère, et autant de fois que bon lui semblera, durant l'espace de six-ans entiers et accomplis, à compter du jour qu'elle sera achevée d'imprimer pour la premiète fois:
Et faiſons tres-expreſſes deffenſes à tou:	Et faisons très-expresses défenses à tou:
tes perſonnes, de quelque qualité & condition qu’elles ſoient, de l’imprimer, faite imprimer, vendre ny debiter en tous leslieux de noſtre obeyſſance, ſans le conſentement de l’Expoſant, ſous ptetexte d’augmentarion, correction, changemens de titres, fauſſes marques, oü autres, en quelque ſorte & maniere que ce ſoit, à peine de trois mil liures d’amende, nonobſtant oppoſitions ou appellations quelconques, par chacun des contreuenans, applicable vn tiers à Nous, vn tiets à l’Hoſtel-Dieu de noſtte bonne ville de Paris, & l'autre tiets à l'Expoſant, confiſcation des exemplaires contrefaits, & de tous deſpens, dommages & intereſts,à condition qu’il ſera mis deux Exemplaites de ladite Tragedie en noſtre Bibliotheque publique, & vne en celle de noſtre tres-cher & ſoal le ſieur Seguier, Cheualier, Chancelier de Franceauant que ll’expoſet en vente, apeine de nullité des preſentes:	tes personnes, de quelque qualité et condition qu'elles soient, de l'imprimer, faite imprimer, vendre encore débiter en tous leslieux de notre obéissance, sans le consentement de l'Exposant, sous ptetexte d'augmentarion, correction, changements de titres, fausses marques, ou autres, en quelque sorte et manière que ce soit, à peine de trois mil livres d'amende, nonobstant oppositions ou appelait quelconques, par chacun des contrevenants, applicable un tiers à Nous, un tiéts à l'Hôtel-Dieu de te bonne ville de Paris, et l'autre tiets l'Exposant, confiscation des exemplaires contrefaits, et de tous dépens, dommages et te condition il sera mis eu Te de ladite Tragedie en nôtre Bo publique, et n en celle de nôtre très-cher et soal le sieur Seguier, Cheualier, Chancelier de Franceauant que exposet en vente, y de nullité des presentes:
Dur contend delquelles, Nous vous mandons que faciez iouir & vſerplainement & paiſiblement ledit Expoſant, & tous ceux qui auront dtoit de luy, ſans qu’il leur ſoit donné aucun trouble ny empeſchement.	Dur compend delquelles, Nous vous mandons que fassiez jouir et userplainement et paisiblement ledit Exposant, et tous ceux qui auront dûtait de grands, sans qu'il leur soit donné aucun trouble rien empêchement.
Voulons auſſi qu’en mettant au commencement ou à la fin dudit Liure vn Extraict des preſentes elles ſoient tenuës pour deutment ſignifiées, & que foy y ſoit adiouſtée, & aux copies collationnées par l’vn de nos amez & feaux Conſeillers & Secretairès, comme à l’original.	Voulons aussi qu'en mettant au commencement ou à la fin dudit Livre un Extrait des présentes elles soient tenues pour deutment signifiées, et que foi y soit ajoutée, et aux copies collationnées par l'ils de nos âmez et féaux Conseillers et Secretairés, comme à l'original.
Mandons au premier-noſtte Huiſſier ou Sergent ſut ce requis, de faire pour l’execution des preſentes tous exploits neceſſaires, ſans demander autre permiſſion:	Mandons au premier-nôtte Huissier ou Sergent sut ce requis, de faire pour l'exécution des présentes tous exploits nécessaires, sans demander autre permission:
Car tel eſt noſtre plaiſir.	Car tel est notre plaisir.
Nonobſtant clameur de Haro, Chattre Normande, & autres Lettres à ce contraires.	Nonobstant clameur de Haro, Chattre Normande, et autres Lettres à ce contraires.
Donné à Paris, lé 5.	Donné à Paris, lé 5.
iour de Nouembre, l’An de grace 1638.	jour de Novembre, l'An de grâce 1638.
Et de noſtre Regne le ving-neufieſme.	Et de notre Reine le ving-neuvième.
Parle Roy enſon Concil.	Parle Roy enson Concil.
DE MONCEAVX.	DE MONCEAUX.
Et ledit Quinet n aſſocié auec luy audit Priuilege Antoine de Sommauille, außi Marchand Lihraire, ſuiuant l’accord fait entr' eux.	Et ledit Quinet n associé avec lui audit Privilège Antoine de Sommaville, aussi Marchand Lihraire, suivant l'accord fait entr' eux.
	
