IRONOCOL 2 Le Theatre repreſente une Nuit.	JRONOCOL 2 Le Théâtre représente une Nuit.
SCENE PREMIERE.	SCÈNE PREMIÈRE.
LA NUIT dans ſon Char.	LA NUIT dans son Char.
& * 6 39 Chevons noſtre cours paiſible, Achevons de verſer nos tranquilles Pavots;	et * 6 39 Chevons notre cours paisible, Achevons de verser nos tranquilles Pavots;
Mortels, dans voſtre ſort penible Le plus grand bien eſt le repos.	Mortels, dans votre sort pénible Le plus grand bien est le repos.
Goûtez ce calme heureux que le Deſtin vous laiſſe, Le Jour ne reviendra qu’avec trop de viteſſe, Et mille ſoins divers S’empareront de l’Univers.	Goûtez ce calme heureux que le Destin vous laisse, Le Jour ne reviendra qu'avec trop de vitesse, Et mille soins divers S'empareront de l'Univers.
On entend un bruit de Guerre.	On entend un bruit de Guerre.
Quel bruit interrompt le ſilence De la Terre & des Cieux?	Quel bruit interrompt le silence De la Terre et des Cieux?
D’où vient que dans ces lieux La Victoire s’avance?	D'où vient que dans ces lieux La Victoire s'avance?
CENE DEUXIE’ME.	CÈNE DEUXIE'ME.
LA NUIT, LA VICTOIRE.	LA NUIT, LA VICTOIRE.
Suite de la Victoire.	Suite de la Victoire.
Chœur de la Suite de la Victoire.	Chœur de la Suite de la Victoire.
Llons, allons, ne tardons pas, AUn jeune HEROS nous appelle;	Llons, allons, ne tardons pas, AUn jeune HÉROS nous appelle;
Allons le couronner dans l’horreur des combats, La Victoire à jamais luy veut eſtre fidelle, Elle ſuivra toüjours ſes pas.	Allons le couronner dans l'horreur des combats, La Victoire à jamais a voir été fidèle, Elle suivra toujours ses pas.
On commence à voir un peu de clarté.	On commence à voir un peu de clarté.
LA VICTOIRE.	LA VICTOIRE.
O Nuit!	Ô Nuit!
precipiteZ voſtre ſombre carriere, Déja du Dieu du Jour un foible éclat nous luit;	précipitez votre sombre carrière, Déjà du Dieu du Jour un faible éclat nous luit;
Cedez à la lumiere, FuyeZ, fuyeSi vojoure Nuit.	Cédez à la lumière, Fuyez, fuieSi vojoure Nuit.
LA NUIT.	LA NUIT.
Il n’eſt pas temps encor que le Soleil me chaſſe, O Ciel!	Il n'est pas temps encor que le Soleil me chasse, Ô Ciel!
par quelle nouveauté Vient-il ſi-toſt prendre ma place Et faire briller ſa clarté?	par quelle nouveauté Vient-il sitôt prendre ma place Et faire briller sa clarté?
La clarté augmente peu à peu.	La clarté augmente peu à peu.
CHOEUR.	CHOEUR.
O Nuit!	Ô Nuit!
precipitez voſtre ſombre carriere, Voyez quel eſt déja cét éclat qui nous luit, Cedez à la lumiere, Fuyez, fuyez, obſcure Nuit.	précipitez votre sombre carrière, Voyez quel est déjà cet éclat qui nous luit, Cédez à la lumière, Fuyez, fuyez, obscure Nuit.
LA NUIT.	LA NUIT.
Il faut ceder, je ne puis m’en défendre, On trop grand eclat m'y reduit.	Il faut céder, je ne puis m'en défendre, On trop grand éclat m'y réduit.
Quel prodige doit-on attendre Dans le jour qui me ſuit?	Quel prodige doit-on attendre Dans le jour qui me suit?
LA VICTOIRE.	LA VICTOIRE.
Le temps vous preſſe trop, oous ne pouvez l’apprendre.	Le temps vous presse trop, oous ne pouvez l'apprendre.
CHOLOR Fuyez, fuyez, obſcure Nuit.	CHOLOR Fuyez, fuyez, obscure Nuit.
La Nuit ſe retire.	La Nuit se retire.
SCENE TROISIE’ME.	SCÈNE -TROISIE'ME.
LAVICTOIRE, Suite de la Victoire.	LAUICTOIRE, Suite de la Victoire.
On voit le Palais du Soleil qui commence à s’ouvrir.	On voit le Palais du Soleil qui commence à s'ouvrir.
LA VICTOIRE.	LA VICTOIRE.
U Palais du Soleil la barriere éclatante D S’ouvre de moment en moment.	V Palais du Soleil la barrière éclatante D 'ouvre de moment en moment.
Marquons au Dieu du Jour qui remplit nôtre attente Combien à nos regards ce ſpectacle eſt charmant.	Marquons au Dieu du Jour qui remplit notre attente Combien à nos regards ce spectacle est charmant.
Pendant que le Palais du Soleil acheve de s’ouvrir, la Suite de la Victoire en marque ſa joye par des Danſes.	Pendant que le Palais du Soleil achève de s'ouvrir, la Suite de la Victoire en marque sa joie par des Danses.
1	1
SCENE QUATRIE’ME.	SCÈNE QUATRIE'ME.
ASOLHIE, LES TIEORES, LAVICTOIRE & ſa Suite.	ASOLHIE, LES TIEORES, LAUICTOIRE et sa Suite.
LE SOLEIL.	LE SOLEIL.
* Ictoire, tu le vois, j’accomplis ma promeſſe, 1 A ſuivre tes deſirs tu vois que je m'empreſſe, L’ordre de l’Univers, & d’éternelles loix lli pouu paucun qui m'arreſte, Je vais partir plûtost que je ne dois, Pour éclairer la premiere Conqueſte Du Fils du plus puiſſant des Rois.	* Ictoire, tu le vois, j'accomplis ma promesse, 1 A suivre tes désirs tu vois que je m'empresse, L'ordre de l'Univers, et d'éternelles lois l ois l' qui m'arrête, Je vais partir plutôt que je ne dois, Pour éclairer la première Conquête Du Fils du plus puissant des Rois.
LA VICTOIRE.	LA VICTOIRE.
Je ne puis te marquer trop de reconnoiſſance, Soleil, quand tu répons à mon impatience Un grand Roy m’a preſcrit de voler en des lieux Où ſon auguſte Fils, d’un courage intrepide, Expoſe des jours precieux, Ma courſe n'eſt jamais plus prompte & plus rapide Que quand je ſuis les Loix d’un Roy ſi glorieux.	Je ne puis te marquer trop de reconnaissance, Soleil, quand tu réponds à mon impatience Un grand Roi m'a prescrit de voler en des lieux Où son auguste Fils, d'un courage intrépide, Expose des jours précieux, Ma course n'est jamais plus prompte et plus rapide Que quand je suis les Lois d'un Roi si glorieux.
LE SOLEIL.	LE SOLEIL.
Pendant quelques momens encore Laiſſons briller l’Aurore, Et j'entre en ma carriere avec la meſme ardeur Qui poſſede ton cœur.	Pendant quelques moments encore Laissons briller l'Aurore, Et j'entre en ma carrière avec la même ardeur Qui possède ton cœur.
0111 Quel Deſtin aujourd’huy commence!	0111 Quel Destin aujourd'hui commence!
Quelle brillante gloire aujour d’huy prend naiſſance!	Quelle brillante gloire aujour d'hui prend naissance!
Que de fameux Exploits l’un à l’autre enchaînez.	Que de fameux Exploits l'un à l'autre enchaînés.
S’offrent dans l’avenir à mes yeux étonnez!	S'offrent dans l'avenir à mes yeux étonnés!
A ce Vainqueur nouveau mille Ennemis ſe rendent, Mille ſuperbes Murs tombent ſous ſon effort.	À ce Vainqueur nouveau mille Ennemis se rendent, Mille superbes Murs tombent sous son effort.
Que voy-je?	Que vois-je?
quel illustre ſort!	quel illustre sort!
ni puiisſait à vout et que utmandent Et l’Exemple qu’il ſuit, & le Sang dont il ſort.	ni puiissait à vout et que utmandent Et l'Exemple qu'il suit, et le Sang dont il sort.
Danſes de la Suite de la Victoire & des Heures.	Danses de la Suite de la Victoire et des Heures.
Chœur de la Suite de la Victoire.	Chœur de la Suite de la Victoire.
Treparons, preparons nos Paimes immortelles Pour tant d’Exploits guerriers, Pour des Conqueſtes ſi belles Préparons tous nos Lauriers.	Treparons, préparons nos Paimes immortelles Pour tant d'Exploits guerriers, Pour des Conquêtes si belles Préparons tous nos Lauriers.
Chœur des Heures & de la Suite de la Victoire.	Chœur des Heures et de la Suite de la Victoire.
Hâtez-vus, ô Soleil!	Hâtez-vus, ô Soleil!
hâtez-vous de paroiſtre, Partez, partez, il en est temps.	hâtez-vous de paraître, Partez, partez, il en est temps.
Que de jours glorieux, que de jours éclatans, Suivront le beau jour qui va naiſtre!	Que de jours glorieux, que de jours éclatants, Suivront le beau jour qui va naître!
Hâtez-vous, ô Soleil!	Hâtez-vous, ô Soleil!
hâtez-vous de paroiſtre.	hâtez-vous de paraître.
LE SOLEIL dans ſon Char.	LE SOLEIL dans son Char.
Je commence mon cours, va, pars ainſi que moy;	Je commence mon cours, va, pars ainsi que moi;
Victoire, accordons-nous à ſervir un grand Roy.	Victoire, accordons-nous à servir un grand Roi.
Le Soleil part, & la Victoire s’envole.	Le Soleil part, et la Victoire s'envole.
RCTE 1 RS DE LA TRAGEDIE.	RCTE 1 RS DE LA TRAGÉDIE.
LES TROIS SIRENES.	LES TROIS SIRÈNES.
LES NEREIDES.	LES NÉRÉIDES.
LES TRITONSET LES FLEUVES.	LES TRITONSET LES FLEUVES.
Troupe de Grecs.	Troupe de Grecs.
Troupe de Perſes.	Troupe de Perses.
LES VENTS.	LES VENTS.
LES TROIS EUMENIDES.	LES TROIS EUMENIDES.
Troupe de Dieux Celeſtes.	Troupe de Dieux Célestes.
Troupe de Dieux Terrestres.	Troupe de Dieux Terrestres.
THETIS	THÉTIS
A TTI I Y MREMAS TRAGEDIE.	À TTI I Y MREMAS TRAGÉDIE.
S Μιλιληλ πλλλλ πηλλλλλλιαη λαλλλμxαη	 Μιλιληλ πλλλλ πηλλλλλλιαη λαλλλμxαη
ACTE TREMIER.	ACTE TREMIER.
Le Theatre repreſente le Palais de Thetis.	Le Théâtre représente le Palais de Thétis.
SCENE PREMIERE.	SCÈNE PREMIÈRE.
PELE’E.	PELÉLÉ.
Ue mon deſtin eſt déplorable!	Que mon destin est déplorable!
En vain à mes ſoûpirs Thetis eſt favorable, Helas!	En vain à mes soupirs Thétis est favorable, Hélas!
Neptune en eſt charmé.	Neptune en est charmé.
La crainte que nous cauſe un Dieu ſi redoutable 2 Tient toujours dans nos cœurs ce beau feu renfermé.	La crainte que nous cause un Dieu si redoutable 2 Tient toujours dans nos cœurs ce beau feu renfermé.
Quelles ſont tes rigueurs, Amour impitoyable!	Quelles sont tes rigueurs, Amour impitoyable!
Il eſt encor des maux pour un amant aimé.	Il est encor des maux pour un amant aimé.
SCENE SECONDE.	SCÈNE SECONDE.
PELEE, DORIS, CIDIPPE.	PÈLE, DORIS, CIDIPPE.
DORIS.	DORIS.
Uoy?	Uoi?
je vous trouve ſeul?	je vous trouve seul?
Thetis attend Ne2 ptune;	Thétis attend Ne2 ptune;
Lorſqu'il vient a ſes yeux faire briller ſa Cour, Il ſemble que d’un ſi beau jour L’éclat vous importune;	Lorsqu'il vient à ses yeux faire briller sa Cour, Il semble que d'un si beau jour L'éclat vous importune;
La retraite ne plaiſt qu’à des cœurs pleins d’amour.	La retraite ne plaît qu'à des cœurs pleins d'amour.
PELE’E.	PELÉLÉ.
Moy, Nimpne, jaimeroust non, mon cœur eſt paiſible, Non, mon cœur n'eſt point enflamé.	Moi, Nympne, jaimeroût non, mon cœur est paisible, Non, mon cœur n'est point enflammé.
DORIS.	DORIS.
On dit d’un air moins animé Que l’on eſt inſenſible.	On dit d'un air moins animé Que l'on est insensible.
PELE’E.	PELÉLÉ.
Par le ſeul mot d’amour vous m’avez allarmé.	Par le seul mot d'amour vous m'avez alarmé.
DORIS.	DORIS.
C’eſt en vain qu’un Amant tache de ſe contraindre, En vain il cache ſon ardeur, Les efforts qu’il ſe fait pour feindré Trahiſſent malgré luy le ſecret de ſon cœur.	C'est en vain qu'un Amant tache de se contraindre, En vain il cache son ardeur, Les efforts qu'il se fait pour feinré Trahissent malgré lui le secret de son cœur.
J'ignore quel objet dans voſtre ame a fait naiſtre Des feux qui n’oſent éclater;	J'ignore quel objet dans votre âme a fait naître Des feux qui n'osent éclater;
Mais vous aimez, j’ay ſceu le reconnoiſtre, Ne cherchez point à m'en faire douter.	Mais vous aimez, j'ai su le reconnaître, Ne cherchez point à m'en faire douter.
PELE’E.	PELÉLÉ.
J'aimerois ſi l’amour ſincere Pouvoit s’aſſûrer d’eſtre heureux;	J'aimerais si l'amour sincère Pouvait s'assurer d'être heureux;
Mais ſouvent les plus beaux feux Trouvent un objet ſevere, Souvent on prefere L’Amant le moins amoureux.	Mais souvent les plus beaux feux Trouvent un objet sévère, Souvent on préfère L'Amant le moins amoureux.
Neptune aime Thetis, c’eſt à moy qu’il confie Ses ſecrets ſentimens, Mais ſes tourmens Me font voir ſans envie Le deſtin des Amans.	Neptune aime Thétis, c'est à moi qu'il confie Ses secrets sentiments, Mais ses tourments Me font voir sans envie Le destin des Amants.
DORIS.	DORIS.
Dequoy peut vous ſervir une feinte éternelle?	Dequoy peut vous servir une feinte éternelle?
Roy des Theſſaliens, fameux par vos exploits, Vous aimez, vous ſerez fidelle, D’où vient que vous n’oſez découvrir voſtre choix?	Roi des Thessaliens, fameux par vos exploits, Vous aimez, vous serez fidèle, D'où vient que vous n'osez découvrir votre choix?
Avec une gloire éclatante, Vous flaterez la vanité D’une fiere beauté;	Avec une gloire éclatante, Vous flatterez la vanité D'une fière beauté;
Avec une flame constante Vous pourrez d’une indifferente Vaincre la cruauté;	Avec une flamme constante Vous pourrez d'une indifférente Vaincre la cruauté;
Glllomnre prorrt cetatante, Avec une flame conſtante, On eſt aiſément écouté.	Glllomnre prorrt cetatante, Avec une flamme constante, On est aisément écouté.
PELE’E.	PELÉLÉ.
Vous tâcheZ vainement d’animer mon courage, Quand je ſerois Amant, croirois-je vos diſcours?	Vous tâchez vainement d'animer mon courage, Quand je serais Amant, croirais-je vos discours?
La crainte eſt toujours Le cruel partage Des tendres amours.	La crainte est toujours Le cruel partage Des tendres amours.
RIS.	RIS.
L’eſpoir eſt toujours Le charmant partage Des tendres amours.	L'espoir est toujours Le charmant partage Des tendres amours.
PELE’E & DORIS.	PELÉLÉ et DORIS.
La crainte L’eſpoir eſt toujours Le charmant Le cruel partage Des tendres amours.	La crainte L'espoir est toujours Le charmant Le cruel partage Des tendres amours.
SCENE TROISIESME.	SCÈNE -TROISIÈME.
THETTS, DORIS, PELEE, CIDIPPE, Nymphes de la Suite de Thetis.	THÉTTS, DORIS, PELÉE, CIDIPE, Nymphes de la Suite de Thétis.
DORIS.	DORIS.
Eeſſe, avec plaiſir nous allons voir la Feſte O Que le Dieu des Eaux vous appreſte.	Éesse, avec plaisir nous allons voir la Fête Ô Que le Dieu des Eaux vous apprête.
THETIS.	THÉTIS.
J'eſpere qu’en ce jour vostre amitié pour moy Vous fera partager l’honneur que je reçoy.	J'espère qu'en ce jour votre amitié pour moi Vous fera partager l'honneur que je reçois.
On voit venir de loin les Sirenes, & on entend leur Muſique.	On voit venir de loin les Sirènes, et on entend leur Musique.
Mais nous voyons déja les Sirenes paroiſtre, Nous entendons leurs doux Concerts, Preparons-nous à voir bien-toſt le Maiſtre Des vaſtes Mers.	Mais nous voyons déjà les Sirènes paraître, Nous entendons leurs doux Concerts, Préparons-nous à voir bientôt le Maître Des vastes Mers.
SCENE QVATRIE'ME.	SCÈNE QUTATRIE'ME.
THETIS, DORIS, PELE’E, LES TROIS SIRENES Nymphes de la Suite de Thetis, Nereïdes qui accompagnent les Sirenes.	THÉTIS, DORIS, PELELE, LES TROIS SIRÈNES Nymphes de la Suite de Thétis, Nereïdes qui accompagnent les Sirères.
LES SIRENES.	LES SIRÈNES.
Os chants harmonieux forcent tout à ſe rendre, N Nous diſpoſons des cœurs à noſtre gré, Dés que nos voix ſe font entendre Noſtre triomphe eſt aſſuré.	Os chants harmonieux forcent tout à se rendre, N Nous disposons des cœurs à notre gré, Dès que nos voix se font entendre Notre triomphe est assuré.
Danſe des Nereïdes.	Danse des Nereïdes.
LES SIRENES à Thetis.	LES SIRÈNES à Thétis.
PreneZ d’aimables chaînes, Que nos Chanſons ne ſoient pas vaines Pour ta premiert jois;	PreneZ d'aimables chaînes, Que nos Chansons ne soient pas vaines Pour ta premiert jois;
Epbcit de righeurs inbumaines Pour un fidelle amour annoncé par nos voix?	Épbit de righeurs inbumaines Pour un fidèle amour annoncé par nos voix?
OOLADLITEIEME.	OLADLITEIEME.
NEPTUNE, THETIS, PELE’E, TRITONS, & FLEUVES de la Suite de Neptune, DORIS, SIRENES, NEREIDES.	NEPTUNE, THÉTIS, PÈLE, TRITONS, et FLEUVES de la Suite de Neptune, DORIS, SIRÈNES, NÉRÉIDES.
Chœur de Tritons & de Fleuves.	Chœur de Tritons et de Fleuves.
Mpreſſons-nous à plaire au Dieu des Ondes, Il adore Thetis, adorons ſes beaux yeux, Les Amours deſcendront dans nos Grottes profondes, Ils regnent juſque dans ces lieux.	Mpressons-nous à plaire au Dieu des Ondes, Il adore Thétis, adorons ses beaux yeux, Les Amours descendront dans nos Grottes profondes, Ils règnent jusque dans ces lieux.
NEPTUNE à Thetis.	NEPTUNE à Thétis.
VoyeZ, belle Déeſſe, Voyez toute ma Cour vous marquer ſon tranſport, Je vous ſoûmets par ma tendreſſe Tout ce qui m'est foumtus par tes orurta du Sort.	VoyeZ, belle Déesse, Voyez toute ma Cour vous marquer son transport, Je vous soumets par ma tendresse Tout ce qui m'est foumtus par tes orurta du Sort.
Jupiter m'enleva le plus noble partage;	Jupiter m'enleva le plus noble partage;
Mais l’Empire des Mers où je donne la loy, bundEmpire des Cieux doit avoir l’avantage, Quand vous regnerez avec moy.	Mais l'Empire des Mers où je donne la loi, bundEmpire des Cieux doit avoir l'avantage, Quand vous régnerez avec moi.
THETIS.	THÉTIS.
Je doute que du Sort la ſuprême puiſſance enx ult voorince ex cev nonncur;	Je doute que du Sort la suprême puissance enx ult volince ex ce nonncur;
Mais je reçoy vos ſoins avec reconnoiſſance, C’est le ſeul ſentiment qui dépend de mon cœur	Mais je reçois vos soins avec reconnaissance, C'est le seul sentiment qui dépend de mon cœur
NEPTUNE.	NEPTUNE.
Je me flate que ma constance Doit m’attirer une autre recompenſe;	Je me flatte que ma constance Doit m'attirer une autre récompense;
Aimez, aimez à vostré tour, C'esi tamour jeut qui pent payer t'amour.	Aimez, aimez à vostré tour, C'esi amour jeut qui pent payer t'amour.
Chœur de toutes les Divinitez de la Mer.	Chœur de toutes les Divinités de la Mer.
Aimez, aimez a vostre tour, C’est l’amour ſeul qui peut payer l’amour.	Aimez, aimez à votre tour, C'est l'amour seul qui peut payer l'amour.
Danſe des Divinitez de la Mer.	Danse des Divinités de la Mer.
Chœur de toutes les Divinitez.	Chœur de toutes les Divinités.
Tout reconnoist l’Amour, tout ſe plaiſt dans ſes chaînes, Tout céde à ſes loix ſouveraines;	Tout reconnaît l'Amour, tout se plaît dans ses chaînes, Tout cède à ses lois souveraines;
Mais il n’eſt rien dans l’Univers Qui luy ſoit plus ſoûmis que l’Empire des Mers.	Mais il n'est rien dans l'Univers Qui notre soit plus soumis que l'Empire des Mers.
ITON.	ITON.
C’est dans nos flots que Venus prit naiſſance, Nous fûmes les premiers ſous ſon obeïſſance, La Mere d’Amour fit ſur nous L’eſſay de ſes traits les plus doux.	C'est dans nos flots que Venus prit naissance, Nous fûmes les premiers sous son obéissance, La Mère d'Amour fit sur nous L'essai de ses traits les plus doux.
Chœur de toutes les Divinitez de la Mer.	Chœur de toutes les Divinités de la Mer.
Rendez-vous à l’amour, ce deZ-luy la victoire, Commandez ſur les flots, accordez-nous la gloire De vivre ſous vos loix.	Rendez-vous à l'amour, ce deZ-lui la victoire, Commandez sur les flots, accordez-nous la gloire De vivre sous vos lois.
NEPTUNE aux Divinitez de la Mer, Je ſuis content de vostre Zele, Il ne ſçauroit mieux éclater.	NEPTUNE aux Divinités de la Mer, Je suis content de votre Zèle, Il ne saurait mieux éclater.
A Thetis.	À Thétis.
ſe vous quitte, atmavte tmmortelle, Songez u tu Granatur ou vous pouveZ monter, Mais ſongez encor plus à mon amour fidelle.	se vous quitte, atmavte tortelle, Songez tu Granatur ou vous pouveZ monter, Mais songez encor plus mon amour fidelle.
Neptune ſort avec les Divinitez de la Mer.	Neptune sort avec les Divinités de la Mer.
SCENE SIXIE’ME.	SCÈNE SIXIE'ME.
THETIS, PELE’E.	THÉTIS, PELÉLÉE.
PELE’E.	PELÉLÉ.
E viens de ſoûtenir le ſpectacle fatal J Des hommages pompeux que vous rend mon Rival, Pour me payer d’une peine ſi dure Vos plus tendres regards ne me ſont-ils pas dûs?	E viens de soutenir le spectacle fatal J Es hommages pompeux que vous rend mon Rival, Pour me payer d'une peine si dure Vos plus tendres regards ne me sont-ils pas dus?
Parlez, ou que du moins un ſoupir me raſſure Contre les ſoins que l’on vous a rendus.	Parlez, ou que du moins un soupir me rassure Contre les soins que l'on vous a rendus.
THETIS.	THÉTIS.
PerdeZ une crainte importune, Je viens d’apprendre encor que mes foibles attraits Vous donnent un Rival plus puiſſant que Neptune, Et mon cœur est à vous plus qu’il n’y fut jamais.	Perdez une crainte importune, Je viens d'apprendre encor que mes faibles attraits Vous donnent un Rival plus puissant que Neptune, Et mon cœur est à vous plus qu'il n'y fut jamais.
PELE’E.	PELÉLÉ.
An:	An:
fupiter est ce Rivai terrible.	fupiter est ce Rivai terrible.
ETIS.	ETIS.
C’eſt luy qui va m’offrir des ſoupirs ſuperflus.	C'est assez qui va m'offrir des soupirs superflus.
PELE’E.	PELÉLÉ.
Quoy?	Quoi?
Jupiter pour vous est devenu ſenſible?	Jupiter pour vous est devenu sensible?
Ma peine eſtoit trop foible, & rien n’y manque plus.	Ma peine était trop faible, et rien n'y manque plus.
DaigneZ me pardonner ma crainte & mes allarmes, Si j’en croyois les troubles que je ſens, Je me plaindrois de l’excés de vos charmes, Coiſqu ues me font ces Iuouux ſi puiſſans.	Daignez me pardonner ma crainte et mes alarmes, Si j'en croyais les troubles que je sens, Je me plaindrais de l'excès de vos charmes, Cois ues me font ces Juvouux si puissants.
HETIS.	HÉTIS.
Vous remportez des victoires nouvelles, Quand je fais des Amans nouveaux, Si mes conquestes ſont trop belles, Vos triomphes en ſont plus beaux.	Vous remportez des victoires nouvelles, Quand je fais des Amants nouveaux, Si mes conquêtes sont trop belles, Vos triomphes en sont plus beaux.
PELE’E.	PELÉLÉ.
Je ne ſuis qu’un mortel, c’est en vain que j’eſpere;	Je ne suis qu'un mortel, c'est en vain que j'espère;
Ces Dieux empreſſez à vous plaire Me font ſentir trop vivement ue je ſuis un temeraire D’oſer estre vostre amant.	Ces Dieux empressez à vous plaire Me font sentir trop vivement ue je suis un téméraire D'oser être votre amant.
THETIS.	THÉTIS.
Dans l’Empire d’Amour on tient le rang ſuprême Dés que l’on ſçait charmer, Un Mortel qui ſe fait aimer Est egal à fûphoumome, Dans l’Empire d’Amour on tient le rang ſuprême Dés que l’on ſçait charmer.	Dans l'Empire d'Amour on tient le rang suprême Dès que l'on sait charmer, Un Mortel qui se fait aimer Est égal à fuphoumome, Dans l'Empire d'Amour on tient le rang suprême Dès que l'on sait charmer.
PELE’E.	PELÉLÉ.
Lorſque j’obtiens de vous un ſi doux ſacrifice, O Ciel!	Lorsque j'obtiens de vous un si doux sacrifice, Ô Ciel!
dans quels malheurs il faut que je languiſſe!	dans quels malheurs il faut que je languisse!
ceſperois que l’hymen finiroit mon tourment, Mais tout s’oppoſe à cét eſpoir charmant, Plus vous m’aimez, plus je ſens le ſupplice D’eſtre aimé vainement.	cesperais que l'hymen finirait mon tourment, Mais tout s'oppose à cet espoir charmant, Plus vous m'aimez, plus je sens le supplice D'être aimé vainement.
PELEE & THETIS.	PÈLE et THÉTIS.
Faut-il que tout s’uniſſe Contre de ſi beaux feux?	Faut-il que tout s'unisse Contre de si beaux feux?
111 queus meijeminee, Les plus tendres amours ſont les plus malheureux.	111 queus meijemine, Les plus tendres amours sont les plus malheureux.
THETIS.	THÉTIS.
Redoublons, s’il ſe peut, nostre ardeur mutuelle, Par nostre amour tâchons à ſurmonter La fortune cruelle.	Redoublons, s'il se peut, notre ardeur mutuelle, Par notre amour tâchons à surmonter La fortune cruelle.
PELE’E & THETIS.	PELÉLE et THÉTIS.
Aimons, c’eſt le ſeul bien qu’on ne peut nous oſter.	Aimons, c'est le seul bien qu'on ne peut nous ôter.
FIN DU PREMIER ACTE.	FIN DU PREMIER ACTE.
LIOTE DLCOLVE Le Iheatre repreſente un Rivage de la Mer.	LIOTE DLCOLVE Le Ihéâtre représente un Rivage de la Mer.
SCENE PREMIERE.	SCÈNE PREMIÈRE.
DORIS, CIDIPPE.	DORIS, CIDIPPE.
CIDIPPE.	CIDIPE.
Ous ſuivez un penchant trop flateur & trop doux, Je doute que Pelée ait de l’amour pour vous.	Ous suivez un penchant trop flatteur et trop doux, Je doute que Pelée ait de l'amour pour vous.
Son feu, s’il vous aimoit, craindroit moins de paroiſtré, Ses ſoins ſeroient plus empreſſez, Il vous tient des diſcours douteux, embaraſſez, L’Amour par ſes regards ne ſe fait point connoiſtre, On l’aperçoit bien mieux Dans voſtre bouche, & dans vos yeux.	Son feu, s'il vous aimait, craindrait moins de paroistré, Ses soins seraient plus empressez, Il vous tient des discours douteux, embarrassez, L'Amour par ses regards ne se fait point connaître, On l'aperçoit bien mieux Dans votre bouche, et dans vos yeux.
DORIS.	DORIS.
Non, j’aime trop pour m’y pouvoir méprendre.	Non, j'aime trop pour m'y pouvoir méprendre.
Des ſoins toûjours craintifs, un timide embaras, Sont les effets de l’Amour le plus tendre, C’eſt en ſoupirant tout bas Qu’il ſe fait le mieux entendre.	Des soins toujours craintifs, un timide embarras, Sont les effets de l'Amour le plus tendre, C'est en soupirant tout bas Qu'il se fait le mieux entendre.
CIDIPPE.	CIDIPE.
On croit facilement qu’on inſpire les feux Que l’on reſſent ſoy-meſme, On ſe flate ſi-toſt qu’on aime, Et tout paroiſt amour à des yeux amoureux.	On croit facilement qu'on inspire les feux Que l'on ressent soi-même, On se flatte sitôt qu'on aime, Et tout paraît amour à des yeux amoureux.
RIS.	RIS.
Pelée aime en ſecret, tout marque ſa tendreſſe, A quel objet ſes vœux pourroient-ils eſtre offerts?	Pelée aime en secret, tout marque sa tendresse, À quel objet ses vœux pourraient-ils être offerts?
Il voit ſouvent Thetis, mais le ſoin qui le preſſe Eſt de ſervir le Dieu des Mers, Il n'eſt pas ſon Rival auprés d’une Déeſſe.	Il voit souvent Thétis, mais le soin qui le presse Est de servir le Dieu des Mers, Il n'est pas son Rival auprès d'une Déesse.
Tout ſemble déclarer Que c’eſt moy qu’il adore;	Tout semble déclarer Que c'est moi qu'il adore;
Mais j’en croy mieux encore Mon cœur qui m’en oſe aßûrer.	Mais j'en crois mieux encore Mon cœur qui m'en ose assûrer.
IDIPPE.	JDIPE.
Ne ſeray-je point trop ſincere, Si je vous aoerii D’un ſecret qui doit vous déplaire?	Ne serai-je point trop sincère, Si je vous aoeri D'un secret qui doit vous déplaire?
J'ay veu dans un lieu ſolitaire Pelée entretenir Thetis, Le hazard ſeul n’euſt pû les y conduire, Sans entendre leurs voix, je ſceus aſſez m’inſtruire De leurs mutuelles amours, Par leurs regards j’entendis leurs diſcours.	J'ai vu dans un lieu solitaire Pelée entretenir Thétis, Le hasard seul n'eût pu les y conduire, Sans entendre leurs voix, je sues assez m'instruire De leurs mutuelles amours, Par leurs regards j'entendis leurs discours.
DORIS.	DORIS.
Il aimeroit Thetis?	Il aimerait Thétis?
Ciel!	Ciel!
cét affreux ſupplice Seroit-il reſervé pour ma ſecrette ardeur?	cet affreux supplice Serait-il réservé pour ma secrète ardeur?
Mais je la voy, pour lire dans ſon cœur Je veux employer l’artifice.	Mais je la vois, pour lire dans son cœur Je veux employer l'artifice.
SCENE SECONDE.	SCÈNE SECONDE.
MIIEPIO, DORIS, CIDIPPE.	MIIEPIO, DORIS, CIDIPE.
L IS.	 LS.
Eeſſe, veneZ-vous ſur ce bord écarté Reſver aux Conqueſtes brillantes Que fait voſtre beauté?	Éesse, venez-vous sur ce bord écarté Rêver aux Conquêtes brillantes Que fait votre beauté?
HETIS.	HÉTIS.
Ce qui peut les rendre charmantes N'est que la ſeule vanité.	Ce qui peut les rendre charmantes N'est que la seule vanité.
Les Dieux ont peu d’amour, on ne doit point attendre Que leur cœur tout entier s’en laiſſe poſſeder, Ces Amans ſont aiſez à prendre, Et difficiles à garder.	Les Dieux ont peu d'amour, on ne doit point attendre Que leur cœur tout entier s'en laisse posséder, Ces Amants sont aisé à prendre, Et difficiles à garder.
I ORIS, & CIDIPPE.	I ORIS, et CIDIPPE.
Un tendre amour doit avoir l’avantage Sur un rang éclatant, Le plus glorieux hommage Eſt celuy d’un cœur conſtant.	Un tendre amour doit avoir l'avantage Sur un rang éclatant, Le plus glorieux hommage Est celui d'un cœur constant.
ORIS.	ORIS.
uelquefois un mortel me jure Qu’il eſt touché du pouvoir de mes yeux, Si j'en eſtois bien ſûre, qua prefereron uuxe Dieux.	Ouelquefois un mortel me jure Qu'il est touché du pouvoir de mes yeux, Si j'en étais bien sure, qua préféreron ouvuxe Dieux.
ETIS.	ETIS.
Et quel eſt cét Amant?	Et quel est cet Amant?
l’ammie bous engage A me laiſſer entrer dans un ſecret ſi doux.	l'ammie bous engage A me laisser entrer dans un secret si doux.
R S.	R S.
mnuu pris ues foins.	menu pris ues foins.
Vous changez de viſage?	Vous changez de visage?
Pourquoy vous troublez-vous?	Pourquoi vous troublez-vous?
TIS, J’ignorois qu’il fuſt dans vos chaiſnes, Avec bien du miſtere il a conduit ſes feux.	TIS, J'ignorais qu'il fût dans vos chaînes, Avec bien du mystère il a conduit ses feux.
S.	S.
L'Amour diſcret cache ſes peines, Et l’objet meſme de ſes vœux.	L'Amour discret cache ses peines, Et l'objet même de ses vœux.
Mais je voy Mercure deſcendre, Je croy que ſans témoins vous le voulez entendre.	Mais je vois Mercure descendre, Je crois que sans témoins vous le voulez entendre.
SCENE TROISIE’ME.	SCÈNE -TROISIE'ME.
THETIS, MERCURE.	THÉTIS, MERCURE.
MERCURE.	MERCURE.
Upiter attiré par vos divins appas Va paroiſtre icy bas.	OUiter attiré par vos divins appas Va paraître ici bas.
Quand Neptune vous rend les armes, Ce triomphe pour vous eſt trop peu glorieux;	Quand Neptune vous rend les armes, Ce triomphe pour vous est trop peu glorieux;
L’Amour devoit à tant de charmes La conqueſte d’un Dieu Maiſtre des autres Dieux.	L'Amour devait à tant de charmes La conquête d'un Dieu Maître des autres Dieux.
THETIS.	THÉTIS.
D'iſçay que fupiter tient tout ſous ſon Empire, Que les Dieux reverent ſes loix, Mercure, on n’a rien à me dire Sur le reſpect que je luy dois.	D'isçai que fupiter tient tout sous son Empire, Que les Dieux révèrent ses lois, Mercure, on n'a rien à me dire Sur le respect que je vou lais.
SCENE QVATRIE'ME.	SCÈNE QUTATRIE'ME.
HETIS.	HÉTIS.
Ristes honneurs, Gloire cruelle, Ah!	Ristes honneurs, Gloire cruelle, Ah!
que vous me génez!	que vous me gênez!
Triſtes honneurs, Gloire cruelle, Pourquoy m’eſtes vous deſtinez?	Tristes honneurs, Gloire cruelle, Pourquoi m'êtes -vous destinez?
Mon amant n’eſt qu’un infidelle!	Mon amant n'est qu'un infidèle!
Dieux!	Dieux!
quel trouble ſaiſit tous mes ſens eſtonnez!	quel trouble saisit tous mes sens étonnés!
Le perfide trahit une flâme ſi belle!	Le perfide trahit une flamme si belle!
Helas!	Hélas!
mes jours infortunez Vont couler dans l’horreur d’une peine éternelle, Triſtes honneurs, Gloire cruelle, Pourquoy m’eſtes vous deſtinez?	mes jours infortunés Vont couler dans l'horreur d'une peine éternelle, Tristes honneurs, Gloire cruelle, Pourquoi m'êtes -vous destinez?
Vous qu’en ces lieux l’Amour appelle, Retournez dans le Ciel que vous abandonnez, Laiſſez-moy m’occuper de ma ueuieur mortelle, At ue trop juſtes pleurs mes yeux ſont condamnez.	Vous qu'en ces lieux l'Amour appelle, Retournez dans le Ciel que vous abandonnez, Laissez-moi m'occuper de ma uieur mortelle, At ue trop justes pleurs mes yeux sont condamnés.
Triſtes honneurs, Gloire cruelle, Pourquoy m'eſtes vous destinez?	Tristes honneurs, Gloire cruelle, Pourquoi m'êtes -vous destinez?
SCENE CINQVIE’ME.	SCÈNE CINQUIE'ME.
THETIS, PELE’E.	THÉTIS, PELÉLÉE.
PELE’E.	PELÉLÉ.
Nfin je vous revoy, quel bonheur pour ma T flame!	Nfin je vous revois, quel bonheur pour ma T flame!
Que ces moments me ſemblent doux!	Que ces moments me semblent doux!
THETIS.	THÉTIS.
Allez chercher Doris, elle a touché vostre ame, e ſçay que vostre cœur ſe partage entre nous.	Allez chercher Doris, elle a touché votre âme, e sais que votre cœur se partage entre nous.
PELE’E.	PELÉLÉ.
O Ciel!	Ô Ciel!
que vous entens-je dire?	que vous entends-je dire?
guoys tors qu'a vostre Hymen vous ſouffrez que f'aſpire.	guoys tors qu'a votre Hymen vous souffrez que s'aspire.
ETIS.	ETIS.
Non, ingrat, non perfide, il n’y faut plus penſer, Mon Hymen t’euſt comblé de gloire, Mlais il le plaiſt à y renoncer Par une trahiſon ſi noire, Non, ingrat, non perfide, il n’y faut plus penſer.	Non, ingrat, non perfide, il n'y faut plus penser, Mon Hymen t'eût comblé de gloire, Mlais il le plaît à y renoncer Par une trahison si noire, Non, ingrat, non perfide, il n'y faut plus penser.
PELE’E.	PELÉLÉ.
Ah!	Ah!
quels noms pleins d’horreur me faites vous entendre?	quels noms pleins d'horreur me faites vous entendre?
Quel traitement, grands Dieux!	Quel traitement, grands Dieux!
& l’amour le plus tendre Peut-il ſe l'eſtre attiré?	et l'amour le plus tendre Peut-il se l'être attiré?
En vain des plus grands Dieux j’avois touché le cœur, Je te ſacrifiois leur majeſté ſupréme, Et j’euſſe encor voulu que Jupiter luy-meſme Euſt eù plus de grandeur.	En vain des plus grands Dieux j'avais touché le cœur, Je te sacrifiais leur majesté suprême, Et j'eusse encor voulu que Jupiter lui-même Eût eu plus de grandeur.
IETIS.	YÉTIS.
Ton crime eſt trop aßûré, Tu ne ſçaurois t’en deffendre.	Ton crime est trop assuré, Tu ne saurais t'en défendre.
Tu me fais cependant la plus cruelle injure.	Tu me fais cependant la plus cruelle injure.
Tu brules pour d’autres appas;	Tu brûles pour d'autres appas;
Quel deſtin eſt le mien?	Quel destin est le mien?
helas!	hélas!
Oge te font uunt urueur irop faele & trop pure De trouver toûjours des ingrats.	Ôge te font unt ouvrueur irop faèle et trop pure De trouver toujours des ingrats.
PELE’E.	PELÉLÉ.
Le croyeZ-vous, belle Deeſſe?	Le croisez-vous, belle Déesse?
Quoy?	Quoi?
vous m’aimeZ, & de voſtre tendreſſe J'ignorerois le prix?	vous m'aimez, et de votre tendresse J'ignorerais le prix?
Quoy?	Quoi?
vous m’aymez, & j’aymerois Doris?	vous m'aimez, et j'aimerais Doris?
Le croyez-vous, belle Deeſſe?	Le croyez-vous, belle Déesse?
Ah!	Ah!
pour vous détromper d’un ſoupçon qui me bleſſe, J'iray, meſme à vos yeux, l’accabler de mépris.	pour vous détromper d'un soupçon qui me blesse, J'irai, même à vos yeux, l'accabler de mépris.
HETIS.	HÉTIS.
Ne croy point m’ébloüir par une fauſſe adreße.	Ne crois point m'éblouir par une fausse adresse.
On voit des Eclairs, & on entend le Tonnerre.	On voit des Éclairs, et on entend le Tonnerre.
Mais je puis me vanger, ces Eſclairs que je voy, Ce Tonnerre qui gronde, M’annoncent le Maiſtre du Monde, Je ſçauray me forcer à recevoir ſa foy, Mon cœur s’eſt engagé ſur l’apparence vaine Des feux que tu feignis pour moy, Et je veux l’en punir en m’impoſant la peine D'en aimer un autre que toy.	Mais je puis me venger, ces Esclairs que je vois, Ce Tonnerre qui gronde, M'annoncent le Maître du Monde, Je saurai me forcer à recevoir sa foi, Mon cœur s'est engagé sur l'apparence vaine Des feux que tu feignis pour moi, Et je veux l'en punir en m'imposant la peine D'en aimer un autre que toi.
PELE’E.	PELÉLÉ.
Et moy, je vais le voir ce Rival redoutable, Pour attirer ſur moy ſa haine impitoyable Mon amour va ſe découvrir;	Et moi, je vais le voir ce Rival redoutable, Pour attirer sur moi sa haine impitoyable Mon amour va se découvrir;
e vous parois coupable, Je ne cherche plus qu’à mourir.	Je vous parais coupable, Je ne cherche plus qu'à mourir.
THEEICU Ah!	THÉEIC H!
que dis-tu?	que dis-tu?
fuy ſa preſence, Quitte des lieux pleins de danger.	fuis sa présence, Quitte des lieux pleins de danger.
PELE’E.	PELÉLÉ.
Si je vous ay pû faire une mortelle offenſe, O ujp uu Tonntire à vons vanger.	Si je vous ai pu faire une mortelle offense, Ô ujp u Tonntire à vons venger.
THETIS.	THÉTIS.
Eloigne-toy, le bruit redouble, fe ne puis plus te voir icy ſans trouble.	Éloigne-toi, le bruit redouble, se ne puis plus te voir ici sans trouble.
PELE’E.	PELÉLÉ.
A me chaſſer vos efforts ſeront vains, Si je ne voy finir voſtre injuſtice extréme.	À me chasser vos efforts seront vains, Si je ne vois finir votre injustice extrême.
Jupiter deſcend du Ciel.	Jupiter descend du Ciel.
3 Va fuy, te montrer que je crains, C’eſt te dire aſſez que je t'ayme.	3 Va fui, te montrer que je crains, C'est te dire assez que je t'aime.
SCENE SIXIE’ME.	SCÈNE SIXIE'ME.
JUPITER, THETIS.	JUPITER, THÉTIS.
PITER.	PITER.
Eeſſe, dans ces lieux mon amour me conduit O Avec tout l’éclat qui me ſuit;	Éesse, dans ces lieux mon amour me conduit Ô Avec tout l'éclat qui me suit;
Pour d’autres beautez moins charmantes J’ay ſouvent emprunté des formes differentes, Arluis te juut eque mes fottts potent puus dignes de vous, Il faut qu’à vos attraits mon hommage réponde, Et c’eſt comme Maiſtre du Monde Que je veux estre à vos genoux.	Pour d'autres beautés moins charmantes J'ai souvent emprunté des formes différentes, Arluis te ju eût meslaits potent puus dignes de vous, Il faut qu'à vos attraits mon hommage réponde, Et c'est comme Maître du Monde Que je veux être à vos genoux.
lnenIies Permettez, que mon cœur prenne peu d’aſſurance Sur des ſoins trop flateurs que je n’attendois pas, Je ſçay quels ſont mes appas, Et quelle eſt voſtre constance.	InénIies Permettez, que mon cœur prenne peu d'assurance Sur des soins trop flatteurs que je n'attendais pas, Je sais quels sont mes appas, Et quelle est votre constance.
PITER.	PITER.
Il eſt vray que juſqu’à ce jour J’ay pris pour cent beautez un inconstant amour, Mais vostre gloire en deviendra plus belle Lors qu’à vos charmes ſeuls mes vœux ſeront offerts, Et vous triompherez, de tant d’objets divers En me rendant fidelle.	Il est vrai que jusqu'à ce jour J'ai pris pour cent beautés un inconstant amour, Mais votre gloire en deviendra plus belle Lors qu'à vos charmes seuls mes vœux seront offerts, Et vous triompherez, de tant d'objets divers En me rendant fidèle.
Rien n’eſt plus doux que d’arreſter Un cœur volage, O quuin unountuge Dont vous devez vous flater.	Rien n'est plus doux que d'arrêter Un cœur volage, Ô quuin unountuge Dont vous devez vous flater.
E T I S Rien n’eſt capable d’arreſter On ceeur toulage, C’eſt un avantage Dont on ne peut ſe flater.	 I S Sien n'est capable d'arrêter On ce toulage, C'est un avantage Dont on ne peut se flatter.
Rien n'eſt ITER & THETI plus doux que L capable d’arreſter Un cœur volage, C’eſt un avantage Dont voüs devez vous Con ne peut ſe S.	Rien n'est ITER et THÉTI plus doux que L capable d'arrêter Un cœur volage, C'est un avantage Dont us devez -vous Con ne peut se S.
flater.	flatter.
R.	R.
Vous refuſez de croire Que mon cœur pour jamais ſoit ſous voſtre pouvoir, Vous ignoreZ encor quelle eſt voſtre victoire, Et bien vous allez le ſçavoir.	Vous refusez de croire Que mon cœur pour jamais soit sous votre pouvoir, Vous ignorez encor quelle est votre victoire, Et bien vous allez le savoir.
Changez-vous, Lieux rustiques, En Jardins magnifiques, Et vous, Peuples divers, Venez, en'un inſtant, & traverſez, les Airs.	Changez-vous, Lieux rustiques, En Jardins magnifiques, Et vous, Peuples divers, Venez, en'un instant, et traversez, les Airs.
Auſſi-toſt le Theatre change, & repreſente des Jardins, & l’on voit paroiſtre quatre Troupes de quatre Peuples les plus differents & les plus éloignez les uns des autres qui fuſſent connus du tenips des Fables.	Aussitôt le Théâtre change, et représente des Jardins, et l'on voit paraître quatre Troupes de quatre Peuples les plus différents et les plus éloignez les uns des autres qui fussent connus du tenips des Fables.
La premiere troupe eſt de Grecs, la ſeconde de Perſes, la troiſiéme d’Ethiopiens, la quatrieme de Scithes.	La première troupe est de Grecs, la seconde de Perses, la troisième d'Éthyopiens, la quatrième de Sithes.
Mercure r’entre.	Mercure rentre.
SCENE SEPTIE'ME.	SCÈNE SEPTIE'ME.
JUPITER, THETIS, MERCURE, Troupes de Grecs, de Perſes, d’Ethiopiens, & de Scithes.	JUPITER, THÉTIS, MERCURE, Troupes de Grecs, de Perses, d'Éthyopiens, et de Sithes.
JUPITER.	JUPITER.
J Ous qui de tous les lieux que le Soleil éclaire V Par mes Ordres puiſſans accourez à la fois, Peuples, qui ſous diverſes loix N’avez rien de commun que l’ardeur de me plaire, Soyez, attentifs à ma voix.	 Jus qui de tous les lieux que le Soleil éclaire V Par mes Ordres puissants accourez à la fois, Peuples, qui sous diverses lois N'avez rien de commun que l'ardeur de me plaire, Soyez, attentifs à ma voix.
Vos vœux ne ſeront point deſormais legitimes, Je ne recevray point d'Encens ny ue victimes, Si le nom de Thetis n’eſt joint àvec le mien, Sans cét aimable nom je n’écoute plus rien.	Vos vœux ne seront point désormais légitimes, Je ne recevrai point d'Encens cy ue victimes, Si le nom de Thétis n'est joint àvec le mien, Sans cet aimable nom je n'écoute plus rien.
Thetis a ſçeu charmer le Maiſtre du Tonnerre, Et le plus grand des Immortels, Il faut que ſur toute la Terre Elle partage ſes Autels.	Thétis a su charmer le Maître du Tonnerre, Et le plus grand des Immortels, Il faut que sur toute la Terre Elle partage ses Autels.
Thetis a ſceu charmer le Maiſtre du Tonnerre, Et le plus grand des Immortels, Il faut que ſur toute la Terre Elle partage ſes Autels.	Thétis a su charmer le Maître du Tonnerre, Et le plus grand des Immortels, Il faut que sur toute la Terre Elle partage ses Autels.
Les Grecs & les Perſes rendent leurs hommages à Thetis par des Danſes.	Les Grecs et les Perses rendent leurs hommages à Thétis par des Danses.
Chœur des Grecs & des Perſes.	Chœur des Grecs et des Perses.
Aimez, Deeſſe, Tout vous en preſſe, Rendez heureux Jupiter amoureux.	Aimez, Deesse, Tout vous en presse, Rendez heureux Jupiter amoureux.
Un Dieu puiſſant reçoit nos vœux ſans ceſſe, Et de ce Dieu vous recevez, les vœux.	Un Dieu puissant reçoit nos vœux sans cesse, Et de ce Dieu vous recevez, les vœux.
Aimez, Deeſſe, Tout vous en preſſe, Rendez heureux Jupiter amoureux.	Aimez, Deesse, Tout vous en presse, Rendez heureux Jupiter amoureux.
De vos deſirs ſi la Gloire eſt maistreſſe, La Gloire meſme approuvera vos feux.	De vos désirs si la Gloire est maîtresse, La Gloire même approuvera vos feux.
Aimez, Deeſſe, Tout vous en preſſe, Rendez heureux Jupiter amoureux.	Aimez, Deesse, Tout vous en presse, Rendez heureux Jupiter amoureux.
Chœur des Peuples.	Chœur des Peuples.
Quel bruit ſoudain nous épouvante?	Quel bruit soudain nous épouvante?
Quelle tempeſte!	Quelle tempête!
quelle horreur!	quelle horreur!
Les Vents ſont déchaineZ, & l’Onde menaçante Répond aux Vents avec fureur.	Les Vents sont déchaineZ, et l'Onde menaçante Répond aux Vents avec fureur.
Neptune paroiſt ſur la Mer.	Neptune paraît sur la Mer.
Chœur des Ethiopiens & des Scithes.	Chœur des Éthiopiens et des Sithes.
Que ne peut point l'Amour par ſes charmans appas?	Que ne peut point l'Amour par ses charmants appas?
Dans nos Deſerts on ne s’en deffend pas, Fiere Beauté, voyez de fiers courages Rendre à l’Amour les plus tendres hommages.	Dans nos Déserts on ne s'en défends pas, Fière Beauté, voyez de fiers courages Rendre à l'Amour les plus tendres hommages.
Que ne peut point l’Amour par ſes charmans appas?	Que ne peut point l'Amour par ses charmants appas?
Dans nos Deſerts on ne s’en deffend pas.	Dans nos Deserts on ne s'en défends pas.
N'esperez point braver une puiſſance A qui nos cœurs n’ont pas fait reſiſtance.	N'espérez point braver une puissance À qui nos cœurs n'ont pas fait résistance.
Que ne peut point l’Amour par ſes charmans appas?	Que ne peut point l'Amour par ses charmants appas?
Dans nos Deſerts on ne s’en deffend pas.	Dans nos Deserts on ne s'en défends pas.
Danſes des Ethiopiens & des Scithes.	Danses des Éthiopiens et des Sithes.
Chœur des quatre Peuples.	Chœur des quatre Peuples.
Que toutes nos voix ſe confondent Pour chanter de Thetis les triomphans appas:	Que toutes nos voix se confondent Pour chanter de Thétis les triomphants appas:
Que tout les celebre icy bas, Que les Cieux meſme nous répondent, Le Souverain des Dieux veut à tout l’Vnivers Vanter la Gloire de ſes fers.	Que tout les célèbre ici bas, Que les Cieux même nous répondent, Le Souverain des Dieux veut à tout les CUnivers Vanter la Gloire de ses fers.
On entend une tempeſte qui s’éleve.	On entend une tempête qui s'élève.
SCENE HVITIE’ME.	SCÈNE HVITIE'ME.
JUPITER, NEPTUNE, MERCURE, PEUPLES.	JUPITER, NEPTUNE, MERCURE, PEUPLES.
Neptune paroiſt ſur la Mer.	Neptune paraît sur la Mer.
NEPTUNE.	NEPTUNE.
E quels chants odieux retentit ce rivage?	E quels chants odieux retentir ce rivage?
DIupiter ſçait-il bien que c’eſt moy qu’il outrage?	DIupiter Sait-il bien que c'est moi qu'il outrage?
A t’il quitté les Cieux pour braver mon couroux, En m’enlevant l’objet de mes vœux les plus doux?	A -t-il quitté les Cieux pour braver mon courroux, En m'enlevant l'objet de mes vœux les plus doux?
YITER.	YITER.
Quy, jauort dneris, Qumen ſaus paut myſtere, Vous, ſi vous m’en croyez, Neptune, épargnez-vous Les impuiſſants tranſports d’une vaine colere.	Qui, jauort dîneris, Quel saus paut mystère, Vous, si vous m'en croyez, Neptune, épargnez-vous Les impuissants transports d'une vaine colère.
Jupiter ſort ſuivy des Peuples.	Jupiter sort suivi des Peuples.
SCENE NEVFIE’ME.	SCÈNE NEUFIE'ME.
NEPTUNE, MERCURE.	NEPTUNE, MERCURE.
Neptune ſort de la Mer, & la tempeſte continuë.	Neptune sort de la Mer, et la tempête continue.
NEPTUNE.	NEPTUNE.
E croit-il donc ſoumis à ſes commandemens?	E croit-il donc soumis à ses commandements?
NTQuoy?	NTQuoi?
me croit-il ſous ſon obeïßance?	me croit-il sous son obéissance?
Ah!	Ah!
dans le juſte éclat de mes reſſentimens Mon bras ſe ſervira de toute ſa puiſſance, Ie confondray les Elemens, I'exciteray mes flots & par leur violence Ie cauſeray par tout d’affreux débordemens, Et ſur la Terre entière exerçant ma vangeance I'ébranleray ſes fondemens.	dans le juste éclat de mes ressentiments Mon bras se servira de toute sa puissance, Je confondrai les Éléments, J'exciterai mes flots et par leur violence Je causerai par tout d'affreux débordements, Et sur la Terre entière exerçant ma vengeance J'ébranlerai ses fondements.
MERCURE.	MERCURE.
S’il faut que Iupiter s’obſtine Dans l’amour dont il eſt bleßé, Ie voy d’une affreuſe ruine L’Univers menacé.	S'il faut que Iupiter s'obstine Dans l'amour dont il est blevé, Je vois d'une affreuse ruine L'Univers menacé.
Songez à prevenir les maux que j’apprehende, L’intereſt commun le demande.	Songez à prévenir les maux que j'appréhende, L'intérêt commun le demande.
PTONE.	PTONE.
Ne croyez point m’intimider, Non, non, que Iupiter ſe rende, I’ay prévenu ſes feux, c’eſt à luy de céder.	Ne croyez point m'intimider, Non, non, que Jupiter se rende, J'ai prévenu ses feux, c'est à La de céder.
MERCURE.	MERCURE.
Une puiſſance plus grande Entre vous peut décider, ConſulteZ le Deſtin, le Deſtin vous commande, Son Arreſt doit vous accorder.	Une puissance plus grande Entre vous peut décider, Consultez le Destin, le Destin vous commande, Son Arrêt doit vous accorder.
La fin de vos débats ne peut eſtre plus prompte, Vous ſçaurez qui des deux doit obtenir Thetis.	La fin de vos débats ne peut être plus prompte, Vous saurez qui des deux doit obtenir Thétis.
EPTUNE.	EPTUNE.
I'y conſens, au Deſtin nous nous rendons ſans honte, Il nous tient tous aſſujettis.	J'y consens, au Destin nous nous rendons sans honte, Il nous tient tous assujettis.
LICTI ELE Le Theatre repreſente le Temple du Deſtin.	LICTI ÉLE Le Théâtre représente le Temple du Destin.
SCENE PREMIERE.	SCÈNE PREMIÈRE.
LES MINISTRES DU DESTIN.	LES MINISTRES DU DESTIN.
UN DES MINISTRES.	UN DES MINISTRES.
Deſtin, quelle puiſſance Ne ſe ſoumet pas à toy?	Destin, quelle puissance Ne se soumet pas à toi?
LS Tout fléchit ſous ta loy, Tes Ordres n’ont jamais trouvé de reſiſtance.	LS Tout fléchit sous ta loi, Tes Ordres n'ont jamais trouvé de résistance.
O Deſtin, quelle puiſſance Ne ſe ſoumet pas à toy?	Ô Destin, quelle puissance Ne se soumet pas à toi?
UN DES MINISTRES.	UN DES MINISTRES.
Malgré nous tu nous entraines Où tu veux,	Malgré nous tu nous entaines Où tu veux,
D i.	D y.
C’eſt toy qui nous amenes Tous les évenemens heureux ou malheureux, Tu les as lieZ entre eux Avec d’inviſibles chaînes;	C'est toi qui nous amène Tous les événements heureux ou malheureux, Tu les as lieZ entre eux Avec d'invisibles chaînes;
Par des moyens ſecrets Ton pouvoir les prépare, Et chaque inſtant déclare Quelqu’un de tes Arreſts.	Par des moyens secrets Ton pouvoir les prépare, Et chaque instant déclare Quelqu'un de tes Arrêts.
CHOEUR.	CHOEUR.
O Deſtin, quelle puiſſance Ne ſe ſoumet pas à toy?	Ô Destin, quelle puissance Ne se soumet pas à toi?
Tout fléchit ſous ta loy, Tes ordres n’ont jamais trouvé de reſiſtance.	Tout fléchit sous ta loi, Tes ordres n'ont jamais trouvé de résistance.
O Destin, quelle puiſſance Ne ſe ſoumet pas à toy?	Ô Destin, quelle puissance Ne se soumet pas à toi?
UN DES MINISTRES.	UN DES MINISTRES.
C’eſt envain qu’un Mortel pleure, gemit, ſoûpire, Un Dieu voudroit envain t’oppoſer ſa fierté, Rien ne change les Loix qu’il te plaist de preſcrire, Ton inflexible dureté Fait la grandeur de ton Empire, Ton inflexible dureté En fait la Majeſté.	C'est envain qu'un Mortel eure, gémit, soupire, Un Dieu voudrait envain t'opposer sa fierté, Rien ne change les Lois qu'il te plaît de prescrire, Ton inflexible dureté Fait la grandeur de ton Empire, Ton inflexible dureté En fait la Majesté.
SCENE SECONDE.	SCÈNE SECONDE.
LES MINISTRES DU DESTIN, PELE’E.	LES MINISTRES DU DESTIN, PELÉLÉ.
PELE’E.	PELÉLÉ.
Iniſtres du Destin, je viens pour vous ap* prendre Que dans ces lieux Neptune va ſe rendre, Neptune vient vous conſulter, Quel spectacle plus doux peut jamais vous flater?	Inistres du Destin, je viens pour vous ap* prendre Que dans ces lieux Neptune va se rendre, Neptune vient vous consulter, Quel spectacle plus doux peut jamais vous flatter?
CHOEUR.	CHOEUR.
O Destin, quelle puiſſance Ne ſe ſoumei pas à ioys Tout fléchit ſous ta loy, Tes ordres n’ont jamais trouvé de reſiſtance.	Ô Destin, quelle puissance Ne se soume pas à jois Tout fléchit sous ta loi, Tes ordres n'ont jamais trouvé de résistance.
O Deſtin, quelle puiſſance Ne ſe ſoumet pas à toy?	Ô Destin, quelle puissance Ne se soumet pas à toi?
UN DES MINISTRES.	UN DES MINISTRES.
Les Dieux ont partagé le Monde, Et leur pouvoir eſt different;	Les Dieux ont partagé le Monde, Et leur pouvoir est différent;
Mais ton vaſte Empire comprend Les Cieux, l’Enfer, la Terre & l’Onde.	Mais ton vaste Empire comprend Les Cieux, l'Enfer, la Terre et l'Onde.
Les Dieux ont partagé le Monde, Mais tu reünis tout ſous un pouvoir plus grand.	Les Dieux ont partagé le Monde, Mais tu réunis tout sous un pouvoir plus grand.
PELE’E.	PELÉLÉ.
DaigneZ auſſi ſur mes peines ſecrettes Des Arrests du Destin estre les interpretes.	Daignez aussi sur mes peines secrètes Des Arrêts du Destin être les interprètes.
CHOEUR.	CHOEUR.
Nous ne répondons point uun Mrortels curieux, L’Oracle du Destin n’est que pour les grands Dieux.	Nous ne répondons point uun Mrortels curieux, L'Oracle du Destin n'est que pour les grands Dieux.
Les Miniſtres ſortent.	Les Ministres sortent.
SCENE TROISIESME.	SCÈNE -TROISIÈME.
PELE’E.	PELÉLÉ.
Iel!	Jel!
en voyant ce Temple redoutable De quel fremiſſement je me ſens agité!	en voyant ce Temple redoutable De quel frémissement je me sens agité!
C’eſt icy qu’il eſt arreſté Si je dois eſtre heureux ou miſerable;	C'est ici qu'il est arrêté Si je dois être heureux ou misérable;
Ger Onure, quei qu'u foit, avit eſtre executé, Mais l’avenir impenetrable Le cache encor dans ſon obſcurité;	Ger Onure, quei qu'u soit, avit être exécuté, Mais l'avenir impénétrable Le cache encor dans son obscurité;
Quel doute inſuportable!	Quel doute insuportable!
Qu’un Amant en eſt tourmenté!	Qu'un Amant en est tourmenté!
Inflexible Destin, dans tes Loix éternelles N’as-tu ſuivy qu’un aveugle haſard?	Inflexible Destin, dans tes Lois éternelles N'as-tu suivi qu'un aveugle hasard?
Helas!	Hélas!
n'as-tu point eù d’égard Pour ues Amums ſatntss Non, non, je tâche envain à flater mes ennuis, Par l’état où tu me reduis Je reconnois déja l’effet de tes caprices, Et n’exerces-tu pas toûjours Tes plus cruelles injustices Sur les plus fidelles amours?	n'as-tu point éù d'égard Pour ues Amums satnts Non, non, je tâche enviées à flatter mes ennuis, Par l'état où tu me réduis Je reconnais déjà l'effet de tes caprices, Et n'exerces-tu pas toujours Tes plus cruelles injustices Sur les plus fidèles amours?
SCENE UATRIESME.	SCÈNE UATRIESME.
PELE’E, DORIS.	PELÉLÉ, DORIS.
DORIS.	DORIS.
U je me trompe, ou c’est voſtre tendreſſe OQui dans ces lieux vous améne avec nous, A l’Arrest du Deſtin voſtre cœur s’intereſſe, Mais je crains qu’il ne donne une aimable Déeſſe A quelque Dieu plustoſt qu’à vous.	V je me trompe, ou c'est votre tendresse OÙ dans ces lieux vous amène avec nous, À l'Arrest du Destin votre cœur s'intéresse, Mais je crains qu'il ne donne une aimable Déesse À quelque Dieu plutôt qu'à vous.
FELEE.	FÊLÉE.
Je ne crains, ny n’eſpere, L’avenir qui m’eſt préparé Sçaura toûjours me plaire, Et le Deſtin peut faire Ses Arreſts a ſon gré.	Je ne crains, ni n'espère, L'avenir qui m'est préparé Saura toujours me plaire, Et le Destin peut faire Ses Arrêts à son gré.
IS.	IS.
Je connnoy vôtre flame, C’eſt envain que vous déguiſeZ	Je connais votre flamme, C'est envain que vous déguisez
PELE’E.	PELÉLÉ.
Plus vous voulez penetrer dans mon ame, Plus vous vous abuſez.	Plus vous voulez pénétrer dans mon âme, Plus vous vous abusez.
Eltippe clem je vons mijse nete tue.	Eltippe clem je vons mijeuse nette tue.
SCENE CINQVIESME.	SCÈNE CINQUIÈME.
DORIS, CIDIPPE.	DORIS, CIDIPPE.
ORIS.	ORIS.
JOus m’avieZ fait un recit trop fidelle, V Ils s’aiment en ſecret, mes feux ſont mépriſeZ.	JOus m'aviez fait un récit trop fidèle, V Ils s'aiment en secret, mes feux sont méprisés.
J'ay crû que l’on m’aimoit, j’ay pris des esperances Sur de trop foibles apparences;	J'ai cru que l'on m'aimait, j'ai pris des espérances Sur de trop faibles apparences;
Ciel!	Ciel!
quelle honte pour mon cœur D’eſtre tombé dans une erreur ſi vaine!	quelle honte pour mon cœur D'être tombé dans une erreur si vaine!
Et quelle peine De renoncer à cette douce erreur!	Et quelle peine De renoncer à cette douce erreur!
CIDIPPE.	CIDIPE.
C’eſt quelquefois un avantage D’ignorer de l’Amour les biens les plus charmans;	C'est quelquefois un avantage D'ignorer de l'Amour les biens les plus charmants;
Quand il faut que l’on ſe dégage, Heureux qui n’a jamais ſenty que des tourmens!	Quand il faut que l'on se dégage, Heureux qui n'a jamais senti que des tourments!
Vôtre douleur ſeroit bien plus cruelle, Si Pelée eût longetemps ccou joue cone loy, Et qu’il vinſt à manquer de foy.	Votre douleur serait bien plus cruelle, Si Pelée eût longetemps cou joue cône loi, Et qu'il vinst à manquer de foi.
DORIS.	DORIS.
quasa que ne meſt io tieſemeue;	quas que ne mest jo tiesemeue;
Il auroit ſoûpiré pour moy.	Il aurait soupiré pour moi.
CIDIPPE.	CIDIPE.
Vôtre amour malheureux cherche trop à ſe plaindre, Ceſſez d’entretenir d’inutiles douleurs.	Votre amour malheureux cherche trop à se plaindre, Cessez d'entretenir d'inutiles douleurs.
DORTS.	DORTS.
Je ſuivray vos conſeils, ma flame va s’éteindre, Je ne ſongeray plus qu’à vanger mes malheurs.	Je suivrai vos conseils, ma flamme va s'éteindre, Je ne songerai plus qu'à venger mes malheurs.
CIDIPPE.	CIDIPE.
L’Amour que l’on offence Ne devroit recourir Qu'a la paiſible indifference, L’ardeur de la vangence Eſt un nouveau mal a ſouffrir.	L'Amour que l'on offense Ne devrait recourir Qu'a la paisible indifférence, L'ardeur de la venger Est un nouveau mal a souffrir.
ORIS.	ORIS.
Sans ce triſte ſecours je ne me puis guerir.	Sans ce triste secours je ne me puis guérir.
J'abandonnois mon cœur à ſa foibleſſe extrême, Et les yeux d’un Ingrat en étoient les témoins ue ne m’apprenoit-il quel eſt l’objet qu’il aime?	J'abandonnais mon cœur à sa faiblesse extrême, Et les yeux d'un Ingrat en étaient les témoins ue ne m'apprenait-il quel est l'objet qu'il aime?
Pour me deſabuſer il n'en faloit pas moins;	Pour me désabuser il n'en fallait pas moins;
Ah!	Ah!
je le puniray des ſoins Que je prenois à me tromper moy-meſme.	je le punirai des soins Que je prenais à me tromper moi-même.
DIPPE.	DIPPE.
N'écoutez point l’amour jaloux, Il n’inspire jamais de tranſports legitimes, N’écouteZ point l’amour jaloux, Il invente des crimes Pour en charger l’objet de ſon courroux.	N'écoutez point l'amour jaloux, Il n'inspire jamais de transports légitimes, N'écoutez point l'amour jaloux, Il invente des crimes Pour en charger l'objet de son courroux.
DORIS.	DORIS.
Une douleur preſſante A toûjours droit de ſe vanger, La cauſe de nos maux ne peut eſtre innocente, Tous les ſecours que la fureur preſente Sont permis pour ſe ſoulager.	Une douleur pressante A toûjours ait de se venger, La cause de nos maux ne peut être innocente, Tous les secours que la fureur présente Sont permis pour se soulager.
SCENE SIXIE'ME.	SCÈNE SIXIE'ME.
NEPTUNE, DORIS, Suite de Neptune.	NEPTUNE, DORIS, Suite de Neptune.
NEPIONE.	NÉPIONE.
O on ne me furot prus, autZ, que l’on m'attende, Je veux que ſans témoins cét Oracle ſe rende.	Ô on ne me furot prus, autZ, que l'on m'attende, Je veux que sans témoins cet Oracle se rende.
SCENE SEPTIE’ME.	SCÈNE SEPTIE'ME.
NEPTUNE.	NEPTUNE.
VEdeZ pour quelquetemps, importune Grãdeur, Cedez au tendre amour qui regne dans mõ cœur.	VEdez pour quelquetemps, importune Grandeur, Cédez au tendre amour qui règne dans mon cœur.
Moy que les vaſtes Mers reconnoiſſent pour Maiſtre Je viens en tremblant reconnoître Un plus grand pouvoir dans ces lieux, L’Amour qui m’y réduit ſçait abaiſſer les Dieux, Sa force contre nous affecte de paroiſtre.	Moi que les vastes Mers reconnaissent pour Maître Je viens en tremblant reconnaître Un plus grand pouvoir dans ces lieux, L'Amour qui m'y réduit sait abaisser les Dieux, Sa force contre nous affecte de paraître.
Deue Spour quttque temps, imponune Grandeur, Cedez au tendre amour qui regne dans mon cœur.	Deve Spour quartque temps, imponune Grandeur, Cédez au tendre amour qui règne dans mon cœur.
SCENE HVITIE’ME.	SCÈNE HVITIE'ME.
NEPTUNE, MINISTRES DU DESTIN UN DES MINISTRES.	NEPTUNE, MINISTRES DU DESTIN UN DES MINISTRES.
Ieu de la Mer, quel ſujet vous amene?	Jeu de la Mer, quel sujet vous amène?
NEPTUNE.	NEPTUNE.
Mon amour pour Thetis cauſe toute ma peine, Jupiter vient troubler mes feux, Prononcez qui de nous verra remplir ſes vœux.	Mon amour pour Thétis cause toute ma peine, Jupiter vient troubler mes feux, Prononcez qui de nous verra remplir ses vœux.
UN DES MINISTRES.	UN DES MINISTRES.
Deſtin, un grand Dieu te demande Quel ſuccez tu veux qu’il attende, Dans tés Buerero moneronc u pentrer, Daigneras-tu les déclarer?	Destin, un grand Dieu te demande Quel succès tu veux qu'il attende, Dans té Bérero moneronc u pentrer, Daigneras-tu les déclarer?
Le Miniſtre eſt ſaiſi tout à coup d’une eſpece d’entouſiaſme, & il continüe, Qu'un respect plein d’épouvante Faſſe tout trembler, L’Avenir va ſe reveler.	Le Ministre est saisi tout à coup d'une espèce d'entousiasme, et il continue, Qu'un respect plein d'épouvante Fasse tout trembler, L'Avenir va se réveler.
E ij Que tout l’Univers reſſente Om neſpeor puoin u opouvante, Le Deſtin eſt preſt à parler.	 Que si l'Univers ressente Om nespeor puoin ouvante, Le Destin est prêt à parler.
CHOEUR.	CHOEUR.
Qu'un reſpect plein d’épouvante Faſſe tout trembler, L’Avenir va ſe reveler.	Qu'un respect plein d'épouvante Fasse tout trembler, L'Avenir va se réveler.
14 Que tout l’Univers reſſente Un respect plein d’épouvante, Le Deſtin eſt preſt à parler.	14 Que tout l'Univers ressente Un respect in d'épouvante, Le Destin est prêt à parler.
On entend une voix qui ſort du fond du Temple.	On entend une voix qui sort du fond du Temple.
ORACLE.	ORACLE.
Ecoutez, Dieu de l’Onde, Pouret que te Deſtin permet qu’on vous réponde;	Écoutez, Dieu de l'Onde, Pouret que te Destin permet qu'on vous réponde;
L’Epoux de la belle Thetis Doit eſtre un jour moins grand, moins puiſſant que jen lits y Tout le reſte eſt caché dans une nuit profonde.	L'Époux de la belle Thétis Doit être un jour moins grand, moins puissant que jen lits y Tout le reste est caché dans une nuit profonde.
NEPTUNE.	NEPTUNE.
Ah!	Ah!
quel Oracle je reçoy!	quel Oracle je reçois!
Quel Arreſt menaçant!	Quel Arrêt menaçant!
quelle funeſte loy!	quelle funeste loi!
FIN DU TROISIESME ACTE.	FIN DU TROISIÈME ACTE.
NOTE I V Le Plieutre reprerente un lieu deſert au bord de la Mer.	NOTE I V Le Plieutre reprerente un lieu désert au bord de la Mer.
SCENE PREMIERE.	SCÈNE PREMIÈRE.
JUPITER, DORIS.	JUPITER, DORIS.
JUPITER.	JUPITER.
Ans quel étonnement voſtre diſcours me jette?	Ans quel étonnement votre discours me jette?
Thetis pourroit bruſler d’une flame ſecrette!	Thétis pourrait brûler d'une flamme secrète!
Je n’eſtois point aimé, mais je croyois dumoins Que ſa ſeule froideur fit rejetter mes ſoins.	Je n'étais point aimé, mais je croyais dumoins Que sa seule froideur fit rejetter mes soins.
DORIS.	DORIS.
Lors qu’on ne peut toucher les Belles, On en accuſe leur froideur, Mais ce qui fait tant de Cruelles C’eſt bien ſouvent quelque ſecrette ardeur.	Lors qu'on ne peut toucher les Belles, On en accuse leur froideur, Mais ce qui fait tant de Cruelles C'est bien souvent quelque secrète ardeur.
JUPITER.	JUPITER.
Et quel Amant a ſçû luy plaire?	Et quel Amant a su lui plaire?
Il eſt vray qu’avant moy Neptune a ſoûpiré, Eſt-ce luy qu'elle me préfere?	Il est vrai qu'avant moi Neptune a soupiré, Est-ce même qu'elle me préfère?
DORIS.	DORIS.
Non, un fimpie Moriet, Pelee eſt adoré.	Non, un fimpie Moriet, Pèlée est adoré.
Je viens de voir encor ces deux Amans enſemble, 1 1e phuuiy O ſeuou vent toujours.	Je viens de voir encor ces deux Amants ensemble, 1 e phui Ô seuou vent toujours.
JUPITER.	JUPITER.
Quoy?	Quoi?
lorſque ſous mes Loix il n’eſt rien qui ne trẽble, On Rxorbον oforou inu berfenmes Aimours?	lorsque sous mes Lois il n'est rien qui ne trble, On Rxorbον offorou ou berfenmes Aimours?
DORIS.	DORIS.
Thetis vient en ces lieux, & vous pouvez vous méme vous etlaittir dans cel inſtant.	Thétis vient en ces lieux, et vous pouvez vous -même vous etlaitir dans cel instant.
SCENE SECONDE.	SCÈNE SECONDE.
JUPITER, THETIS.	JUPITER, THÉTIS.
PITER.	PITER.
Eeſſe, expliqueZ-vous ſur le ſort qui m’attend Jupiter ne veut point que ſa grandeur ſuprême Luy faſſe auprés de vous un merite éclatant, Il ne veut s’en ſervir qu’à prouver qu’il vous aime En vous la ſoumettant.	Eesse, expliquez-vous sur le sort qui m'attend Jupiter ne veut point que sa grandeur suprême Lui fasse auprès de vous un mérite éclatant, Il ne veut s'en servir qu'à prouver qu'il vous aime En vous la soumettant.
THETIS.	THÉTIS.
Neptune ainſi que vous prétend à ma tendreſſe, Il eſt le Dieu des Mers, j’en ſuis une Déeſſe, Je dois redouter ſon courroux, Il ne m'eſt pas permis de choiſir entre vous.	Neptune ainsi que vous prétend à ma tendresse, Il est le Dieu des Mers, j'en suis une Déesse, Je dois redouter son courroux, Il ne m'est pas permis de choisir entre vous.
ITER.	ITER.
Tant d’égards, tant de prévoyance Sont des effets d’indifference, Ces timides ménagemens Ne jani pus fans pour tes damans.	Tant d'égards, tant de prévoyance Sont des effets d'indifférence, Ces timides ménagements Ne jani us sans pour tes damans.
ETIS.	ETIS.
Vous ſçavez quelle eſt ma fortune, Le Deſtin m’a ſoumiſe au Maiſtre de la Mer.	Vous savez quelle est ma fortune, Le Destin m'a soumise au Maître de la Mer.
JUPITER.	JUPITER.
Vous craindriez moins Neptune Si vous aimiez Jupiter.	Vous craindriez moins Neptune Si vous aimiez Jupiter.
Mais je voy trop que vous feignez de craindre, Vous avez d’autres ſoins que vous n’expliquez, pas.	Mais je vois trop que vous feignez de craindre, Vous avez d'autres soins que vous n'expliquez, pas.
HETIS.	HÉTIS.
Non, c’eſt Neptune ſeul qui fait mon embaras, Rien ne peut m’obliger à feindre.	Non, c'est Neptune seul qui fait mon embarras, Rien ne peut m'obliger à feindre.
Mais que nous veut Protée?	Mais que nous veut Protée?
il le faut écouter.	il le faut écouter.
SCENE TROISIE’ME.	SCÈNE -TROISIE'ME.
JUPITER, THETIS, PROTE’E.	JUPITER, THÉTIS, PROTE.
PROTE’E à Jupiter.	PROTÉ à Jupiter.
Eptunt mu enarge ut oenir vous apprendre N Qu’à l’Hymen de Thetis il ceſſe de prétendre, Qu'il n’a plus le deſſein de vous la diſputer.	Eptunt mu enarge ut oenir vous apprendre N Qu'à l'Hymen de Thétis il cesse de prétendre, Qu'il n'a plus le dessein de vous la disputer.
JUPITER.	JUPITER.
Quel bonheur imprévu vient icy me ſurprendre?	Quel bonheur imprévu vient ici me surprendre?
Ah!	Ah!
ma reconnoiſſance aura ſoin d’éclater, Dis-luy qu’il en doit tout attendre.	ma reconnaissance aura soin d'éclater, Dis-lui qu'il en doit tout attendre.
SCENE QVATRIE'ME.	SCÈNE QUTATRIE'ME.
UPITER, THETIS.	OÙPITER, THÉTIS.
UPITER.	OÙPITER.
Ien n'eſt donc plus contraire au ſuccez de mes Rhæux, Vous m’oppoſiez un obſtacle qui ceſſe.	Ien n'est donc plus contraire au succès de mes Rhæux, Vous m'opposiez un obstacle qui cesse.
Mais que vois-je, Thetis?	Mais que vois-je, Thétis?
quelle ſombre triſteſſe Dans le moment que tout céde à mes feux?	quelle sombre tristesse Dans le moment que tout cède à mes feux?
Que m’annoncent, helas!	Que m'annoncent, hélas!
ce trouble, ce ſilence, Eu cel air interdits	ce trouble, ce silence, Eu cel air interdits
Ah!	Ah!
Ah!	Ah!
j’ay de mon malheur l’entiere connoiſſance, Ingrate, vous aimez, on me l’avoit bien dit.	j'ai de mon malheur l'entière connaissance, Ingrate, vous aimez, on me l'avait bien dit.
THETIS.	THÉTIS.
Que vous a-t’on pû dire?	Que vous a-t-on pu dire?
JUPITER.	JUPITER.
Que Pelée en ſecret.	Que Pelée en secret.
THETIS.	THÉTIS.
Non, ne le croyez pas, Je n'aime point Pelée, & ſi ſon cœur ſoupire, C’eſt pour d’autres appas, Non, ne le croyez, pas.	Non, ne le croyez pas, Je n'aime point Pelée, et si son cœur soupire, C'est pour d'autres appas, Non, ne le croyez, pas.
TER.	TER.
Je voy que vous eſtes coupable, Vous vous juſtifiez d’un air trop empreſſé.	Je vois que vous êtes coupable, Vous vous justifiez d'un air trop empressé.
Voſtre cœur s’eſt donc abaiſſé Aux vœux d’un Mortel mépriſable?	Votre cœur s'est donc abaissé Aux vœux d'un Mortel méprisable?
Lorſque je ſoupirois pour vous Je rendois ſeulement ſon triomphe plus doux?	Lorsque je soupirais pour vous Je rendais seulement son triomphe plus doux?
Sous une trompeuſe apparence Vous impoſieZ à cét amour fatal Qui tenoit Jupiter ſous voſtre obeïſſance?	Sous une trompeuse apparence Vous imposiez à cet amour fatal Qui tenait Jupiter sous votre obéissance?
Non, je n’auray pas trop de toute ma puiſſance, Pour punir à mon gré mon odieux Rival.	Non, je n'aurai pas trop de toute ma puissance, Pour punir à mon gré mon odieux Rival.
THETIS.	THÉTIS.
Ciel!	Ciel!
que viens-je d’entendre?	que viens-je d'entendre?
Eſt-ce là cét Amour ſi ſoumis & ſi tendre?	Est-ce là cet Amour si soumis et si tendre?
IPITER.	IPITER.
Par de cruels mépris vous oſez m’irriter, Et vous avez recours à mon amour extréme Quanu ma jureur eſe prefet ueclater?	Par de cruels mépris vous osez m'irriter, Et vous avez recours à mon amour extrême Quanu ma jureur eze préfet ueclater?
TrembleZ, c’est cét Amour luy meſme Que vous aveZ à redouter.	Tremblez, c'est cet Amour lui -même Que vous avez à redouter.
SCENE CINQVIE’ME.	SCÈNE CINQUIE'ME.
THETIS.	THÉTIS.
Uelle horreur m’environne, & quel effroy me glace!	Uelle horreur m'environne, et quel effroi me glace!
Quels abiſmes de maux s’ouvrent devant mes yeux!	Quels abîmes de maux s'ouvrent devant mes yeux!
Helas!	Hélas!
c’eſt mon Amant que Jupiter menace, Quels traits peut nous lancer le ſouverain des Dieux?	c'est mon Amant que Jupiter menace, Quels traits peut nous lancer le souverain des Dieux?
Ah!	Ah!
je le voy déja, je le voy qui prépare Ses plus terribles coups.	je le vois déjà, je le vois qui prépare Ses plus terribles coups.
Trop funeſtes appas, pourquoy m’attirez-vous, Sous le doux nom d’amour, cette haine barbare, Et cet implacable courroux?	Trop funestes appas, pourquoi m'attirez-vous, Sous le doux nom d'amour, cette haine barbare, Et cet implacable courroux?
SCENE SIXIE'ME.	SCÈNE SIXIE'ME.
THETIS, PELE’E.	THÉTIS, PELÉLÉE.
HETIS.	HÉTIS.
H!	H!
Pelée, appreneZ tous les malheurs enſemble, IAJupiter ſçait enfin nos ſecrettes amours.	Pelée, appreneZ tous les malheurs ensemble, IAupiter Sait enfin nos secrètes amours.
Vous diray-je encor plus?	Vous dirai-je encor plus?
Ciel!	Ciel!
je fremis, je tremble, Jupiter menace vos jours.	Je frémis, je tremble, Jupiter menace vos jours.
Quoy?	Quoi?
de voſtre peril la funeſte nouvelle Ne vous inſpire pas d’effroy?	de votre péril la funeste nouvelle Ne vous inspire pas d'effroi?
PELE’E.	PELÉLÉ.
Jupiter en fureur ne peut rien contre moy, Vous eſtes immortelle.	Jupiter en fureur ne peut rien contre moi, Vous êtes immortelle.
THETIS.	THÉTIS.
Si vous ne craignez pas pour vous, Craignez du moins pour une Amante;	Si vous ne craignez pas pour vous, Craignez du moins pour une Amante;
Peut-on vous porter des coups Que mon ame ne reſſente?	Peut-on vous porter des coups Que mon âme ne ressente?
PELE’E.	PELÉLÉ.
Que vôtre tendreſſe eſt charmante, Et que mon trépas ſera doux!	Que votre tendresse est charmante, Et que mon trépas sera doux!
L’ennemy qui nous tourmente Luy meſme en ſera jaloux.	L'ennemi qui nous tourmente Lui même en sera jaloux.
THETIS.	THÉTIS.
Craignez, du moins pour une Amante Si vous ne craignez pas pour vous.	Craignez, du moins pour une Amante Si vous ne craignez pas pour vous.
Quel ſeroit mon deſtin?	Quel serait mon destin?
vous ceſſeriez de vivre, Et moy, je ne pourrois recourir au trépas;	vous cesseriez de vivre, Et moi, je ne pourrais recourir au trépas;
Si je pouvois vous ſuivre, Je ne me plaindrois pas.	Si je pouvais vous suivre, Je ne me plaindrais pas.
THETIS & PELE’E, Helas!	THÉTIS et PELÉE, Hélas!
de quelles flames Nous perdons les douceurs!	de quelles flammes Nous perdons les douceurs!
Quet amour entnamoi nos ames!	Quet amour entnamoi nos âmes!
Quel amour uniſſoit nos cœurs!	Quel amour unissait nos cœurs!
Helas!	Hélas!
de quelles flames Nous perdons les douceurs!	de quelles flammes Nous perdons les douceurs!
THETIS.	THÉTIS.
Mais quels bruits pleins d’horreur troublent mes ſens timides?	Mais quels bruits pleins d'horreur troublent mes sens timides?
Tous les Vens raſſemblez fremiſſent dans les Airs.	Tous les Vents rassemblés frémissent dans les Airs.
PELE’E.	PELÉLÉ.
Je voy ſortir des Enfers Les cruelles Euménides.	Je vois sortir des Enfers Les cruelles Eumenides.
THETIS.	THÉTIS.
Ah!	Ah!
c'en eſt fait je vous pers.	c'en est fait je vous perds.
SCENE SEPTIE'ME.	SCÈNE SEPTIE'ME.
THETIS, PELE’E, LES TROIS EUMENIDES, LES VENTS.	THÉTIS, PELÉLE, LES TROIS EUMENIDES, LES VENTS.
Les Vents arrivent en faiſant des eſpeces de tourbillons autour de Pelée avec des actions menaçantes.	Les Vents arrivent en faisant des espèces de tourbillons autour de Pelée avec des actions menaçantes.
P UNE EUMENIDE.	 UNE EUMENIDE.
Elée, il faut aller ſur ce Rocher funeſte, Où dans un tourment éternel Gemit le fameux Criminel Qui déroba le feu Celeſte.	Elée, il faut aller sur ce Rocher funeste, Où dans un tourment éternel Gémit le fameux Criminel Qui déroba le feu Celeste.
Partez, Vents, & l’emporteZ Dans ces lieux ſi redoutez.	Partez, Vents, et l'emportez Dans ces lieux si redoutez.
Les Vents vont pour enlever Pelée.	Les Vents vont pour enlever Pelée.
THETIS.	THÉTIS.
Accablez-moy pluſtoſt des plus affreuſes peines, Arreſtez, Cruels, arreſtez.	Accablez-moi plutôt des plus affreuses peines, Arrêtez, Cruels, arrêtés.
LES EUMENIDES.	LES EUMENIDES.
Déeſſe, vos larmes ſont vaines, Vos cris ne ſont point écoutez, Les Loix de Jupiter ſont des Loix ſouveraines, Il faut ſuivre ſes volontez.	Déesse, vos larmes sont vaines, Vos cris ne sont point écoutez, Les Lois de Jupiter sont des Lois souveraines, Il faut suivre ses volontés.
Les Vents vont encore pour enlever Pelée.	Les Vents vont encore pour enlever Pelée.
THETIS.	THÉTIS.
Arreſtez, cruels, arreſtez.	Arrêtez, cruels, arrêtez.
PELE’E à Thetis.	PELÉL'E à Thétis.
Laiſſez-moy d’un Rival devenir la victime, Puiſqu’un tendre amour eſt un crime, Quels rigoureux tourmens n’ay-je pas meritez?	Laissez-moi d'un Rival devenir la victime, Puisqu'un tendre amour est un crime, Quels rigoureux tourments n'ai-je pas mérités?
UNE EUMENIDE.	UNE EMENIDE.
Vents, ne differez plus, ovvipeie y'plirtez.	Vents, ne différez plus, ouipeie y aplirtez.
Les Vents enlevent Pelée.	Les Vents enlèvent Pelée.
SCENE HVITIESME.	SCÈNE HVITIESME.
THETIS, LES EUMENIDES.	THÉTIS, LES EUMENIDES.
THETIS.	THÉTIS.
QUoy?	QUoi?
toute la Nature A ce ſpectacle affreux ne fremit-elle pas?	toute la Nature À ce spectacle affreux ne frémit-elle pas?
Soleil, retourne ſur tes pas, Plonge nous pour jamais dans une nuit obſcure;	Soleil, retourne sur tes pas, Plonge nous pour jamais dans une nuit obscure;
Dieux Immortels, uniſſeZ-vous Contre un Tiran qui nous opprime tous.	Dieux Immortels, unissez-vous Contre un Tyran qui nous opprime tous.
LES EUMENIDES.	LES EUMENIDES.
Allons, marchons ſur les pas du Coupable, Irritons nos Serpens, allumons nos Flambeaux, Qu'une vengeance impitoyable Invente des tourmens nouveaux.	Allons, marchons sur les pas du Coupable, Irritons nos Serpents, allumons nos Flambeaux, Qu'une vengeance impitoyable Invente des tourments nouveaux.
THETIS.	THÉTIS.
Tournez contre moy ſeule une implacable rage, Si je ne puis mourir, Au moins je puis ſouffrir.	Tournez contre moi seule une implacable rage, Si je ne puis mourir, Au moins je puis souffrir.
Tournez contre moy ſeule une implacable rage, Il en ſouffrira davantage.	Tournez contre moi seule une implacable rage, Il en souffrira davantage.
LES EUMENIDES.	LES EUMENIDES.
Non, n’eſpereZ point tromper La fureur qui nous anime, Noſtre victime Ne peut nous écbaper.	Non, n'espérez point tromper La fureur qui nous anime, Notre victime Ne peut nous écbaper.
Les Eumenides ſortent.	Les Eumenides sortent.
VT X La Decoration eſt la meime que dans l’Acte precedent.	VT X La Décoration est la meime que dans l'Acte dent.
SCENE PREMIERE.	SCÈNE PREMIÈRE.
JUPITER, MERCURE.	JUPITER, MERCURE.
MERCURE.	MERCURE.
En douteZ point, Neptune à ſa flame renonce Sur l’Oracle qu’icy je vous ay rapporté, J'ay voulu du Deſtin apprendre la réponſe, Par mes avis il l’avoit conſulté.	En doutez point, Neptune à sa flamme renonce Sur l'Oracle qu'ici je vous ai rapporté, J'ai voulu du Destin apprendre la réponse, Par mes avis il l'avait consulté.
PITER.	PITER.
Quel Oracle cruel!	Quel Oracle cruel!
que je ſuis agité!	que je suis agité!
J’ay puny mon Rival, Thetis ambitieuſe Auroit pû l’oublier aprés quelques ſoupirs;	J'ai puni mon Rival, Thétis ambitieuse Aurait pu l'oublier après quelques soupirs;
Mais d’un Fils trop puïſſant la naiſſance odieuſe Seroit l’effet de mes deſirs.	Mais d'un Fils trop puissant la naissance odieuse Serait l'effet de mes désirs.
Mon trouble eſt extrême, Vous m’entraînez tour à tour, Trop charmant Amour, Doux attraits du Rang ſuprême.	Mon trouble est extrême, Vous m'entraînez tour à tour, Trop charmant Amour, Doux attraits du Rang suprême.
Helas!	Hélas!
faut-il que dans mon cœur, Dans le cœur de Jupiter même, L'Amour balance la Grandeur?	faut-il que dans mon cœur, Dans le cœur de Jupiter même, L'Amour balance la Grandeur?
MIERCONL.	MIERCONL.
Le cœur de Jupiter n’eſt fait que pour la Gloire, L’Amour n’y peut long-temps diſputer la victoire.	Le cœur de Jupiter n'est fait que pour la Gloire, L'Amour n'y peut longtemps disputer la victoire.
PITER.	PITER.
Non, il ne la diſpute plus, C’en eſt fait, ſes nœuds ſont rompus.	Non, il ne la dispute plus, C'en est fait, ses nœuds sont rompus.
Pour monter ſur ce Trône où le Ciel me revere, J'en fis tomber mon Pere, Un Fils ambitieux le vangeroit ſur moy, Je connois les deſirs qu’un ſi beau Rang inſpire, Mon propre exemple doit ſuffire Pour me remplir d’effroy.	Pour monter sur ce Trône où le Ciel me révère, J'en fis tomber mon Père, Un Fils ambitieux le vengerait sur moi, Je connais les désirs qu'un si beau Rang inspire, Mon propre exemple doit suffire Pour me remplir d'effroi.
Mais quel ſouvenir me retrace Des charmes trop doux & trop chers?	Mais quel souvenir me retrace Des charmes trop doux et trop chers?
Ma Grandeur diſparoiſt, tout ſon éclat s’efface;	Ma Grandeur disparaît, tout son éclat s'efface;
Faudra-t’il ſuccomber & rentrer dans mes fers?	Faudra-t-il succomber et rentrer dans mes fers?
JUPITER, MERCURE, THETIS,	JUPITER, MERCURE, THÉTIS,
HETIS.	HÉTIS.
JOyez de mes douleurs toute la violence, V VoyeZ, Maiſtre des Dieux, quelle est voſtre vengeance.	JOyez de mes douleurs toute la violence, V VoyeZ, Maître des Dieux, quelle est votre vengeance.
Si mes tourments eſtoient moins rigoureux, J’aurois moins d’eſperance De toucher un cœur genereux.	Si mes tourments étaient moins rigoureux, J'aurais moins d'espérance De toucher un cœur généreux.
Vous meſme vous deveZ approuver ma conſtance, N’auriez-vous de l’amour éprouvé la puiſſance, Que pour rendre à jamais deux amants malheureux?	Vous rendre vous devez approuver ma constance, N'auriez-vous de l'amour éprouvé la puissance, Que pour rendre à jamais deux amants malheureux?
SCENE TROISIE’ME.	SCÈNE -TROISIE'ME.
UPITER, MERCURE, THETIS, ORIS.	OUPITER, MERCURE, THÉTIS, ORIS.
DORIS à Jupiter.	DORIS à Jupiter.
N juſte repentir m’agite & me tourmente, O J'ay troublé deux Amans dans leur flame innocente, J’ay pouſſe voſtre bras, & j’ay conduit vos traits;	 Notre repentir m'agite et me tourmente, Ô J'ai troublé deux Amants dans leur flamme innocente, J'ai pousse votre bras, et j'ai conduit vos traits;
Que ne puis-je du moins par ma douleur preſſante Reparer les maux que j’ay faits?	Que ne puis-je du moins par ma douleur pressante Réparer les maux que j'ai faits?
THETIS à Jupiter.	THÉTIS à Jupiter.
En vain voſtre rigueur accable L'Amant dont je receus la foy, v ous me te renuez plus aimable Par tout ce qu’il ſouffre pour moy.	En vain votre rigueur accable L'Amant dont je reçus la foi, ous me te renvez plus aimable Par tout ce qu'il souffre pour moi.
THETIS & DORIS.	THÉTIS et DORIS.
Que voſtre haine ceſſe, Duriſſe & oolix emowooirs	Que votre haine cesse, Durisse et oolix emovoirs
MERCURE.	MERCURE.
La Gloire vous en preſſe.	La Gloire vous en presse.
E *18.	E *18.
L’Amour même, l’Amour vous en fait un devoir.	L'Amour même, l'Amour vous en fait un devoir.
Que voſtre haine ceſſe, Laiſſez-vous émouvoir.	Que votre haine cesse, Laissez-vous émouvoir.
La Gloire vous en preſſe, L’Amour même, l’Amour vous en fait un devoir.	La Gloire vous en presse, L'Amour même, l'Amour vous en fait un devoir.
TER.	TER.
Vents, partez, & que la Déeſſe Revoye en ce moment l’objet de ſa tendreſſe.	Vents, partez, et que la Déesse Revoie en ce moment l'objet de sa tendresse.
Doris ſort.	Doris sort.
THETIS.	THÉTIS.
Ah!	Ah!
quel genereux retour!	quel généreux retour!
Quel bon-heur pour mon amour:	Quel bonheur pour mon amour:
MERCURE & THETIS.	MERCURE et THÉTIS.
Les grands Dieux quelquefois écoutent leur colere, Mais la bonté peut encor plus ſur eux, Il n'ont rien dans leur ſort qui doive plus leur plaire, Que le pouvoir de contenter nos vœux.	Les grands Dieux quelquefois écoutent leur colère, Mais la bonté peut encor plus sur eux, Il n'ont rien dans leur sort qui doive plus leur plaire, Que le pouvoir de contenter nos vœux.
SCENE QVATRIESME.	SCÈNE QUATRIÈME.
JUPITER, MERCURE, THETIS, PELE’E ramené par les Vents.	JUPITER, MERCURE, THÉTIS, PELÉLÉ ramené par les Vents.
PELE’E à Thetis.	PELÉL'E à Thétis.
Ois-je en croire mes yeux?	Ois-je en croire mes yeux?
ô Ciel!	ô Ciel!
eſt-il poſſible?	est-il possible?
P Belle Thetis, je vous revoy!	 Pelle Thétis, je vous revois!
THETIS.	THÉTIS.
Le Souverain des Dieux daigne vous rendre à moy, Mes larmes l’ont trouvé ſenſible.	Le Souverain des Dieux daigne vous rendre à moi, Mes larmes l'ont trouvé sensible.
THETIS & PELE’E.	THÉTIS et PELÉÉLE.
Que nos cœurs unis à jamais Sentent par leur bon-heur le prix de ſes bienfaits.	Que nos cœurs unis à jamais Sent par leur bonheur le prix de ses bienfaits.
PITER.	PITER.
Voſtre amour eſt content, un doux ſuccés le flate, Mais il faut que ma gloire en ce beau jour éclate, je veux que votre Hymen ſe celebre à mes yeux, Je veux que ce lieu s’embelliſſe, Et qu’une feste y réuniſſe Les Dieux les plus puiſſans de la Terre & des Cieux.	Votre amour est content, un doux succès le flatte, Mais il faut que ma gloire en ce beau jour éclate, je veux que votre Hymen se célèbre à mes yeux, Je veux que ce lieu s'embellisse, Et qu'une fête y réunisse Les Dieux les plus puissants de la Terre et des Cieux.
Le Theatre change & repreſente l’appareil du Feſtin des Nopces de Thetis & de Pelée.	Le Théâtre change et représente l'appareil du Festin des Noces de Thétis et de Pelée.
Les Dieux Celeſtes ſont placez de tous coſtez ſur des Nuages, & les Dieux Terreſtres ſont en bas.	Les Dieux Célestes sont placés de tous côtés sur des Nuages, et les Dieux Terrestres sont en bas.
SCENE CINQVIE’ME.	SCÈNE CINQUIE'ME.
JUPITER, THETIS, PELE’E, Troupe de Dieux Celeſtes, Troupe de Dieux Terreſtres.	JUPITER, THÉTIS, PÈLE, Troupe de Dieux Célestes, Troupe de Dieux Terrestres.
PITER.	PITER.
CouteZ moy, Troupe Immortelle.	Coutez moi, Troupe Immortelle.
E Quand l'Amour à Thetis me fit rendre des ſoins, Une flame ſi belle Hur tous tes EνFοrtεtο pour témoins.	 Quand l'Amour à Thétis me fit rendre des soins, Une flamme si belle Hur tous tes EνFοrtεtο pour témoins.
Mais j’ay ſacrifie mon amour à ma gloire, Je cede à mon Rival ce que j’aime le mieux, Je veux avoir toûs les Dieux Pour témoins de ma Victoire.	Mais j'ai sacrifie mon amour à ma gloire, Je cède à mon Rival ce que j'aime le mieux, Je veux avoir tous les Dieux Pour témoins de ma Victoire.
DIEOX DO CIEL.	DIEOX DO CIEL.
Celebrons tous par des Concerts charmans Du Souverain des Dieux le triomphe ſupréme.	Célébrons tous par des Concerts charmants Du Souverain des Dieux le triomphe suprême.
DIEUX DE LA TERRE.	DIEUX DE LA TERE.
Celebrons le bonheur extréme De deux parfaits Amans.	Célébrons le bonheur extrême De deux parfaits Amants.
DIEUX DU CIEL.	DIEUX DU CIEL.
Quels honneurs Jupiter ne doit-il pas attendre?	Quels honneurs Jupiter ne doit-il pas attendre?
DIEUX DE LA TERRE.	DIEUX DE LA TERE.
Que ces heureux Amans ſont charmeZ en ce jour!	Que ces heureux Amants sont charmés en ce jour!
DIEUX DU CIEL.	DIEUX DU CIEL.
Qu’il eſt beau de vaincre l’Amour!	Qu'il est beau de vaincre l'Amour!
DIEOX DE LA IERRE.	DIEOX DE LA IERE.
Qu'il est doux de s’y rendre!	Qu'il est doux de s'y rendre!
DIEUX DU CIEL & DE LA TERRE.	DIEUX DU CIEL et DE LA TERE.
Celebrons tous par des Concerts charmans Du Souverain des Dieux le triomphe ſuprême, Celebrons le bonheur extrême De deux parfaits Amans.	Célébrons tous par des Concerts charmands Du Souverain des Dieux le triomphe suprême, Clébrons le bonheur extrême De deux parfaits Amants.
Les Dieux Terreſtres ſe partagent en trois Quadrilles qui font des Danſes accompagnées de Recits.	Les Dieux Terrestres se partagent en trois Quadrilles qui font des Dans accompagnées de Recits.
La premiere Quadrille eſt celle de Vertumne & de Flore, ſuivis de Bergers & de Bergeres.	La première Quadrille est celle de Vertumne et de Flore, suivis de Bergers et de Bergères.
La ſeconde eſt celle de Pan & de Palés, avec les Faunes & les Silvains.	La seconde est celle de Pan et de Palés, avec les Faunes et les Silvains.
La troiſiéme eſt celle de Bacchus & de ſes Ménades.	La troisième est celle de Bacchus et de ses Ménades.
RECIT DE FLORE.	RÉCIT DE FLORE.
Tous vos vœux ſont ſatisfaits, Amans, ne changez jamais.	Tous vos vœux sont satisfaits, Amants, ne changez jamais.
Une flame contente N’en doit pas eſtre moins ardente, L’amour ne vous rend pas heureux Pour vous rendre moins amoureux.	Une flamme contente N'en doit pas être moins ardente, L'amour ne vous rend pas heureux Pour vous rendre moins amoureux.
Que toûjours les Zephirs & Flore Vous trouvent à leur retour Plus charmez, encore D’un mutuel amour.	Que toujours les Zéphirs et Flore Vous trouvent à leur retour Plus charmés, encore D'un mutuel amour.
RECIT DE PAN ET DE PALE'S.	RÉCIT DE PAN ET DE PALE'ES.
Belle Thetis, que votre choix Sera celebré dans nos bois!	Belle Thétis, que votre choix Sera célébré dans nos bois!
Vous avez d’un Mortel recompenſé la flame, L'éclat le plus brillant n’a point touché votre ame.	Vous avez d'un Mortel récompensé la flamme, L'éclat le plus brillant n'a point touché votre âme.
Belle Thetis, que votre choix Sera celebré dans nos bois!	Belle Thétis, que votre choix Sera célébré dans nos bois!
C’eſt ainſi que l’Amour nous guide & nous inſpire, Mempert Giueundenc iguorens lempire.	C'est ainsi que l'Amour nous guide et nous inspire, Mempert Giveundenc iguorents lempire.
Belle Thetis, que votre choix Sera celebré dans nos bois!	Belle Thétis, que votre choix Sera célébré dans nos bois!
RECIT DE BACCHUS.	RÉCIT DE BACCHUS.
Mélons noſtre douce folie Aux tranſports de ces cœurs ſi contents de leur ſort;	Mélons notre douce folie Aux transports de ces cœurs si contents de leur sort;
Bacchus avec l’Amour eſt aiſément d’accord.	Bacchus avec l'Amour est aisément d'accord.
Heureuſe une ame remplie De mes aimables fureurs, Ou de feutenureo tungueurs!	Heureuse une âme remplie De mes aimables fureurs, Ou de feutenureo tungueurs!
C’eſt par nous qu’on peut ſe défaire D’une raiſon trisfe & ſevere, Les bienfaits des autres Dieux Ne ſont pas ſi precieux.	C'est par nous qu'on peut se défaire D'une raison trisfe et sévère, Les bienfaits des autres Dieux Ne sont pas si précieux.
CHOEUR DE TOUS LES DIEUX.	CHOEUR DE TOUS LES DIEUX.
Vivez heureux, tendres Amans, Vivez, vivez heureux, oublieZ vos tourmens.	Vivez heureux, tendres Amants, Vivez, vivez heureux, oublieZ vos tourments.
Vn beau nœud vous unit, joüiſſez de ſes charmes.	Un beau nœud vous unit, jouissez de ses charmes.
Vous les avez payez par toutes vos allarmes.	Vous les avez payés par toutes vos alarmes.
Du ſort des plus grands Dieux ne ſoyez point jaloux, Ils ont peu de plaiſirs s’ils n’aiment comme vous.	Du sort des plus grands Dieux ne soyez point jaloux, Ils ont peu de plaisirs s'ils n'aiment comme vous.
FIN DU CINQUIE'ME ET DERNIER ACTE.	FIN DU CINQUIE'ME ET DERNIER ACTE.
Vous avez d’un Mortel recompenſé la flame, L'éclat le plus brillant n’a point touché votre ame.	Vous avez d'un Mortel récompensé la flamme, L'éclat le plus brillant n'a point touché votre âme.
Belle Thetis, que votre choix Sera celebré dans nos bois!	Belle Thétis, que votre choix Sera célébré dans nos bois!
C’eſt ainſi que l’Amour nous guide & nous inſpire, Mempert Giueundenc iguorens lempire.	C'est ainsi que l'Amour nous guide et nous inspire, Mempert Giveundenc iguorents lempire.
Belle Thetis, que votre choix Sera celebré dans nos bois!	Belle Thétis, que votre choix Sera célébré dans nos bois!
RECIT DE BACCHUS.	RÉCIT DE BACCHUS.
Mélons noſtre douce folie Aux tranſports de ces cœurs ſi contents de leur ſort;	Mélons notre douce folie Aux transports de ces cœurs si contents de leur sort;
Bacchus avec l’Amour eſt aiſément d’accord.	Bacchus avec l'Amour est aisément d'accord.
Heureuſe une ame remplie De mes aimables fureurs, Ou de feutenureo tungueurs!	Heureuse une âme remplie De mes aimables fureurs, Ou de feutenureo tungueurs!
C’eſt par nous qu’on peut ſe défaire D’une raiſon trisfe & ſevere, Les bienfaits des autres Dieux Ne ſont pas ſi precieux.	C'est par nous qu'on peut se défaire D'une raison trisfe et sévère, Les bienfaits des autres Dieux Ne sont pas si précieux.
CHOEUR DE TOUS LES DIEUX.	CHOEUR DE TOUS LES DIEUX.
Vivez heureux, tendres Amans, Vivez, vivez heureux, oublieZ vos tourmens.	Vivez heureux, tendres Amants, Vivez, vivez heureux, oublieZ vos tourments.
Vn beau nœud vous unit, joüiſſez de ſes charmes.	Un beau nœud vous unit, jouissez de ses charmes.
Vous les avez payez par toutes vos allarmes.	Vous les avez payés par toutes vos alarmes.
Du ſort des plus grands Dieux ne ſoyez point jaloux, Ils ont peu de plaiſirs s’ils n’aiment comme vous.	Du sort des plus grands Dieux ne soyez point jaloux, Ils ont peu de plaisirs s'ils n'aiment comme vous.
FIN DU CINQUIE'ME ET DERNIER ACTE.	FIN DU CINQUIE'ME ET DERNIER ACTE.
