Vous ne vous eſtes pas rrompé daus voſtre penſée, lors que vous auez dit (auant que l’on le joüaſt) que fi, Le Cocu Imaginaire, eſtoit traitté par vn habile homme, ſe deuoit eſtre vne parfaitement belle Piece:	Vous ne vous êtes pas rompé daus votre pensée, lors que vous avez dit (avant que l'on le jouât) que fi, Le Cocu Imaginaire, était traité par un habile homme, se devait avoir une parfaitement belle Pièce:
C’eſt pourquoy ie croy qu’il ne me ſera pas difff.	C'est pourquoi votre crois qu'il ne me sera pas dis.
sile de vous faire tomber d’arcord de la beauté de cette Comedie, meſme auant que de l’auoir veuë, quand te vous auray dit qu'elle part de la plume de l’ingenieux Autheur des Pretieuſes Ridicules.	síle de vous faire tomber d'arcord de la beauté de cette Comédie, même avant que de l'avoir vue, quand te vous aurai dit qu'elle part de la plume de l'ingénieux Auteur des Pretieuses Ridicules.
Iugez apres cela, ſi ce ne doit pas eſtre vnOuurage tout à fait galand & tout à fait ſpirituel, puiſque ce ſont deux choſes que ſon Autheur poſſede auantageuſement.	Jugez après cela, si ce ne doit pas être vnOuurage tout à fait galant et tout à fait spirituel, puisque ce sont deux choses que son Auteur possède avantageusement.
Elles y brillent außi auec tant d’éclat, que cette piece ſurpaſſe de beaucoup toutes celles qu’il a faites, quoy que le ſujet de ces Pretieuſes ridicules ſoit tout à fait ſpirituel, & celuy de ſon dépit amoureux tout à fait galand Mais' vous en alleZ vous-meſme eſtre Iuge dés que vous l’aurez leuë, & ie ſuis aſſeuré que vous y trouuerez quantité de Vers qui ne ſe peuuent payer, que plus vous relireZ, plus vous connoiſtrez auoir eſté profondement penſez.	Elles y brillent aussi auec tant d'éclat, que cette pièce surpasse de beaucoup toutes celles qu'il a faites, quoi que le sujet de ces Pretieuses ridicules soit tout à fait spirituel, et celui de son dépit amoureux tout à fait galant Mais vous en alleZ vous-même être Juge dès que vous l'aurez lue, et je suis assuré que vous y trouverez quantité de Vers qui ne se peuvent payer, que plus vous relirez, plus vous connaîtrez avoir été profondément pensez.
En effet, le ſens en eſt ſi mysterieux, qu’ils ne peuuent partir que d’vn homme conſommé dans les Compagnies, & i’oſe meſme auancer que Sganarelle n'a aucun mouuement jaloux, ny ne pouſſe aucuns ſentimens, que l’Autheur n’ait, peut-eſtre, ouys luy-meſme de quantité de gens, au plus fort de leur ialouſie, tant ils ſont exprimez naturellement;	En effet, le sens en est si mystérieux, qu'ils ne peuvent partir que d'un homme consommé dans les Compagnies, et j'ose même avancer que Séganarelle n'a aucun mouvement jaloux, ni ne pousse aucuns sentiments, que l'Auteur n'ait, peut-être, ouïs m-même de quantité de gens, au plus fort de leur jalousie, tant ils sont exprimez naturellement;
ſi bien que l’on peut dire que quand il veut mettre quelque choſe au iour, il le	si bien que l'on peut dire que quand il veut mettre quelque chose au jour, il le
lit premierement dans le moude (s’il eſt permis de parler ainſi) ce qui ne ſe peut faire ſans auoir vn diſcernement außi bon que luy, & außi propre à choiſir ce qui plaiſt.	lit premièrement dans le moude (s'il est permis de parler ainsi) ce qui ne se peut faire sans avoir un discernement aussi bon que sans, et aussi propre à choisir ce qui plaît.
On ne doit donc pas s’eſtõner apres cela, ſi ſes Pieces ont vne ſi extraordinaire reüßite, puiſque l’on n’y voit rien de forcé, que tout y eſt naturel, que tout y tombe ſous le ſens, & qu’enfin, les plus ſpirituels confeſſent que les paßions produiroiẽt en eux les meſmes effets qu’ils produisẽt en ceux qu’il introduit ſur laScene.	On ne doit donc pas s'estõner après cela, si ses Pièces ont été si extraordinaire réussi, puisque l'on n'y voit rien de forcé, que tout y est naturel, que tout y tombe sous le sens, et qu'enfin, les plus spirituels confessent que les passions produiraient en eux les mêmes effets qu'ils produisent en ceux qu'il introduit sur laScène.
Ie n’aurois iamais fait, ſi ie pretendois vous dire tout ce qui rend recommandable l’Autheur des Pretieuſes Ridicules, & du Cocu Imaginaire:	Je n'aurais jamais fait, si ici prétendais vous dire tout ce qui rend recommandable l'Auteur des Prifieuses Ridicules, et du Cocu Imaginaire:
C’eſt ce qui fait que ie ne vous en entretiendray pas dauantage, pour vous dire que quelques beautez que cette Piece vous faſſe voir ſur le papier, elle n’a pas encor tous les agrémens que le Theatre donne d'brumnant a les fortes d’Ouurages.	C'est ce qui fait que ie ne vous en entretiendrai pas davantage, pour vous dire que quelques beautés que cette Pièce vous fasse voir sur le papier, elle n'a pas encor tous les agrémens que le Théâtre donne d'Orhumnant a les fortes d'Ouvrages.
Ie tâcheray toutefois de vous en faire voir quelque choſe aux endroits où il ſera neceſſaire, pour l’intélligence des Vers & du ſujet, quoy qu’il ſoit aſſez difficile de bien exprimer ſur le papier ce que les Poëtes appellent Ieux de Theatre, qui ſont de certains endroits où il faut que le corps & le viſage joüent beaucoup, & qui dépendent plusdu Comedien que du Poëte, conſiſtant preſque touſiours dans l’action:	Je tâcherai toutefois de vous en faire voir quelque chose aux endroits où il sera nécessaire, pour l'intélligence des Vers et du sujet, quoi qu’il soit assez difficile de bien exprimer sur le papier ce que les Poètes appellent Jeux de Théâtre, qui sont de certains endroits où il faut que le corps et le visage jouent beaucoup, et qui dépendent plus Comédien que du Poète, consistant presque toujours dans l'action:
C’eſt pourquoy ie vous conſeille de venir à Paris, pour voir repreſenter le Cocu Imaginaire, par ſon Autheur, & vous verrez qu’il y fait des choſes qui ne vous donneront pas moins d’admiration, que vous aura donné la lecture de cette Piece;	C'est pourquoi votre vous conseille de venir à Paris, pour voir représenter le Cocu Imaginaire, par son Auteur, et vous verrez qu'il y fait des choses qui ne vous donneront pas moins d'admiration, que vous aura donné la lecture de cette Pièce;
mais ie ne m’apperçois pas que ie vousviens de promettre de ne vous plus entretenir de l’eſprit de cet Autheur, puiſque vous en découurirez plus dans les Fers que vous allez lire, que dans tous les diſcours que ie vous en pourrois faire.	mais personne ne m'aperçois pas que je vousviens de promettre de ne vous plus entretenir de l'esprit de cet Auteur, puisque vous en découvrirez plus dans les Fers que vous allez lire, que dans tous les discours que je vous en pourrais faire.
Ie ſçay bien que ie vous ennuye, & ie m’imagine vous voir paſſer les yeux auec chagrin par deſſus cette longue Epiſtre;	Je sais bien que je vous ennuie, et Seigneur m'imagine vous voir passer les yeux avec chagrin par dessus cette longue Épître;
mais prenez vous-en àl'Autheur.	mais prenez vous-en àl'Auteur.
Eoin, ie voudrois bien éuiter ce mot d’Autheur;	Eoin, Seigneur voudrais bien éviter ce mot d'Auteur;
car ie croy qu’il ſe rencontre preſque dans chaque ligne, & i’ay deſia eſté tenté plus de ſix fois de mettre Monſieur de Molier en ſa place.	car grands crois qu'il se rencontre presque dans chaque ligne, et j'ai déjà été tenté plus de six fois de mettre Monsieur de Molier en sa place.
Prenez vous-en donc à Monſieur de Molier, puiſque le voila.	Prenez vous-en donc à Monsieur de Mollier, puisque le voilà.
Non, laiſſez-le là toutesfois, & ne vous en prenez qu'à ſon eſprit qui m'a fait faire vne lettre plus longue que ie n’aurois voulu, ſans toutefois auoir parlé d’autres perſonnes que de luy, & ſans auoir dit le quart de ce que i’auois à dire à ſon auantage.	Non, laissez-le là toutefois, et ne vous en prenez qu'à son esprit qui m'a fait faire une lettre plus longue que je n'aurais voulu, sans toutefois avoir parlé d'autres personnes que de jours, et sans avoir dit le quart de ce que j'avais à dire à son avantage.
Mais ie finis, de peur que cette Epiſtre n'attire quelque maudiſſon ſur elle, & ie gage que dans l’impatience où vous eſtes vous ſerez bien aiſe d’en voir la fin, & le commencement de cette Piece.	Mais quelque finis, de peur que cette Épître n'attire quelque maudisson sur elle, et ie mage que dans l'impatience où vous êtes vous serez bien aise d'en voir la fin, et le commencement de cette Pièce.
ACTEVRS.	ACTEURS.
GORGIBVS, Bourgeois de Paris.	GORGIBUS, Bourgeois de Paris.
CEEIE, la filic.	CEIE, la filic.
LELIE, Amant de Celic.	LELIE, Amant de Célic.
GROS RENE', Valet de Lelie.	GROS RENE', Valet de Lélie.
SGANARELLE, Bourgeois deParis, & Cocu Imaginaire.	SGANARELLE, Bourgeois deParis, et Cocu Imaginaire.
SGANARELLE DV LE COCVIMAGINAIRE.	SGANARELLE DU LE COCVIMAGINAIRE.
COMEDIE.	COMÉDIE.
SCENE PREMIERE.	SCÈNE PREMIÈRE.
GORGIBVS, CELIE, SA SVIVANTE.	GORGIBUS, CÉLIE, SA SVIVANTE.
ETTE premiere Scene, où Gorgibus entre auecque ſa fille, fait voir à l’Auditeur que l’auarice eſt la paſſion la plus ordinaire aux vieillards, de meſme que l’amour eſt celle qui regne le plus ſouuent dans vn ieune cœur, & principalement dans celuy d’vne fille:	ETTTE première Scène, où Gorgibus entre auecque sa fille, fait voir à l'Auditeur que l'avarice est la passion la plus ordinaire aux vieillards, de même que l'amour est celle qui règne le plus souvent dans un jeune cœur, et principalement dans celui d'une fille:
car l’on y voit Gorgibus, malgré le choix qu’il auoit fait de Lelie, pour ſon gendre, preſſer ſafille d’agréer vn autre Eſpoux nommé Valere, incomparablement plus mal fait que Lelie, ſans donner d’autre raiſon de ce changemẽt, ſinon que le dernier eſt plus riche.	car l'on y voit Gorgibus, malgré le choix qu'il avait fait de Lélie, pour son gendre, presser safille d'agréer un autre Époux nommé Valère, incomparablement plus mal fait que Lélie, sans donner d'autre raison de ce changement, sinon que le dernier est plus riche.
L’on voit d’vn autre coſté que l’amour ne ſort pas facilement du cœur d’vne fille, quãd vne fois il en a ſeeu prẽdre poſſeſſiõ:	L'on voit d ' Hôte que l'amour ne sort pas facilement du cœur d'une fille, quand une fois il en a sû prẽdre possessions:
c’eſt ce qui fait vn agreable cõbat dãs cette Scene entre le pere & la fille, le pere luy voulant perſuader qu’il faut eſtre obeïſſante, & luy propoſant pour la deuenir, au lieu de la lecture de Clelie, celle de quelques vieux liures qui marquent l’antiquité du bon homme, & qui n’ont rien qui ne parût barbare, ſi l’on en comparoit le ſtile à celuy des ouuragès de l’Illuſtre Sapho.	c'est ce qui fait crains agréable combatt dans cette Scène entre le père et la fille, le père jour voulant persuader qu'il faut être obéissante, et même proposant pour la devenir, au lieu de la lecture de Clélie, celle de quelques vieux livres qui marquent l'antiquité du bon homme, et qui n'ont rien qui ne parut barbare, si l'on en comparait le style à celui des ouvragés de l'Illustre Sapho.
Mais que tout ce que ſon pere luy dit la touche peu, elle abandonneroit volontiers la lecture de toutes ſortes de liures pour s’occuper à repaſſer ſans ceſſe en ſon eſprit, les belles qualitez de ſonAmant, & les plaiſirs dont jouiſſent deux perſonnes qui ſe marient, quand ils s’aiment mutuellement:	Mais que tout ce que son père avait dit la touche peu, elle abandonnerait volontiers la lecture de toutes sortes de livres pour s'occuper à repasser sans cesse en son esprit, les belles qualités de sonAmant, et les plaisirs dont jouissent deux personnes qui se marient, quand ils s'aiment mutuellement:
mais, las!	mais, las!
que ce pere luy donne ſujet d’auoit bien de plus triſtes peuſées, il la preſſe ſi fort, que cette fille affligée n’a plus de recours qu’aux larmes, qui ſont les armes ordinaires de ſon ſexe, qui ne ſont pas toutesfois aſſez puiſſantes pour vaincre l’auarice de cet inſenſible pere, qui la laiſſe toute eſplorée.	que ce père avait donnée sujet d'avait bien de plus tristes peusées, il la presse si fort, que cette fille affligée n'a plus de recours qu'aux larmes, qui sont les armes ordinaires de son sexe, qui ne sont pas toutefois assez puissantes pour vaincre l'avarice de cet insensible père, qui la laisse toute esplorée.
Voicy les Vers de cette Scene qui vous feront voir ce que ie vous viens de diroimieux que ie n’ay fait dans cette Proſe.	Voici les Vers de cette Scène qui vous feront voir ce que je vous viens de diroimieux que ie que fait dans cette Prose.
CELIE ſortant toute eſplorée, & ſon pere la ſuiuant.	CELIE sortant toute esplorée, et son père la suivant.
Hln’eſperez iamais que mon cœur y conſente.	Hlès espérez jamais que mon cœur y consente.
A GORGIBVS.	À GORGIBUS.
Que marmortez-vous là petite impertinente, Vous pretendez choquer ce que i’ay reſolu, Ie n’auray pas ſur vous vn pouuoir abſolu?	Que marmortez-vous là petite impertinente, Vous prétendez choquer ce que j'ai résolu, Je n'aurai pas sur vous un pouvoir absolu?
Et par ſottes raiſons, voſtre ieune ceruelle Voudroit regler icy la raiſon paternelle.	Et par sottes raisons, votre jeune cervelle Voudrait régler ici la raison paternelle.
Qui de nous deux à l’autre a droit de faire loy, A voſtre aduis, qui mieux, ou de vous, ou de moy, O ſotte, peut iuger ce qui vous eſt vtile!	Qui de nous deux à l'autre a droit de faire loi, À votre avis, qui mieux, ou de vous, ou de moi, Ô tte, peut juger ce qui vous est utile!
Par la corbleu, gardez d’eſchauffer trop ma bile, Vous pourriez éprouuer, ſans beaucoup de lõgueur.	Par la corbleu, gardez d'échauffer trop ma bile, Vous pourriez éprouver, sans beaucoup de lõgueur.
Si mon bras ſçait encor montrer quelque vigueur.	Si mon bras sait encor montrer quelque vigueur.
Voſtre plus court ſera, Madame la mutine, D’accepter ſans façõs l’époux qu’on vous deſtine.	Votre plus court sera, Madame la mutine, D'accepter sans façons l'époux qu'on vous destine.
I’ignore, dites-vous, de quelle humeur il eſt.	J'ignore, dites-vous, de quelle humeur il est.
Et dois auparauant conſulter s’il vous plaiſt.	Et dois auparavant consulter s'il vous plaît.
Informé du grand bien qui luy tombe en partage, Dois-je prendre le ſoin d’en ſçauoir dauantage, Et cet eſpoux ayant vingt mille bons Ducats, Pour eſtre aimé de vous doit-il manquer d’appas.	Informé du grand bien qui avait tombe en partage, Dois-je prendre le soin d'en savoir davantage, Et cet époux ayant vingt mille bons Ducats, Pour être aimé de vous doit-il manquer d'appas.
Aliez tel qu’il pumne eſtre auecque cette ſomme;	Aliez tel qu'il pumne être auecque cette somme;
Ie vous ſuis caution qu’il eſt tres-hõneſte homme	Je vous suis caution qu'il est très-hõneste homme
Helas !	Hélas !
CELIE	CELIE
GORGIBVS.	GORGIBUS.
Et bien helas!	Et bien hélas!
que veut dire cecy, Voyez le bel helas!	que veut dire ceci, Voyez le bel hélas!
qu’elle nous donne icy, He!	qu'elle nous donne ici, He!
que ſi la colere vne fois me trauſporte, Ie vous fe ay chanter helas!	que si la colère homme me trausporte, Je vous se ai chant hélas!
de belle ſotte.	de belle sotte.
Voila, voila, le fruit de ces empreſſemens Qu’on vous voit nuit & iour à lite vos Romans, De colibets d’amour voſtre teſte eſt remplie, Et vous parlez de Dieu bien moins que de Clelie.	Voilà, voilà, le fruit de ces empressements Qu'on vous voit nuit et jour à lite vos Romans, De colibets d'amour votre tête est remplie, Et vous parlez de Dieu bien moins que de Clélie.
Iettez-moy dans le feu tous ces meſchans écrits Qui gaſtent tous les iours tant de ieunes eſprits, Liſez-moy comme il faut, au lieu de ces ſornettes Les Quatrains de Pibrac, & les doctes Tablettes Du Conſeiller Mathieu, ouurage de valeur, Dt plein de beaux dictons à reciter par cœur, La Guide des pecheurs eſt encor vn bon liure ;	Jettez-moi dans le feu tous ces méchants écrits Qui gâtent tous les jours tant de jeunes esprits, Lisez-moi comme il faut, au lieu de ces sornettes Les Quatrains de Pibrac, et les doctes Tablettes Du Conseiller Mathieu, ouurage de valeur, Dt plein de beaux dictons à réciter par cœur, La Guide des pécheurs est encor un bon livre ;
C’eſt là qu’en peu de temps on apprẽd à bien viure, Et ſi vous n’auiez leu que ces Moralitez, Vous ſçauriez vn peu mieux ſuiure mes volontez.	C'est là qu'en peu de temps on apprend à bien vivre, Et si vous n'aviez lu que ces Moralités, Vous sauriez un peu mieux suivre mes volontés.
CELIE.	CELIE.
Quoy, vous pretendez donc, mon pere, que i'oublie La conſtante amitié que ie dois à Lelie?	Quoi, vous prétendez donc, mon père, que j'oublie La constante amitié que ie dois à Lelie?
I’aurois tort ſi ſans vous ie diſpoſois de moy;	J'aurais tort si sans vous . disposais de moi;
Mais vous meſme à ſes vœux engegeaſtes ma foy.	Mais vous -même à ses vœux engegeastes ma foi.
GORGIBVS.	GORGIBUS.
Luy fut-elle engagée encore dauantage, Vn autre eſt ſuruenu, dont le bien l’en dégage.	Lui fut-elle engagée encore davantage, Un autre est survenu, dont le bien l'en dégage.
Lelie eſt fort bien fait;	Lélie est fort bien fait;
mais aprẽds qu’il n’eſt rien Qui ne doiue cedet au ſoin d’auoir du bien, Que l’or dnone aux plus laids certain charme pour plaire, Et que ſans luy le reſte eſt vne triſte affaite.	mais apprendre qu'il n'est rien Qui ne doive cédet au soin d'avoir du bien, Que l'or dnone aux plus laids certain charme pour plaire, Et que sans avoir le reste est une triste affaite.
Valere Valere, ie croy bien n’eſt pas de toy chery;	Valère Vale, ie crois bien n'est pas de toi chéri;
Mais s’il ne l’eſt amant, jil le ſera maty.	Mais s'il ne l'est amant, jil le sera mati.
Pluſque l’on ne le croit, ce nom d’eſpoux engage Et ’amour eſt ſouuent vn fruit de mariage.	Plusque l'on ne le croit, ce nom d'époux engage Et 'amour est souvent un fruit de mariage.
Mais ſuis-ie pas bien fat de vouloir raiſonner, Où de droit abſolu i’ay pouuoir d’ordonner, Treue donc, ie vous prie à vos impertinences, Que ie n’entende plus vos ſottes doleances:	Mais suis-je pas bien fat de vouloir raisonner, Où de droit absolu j'ai pouvoir d'ordonner, Treve donc, où vous prie à vos impertinences, Que ie n'entende plus vos sottes doléances:
Ce gendre doit venir vous viſiter ce ſoir, Manquez vn peu, manquez à le bien receuoir, Si ie ne vous luy vois faire fort bon viſage, Ie vous.	Ce gendre doit venir vous visiter ce soir, Manquez un peu, manquez à le bien recevoir, Si ici ne vous lui vois faire fort bon visage, Je vous.
,.	Ç,
ie ne veux pas en dire dauantage.	aires ne veux pas en dire davantage.
SCENE II.	SCÈNE II.
CELIE, SA SVIVANTE.	CELIE, SA SUIVANTE.
cheſſe eſt preferable à l’amour, il fait parler dans celle-cy (afin de diuertir l’Auditeur par la varieté de la matiere) vne veufve ſuiuante de Celie, & confidente tout enſemble, qui s’étonne dequoy ſa Maiſtreſſe reſpond par des larmes à des offres d’hymen, & apres auoir dit qu’elle ne feroit pas de meſme ſi l’on la vouloit marier, elle trouue moyen de deſcrire toutes les douceurs du mariage;	chesse est préférable à l'amour, il fait parler dans celle-cy (afin de divertir l'Auditeur par la variété de la matière) une veuve suivante de Célie, et confidente tout ensemble, qui s'étonne dequoy sa Maîtresse répond par des larmes à des offres d'hymen, et après avoir dit qu'elle ne ferait pas de même si l'on la voulait marier, elle trouve moyen de décrire toutes les douceurs du mariage;
ce qu’elle execute ſi bien, qu’elle en fait naître l’enuie à celles qui n’en ont pas tâtéSa Maiſtreſſe, comme font d’ordinaire celles qui n’ont iamais eſté mariées, l’eſcoute auec attention, & ne recule le temps de jouir de ſes douceurs, que parce qu’elle les veut goûter auec Lelie, qu’elle aime parfaiteinent, & qu’elles ſe changent toutes en amertumes, lors que l’on les goûte auec vne perſonne que l’on n’aime pas;	ce qu'elle exécute si bien, qu'elle en fait naître l'envie à celles qui n'en ont pas tâtéSa Maîtresse, comme font d'ordinaire celles qui n'ont jamais été mariées, l'écoute avec attention, et ne recule le temps de jouir de ses douceurs, que parce qu'elle les veut goûter auec Lie, qu'elle aime parfaiteinent, et qu'elles se changent toutes en amertumes, lors que l'on les goûte auec si personne que l'on n'aime pas;
c’eſt pourquoy-elle montre à ſa Suiuante le Portrait de Lelie, pour la faire tomber d’accord de la bonne mine de ce Galand, & du ſujet qu’elle ade l’aimet.	c'est pourquoi-elle montre à sa Suivante le Portrait de Lelie, pour la faire tomber d'accord de la bonne mine de ce Galant, et du sujet qu'elle ade l'aimet.
Vous m’objecterez peuteſtre que cette fille le doit connoître, puis qu’elle demeure auecque Celie, & que ſon pere l’ayant promiſe à Lelie, cet Amant eſtoit ſouuent venu voir ſa maiſtreſſe;	Vous m'objecterez peutêtre que cette fille le doit connaître, puis qu'elle demeure avec Celie, et que son père l'ayant promise à Lélie, cet Amant était souvent venu voir sa maîtresse;
mais ie vous répondray que Lelie eſtoit à la Campagne deuant qu’elle demeuraſt auec elle;	mais ici vous répondrai que Lélie était à la Campagne devant qu'elle demeurât toujours elle;
apres cette diſgreſſion, pour la iuſtification de noſtre Autheur, voyõs quels effets ce Portrait produit.	après cette disgrression, pour la justification de notre Auteur, vois quels effets ce Portrait produit.
Celle qui peu auparauant diſoit, qu’il ne falloit iamais reietter des offres d’hymen, avoüe que Celie a ſujet d’aimer tendrement vn homme ſi bien fait, & Celie ſongeant qu’elle ſera peut-eſtre cõtrainte d’en eſpouſer vn autre s’éuanoüit:	Celle qui peu auparavant disait, qu'il ne fallait jamais rejetter des offres d'hymen, avoue que Celie a sujet d'aimer tendrement un homme si bien fait, et Célie songeant qu'elle sera peut-être comtrainte d'en épouser un autre s'évanouit:
Sa confidente appelle du ſecours.	Sa confidente appelle du secours.
Cependant qu’il en viendra, vous pouuez lire ces Vers, qui vous le feront attendre ſans impatience.	Cependant qu'il en viendra, vous pouvez lire ces Vers, qui vous le feront attendre sans impatience.
LA SVIVANTE.	LA SVIVANTE.
Voy!	Voi!
refuſer Madame, auec cette rigueur, QCe que tant d’autres gens voudroient de tout leüt cœur, A des offres d’hymen reſpondre par des larmes, Et tarder tont à dire vn ouy ſi plein de charmes.	refuser Madame, avec cette rigueur, QCe que tant d'autres gens voudraient de tout le part, A des offres d'hymen répondre par des larmes, Et tarder tont à dire ain si si plein de charmes.
Helas!	Hélas!
que ne veut-on auſſi me marier, Ce ne ſeroit pas moy qui ſe feroit prier, Et loin qu’vn pareil ouy me donna de la peine Croyez que i’en dirois bien viſte vne douzaine, Le Precepteur qui fait repeter la leçon A voſtre ieune frere, a fort bonne raiſon, Lors que nous diſcourant des choſes de la terre, Il dit que la femelle eſt ainſi que le lierre, Qui croit beau tant qu’à l’arbre il ſe tiẽt bien ſerré, Et ne profire point s’il en eſt ſeparé.	que ne veut-on aussi me marier, Ce ne serait pas moi qui se ferait prier, Et loin qu'un pareil ouï me donna de la peine Croyez que j'en dirais bien vite une douzaine, Le Précepteur qui fait répéter la leçon A vôtre jeune frère, a fort bonne raison, Lors que nous discourant des choses de la terre, Il dit que la femelle est ainsi que le lierre, Qui croit beau tant qu'à l'arbre il se tierre il serré, Et ne profire point s'il en est séparé.
Il n’eſt rien de plus vray, ma tres-chere maiſtreſſe, Et ie l’eſprouue en moy, chetiue pechereſſe.	Il n'est rien de plus vrai, ma très-chère maîtresse, Et tu l'éprouve en moi, chétive pécheresse.
Le bon Dieu faſſe paix à mon pauure Martin, Mais i’auois, luy viuant, le teint d’vn Cherubin,  L’embonpoint merueilleux, l’œil gay, l'ame contente, Et ie ſuis maiatenant, ma commere, dolente.	Le bon Dieu fasse paix à mon pauvre Martin, Mais j'avais, Seigneur vivant, le teint d' Cherubin, L'embonpoint merveilleux, l'œil gai, l'âme contente, Et ie suis matenant, ma commere, dolente.
Pendant cet heureux temps paſſé comme vn éclair, Ie me couchois ſans feu dans le fort de l’Hyuer, Seicher meſme les draps me ſembloit ridicule, Et ie tremble à preſent dedans la Canicule.	Pendant cet heureux temps passé comme un éclair, Je me couchais sans feu dans le fort de l'Hiver, Sicher même les draps me semblait ridicule, Et quelque tremble à présent dedans la Canule.
Enfin, il n’eſt rien tel, Madame, croyez moy, Que d’auoir vn mary la nuit aupres de ſoy, Ne fut-ce que pour l’heur d’auoir qui vous ſalus D’vn Dieu vous ſoit en aide, alors qu’on eſternuë.	Enfin, il n'est rien tel, Madame, croyez moi, Que d'avoir un mari la nuit auprès de soi, Ne fut-ce que pour l'heur d'avoir qui vous salus D'un Dieu vous soit en aide, alors qu'on éternue.
19 Ille LbNCELIE.	19 Ille LébNCELIE.
II Peux-tu me conſeiller de commettre vn forfait, D’abandonner Lelie, & prendre ce mal-fait?	II Peux-tu me conseiller de commettre un forfait, D'abandonner Lelie, et prendre ce mal-fait?
u	
LA SVIVANTE, Voſtre Lelie auſſi, n’eſt ma foy qu'vne beſte, Puiſque ſi hors de temps ſon voyage -l'arreſte, l Et la grande longueur de ſon eſloignement Me le fait ſoupgonner de quelque changement.	LA SVIVIANTE, Votre Lélie aussi, n'est ma foi qu'une bête, Puisque si hors de temps son voyage -l'arrête, l' Et la grande longueur de son éloignement Me le fait soupgonner de quelque changement.
CELIE luy montrant le Pertrait de Lelie.	CELIE belle montrant le Pertrait de Lélie.
Ah!	Ah!
ne m’accable point par ce triſte preſage, 1 Vois attentiuement les traits de ce viſage, Ils iurent à mon cœur d’eternelles ardeurs, Ie veux croire aptes tout, qu’ils ne ſont pas menteurs, Et comme c’eſt celuy que l'art y repceſshre MaN Il conſerue à mes feux vne amitie conſtante.	ne m'accable point par ce triste présage, 1 Vois attentivement les traits de ce visage, Ils jurent à mon cœur d'éternelles ardeurs, Je veux croire aptes tout, qu'ils ne sont pas menteurs, Et comme c'est celui que l'art y répcesshre MaN Il conserve à mes feux -je amitié constante.
LA SVIVANTE.	LA SVIVANTE.
i eit tray que ces traits marquent vn digne Amant, Et que vous auez lieu de l’aimer tendrement,	y j' ai que ces traits marquent un digne Amant, Et que vous avez lieu de l'aimer tendrement,
d ae det Et cependant il faut.	 dpe dét Et cependant il faut.
ah!	ah!
ſouſtiens moy.	soutiens -moi.
LA SVIVANTE.	LA SVIVANTE.
Madame D'où vous pourroit venir.	Madame D'où vous pourrait venir.
ah!	ah!
bon Dieux elle pâme.	bon Dieux elle pâme.
He!	He!
viſte, hola, quelqu’vn.	vite, holà, quelqu'amour.
10	10
SCENE III.	SCÈNE III.
I CELIE, LA SVIVANTE, SGANARELLE.	I CELIE, LA SVIVANTE, SGANARELLE.
Erte Scene eſt fort courte, & SgaCnarelle, comme vn des plus proches voiſins de Celie, accourt aux cris de cette Suiuante, qui luy donne ſa Maiſtreſſe à ſouſtenir, cepẽdant qu’elle va chercher encore du ſecours d’vn autre coſté, comme vous pouuez voir par ce qui ſuit.	Erte Scène est fort courte, et SégaCharelle, comme un des plus proches voisins de Celie, accourt aux cris de cette Suivante, qui avait donne sa Maîtresse à soutenir, cepiendant qu'elle va chercher encore du secours d'un autre côté, comme vous pouvez voir par ce qui suit.
10	10
SGANARELLE.	SGANARELLE.
Qu'ent-te donc?	Qu'ent-te donc?
me voila.	me voilà.
A SVIVANTE.	À SVIVANTE.
Ma Maiſtrefſe ſe meurt.	Ma Maîtrefse se meurt.
B Ij	BI Ij
21 SGANAREL LE Quoy, ce n’eſt que cela, Ie croyois tout perdu de crier de la forte;	21 SGANAREL LE Quoi, ce n'est que cela, Je croyais tout perdu de crier de la forte;
Mais approchons pourtant.	Mais approchons pourtant.
Madame eſtes vous morte  Hays, elle ne dit mot.	Madame êtes -vous morte Hais, elle ne dit mot.
LA SVIVANTE.	LA SVIVANTE.
Ie vay faire venit Quelqu’vn pour lemporteij ruemen ta louſtenir.	Je vais faire venit Quelqu'autre pour lemporteij pour le loutenir.
SCENE IV.	SCÈNE IV.
CELIE, SGANARELLE,	CELIE, SGANARELLE,
11144 SA FEMME.	11144 SA FEMME.
1 14.	1 14.
10 2adign Ette Scene n’eſt pas plus longue 14 que la precedente, & la femme de Sganarelle, regardant par la feneſtre, prend de la jalouſie de ſon mary, à qui elle voit tenir vne femme entle les pras, d dencena poti ſe ſurprendre, cependant qu’il aide a rem20 porter Celie chez elle.	10 2adign Ette Scène n'est pas plus longue 14 que la précédente, et la femme de Séanarelle, regardant par la fenêtre, prend de la jalousie de son mari, à qui elle voit tenir une femme entle les pras, d encena poti se surprendre, cependant qu'il aide à rem20 porter Célie chez elle.
Ce que vous pourrez voir en liſant ces Vers.	Ce que vous pourrez voir en lisant ces Vers.
SGANARELLE, En luy paſſant la MO 0HO main ſur le ſein.	SGANARELLE, En lui passant la MO main sur le sein.
«Lle eſt froide par tout, & ie ne ſçay qu’en dire, LApprochons nous pour voir ſi ſa bouche reſpire.	«Lle est froide par tout, et ainsi ne sais qu'en dire, LApprochons nous pour voir si sa bouche respire.
Mſa foy ie ne ſcay pas;	Msa foi Madame ne sais pas;
mais i’y trouué encor moy!	mais j'y trouvé encor moi!
Quelque ſigne de vic.	Quelque signe de vic.
LAFEMME de Sganareſle regardant par la fenestre.	LAFEMME de Séganaresle regardant par la fenêtre.
Ah!	Ah!
qu’eſt-ce que ie oy, Mon mary dans ſes bras.	qu'est-ce que ie cy, Mon mari dans ses bras.
mais ie m’en vais deſcendte.	mais ici m'en vais descendte.
dn an qa Il me trahit ſans doute, & ie veux le ſurprendre.	Un an qa Il me trahit sans doute, et On veux le surprendre.
SGANARELLE.	SGANARELLE.
Il faut ſe dépeſcher de l’aller ſecourir, noaplai Cettes elle auroit tort de ſe laiſſer mourir, finet en l’autre monde eſt treſ-grande ſottiſe, l'aſt que dianx celureey d’om peuteiie de mife.	Il faut se dépêcher de l'aller secourir, noapplai Cettes elle aurait tort de se laisser mourir, finet en l'autre monde est très-grande sottise, l'ast l' dianx que dom peuteiie de mife.
.	.
Il l'emporte auec vn homme que la Suinante amene.	Il l'emporte avec un homme que la Suinante amène.
SCENE V.	SCÈNE V.
LA FEMME DE SGANARELLE ſeule.	LA FEMME DE SGANARELLE seule.
FAT ’Autheur, qui, comme nous auõs Ldit cydeſſus, ſçait,tout à fait bien meſnager l'eſprit de ſon Auditeur, apres l’auoir diuerty dans les deux precedentes Scenes, dont la beauté conſiſte preſque toute dans l’action, l’attache dans celle-cy par vn raiſonnement ſi iuſte, que l'on ne pourra qu’à peine ſe l’imaginer, ſi l’on en conſidere la matiere;	FAT AUteur, qui, comme nous auõs Lédit cydessus, sait,tout à fait bien ménager l'esprit de son Auditeur, après l'avoir diverti dans les deux précédentes Scères, dont la beauté consiste presque toute dans l'action, l'attache dans celle-cy par un raisonnement si juste, que l'on ne pourra qu'à peine se l'imaginer, si l'on en considère la matière;
mais il n’appartient qu’à des plumes, comme la ſienne, à faire beaucoup de peu, & voicy pour ſatisfaire voſtre curioſité le ſu	mais il n'appartient qu'à des plumes, comme la sienne, à faire beaucoup de peu, et voici pour satisfaire votre curiosité le su
jet de cette Scene.	jet de cette Scène.
La femme de Sganarelle eſtant deſcenduë, & n’ayant point trouué ſon mary, fait eſclater ſa jalouſie, mais d’vne maniere s’y ſurprenante & ſi extraordinaire, que quoy que cette matiere ait eſté fort ſouuent rebatuë, iamais perſonne ne l’a traittée auec tant de ſuccez, d’vne maniere ſi contraire à celles de toutes les autres femmes, qui n’ont recours qu’aux emportemens en de ſemblables rencõtres, & cõme il m’a eſté preſque impoſſible de vous l’exprimer auſſi bien que luy:	La femme de Séanarelle étant descendue, et n'ayant point trouvé son mari, fait éclater sa jalousie, mais d'une manière s'y surprenante et si extraordinaire, que quoi que cette matière ait été fort souvent rebatue, jamais personne ne l'a traitée avec tant de succès, d'une manière si contraire à celles de toutes les autres femmes, qui n'ont recours qu'aux emportements en de semblables rencôtres, et comme il m'a été impossible impossible que vous l'exprimer aussi bien que tu:
Ces Vers vous en feront connoître la beauté!	Ces Vers vous en seront connaître la beauté!
LA FEMME DESGANARELLE ſeule.	LA FEMME DESGANARELLE seule.
L s’eſt ſubitement éloigné de ces lieux, IEt ſa fuite à trompé mon deſir curieux.	 L'est subitement éloigné de ces lieux, JEt sa fuite à trompé mon désir curieux.
Mais de ſa trahiſon ie ne fais plus de doute, Et le peu que i’ay veu me la découure toute.	Mais de sa trahison ici ne fais plus de doute, Et le peu que j'ai vu me la découvre toute.
Ie ne m’eſtonne plus de l’eſtrange froideur Dont ie le vois reſpondre à ma pudique ardeur,  Il reſerue, l’ingrat, ſes careſſes à d’autres, Il nourrit leurs plaiſirs par le jeûne des noſtres.	Je ne m'étonne plus de l'étrange froideur Dont ie le vois répondre à ma pudique ardeur, Il réserve, l'ingrat, ses caresses à d'autres, Il nourrit leurs plaisirs par le jeûne des nôtres.
Voila de nos maris le procedé commun, Ce qui leur eſt permis, leur deuient importun;	Voilà de nos maris le procédé commun, Ce qui leur est permis, leur devient importun;
Dans les commẽcemens ce ſont toutes merueilles, Ils témoignẽt pour nous des ardeurs nompareilles, Mais les traiſtres bien-toſt ſe laſſent de nos feux, Et portent autre part ce qu’ils doiuent chez eux.	Dans les commencements ce sont toutes merveilles, Ils témoignẽt pour nous des ardeurs nompareilles, Mais les traîtres bientôt se lassent de nos feux, Et portent autre part ce qu'ils doivent chez eux.
Ah!	Ah!
que i’ay de deſpit, que la loy n’authoriſe A changer de mary comme on fait de chemiſe :	que j'ai dé dépit, que la loi n'autorise A changer de mari comme on fait de chemise :
Cela ſeroit commode, & i’en ſçay tel icy Qui comme moy, ma foy, le voudroit bien auſſiMais quel eſt ce bijou que le ſort me preſente, L’aimail en eſt fort beau, la graueure charmante, Ouurons.	Cela serait commode, et j'en sais tel ici Qui comme moi, ma foi, le voudrait bien aussiMais quel est ce bijou que le sort me présente, L'aimail en est fort beau, la graveure charmante, Ouvrons.
SGANARELLE, ET SA FEMME.	SGANARELLE, ET SA FEMME.
1 Velques beautez que l’Autheur ait fait voir dans la Scene precedente, ne croyez pas qu’il ſoit de ceux qui ſouuent apres vn beau debut donnẽt (pour parler vulgairemẽt) du nez en terre, puiſque plus vous auancerez dans la lecture de cette Piece, plus vous y découurirez de beautez, & pour en eſtre perſuadé, il ne faut que ietter les yeux ſur cette Scene qui en fait le fondement.	1 Velques beautés que l'Auteur ait fait voir dans la Scène précédente, ne croyez pas qu'il soit de ceux qui souvent après un beau début donnée (pour parler vulgairemẽt) du nez en terre, puisque plus vous avancez dans la lecture de cette Pièce, plus vous y découvrirez de beautés, et pour en même persuadé, il ne faut que jeter les yeux sur cette Scène qui en fait le fondement.
Celie en s’éuanouiſſant, ayant laiſſé tomber le portrait de ſon Amant, la femme de Sganarelle le ramaſſe, & com10 me elle le conſidere attentiuement, ſon mary ayant aidé à reporter Celie chez elle, rentre ſur la Scene, & regarde par deſſus l'eſpaule de la lents cat amuce nda 44 me, ce qu’elle conſidere, & voyant ce portrait, commence d’entrer en quelque ſorte de jalouſie, lors que ſafemme s’aniſe de le ſentir, ce qui confirme ces ſoupçons, dans la penſée qu’il a qu’elle le baiſe;	Celie en s'évanouissant, ayant laissé tomber le portrait de son Amant, la femme de Séganarelle le ramasse, et com10 me elle le considère attentivement, son mari ayant aidé à reporter Célie chez elle, rentre sur la Scène, et regarde par -dessus l'épaule de la lents cat amuce néda 44 me, ce qu'elle considère, et voyant ce portrait, commence d'entrer en quelque sorte de jalousie, lors que safemme s'anise de le sentir, ce qui confirme ces soupçons, dans la pensée qu'il a qu'elle le baise;
mais il ne doute bien-toſt plus qu’il eſt de la grande Confrairie, quand il entend dire à ſa femme, qu’elle ſouhaiteroit d’auoir vn Eſpoux d’vne auſſi bonne mine:	mais il ne doute bientôt plus qu'il est de la grande Confrairie, quand il entend dire à sa femme, qu'elle souhaiterait d'avoir un Époux d'une aussi bonne mine:
C’eſt alors qu’en la ſurprenant, il luy arrache ce portrait.	C'est alors qu'en la surprenant, il lui arrache ce portrait.
Mais deuant que de parler des diſcours qu’ils tiennent enſemble ſur le ſujet de leur jalouſie, il eſt à propos de vous dire qu’il ne s’eſt iamais rien veu de fi agreable que les poſtures de Sganarelle, quand il eſt derriere ſa femme, ſon viſage & ſes geſtes expriment ſi bien ſa jalouſie, qu’il ne ſeroit pas neceſſaire qu’il parlaſt pour paroiſtre le plus jaloux de tous les hommes:	Mais devant que de parler des discours qu'ils tiennent ensemble sur le sujet de leur jalousie, il est à propos de vous dire qu'il ne s'est jamais rien vu de fi agréable que les postures de Sanarelle, quand il est derrière sa femme, son visage et ses gestes expriment si bien sa jalousie, qu'il ne serait pas nécessaire qu'il para pour paroistre le plus jaloux de tous les hommes:
Il reproche à ſa femme ſon infidelité, & tâche à la perſuader qu’elle eſt d’autant plus coupable qu’elle a vn mary qui (ſoit pour les qualitez du corps, ſoit pour celles de l'eſprit) eſt entierement patfait.	Il reproche à sa femme son infidélité, et tâche à la persuader qu'elle est d'autant plus coupable qu'elle a un mari qui (sait pour les qualités du corps, soit pour celles de l'esprit) est entièrement patfait.
Sa femme qui, d’vn autre coſté, croit auoir autant & plus de ſujet que luy d’auoir martel en teſte, s’emporte contre luy, en luy redemandant ſon bijou;	Sa femme qui, d'un autre côté, croit avoir autant et plus de sujet que lui d'avoir martel en tête, s'emporte contre lui, en lui redemandant son bijou;
tellement que chacun croyant auoir raiſon, cette diſpute donne vn agreable diuertiſſement à l’Auditeur, à quoy Sganarelle contribuë beaucoup par des geſtes qui ſont inimitables, & qui ne ſe peuuent exprimer ſur le papier.	tellement que chacun croyant avoir raison, cette dispute donne un agréable divertissement à l'Auditeur, à quoi Sganarelle contribue beaucoup par des gestes qui sont inimitables, et qui ne se peuvent exprimer sur le papier.
Sa femme eſtant laſſe d’oüyr ſes reproches, luy arrache le portrait qu’il luy auoit pris, & s’enfuit, & Sganarelle court apres elle.	Sa femme étant lasse d’ mourir ses reproches, tu arrache le portrait qu'il M adait pris, et s'enfuit, et Séganarelle court après elle.
Vous auriez ſujet de me quereller, ſi iene vous enuoyois pas les Vers d’vne deene qui fait le rondenſent de cette Piece;	Vous auriez sujet de me quereller, si ience vous envoyais pas les Vers d'une deene qui fait le rondensent de cette Pièce;
c’eſt pourquoy ie ſatis- faits à voſtre curiofité.	c'est pourquoi Madame satî- faits à votre curiosité.
SGANARELLE.	SGANARELLE.
ON la cioyont mnorte, & ce nenon rien, Il n’en faut plus qu’autant, elle ſe porte bien.	ON la cioyont morte, et ce nenon rien, Il n'en faut plus qu'autant, elle se porte bien.
Mais i’apperçois ma femme.	Mais j'aperçois ma femme.
SA FEMME.	SA FEMME.
O ciel!	Ô ciel!
c’eſt mignature, Et voila d'vn bel homme vne viue peinture.	c'est mignature, Et voilà d'un bel homme une vive peinture.
SGANARELLE à part, & regardant dai rqpale at la Jeune Que confidere-t'elle auéc attention?	SGANARELLE à part, et regardant dai rqpale at la Jeune Que considère-t'-elle auéc attention?
Ce portrait mon honneur ne nous dit rien de bon, D’vn forr vilain ſoupçon ie me ſens l’ame eſmeuë.	Ce portrait mon honneur ne nous dit rien de bon, D'un forr vil soupçon ie me sens l'âme émue.
1 SA FEMME.	1 SA FEMME.
Sant l’aperceuoir contin uë.	Sant l'apercevoir contin ue.
Iamais rien de plus beau ne s’offrit à ma veuë.	Jamais rien de plus beau ne s'offrit à ma vue.
Le tlauail pius que l’ol s en uoit encoi priſer.	Le tlavail pius que l'ol s en uoit encoi pris.
Hon que cela ſent bon	Hon que cela sent bon
SGANARELLE à part.	SGANARELLE à part.
Quoy, beſte le baiſer Ah!	Quoi, bête le baiser Ah!
i'en tiens.	j'en tiens.
SA FEMME pourſuit.	SA FEMME poursuit.
Auoüons qu’on doit eſtte rauie Quand d’vn hõme ainſi fait on ſe peut voir ſerure, Et que s’il en contoit auec attention, Le penchant ſeroit grand à la tentation.	Auoüons qu'on doit estte ravie Quand d'un hõme ainsi fait on se peut voir servre, Et que s'il en contait a attention, Le penchant serait grand à la tentation.
Ah!	Ah!
que n’ay-ie vn mary d’vne auſſi bonne mine, Au lieu de mon pelé, de mon ruſtre.	que n'ai-je un mari d'une aussi bonne mine, Au lieu de mon pelé, de mon rustre.
SGANARELLE luy arrasbant le portrait.	SGANARELLE était arrasbant le portrait.
Ah!	Ah!
matine, Nous vous y ſurprenons en faute contre nous, En diffamant l’honneur de voſtre cher eſpoux.	matine, Nous vous y surprenons en faute contre nous, En diffamant l'honneur de votre cher époux.
Donc à voſtre calcul.	Donc à votre calcul.
ô ma trop digne femme!	ô ma trop digne femme!
Monſieur, tout bien cõté, ne vaut pas bien Madame, Et de par Belzebut, qui vous puiſſe emporter, Quel plus rate party pourriez-vous ſouhaitter.	Monsieur, tout bien compté, ne vaut pas bien Madame, Et de par Belzebut, qui vous puisse emporter, Quel plus rate parti pourriez-vous souhaiter.
Peut-on trouuer en moy quelque choſe à redire, Cette taille, ce port, que tout le monde admire, Ce viſage ſi propre à donner de l’amour, Pour qui mille beautez ſoûpirent nuit & iout;	Peut-on trouver en moi quelque chose à redire, Cette taille, ce port, que tout le monde admire, Ce visage si propre à donner de l'amour, Pour qui mille beautés soupirent nuit et jout;
Bref, en tout & par tout ma perſonne charmante, N’eſt donc pas vn morceau dont vous ſoyez conaente „ Et pour raſſaſier voſtre appetit gourmand, Il faut à ſon mary le ragoût d’vn galand.	Bref, en tout et par tout ma personne charmante, N'est donc pas un morceau dont vous soyez conaente „ Et pour rassasier votre appétit gourmand, Il faut à son mari le ragoût d'un galant.
SA FEMMB.	SA FEMB.
I'entends à demy mot où va la raillerie, Tu crois par ce moyen.	J'entends à demi mot où va la raillerie, Tu crois par ce moyen.
SGANARELLE.	SGANARELLE.
A d’autres ie vous prie, La choſe eſt auerée, & ie tiens dans mes mains Vn Vn bon certificat du mal dont ie me plains.	À d'autres fois vous prie, La chose est auerée, et tu tiens dans mes mains Un Vn bon certificat du mal dont votre me plains.
SA FEMME.	SA FEMME.
Mon courroux n’a deſia que trop de violence, Sans le charger encor d’vne nouuelle offences Eteoute, ne erois pas letei mon bijou, Et ſonge vn peu.	Mon courroux n'a déjà que trop de violence, Sans le charger encor d'une nouvelle offenses Éteoute, ne erais pas lettei mon bijou, Et songe un peu.
SGANARELLE.	SGANARELLE.
Ie ſonge à te rompre le cou.	Je songe à te rompre le cou.
Que ne puis-ie auſſi bien que ie tiens la copie, Tenir l’originan	Que ne puis-je aussi bien que . Tiens la copie, Tenir l'originan
SA FEMME.	SA FEMME.
Pourquoy?	Pourquoi?
SGANARELLE.	SGANARELLE.
Pour rien ma mieDoux objet de mes vœux j’ay grand tort de crier, Et mon front de vos dons vous dort femercier.	Pour rien ma mieDoux objet de mes vœux j'ai grand tort de crier, Et mon front de vos dons vous dort femercier.
Le voila le beau fils, le mignon de couchette, Le mal-heureux tiſon de ta flame ſecrette, de dron adec lequele.	Le voilà le beau fils, le mignon de couchette, Le malheureux tison de ta flamme secrète, de dron adec le.
SA FEMME.	SA FEMME.
Auec lequel, poutſuis:	Avec lequel, poutsuis:
SGANARELLE.	SGANARELLE.
Auec lequel te dis-ie.	Avec lequel te dis-je.
& i’en creue d’ennuis.	et j'en crève d'ennuis.
SA FEMME.	SA FEMME.
Que me veut donc par là, cõter ce maiſtte yurogne?	Que me veut donc par là, comme ce maistte ivrogne?
SGANARELLE.	SGANARELLE.
Tu ne m’entends que trop, Madame la carogne.	Tu ne m'entends que trop, Madame la carogne.
Sganarelle eſt vn nom qu’on ne me dira plus, Et l’on va m’appeller Seigneur Cornellius:	Séganarelle est un nom qu'on ne me dira plus, Et l'on va m'appeler Seigneur Cornelius:
I’en ſuis pour mon honneur;	J'en suis pour mon honneur;
mais à toy qui me Tontcs, Ie t’en feray du moins pour vn bras ou deux coſtes.	mais à toi qui me Tontcs, Je t'en ferai du moins pour un bras ou deux côtes.
SA FEMME.	SA FEMME.
Et tu m’oſes tenir de ſemblables diſcours,	Et tu m'oses tenir de semblables discours,
SGANARELLE.	SGANARELLE.
Et tu m’oſes ioüer de ces diables de tours?	Et tu m'oses ioüer de ces diables de tours?
SA FEMME.	SA FEMME.
Et quels diables de.	Et quels diables de.
tours, parle done ſans tiez feindre?	tours, parle donce sans tiez feindre?
SGANARELLE.	SGANARELLE.
Ah!	Ah!
cela ne vaut pas la peine de ſe plaindre, o vu pamene de cetf ſur le ſroût me pouruoit, Helas!	cela ne vaut pas la peine de se plaindre, ô vu pamène de cetf sur le sroût me pourrait, Hélas!
voila vrayment vn beau venez-y voit.	voilà vraiment un beau venez-y voit.
SA FEMME.	SA FEMME.
Douc apres m’auoir fait la plus ſenſible offenſe Qui puiſſe d’vne femme cxciter la vengeance, Tu prends d’vn feint courroux le vain amuſement b01 p.	Douc après m'avoir fait la plus sensible offense Qui puisse d'une femme cxciter la vengeance, Tu prends d'un feint courroux le vain amusement b01 p.
iuenir l’effet de mon teſſeutiment :	juenir l'effet de mon tesseutiment :
D’vn pareil procedé l’inſolence eſt nouuelle, Celuy qui fait l’offence eſt celuy qui querelle.	D'un pareil procédé l'insolence est nouvelle, Celui qui fait l'offense est celui qui querelle.
SGANARELLE Eh!	SGANARELLE Eh!
la bonne effrontée, à voir ce fier maintien Ne la croitoit-on pas vne femme de bien?	la bonne effrontée, à voir ce fier maintien Ne la croit-on pas une femme de bien?
A FEMME.	À FEMME.
Ruy pourſuis ton chemin cajolle tes maiſtreſſes, Addreſſe leur tes vœux.	Ruy poursuis ton chemin cajolle tes maîtresses, Adresse leur té mœux.
& fais leur des careſſes, Mais rends moy mon portrait ſans te joüet de moy.	et fais leur des caresses, Mais rends moi mon portrait sans te jet de moi.
Ele liay arraent te portrau, Crenjait.	Elle liai arraent te portrau, Crenjait.
SGANARELLE courant apres elle, Ouy, tu erbis ui efenapperei Pauray malgré toy.	SGANARELLE courant après elle, Oui, tu erbis ui efenapperei Paurai malgré toi.
SCENE VII.	SCÈNE VII.
LELIE, GROSRENE'.	LELIE, GROSRENE.
Elie auoit deſia trop cauſé de Etrouble dans l’eſprit de tous nos Acteurs, pour ne pas venir faire paroître les ſiens ſur la Scene:	Elie avait déjà trop causé de Étrouble dans l'esprit de tous nos Acteurs, pour ne pas venir faire paraître les siens sur la Scène:
En effet, il n’y arriue pas plûtoſt, que l’on voit la triſteſſe peinte ſur ſon viſage.	En effet, il n'y arrive pas plutôt, que l'on voit la tristesse peinte sur son visage.
Il fait voir que de la campagne où il eſtoit, il s’eſt rendu au plûtoſt à Paris, ſur le bruit de l’hymen de Celie.	Il fait voir que de la campagne où il était, il s'est rendu au plutôt à Paris, sur le bruit de l'hymen de Celie.
Comme il eſt tout nouuellement arriué, ſon valet le preſſe d’aller manger vn morceau deuant que d’aller apprendre des nouuelles de ſa Maîtreſſe;	Comme il est tout nouvellement arrivé, son valet le presse d'aller manger un morceau devant que d'aller apprendre des nouvelles de sa Maîtresse;
mais il n’y veut pas conſentir, & voyant que ſon valet l’importune, il l’enuoye manger, cependant qu’il va chercher à ſe delaſſer des fatigues de ſon voyage aupres de ſa Maiſtreſſe.	mais il n'y veut pas consentir, et voyant que son valet l'importune, il l'envoie manger, cependant qu'il va chercher à se délasser des fatigues de son voyage auprès de sa Maîtresse.
Remarquez, s’il vous plaiſt, ce que cette Scene contient, & ie vous feray voir en vn autre endroit, que l’Autheur ainfiniment de l’eſprit de l’auoir placée ſi à propos;	Remarquez, s'il vous plaît, ce que cette Scène contient, et personne vous ferai voir en un autre endroit, que l'Auteur ainfiniment de l'esprit de l'avoir placée si à propos;
& pour vous en mieux faire reſſoudenir, en voicy les Vers.	et pour vous en mieux faire ressoudenir, en voici les Vers.
GROSRENE'.	GROSRENE.
Nfin, nous y voicy;	Nfin, nous y voici;
mais Monſieur, ſi ie l’oſe, LIe voudrois vous prier de me dire vnc chuſe.	mais Monsieur, si on l'ose, LIe voudrais vous prier de me dire un chuse.
Hé bien, parle.	Hé bien, parle.
LELIE.	LELIE.
GROSRENE'.	GROSRENE.
Auez-vous le diable dans le corps Pour ne pas ſuccomber à de pareils efforts:	Avez-vous le diable dans le corps Pour ne pas succomber à de pareils efforts:
Depuis huit iours entiers auec vos longues traites, Nous ſommes à piquer de chiennes de mazettes, De qui le train maudit nous a tant ſecoüez, Que ie m’en ſens, pour moy, tous les mẽbres roüez, Sans preiudice encor d’vn accident bien pire, Qui m’afflige vn endroit que ie ne veux pas dire;	Depuis huit jours entiers auec vos longues traites, Nous sommes à piquer de chiennes de mazettes, De qui le train maudit nous a tant secoüez, Se ie m'en sens, pour moi, tous les mienbres rouez, Sans préjudice encor d'H accident bien pire, Qui m'afflige un endroit que ie ne veux pas dire;
Cependant arriué vous ſortez bien & beau Sans prendre le repos, ny manger vn morceau.	Cependant arrivé vous sortez bien et beau Sans prendre le repos, ni manger un morceau.
LELIE.	LELIE.
Ce grand empeſchemẽt n’eſt point digne de blâme De l’hymen de Celie, on allarme mon ame;	Ce grand empêchement n'est point digne de blâme De l'hymen de Célie, on alarme mon âme;
Tu ſçais que ie l’adore, & ie veux eſtre inſtruit Auant tout autre ſoin de ce funeſte bruit.	Tu sais que personne l'adore, et et veux estre instruit Avant tout autre soin de ce funeste bruit.
GROSRENE'.	GROSRENE.
Ouy, mais vn bon repas vous ſeroit neceſſaire Pour s’aller eſclaireir, Monſieur, de cette affaire, Et voſtre cœur ſans doute en deuiendroit plus fort Pour pouuoir reſiſter aux attaques du ſort.	Oui, mais un bon repas vous serait nécessaire Pour s'aller éclaire, Monsieur, de cette affaire, Et votre cœur sans doute en deviendrait plus fort Pour pouvoir résister aux attaques du sort.
I’en iuge par moy-meſme, & la moindre diſgrace, Lors que ie ſuis à ieun, me faiſit, me terrace;	J'en juge par moi-même, et la moindre disgrâce, Lors que sans suis à jeun, me faisit, me terrace;
Mais quand i’ay bien mangé, mon ame eſt ferme à tout, Et les plus grands reuers n’en viendroient pas à bout.	Mais quand j'ai bien mangé, mon âme est ferme à tout, Et les plus grands revers n'en viendraient pas à bout.
croyez moy bourrez vous, & ſans teſerue aucune, Contre les coups que peut vous porter la fortune;	croyez moi bourrez -vous, et sans teserue aucune, Contre les coups que peut vous porter la fortune;
Et pour fermer chez vous l’entrée à la douleur, De vingt verres de vin entourez voſtre cœur.	Et pour fermer chez vous l'entrée à la douleur, De vingt verres de vin entourez votre cœur.
ADEIE.	ADEIE.
Ie ne ſçaurois manger.	Je ne saurais manger.
GROSRENE a part ce demy vers.	GROSRENE a part ce demi vers.
Si feray bien moy, ie meure, Voſtre diſner pourtant ſeroit preſt tout à l’heure.	Si ferai bien moi, ie meure, Votre dîner pourtant serait prêt tout à l'heure.
LELIE.	LELIE.
Tay toy, ie te l’ordonne.	Tais -toi, Seigneur te l'ordonne.
GROSRENE'.	GROSRENE.
Ah!	Ah!
quel ordre inhumain.	quel ordre inhumain.
LELIE.	LELIE.
Yay de l'inquietude, & non pas de la faim.	Yai de l'inquiétude, et non pas de la faim.
GROSRENE’.	GROSRENE.
Et moy i'ay de la faim & de l'inquietude, De vois qu’vn ſot amour fait tonte voſtre eſtude.	Et moi j'ai de la faim et de l'inquiétude, De vois qu'un sot amour fait tonte votre étude.
LELIE.	LELIE.
Laiſſe-moy m’informer de l'objet de mes vœux, Et ſans m’importuner va manger ſi tu veux,	Laisse-moi m'informer de l'objet de mes vœux, Et sans m'importuner va manger si tu veux,
GROSRENE.	GROSRENE.
Ie ne replique point à ce qu’vn maiſtre ordonne.	Je ne replique point à ce qu'autre maître ordonne.
DODEE REER LELIE ſeul.	DODEE RÉER LELIE seul.
E ne vous diray rien de cette Scene, Ipuis qu’elle ne contient que ces trois vers.	E ne vous dirai rien de cette Scène, Ipuis qu'elle ne contient que ces trois vers.
LELIE ſeul.	LELIE seul.
On, non, à trop de peur mon amc s'abandonne, IN Le pere m’a promis, & la fille a fait voir Des preuues d’vn amour qui ſouſtient mon eſpoir	On, non, à trop de peur mon amc s'abandonne, IN Le père m'a promis, et la fille a fait voir Des preuves d'un amour qui soutient mon espoir
SCENE IX.	SCÈNE IX.
SGANARELLE, LELIE.	SGANARELLE, LELIE.
Sganarelle ayant atraché à ſa femme le portrait qu’elle luy venoit de reprendre, vient pour le conſiderer à loiſir, lors que Lelie voyant que cette boëte reſſembloit fort à celle où eſtoit le portrait qu’il auoit donné à ſa Maiſtreſſe, s’approche de luy pour le regarder par deſſus ſon eſpaule:	Séganarelle ayant atraché à sa femme le portrait qu'elle a venoit de reprendre, vient pour le considérer à loisir, lors que Lelie voyant que cette boète ressemblait fort à celle où était le portrait qu'il avait donné à sa Maîtresse, s'approche de parler pour le regarder par -dessus son épaule:
tellement que Sganarelle voyant qu’il n’a pas le loiſir de conſiderer ce portrait comme il le voudroit bien, & que de quelque coſté qu’il ſe puiſſe tourner, il eſt obſedé par Lelie:	tellement que Séganarelle voyant qu'il n'a pas le loisir de considérer ce portrait comme il le voudrait bien, et que de quelque côté qu'il se puisse tourner, il est obsédé par Lélie:
Et Lelie enfin de ſon coſté ne doutant plus que ce ne ſoit ſon portrait, & impatient de ſçauoir de qui Sganarelle peut l’auoir eu, s’enqueſte de luy comment il eſt tombé entre ſes mains.	Et Lélie enfin de son côté ne doutant plus que ce ne soit son portrait, et impatient de savoir de qui Séganarelle peut l'avoir eu, s'enquête de M comment il est tombé entre ses mains.
Ce deſir eſtonne Sganarelle;	Ce désir étonne Séganarelle;
mais ſa ſurpriſe ceſſe bien toſt, lors qu’apres auoir bien examiné ce portrait, il reconnoît que c’eſt celuy de Lelie.	mais sa surprise cesse bien tôt, lors qu'après avoir bien examiné ce portrait, il reconnaît que c'est celui de Lelie.
Il luy dit qu’il ſçait bien le ſoucy qui le tient, qu’il connoît bien que c’eſt ſon portrait, & le prie de ceſſer vn amour qu’vn mary peut trouuer fort mauueio.	Il était dit qu'il sait bien le souci qui le tient, qu'il connaît bien que c'est son portrait, et le prie de cesser un amour qu'un mari peut trouver fort mauverio.
Lene miy demande s’il eſt mary de celle qui conſeruoit ce gage.	Lene mi demande s'il est mari de celle qui conservait ce gage.
Sganarelle luy dit qu’oüy, & qu’il en eſt mary tres-marry, qu’il en ſçait bien la cauſe, & qu’il va ſur l’heure, l’apprendre aux parens de ſa femme, & moy cepẽdant ie m’en vais vous apprendre les vers de cette Scene.	Sganarelle avait dit qu'il, et qu'il en est mari très-marri, qu'il en sait bien la cause, et qu'il va sur l'heure, l'apprendre aux parents de sa femme, et moi cependant avoir m'en vais vous apprendre les vers de cette Scène.
Il faut que vous preniez garde qu’vn agreable mal-entendu eſt ce qui fait la beauté de cette Scene, & que ſubſiſtant pendant le reſte de la Piece entre les quatre principaux Acteurs, qui ſont Sganarelle, ſa Femme, Lelie, & ſa Maiſtreſſe, qui ne s’entendent pas, il diuertit merueilleuſement l’Auditeur, ſans fatiguer ſon eſprit, tant il naît naturellement, & tant ſa conduite eſt admirable dans cette Piece.	Il faut que vous preniez garde qu'un agréable mal-entendu est ce qui fait la beauté de cette Scène, et que subsistant pendant le reste de la Pièce entre les quatre principaux Acteurs, qui sont Séganarelle, sa Femme, Lélie, et sa Maîtresse, qui ne s'entendent pas, il divertit merveilleusement l'Auditeur, sans fatiguer son esprit, tant il nat naturellement, et tant sa conduite est admirable dans cette Pièce.
SGANARELLE.	SGANARELLE.
M Ous l'auons, & ie puis voir à l’aiſe la trogne N Du malheureux pendart qui cauſe ma vergogne.	M Ous l'avons, et ainsi puis voir à l'aise la trogne N Du malheureux pendard qui cause ma vergogne.
l ne m’eſt point connu.	l ne m'est point connu.
40 2 LELIE à part.	40 2 LELIE à part.
Dieux!	Dieux!
qu’aperçois-ie icy, Et ſi c’eſt mon portrait, que dois-ie croire auſſi.	qu'aperçois-je ici, Et si c'est mon portrait, que dois-je croire aussi.
SGANARELLE continuë.	SGANARELLE continue.
Ah!	Ah!
pauure Sganarelle, à quelle deſtinée Ta reputation eſt-elle condamnée?	pauvre Sganarelle, à quelle destinée Ta réputation est-elle condamnée?
Aperceuant Lelie qui le regarde, il ſe tourne d'vn  autre costé.	Apercevant Lélie qui le regarde, il se tourne d'un autre côté.
Faut.	Faut.
LELIE à part.	LELIE à part.
de gage ne peut laus aſtarmer ma foy, Eſtre ſorty des mains qui le tenoit de moy.	de gage ne peut laus astarmer ma foi, Être sorti des mains qui le tenait de moi.
SGANARELLE.	SGANARELLE.
Faut-il que deſor mais à deux doigts l’on me mõtre, Qu’on te mette en chanſons, & qu’en toute rencontre, On te tejette au nez le ſcandaleux affront Qu'vne remmie mai net imprime lut ton front.	Faut-il que désor mais à deux doigts l'on me montre, Qu'on te mette en chansons, et qu'en toute rencontre, On te tejette au nez le scandaleux affront Qu'une remie mai net imprime lut ton front.
LELIE à part.	LELIE à part.
Me trompay-je?	Me trompé-je?
SGANARELLE.	SGANARELLE.
Ah!	Ah!
truande, as-tu bien le coutage De m’auoir fait cocu dans la fleur de mon âge?	truande, as-tu bien le coutage De m'avoir fait cocu dans la fleur de mon âge?
Et femme d’vn mary qui peut paſſer pour beau, Faut-il qu’vil Marhiouret, vn inauuit Eitburneau.	Et femme d'une mari qui peut passer pour beau, Faut-il qu'une Marhouret, un inavuit Eitburneau.
LELIE à part.	LELIE à part.
& regardant encore ſonportrait.	et regardant encore sonportrait.
Ie, ne m’abuſe point, c’eſt mon portrait luy meſme.	Je, ne m'abuse point, c'est mon portrait luiprendre.
SGANARELLE luy retourne le dos.	SGANARELLE était retourne le dos.
Cet homme eſt curieux.	Cet homme est curieux.
6462 LELIE à part.	6462 LELIE à part.
Ma ſurpriſe eſt extrême,	Ma surprise est extrême,
SGANARELLE.	SGANARELLE.
A qui donc en a-t’il.	À qui donc en a-t-il.
Ml gi LELIE a part.	Ml gy LELIE a part.
haut, Ie le veux acoſter.	haut, Je le veux acoster.
Iuis lealamne deglace, va mou	Juis lealamne deglace, va mou
SGANARELLE le fuit encore, Que me veut-il conter?	SGANARELLE le fuit encore, Que me veut-il conter?
LELIE.	LELIE.
Puis-ie obtenir de vous, de ſçauoir l’auanture, Qui fait dedans vos mains trouuer cette peinture?	Puis-je obtenir de vous, de savoir l'aventure, Qui fait dedans vos mains trouver cette peinture?
SGANARELLE à part, & examinant  le portrait qu’il tient & Lelie.	SGANARELLE à part, et examinant le portrait qu'il tient et Lelie.
D'où luy vient ce deitt imais te m'auiſe icy.	D'où lui vient ce déitt imais te m'avise ici.
Ah!	Ah!
ma foy me voila de ſon trouble eſclaircy, Sa ſurpriſe à preſent n’eſtonne plus mon ame, e die mon homme, ou pluſtoſt c’eſt celuy de ma femme.	ma foi me voilà de son trouble éclairci, Sa surprise à présent n'étonne plus mon âme, est die mon homme, ou plutôt c'est celui de ma femme.
2SSTe.	2STe.
Retirez moy de peine, & dites d’où vous vient.	Retirez -moi de peine, et dites d'où vous vient.
SGANARELLE.	SGANARELLE.
Nous ſçauons Dieu mercy le ſoucy qui vous tient, Ce portrait qui vous fâche eſt voſtre reſſemblance, Il eſtoit en des mains de voſtre connoiſſance, Et ce n’eſt pas vn fait qui ſoit ſecret pour nous Que les douces ardeurs de la Dame & de vous :	Nous sçauons Dieu merci le souci qui vous tient, Ce portrait qui vous fâche est toujours ressemblance, Il était en des mains de votre connaissance, Et ce n'est pas un fait qui soit secret pour nous Que les douces ardeurs de la Dame et de vous :
Ie ne ſçay pas ſi i’ay dans ſa galanterie L’honneur d’eſtte connu de voſtre Seigneurie;	Je ne sais pas si j'ai dans sa galanterie L'honneur d'estte connu de votre Seigneurie;
Mais faités-moy celuy de ceiſer deſormais Vn amour qu’vn mary peut trouuer fort mauuais, Et ſongez que les nœuds du ſacré mariage.	Mais faitez-moi celui de ceiser désormais Un amour qu' il peut trouver fort mauvais, Et songez que les nœuds du sacré mariage.
Davane Quoy, celle, dites-vous, dont vous tenez ce gage.	Davane Quoi, celle, dites-vous, dont vous tenez ce gage.
SGANARELLE Eſt ma femme, & ie ſuis ſon mary.	SGANARELLE Est ma femme, et beau suis son mari.
LELIE.	LELIE.
Son mary.	Son mari.
SGANARELLE.	SGANARELLE.
Ouy, ſon mary vous dis-je, & mary tres-marry, Vous en ſçauez la cauſe, & ie m’en vay l’apprẽdre, Sur l’heurt à les parens.	Oui, son mari vous dis-je, et mari très-marri, Vous en savez la cause, et quelque m'en vais l'apprendre, Sur l'heurt à les parents.
SCENE X.	SCÈNE X.
LELIE ſeule.	LELIE seule.
Elie ſe plaint dans cette Scene de Ll’infidelité de ſa Maiſtreſſe, & de l’outrage qu’elle luy fait, ne l’abattant pas moins que les longs trauaux de ſon voyage, le fait tomber en foibleſſe.	Élie se plaint dans cette Scène de Ll'infidélité de sa Maîtresse, et de l'outrage qu'elle avait fait, ne l'abattant pas moins que les longs travaux de son voyage, le fait tomber en faiblesse.
Pluſieurs ont aſſez ridiculement repris cette Scene, ſans auoir pour iuſtifier leur impertinence) autre choſe à dire, ſinon que l’infidelité d’vne Maiſtreſſe n’eſtoit pas capable de faire éuanouir vn homme.	Plusieurs ont assez ridiculement repris cette Scène, sans avoir pour justifier leur impertinence) autre chose à dire, sinon que l'infidélité d'une Maîtresse n'était pas capable de faire évanouir un homme.
D’autres ont dit encor, que cet éuanouiſſement eſtoit mal placé, & que l’on voyoit bien que l’Autheur ne s’en eſtoit ſeruy que pour faire naiſtre l’incident qui paroît en ſuite.	D'autres ont dit encor, que cet évanouissement était mal placé, et que l'on voyait bien que l'Auteur ne s'en était servi que pour faire naître l'incident qui paraît en suite.
Mais ie reſpondray en deux mots aux vns & aux autres;	Mais ici répondrai en deux mots aux uns et aux autres;
Et ie dis d’abord aux premiers, qu’ils n’ont pas bien cohſideré, que l’Autheur auoit preparé cet incident long-temps deuant, & que l’infidelité de la Maiſtreſſe de Lelie, n’eſt pas ſeule la cauſe de ſon éuanouiſſement, qu’il en a encor deux puiſſantes raiſons, dont l’vne eſt les longs & penibles trauaux d’vn voyage de huit iours, qu’il auoit fait en poſte, & l’autre qu’il n’auoit point mangé depuis ſon arriuée, comme l’Autheur l’a découuert cy-deuant aux Auditeurs, en faiſant que Groſrené le preſſe d’aller mãger vn morceau, afin de pouuoir reſiſter aux atraques du ſort, & c’eſt pour cela que ie vous ay prié de remarquer la Scene qu’ils font enſemble, tellement qu’il n’eſt pas impoſſible qu’vn homme qui arriue d’vn long voyage, qui n’a point mangé depuis ſon arriuée, & qui apprend l’infidelité d’vne Maiſtreſſe, s’éuanouiſſe.	Et petit dis d'abord aux premiers, qu'ils n'ont pas bien cohsideré, que l'Auteur avait préparé cet incident longtemps devant, et que l'infidélité de la Maîtresse de Lélie, n'est pas seule la cause de son évanouissement, qu'il en a encor deux puissantes raisons, dont l'une est les longs et pénibles travaux d'un voyage de huit jours, qu'il avait fait en poste, et l'autre qu'il n'avait point mangé depuis son arrivée, comme l'Auteur l'a découvert cy-devant aux Auditeurs, en faisant que Gros le presse aller m morceau, afin de pouuoir résister aux atraques du sort, et est pour cela que ie vous ay prié de remarquer la Scene ils font ensemble, et il est pas impossible homme qui arriue long voyage, qui a point mangé depuis son arriuée, et qui apprend infidelité Maistresse, éuanouisse.
Voila ce que i’ay d'dire aux premiers cenſeurs de cet ineldent miraculeux.	Voilà ce que j'ai d'dire aux premiers censeurs de cet ineldent miraculeux.
Pour ce qui regarde les ſeconds, quoy qu’ils paroiſſent le reprendre auec plus de iuſtice, ie les confondray encor plûtoſt, & pour commencer à leur faire voir leur ignorance, ie veux leur accorder que l’Autheur n’a fait éuanouïr Lelie, que pour doner lieu à l’incident qui ſuit;	Pour ce qui regarde les seconds, quoi qu'ils paraissent le reprendre avec plus de justice, que les confondrai encor plutôt, et pour commencer à leur faire voir leur ignorance, tu veux leur accorder que l'Auteur n'a fait éuanouïr Lelie, que pour doner lieu à l'incident qui suit;
mais ne doiuent-ils pas ſçauoir que quand vn Autheur a vn bel incident à inſerer dans vne Piece, s’il trouue des moyens vrays ſemblables pour le faire naiſtre, il en doit d’autant eſtre plus eſtimé, que la choſe eſt beaucoup difficile, & qu’au contraire, s’il ne le fait paroiſtre que par des moyẽs erronez & tirez par la queuë, il doit paſſer pour vn ignorant, puiſque c’eſt vne des qualitez la plus neceſſaire à vn Autheur, que de ſçauoir inuenter auec vraye ſemblance;	mais ne doivent-ils pas savoir que quand un Auteur a un bel incident à insérer dans une Pièce, s'il trouve des moyens vrais semblables pour le faire naître, il en doit d'autant être plus estimé, que la chose est beaucoup difficile, et qu'au contraire, s'il ne le fait paraître que par des moyens erroné et tirez par la queue, il doit passer pour un ignorant, puisque c'est une des qualités la plus nécessaire à un Auteur, que de sçauoir inventer auec vraie semblance;
c’eſt pourquoy puis qu’il y a tant de poſſibilité & de vraye ſemblance dans l’éuanouiïſſement de Lelie, que l’on pourroit dire qu’il eſtoit abſolument neceſſaire qu’il s’éuanouït, puis qu’il auroit paru peu amoureux, ſi eſtant arriué à Paris, il s’eſtoit allé amuſer à manger, au lieu d’aller trouuer ſa Maiſtreſſe:	c'est pourquoi puis qu'il y a tant de possibilité et de vraie semblance dans l'éuanouiïssement de Lelie, que l'on pourrait dire qu'il était absolument nécessaire qu'il s'évanouit, puis qu'il aurait paru peu amoureux, si étant arrivé à Paris, il s'était allé amuser à manger, au lieu d'aller trouver sa Maîtresse:
Ils condamnent des choſes qu’ils deuroient eſtimer, puiſque la conduite de cet incident auec toutes les preparations neceſſaires, fait voir que l’Auteur penſe meurement à ce qu’il fait, & que rien ne ſe peut égaler à la ſolidité de ſon eſprit.	Ils condamnent des choses qu'ils devraient estimer, puisque la conduite de cet incident avec toutes les préparations nécessaires, fait voir que l'Auteur pense meurement à ce qu'il fait, et que rien ne se peut égaler à la solidité de son esprit.
Voila quelle eſt ma penſée là deſſus, & pour vous montrer que les raiſons que i’ay apportées ſont vrayes, vous n’auez qu’à lire ces vers.	Voilà quelle est ma pensée là -dessus, et pour vous montrer que les raisons que j'ai apportées sont vraies, vous n'avez qu'à lire ces vers.
LELIE	LELIE
LELIE ſeul.	LELIE seul.
AHt que viens-ie d'entendte, L'on me l'auoit bien dit, & que c’eſtoit de tous L’homme le plus mal-fait qu’elle auoit pour époux.	AHt que viens-je d'entendte, L'on me l'avait bien dit, et que c'était de tous L'homme le plus malhait qu'elle avait pour époux.
Ah!	Ah!
quand mille ſermens de ta bouche inſidele Ne m’auroient pas promis vne flame eternelle, Le ſeul mépris d’vn choix ſi bas & ſi honteux Deuoit bien ſoûtenir l’intereſt de mes feux Ingrate, & quelque bien.	quand mille serments de ta bouche insidele Ne m'auraient pas promis une flamme éternelle, Le seul mépris d'un choix si bas et si honteux Deuait bien soutenir l'intérêt de mes feux Ingrate, et quelque bien.
mais ce ſenſible outrage Se meſlant aux trauers d’vn aſſez long voyage, Me donne tout à coup vn choc ſi violent, de mon ceut ueulent loible, & mon corps chaucelant.	mais ce sensible outrage Se mêlant aux travers d'un assez long voyage, Me donne tout à coup un choc si violent, de mon ceut veulent loisible, et mon corps chaucelant.
SCENE XI.	SCÈNE XI.
LELIE, L’A FEMME DE SGANARELLE.	LELIE, L'A FEMME DE SGANARELLE.
JOyons ſi quelqu’vn n’aura point V de pitié de ce pauure Amant qui tombe en foibleſſe.	JOyons si quelqu'une n'aura point V de pitié de ce pauvre Amant qui tombe en faiblesse.
La femme de Sganarelle en colere contre ſon mary, de ce qu’il luy auoit emporté le bijou qu’elle auoit trouué, ſort de chez elle, & voyant Lelie qui commençoit à s’éuanouïr, le fait entrer dans ſa ſale, en attendant que ſon mal ſe paſſe.	La femme de Séganarelle en colère contre son mari, de ce qu'il lui avait emporté le bijou qu'elle avait trouvé, sort de chez elle, et voyant Lelie qui commençait à s'évanouir, le fait entrer dans sa le, en attendant que son mal se passe.
Iugez apres les tranſports de la jalouſie de Sganarelle, de l’effet que cet incident doit produire, & s’il fut iamais rien de mieux imaginé.	Jugez après les transports de la jalousie de Séganarelle, de l'effet que cet incident doit produire, et s'il fut jamais rien de mieux imaginé.
Vous pourrez lire les vers de cette Scene;	Vous pourrez lire les vers de cette Scène;
cependant que j’iray voir ſi Sganarelle a trouué quelqu’vn des parens de ſa femme.	cependant que j'irai voir si Séganarelle a trouvé quelqu'un des parents de sa femme.
0 LA FEMME de Scanarelle ſe tournant a 1 vers Lelie.	0 LA FEMME de Scanarelle se tournant à 1 vers Lelie.
Algré moy mon perfide.	Algré moi mon perfide.
helas!	hélas!
quel mal vous 44 tneeurpamam Ie vous vois preſt, Monſieur, à tomber en foibleſſe?	quel mal vous 44 tneeurpamam Je vous vois prêt, Monsieur, à tomber en faiblesse?
LELIE.	LELIE.
C’eſt vn mal qui m’a pris aſſez ſubitement.	C'est un mal qui m'a pris assez subitement.
LA FEMME de Sganarelle.	LA FEMME de Séganarelle.
Ie crains icy pour vous l’éuanouïſſement Entrez dans cette ſale en attendant qu’il paſſe.	Je crains ici pour vous l'éuanouïssement Entrez dans cette sale en attendant qu'il passe.
LELIE.	LELIE.
SH1Q Pour vn moment ou deux, i’accepte cette grace.	SH1Q Pour un moment ou deux, j'accepte cette grâce.
ui lain L faudroit auoir le pinceau de IPouſſin, le Brun, & Mignard, pour	Oui lain L audrait avoir le pinceau de IPoussin, le Brun, et Mignard, pour
14 SCENE XII.	14 SCÈNE XII.
21 anuoran iinensliioame SGANARELLE, ET LE PARENT 42 1 DE SA FEMME.	21 anuoran iinensliioame SGANARELE, ET LE PARENT 42 1 DE SA FEMME.
vous repreſenter auec quelle poſture Sganarelle ſe fait admirer dans cette Scene, où il paroît auec vn parent de ſa femme.	vous représenter avec quelle posture Séganarelle se fait admirer dans cette Scène, où il paraît toujours un parent de sa femme.
L’on n’a iamais ven tenir de diſcours ſi naïfs, ny paroiſtre auec vn viſage ſi niais, & l’on ne doit pas moins admirer l’Autheur, pour auoir fait cette Piece, que pour la maniere dont il la repreſente.	L'on n'a jamais ven tenir de discours si naïfs, ni paraître avec un visage si niais, et l'on ne doit pas moins admirer l'Auteur, pour avoir fait cette Pièce, que pour la manière dont il la représente.
Iamais perſonné ne ſçeut ſi bien démontrer ſon viſage, & l’on peut dire D que dedans cette Piece, il en change plus de vingt fois;	Jamais personné ne sut si bien démontrer son visage, et l'on peut dire D que dedans cette Pièce, il en change plus de vingt fois;
mais comme c’oſt vn diuertiſſement que vous ne pouuez auoir à moins que de venir à Pa14 ris, voir repreſenter cet incõparabie Ouurage, ie ne vous en diray pas dauantage, pour paſſer aux choſes dont ie puis plus aiſément vous faire part.	mais comme c'ost un divertissement que vous ne pouvez avoir à moins que de venir à Pa14 ris, voir représenter cet incõparabie Ouvrage, je ne vous en dirai pas davantage, pour passer aux choses dont je puis plus aisément vous faire part.
Ce bon Vieillard remontre à Sganarelle, que le trop de promptitude expoſe ſouuẽt à l’erreur;	Ce bon Vieillard remontre à Séanarelle, que le trop de promptitude expose souvent à l'erreur;
que tout ce qui regarde l’honneur eſt delicat:	que tout ce qui regarde l'honneur est délicat:
En ſuite il luy dit qu’il s’informe mieux comment ce portrait eſt tombé entre les mains de ſa fême, & que s’il ſe trouue qu’elle ſoit criminelle, il ſera le prem ier à punir ſon offenſe.	En suite il avait dit qu'il s'informe mieux comment ce portrait est tombé entre les mains de sa fême, et que s'il se trouve qu'elle soit criminelle, il sera le je r à punir son offense.
Il ſe retire apres cela.	Il se retire après cela.
Comme ie n’ay pû dans cette Scene vous enuoyer le portrait du viſage de Sganarelle, en voicy les Vers.	Comme notre n'ai pu dans cette Scène vous envoyer le portrait du visage de Séganarelle, en voici les Vers.
i de lanadibe	y de lanadibe
LE PARENT.	LE PARENT.
Vn mary ſur ce point i’approuue le ſoucy;	Un mari sur ce point j'approuve le souci;
DMais c’eſt prendre la chevre vn peu bien viſte auſſi, 0 Et tout ce que de vous ie viens d’ouïr contr’elle, Ne conclut point, parent, qu’elle ſoit criminelle:	DMais c'est prendre la chèvre un peu bien vite aussi, 0 Et tout ce que de vous ie viens ouïr contr’elle, Ne conclut point, parent, elle soit criminelle:
C’eſt vn point delicât, & de pareils forfaits, Sans les bien auerer ne s’imputent lamais.	C'est un point delicât, et de pareils forfaits, Sans les bien avérer ne s'imputent lamais.
SGANARELLE.	SGANARELLE.
C’eſt à dire qu’il fout toucher au doigt la choſe.	C'est -à -dire qu'il fout toucher au doigt la chose.
LE PARENT.	LE PARENT.
Le trop de promptitude à l’erreur nous expoſe.	Le trop de promptitude à l'erreur nous expose.
Qui ſçait comme en ſes mains ce portrait eſt venu, Et il Tilomme apres tout luy peut entre connu?	Qui sçait comme en ses mains ce portrait est venu, Et il Tilomme après tout notre peut entre connu?
Informez vous-en donc, & ſi c’eſt ce qu’on penſe, Nous ierons les premners à pumt ioh offenſe.	Informez -vous-en donc, et si c'est ce qu'on pense, Nous jerons les premers à pumt ioh offense.
SCENE XIII.	SCÈNE XIII.
2  101 SGANARELLE ſeul.	2 101 SGANARELLE seul.
ſe perſuader qu’il s’eſt trop toſt mis dans la teſte des viſions cornuës, lors que Lelie ſortant de chez luy, auec ſa femme qui le conduit, le fait de nouueau r’entrer en jalouſie.	se persuader qu'il s'est trop tôt mis dans la tête des visions cornues, lors que Lelie sortant de chez lui, avec sa femme qui le conduit, le fait de nouveau rentrer en jalousie.
Les Vers qu’il dit dans cette Scene, vous feront mieux voir ſon caractere, que ie ne vous l’ay dépeint.	Les Vers qu'il dit dans cette Scène, vous feront mieux voir son caractère, que je ne vous l'ai dépeint.
SGANARELLE.	SGANARELLE.
60 On ne peut pas mieux dire, en effect, il eſt bon D’aller tout doucement.	60 On ne peut pas mieux dire, en effet, il est bon D'aller tout doucement.
Peut-eſtre ſans raiſon, Me ſuis-ie en teſte mis ces viſions cornuës, Et les ſueurs au front m’en ſont trop toſt venuës.	Peut-être sans raison, Me suis-je en tête mis ces visions cornues, Et les sueurs au front m'en sont trop tôt venues.
Par ce portrait enfin, dont ie ſuis allarmé, Mon des-honneur n’eſt pas tout à fait confirmé, Taſchons donc par nos ſoins.	Par ce portrait enfin, dont votre suis alarmé, Mon des-honneur n'est pas tout à fait confirmé, Tâchons donc par nos soins.
SCENE IV.	SCÈNE IV.
SGANARELLE, SAFEMME, LELIE ſur la porte de Sganarelle, en parlant à ſa Femmne.	SGANARELLE, SAFEMME, LELIE sur la porte de Séganarelle, en parlant à sa Femmne.
IE ne vous dis rien de cette Scene, & Tie vous laiſſe iuger par ces Vers de la ſurpriſe de Sganarelle.	JE ne vous dis rien de cette Scène, et Tie vous laisse juger par ces Vers de la surprise de Séanarelle.
SGANARELLE pourſuit.	SGANARELLE poursuit.
auallmilin im As  444 AH!	avallmilin im As 444 AH!
que vois-ie, ie meure.	que vois-je, Seigneur meure.
Il n’eſt plus queſtion de porttar a ceut leure, Voicy ma foy la chote en propre original,	Il n'est plus question de portar a ceut lèvre, Voici ma foi la chote en propre original,
LA FEMME de Sganarelle à Lelie.	LA FEMME de Séganarelle à Lélie.
Cen par trop vous haſter, Monſieur.	Cen par trop vous hâter, Monsieur.
& voſtre mal, Si vous ſortez ſi toſt, pourra bien vous reprendre.	et votre mal, Si vous sortez si tôt, pourra bien vous reprendre.
LELIE.	LELIE.
Non, non, ie vous rends grace, autant qu’on puiſſe rendre, 2 De l’obligeant ſecours que vous m’auez preſté.	Non, non, je vous rends grâce, autant qu'on puisse rendre, 2 De l'obligeant secours que vous m'avez prêté.
SGANARELLE à part.	SGANARELLE à part.
La maſque encore apres luy fait ciuilité.	La masque encore après avoir fait civilité.
SGANARELLE, L’ELIE.	SGANARELLE, L'ELIE.
32n aupolunol 5b 29q d v JIET J Elie donne, ſans y penſer, le chanLge à Sganarelle dans cette Scene, & ne le ſurprend pas moins que l’autre a tantoſt fait, en luy diſant qu’il tenoit ſon portrait des mains de ſa femme.	32n aupolunol 5b 29q d v IET Ilie donne, sans y penser, le chanLge à Séganarelle dans cette Scène, et ne le surprend pas moins que l'autre a tantôt fait, en lui disant qu'il tenait son portrait des mains de sa femme.
Pour mieux iuger de la ſutpriſe de Sganarelle, vous pouuez lire ces Vers, dont le dernier eſt placé ſi à propos, que iamais Piece n’a fait tant d’éclat que ce Vers ſeul.	Pour mieux juger de la sutprise de Séganarelle, vous pouvez lire ces Vers, dont le dernier est placé si à propos, que jamais Pièce n'a fait tant d'éclat que ce Vers seul.
SGANARELLE à part.	SGANARELLE à part.
IL m’apperçoit, voyons ce qu’il me pourla une.	IL m'aperçoit, voyons ce qu'il me pourla une.
à part.	à part.
LELIE.	LELIE.
Ah!	Ah!
mon ame s’émeut & cet objet m’inſpire.	mon âme s'émut et cet objet m'inspire.
Mais ie dois condamner çet injuſte tranſport, Et n’imputer mes maux qu’aux rigueurs de mon tolt.	Mais ici dois condamner çet injuste transport, Et n'imputer mes maux qu'aux rigueurs de mon tolt.
Elvrons ieulement le bon-heur de la flame.	Elvrons jeulement le bonheur de la flamme.
Paſſant aupres de luy & le regardant.	Passant auprès de jours et le regardant.
mhadop metrena d aton vnt n'gent femnac.	mhadop mettrena d on vnt n'gent femnac.
SCENE XVI.	SCÈNE XVI.
milln illi vilio No dimlam  SCANAAELLE, CELIE,  regardant aller Lelie.	milln illy vilio No dimlam SCANAAELLE, CELIE, regardant aller Lélie.
’On peut dire que cette Scene en L contient deux, puiſque Sganarelle fait vne eſpece de Monoloque, pendant que Celie, qui auoit veu ſortir ſon Amant d’auec luy, le conduit des yeux, iuſqu’à ce qu’elle l’ait perdu de veuë, pour voir ſi elle ne s’eſt point trompée.	On peut dire que cette Scène en L contient deux, puisque Séganarelle fait une espèce de Monoloque, pendant que Célie, qui avait vu sortir son Amant d'avec lui, le conduit des yeux, jusqu'à ce qu'elle l'ait perdu de veuë, pour voir si elle ne s'est point trompée.
Sganarelle de ſon coſté regarde auſſi en aller Lelie, & fait voir le dépit qu’il a de ne luy auoir pas fait inſulte, apres l’aſſeurance qu’il croit auoir d’eſtre Cocu de luy.	Socanarelle de son côté regarde aussi en aller Lélie, et fait voir le dépit qu'il a de ne lui avoir pas fait insulte, après l'assurance qu'il croit avoir d'être Cocu de même.
Celie luy ayant laiſſé ietter la plus grande partie de ſon feu, c’enapproene pour laj demander ſi celuy qui luy vient de parler ne luy eſt pas connu;	Celie était ayant laissé jeter la plus grande partie de son feu, c'enapproène pour laj demander si celui qui lui vient de parler ne lui est pas connu;
mais il luy répond auec ſa naiueté ordinaire, que c’eſt ſa femme qui le connoît;	mais il était répond avec sa naiveté ordinaire, que c'est sa femme qui le connaît;
& découure peu à peu, mais d’vne maniere tout à fait agreable, que Lelie le deshonore.	et découvre peu à peu, mais d'une manière tout à fait agréable, que Lelie le déshonore.
C’eſt icy que l’equiuoque diuertit merueilleuſemẽt l’Auditeur, puiſque Celie deteſtant la perfidie de ſon Amant, iettant feu & flames contre luy, & ſortant à deſſein de s’en vãger, Sganarelle croit qu’elle prend ſa defenſe, & qu’elle ne court à deſſein de le punir que pour l’amour de luy.	C'est ici que l'équiuoque divertit merueilleusemẽt l'Auditeur, puisque Celie détestant la perfidie de son Amant, jetant feu et flammes contre lui, et sortant à dessein de s'en venger, Séganarelle croit qu'elle prend sa défense, et qu'elle ne court à dessein de le punir que pour l'amour de sa.
Comme les Vers de certe Scene donnent à l’Auditeur vn plaiſir extraordinaire, il ne ſeroit pas iuſte de vous priuer de ce contentement:	Comme les Vers de certe Scène donnent à l'Auditeur un plaisir extraordinaire, il ne serait pas juste de vous priver de ce contentement:
C’eſt pourquoy en iettant les yeux ſur ces lignes ſuiuantes, vous pourrez connoître que l’Auteur ſçait parfaitement bien conduire vn equiuoque.	C'est pourquoi en jetant les yeux sur ces lignes suivantes, vous pourrez connaître que l'Auteur Sait parfaitement bien conduire un équivoque.
SGANARELLE, ſans voir Celie.	SGANARELLE, sans voir Celie.
E n’eſt poirt s’expliquer en termes ambigus.	E n'est poirt s'expliquer en termes ambigus.
Ccet eſtrange propos me rend auſſi confus que s'il meſtoit vend des corſles a la terce.	Ccet étrange propos me rend aussi confus que s'il mestoit vend des cors à la terce.
Il ſe tourne du coſté que Lelie s'en vient d'en alley.	Il se tourne du côté que Lélie s'en vient d'en allei.
Allez, ce procedé n’eſt point da tout honneſte.	Allez, ce procédé n'est point da tout honnête.
CELIE à part.	CELIE à part.
Loir pui a paru tout à l’heure à mes yenz, Qui podrroit me cacher ſon retour en ces lieux.	Loir puy a paru tout à l'heure à mes yenz, Qui podrait me cacher son retour en ces lieux.
GANARELLE pourſuit.	GANARELLE poursuit.
O!	Ô!
trop heureux d’auoir vne ſi belle femme, Celie approcha peu à peu de luy, & attend que ſon tranſport ſoit finy pour luy parler.	trop heureux d'avoir une si belle femme, Celie approcha peu à peu de peine, et attend que son transport soit fini pour lui parler.
Malheureux, bien plutoſt, de l’auoir, cette infame Dont le coupable feu trop bien verifié, Sans reſpect ny demy nous a cocufié:	Malheureux, bien plutôt, de l'avoir, cette infâme Dont le coupable feu trop bien vérifié, Sans respect ny demi nous a cocufié:
Mais ie le laiſſe aller apres vn tel indice Et demeure les bras croiſez comme vn Iocrice.	Mais était le laisse aller après un tel indice Et demeure les bras croissez comme un Jocrice.
Ah!	Ah!
ie deuois du moins luy ietter ſon chapeau, Luy ruer quelque pierre, ou crotter ſon manteau, Et ſur luy hautement pour contenter ma rage, Tallt au larron a nomneui ener le romnage.	Les devais du moins nom jeter son chapeau, Lui ruer quelque pierre, ou crotter son manteau, Et sur notre hautement pour contenter ma rage, Tallt au larron a nomneui en le romnage.
CELIE.	CELIE.
Celuy qui mainten ant deuers vous eſt venu, Et qui vous a parlé, d’où vous eſt-il cohnu?	Celui qui mainten ant devers vous est venu, Et qui vous a parlé, d'où vous est-il cohnu?
SGANARELLE.	SGANARELLE.
Hleſapieemen pus mo, qua do pauaſt Madame, C’eſt ma femme.	Hlesapieemen pus mo, qua do pavât Madame, C'est ma femme.
O CELIE.	Ô CELIE.
I Quel trouble agite ainſi voſtre ame ?	I Quel trouble agite ainsi votre âme ?
SGANARELLE.	SGANARELLE.
Ne me condamnez point d’vn dueïl hors de ſaiſon, Et laiſſez moy pouſſer des ſoûpirs à foiſon.	Ne me condamnez point d'une dueil hors de saison, Et laissez moi pousser des soupirs à foison.
CELIE.	CELIE.
D'où vous peuuent venit ces douleuts non communes;	D'où vous peuvent venit ces douleuts non communes;
4	4
SGANARELLE.	SGANARELLE.
Si ie ſuis affligé, ce n’eſt pas pour des prunes, Et ie le donnetois à bien d’autre qu’à moy, De ſe voir ſans chagrin au point où ie me voy.	Si je suis affligé, ce n'est pas pour des prunes, Et tu le donnetais à bien d'autre qu'à moi, De se voir sans chagrin au point où personne me vois.
Des maris mal-heureux, vous voyez le modele, On dérobe l’honneur au pauure Sganarelle;	Des maris malheureux, vous voyez le modèle, On dérobe l'honneur au pauvre Séganarelle;
Mais c’eſt peu que l’honneur dans mon affliction, L’on me dérobe encor la reputation.	Mais c'est peu que l'honneur dans mon affliction, L'on me dérobe encor la réputation.
CELIE.	CELIE.
Comment ?	Comment ?
SGANARELLE.	SGANARELLE.
Ce Damoiſeau parlant par reuerence, Me fait cocu, Madame, auec tonte licence, ne ray iģeu par mes yeux auerer aujourd’huy Le commeree ſecret de ma femme & de luy.	Ce Damoiseau parlant par révérence, Me fait cocu, Madame, avec tonte licence, ne ray jeu par mes yeux au jourd'hui Le commerèse secret de ma femme et de lui.
Celuy qui maintenant.	Celui qui maintenant.
SGANARELLE.	SGANARELLE.
Ouy, ouy, me deshonore, Il adore ma femme, & ma femme l’adore.	Oui, oui, me déshonore, Il adore ma femme, et ma femme l'adore.
CLIE.	CLIE.
I1 2 Ah!	I1 2 Ah!
i'auois bien iugé que ce ſecret retour ise pouuoit me couurir que quelque lâche tour.	j'avais bien jugé que ce secret retour ize pouvait me couvrir que quelque lâche tour.
Et i’ay tremblé d’abord en le vovant patoître, Par vi preſſentiment de ce qui deuoit eſtre.	Et j'ai tremblé d'abord en le vouant patoître, Par vi pressentiment de ce qui devait être.
SGANARELLE.	SGANARELLE.
Vous prenez ma def enſe auec trop de bonté, 441 rout le monde na pas la meme cnarité, Et pluſieurs qui tantoſt ont appris mon martyre, Bien loin d’y prendre part, n’en ont rien fait que rire.	Vous prenez ma déf ense auec trop de bonté, 441 rout le monde na pas la meme carité, Et plusieurs qui tantôt ont appris mon martyre, Bien loin d'y prendre part, n'en ont rien fait que rire.
2	2
CELIE.	CELIE.
Eſt-il rien de prus nont que ta lache action, Et peut-on luy trouuer vne punition:	Est-il rien de prus nont que ta lâche action, Et peut-on lui semer une punition:
Aois-tu ne te pas croire indigne de la vie, Apres t’eſtre ſouillé de cette perfidie.	Aois-tu ne te pas croire indigne de la vie, Après t'être souillé de cette perfidie.
O Ciel l eſt-il poſſible?	Ô Ciel l 'il possible?
110	110
SGANARELLE.	SGANARELLE.
Il eſt trop vray pour moy.	Il est trop vrai pour moi.
CELIE.	CELIE.
Ah!	Ah!
traiſtre, ſcelerat, ame double & ſans foy,	traître, scélérat, âme double et sans foi,
La bonne ame.	La bonne âme.
SGANARELLE.	SGANARELLE.
CEETE.	CETE.
C Non non, l'Enfet n'a point de geſne, Qui ne ſoit pour ton erime vne trop douce peine,	Ç Non non, l'Enfet n'a point de gêne, Qui ne soit pour ton erime trop douce peine,
GANARELLE.	GANARELLE.
Que voila bien parler.	Que voilà bien parler.
CELIE.	CELIE.
Auoir ainſi traitté Et da meſme innocence, & la meſme bouté.	Avoir ainsi traité Et da même innocence, et la même bouté.
Hay !	Hais !
GANARELLE, ſoúpire haut.	GANARELLE, soùpire haut.
CELIE.	CELIE.
Vn cœur, qui iamais n'a rait la moindre choſe, A merité l’affront où ton meſpris l’expoſe.	Un cœur, qui jamais n'a rait la moindre chose, À mérité l'affront où ton mépris l'expose.
Il eſt vray.	Il est vrai.
SGANARELLE.	SGANARELLE.
Oel eur, Qui bien loin.	Oel eur, Qui bien loin.
mais c’eſt trop, & ce cœur.	mais c'est trop, et ce cœur.
Ne ſçauroit y ſonger ſans mourir de douleur.	Ne saurait y songer sans mourir de douleur.
SGANARELLE.	SGANARELLE.
Ne vous fâchez pas tant ma tres-chere Madame, Mon mal vous touche trop, & vous me percez l’ame.	Ne vous fâchez pas tant ma très-chère Madame, Mon mal vous touche trop, et vous me percez l'âme.
CELIE.	CELIE.
Mais ne t’abuſe pas iuſqu’à te figuret, 10 21 Qu’à des plaintes, ſans fruit, i’en vueille demeuret, Mon cœut pour le vanger içait ce qu’i te faut faire, uia Et i’y cours de ce pas, rien ne m’en peut diſtraire.	Mais ne t'abuse pas jusqu'à te figuret, 10 21 Qu'à des plaintes, sans fruit, j'en veuille demeuret, Mon cœut pour le venger içait ce qu'y te faut faire, uia Et j'y cours de ce pas, rien ne m'en peut distraire.
SCENE XVII.	SCÈNE XVII.
SGANARELLE ſeul.	SGANARELLE seul.
I j’auois tantoſt beſoin de ces exOcellens Peintres que ie vous ay nommez, pour vous dépeindre le viſage de Sganarelle;	I j'avais tantôt besoin de ces exOcellents Peintres que je vous a nommez, pour vous dépeindre le visage de Séganarelle;
jaurois maintenant beſoin & de leur pinceau & de la plume des plus excellens Orateurs, pour vous décrire cette Scene.	jaurais maintenant besoin et de leur pinceau et de la plume des plus excellents Orateurs, pour vous décrire cette Scène.
Iamais il ne ſe vit rien de plus beau, iamais rien de mieux joüé, & iamais Vers ne furent ſi generalement eſtimez.	Jamais il ne se vit rien de plus beau, jamais rien de mieux joué, et jamais Vers ne furent si généralement estimez.
Sganarelle jouë ſeul cette Scene, repaſſant dans ſon eſprit tout ce que l’on peut dire d’vn Cocu, & les raiſons pour leſquelles il ne s’en doit pas mettre en peine, s’en démeſle ſi bien, que ſon raiſonnement pourroit en vn beſoin conſoler ceux qui ſont de ce nombre.	Séganarelle joue seul cette Scène, repassant dans son esprit tout ce que l'on peut dire d'un Cocu, et les raisons pour lesquelles il ne s'en doit pas mettre en peine, s'en démêle si bien, que son raisonnement pourrait en un besoin consoler ceux qui sont de ce nombre.
Ie vous enuoye les Vers de cette Scene, afin que ſi vous connoiſſez quelqu’vn à voſtre pays, qui ſoit de la Confrairie dont Sganarelle ſe crolt ente, vous le pulez par la retirer de la melancolie où il pourroit s’eſtre plongé.	Je vous envoie les Vers de cette Scène, afin que si vous connaissez quelqu'un à votre pays, qui soit de la Confrairie dont Séganarelle se crolt ente, vous le pulez par la retirer de la mélancolie où il pourrait s'être plongé.
5 SGANARELLE ſeul.	5 SGANARELLE seul.
Ve le Ciel la preſerue à iamais de danger.	Ve le Ciel la préserve à jamais de danger.
OVoyez quelle bonté de vouloir me vanger;	OUoyez quelle bonté de vouloir me venger;
En effet, ſon courroux qu’excite ma diſgrace, M’enſeigne hautement ce qu’il faut que ie faſſe, Et l’on ne doit iamais ſouffrir ſans dire mot, De ſemblables affronts, à moins qu’eſtre vn vray ſot.	En effet, son courroux qu'excite ma disgrâce, M'enseigne hautement ce qu'il faut que sans fasse, Et l'on ne doit jamais souffrir sans dire mot, De semblables affronts, à moins qu'être un vrai sot.
Courons donc le chercher, cependant qu’il m’affronte, Monttons noſtre courage à vanger noſtre honte.	Courons donc le chercher, cependant qu'il m'affronte, Montons notre courage à venger notre honte.
V ous Vous apprendrez, maroufle, à rire à nos deſpens, Et ſans aucun reſpect faire cocu les gens.	V ous Vous apprendrez, maroufle, à rire à nos dépens, Et sans aucun respect faire cocu les gens.
Il ſe tourze ayant fait trois ou quatre pas.	Il se tourze ayant fait trois ou quatre pas.
Doucement, s’il vous plaiſt, cet homme a bien la mine, D'auoir le ſang bouïllant, & l’ame vn peu mutine, Il pourroit bien, mettant affront deſſus affront, Charger de bois mon dos, comme il a fait mos front.	Doucement, s'il vous plaît, cet homme a bien la mine, D'avoir le sang boullant, et l'âme un peu mutine, Il pourrait bien, mettant affront dessus affront, Charger de bois mon dos, comme il a fait mos front.
Ie hay de tout mon cœur les Eſprits coleriques.	Je hais de tout mon cœur les Esprits colériques.
Et porte grand amour aux hommes pacifiques e Ie ne ſuis point battant de peur d’eſtre battu, Et l’humeur dehonnaire eſt ma grande vertu.	Et porte grand amour aux hommes pacifiques e Ie ne suis point battant de peur d'être battu, Et l'humeur dehonnaire est ma grande vertu.
Mais mon honneur me dit que d’vne telle offenſe.	Mais mon honneur me dit que d'une telle offense.
Il faut abſolument que ie prenne vengeauce.	Il faut absolument que ici prenne vengeauce.
Ma foy, laiſſons-le dire, autant qu’il luy plaira, Au diantre qui pourtant rien du tout en fera:	Ma foi, laissons-le dire, autant qu'il lui plaira, Au diantre qui pourtant rien du tout en fera:
Quand i’auray fait le braue, & qu’vn fer pour mpeine, M’aura d’vn vilain coup tranſpercé la bedaine, Que par la ville ira le bruit de mon treſpas, Dites moy mon honneur, en ſerez vous plus gras:	Quand j'aurai fait le brave, et qu' Hum pour mépeine, M'aura d'un vilain coup transpercé la bedaine, Que par la ville ira le bruit de mon trépas, Dites -moi mon honneur, en serez -vous plus gras:
La Biere eſt vn ſejour par trop melancolique Et trop mal ſain pour ceux qui craignent la s lique, Et quant à moy ie trouue, ayafit tout compaſſés.	La Bière est un séjour par trop mélancolique Et trop mal sain pour ceux qui craignent la s lique, Et quant à mo ie grue, ayafit tout compassés.
Qu’il vaut mieux eſtre encor foèu que treſpaſſé.	Qu'il vaut mieux être encor soeur que trépassé.
Quel mal cela fait-il?	Quel mal cela fait-il?
la jambe en deuient-elle Plus tortuë apres tout, & la taille moins bellę.	la jambe en devient-elle Plus tortue après tout, et la taille moins bell.
Peſte ſoit qui premier trouua l’inuention De s’affliget l’eſprit de cette viſion3 TLI.	Peste soit qui premier trouva l'invention De s'affliget l'esprit de cette vision3 TLI.
13 - Et d’attacher l’honneur de l’hommé le plus ſagé.	13 - Est d'attacher l'honneur de l'hommé le plus sagé.
Aux choſes que peut faire vne femme volage;	Aux choses que peut faire une femme volage;
Puis qu’on tient à bon droit tout crime perſonnel.	Puis qu'on tient à bon droit tout crime personnel.
Que fait là noſtre honneur pour eſtre criminel?	Que fait là notre honneur pour être criminel?
Des actions d’autruy l’on nous donne le blâme, Si nos femmes ſans nous ont vn commerce infame, Il faut que tout le mal tombe ſur noſtre dos, Elles font la ſortiſe, & nous ſommes les ſots.	Des actions d'autrui l'on nous donne le blâme, Si nos femmes sans nous ont un commerce infâme, Il faut que tout le mal tombe sur notre dos, Elles font la sortise, et nous sommes les sots.
Ceſt vn vilain abus e les gent de polſee Nous deuroient bien regler vne telle injuſtice.	Cest un vilain abus e les gent de polsée Nous devraient bien régler une telle injustice.
N’auons nous pas aſſez des autres accidents, Qui nous viennent happer en dépit de nos dents, Les querelles, procez, faim, ſoif, & maladie, Troublent-ils pas aſſez le repos de la vie, Sans s’aller de ſurcroiſt auiſer ſottement, De ſe faire vn chagrin, qui n’a nul fondement?	N'avons nous pas assez des autres accidents, Qui nous viennent happer en dépit de nos dents, Les querelles, procès, fait, soif, et maladie, Troublent-ils pas assez le repos de la vie, Sans s'aller de surcroît aviser sottement, De se faire un chagrin, qui n'a nul fondement?
Mocquons-nous de cela, meſpriſons les allarmes, Et mettõs ſous nos pieds les ſoûpirs & les larmes, Si ma femme a failly, qu’elle pleure bien fort;	Moquons-nous de cela, méprisons les alarmes, Et metts sous nos pieds les soupirs et les larmes, Si ma femme a failly, qu'elle pleure bien fort;
Mais pourquoy moy pleurer puiſque ie n’ay point tort :	Mais pourquoi moi pleurer puisque ici n'ai point tort :
En tout cas ce qui peut m’oſter ma fâcherie, C’eſt que ie ne ſuis pas ſeul de ma Confrairie, Voir caioler ſa femme, & n’en teſmoigner rien, Se pratique aujourd’huy par force gens de bien :	En tout cas ce qui peut m'ôter ma fâcherie, C'est que je ne suis pas seul de ma Confrairie, Voir caioler sa femme, et n'en témoigner rien, Se pratique aujourd'hui par force gens de bien :
N’allons donc point chercher à faire vne querelle, Pour vn affront qui n’eſt que pure bagatelle.	N'allons donc point chercher à faire une querelle, Pour un affront qui n'est que pure bagatelle.
L’on m’appellera ſot de ne me vanger pas;	L'on m'appellera sot de ne me venger pas;
Mais ie le ſerois fort de courir au treſpas.	Mais ie le serais fort de courir au trépas.
Mettant la main ſur ſon estomach.	Mettant la main sur son estomac.
Ie me ſens là, pourtant remuer vne bille, Qui veut me conſeiller quelque action virille :	Je me sens là, pourtant remuer une bille, Qui veut me conseiller quelque action virille :
Ouy, le courroux me prend, c’eſt ttop eſtre poltſon, Ie veux reſolument me vauget du Latron :	Oui, le courroux me prend, c'est top être poltson, Je veux résolument me vauget du Latron :
Deſia pour commencet daus l’ardeur qui m'enflame, ſe.	Déjà pour commencet daus l'ardeur qui m'enflamme, se.
2A Ie vay dire par tout qu’il couche auec ma femme.	2A Je vais dire par tout qu'il couche avec ma femme.
Avoüez moy maintenant la verité, eſt-il pas vray, Monſieur, que vous 151 auez trouué ces Vers tout à fait beaux, que vous ne vous eſtes pũ em0 T peſcher de les relire encore vne fois, & que vous demeurez d’accord que Paris a eu raiſon de nommer cette Scene, la belle Seene.	Avoüez moi maintenant la vérité, est-il pas vrai, Monsieur, que vous 151 avez trouvé ces Vers tout à fait beaux, que vous ne vous êtes pes em0 T pescher de les relire encore une fois, et que vous demeurez d'accord que Paris a eu raison de nommer cette Scène, la belle Seène.
GORGIBVS, CELIE, LA SVIVANTE.	GORGIBUS, CÉLIE, LA SVIVANTE.
Elie n’ayant point trouué de Cmoyen plus propre pour punir ſon Amant, que d’eſpouſer Valere, dit à ſon pere, qu’elle eſt preſte de ſuiure en tout ſes volontez, dequoy le bon vieillard teſmoigne eſtre beaucoup ſatisfait, comme vous pouuez voir par ces Vers.	Élie n'ayant point trouvé de Cmoyen plus propre pour punir son Amant, que d'épouser Valère, dit à son père, qu'elle est prête de suivre en tout ses volontés, dequoy le bon vieillard témoigne être beaucoup satisfait, comme vous pouvez voir par ces Vers.
CELIE.	CELIE.
y, ie veux bien ſabir vne ſi iuſte Loy, O Mon pere, diſpoſez de mes vœux & de moy, Paſtes quald vous vouuter neni cente nymenée, A ſuiure mon deuoir je ſuis determinée, Ie pretends gourmander mes propes ſentimens, Et me ſoûmettre en tout à vos commandemens.	y, ie veux bien sabir ainsi si juste Lois, Ô Mon père, disposez de mes vœux et de moi, Pastes quald vous vouder neni cente nymenée, A suivre mon devoir je suis déterminée, Je prétends gourmander mes propes sentiments, Et me soumettre en tout à vos commandements.
GORGIBVS.	GORGIBUS.
Ah!	Ah!
voila qui me plaiſt de parler de la ſorte, Parbleu, ſi grande ioye à l’heure me tranſporte, Que mes jambes ſur l’heure en cabrioleroient, Si nous n’eſtions point veus de gens qui s’en ri roient.	voilà qui me plaît de parler de la sorte, Parbleu, si grande joie à l'heure me transporte, Que mes jambes sur l'heure en cabrioleraient, Si nous n'étions point vus de gens qui s'en ri roient.
Approche toy de moy, viens-çà que ie t’embraſſe, Vne belle action n’a pas mauuaiſe grace, Vn pere, quand il veut, peut ſa fille baiſer, Sans que l’on ait ſujet de s’en ſcandaliſer.	Approche toi de moi, viens-à que ie embrasse, v belle action a pas mauuaise grace, pere, quand il veut, peut t' fillebaiser, As que on ait se de en scandaliser,
E 1j Va, le contentement de te voir ſi bien née, Me fera rajeunir de dix fois vne année.	E 1j à, le contentement de te voir si bien née, Me fera rajeunir de dix fois une année.
SCENE XIX.	SCÈNE XIX.
CELIE, LA SVIVANTE.	CELIE, LA SVIVANTE.
opulO Ma?	opulO Ma?
LOus pourrez dans les cinq Vers phhiiepprendre tout le ſujet de cette Scene.	LOus pourrez dans les cinq Vers phhiiepprendre tout le sujet de cette Scène.
211	211
2 LA SVIVANTE.	2 LA SVIVANTE.
nin «ollaiini det ausi ilau Lr thangemen menonne.	nin «ollaiini dét ausi ilau Leng thangemen menonne.
nm mu pauad	nm mu pavad
2 CELIE.	2 CELIE.
11af Et lors que tu ſçautas eominiu dl Par quel motif j’agis, tu m’en eſtimeras.	11af Et lors que tu saautas eominu dl Par quel motif j'agis, tu m'en estimeras.
LA SVIVANTE.	LA SVIVANTE.
Cela pourront bien tite anomam de am	Cela pourront bien tite anomam de am
{IN GELIECD.	{IN GELIECD.
Apprends donc que Lelie, A pû bleſſer mon cœur par vne perfidie, qu’il eſtoit en ces neux ſans.	Apprends donc que Lélie, A pu blesser mon cœur par une perfidie, qu'il était en ces neux sans.
Talliounon el	Talliounon elle
LA SVIVANTE.	LA SVIVANTE.
Mais il vient à nous.	Mais il vient à nous.
SCENE XX.	SCÈNE XX.
CELIE, LELIE, LA SVIVANTE.	CELIE, LELIE, LA SVIVANTE.
TMAVEVT Ans cette Scene, Lelie, qui auoit Dfait deſſein de s’en retourner, vient trouuer Celie, pour luy dire vn eternel Adieu, & ſe plaindre de ſon infidelité, dans la penſée qu’il a, qu’elle eſt mariée à Sganarelle;	TMAUEUT Ans cette Scène, Lélie, qui avait Défait dessein de s'en retourner, vient trouver Celie, pour lui dire un éternel Adieu, et se plaindre de son infidélité, dans la pensée qu'il a, qu'elle est mariée à Séganarelle;
lors que Celie, qui croit auoir plus de lieu de ſe plaindre que luy, luy reproche de ſon coſté ſa perfidie, ce qui ne donne pas vn mediocre contentement à l’Auditeur, qui connoît l’innocence de l’vn & de l’autre, & comme vous la connoiſſez auſſi, ie croy que ces Vers vous pourront diuertir.	lors que Célie, qui croit avoir plus de lieu de se plaindre que lui, tu reproche de son côté sa perfidie, ce qui ne donne pas un médiocre contentement à l'Auditeur, qui connaît l'innocence de l'Homme de l'autre, et comme vous la connaissez aussi, Vous crois que ces Vers vous pourront divertir.
TELIE, Vant que pour iamais ie m’e loigne de vous, Aie veux vous reprocher au moins en cette place.	TELIE, Vant que pour jamais belle m'e loigne de vous, Aie veux vous reprocher au moins en cette place.
CELIE.	CELIE.
Quoy, me parler encor, auez-vous cette audace?	Quoi, me parler encor, avez-vous cette audace?
LELIE.	LELIE.
Il eſt vray qu’elle eſt grãde, & voſtre choix eſt tel, Qu’à vous rien reptocher, ie ſerois criminel.	Il est vrai qu'elle est grand, et votre choix est tel, Qu'à vous rien réptocher, Seigneur serais criminel.
viuez, viuez contente, & brauez ma memoite Auec le digne eſpoux, qui vous comble de gloire.	vivez, vivez contente, et bravez ma mémoite Avec le digne époux, qui vous comble de gloire.
CELIE.	CELIE.
Ouy, traiſtre, j’y veux viure, & mon plus grand dent 1 T Ce ſeroit que ton cœur en eût du déplaiſir.	Oui, traître, j'y veux vivre, et mon plus grand dent 1 Ce serait que ton cœur en eût du déplaisir.
2	2
LELIE.	LELIE.
Qui rend donc contre moy ce courroux legitime	Qui rend donc contre moi ce courroux légitime
CELIE.	CELIE.
Quoy, tu rais le iurpris, & denfande ton crime?	Quo, tu rais le jurpris, et denfande ton crime?
L.	L.
«q102 41 IIIC 414  CAI CELIE, LELIE, SGANARELLE!	«q102 41 IIC 414 CAI CELIE, LELIE, SGANARELLLE!
ARIOIILA SVIVANTE.	ARIOILA SVIVANTE.
JIE HOI	JIE HOI
Ganarelle, qui comme vous auez Oveu dans la fin de la belle Scene, (puis qu’elle n’an point, à preſent d’autreo nom dans Paris ) aol pris reſolution de ſe vanger de Lelie, vient pour cet effet dans cette Scene, armé de toutes pieces:	Ganarelle, qui comme vous avez Ovu dans la fin de la belle Siène, (puis qu'elle n'an point, à présent d'autre nom dans Paris ) aol pris résolution de se venger de Lélie, vient pour cet effet dans cette Scène, armé de toutes pièces:
Et comme il ne l’apperçoit pas d’abord, il ne luy promet pas moins que la mort, dés qu’il le rencontrera.	Et comme il ne l'aperçoit pas d'abord, il ne lui promet pas moins que la mort, dès qu'il le rencontrera.
Mais comme il eſt de ceux qui n’exterminent leurs ennemis que quand ils ſont abſens, auſſi toſt qu’il apperçoit Lelie, bien loin de luy paſſer l’eſpée au trauers du corps, il ne luy fait que des i'euerences, & puis ſe retirant à quartier, il s’excite à faire quelque effort genereux, & à le tuer par derriere, & ſe mettant apres en colere contre luy meſme de ce que ſa poltronnerie ne luy permet pas ſeulement de le regarder entre deux yeux, il ſe punit luy meſme de ſa lâcheté, par les coups & les ſoufflets qu’il ſe donne, & l’on peut dire, que quoy que bien ſouuent l’on ait veu des Scenes ſemblables, Sganarelle ſçait ſi bien animer cette action, qu’elle paroît nouuelle au Theatre.	Mais comme il est de ceux qui n'exterminent leurs ennemis que quand ils sont absents, aussi tôt qu'il apperçoit Lelie, bien loin de même passer l'épée au travers du corps, il ne avait fait que des j'euerences, et puis se retirant à quartier, il s'excite à faire quelque effort généreux, et à le tuer par derrière, et se mettant après en colère contre lui même de ce que sa poltronnerie ne lui permet pas seulement de le regarder entre deux yeux, il se punit nos même de sa lâcheté, par les coups et les soufflets qu'il se donne, et qu'on peut dire, que quoi que bien souuent on a u des ç semblables, Sganarelle sçait si bien animer cette action, uvelle paroît nouuelle au Theatre.
Cependant que Sganarelle ſe tourmente ainſi luy meſme, Celie & ſon Amant n’ont pas moins d’inquietude que luy, & ne ſe reprochent que par des regards enflammez de courroux, leur infidelité imaginaire;	Cependant que Séanarelle se tourmente ainsi lui -même, Celie et son Amant n'ont pas moins d'inquiétude que lui, et ne se reprochent que par des regards enflammés de courroux, leur infidélité imaginaire;
la colere quand elle eſt montée iuſqu’à l’excez, ne nous leiſſant pour  l'ordinaire, que le pouuoir de dire peu de paroles.	la colère quand elle est montée jusqu'à l'excès, ne nous leissant pour l'ordinaire, que le pouvoir de dire peu de paroles.
Celie eſt le premier qui, à la veuë de Sganarelle, dit à ſon Amant de jetter les yeux ſur luy, & qu’il verra dequoy le faire reſſouuenit de ſon crime;	Celie est le premier qui, à la vue de Séganarelle, dit à son Amant de jeter les yeux sur lui, et qu'il verra dequoy le faire ressouvenit de son crime;
maïs comment y trouueroit-il dequoy le confondre, puiſque c’eſt par là qu’il pretend la confondre ellé meſme:	maïs comment y trouverait-il dequoy le confondre, puisque c'est par là qu'il prétend la confondre ellé même:
Il ſe paſſe encore quantité de choſes dans cette Scene, qui confirment les ſoupçons de l’vn & de l’autre;	Il se passe encore quantité de choses dans cette Scène, qui confirment les soupçons de l'un et de l'autre;
mais de peur de vous ennuyer trop long- temps par ma hiole, l’ay recouis aux vers que voicy, pour vous les expliquer.	mais de peur de vous ennuyer trop long- temps par ma hiole, l'ai recouis aux vers que voici, pour vous les expliquer.
113	113
I SCAANARE L LE entre armd· 30 n0 « Vorre, guerre mortelle à ce larron d’honneur, O O Qui ſans miſericorde acſouillé noſtre honneur.	I SCANARE L LE entre armd· 30 nature " Vorre, guerre mortelle à ce larron d'honneur, Ô Ô Qui sans miséricorde acsouillé notre honneur.
A CCEL LE la Lelieme Oop etm Tourne, toutne les yeux ſans me faire reſpondre.	À CCEL LE la Lelieme Oop etm Tourne, toutne les yeux sans me faire répondre.
nni le voh.	nni le voh.
u IAAUOL ADS CAELIE.	Quu IAUOL ADS CAELIE.
Cet objat ſuffit pour te confondre.	Cet objat suffit pour te confondre.
21100 TLELIE.	21100 TLÉLIE.
Mais pour vous obliger bien plutoſt à rougir.	Mais pour vous obliger bien plutôt à rougir.
SGANARELLE.	SGANARELLE.
2O 1O Rla corere a prerent ent cn eſtar d’agir, U Deſſus ſes grands cheuaux eſt monté mon courage, Et ſi ie le rencontre, on verra du carnage:	2O 1O Rla core a prévrent ent cn estar d'agir, V Dessus ses grands chevaux est monté mon courage, Et si personne le rencontre, on verra du carnage:
Ouv, i’ay iuré ſa mort, rien ne peut l’empeſcher, Où ie le trouueray, ie le veux dépeſcher, Au beau milieu du cœur, il faut que ie luy donne.	Ouv, j'ai juré sa mort, rien ne peut l'empêcher, Où ie le trou, ie le veux dépescher, a beau milieu du cœur, il faut que ie lui donne.
it ani d ELIE.	it ani d ELIE.
A qui donc en veut-on dntib poinen	À qui donc en veut-on dîntib poinen
SGANARELLE.	SGANARELLE.
Ie n’en veux à perſonne.	Je n'en veux à personne.
LELIE.	LELIE.
Pourquoy ces armes la?	Pourquoi ces armes la?
SGANARELLE.	SGANARELLE.
1111 C’eſt vn habillement.	1111 C'est un habillement.
a part.	à part.
1 o.	1 ô.
Que i'ay pris pour la pluye.	Que j'ai pris pour la pluie.
Ah quel contentemem, I’aurois à le tuer, prenons-en le courage.	Ah quel contentemoi, J'aurais à le tuer, prenons-en le courage.
H cuamrem LELIE.	H Huamrem LELIE.
Hay?	Hai?
quoi a min mpan	quoi à min mpan
I SGANARELE ſe donnant des coups de 1 a part.	I SGANARELE se donnant des coups de 1 a part.
poings ſur l'eſtomech, & des.	poings sur l'estomèch, et des.
Joufflets pour s’exciter.	Joufflets pour s'exciter.
CELIE.	CELIE.
LAHOC IYACT Il t'en doit dire aſſez, Cet objet, dont tes yeux nous paroiſſent bleſſez.	LAHOC IYACT Il t'en doit dire assez, Cet objet, dont tes yeux nous paraissent blessez.
LELIE.	LELIE.
Ouy, ie connois par là que vous eſtes coupable De l’infidelité la plus inexcuſable, 1 Qui iamais d’vn Amant puiſſe outrager la foy.	Oui, Seigneur connais par là que vous êtes coupable De l'infidélité la plus inexcusable, 1 Qui jamais d'un Amant puisse outrager la foi.
DOINIREDEPAPAR Que n’ay-ie vn peu de cœur.	DOINIREDEPAPAR Que n'ai-je peu de cœur.
CELIE.	CELIE.
Ah!	Ah!
ceſſe deuant moy, Traiſtre, de ce diſcours l'inſolence cruelle.	cesse devant moi, Traître, de ce discours l'insolence cruelle.
SGANARELIE.	SGANARELIE.
Sganarelle, tu vois qu'elle prend ta querelle, courage moi emuney aoa empra viguurcar, Là, hardy, tâche à faire vn effort genereux, En le tuant, tandis qu’il tourne le derriere.	Séganarelle, tu vois qu'elle prend ta querelle, courage moi emuney aoa empra viguurcar, Là, hardi, tâche à faire un effort généreux, En le tuant, tandis qu'il tourne le derrière.
Do.	Do.
LELIE faiſant deux ou trois pas ſans 609 deſſein fait retourner Sgavarelle qui s’approchoit pour le tuer.	LELIE faisant deux ou trois pas sans 609 dessein fait retourner Savarelle qui s'approchait pour le tuer.
Puis qu’vn pareil diſcours eſmeut voſtre colere,  Ie dois de voſtre cœur me montrer ſatisfait, Et l’applaudir icy du beau enonn qu nu ruiumomui.	Puis qu'un pareil discours émut votre colère, Je dois de votre cœur me montrer satisfait, Et l'applaudir ici du beau enonn qu' nu ruiumomui.
CELIE.	CELIE.
Ouy, ouy, mon choix eſt tel qu’on n’y peut rien reprendre.	Oui, oui, mon choix est tel qu'on n'y peut rien reprendre.
LELIE.	LELIE.
Allez, vous faites bien, de le vouloir defendre.	Allez, vous faites bien, de le vouloir défendre.
SGANARELLE.	SGANARELLE.
Sans doute.	Sans doute.
elle fait bien de defendre mes droits:	elle fait bien dé fendre mes droits:
Cette action, Monſieur, n’eſt point ſelon les loix, I’ay raiſon de m’en plaindre, & ſi ie n’eſtois ſage, On verroit arriner vn eſtrange carnage.	Cette action, Monsieur, n'est point selon les lois, J'ai raison de m'en plaindre, et si ici n'étais sage, On verrait arriner un étrange carnage.
LBLIE.	LBLIE.
D’où vous naiſt cette plainte?	D'où vous naît cette plainte?
& quel chagrin brutal.	et quel chagrin brutal.
SGANARELLE.	SGANARELLE.
Suffit, vous ſçauez bien où le bois me fait mal;	Suffit, vous savez bien où le bois me fait mal;
Mais voſtre couſcience & le ſoin de voſtre ame Vous deuroient mettre aux yeux que ma femme, eſt ma femme, Et vouloir à ma barbe en faire voſtre bien, Que ce n’eſt pas du tout agir en bon Chreſtien.	Mais votre coucience et le soin de votre âme Vous devraient mettre aux yeux que ma femme, est ma femme, Et vouloir à ma barbe en faire votre bien, Que ce n'est pas du tout agir en bon Chrétien.
LELIL.	LELIL.
Vn ſemblable ſoupçon eſt bas & ridicule, Allez deſſus ce point, n’ayez aueun ſerupule, Ie ſçay qu’elle eſt à vous, & bien loin de brûler.	Un semblable soupçon est bas et ridicule, Allez dessus ce point, n'ayez aveun serupule, Je sais qu'elle est à vous, et bien loin de brûler.
CELIE.	CELIE.
nan quioy tu igais bien, trantre, dimmuler.	nan qui tu ais bien, trantre, dimuler.
LELIE.	LELIE.
Quoy, me ioupçonnez-vous d’auoir vne penſée, De qui ſon ame ait lieu de ſe croire offenſée?	Quoi, me ioupçonnez-vous d'avoir une pensée, De qui son âme ait lieu de se croire offensée?
De cette lâcheté voulez-vous me noireir.	De cette lâcheté voulez-vous me noireir.
1	1
CELIE.	CELIE.
Parle, parle à luy meſme, il pourra t’eſclaireir.	Parle, parle à M mesme, il pourra t'éclaireir.
GANARELLE.	GANARELLE.
Vous me defendez mieux que ie ne ſçaurois faire, Et du biais qu’il faut vous prenez cctte affaire.	Vous me défendez mieux que ici ne saurais faire, Et du biais qu'il faut vous prenez te affaire.
SCENE XXII CELIE, LELIE, SGANARELLE, SA FEMME, LA SVIVANTE.	SCÈNE XXII CÉLIE, LELIE, SGANARELLE, SA FEMME, LA SVIANTE.
Ans la quatriéme Scene de cetU te Piece, la femme de Sganarelle, qui auoit pris de la jalouſie en voyant Celie entre les bras de ſon mary, vient pour luy faire des reproches (ce qui fait voir la merueilleuſe conduite de cet Ouurage) iugez de la beauté qu’vn agreable mal-entendu produit dans cette Scene.	Ans la quatrième Scène de cetU te Pièce, la femme de Séganarelle, qui avait pris de la jalousie en voyant Celie entre les bras de son mari, vient pour lui faire des reproches (ce qui fait voir la merveilleuse conduite de cet Ouvrage) jugez de la beauté qu'un agréable mal-entendu produit dans cette Scène.
Sganarelle croit que ſa femme vient pour défendre ſon galand, ſa femme croit qu’il aime Celie, Celie croit qu’elle vîent ingenument ſe plaindre d’elle, à cauſe qu’elle eſt auec Lelie, & luy en fait des reproches, & Lelie enfin ne ſçait ce qu’on luy vient conter, & croit touſiours que Celie a eſpouſé Sganarelle, quoy que cette Scene donne vn plaiſir incroyable à l’Auditeur, elle ne peut pas durer plus long-temps ſans trop de confuſion, & ie gage que vous ſouhaittez deſia de voir comment toutes ces perſonnes ſortiront de l’embarras où ils ſe rencontrent;	Séganarelle croit que sa femme vient pour défendre son galant, sa femme croit qu'il aime Celie, Celie croit qu'elle vît ingénument se plaindre d'elle, à cause qu'elle est avec Lélie, et et en fait des reproches, et Lelie enfin ne sait ce qu'on lui vient conter, et croit toujours que Celieu a épousé Sganarelle, quoi que cette Scène donne un plaisir incroyable à l'Auditeur, elle ne peut pas durer plus longtemps sans trop de confusion, et un gage que vous souhaités des de né de voir ces personnes sortiront del’embarras où ils se rencontrent;
mais ie vous le donnerois bien à deuiner en quatre coups, ſans que vous en pûſſiez venir à bout.	mais ici vous le donnerais bien à deviner en quatre coups, sans que vous en pussiez venir à bout.
Peuteſtre vous perſuadez-vous qu’il va venir quelqu’vn qui ſans y penſer luy meſme, les tirera de leur erreur.	Peutêtre vous persuadez-vous qu'il va venir quelqu'un qui sans y penser un même, les tirera de leur erreur.
Peuteſtre croyez-vous auſſi qu’à force de s’animer les vns contre les autres, quelqu’vn venant à ſe iuſtifier, leur fera voir à tous qu’ils s’abuſent;	Peutestre croyez-vous aussi qu'à force de s'animer les uns contre les autres, quelqu'un venant à se justifier, leur fera voir à tous qu'ils s'abusent;
mais ce n’eſt point tout cela, & l’Autheur s’eſt ſeruy d’vn moyen dont perſonne ne s’eſt iamais auiſé, & que vous pourrez ſçauoir ſi vous liſez les vers de cette Scene.	mais ce n'est point tout cela, et l'Auteur s'est servi d'un moyen dont personne ne s'est jamais avisé, et que vous pourrez sçauoir si vous lisez les vers de cette Scène.
LA FEMME de Sganarelle à Celie, E ne iuis pomt d'numeur à vouloit coutre vous IFaire eſclater, Madame, vn eſprit trop jaloux;	LA FEMME de Séganarelle à Célie, ne juis pompt d'numeur à voulait coutre vous IFaire éclater, Madame, un esprit trop jaloux;
Mais ie ne ſuis point duppe, & voy ce qui ſe paſſe, Il eſt de certains feux de fort mauuaiſe grace, Et voſtre ame deuroit prendre vn meilleut employ, Que de ſeduire vn cœur qui doit n’eſtre qu’à moy.	Mais personne ne suis point dupe, et vois ce qui se passe, Il est de certains feux de fort mauvaise grâce, Et votre âme devrait prendre un meilleut emploi, Que de séduire un cœur qui doit n'être qu'à moi.
a a e l da La declaration eſt aſſez ingenuë.	a à eût la da La déclaration est assez ingénue.
SGANA	SGANA
SGANARELLE à ſa femme.	SGANARELLE à sa femme.
L'on ne demandoit pas, carogne, ta venuë, ru ia tiens quereller lors qu’elle me deffend, Et tu trembles de peur qu’on t’oſte ton galand.	L'on ne demandait pas, carogne, ta venue, ru ia tiens quereller lors qu'elle me défend, Et tu trembles de peur qu'on t'ôte ton galant.
CELIE ſe tournant vers Lelie.	CELIE se tournant vers Lélie.
Allez ne croyez pas que l’on en ait enuie, Tu vois ſi c’eſt menſonge, & i’en ſuis fort rauie.	Allez ne croyez pas que l'on en ait envie, Tu vois si c'est mensonge, et j'en suis fort ravie.
LELIE.	LELIE.
Que me veut-on conter?	Que me veut-on conter?
LA SVIVANTE.	LA SVIVANTE.
Ma foy, ie ne ſçay pas Quand on verra finir ce galimathias?	Ma foi, Seigneur ne sais pas Quand on verra finir ce galimathias?
Deſia depuis long-temps ie tâche à le comprendre, Et ſi plus ie l’eſcoute, & moins ie puis l’entendre;	Déjà depuis longtemps était tâche à le comprendre, Et si plus un comprendre, et moins quelque puis l'entendre;
Ie vois bien à la fin que ie m’en dois meſſer.	Je vois bien à la fin que votre m'en dois messer.
Allant ſe mettre entre Lelie & ſa maiſtreſſe.	Allant se mettre entre Lélie et sa maîtresse.
ſeeiponuen moy par ordre, & me laiſſez parler.	seiponven moi par ordre, et me laissez parler.
A Lelie.	À Lélie.
Vous, qu’eſt-ce qu’à ſon cœur peut reprocher le voſtre?	Vous, qu'est-ce qu'à son cœur peut reprocher le vôtre?
LELIE.	LELIE.
Que l’infidele a pû me quitter pour vn autre:	Que l'infidèle a pu me quitter pour un autre:
Que lors que ſur le bruit de ſon hymen fatal.	Que lors que sur le bruit de son hymen fatal.
I’accours tout tranſporté d’vn amour ſans égal, Dont l’ardeur reſiſtoit à ſe croire oubliée, Mon abord en ces neux la ttouue mariée.	J'accours tout transporté d'un amour sans égal, Dont l'ardeur résistait à se croire oubliée, Mon abord en ces neux la touve mariée.
LA SVIVANTE.	LA SVIVANTE.
Mariée, à qui done ?	Mariée, à qui done ?
LELIE monſtrant Sganarelle.	LELIE montrant Sganarelle.
A luy.	A Aux.
AMOIMETE.	AMOIMETE.
Comment à luy?	Comment à Seigneur?
Ouy-da.	Oui-dà.
LEBIE.	LEBIE.
LA SVIVANTE.	LA SVIVANTE.
Qui vous l'a dit?	Qui vous l'a dit?
LELIE.	LELIE.
C’eſt luy-meſme aujourd’huy.	C'est notre-même aujourd'hui.
LA SVIVANTE a Sganarele.	LA SVIVANTE a Sganarele.
i&t il vray?	ict il vrai?
SGANARELLE.	SGANARELLE.
Moy, i’ay dit que c’eſtoit à ma femme, Que i’eſtois marié.	Moi, j'ai dit que c'était à ma femme, Que j'étais marié.
LELIE.	LELIE.
Luus in grana trouere dame, Tantoſt de mon portrait ie vous ay veu ſaiſi.	Luus in grana trouère dame, Tantôt de mon portrait ie -vous ai vu saisi.
SGANARELLE.	SGANARELLE.
Il eſt vray, le voila.	Il est vrai, le voilà.
LELIE.	LELIE.
Vous m’auez dit auſſi, Que celle aux mains de qui vous auiez pris ce gage Eſtoit liée à vous des nœuds du mariage.	Vous m'avez dit aussi, Que celle aux mains de qui vous aviez pris ce gage Était liée à vous des nœuds du mariage.
EE momttune ja femme.	CE momenttune ja femme.
Sans doute, & ie l’auois de ſes mains arraché, Et n’euſſe pas ſans luy découuert ſon peché.	Sans doute, et ainsi l'avais de ses mains arraché, Et n'eusse pas sans lui découvert son péché.
LA FEMME de Sganarelle.	LA FEMME de Séganarelle.
Que me viens-tu conter par ta plainte impottune, Ie l’auois ſous mes pieds rencontré par fortune, Et meſme quand apres ton injuſte courroux,	Que me viens-tu conter par ta plainte impottune, Je l'avais sous mes pieds rencontré par fortune, Et même quand après ton injuste courroux,
nunt paul hectt.	nunt paul hectt.
I’ay fait dans ſa foibleſſe entrer Monſieur chez nous, Ie n’ay pas reconnu les traits de ſa peinture.	J'ai fait dans sa faiblesse entrer Monsieur chez nous, Je n'ai pas reconnu les traits de sa peinture.
CELIE.	CELIE.
C’eſt moy qui du portrait ay cauſé l’auanture, Et ie l’ay laiſſé cheoir en cette pâmoiſon, à oganareute Qui m’a fait par vos ſoins remettre à la maiſon.	C'est moi qui du portrait ai causé l'aventure, Et tu l'ai laissé choir en cette pâmoison, à oganareute Qui m'a fait par vos soins remettre à la maison.
LA SVIVANTE.	LA SVIVANTE.
Vous voyez que ſans moy vous y ſeriez encore Et vous auiez beſoin de mon peu d’Elebore.	Vous voyez que sans moi vous y seriez encore Et vous aviez besoin de mon peu d'Élébore.
SGANARELLE.	SGANARELLE.
Prendrons-nous tout cery pour de raigent contentMon front l’a ſur mon ame, eu bien chaude pourtant.	Prendrons-nous tout ceri pour de raigent contentMon front l'a sur mon âme, eu bien chaude pourtant.
1 SA FEMME.	1 SA FEMME.
Ma crainte toutefois n’eſt pas trop diſſipée, Et doux que ſoit le mal, ie crains d’eſtre trompée.	Ma crainte toutefois n'est pas trop dissipée, Et doux que soit le mal, tu crains d'être trompée.
SGANARELLE.	SGANARELLE.
Hé!	Hé!
mutuellement croyons nous gens de bien.	mutuellement croyons nous gens de bien.
Ie riſque plus du mien que tu ne fais du den:	Je risque plus du mien que tu ne fais du den:
Accepte ſans façon le marche qu’on propoſe.	Accepte sans façon le marche qu'on propose.
SA FEMME.	SA FEMME.
Soit, mais gare le bois, ſi i’apprends quelque choſe.	Soit, mais gare le bois, si j'apprends quelque chose.
CELIE à Lelie apres auoir parlé bas enſemble.	CELIE à Lélie après avoir parlé bas ensemble.
Ah!	Ah!
Dieux, s’il eſt ainſi, qu'eſt-ce donc que i’ay fait, Ie dois de mon courroux apprehender l’effet:	Dieux, s'il est ainsi, qu'est-ce donc que j'ai fait, Je dois de mon courroux appréhender l'effet:
Ouy, vous croyant ſans foy, i’ay pris pour ma vengeance Le malheur eux ſecours de mon obeïſſance, Et depuis vn moment mon cœut vient d’accepter, vn hymen que touſours reur neu de rebuter, I’ay promis à mon pere, & ce qui me deſole.	Oui, vous croyant sans foi, j'ai pris pour ma vengeance Le malheur eux secours de mon obéissance, Et depuis un moment mon cœut vient d'accepter, un hymen que tous reçu de rebuter, J'ai promis à mon père, et ce qui me désole.
Mais ie le vois venit.	Mais ie le vois venit.
LLETES Il me tiendra parole.	LLÉTES Il me tiendra parole.
SCENE XXIII.	SCÈNE XXIII.
CELIE, LELIE, GORGIBVS, SGANARELLE, SA FEMME,	CELIE, LELIE, GORGIBUS, SGANARELLE, SA FEMME,
LELIE.	LELIE.
Onſieur, vous me voyez en ces lieux de reM tour, Bruſlant des meſmes feux, & mon ardante amour vorla comme mu uun jalu paumame dacomprie, Qui me donna l’eſpoir de l’hymen de Celie.	Onsieur, vous me voyez en ces lieux de reM en, Brhuslant des mêmes feux, et mon ardante amour vorla comme mu uun jal paumame dacomprie, Qui me donna l'espoir de l'hymen de Célie.
GORGEBVS.	GORGEBUS.
Monſieur, que ie reuois en ces lieux de retour, Bruſſant des meſmes feux, & dont l’ardante amour, Verra que vous croyez la promeſſe accomplie, Qui vous donna l’eſpoir de l’hymen de Celie, Tres-humble ſe ruiteur à voſtre Seigneurie.	Monsieur, que je rêvais en ces lieux de retour, Brussant des mêmes feux, et dont l'ardante amour, Verra que vous croyez la promesse accomplie, Qui vous donna l'espoir de l'hymen de Célie, Très-humble se ruiteur à votre Seigneurie.
LELTL.	LELTL.
Quoy?	Quoi?
Monſieur, eſt-ce ainſi qu’on trahit mon eſpoir?	Monsieur, est-ce ainsi qu'on trahit mon espoir?
22	22
GORGIBVS, Ouy, Monſieur, c’eſt ainſi que ie fais mon deuolr, Ma fille en ſuit les loix.	GORGIBUS, Oui, Monsieur, c'est ainsi que tu fais mon dévolr, Ma fille en suit les lois.
M CELLE.	M MELLE.
Mon deuoir m’intereſſe, Mon pere, à dégager vers luy voſtre promeſſe.	Mon devoir m'intéresse, Mon père, à dégager vers lui vôtre promesse.
ORGIBVS.	ORGIBUS.
Eſt-ce reſpondre en fille à mes commandemens?	Est-ce répondre en fille à mes commandements?
Tu te démens bien-toſt de tes bons ſentimens, Pour Valere, tantoſt.	Tu te déments bientôt de tes bons sentiments, Pour Valère, tantôt.
mais i’apperçois ſon pere, Il vient aſſeurément pour conclutre l'affaire.	mais j'aperçois son père, Il vient assurément pour conclutre l'affaire.
SCENE DERNIERE.	SCÈNE DERNIÈRE.
CELIE, LELIE, GORGIBVS, SGANARBLLE, SA FEMME, VILLEBREQVIN, LA SVIVANTE.	CELIE, LELIE, GORGIBUS, SGANARBLLE, SA FEMME, VILLEBREQUIN, LA SVIVANTE.
ondeconeula IEMIII M COOUN A joye que Celie auoit euë en apEprenant que ſon Amant ne luy ſtoit pas infide le, eut eſté de courte durée, ſi le pere de Valere ne fut pas venu à temps pour les retirer tous deux de peine.	ondeconeula JEMII M OUN À joie que Celie avait eue en apprenant que son Amant ne lui stait pas infide le, eut été de courte durée, si le père de Valère ne fut pas venu à temps pour les retirer tous deux de peine.
Vous pourrez voir dans le reſte des Vers de cette Piece, que voicy le ſujet qui le fait venir.	Vous pourrez voir dans le reste des Vers de cette Pièce, que voici le sujet qui le fait venir.
20 GORGIBVS.	20 GORGIBUS.
QVi vous amene icy, Seigneur villebrequin?	QUi vous amène ici, Seigneur villebrequin?
VIL.	VIL.
LEBREQVIN.	LEBREQUIN.
Vn ſecret important que i’ay ſçeu ce matin, Qui rompt abſolument ma parole donnée.	Un secret important que j'ai su ce matin, Qui rompt absolument ma parole donnée.
Mon fils dont voſtre fille acceptoit l’hymenée, Sous des liens cachez, trompant les yeux de tous, viſt depuis quatre mois auec Liſe en eſpoux, Et comme des parens le bien & la naiſſance, M’oſtent tout le pouuoir d’en caſſer l’alllance, Ie vous viens.	Mon fils dont votre fille acceptait l'hyménée, Sous des liens cachés, trompant les yeux de tous, vit depuis quatre mois était Lise en époux, Et comme des parents le bien et la naissance, M'ôtent tout le pouvoir d'en casser l'alllance, Je vous viens.
GORGIBVS.	GORGIBUS.
Briſons la, ſi ſans voſtre çongé, Valere voſtre fils ailleurs s’eſt engagé;	Brisons la, si sans votre çongé, Valère votre fils ailleurs s'est engagé;
Ie ne vous puis celer que ma fille Celie, Des fongiteps par moyninemejen promiſe à Lelie, Et que riche en vertus, ſon retour aujourd’huy M’empeſche d’agréer vn autre eſpoux que luy.	Je ne vous puis celer que ma fille Celie, Des fongites par moyninemejen promise à Lelie, Et que riche en vertus, son retour aujourd'hui M'empêche d'agréer un autre époux que lui.
VILLEBREQYIN.	VILEBREQYIN.
T Vn tel choix me plaiſt fort.	T Un tel choix me plaît fort.
LELIE, Et cette juſte enuie, D’vn bon-heur eternel va couronner ma vie.	LELIE, Et cette juste envie, D'un bonheur éternel va couronner ma vie.
0 GORGIBVS, 1 Allons choiſir le iour pour ſe donner la foy.	0 GORGIBUS, 1 Allons choisir le jour pour se donner la foi.
SGANARELLE.	SGANARELLE.
A-t’on mieux crû iamais eſtre cocu que moy.	A-t-on mieux cru jamais être cocu que moi.
Vous voyez qu’en ce fait la plus forte apparence.	Vous voyez qu'en ce fait la plus forte apparence.
Peut ietter dans l’eſprit vne fauſſe creance:	Peut jeter dans l'esprit une fausse créance:
De cet exemple-cy, reſſouuenez-vous bien, Et quand vous verriez tout ne croyez iamais rien.	De cet exemple-cy, ressouuenez-vous bien, Et quand vous verriez tout ne croyez jamais rien.
Sans mentir, Monſieur, vous me deuez eſtre bien obligé de tant de belles choſes que ie vous enuoye, & tous les melons de voſtre iardin ne ſont pas ſuffiſans pour me payer de la peine d’auoir retenu pour l’amour de vous toute cette Piece par cœur:	Sans mentir, Monsieur, vous me devez être bien obligé de tant de belles choses que ie vous envoie, et tous les melons de votre jardin ne sont pas suffisants pour me payer de la peine d'avoir retenu pour l'amour de vous toute cette Pièce par cœur:
mais i’oubliois de vous dire vne choſe à l’auantage de ſon Autheur, qui eſt que comme ie n’ay eu cette Piece, que ie vous enuoye que par effort de memoire, il peut s’y eſtre coulé quantité de mots, les vns pour les autres, bien qu’ils ſignifient la meſme choſe,& comme ceux de l’Autheur peuuent eſtre plus ſignificatifs, ie vous prie de m’imputer toutes les fautes de cette nature;	mais j'oubliais de vous dire une chose à l'avantage de son Auteur, qui est que comme Elle n'ai eu cette Pièce, que je vous envoie que par effort de mémoire, il peut s'y avoir coulé quantité de mots, les uns pour les autres, bien qu'ils signifient la même chose, comme ceux de l'Auteur peuvent être plus significatifs, je vous prie de m'imputer toutes les fautes de cette nature;
que vous y trouuerez, & ie vous conjure auec tous les curieux de France, de venit in reprijoner cette Piece, comme vn des plus beaux Ouurages,& vn des mieux ioüez qui oit iamais puru ſur la Sçene.	que vous y trouverez, et ainsi vous conjure auec tous les curieux de France, de venit in reprijoner cette Pièce, comme un des plus beaux Ouvrages, q des grande ioüez qui oit jamais puru sur la Scène.
IN.	IN.
