M.	M.
DC.	DC.
LXXVIII, AVEC PERMISSION DE LA COUR.	LXXVIII, AVEC PERMISSION DE LA COUR.
au lieu de vous preſenter le Portrait d'un Héros tout couvert de Lauriers, je produis un Perſonnage de bas aloy, dont les ſentiments ſont entiérement oppoſez à cette généroſité qui vous eſt héréditaire:	au lieu de vous présenter le Portrait d'un Héros tout couvert de Lauriers, je produis un Personnage de bas aloi, dont les sentiments sont entierrement opposés à cette générosité qui vous est héréditaire:
C’eſt un Financier inſolent depé par ſa propre inconduite, & châtie de ſa curioſité criminelle;	C'est un Financier insolent dépé par sa propre inconduite, et châtie de sa curiosité criminelle;
Mais j’ay crû en cela imiter les Peintres, leſquels pour donner plus de luſtre à leurs Perſonnages, les ombragent ordinairement des plus noires couleurs;	Mais j'ai cru en cela imiter les Peintres, lesquels pour donner plus de lustre à leurs Personnages, les ombragent ordinairement des plus noires couleurs;
ainſi cét eſprit de bouë & de fange ne paroîtra prés de vêtre Nom Illuſtre que pour ſa confufion;	ainsi cet esprit de boue et de fange ne paraîtra près de vêtre Nom Illustre que pour sa confusion;
& comme j’ay pris plaiſir à le berner, je croiray y avoir infiniment mieux reußi, ſi ſa propre turpitude peut vous diſtraire un moment pour en condamner les maximes, & le traiter d’un mépris proportionné à ce haut degré de vertu que tout le monde admire en Vous.	et comme j'ai pris plaisir à le berner, je croirai y avoir infiniment mieux reussi, si sa propre turpitude peut vous distraire un moment pour en condamner les maximes, et le traiter d'un mépris proportionné à ce haut degré de vertu que tout le monde admire en Vous.
Ce ſeroit en quelque façon faire tort à vôtre gloire de prétendre icy faire les éloges de la Maiſon de Tere, les Actions héroïques de vos Anreſtres, dont toutes nos Histoires ſont remplies depuis plus de ſix cents ans, ne chantent qu’une infinité de trophées dreſſez à leur mémoire;	Ce serait en quelque façon faire tort à votre gloire de prétendre ici faire les éloges de la Maison de Tere, les Actions héroïques de vos Anrêtres, dont toutes nos Histoires sont remplies depuis plus de six cents ans, ne chantent qu'une infinité de trophées dressez à leur mémoire;
La Conqueſte d’Angleterre par le grand Duc de Normandie en eſt une preuve aſſez connuë, & la Charge de Banneret Héréditaire de la Province, confirment cette vérité.	La Conquête d'Angleterre par le grand Duc de Normandie en est une preuve assez connue, et la Charge de Banneret Héréditaire de la Province, confirment cette vérité.
La Fondation de la belle Abbaye de Sainte Catherine de la Perrine, il y a environ cinq cens ans, par une Catherine de Tere, fait voir que cette Maiſon n’a pas moins éclaté en Pieté que dans les Armes.	La Fondation de la belle Abbaye de Sainte Catherine de la Perrine, il y a environ cinq cents ans, par une Catherine de Tere, fait voir que cette Maison n'a pas moins éclaté en Piété que dans les Armes.
Je craindrois, MONSIEUR, de vous eſtre ennuyeux, d’entreprendre dans ce petit Compliment d’en vouloir remarquer les avantages, Je me contenteray de faire connoiſtre au Leéteur, que j’ay pour Protecteur MONSIEUR DES GLANDES, dont le rare mérite & les belles actions parlent d’eux-meſmes, & je m’eſtimeray trés-heureux de me pouvoir dire avec reſpect,	Je crois, MONSIEUR, de vous être ennuyeux, d'entreprendre dans ce petit Compliment d'en vouloir remarquer les avantages, Je me contenterai de faire connaître au Leéteur, que j'ai pour Protecteur MONSIEUR DES GLANDES, dont le rare mérite et les belles actions parlent d'eux-mêmes, et je m'estimerai très-heureux de me pouvoir dire avec respect,
IONSIEUR,	JONSIEUR,
Vôtre tres-humble & trés-obeïſſant S erviteur, I IEBL, Avocat aux Conſeils d’Eſtat-& Privé du B oy.	Votre très-humble et très-obeïssant S erviteur, I JEBL, Avocat aux Conseils d'État- Privé du B oi.
Extrait de la Permißion de la Cour de Parlencin.	Extrait de la Permise de la Cour de Parlencin.
L eſt permis au Sieur NEEL Avocat aux ConI ſeils d’Eſtat & Privé du Roy, de faire Imprimer, vendre & debiter une Comedie intitulée L’Illuſion Groteſque, ou le Feint Nécromancien, de ſa Compoſition, avec défences à tous Imprimeurs Libraires du Reſſort dudit Parlement, autre que celuy qu’il aura choiſy, de l’Imprimer, vendre & debiter, à peine de confiſcation des Exemplaires, cins cens livres d’amende, intéreſts, dommages & dépens.	L est permis au Sieur NEL Avocat aux ConI seils d'État et Privé du Roi, de faire Imprimer, vendre et débiter une Comédie intitulée L'Illusion Grotesque, ou le Feint Nécromancien, de sa Composition, avec défenses à tous Imprimeurs Libraires du Ressort dudit Parlement, autre que celui qu'il aura choisy, de l'Imprimer, vendre et débiter, à peine de confiscation des Exemplaires, ç cens livres d'amende, intérêts, dommages et dépens,
A Roüen le 26 Aouſt 1672,	À Ren le 26 Août 1672,
Signé PELLOT.	Signé PELOT.
Et ledit ſieur Néel a cedé ſon Droit à Antoine Maurry, ſuivant l'accord fait entr’eux.	Et ledit sieur Néel a cédé son Droit à Antoine Mauri, suivant l'accord fait entr'eux.
PERSONNAGES.	PERSONNAGES.
PHILANDRE, Financiti, Amant d’Arminde.	PHILANDRE, Financiti, Amant d'Arminde.
MASCARILLE, Pere d’Arminde.	MASCARILLE, Père d'Arminde.
ARMINDE, Fille de Maſcarille.	ARMINDE, Fille de Mascarille.
PALMIRE, Amant d’Arminde.	PALMIRE, Amant d'Arminde.
ROSELLE, ſous habit d’homme, & le Nom d’Ormin, ſœur de Palmire, Valet de Chambre de Philandre.	ROSELLE, sous habit d'homme, et le Nom d'Ormin, sœur de Palmire, Valet de Chambre de Philandre.
BEATRIX, Confidente d’Arminde, & Sœur de Criſpin.	BEATRIX, Confidente d'Arminde, et Sœur de Crispin.
CRISPIN, Valet de Palmire.	CRISPIN, Valet de Palmire.
POLEMCIJTGCIOmhancien, & quatre Lutins.	POLEMCIJTGCIOmhancien, et quatre Lutins.
UN BRIGADIER.	UN BRIGADIER.
Quatre Rats de Cave.	Quatre Rats de Cave.
UNEXEMT, & ſes Archers.	UNEXEMT, et ses Archers.
La Scene eſt à Chaalons en Champagne.	La Scène est à Chalons en Champagne.
MABEOGION	MABEOGION
LIEESSION GROTESQUE, LE FEINT NECROMANCIEN.	LIESION GROTESQUE, LE FEINT NÉCROMANCIEN.
COMEDIE.	COMÉDIE.
ACTEI.	ACTEI.
SCENE PREMIERE.	SCÈNE PREMIÈRE.
PHILANDRE, & ſes Commis.	PHILANDRE, et ses Commis.
PHILANDRE.	PHILANDRE.
OMMIS, qu’en mon abſence on ait ſoin de la Ferme, Et ſur tout n’épargnez perſonne aprés le terme;	OMMIS, qu'en mon absence on ait soin de la Ferme, Et sur tout n'épargnez personne après le terme;
Contremarquez ſi bien Futailles & Ponçons Qu’on ne puiſſe de nuit rembouger les boiſſons.	Contremarquez si bien Futailles et Ponçons Qu'on ne puisse de nuit remouger les boissons.
Ne diminuez rien pour coulage ny lie, Que d’un controlle exact la Queſte ſoit ſuivie, Et ſi vous ſoupçonnez quelqu’un d’en uſer mal, Soit veritable ou faux faites Procez verbal, N’apprehendez jamais que le Juge les caſſe, Puiſque nous l’appointons il faut bien qu’il les paſſe.	Ne diminuez rien pour coulage Seigneur lie, Que d'un controlle exact la Quête soit suivie, Et si vous soupçonnez quelqu'un d'en user mal, Soit véritable ou faux faites Procès -verbal, N'appréhendez jamais que le Juge les casse, Puisque nous l'appointons il faut bien qu'il les passe.
Non, le pere d’Arminde aprés tout n’eſt qu’un fat De m’avoir ſans raiſon qualifié de Rat.	Non, le père d'Arminde après tout n'est qu'un fat De m'avoir sans raison qualifié de Rat.
Qu’il apprenne morbleu que les gens de Finance Surpaſſent de beaucoup en eſprit, en puiſſance, Tous les autres emplois, & ſans en excepter;	Qu'il apprenne morbleu que les gens de Finance Surpassent de beaucoup en esprit, en puissance, Tous les autres emplois, et sans en excepter;
J’en juge par moy-meſme, & c’eſt ſans me flater.	J'en juge par moi-même, et c'est sans me flatter.
Qu’on parle d’Avocats, & de Juriſprudence, Ou d’eſprits conſommez en toute l’éloquence, Ils u’ont que des diſcours la pluſpart ſans raiſon:	Qu'on parle d'Avocats, et de Jurisprudence, Ou d'esprits consommés en toute l'éloquence, Ils ont que des discours la pluspart sans raison:
Et que vaut tout cela?	Et que vaut tout cela?
rien en comparaiſon.	rien en comparaison.
A de foibles eſprits ils vendent des paroles, C’eſt à dire du vent & des contes frivoles.	À de faibles esprits ils vendent des paroles, C'est à dire du vent et des contes frivoles.
L’employ d’un Financier eſt plus noble & plus beau Que celuy d’un Conteur de ſornette au Barreaus Sa fortune eſt plus prompte & plus pecunieuſe, Au lieu que la chicane eſt longue & périllenſe, Et la pluſpart du temps il n’en vient d’autre bien Que de vivre d’eſpoir & dépenſer le ſien.	L'emploi d'un Financier est plus noble et plus beau Que celui d'un Conteur de sornette au Barreaus Sa fortune est plus prompte et plus pécunieuse, Au lieu que la chicane est longue et périllense, Et la plupart du temps il n'en vient d'autre bien Que de vivre d'espoir et dépenser le sien.
Nous n’avons point chez nous cette ſotte coûtume.	Nous n'avons point chez nous cette sotte coutume.
Nôtre compte toûjours eſt au bout de la plume.	Notre compte toujours est au bout de la plume.
O qu’il eſt plus honnête & plus avantageux De ſçavoir que de cinq ôtant trois reſte deux, On peut bien égaler & recepte & dépence, Faire paſſer ſans bruit la partie en ſouffrance, Traiter bien à propos de quelque bon Debet, De feintes Non-valeurs obtenir le rejet, Se rendre en partageant les Juges favorables, Pour paſſer des chanſons en quittances comptables.	Ô qu'il est plus honnête et plus avantageux Dé ceavoir que de cinq ôtant trois reste deux, On peut bien égaler et recepte et dépense, Faire passer sans bruit la partie en souffrance, Traiter bien à propos de quelque bon Débet, De feintes Non -valeurs obtenir le rejet, Se rendre en partageant les Juges favorables, Pour passer des chansons en quittances comptables.
Voila ce qui s’appelle avoir bien de l’eſprit;	Voilà ce qui s'appelle avoir bien de l'esprit;
C’eſt enfin parmy nous à preſent comme on vit.	C'est enfin parmi nous à présent comme on vit.
Ainſi donc Maſcarille, en me prenant pour gendre, Pour Arminde en ce choix ne ſçauroit ſe méprendre, J’ay du bien, de l’acquis, & je le porte beau, Et ſçais faire valoir, comme il faut, le Bureau.	Ainsi donc Mascarille, en me prenant pour gendre, Pour Arminde en ce choix ne saurait se méprendre, J'ai du bien, de l'acquis, et je le porte beau, Et sais faire valoir, comme il faut, le Bureau.
Mais Ormin tarde bien, & ſa longueur m’ennuye, Sa réponce fera le bonheur de ma vie;	Mais Ormin tarde bien, et sa longueur m'ennuie, Sa réponse fera le bonheur de ma vie;
Je la croy favorable, & l’eſpoir m’en eſt doux Le voila qui s’avance.	Je la crois favorable, et l'espoir m'en est doux Le voilà qui s'avance.
Allez, retirez-vous.	Allez, retirez-vous.
SCENE II.	SCÈNE II.
PHILANDRE, ORMIN, en habit d’homme.	PHILANDRE, ORMIN, en habit d'homme.
PHILANDRE.	PHILANDRE.
E' bien, qu’a donc produit ta derniere ambaſTT ſade?	E' bien, qu'a donc produit ta dernière ambasT sade?
Veut-il perſeverer en ſa ſotte boutade, Et cét eſprit bourru ſur la fin de ſes ans A-t-il pour l’intereſt perdu tous ſentimens?	Veut-il persévérer en sa sotte boutade, Et cet esprit bourru sur la fin de ses ans At-il pour l'intérêt perdu tous sentiments?
La noble ambition d’aggrandir ſa famille L’a-t-elle pû fléchir en faveur de ſa fille?	La noble ambition d'aggrandir sa famille L'a-t-elle pu fléchir en faveur de sa fille?
yeeonnolsten senie a toumer un eiprit, Et que quand tu le veux ton projet reüſſit.	yeonnolsten sénie a toumer un eiprit, Et que quand tu le veux ton projet réussit.
O RiIr.	Ô RiIr.
Vous vous mocquez, Monſieur.	Vous vous moquez, Monsieur.
PHILANDRE.	PHILANDRE.
Non, j’ay, je le confeſſe, En cent occaſions admiré ton adreſſe.	Non, j'ai, je le confesse, En cent occasions admiré ton adresse.
A ij	À ij
ORMIN.	ORMIN.
Quand je n’en aurois pas, un harnois ſi pimpant Suffit pour réveiller l’eſprit le plus peſant.	Quand je n'en aurais pas, un harnais si pimpant Suffit pour réveiller l'esprit le plus pesant.
La plume ſur l’oreille, & la perruque blonde, Un Sabre, avec du cœur, m’ornent le mieux du monde.	La plume sur l'oreille, et la perruque blonde, Un Sabre, avec du cœur, m'ornent le mieux du monde.
Que dites-vous, Monſieur, de cét air dégagé?	Que dites-vous, Monsieur, de cet air dégagé?
Vous voudriez, je croy, n’eſtre pas plus âgé.	Vous voudriez, je crois, n'être pas plus âgé.
a part.	à part.
Je croy que de tous points je vaux bien ma Rivale.	Je crois que de tous points je vaux bien ma Rivale.
PHILANDRE.	PHILANDRE.
Mais pourquoy n’as- tu point la barbe à la Royale?	Mais pourquoi n'as- tu point la barbe à la Royale?
C’eſt-là d’un Cavalier le plus bel ornement.	C'est-là d'un Cavalier le plus bel ornement.
ORMIN.	ORMIN.
Je vous veux là-deſſus conter mon accident.	Je vous veux là-dessus conter mon accident.
Un Baibier fort expert de nôtre voiſinage Remarquant que le poil gâteroit mon viſage, Et qu’en ſuite du temps j’en deviendrois moins beau, Me vint faire preſent d’une ſi ſubtile eau, Qu’elle pouvoit du poil extirper la racine, Et conlerver toujours la baibe a la Maupnine.	Un Baibier fort expert de notre voisinage Remarquant que le poil gâterait mon visage, Et qu'en suite du temps j'en deviendrais moins beau, Me vint faire présent d'une si subtile eau, Qu'elle pouvait du poil extirper la racine, Et conlerver toujours la baibe a la Maupnine.
J’en pris, & dés l’inſtant, comme vous pouvez voin Je n’ay plus eu beſoin de barbier ny raſoir.	J'en pris, et dès l'instant, comme vous pouvez voin Je n'ai plus eu besoin de barbier ni rasoir.
Ah!	Ah!
d’un homme ſçavant le conſeil ſalutaire!	d'un homme Savant le conseil salutaire!
PHILANDRE.	PHILANDRE.
Laiſſe-là ton barbier, parlons de nôtre affaire.	Laisse-là ton barbier, parlons de notre affaire.
As-tu fait le détail de toutes mes grandeurs, De mes poſſeſſions, mes tîtres, mes honneurs;	As-tu fait le détail de toutes mes grandeurs, De mes possessions, mes tîtres, mes honneurs;
Quels devoirs nuit & jour le peuple me vient rendre, Et pour m’avoir déplu, combien j’en ay fait pendre?	Quels devoirs nuit et jour le peuple me vient rendre, Et pour m'avoir déplu, combien j'en ai fait pendre?
ORMIN.	ORMIN.
J’en ay dit encor plus afin de l’engager, Que tous vos ſentimens n’alloient qu’à l’obliger;	J'en ai dit encor plus afin de l'engager, Que tous vos sentiments n'allaient qu'à l'obliger;
Que vous avez l’humeur accorte & complaiſante, Et dans l'occaſion toûjours reconnoiſſante:	Que vous avez l'humeur accorte et complaisante, Et dans l'occasion toujours reconnaissante:
Juſques là que j’ay dit, que s’il le vouloit bien, Des boiſſons qu’il vendra vos gens n’en preudront rien.	Jusque là que j'ai dit, que s'il le voulait bien, Des boissons qu'il vendra vos gens n'en preudront rien.
PHILANDRE.	PHILANDRE.
Ormin, c’en eſt beaucoup.	Ormin, c'en est beaucoup.
ORMIN.	ORMIN.
Mais, Monſieur, c’eſt le pire, Car de tous vos honneurs il ne faiſoit que rire.	Mais, Monsieur, c'est le pire, Car de tous vos honneurs il ne faisait que rire.
Ces gens-là, m’a-t-il dit, n’ont que l’éclat d’un jour;	Ces gens-là, m'a-t-il dit, n'ont que l'éclat d'un jour;
Un en éleve, & l’autre en abyme à ſon tour.	Un en élève, et l'autre en abîme à son tour.
Ce ſont des Champignons qui ne faiſant que naître, Dans l’eſpace d’un jour ſont preſts à diſparoiſtre:	Ce sont des Champignons qui ne faisant que naître, Dans l'espace d'un jour sont prêts à disparaître:
Leur cours précipité paſſe comme le vent, S’ils éclatent, ils ſont demain dans le neant.	Leur cours précipité passe comme le vent, S'ils éclatent, ils sont demain dans le néant.
On les appelle en Cour éponges ordinaires, Qui ſont de cent grands biens ſimples dépoſitaires, Et dont au cas urgent, ou maxime d’Eſtat, La dépoüille s’appreſte au gré du Potentat, Ce ſont dans le beſoin des reſourees fort ſûres, Et l’on conte pour rien ces ſortes de captures.	On les appelle en Cour éponges ordinaires, Qui sont de cent grands biens simples dépositaires, Et dont au cas urgent, ou maxime d'État, La dépouille s'apprête au gré du Potentat, Ce sont dans le besoin des resourees fort sûres, Et l'on conte pour rien ces sortes de captures.
Qu’omne m’en parle plus.	Qu'omne m'en parle plus.
Enfin ce vieux rêveur Infatué du faſte & du ſot point d’honneur, Demande un Gentilhomme, ou du moins qu’à l’armée Son gendre ſoit en fonds d’un peu de renommée.	Enfin ce vieux rêveur Infatué du faste et du sot point d'honneur, Demande un Gentilhomme, ou du moins qu'à l'armée Son gendre soit en fonds d'un peu de renommée.
Croyez-vous là deſſus le pouvoir contenter?	Croyez-vous là -dessus le pouvoir contenter?
vous arer tant deiprit, il faut encor tenter.	vous arer tant deiprit, il faut encor tenter.
Aviſez promptement, l’occaſion eſt belle, Prenez un vêtement à la mode nouvelle;	Avisez promptement, l'occasion est belle, Prenez un vêtement à la mode nouvelle;
Ne vous connoiſſant plus, vous pourrez lans façon Couvert d’une autre ſorte entrer dans ſa maiſon.	Ne vous connaissant plus, vous pourrez lans façon Couvert d'une autre sorte entrer dans sa maison.
PHILANDRE.	PHILANDRE.
Je t’entends bien Ormin, & je puis bien ſans peine Sous un déguiſement faire le Capitaine.	Je t'entends bien Ormin, et je puis bien sans peine Sous un déguisement faire le Capitaine.
ORMIN.	ORMIN.
Ouy, cela ſe peut faire auſſi toſt qu’un Commis?	Oui, cela se peut faire aussi tôt qu'un Commis?
PHILANDRE.	PHILANDRE.
je veux uile en prenant un habillement gris.	je veux uile en prenant un habillement gris.
ORMIN.	ORMIN.
Et quel nom prendrez-vous?	Et quel nom prendrez-vous?
PHILANDRE.	PHILANDRE.
Ou quelqu’autre à ton choix.	Ou quelque autre à ton choix.
ccruy de la l'aillade,	ccrui de la l'aillade,
ORMIN.	ORMIN.
Ce nom ſent la bravade;	Ce nom sent la bravade;
On n’euſt pû mieux choiſir pour un nom d’Officier, Ce tître relevé ne marque qu’un Guerrier.	On n'eût pu mieux choisir pour un nom d'Officier, Ce tître relevé ne marque qu'un Guerrier.
Or puiſqu’il eſt ainſi, Monſieur de la Taillade, Endoſſez vôtre bufle, & prenez vôtre eſpade, Et dans cee equipuge em orare Comiirandaut, Aller à ce penart porter un compliment.	Or puisqu'il est ainsi, Monsieur de la Taillade, Endossez votre buffle, et prenez votre espade, Et dans ece équipuge em orare Comiirandaut, Aller à ce pénart porter un compliment.
vous attendray je icy dans mon humeur guerriere?	vous attendrai -je ici dans mon humeur guerrière?
PHILANDRE.	PHILANDRE.
Non, va-t’en au logis, je ne tarderay guere.	Non, va-t-en au logis, je ne tarderai guère.
RMIN à part.	RMIN à part.
Amour qui m’as réduite à ce funeſte ſort, Aide à mon ſtratagême, ou me donne la mort.	Amour qui m'as réduite à ce funeste sort, Aide à mon stratagème, ou me donne la mort.
PHILANDRE retonrnant.	PHILANDRE retonrnant.
j’oubne à t’avertit d’aller tout à cette heure Trouver le Devineur.	j'oubne à t'avertit d'aller tout à cette heure Trouver le Devineur.
Sçais tu bien ſa demeure?	Sais -tu bien sa demeure?
Si tu ne la ſçais pas tu peux la demander, C’eſt auprés du carfour;	Si tu ne la sais pas tu peux la demander, C'est auprès du carrefour;
il ne faut pas tarder.	il ne faut pas tarder.
ORMIN.	ORMIN.
Bien, Monſieur, ça, j’y cours;	Bien, Monsieur, ça, j'y cours;
mais que luy dois-je dire?	mais que mille dois-je dire?
Eſt ce ſur vôtre hymen quelque choſe à preſcrire?	Est -ce sur votre hymen quelque chose à prescrire?
PHILANDRE.	PHILANDRE.
Dy luy que de ma part un ſecret important Fait que je veux le voir, & s’il peut à l’inſtant.	Dis ainsi que de ma part un secret important Fait que je veux le voir, et s'il peut à l'instant.
SCENE III.	SCÈNE III.
PALMIRE, ORMIN.	PALMIRE, ORMIN.
ORM IN ſoûriant.	ORM IN souriant.
Entrez Mouſieur Palmire.	Entrez Mousieur Palmire.
EIIDMTRE.	EIIDMTRE.
Ah!	Ah!
c’eſt toy meſme, Otmin, ſans que je t’ay vû rire, je ne ſçavois ma foy quel ſangage tenir.	c'est toi -même, Otin, sans que je t'ai vu rire, je ne savais ma foi quel sangage tenir.
ORMI N.	ORMI N.
Philandre de ces lieux ne fait que de ſortir.	Philandre de ces lieux ne fait que de sortir.
PALMIRE.	PALMIRE.
Mais d’où vient cét habit & tout cét équipage?	Mais d'où vient cet habit et tout cet équipage?
Vas tu dans quelque Bal joüer un perſonnage, Nous voicy dans le temps?	Vas tu dans quelque Bal joüer un personnage, Nous voici dans le temps?
ORMIN.	ORMIN.
Je croy que vous rêvez;	Je crois que vous rêvez;
Eſt ce le compliment que vous me réſervez?	Est -ce ce compliment que vous me réservez?
Aprés avoir pour vous épuiſé mon génie, Du plus grand ſerieux vous faites raillerie.	Après avoir pour vous épuisé mon génie, Du plus grand sérieux vous faites raillerie.
PALMIRE.	PALMIRE.
n dieu ne plalie, Oimin, ce Iuoit changement M’a cauſé, je l’avouë, un peu d’étonnement.	 dieu ne plalie, Oimin, ce Juait changement M'a causé, je l'avoue, un peu d'étonnement.
Ailleurs qu’icy mes yeux n’auroient pû te connoître Dans ce déguiſement oû je te voy paroître.	Ailleurs qu'ici mes yeux n'auraient pu te connaître Dans ce déguisement ouïru je te paraître.
Je ſuis homme d’honneur;	Je suis homme d'honneur;
ce que je t’ay promis.	ce que je t'ai promis.
ORMIN.	ORMIN.
Briſons-là, ce n’eſt pas tout à fait où j’en ſuis.	Brisons-là, ce n'est pas tout à fait où j'en suis.
Bien donc.	Bien donc.
PALMIRE.	PALMIRE.
ORMIN.	ORMIN.
Vous apprendrez que mon Maître Philandre, Qui ſe veut marier, ma fait malgré moy prendre Cette hient parure ce cet haoit d’honneur, Pour eſtre de ſes vœux l’unique ambaſſadeur.	Vous apprendrez que mon Maître Philandre, Qui se veut marier, ma fait malgré moi prendre Cette hient parure ce cet haait d'honneur, Pour être de ses vœux l'unique ambassadeur.
FALMINE.	FALMINE.
Mais quel fruit en axt il ?	Mais quel fruit en axt -il ?
ORMIN.	ORMIN.
Nommant le perſonnage, Le prétendu beaupere a tourné le viſage, Et m’a dit, ouy, Monſieur, je vous ſuis obligé;	Nommant le personnage, Le prétendu beaupère a tourné le visage, Et m'a dit, oui, Monsieur, je vous suis obligé;
Mais ma fille à l’hymen n’a pas encor ſongé.	Mais ma fille à l'hymen n'a pas encor songé.
Avecque ce ſuccez digne de ſon mérite, Au ſortir j’ay repris mon chemin au plus vîte, Pour luy venir conter cet outrageant refus;	Avec ce succès digne de son mérite, Au sortir j'ai repris mon chemin au plus vite, Pour lui venir conter cet outrageant refus;
Mais loin de s’en fâcher & d’en eſtre confus, Il m’a fait redoubler cette meſme ambaſſade, Où j’ay derechef eu la meſme rébuffade, En des termes ſi crus, avec tant de mépris, Que moy-meſme pour luy j’en ſuis encor ſurpris.	Mais loin de s'en fâcher et d'en être confus, Il m'a fait redoubler cette seule ambassade, Où j'ai derechef eu la même rébuffade, En des termes si crus, avec tant de mépris, Que moi-même pour donner j'en suis encor surpris.
’ay prévû que ce coup ouvroit à vôtre affaire Un chemin qui pouvoit en bref vous ſatisfaire.	U'ai prévu que ce coup ouvrait à votre affaire Un chemin qui pouvait en bref vous satisfaire.
J’ay feint pour cét effet que Maſcarille entier Inſiſtoit à haïr le nom de Financier, Et quoy qu’on puiſſe dire à ce mot d’importance, Qu’il ne le ſupportoit qu’avec impatience, Tant ce nom luy déplaiſt;	J'ai feint pour cet effet que Mascarille entier Insistait à haïr le nom de Financier, Et quoi qu’on puisse dire à ce mot d'importance, Qu'il ne le supportait qu'avec impatience, Tant ce nom lui déplaît;
mais qu’un homme d’honneur, Soit noble, ſoit guerrier, pourroit gagner ſon cœut.	mais qu'un homme d'honneur, Soit noble, soit guerrier, pourrait gagner son cœut.
S’il ne tient qu’à cela, m’a repliqué Philandre, Je prétends, cher Ormin, eſtre bientoſt ſon gendre.	S'il ne tient qu'à cela, m'a repliqué Philandre, Je prétends, cher Ormin, être bientôt son gendre.
On fait tout ce qu’on veut par l’éclat de l’argent, Aujourd’huy je ſuis Noble, & demain Commandant.	On fait tout ce qu'on veut par l'éclat de l'argent, Aujourd'hui je suis Noble, et demain Commandant.
Sors d’icy promptement, va dire aMa Grippiere 2 Mon Commis, qu’il m’aporte une longue rapiere, Un Bufle, un Hauſſecol, enfin tous les atours Que portent dans le Camp nos Majors tous les jours.	Sors d'ici promptement, va dire aMa Gripière 2 Mon Commis, qu'il m'apporte une longue rapière, Un Buffle, un Haussecol, enfin tous les atours Que portent dans le Camp nos Majors tous les jours.
Traveſty de la ſorte il va chez Maſcarille J’ay conduit cette fourbe en ce malheur preſſant Pour nous en mieux aider par ſon déguiſement.	Travesti de la sorte il va chez Mascarille J'ai conduit cette fourbe en ce malheur pressant Pour nous en mieux aider par son déguisement.
Il eſt temps ou jamais de joüer nôtre rolle, Sur tout prenez bien garde à la moindre parole;	Il est temps ou jamais de joüer notre rolle, Sur tout prenez bien garde à la moindre parole;
Retournez promptement vous mettte en Officier, Et vous nommez tout haut Monſieur le Brigadier;	Retournez promptement vous mette en Officier, Et vous nommez tout haut Monsieur le Brigadier;
Deux ſoldats ſoffiront pour faire vôtre eſcorte, L’ordre ſera donné pour vous ouvrir la porte, Vous ne manquerez pas d’y trouver ce Monſieur, Dont vous vous ſaiſirez comme d’un deſerteur, La ruſe en eſt facile & le tour manifeſte;	Deux soldats solffiront pour faire votre escorte, L'ordre sera donné pour vous ouvrir la porte, Vous ne manquerez pas d'y trouver ce Monsieur, Dont vous vous saisirez comme d'un déserteur, La ruse en est facile et le tour manifeste;
Obſervez bien cela, je vous répons du reſte;	Observez bien cela, je vous réponds du reste;
La Taillade eſt ſon nom que vous devez ſçavoir.	La Taillade est son nom que vous devez sçavoir.
PALMIRE, Et toy que feras tu?	PALMIRE, Et toi que feras -tu?
ORMIN.	ORMIN.
Je feray mon devoïr.	Je ferai mon devoïr.
Sçachez qu’en vous fervant vous me ſervez de meſme, Et que de là dépend nôtre bonheur extréme:	Sachez qu'en vous servant vous me servez de même, Et que de là dépend notre bonheur extrême:
Vôtre ſort & le mien ont ui enenainement, Et pour nous rendre heureux il ne faut qu’un momẽt.	Votre sort et le mien ont ui enenainement, Et pour nous rendre heureux il ne faut qu'un moment.
PALMIRE.	PALMIRE.
je ne puis penêtrer dans toute ta penſée, Et de tes derniers mots j’ay l’ame embaraſſée.	je ne puis penêtrer dans toute ta pensée, Et de tes derniers mots j'ai l'âme embarrassée.
ORMIN.	ORMIN.
Je les expliqueray, tantoſt vous les ſçaurez, Quand de nôtre bonbeur nous ſerons aſſurez.	Je les expliquerai, tantôt vous les saurez, Quand de notre bonbeur nous serons assurés.
PALMIRE.	PALMIRE.
Que ne te dois-je point !	Que ne te dois-je point !
RMIN.	RMIN.
Laiſſons-là je vous prie Tous vos remercimens aprés la Comedie;	Laissons-là je vous prie Tous vos remerciments après la Comédie;
Faites de vôtre part tout ce que je vous dis, Et nos ſouhaits ſeront dans ce jour accomplis.	Faites de votre part tout ce que je vous dis, Et nos souhaits seront dans ce jour accomplis.
Seul.	Seul.
Quoy!	Quoi!
mon frete n’a pû jamais me reconnoître Sous ce déguiſement où l’on me voit paroître!	mon frèrete n'a pu jamais me reconnaître Sous ce déguisement où l'on me voit paraître!
Il faut avoir ſurpris adroitement ſes yeux;	Il faut avoir surpris adroitement ses yeux;
Et ceux de mon ingrat n’ont pas pénétré mieux;	Et ceux de mon ingrat n'ont pas pénétré mieux;
Il eſt vray qu’il me croit dans la demeure ſombre Où de nous en mourant il ne reſte qu’une ombre;	Il est vrai qu'il me croit dans la demeure sombre Où de nous en mourant il ne reste qu'une ombre;
Mais puiſque je ſurvis a mon fatal malheur, Je dois porter un fete a vanger dhe ſœur.	Mais puisque je survis a mon fatal malheur, Je dois porter un fète a venger dhe sœur.
Fin du premier Acte.	Fin du premier Acte.
ACTE II.	ACTE II.
SCENE PREMIERE.	SCÈNE PREMIÈRE.
ORMIN, CRISPIN.	ORMIN, CRISPIN.
ORMIN bas IEN ne peut égaler l’excez de ſon offence, Et quoy qu’il en arrive il faut rompre ſilẽce.	ORMIN bas JEN ne peut égaler l'excès de son offense, Et quoi qu'il en arrive il faut rompre silence.
Criſpin, je te rencontre icy fort à propos.	Crispin, je te rencontre ici fort à propos.
40 RISPIN.	40 RISPIN.
Parle, que me veux-tu?	Parle, que me veux-tu?
ORMIN.	ORMIN.
Te dire quatre mots;	Te dire quatre mots;
C’eſt icy que Palmire a beloin dé ton zéle;	C'est ici que Palmire a beloin de ton zèle;
Et moy qui te connois fort diſcrer & fidelle, De tous les ſerviteurs le plus prompt & ſubtil, Je te choiſis exprés.	Et moi qui te connais fort discrer et fidèle, De tous les serviteurs le plus prompt et subtil, Je te choisis exprès.
CRIOIIII.	CRIOIII.
Dequoy donc s’agit il?	Dequoy donc s'agit -il?
ORMIN.	ORMIN.
D’empeſcher promptement l’hymen qui ſe va faire De Philandre & d’Arminde.	D'empêcher promptement l'hymen qui se va faire De Philandre et d'Arminde.
CRISPIN.	CRISPIN.
Eh!	Eh!
qui peut le contraire?	qui peut le contraire?
ORMIN.	ORMIN.
Faiſant de point en point ce que je te diray, La lepcar detouinel.	Faisant de point en point ce que je te dirai, La lepar détouinel.
2 CRISPIN.	2 CRISPIN.
Bien donc, parle, & j’iray?	Bien donc, parle, et j'irai?
Mais ne t’amuſe pas à me faire une piece.	Mais ne t'amuse pas à me faire une pièce.
ORMIN.	ORMIN.
Non, c’eſt pour emierer une jeune Maitreſſe Que ton Maître ne peut avoir ſans ton ſecours.	Non, c'est pour emièrer une jeune Maitresse Que ton Maître ne peut avoir sans ton secours.
Tn.	Tn.
IN.	IN.
Puiſque c’eſt tout de bon, dy moy vîte, & j’y cours.	Puisque c'est tout de bon, dis -moi vite, et j'y cours.
ORMIN.	ORMIN.
Il faut auparavant que tu ſçaches l’affaire, Qui fait toute ma honte, & qui me deſeſpere.	Il faut auparavant que tu saches l'affaire, Qui fait toute ma honte, et qui me désespère.
Apprens-là donc Criſpin.	Apprends-là donc Crispin.
Ton innocente erreur De Palmire amoureux en moy trouve la ſœur;	Ton innocente erreur De Palmire amoureux en moi trouve la sœur;
Reconnois, cher Criſpin, la conſtante Roſelle Que le Traître Philandre autrefois trouva belle, Et qui depuis charmé de mille objets divers, En n’aimant rien du tout, aime tout l'Univers.	Reconnais, cher Crispin, la constante Roselle Que le Traître Philandre autrefois trouva belle, Et qui depuis charmé de mille objets divers, En n'aimant rien du tout, aime tout l'Univers.
Ta Sœur de nos amours fut ſeule confidenté, Lors qu’il ſçeut triompher de ma vertu mourante;	Ta Sœur de nos amours fut seule confidenté, Lors qu'il avait triompher de ma vertu mourante;
Regarde de ſa foy le gage infortuné, L’Anneau qui de fa part alors me fut donné, Ou plûtoſt d’un Tyran indigne de la vie, L’inſtrument qui fait voir la noire perfidie.	Regarde de sa foi le gage infortuné, L'Anneau qui de fa part alors me fut donné, Ou plutôt d'un Tyran indigne de la vie, L'instrument qui fait voir la noire perfidie.
Aprés avoir long-temps, mais inutilement Attendu le retour de cét ingrat amant;	Après avoir longtemps, mais inutilement Attendu le retour de cet ingrat amant;
Connoiſſant qu’il brûloit d’une nouvelle flame, Et qu’il avoit banny la raiſon de ſon ame, Un jaloux deſeſpoir m’obligea de tenter Tout ce que ma vengeance a voulu me dicter;	Connaissant qu'il brûlait d'une nouvelle flamme, Et qu'il avait banni la raison de son âme, Un jaloux désespoir m'obligea de tenter Tout ce que ma vengeance a voulu me dicter;
Et comme tout mon ſoin à le perdre s’applique, Je me ſuis traveſtie en ſimple domeſtique, Pour plus facilement découvrir ſes amouts, Et s’il ſe peut enfin en prévenir le cours.	Et comme tout mon soin à le perdre s'applique, Je me suis travestie en simple domestique, Pour plus facilement découvrir ses amouts, Et s'il se peut enfin en prévenir le cours.
To ne me répouds rien, quer tiouble te luimonte?	To ne me répouds rien, quer toujours te luimonte?
CRISPIN.	CRISPIN.
Je n’en ſçais rien, ſinon que je rougis de honte;	Je n'en sais rien, sinon que je rougis de honte;
N’importe, puiſque c’eſt pour le meſme intereſt, Roſelle, vous ſervir eſt tout ce qui me plaiſt.	N'importe, puisque c'est pour le même intérêt, Roselle, vous servir est tout ce qui me plaît.
Que ne m’eſt-il permis d’attaquer le perfide!	Que ne m'est-il permis d'attaquer le perfide!
Vous verriez à l’inſtant un courage intrépide, Qui prendroit tout le ſoin qu’il faut pour vous vanger.	Vous verriez à l'instant un courage intrépide, Qui prendrait tout le soin qu'il faut pour vous venger.
ORMIN.	ORMIN.
Je ne cherche, Criſpin, rien qu’à me ſoulager.	Je ne cherche, Crispin, rien qu'à me soulager.
Retien toy, mais ſur tout prens garde à ne rien dire De mon déguiſement à mon frere Palmire;	Retien toi, mais sur tout prends garde à ne rien dire De mon déguisement à mon frère Palmire;
Il n’eſt pas encor temps qu’il le doive ſçavoir, A moins que mon ingrat n’oubliaſt ſon devoir.	Il n'est pas encor temps qu'il le doive sçavoir, À moins que mon ingrat n'oubliât son devoir.
Philandre ſe croyant prés de ſon hymenée, Et dans une heure au plus l’affaire terminée, A changé d’équipage, & dans un autre eſtat, D’un Commandant d’armée affecte icy l’éclat.	Philandre se croyant près de son hyménée, Et dans une heure au plus l'affaire terminée, A changé d'équipage, et dans un autre état, D'un Commandant d'armée affecte ici l'éclat.
Sa curioſité toûjours extravagante, Autant que ſon amour, pour moy fut inconſtante, D’un Nécromancien veut avant tout ſçavoir Quel bon ou mauvais ſort ſon hymen doit avoir.	Sa curiosité toujours extravagante, Autant que son amour, pour moi fut inconstante, D'un Nécromancien veut avant tout sçavoir Quel bon ou mauvais sort son hymen doit avoir.
C’eſt-là le dernier coup dont mon eſpoir ſe flate;	C'est-là le dernier coup dont mon espoir se flatte;
C’eſt là qu’il faut auſſi que ton adreſſe éclate;	C'est là qu'il faut aussi que ton adresse éclate;
Tu ne t’en peux dédire, il faut, mon cher Criſpin, Qu’en ce jour on te voye & prophete & devin.	Tu ne t'en peux dédire, il faut, mon cher Crispin, Qu'en ce jour on te voie et prophète et devin.
Ne me refuſe pas cette faveur derniere, Je te ſatisferay de la belle maniere.	Ne me refuse pas cette faveur dernière, Je te satisferai de la belle manière.
Va prendre un habit noir, & reviens ſur tes pas, L afaile prelle.	Va prendre un habit noir, et reviens sur tes pas, L' afaile prélle.
RISPIN.	RISPIN.
Soit, je n’y manqueray pas:	Soit, je n'y manquerai pas:
Auſſi-bien ſuis-je expert dans la blanche magie, Et je me meſle un peu de la Chiromancie.	Aussi-bien suis-je expert dans la blanche magie, Et je me mêle un peu de la Chiromancie.
ORMIN.	ORMIN.
Sauve toy, je l’ertends.	Sauve toi, je l'ertends.
CRISPIN.	CRISPIN.
Je vay me traveſtir, Et dans quelques moments ſans faute revenir.	Je vais me travestir, Et dans quelques moments sans faute revenir.
SCENE II.	SCÈNE II.
PIILANDRE, ORMIN.	PIILANDRE, ORMIN.
TMILANDRE.	TMILANDRE.
Rmin, as-tu trouvé ce Diſeur d’avanture?	Rmin, as-tu trouvé ce Dis d'aventure?
ORMIN.	ORMIN.
Ou plûtoſt cét Oiſeau de malheureux augure, Ce Diable déchainé, Sorcier, Magicien, Pour tout dire en un mot ce Nécromancien.	Ou plutôt cet Oiseau de malheureux augure, Ce Diable déchaîné, Sorcier, Magicien, Pour tout dire en un mot ce Nécromancien.
J’en tremble de frayeur;	J'en tremble de frayeur;
ô Dieux!	ô Dieux!
le vilain homme, S’il me revoit jamais je veux bien qu’on m’aſſomme, Ne m’y renvoyez plus, ou je vous quitteray;	le vilain homme, S'il me revoit jamais je veux bien qu'on m'assomme, Ne m'y renvoyez plus, ou je vous quitterai;
RonrtearRalle fajet je vous ouelay	RonrtearRalle fajet je vous ouelai
PHILANDRE.	PHILANDRE.
Qu’as-tu vû?	Qu'as-tu vu?
d’où te vient cette terreur panique?	d'où te vient cette terreur panique?
Parle moy nettement, je veux que l’on s’explique,	Parle moi nettement, je veux que l'on s'explique,
ORMIN.	ORMIN.
Un Savetier, Monſieur, parlant avec honheur, M’ayant montré de loin où vôtre Devineur Avoit accoûtumé de faire réſidence.	Un Savetier, Monsieur, parlant avec honheur, M'ayant montré de loin où votre Devineur Avait accoutumé de faire résidence.
Afin de debiter ſa damnable Science;	Afin de débiter sa damnable Science;
Comme je m’en allois pour lever le marteau, Une vieille ſans dents m’a dit, mon fils, tout beau:	Comme je m'en allais pour lever le marteau, Une vieille sans dents m'a dit, mon fils, tout beau:
Vous venez, je le ſçay, de la part de Philandre Voir Monſieur Palemon;	Vous venez, je le sais, de la part de Philandre Voir Monsieur Palemon;
entrez il va deſcendre;	entrez il va descendre;
Je la ſuis pas à pas, & marchant lentement Je paſſe dans l'horreur de ſon appartement.	Je la suis pas à pas, et marchant lentement Je passe dans l'horreur de son appartement.
Elle m’ouvre à la fin la Salle de derriére, Où jamais en plein jour on ne voit de lumiere, Mais une Lampe obſcure y jette un jour épais, Dont à peine on pourroit diſtinguer les objets.	Elle m'ouvre à la fin la Salle de derrièvre, Où jamais en plein jour on ne voit de lumière, Mais une Lampe obscure y jette un jour épais, Dont à peine on pourrait distinguer les objets.
Quelques moments aprés un homme épouventable M’ã juſtement paru comme on dépeint un Diable;	Quelques moments après un homme épouventable M'à justement paru comme on dépeint un Diable;
Sa barbe d’un grand pied pour le moins en longueur, A ſa noire Soutane eſt égale en couleur;	Sa barbe d'un grand pied pour le moins en longueur, À sa noire Soutane est égale en couleur;
Un grand chapeau qu’il tient enfoncé ſur ſa tête Redouble la laideur de cetre horrible bête:	Un grand chapeau qu'il tient enfoncé sur sa tête Redouble la laideur de cetre horrible bête:
Les yeux colez à terre, & toûjours marmotant Des termes inconnus que perſonne n’entend, Il s’eſt à meſme temps aſſis dans uue chaiſe, Tenant un gros chat noir qu’il careſſe & qu’il baiſe.	Les yeux colés à terre, et toujours marmotant Des termes inconnus que personne n'entend, Il s'est à même temps assis dans uve chaise, Tenant un gros chat noir qu'il caresse et qu'il baise.
Enfin auprés de luy j’ay fait tout mon devoir, Diſant que vous aviez grand deſir de le voir.	Enfin auprès de belle j'ai fait tout mon devoir, Disant que vous aviez grand désir de le voir.
Je connois, m’a-t-il dit, le ſujet de ſa peine, Et je puis l’éclaircir du trouble qui le gêne:	Je connais, m'a-t-il dit, le sujet de sa peine, Et je puis l'éclaircir du trouble qui le gêne:
Mais vous qui dans ce trouble avez plus d’intéreſt, Si vous voulez m’aimer, vous ſçaurez quel il eſt, C’eſt un ſecret qui doit contenter vôtre envie, Puiſque de vos ſouhaits elle ſera ſuivie.	Mais vous qui dans ce trouble avez plus d'intérêt, Si vous voulez m'aimer, vous saurez quel il est, C'est un secret qui doit contenter votre envie, Puisque de vos souhaits elle sera suivie.
A ces mots ſur mon front une froide ſueur M’a fait preſque tomber de foibleſſe & de peur.	À ces mots sur mon front une froide sueur M'a fait presque tomber de faiblesse et de peur.
Luy, voyant à quel point mon ame s’eſt troublée A ſoudain appelé cette vieille endiablée, Qui poulme fandier a rant tous les enerts, Mais rien juſques à temps que j’aye eſté dehors.	Lui, voyant à quel point mon âme s'est troublée A soudain appelé cette vieille endiablée, Qui poulme fandier a rant tous les enerts, Mais rien jusqu' à temps que j'aie été dehors.
La vieille enfin m’a dit que ſans vous faire attendre Il ne manquera pas prés de vous de ſe rendre;	La vieille enfin m'a dit que sans vous faire attendre Il ne manquera pas près de vous de se rendre;
J’en ſuis à demy mort.	J'en suis à demi mort.
PHILANDRE.	PHILANDRE.
Ce n’eſt rien que cela;	Ce n'est rien que cela;
C’eſt l'ordinaire abord de toutes ces gens-là.	C'est l'ordinaire abord de toutes ces gens-là.
Ormin, retire-toy, le voicy qui s’avance;	Ormin, retire-toi, le voici qui s'avance;
Qu'on nous laiſſe icy ſeuls.	Qu'on nous laisse ici seuls.
C ij	Ç ij
SCENE III.	SCÈNE III.
PHIDAADRE, IALEMON.	PHIDADRE, IALEMON.
PHILANDRE.	PHILANDRE.
MOnſeur, la connoiſſancs Que vous donne vôtre Ait des choſes t ienir, Me fait vous conſulter pour vous entretenir D’un ſcrupule importun dont la fin m'embaraſſe.	MOnseur, la connaissancs Que vous donne votre Ait des choses t ienir, Me fait vous consulter pour vous entretenir D'un scrupule importun dont la fin m'embarrasse.
POLEMON.	POLEMON.
Il n’eſt rien que pour vous volontiers je ne faſſe;	Il n'est rien que pour vous volontiers je ne fasse;
Vous n’avez qu’à parler, & me preſcrire en quoy Vôtre eſprit inquiet veut ſe ſervir de moy.	Vous n'avez qu'à parler, et me prescrire en quoi Votre esprit inquiet veut se servir de moi.
Je puis tout ſur les Cieux, ſur la Terre & ſur l’Onde, Et ſoûmets à mon gié cette Machine ronde;	Je puis tout sur les Cieux, sur la Terre et sur l'Onde, Et soumets à mon gié cette Machine ronde;
Je diſpoſe de l’air ainſi que ie le veux, Tantoſt je le rends clair, & tantoſt ténébreux;	Je dispose de l'air ainsi que tu le veux, Tantôt je le rends clair, et tantôt ténébreux;
Dans le plus grand ſerain j’amene les nuages, Je fais fondre où je veux les plus rudes orages, La foudre & les carreaux ſont par moy balancez, Et c’eſt où j’ay voulu qu’ils ont eſté lancez.	Dans le plus grand serain j'amène les nuages, Je fais fondre où je veux les plus rudes orages, La foudre et les carreaux sont par moi balancés, Et c'est où j'ai voulu qu'ils ont été lancez.
Je ſçay les qualitez de toutes les Planettes, Des Conſtellations, des Signes, des Comettes;	Je sais les qualités de toutes les Planètes, Des Constellations, des Signes, des Comettes;
Je puis les faire agir, je puis les détourner, Guerir par mes ſecrets les maux ou les donner;	Je puis les faire agir, je puis les détourner, Guérir par mes secrets les maux ou les donner;
Eteindre ou faire naître une flame nouvelle, De deux Amants unis rompre le nœud fidelle.	Éteindre ou faire naître une flamme nouvelle, De deux Amants unis rompre le nœud fidèle.
Les Philtres amoureux, les Compoſitions, Les Anneaux conſtellez, les incantations, La Poudre ſympathique, & tous les venefices Sont de nôtre métier les premiers exercices, Pour pouvoir pénétrer dans le ſort des Amants, Nous avons le ſecours de tous les Taliſments;	Les Philtres amoureux, les Compositions, Les Anneaux constellez, les incantations, La Poudre sympathique, et tous les venefices Sont de notre métier les premiers exercices, Pour pouvoir pénétrer dans le sort des Amants, Nous avons le secours de tous les Talisments;
Le Secret du Tranſport, & la Lycanthropie Font le plus haut degré de nôtre Art ou Magie:	Le Secret du Transport, et la Lycanthropie Font le plus haut degré de notre Art ou Magie:
Nous pouvons ſans ſcrupule à preſent profeſſer Cette haute Science, & meſme l’exercer, Depuis que quelques fous en ont fait raillerie, Et vouloient la traiter de pure réverie;	Nous pouvons sans scrupule à présent professer Cette haute Science, et même l'exercer, Depuis que quelques fous en ont fait raillerie, Et voulaient la traiter de pure réverie;
Grace a leur ignorance & caprice brutal, Quoy qu’il en ſoit, cela ne nous fait point de maſJe poſſede une force à nulle autre commune, rour pirant la conne ou mauvaiſe fortune.	Grâce à leur ignorance et caprice brutal, Quoi qu'il en soit, cela ne nous fait point de mase possède une force à nulle autre commune, rour pirant la conne ou mauvaise fortune.
PHILANDRE.	PHILANDRE.
Alletel, c’eit tout drojt ou le vous actendoros.	Alletel, c'éit tout drojt ou le vous actendoros.
POLEMON.	POLEMON.
Je vous ſatisferay, Monſieur, comme je dois,	Je vous satisferai, Monsieur, comme je dois,
PHILANDRE.	PHILANDRE.
Puiſqu’il faut qu’à l’hymen aujourd’huy je m’engage, Je vous veux conſuiter touchant mon mariage, Et comme ce paſſage eſt un peu dangereux, Qu’il fait péu de contents, & bien des malheureux, Moy dans l’âge où je ſuis, riche & fort à mon aiſe, Je ne me veux charger de rien qui me déplaiſe;	Puisqu'il faut qu'à l'hymen aujourd'hui je m'engage, Je vous veux consuiter touchant mon mariage, Et comme ce passage est un peu dangereux, Qu'il fait pévu de contents, et bien des malheureux, Moi dans l'âge où je suis, riche et fort à mon aise, Je ne me veux charger de rien qui me déplaise;
Je cherche ſeulement de l’amour, du plaiſir, Et rien qui puiſſe faire obſtacle à mon deſir.	Je cherche seulement de l'amour, du plaisir, Et rien qui puisse faire obstacle à mon désir.
Arminde, je l’avouë, eſt aſſez jeune & belle, Mais ſi je prétendois qu’elle fuſt infidelle, Qu’elle puſt écouter quelqu’un à ſes geuoux, Ma foy dés à preſent je ne ſuis plus époux.	Arminde, je l'avoue, est assez jeune et belle, Mais si je prétendais qu'elle fût infidèle, Qu'elle pût écouter quelqu'un à ses guoux, Ma foi dès à présent je ne suis plus époux.
Jadis je me meſlois de la galanterie, Et faiſois de bon coups dans la coquetterie;	Jadis je me mêlais de la galanterie, Et faisais de bon coups dans la coquetterie;
Mais à preſent je veux de ſolides amours Pour paſſer ſans chagrin le reſte de mes jours.	Mais à présent je veux de solides amours Pour passer sans chagrin le reste de mes jours.
Deux ans ſe ſont paſſez depuis qu’une Roſelle En eut pour m’avoir crû bien avant dedans l’aîle.	Deux ans se sont passez depuis qu'une Roselle En eut pour m'avoir cru bien avant dedans l'aîle.
On pourroit m’accuſer d’un peu de cruauté, Mais on rit à preſent de l’infidelité.	On pourrait m'accuser d'un peu de cruauté, Mais on rit à présent de l'infidélité.
Aprés m’eſtre emparé de toute ſa tendreſſe, Ne la traitant qu’en femme & non plus en maîtreſſe, Mon cœur ſe trouva las de ſe voir enchaîné, Je partis ſans rien dire, & je l’abandonnay;	Après m'être emparé de toute sa tendresse, Ne la traitant qu'en femme et non plus en maîtresse, Mon cœur se trouva las de se voir enchaîné, Je partis sans rien dire, et je l'abandonnai;
Je n’en ay rien enſuite appris d’aucune ſorte, Sinon qu’en accouchant on m’a dit qu’elle eſt morte.	Je n'en ai rien ensuite appris d'aucune sorte, Sinon qu'en accouchant on m'a dit qu'elle est morte.
Dites-moy promptement que doit il arriver De celle que le ſort m’a voulu réſerver?	Dites-moi promptement que doit -il arriver De celle que le sort m'a voulu réserver?
PALEMON.	PALÉMON.
Auparavant, Monſieur, que de vôtre avanture ye pume decourmn la momdre conjecture, ’ay befoin du ſecours de quatre Farfadets, Qui pour mieux deviner me fervent de valets.	Auparavant, Monsieur, que de votre aventure ie pume décourmn la femme conjecture, 'ai besoin du secours de quatre Farfadets, Qui pour mieux deviner me fervent de valets.
Il frappe du pied.	Il frappe du pied.
Venez mes Confidents, accourez à cette heure, Quittez pour un moment vôtre noire demeure.	Venez mes Confidents, accourez à cette heure, Quittez pour un moment votre noire demeure.
Alinmepmompant puroiſt fortant ue deſſous le Theatre une table couverte de noïr, un miroir appuyé par un tnat, (e d'nne patte tenant nne Sphere, & quatre Eutins en pantalons noirs, qui dan ent une entrée.	Alinmepmompant purait sortant ue dessous le Théâtre une table couverte de noïr, un miroir appuyé par un tnat, (e d'nne patte tenant nne Sphère, et quatre Eutins en pantalons noirs, qui dan ent une rée.
PHILANDRE.	PHILANDRE.
Les vilains Eſtaffiers, je tremble de frayeur.	Les vilains Étaffiers, je tremble de frayeur.
PALEMON.	PALÉMON.
Vous paroiſſez émû, raſſurez-vous, Monſieur.	Vous paraissez ému, rassurez-vous, Monsieur.
Ecoutez ſeulement des vers mis en muſique, Où le fatal arreſt de vôtre hymen s’explique;	Écoutez seulement des vers mis en musique, Où le fatal arrêt de votre hymen s'explique;
Tel le veulent les Dieux, & telle en eſt la loy;	Tel le veulent les Dieux, et telle en est la loi;
Ne me demandez pas ny comment, ny pourquoy.	Ne me demandez pas mieux comment, ni pourquoi.
Les Lutins après avoir dancé, chantent ces vers.	Les Lutins après avoir dancé, chantent ces vers.
Quand la rigueur du ſort a preſcrit une choſe, On luy réſiſte en vain, Il faut quoy qu’un amant dans ſon cœur ſe propoſe, Obeïr au deſtin.	Quand la rigueur du sort a prescrit une chose, On lui résiste en vain, Il faut quoi qu'un amant dans son cœur se propose, Obéir au destin.
Si ſa ſevere loy paroît inévitable, Ce n’eſt que pour un bien;	Si sa sévère loi paraît inévitable, Ce n'est que pour un bien;
Un Amant infidelle eſt toûjours trop coupable Quand il rompt ſon lien.	Un Amant infidèle est toujours trop coupable Quand il rompt son lien.
Quelque ſoin qu’il ait pris pour changer de Bergers Il n’y peut réüſſir, Et ſouvent il s’engage avecque la premiere, Quand il penſe la fuis.	Quelque soin qu'il ait pris pour changer de Bergers Il n'y peut réussir, Et souvent il s'engage avec la première, Quand il pense la fuis.
POLEMON.	POLEMON.
L’aſtre prédominant lors de vôtre naiſſance, phum fom e anſedenpende pomna votre espérance,	L'astre prédominant lors de votre naissance, phum fom e ansédenpende pomna votre espérance,
PHILANDRE.	PHILANDRE.
Seray-je donc cocu, Monſieur?	Serai-je donc cocu, Monsieur?
POLEMON.	POLEMON.
Je n’en dis rien?	Je n'en dis rien?
Non, ſi vous épouſez une fille de bien.	Non, si vous épousez une fille de bien.
DAAIDIRDRE.	DAIDIRDRE.
Qui donc de m’épouſer aura la préference?	Qui donc de m'épouser aura la préférence?
FOLEMON.	FOLEMON.
Une que vous traitez avec indifference.	Une que vous traitez avec indifférence.
Qui s’appelle?	Qui s'appelle?
PHILANDRE.	PHILANDRE.
POLEMON.	POLEMON.
Il n’eſt pas permis de la nommer, Il ſuffit qu’autrefois elle vous pût charmer.	Il n'est pas permis de la nommer, Il suffit qu'autrefois elle vous put charmer.
PIITLANDRE.	PIITLANDRE.
Quand la dois-je épouſer?	Quand la dois-je épouser?
POLEMON.	POLEMON.
Cette meſme journée Il faudra malgré vous en ſigner l’hymenée.	Cette même journée Il faudra malgré vous en signer l'hyménée.
PHILANDRÉ.	PHILANDRÉ.
Malgré moy?	Malgré moi?
non, cela ne ſe fera jamais, Je n’y ſouſcriray point, & je vous le promets.	non, cela ne se fera jamais, Je n'y souscrirai point, et je vous le promets.
Je prendrois par contrainte une fille inconnuë!	Je prendrais par contrainte une fille inconnue!
En l’art de deviner vous avez la berluë, Vous n’eſtes qu’un rêveur.	En l'art de deviner vous avez la berlue, Vous n'êtes qu'un rêveur.
POLEMON.	POLEMON.
Tout ce que vous voudrez, Le ſort l’ordonne, en vain vous luy réſiſterez.	Tout ce que vous voudrez, Le sort l'ordonne, en vain vous reste résisterez.
PHILANDRE.	PHILANDRE.
C’eſt donc pour me railler, infame Canibale Que tu viens des Enfers évoquer ta cabale:	C'est donc pour me railler, infâme Canibale Que tu viens des Enfers évoquer ta cabale:
Et vous petits Lutins, Farfadets, Lougaroux, Sçachez que j’ay des gens bien plus diables que vous, Que l’on faſſe venir mes quatre Rats de Cave, Grezillon, Happetout, la Montagne, Guſtave, Chaſſez-moy promptement tous ces monſtres hideux;	Et vous petits Lutins, Farfadets, Lougarroux, Sachez que j'ai des gens bien plus diables que vous, Que l'on fasse venir mes quatre Rats de Cave, Grezillon, Hapétout, la Montagne, Gustave, Chassez-moi promptement tous ces monstres hideux;
Ah!	Ah!
que je me repens d’eſtre ſi curieux!	que je me repens d'être si curieux!
Ces prédictions-là funeſtes & trompeuſes N’aportent d’autre fruit que des ſuites fâcheuſes.	Ces prédictions-là funestes et trompeuses N'apportent d'autre fruit que des suites fâcheuses.
Quatre Commis paroiſſent armez, à la veuë deſquels les Lutins diſparoiſſent.	Quatre Commis paraissent armés, à la vue desquels les Lutins disparaissent.
C’eſt aſſez, me voila défait de ces fripons;	C'est assez, me voilà défait de ces fripons;
Vous, quand j’appelleray, ſoyez un peu plus prompts.	Vous, quand j'appellerai, soyez un peu plus prompts.
a part.	à part.
Il faut donc aujourd’huy que Philandre s’engage.	Il faut donc aujourd'hui que Philandre s'engage.
Et que malgré ſes dents il ſigne au mariage;	Et que malgré ses dents il signe au mariage;
Je t’en feray mentir Charlatan, impoſteur, Ta ſcience n’eſt rien qu’un métier d’affronteur;	Je t'en ferai mentir Charlatan, imposteur, Ta science n'est rien qu'un métier d'affronteur;
Je te feray bien voir que ta noire ſoutane Dans l’Art de deviner ne couvre qu’un franc aſne, J’y donneray bon ordre, & je vay ſeulement Faire chez Maſcarille un ſimple compliment.	Je te ferai bien voir que ta noire soutane Dans l'Art de deviner ne couvre qu'un franc ordre, J'y donnerai bon ordre, et je vais seulement Faire chez Mascarille un simple compliment.
ACTE	ACTE
ACIE III.	ACIE III.
SCENE PREMIERE.	SCÈNE PREMIÈRE.
PALMIRE, ORMIN.	PALMIRE, ORMIN.
ONMIN.	ONMIN.
I je m’étois plus tard peut-eſtre déclarée, l’aurois crû lentrepriſe un peu moins aſſurée.	I je m'étais plus tard peut-être déclarée, l'aurais crû lentreprise un peu moins assurée.
PALMIRE.	PALMIRE.
Non, j’aurois achevé le deſſein entrepris Avec le meſme ſoin que je l’avois promis:	Non, j'aurais achevé le dessein entrepris Avec le Seigneur soin que je l'avais promis:
Mais je puis avoüer que dans cét équipage Je n’aurois pû jamais vous connoître au viſage.	Mais je puis avouer que dans cet équipage Je n'aurais pu jamais vous connaître au visage.
La taille ny la voix ne m’ont pas encor dit Que Roſelle à mes yeux paroiſſe en cét habit:	La taille mieux la voix ne m'ont pas encor dit Que Roselle à mes yeux paraisse en cet habit:
C’eſt dont vous avez pû tromper auſſi Philandre, Puiſqu’un frere en ſa ſœur a bien pû ſe méprendre.	C'est dont vous avez pu tromper aussi Philandre, Puisqu'un frère en sa sœur a bien pu se méprendre.
Mais puis qu’il faut agir, agiſſons de concert, Et montrons qu'a plopos ce enaugemient nous ſert5 La ruſe en eſt ſubtile, & tout ce qui m’étonne C’eſt que Philandre encor de rien ne vous ſoupçonne, Et que toute l’intrigue eſt conduite à ce point Qu’il ſe voit preſque pris, & ne le connoiſt point,	Mais puis qu'il faut agir, agissons de concert, Et montrons qu'a plopos ce enaugemient nous sert5 La ruse en est subtile, et tout ce qui m'étonne C'est que Philandre encor de rien ne vous soupçonne, Et que toute l'intrigue est conduite à ce point Qu'il se voit presque pris, et ne le connaît point,
ORMIN.	ORMIN.
Mais ſçachez que Criſpin, comme j’ay pû l’inſtruire, En faiſant le Devin a bien ſcû ſe conduire,	Mais sachez que Crispin, comme j'ai pu l'instruire, En faisant le Devin a bien su se conduire,
Et que par là Philandre eſt fort embaraſſé Autant ſur ſon hymen, que ſur le temps paſſé.	Et que par là Philandre est fort embarrassé Autant sur son hymen, que sur le temps passé.
Son eſprit inquiet ne ſçait ce qu’il doit faire, Et ce tour ne ſert pas moins à la ſœur qu’au frere.	Son esprit inquiet ne sait ce qu'il doit faire, Et ce tour ne sert pas moins à la sœur qu'au frère.
Mais j’apperçois Arminde & Beatrix auſſi.	Mais j'aperçois Arminde et Beatrix aussi.
PALMIRE.	PALMIRE.
Rolcile, lamebemoy fentieteun ley.	Rolcile, lamebemoi fentiéteun lei.
SCENE II.	SCÈNE II.
PALMIRESIMINDE, BEATRIX.	PALMIRESIMINDE, BEATRIX.
PALMIRE.	PALMIRE.
Uy, Madame, le feu qui-conſume mon ame, CA cent fois à vos yeux fait paroître ſa flame;	Oui, Madame, le feu qui-consume mon âme, CA cent fois à vos yeux fait paraître sa flamme;
Mais vous trouvant toûjours cette meſme froideur, J’ay fait de vains efforts pour vous toucher le cœur.	Mais vous trouvant toujours cette même froideur, J'ai fait de vains efforts pour vous toucher le cœur.
Malgré tous mes ennuis & ma perſéverance Garderez vous toûjours la meſme indifference?	Malgré tous mes ennuis et ma persévérance Garderez -vous toujours la même indifférence?
Ou quelqu’autre Rival plus fortuné que moy Pourra t-il ſe vanter d’engager vôtre foy?	Ou quelqu'autre Rival plus fortuné que moi Pourra t-il se vanter d'engager votre foi?
Dans un reſte d’eſpoir dont mon ame ſe flate, Permettez qu’aujourd’huy ma paſſion éclate, Et ne réduiſez pas juſqu’aux extrémitez Un amant qui ſçait trop ce que vous méritez.	Dans un reste d'espoir dont mon âme se flatte, Permettez qu'aujourd'hui ma passion éclate, Et ne réduisez pas jusqu'aux extrémités Un amant qui sait trop ce que vous méritez.
S’il n’a pas la fortune, il a de la naiſſance.	S'il n'a pas la fortune, il a de la naissance.
Et ſon cœur s’affermit ſur ſa propre conſtance.	Et son cœur s'affermit sur sa propre constance.
Quelque obſtacle qu’un pere oppoſe à ſon bonheur, Ce pere, comme vous, n’en connoiſt pas le cœur.	Quelque obstacle qu'un père oppose à son bonheur, Ce père, comme vous, n'en connaît pas le cœur.
Pour vous je ſerois preſt de tenter l’impoſſible, Et toutes vos froideurs me lonuene pras fennure.	Pour vous je serais prêt de tenter l'impossible, Et toutes vos froideurs me lonvène pras fennure.
Ouy, Madame, à vos pieds je vous en fais l’aveu, Et ne puis plus longremps vous cacher tout mon feu.	Oui, Madame, à vos pieds je vous en fais l'aveu, Et ne puis plus longmps vous cacher tout mon feu.
Je ſçay que le devoir qu’un pere vous ordonne, Eſt de ſuivre la loy qu’il preſcrit & qu’il donne;	Je sais que le devoir qu'un père vous ordonne, Est de suivre la loi qu'il prescrit et qu'il donne;
Mais le choix pour l’hymen eſt bien une autre loy, Elle dépend d’un cœur qui ceſſe d’eſtre à ſoy;	Mais le choix pour l'hymen est bien une autre loi, Elle dépend d'un cœur qui cesse d'être à soi;
Ainſi lors que vos yeux par leur pouvoir ſuprême M’ont enlevé le mien, il n’eſt plus à moy meſme:	Ainsi lors que vos yeux par leur pouvoir suprême M'ont enlevé le mien, il n'est plus à moi -même:
Peut-eſtre que bientoſt le vôtre aux meſmes lois Se trouvera ſoûmis, & bornera ſon choix.	Peut-être que bientôt le vôtre aux mêmes lois Se trouvera soumis, et bornera son choix.
Il faut qu’il ſe déclare, ou rompe le ſilence, Et ne me tieune prus en la hremie darancen Depuis deux ans entiers mon eſprit ſuſpendu Avec la meſme ardeur a toûjours attendu.	Il faut qu'il se déclare, ou rompe le silence, Et ne me tiène prus en la hérémie darancen Depuis deux ans entiers mon esprit suspendu Avec la même ardeur a toujours attendu.
ARMENDE.	ARMENDE.
Monſieur, quelque panchant que je faſſe paroître, De mon amour mon cœur ſera toûjours le maître, Et ſans vous dérober, ny donner trop d’eſpoir, Je ne veux m’attacher qu’aux régles du devoir.	Monsieur, quelque penchant que je fasse paraître, De mon amour mon cœur sera toujours le maître, Et sans vous dérober, ni donner trop d'espoir, Je ne veux m'attacher qu'aux règles du devoir.
Un amant vient a bout de tout ce qu’il eſpere Quand il ſçait ménager & la fille & le pere.	Un amant vient à bout de tout ce qu'il espère Quand il sait ménager et la fille et le père.
Palmire, j’en rougis, je vous en trop dit, Et ce mot qui m’échape à vôtre eſpoir ſuffit.	Palmire, j'en rougis, je vous en trop dit, Et ce mot qui m'échappe à votre espoir suffit.
Si vous apprehendez quelque choix pour Philandre, Je dois m’en conſulter avant que de me rendre;	Si vous appréhendez quelque choix pour Philandre, Je dois m'en consulter avant que de me rendre;
Ne me preſlez donc plus juſqu’à me déclarer.	Ne me preslez donc plus jusqu'à me déclarer.
BEATRIX.	BEATRIX.
On amant juiqu’au oout dont toujours erperer;	On amant juiqu'au oout dont toujours erprérer;
Vous voyez que Madame.	Vous voyez que Madame.
PALMIRE.	PALMIRE.
Augmente encor ma peïne, Et dans ce choix douteux m’inquiete & me geſne.	Augmente encor ma péine, Et dans ce choix douteux m'inquiète et me gêne.
ARMINDE.	ARMINDE.
C’en eſt trop dire, allez, & laiſſez-moy réver Sur le trouble où mon cœur commence à ſe trouver, Mon pere doit réſoudre, & dans cette journés En faveur d’un des deux l’affaire terminée En doit regſer le fort.	C'en est trop dire, allez, et laissez-moi réver Sur le trouble où mon cœur commence à se trouver, Mon père doit résoudre, et dans cette journès En faveur d'un des deux l'affaire terminée En doit régser le fort.
PALMIRE.	PALMIRE.
Helas!	Hélas!
que dites vous!	que dites -vous!
Ce pouvoir abſolu.	Ce pouvoir absolu.
ARMINDE, Peut-eſtre ſera doux,	ARMINDE, Peut-être sera doux,
PALMIRE.	PALMIRE.
Si l'aveugle intereſt emporte l’avantage.	Si l'aveugle intérêt emporte l'avantage.
ARMINDE.	ARMINDE.
Que puis-je vous répondre?	Que puis-je vous répondre?
IiiiML.	IiiiML.
Ah!	Ah!
ce ſeul mot m’outrage, Et dans le deſeſpoir où je ſors de ces lieux.	ce seul mot m'outrage, Et dans le désespoir où je sors de ces lieux.
BEATRIX.	BEATRIX.
Palmire, helas!	Palmire, hélas!
Arminde a les larmes aux yeux?	Arminde a les larmes aux yeux?
N’augmentez point ſa peine.	N'augmentez point sa peine.
PALMIRE.	PALMIRE.
Arminde.	Arminde.
ANMINDE.	ANMINDE.
Helas!	Hélas!
je tremble, Que mon pere ne vienne & ne nous voye enſembles Allez donc.	Je tremble, Que mon père ne vienne et ne nous voie ensembles Allez donc.
PALMIRE.	PALMIRE.
J’obeïs, & ſors en ce moment, Helas!	J'obéis, et sors en ce moment, Hélas!
quel rude coup pour un ſenſible amant?	quel rude coup pour un sensible amant?
SCENE III.	SCÈNE III.
eIHMRDE, BEATRTX	eIHMRDE, BEATRTX
ARMINDE.	ARMINDE.
Pproche, Beatrix, dy moy, je t’en conjure, ATon dernier ſentiment dans cetre conjoncture;	Proche, Beatrix, dis -moi, je t'en conjure, ATon dernier sentiment dans cet conjoncture;
Ne me conſeille rien qui bleſſe ma vertu, Je ſens de deux tranſports mon eſprit combatu.	Ne me conseille rien qui blesse ma vertu, Je sens de deux transports mon esprit combattu.
Auquel faut-il des deux que mon cœur s’abandonne, L’honneur m’en défend un, quand l’amour me l’ordonne.	Auquel faut-il des deux que mon cœur s'abandonne, L'honneur m'en défend un, quand l'amour me l'ordonne.
Palmire a ſur mes ſens un abſolu pouvoir, Mais ſon deſſein me ſemble & trop lâche & trop noir, Le naturel dégouſt que je ſens pour Philandre, Loin de me rebuter me fait tout entreprendre, Et ce funeſte hymen dont il s’oſe flater Ne me laiſſe plus rien que je n’aille tenter.	Palmire a sur mes sens un absolu pouvoir, Mais son dessein me semble et trop lâche et trop noir, Le naturel dégoût que je sens pour Philandre, Loin de me rebuter me fait tout entreprendre, Et ce funeste hymen dont il s'ose flatter Ne me laisse plus rien que je n'aille tenter.
rour prevenir ſhorreur d’un ſi rude martyre, Je choiſirois la mort plûtoſt que ſon empire, Mais helas!	rour prévenir shorreur d'un si rude martyre, Je choisirais la mort plutôt que son empire, Mais hélas!
quelque ſoit l’excez de mon tourment, J’ay peine à conſentir à cét enlevement,	quelque soit l'excès de mon tourment, J'ai peine à consentir à cet enlèvement,
BEATRIX.	BEATRIX.
Madame, en verité ſouffrez-moy de vous dire Qu’avec cette rigueur dont vous traitez Palmire, C’eſt trahir le ſecret de vôtre paſſion:	Madame, en vérité souffrez-moi de vous dire Qu'avec cette rigueur dont vous traitez Palmire, C'est trahir le secret de votre passion:
A quoy bon tant montrer d’irréſolution?	À quoi bon tant montrer d'irrésolution?
Si l’on juge d’un cœur par la perſéverance, Le ſien doit ſur le vôtre avoir de la puiſſance;	Si l'on juge d'un cœur par la persévérance, Le sien doit sur le vôtre avoir de la puissance;
Ne balancez donc plus à ſeconder ſes vœux, Prenez l'occaſion, comme on dit, aux cheveux.	Ne balancez donc plus à seconder ses vœux, Prenez l'occasion, comme on dit, aux cheveux.
Quoy!	Quoi!
négligeriez-vous cét unique avantage Qui vous tire aujourd’huy d’un ſi rude eſclavage?	négligeriez-vous cet unique avantage Qui vous tire aujourd'hui d'un si rude esclavage?
Pouvez vous ſans frayeur, prête à vous voir lier Sous l’inhumaine loy de vôtre Financier, Regarder de ſi prés le bord du précipice, Courir aveuglément aprés vôtre ſupplice, En un mot vous donner à cét infame époux?	Pouvez -vous sans frayeur, prête à vous voir lier Sous l'inhumaine loi de votre Financier, Regarder de si près le bord du précipice, Courir aveuglément après votre supplice, En un mot vous donner à cet infâme époux?
Je vous en blâmerois & ſerois contre vous.	Je vous en blâmerais et serais contre vous.
L’agreable party que vôtre beau Philandre!	L'agréable parti que votre beau Philandre!
Plûtoſt que l’épouſer je me laiſſerois pendre.	Plutôt que l'épouser je me laisserais pendre.
Ie connois la-deſſus vôtre tempérament, Et tous eſtes bien loin d’un tel abaiſſement.	Je connais la-dessus votre tempérament, Et tous êtes bien loin d'un tel abaissement.
ARMINDE.	ARMINDE.
Voicy venir mon pere.	Voici venir mon père.
DEATRIA.	DEATRIA.
Ah!	Ah!
nous ſerions perduës Si cét eſprit bourru nous avoit entreveuës.	nous serions perdues Si cet esprit bourru nous avait entrevues.
ARMTNDE.	ARMTNDE.
Demeure, Beatrix, & ſur tout retiens bien La felolution de toue leur encretient	Demeure, Beatrix, et sur tout retiens bien La solution de toue leur encretient
SCENE IV.	SCÈNE IV.
PHILANDRE, MASCARILLE, BEATRIX.	PHILANDRE, MASCARILLE, BEATRIX.
J PHILANDRE.	 JHILANDRE.
N homme comme moy, Monſieur de Maſcarille, Auroit-il du mérite aſſez pour vôtre fille?	N homme comme moi, Monsieur de Mascarille, Aurait-il du mérite assez pour votre fille?
J’ay commandé dix ans un eſcadron à pié, Sans que, graces à Dieu, j’en ſois eſtropié.	J'ai commandé dix ans un escadron à pied, Sans que, grâces à Dieu, j'en sois estropié.
Le nom de la Taillade eſt connu dans l’armée, Et ma valeur a fait toute ma renommée.	Le nom de la Taillade est connu dans l'armée, Et ma valeur a fait toute ma renommée.
Pour prouver ſa Nobleſſe il ne faut à preſent Que quatre bons degrez conſécutivement.	Pour prouver sa Noblesse il ne faut à présent Que quatre bons degré consécutivement.
J'en prouverois un cent, s’il eſtoit néceſſaire, D'ayeuls, de biſayeuls, enfin juſqu’à mon pere.	J'en prouverais un cent, s'il était nécessaire, D'aïeuls, de bisayeuls, enfin jusqu'à mon père.
Mais à propos de luy, ſa noble ambition Pour la guerre, eut toûjours de l’inclination.	Mais à propos de peine, sa noble ambition Pour la guerre, eut toujours de l'inclination.
Il ſe ſignala fort au Siege de Candie, Mais malheureuſement il y perdit la vie.	Il se signala fort au Siège de Candie, Mais malheureusement il y perdit la vie.
Tout ce qui me conſole en ce malheur dernier, C’eſt qu’il mourut en Noble, & non en Roturier.	Tout ce qui me console en ce malheur dernier, C'est qu'il mourut en Noble, et non en Roturier.
Dans le plus rude aſſaut, le meurtre & le carnage, Ce brave homme s’étoit poſté dans le bagage, Il y tenoit ſon rang en genereux Guerrier;	Dans le plus rude assaut, le meurtre et le carnage, Ce brave homme s'était posté dans le bagage, Il y tenait son rang en généreux Guerrier;
Mais les nôtres enfin obligez de plier, Et voyant qu’il faloit ceder à la tempête, Un Turc vint par derriere, & luy coupa la tête:	Mais les nôtres enfin obligez de plier, Et voyant qu'il fallait céder à la tempête, Un Turc vint par derrière, et lui coupa la tête:
Helas!	Hélas!
j’en ay porté plus de trois an le dueil, Et le ſeul ſouvenit m’en met la larme à l’œil.	j'en ai porté plus de trois an de uil, Et le seul souvenit m'en met la larme à l'œil.
volla plouver anel reciat de ma nainance;	volla plouver anel réciat de ma nainance;
Sans qu’on oſe y nommer la moindre dérogeance.	Sans qu'on ose y nommer la moindre dérogeance.
Aucun Bourgeois chez nous n’ayant pû s’allier, Je puis meſine prétendre au Rang de Chevalier.	Aucun Bourgeois chez nous n'ayant pu s'allier, Je puis mes prétendre au Rang de Chevalier.
MASCARILLE.	MASCARILLE.
Aprés les grands exploits que je viens de comprendre, Je tiens à grand honneur de vous avoir pour gendre.	Après les grands exploits que je viens de comprendre, Je tiens à grand honneur de vous avoir pour gendre.
YHTLANDNE.	YHTLANDNE.
Je le croy;	Je le crois;
vôtre fille en eſt de meſme auſſi, Faites-là donc, Monſieur, un peu venir icy.	votre fille en est de même aussi, Faites-là donc, Monsieur, un peu venir ici.
à part.	à part.
Elle voudroit déja bien me tenir.	Elle voudrait déjà bien me tenir.
MASCARILLE.	MASCARILLE.
De grace, Tant plus je m’étudie aux traits de vôtre face, E ij Et plus je vois l’objet que j’ay veu dans Senlis.	De grâce, Tant plus je m'étudie aux traits de votre face, E j Et plus je vois l'objet que j'ai vu dans Senlis.
Ne lefoit-ce point vous ?	Ne lésait-ce point vous ?
PHILANDRE.	PHILANDRE.
Non, mais bien à Paris.	Non, mais bien à Paris.
Dedans le Luxembourg, & meſme aux Tuilleries, Je m’y ſuis ſignalé par mille batteries;	Dedans le Luxembourg, et même aux Tuilleries, Je m'y suis signalé par mille batteries;
En cutule cermee, ou comoat nugunler, J’étois aux Rendez-vous ſans ceſſe le premier.	En cutule cermée, ou comat nugunler, J'étais aux Rendez-vous sans cesse le premier.
MASCARILLE.	MASCARILLE.
Parbleu, dans mon eſprit je ne me puis méprendre, C’eſt vous que je cherchois, c’eſt vous, Monſieur Philandre;	Parbleu, dans mon esprit je ne me puis méprendre, C'est vous que je cherchais, c'est vous, Monsieur Philandre;
Je ne vous avois veu vêtu qu’en Financier, mumtenant je vous vois lale le Cavaner.	Je ne vous avais vu vêtu qu'en Financier, mumtenant je vous vois la le Cavaner.
PHILANDRE.	PHILANDRE.
Je ne le connois pas, vôtre erreur eſt extrémes	Je ne le connais pas, votre erreur est extrêmes
MASCARILLE.	MASCARILLE.
Hé quoy!	Hé quoi!
n’étes-vous pas Fermier du Quatriémet Là, là, ſouvenez vous que plus de trente fois A vous meme du burcau jen ay paye les Dloits.	n'êtes-vous pas Fermier du Quatriémet Là, là, souvenez vous que plus de trente fois À vous meme du burcau jen ai paye les Dlaits.
PHILANDRE.	PHILANDRE.
Pour qui me prenez-vous?	Pour qui me prenez-vous?
pour quelque Rat de cave?	pour quelque Rat de cave?
C eſt me faire un affront?	Ç est me faire un affront?
MASCARILLE.	MASCARILLE.
En ſeriez-vous moins biave!	En seriez-vous moins biave!
Dans les Fermes du Roy l'on ne déroge pas.	Dans les Fermes du Roi l'on ne déroge pas.
PHILANDRE.	PHILANDRE.
Un vray Noble auroit-il des ſentimens bas?	Un vrai Noble aurait-il des sentiments bas?
SCENE V.	SCÈNE V.
PHILANDRE, MASCARILLE, ORMIN,	PHILANDRE, MASCARILLE, ORMIN,
ORMIN à Maſcarille.	ORMIN à Mascarille.
N'Officier de guerre, & d’une mine altiere, U Demande à vous parier.	N'Officier de guerre, et d'une mine altière, V Demande à vous parier.
MASCARILLE.	MASCARILLE.
Rous fommes en affaire.	Rous fommes en affaire.
SRMIN.	SRMIN.
Mais il m’a dit, Monſieur, que c’eſt de par le Roy.	Mais il m'a dit, Monsieur, que c'est de par le Roi.
MASCARILLE.	MASCARILLE.
Sans doute c’eſt à vous, Monſieur, non pas à moy;	Sans doute c'est à vous, Monsieur, non pas à moi;
Qu’il entre.	Qu'il entre.
CENE VI.	CÈNE VI.
MASCARILLE, PHILANDRE, UN BRIGADIER, ORMIN,	MASCARILLE, PHILANDRE, UN BRIGADIER, ORMIN,
LE BRIGADIER.	LE BRIGADIER.
AH, je vous tiens, Monſieur de la Taillade, Vous qui voulez en lâche eſquiver ma brigade, Et mettant ſous le pied tous ſentimens d’honneur, Eſtes icy venu faire le Deſerteur:	AH, je vous tiens, Monsieur de la Taillade, Vous qui voulez en lâche esquiver ma brigade, Et mettant sous le pied tous sentiments d'honneur, Êtes ici venu faire le Déserteur:
Je vous fais priſonnier.	Je vous fais prisonnier.
MASCARILLE.	MASCARILLE.
Arrêtez, je vous prie.	Arrêtez, je vous prie.
PHILANDRE.	PHILANDRE.
Moy, je ne fus jamais engagé de ma vie.	Moi, je ne fus jamais engagé de ma vie.
Je renonce à la guerre, & mon unique employ, N’eſt que de me mêler des affaires du Roy.	Je renonce à la guerre, et mon unique emploi, N'est que de me mêler des affaires du Roi.
J'arrive de Senlis pour épouſer la fille, Tel que vous me voyez, de Monfieur Maſcarille;	J'arrive de Senlis pour épouser la fille, Tel que vous me voyez, de Monfieur Mascarille;
Il m’en vient d’aſſurer, & dedans un moment Elle va recevoir la foy de ſon amant.	Il m'en vient d'assurer, et dedans un moment Elle va recevoir la foi de son amant.
MASCARILLE.	MASCARILLE.
Vous, épouſer ma fille!	Vous, épouser ma fille!
adieu, Monſieur Philandre, Puiſque vous deſertez, il faut vous faire pendre.	adieu, Monsieur Philandre, Puisque vous désertez, il faut vous faire pendre.
J’aymois tantoſt en vous de belles qualitez;	J'aimais tantôt en vous de belles qualités;
Mais recevez icy ce que vous méritez.	Mais recevez ici ce que vous méritez.
Le joly Capitaine!	Le joli Capitaine!
allez, faites juſtice, Monſieur le Brigadier, vous ſçavez vôtre office.	allez, faites justice, Monsieur le Brigadier, vous savez votre office.
Sa mine ne vaut rien;	Sa mine ne vaut rien;
je ſerois à l’inſtant, Sans vôtre ordre, vangé d’un affront ſi ſanglant.	je serais à l'instant, Sans votre ordre, vengé d'un affront si sanglant.
on puurtant la piele pouveit touenen votre âme, Je vous conſeillerois de lâcher cét infame, Et puiſque vous ſçavez qu’il eſt homme opulent, Commuez ſon ſupplice en bon nombre d’argent.	on puurtant la pièle pouvit touen votre âme, Je vous conseillerais de lâcher cet infâme, Et puisque vous savez qu'il est homme opulent, Commuez son supplice en bon nombre d'argent.
PHILANDRE.	PHILANDRE.
Eh!	Eh!
Monſieur, un billet payable à lettré veuë;	Monsieur, un billet payable à lettré vue;
Dè vous en mon Bureau meſme ſomme receuë.	Dé vous en mon Bureau même somme reçue.
LE BRIGADIER.	LE BRIGADIER.
De combien, d’y poltron?	De combien, d'y poltron?
de trente mille francs?	de trente mille francs?
Eſt-ce trop?	Est-ce trop?
PHILANDRE.	PHILANDRE.
Non, Monſieur.	Non, Monsieur.
LE BRIGADIER.	LE BRIGADIER.
Ecry donc.	Écri donc.
PHILANDRE.	PHILANDRE.
1peonſens.	1péonsens.
LE BRIGADIER.	LE BRIGADIER.
Ca, vîte du papier.	Ça, vite du papier.
à Maſcarille.	à Mascarille.
Vôtre ſeule priere rait que preſque pour rien je le tire d’affaire.	Votre seule prière rait que presque pour rien je le tire d'affaire.
OR MIN bas.	OR MIN bas.
Tout va bien juſqu’icy, ſon hymen eſt rompu, Paimle adeja lant pour moy ce qun à pu , Mais je puis eſpérer encor bien plus du reſte.	Tout va bien jusqu'ici, son hymen est rompu, Paimle adejà lant pour moi ce qu' en pu , Mais je puis espérer encor bien plus du reste.
PHILANDRE bas.	PHILANDRE bas.
O dieux!	Ô dieux!
l’horrible affront!	l'horrible affront!
dans mon cœur j’en déteſte.	dans mon cœur j'en déteste.
SCENE DERNIERE.	SCÈNE DERNIÈRE.
MASCARILLE, PHILANDRE, UN EXEMT, avec deux Archers, PALMIRE, ORMIN, ARMINDE, BEATRIX.	MASCARILLE, PHILANDRE, UN EXEMT, avec deux Archers, PALMIRE, ORMIN, ARMINDE, BEATRIX.
L’EXEMT.	L'EXEMT.
Ordre de vous ſaiſir qu’on me vient d’aporter, L Vertu d’un Mandement, me fait vous arréten.	Ordre de vous saisir qu'on me vient d'apporter, L Vertu d'un Mandement, me fait vous arrêten.
PHILANDRE.	PHILANDRE.
muon petie compagnou, vous avez ia berluë.	muon petie compagnou, vous avez ja berlue.
L’EXEMT.	L'EXEMT.
Et vous, amant trop fier, vôtre peine eſt perduë.	Et vous, amant trop fier, votre peine est perdue.
PHILANDRE.	PHILANDRE.
Liſez ce Mandement.	Lisez ce Mandement.
L’EXEMT.	L'EXEMT.
Ouy, ouy, je le liray, Il eſt comme il le faut ſur du papier timbré.	Oui, oui, je le lirai, Il est comme il le faut sur du papier timbré.
Veu de la part d’Orgon la plainte criminelle, Sur l’enlexement fait de ſa fille Roſelle, Philandre convaincu par l’Information, D’avoir depuis deux ans commis cette action, Et de plus, non content de l’avoir abuſée, De la garder encor avec luy déguiſée, Sous le tître d’Ormin, en habit de Valet, Pour venir rendre icy raiſon de ſon forfait, Sera par le pouvoir que la Cour vous en donne, Arrété priſonnier, puis conduit en perſonne Aux priſons du Palais, & s’il fait le retif, Qu’il nous ſoit ſans defant amené mort ou vif.	Veu de la part d'Orgon la plainte criminelle, Sur l'enlexement fait de sa fille Roselle, Philandre convaincu par l'Information, D'avoir depuis deux ans commis cette action, Et de plus, non content de l'avoir abusée, De la garder encor avec lui déguisée, Sous le tittre d'Ormin, en habit de Valet, Pour venir rendre ici raison de son forfait, Sera par le pouvoir que la Cour vous en donne, Arrété prisonnier, puis conduit en personne Aux prisons du Palais, et s'il fait le rétif, Qu'il nous soit sans défant amense mort ou vif.
PHILANDRE.	PHILANDRE.
Quoy, Roſelle eſt Ormin!	Quoi, Roselle est Ormin!
ô Dieux!	ô Dieux!
quelle ſurpriſe!	quelle surprise!
Où donc eſtoient mes yeux, quand chez moy je l’ay priſe, Penſant prendre un Valet?	Où donc étaient mes yeux, quand chez moi je l'ai prise, Pensant prendre un Valet?
Si j’en ſuis abuſé, Je dois eſtre puny d’en avoir mal uſé.	Si j'en suis abusé, Je dois être puni d'en avoir mal usé.
PALMIRE.	PALMIRE.
Traître, il faut maintenant que t’arrachant la vie, Je t’immole à ma ſœur que tu nous as ravie, Son honneur & le mien qui veut eſtre vangé, Ordonne que tu ſois de ma main égorgé.	Traître, il faut maintenant que t'arrachant la vie, Je t'immole à ma sœur que tu nous as ravie, Son honneur et le mien qui veut être vengé, Ordonne que tu sois de ma main égorgé.
Aha c’eſt trop differer.	Aha c'est trop différer.
Il tire l’épée.	Il tire l'épée.
Qu’en dites-vous, Roſelle?	Qu'en dites-vous, Roselle?
ONMIN.	ONMIN.
Ah!	Ah!
mon frere, écoutez cét amant iofidelle.	mon frère, écoutez cet amant iofidelle.
PHILANDRE.	PHILANDRE.
Quoy!	Quoi!
Rofelle, mon ſang à vos yeux répandu .	Rofelle, mon sang à vos yeux répandu .
ORMIN.	ORMIN.
Ouy, traître, tout ton ſang à mon honneur eſt dû.	Oui, traître, tout ton sang à mon honneur est dû.
Sons Sous ce déguiſement je t’ay voulu pourſuivre:	Sons Sous ce déguisement je t'ai voulu poursuivre:
Mon honneur veur ta mort.	Mon honneur veut ta mort.
PALMIRE.	PALMIRE.
Il va ceſſer de vivre.	Il va cesser de vivre.
PHILANDRE.	PHILANDRE.
Tout beau, tout beau, Monſieur, je vous ſatisferay.	Tout beau, tout beau, Monsieur, je vous satisférai.
PAEMNRE.	PAMNRE.
Comment pourras tu faire?	Comment pourras -tu faire?
PHILANDRE.	PHILANDRE.
Hé!	Hé!
je l'épouſeray.	je l'épouserai.
Je croy qu’aprés cela vous n’aurez rien à dire.	Je crois qu'après cela vous n'aurez rien à dire.
L’EXEMT.	L'EXEMT.
Je veux vous accorder, Arminde aime Palmire.	Je veux vous accorder, Arminde aime Palmire.
Ne vous oppoſez plus, Philandre, à leur bonheur, Conſentez en mhymen en epoutant ſa ſœur, Par là vous préviendrez l’infaillible vangeance, Qui ſans doute ſuivroit l’excez de vôtre offenſe.	Ne vous opposez plus, Philandre, à leur bonheur, Consentez en mhymen en epoutant sa sœur, Par là vous préviendrez l'infaillible vengeance, Qui sans doute suivrait l'excès de votre offense.
PH-ILANDRE.	PH-ILANDRE.
Je ſouſcris volontiers à cette aimable loy, Roſelle, encore un coup, recevez donc ma foy.	Je souscris volontiers à cette aimable loi, Roselle, encore un coup, recevez donc ma foi.
DRMIN.	DRMIN.
Mon frere, croyez vous ma gloite aſſez vangée?	Mon frère, croyez -vous ma gloite assez vengée?
PALMTRE.	PALMTRE.
L’hymen efface tout.	L'hymen efface tout.
Je vous vois ſoulagée, Et vôtre honneur par la reprend tout ſon éclat;	Je vous vois soulagée, Et votre honneur par la reprend tout son éclat;
Ouy, donnez-luy la main, & meſme en cet eſtat.	Oui, donnez-lui la main, et même en cet état.
L’EXEMT à Maſcarille.	L'EXEMT à Mascarille.
Faites le meſme effort, Monſieur de Maſcarille.	Faites le même effort, Monsieur de Mascarille.
MASCARTLLE.	MASCARTLLE.
Ouy, Palmire, aujourd’huy je vous donne mafille.	Oui, Palmire, aujourd'hui je vous donne mafille.
PALMIRE.	PALMIRE.
A l'égard du billet de trente mille francs, A ces conditions, Monſieur, je vous le rends.	À l'égard du billet de trente mille francs, À ces conditions, Monsieur, je vous le rends.
BEATRIX.	BEATRIX.
On appelle cela recevoir en peinture Les deniers de la dot d’une épouſe future.	On appelle cela recevoir en peinture Les deniers de la dot d'une épouse future.
C’eſt encore beaucoup pour de ſemblables gens, Tous ces gros Financiers ont de l’or en tout temps.	C'est encore beaucoup pour de semblables gens, Tous ces gros Financiers ont de l'or en tout temps.
Une fille pour luy, jeune, bien faite, & ſage, Et de l’argent comptant, c’euſt eſlé grand dommage, C’eſt ce qu’un honnête homme a peine à remporter.	Une fille pour lui, jeune, bien faite, et sage, Et de l'argent comptant, c'eût eslé grand dommage, C'est ce qu'un honnête homme a peine à remporter.
E HI LANDRE.	E HI LANDRE.
Il faut donc pour l’hymen aller tout appreſter.	Il faut donc pour l'hymen aller tout apprêter.
Qu’une fille amoureuſe eſt une choſe eſtrange!	Qu'une fille amoureuse est une chose étrange!
C’eſt un Diable ſouvent quand on la croit un Ange.	C'est un Diable souvent quand on la croit un Ange.
Allons, puis qu’il le faut, allons nous marier, Et par un double hymen nous réconcilier.	Allons, puis qu'il le faut, allons nous marier, Et par un double hymen nous réconcilier.
IN.	IN.
