A TARIS, Chez C.	À TARIS, Chez Ç.
Blageart, Court-neuve du Palais, au Dauphin.	Blageart, Court-neuve du Palais, au Dauphin.
M.	M.
DC.	DC.
LXXXIV.	LXXXIV.
AVEC PRIVILEGE DU ROY.	AVEC PRIVILÈGE DU ROY.
M ONSIEUR, Quand on a eu la penſée de faire imprimer cette Comédie, j'ay ſongé à meſme temps à vous la dédier,	M ONSIEUR, Quand on a eu la pensée de faire imprimer cette Comédie, j'ai songé à même temps à vous la dédier,
GRAPINIAN A M ** FAMEUX PROCUREUR.	GRAPINIAN À M * FAMEUX PROCUREUR.
ne pouvant paroiſtre en public avec une protection plus illuſtre que la vostre.	ne pouvant paraître en public avec une protection plus illustre que la vôtre.
e ſçay bien que ſi je vous euſſe conſulté ſur cette petite Piece, vous y auriez, ajoüté des traits ſinguliers.	Je sais bien que si je vous eusse consulté sur cette petite Pièce, vous y auriez, ajouté des traits singuliers.
qui luy auroient fait atteindre ce point de perfection, ſi defficile a trouver en toutes choſes.	qui était auraient fait atteindre ce point de perfection, si déficile à trouver en toutes choses.
Je connois voſtre grand talent dans les Affaires, & la penétration que vous avez dans toutes les Procédures, qui ſont néceſſaires poun empeſ cher qu'elles ne finiſſent.	Je connais votre grand talent dans les Affaires, et la pénétration que vous avez dans toutes les Procédures, qui sont nécessaires poun empes cher qu'elles ne finissent.
Une longue ſuite d’années vous a découvert des biais, que le Public admire, & dont ceux de nos Confreres, qui exercent la Profeß on avec honneur, vous ſeront eternellement obligez;	Une longue suite d'années vous a découvert des biais, que le Public admire, et dont ceux de nos Confrères, qui exercent la Profess on avec honneur, vous seront éternellement obligez;
car non ſeulement vous nous avez, appris à tirer les Pieces des Sacs de nos Parties, pour les remettre à leurs Adverſaimoomrrun pouvonnen Oyits nous avez donné d’utiles Lecons ſur les adreſſes dont nous devons nous ſervir pour les engager dans de mauvais Procés;	car non seulement vous nous avez, appris à tirer les Pièces des Sacs de nos Parties, pour les remettre à leurs Adversaimoomrun pouvonnen Ois nous avez donné d'utiles Lecons sur les adresses dont nous devons nous servir pour les engager dans de mauvais Procès;
mais encore, nous ſçavons par vous les moyens de les ſurprendre par des Projets captieux, & par des Accommodemens ſimulez, en leur faiſant ſigner des Articles, qui dans la ſuite ſont la cauſe de leur ruine.	mais encore, nous savons par vous les moyens de les surprendre par des Projets captieux, et par des Accommodements simulez, en leur faisant signer des Articles, qui dans la suite sont la cause de leur ruine.
Enfin tout ce qu’il y a de plus ſubtil dans l’Art lucratif des Fripohreriis yueſt à vos lumieres que nous le devons.	Enfin tout ce qu'il y a de plus subtil dans l'Art lucratif des Fripohriis yvest à vos lumières que nous le devons.
Je ne parle point de toutes vos délicateſſes à bien ménager les fauſſetez.	Je ne parle point de toutes vos délicatesses à bien ménager les faussetés.
le ne dis rien des dépoſts que vous avez niez, des dates de Contracts que vous avez changées des noms veritables que vous avez, trouvé moyen d’effacer, pour y écrire celuy de quelques Perſonnes ſages, qui en vous ouvrant leur Bource, vous engageoient à les protéger.	le ne dis rien des dépôts que vous avez niez, des dates de Contrats que vous avez changées des noms véritables que vous avez, trouvé moyen d'effacer, pour y écrire celui de quelques Personnes sages, qui en vous ouvrant leur Bource, vous engageaient à les protéger.
Ce n'eſt pas par des louanges ſi peu conſidérables, que je veux faire éclater voſtre gloire.	Ce n'est pas par des louanges si peu considérables, que je veux faire éclater votre gloire.
Elle a des endroits plus ſolides pour ſe ſoütenir elle-meſme;	Elle a des endroits plus solides pour se sourtenir elle-même;
& cette quantité de Cliens, que vous avez, mis en chemiſe, prennent ſoin de la publier tous les jours.	et cette quantité de Cliens, que vous avez, mis en chemise, prennent soin de la publier tous les jours.
Ce qui me touche ſenſiblement, c'eſt qu’on vous ait oſté les moyens de continuer l’exercice de ce talent admirable, que vous faiſiez valoir depuis tant d’années;	Ce qui me touche sensiblement, c'est qu'on vous ait ôté les moyens de continuer l'exercice de ce talent admirable, que vous faisiez valoir depuis tant d'années;
mais, MONSIEUR, telle eſt l’ingratitude du Siecle, & l’inustice des Hommes, qui perſécutent le mérité, qui ne peuvent ſoufrir la vertu.	mais, MONSIEUR, telle est l'ingratitude du Siècle, et l'intice des Hommes, qui persécutent le mérité, qui ne peuvent soufrir la vertu.
Dißipez, vostre chagrin par la lecturé de mes Galanteries;	Dissipez, votre chagrin par la lecturé de mes Galanteries;
je vais paroiſtre dans mon Etude, comme vous eſtiez dans la voſtre;	je vais paraître dans mon Étude, comme vous étiez dans la vôtre;
& le manége que  feray avec mes Parties, vous divertira peut-eſtre par le ſouvenir de ce que vous faïſiez autrefois.	et le manège que ferai avec mes Parties, vous divertira peut-être par le souvenir de ce que vous faïsiez autrefois.
Je m'eſt meray heureux, ſi ayant déja réjouy tant de Plaideurs, qui, comme vous ſçavez, rient à leurs dépens, je puis deſennuyer un Homme außi illustre que vous, dont l’eſtime me ſera plus glorieuſe, que celle que j'ay acquiſe dans tout le Royaume.	Je m'est merai heureux, si ayant déjà réjoui tant de Plaideurs, qui, comme vous savez, rient à leurs dépens, je puis désennuyer un Homme aussi illustre que vous, dont l'estime me sera plus glorieuse, que celle que j'ai acquise dans tout le Royaume.
C’eſt le deſſein que je me propoſe pour vous témoigner que je ſuis de tout mon cœur,	C'est le dessein que je me propose pour vous témoigner que je suis de tout mon cœur,
MONSIEUR,	MONSIEUR,
Voſtre tres-humble & tres;	Votre très-humble et très;
obeïſſant Serviteur,	obéissant Serviteur,
GRAPINIA	GRAPINIA
UN PLAIDEUR Alo un alleleo	UN PLAIDEUR Alo un allèleo
Ib pn L'y a environ un an & demy que les Comédiens Italiens repréſenterent une Piece intitulée, La Matrone d'Epheſe, ou Arlequin Procureur.	Ib pen L'y a environ un an et demi que les Comédiens Italiens représentèrent une Pièce intitulée, La Matrone d'Éphèse, ou Arlequin Procureur.
Comme le ſuccés en fut fortgrand, ils la joüerent pres de trois mois, & le bruit qu’elle fit alla ſi loin, que mes Amis de la Province m’écrivirent pluſieurs fois pour me prier de la leur envoyer, ſi elle eſtoit imprimée.	Comme le succès en fut fortgrand, ils la jouèrent pres de trois mois, et le bruit qu'elle fit alla si loin, que mes Amis de la Province m'écrivirent plusieurs fois pour me prier de la leur envoyer, si elle était imprimée.
L’utilité que le Public en peut tirer, me fit employer toute ſorte de moyens pour l’avoir.	L'utilité que le Public en peut tirer, me fit employer toute sorte de moyens pour l'avoir.
Enfin apres beaucoup d’intrigues, on me la remit toute entiere entre les mains, avec la Lettre dédicatoire;	Enfin après beaucoup d'intrigues, on me la remit toute entière entre les mains, avec la Lettre dédicatoire;
mais comme les deux premiers Actes ſont Italiens, & que leurs agrémens dépendent de la Repréſentation, on m’a conſeillé de faire imprimer le troiſiéme ſeul, qui eſt la Comédie d’Arlequin Procureur.	mais comme les deux premiers Actes sont Italiens, et que leurs agrémens dépendent de la Représentation, on m'a conseillé de faire imprimer le troisième seul, qui est la Comédie d'Arlequin Procureur.
On l’attribuë à quatre ou cinq diférentes Perſonnes;	On l'attribue à quatre ou cinq diférentes Personnes;
mais de quelque endroit qu’elle vienne, les Italiens n’en ont guére repréſenté de meilleures;	mais de quelque endroit qu'elle vienne, les Italiens n'en ont guère représenté de meilleures;
car ſans parler du caractere de la Matrone, & de celuy du Grand-Preſtre de Diane, qui profane l’Autel de la Déeſſe par ſon avarice, celuy du Procureur eſt incomparable.	car sans parler du caractère de la Matrone, et de celui du Grand-Prêtre de Diane, qui profane l'Autel de la Déesse par son avarice, celui du Procureur est incomparable.
Arlequin qui le repréſente ſous le nom de Grapinian, ne dit qu’une fort petite partie des tours qui ſe font parmy ſes Confreres;	Arlequin qui le représente sous le nom de Grapinian, ne dit qu'une fort petite partie des tours qui se font parmi ses Confrères;
& me trouvant un jour à cette Comédie pres d’un Procureur, je le vis en colere contre l’Autheur de la Piece, aſſurant qu’il n’entendoit pas le Palais, & qu’un Clerc de trois mois en diroit dix fois davantage.	et me trouvant un jour à cette Comédie pres d'un Procureur, je le vis en colère contre l'Auteur de la Pièce, assurant qu'il n'entendait pas le Palais, et qu'un Clerc de trois mois en dirait dix fois davantage.
Son dépit doit faire juger des galanteries de ceux de ſa Profeſſion, quand ils ſont de mauvaiſe foy.	Son dépit doit faire juger des galanteries de ceux de sa Profession, quand ils sont de mauvaise foi.
Ce qu’on croit devoir ajoûter icy, eſt qu’on n’a jamais eu le moindre deſſein de joüer aucun Procureur en particulier;	Ce qu'on croit devoir ajouter ici, est qu'on n'a jamais eu le moindre dessein de jouer aucun Procureur en particulier;
mais on m’a dit qu’on avoit pris en ge néral les friponneries qu’on a faites autrefois, & qu’on fait peuteſtre encore aujourd’huy.	mais on m'a dit qu'on avait pris en ge néral les friponneries qu'on a faites autrefois, et qu'on fait peutestre encore aujourd'hui.
Arlequin dans ſon Etude, & ſa converſation avec fes Cliens, découvre l’adreſſe de pluſieurs Procureurs, qui parlant à leurs Parties, ſongent plutoſt à attraper leur argent, qu’à défendre leurs intéreſts.	Arlequin dans son Étude, et sa conversation avec fes Cliens, découvre l'adresse de plusieurs Procureurs, qui parlant à leurs Parties, songent plutôt à attraper leur argent, qu'à défendre leurs intérêts.
Nous autres Plaideurs, nous pouvons auſſi penſer que ce que nous voyons ſur le Théatre, ſe paſſe comme on nous le repréſente, & nous devons nous tenir ſur nos gardes avec d’autres Grapinians plus dangereux, qui nous peuvent faire des tours bien plus violens que ceux qu’on nous montre à l’Hôtel de Bourgogne.	Nous autres Plaideurs, nous pouvons aussi penser que ce que nous voyons sur le Théâtre, se passe comme on nous le représente, et nous devons nous tenir sur nos gardes avec d'autres Grapiniants plus dangereux, qui nous peuvent faire des tours bien plus violents que ceux qu'on nous montre à l'Hôtel de Bourgogne.
En effet, en voicy un qui peut eſtre raconté.	En effet, en voici un qui peut être raconté.
Il y a quelque temps qu’un ancien Procureur, qui autant qu’il avoit pû, avoit exercé la Profeſſion avec toute l’exactitude imaginable, ſe trouvant avec un de ſes Amis, & parlant de certaines petites facilitez qui ſe pratiquent dans les Affaires, dit, qu’eſtant Procureur d’un grand Seigneur dont tout le Bien eſtoit ſaiſy, & ayant obtenu pluſieurs Proviſions pour luy, il en voulut avoir une nouvelle de vingt mille francs.	Il y a quelque temps qu'un ancien Procureur, qui autant qu'il avait pu, avait exercé la Profession avec toute l'exactitude imaginable, se trouvant avec un de ses Amis, et parlant de certes petites facilités qui se pratiquent dans les Affaires, dit, qu'étant Procureur d'un grand Seigneur dont tout le Bien était saisi, et ayant obtenu plusieurs Provisions pour lui, il en voulut avoir une nouvelle de vingt mille francs.
Je le confirmay dans cette penſée, ajoûta ce Procureur, & je n’avois garde de m’y oppoſer, puis que j’avois part au Gâteau.	Je le confirmai dans cette pensée, ajouta ce Procureur, et je n'avais garde de m'y opposer, puis que j'avais part au Gâteau.
Je fis donc la demande, & on m’en debouta, parce que le plus ancien Procureur des Creanciers ſaiſiſſans, & celuy qui pourſuivoit les Criées, ſe défendirent en Gens d’honneûr;	Je fis donc la demande, et on m'en débouta, parce que le plus ancien Procureur des Créanciers saisissants, et celui qui poursuivait les Criées, se défendirent en Gens d'honneurer;
mais je fus bien ſur.	mais je fus bien sur.
pris, quand apres avoir perdu ma Cauſe, ces deux meſmes Procureurs me trouvant le lendemain à la Grand’ Chambre, me tirerent à part, & me dirent tout-bas à l’oreille, qu’il ne tenoit qu’à moy d’avoir les vingt mille francs que je voulois.	pris, quand après avoir perdu ma Causse, ces deux mêmes Procureurs me trouvant le lendemain à la Grand Chambre, me tirèrent à part, et me dirent tout-bas à l'oreille, qu'il ne tenait qu'à moi d'avoir les vingt mille francs que je voulais.
Je leur demanday le moyen.	Je leur demandai le moyen.
Pour un habile Homme comme vous, reprit l’un, s’y prend-on de la ſorte?	Pour un habile Homme comme vous, reprit l'un, s'y prend-on de la sorte?
Hé, morbleu, mon Amy, continua l’autre, radotez-vous, & n’entendezvous plus le Palais?	Hé, morbleu, mon Ami, continua l'autre, radotez-vous, et n'entendez pluseze Palais?
Ne faut il pas que tout vive?	Ne faut il pas que tout vive?
Il n’y a qu’un mot à cela, cent Piſtoles à chacun, & nous vous allons paſſer voſtre Proviſion.	Il n'y a qu'un mot à cela, cent Pistoles à chacun, et nous vous allons passer votre Provision.
Vous voyez bien, ajoûta-t-il, qu’on ſe met à la raiſon, & qu’il n’y a perſonne au monde aſſez ſtupide, qui refuſe dix-huit mille francs pour une ſi petite ſomme.	Vous voyez bien, ajouta-t-il, qu'on se met à la raison, et qu'il n'y a personne au monde assez stupide, qui refuse dix-huit mille francs pour une si petite somme.
Et alors ſe prenant tous deux à rire, ils me toucherent dans la main, & me dirent que ma maniere d’agir les avoit ſurpris.	Et alors se prenant tous deux à rire, ils me touchèrent dans la main, et me dirent que ma manière d'agir les avait surpris.
Je leur demanday fi ma procédure n’eſtoit pas réguliere.	Je leur demandai fi ma procédure n'était pas régulière.
Non, me dirent ils, elle ne l’eſtoit pas, puis que vous avez manqué voſtre Cauſe.	Non, me dirent ils, elle ne l'était pas, puis que vous avez manqué votre Causse.
On agit toûjours régulierement, quand on obtient ce qu’on pourſuit, de quelque façon qu’on l’attrape.	On agit toujours régulièrement, quand on obtient ce qu'on poursuit, de quelque façon qu'on l'attrape.
Mais, Meſſieurs, leur rẽpartis-je, que diront vos Parties, s’ils découvrent la choſe?	Mais, Messieurs, leur rempartis-je, que diront vos Parties, s'ils découvrent la chose?
N’entrez point dans ce détail, reprirent-ils, chacun ſçait ſon meſtier.	N'entrez point dans ce détail, reprirent-ils, chacun Sait son métier.
C’eſt à dire, ajoûtay-je, que vous me vendez tous deux leurs intéreſts pour deux cens Piſtoles.	C'est à dire, ajoutai-je, que vous me vendez tous deux leurs intérêts pour deux cens Pistoles.
Ma reflexion les fit éclater de rire, & ils me demanderent depuis quand j’eſtois devenu ſi ſcrupuleux, & qu’ils voyoient bien que ſur mes vieux jours je voulois faire ſemblant d’avoir de la conſcience.	Ma réflexion les fit éclater de rire, et ils me demandèrent depuis quand j'étais devenu si scrupuleux, et qu'ils voyaient bien que sur mes vieux jours je voulais faire semblant d'avoir de la conscience.
Ha, vieux Pecheur, dirent- ils, tu mourras dans ton peché auſſi-bien que les autres.	Ha, vieux Pécheur, dirent- ils, tu mourras dans ton péché aussi-bien que les autres.
Enfin je leur donnay deux cens Piſtoles, & ils m’accorderent dix-huit mille francs, dont je tiray ma part en Homme d’honneur.	Enfin je leur donnai deux cents Pistoles, et ils m'accordèrent dix-huit mille francs, dont je tirai ma part en Homme d'honneur.
I Ar Grace & Privilege du Roy, donné à Verſailles le 17.	I Ar Grâce et Privilège du Roi, donné à Versailles le 17.
jour de Decembre 1683.	jour de Décembre 1683.
Signé, Par le Roy en ſon Conſeil, D’ALENCE';	Signé, Par le Roi en son Conseil, D'ALENCE';
Il eſt permis au Sieur Darennes de faire imprimer une Comédie intitulée La Matrone d’Epheſe, où Arlequin Procureur, par tel Imprimeur ou Libraire qu’il voudra choiſir, pendant le temps de ſix années, à compter du jour qu’elle ſera achevée d’imprimer pour la premiere fois;	Il est permis au Sieur Darennes de faire imprimer une Comédie intitulée La Matrone d'Éphése, où Arlequin Procureur, par tel Imprimeur ou Libraire qu'il voudra choisir, pendant le temps de six années, à compter du jour qu'elle sera achevée d'imprimer pour la première fois;
Et défenſes ſont faites à toutes autres Perſonnes de l’imprimer, faire imprimer, vendre & debiter, fans le conſentement de l’Expoſant, ou de ceux qui auront droit de luy, à peine aux Contreve.	Et défenses sont faites à toutes autres Personnes de l'imprimer, faire imprimer, vendre et débiter, sans le consentement de l'Exposant, ou de ceux qui auront droit de lui, à peine aux Contreve.
nans de trois mille livres d’amende, confiſcation des Exemplaires contrefaits, & de tous dépens, dommages & intereſts, aitiii que plus au long il eſt porté par ledit Privilege.	nans de trois mille livres d'amende, confiscation des Exemplaires contrefaits, et de tous dépens, dommages et intérêts, aiti que plus au long il est porté par ledit Privilège.
Regiſtré ſur le Livre de la Communauté le 4.	Registré sur le Livre de la Communauté le 4.
Janvier 1684.	Janvier 1684.
Signé, ANGOT, Syndic.	Signé, ANGOT, Syndic.
Ledit Sieur Darennes a cedé ſon Privilege à C.	Ledit Sieur Darennes a cédé son Privilège à Ç.
Blageart Imprimeur-Libraire, pour en joüir ſuivant l’accord fait entr’eux.	Blageart Imprimeur-Libraire, pour en jouir suivant l'accord fait entr'eux.
Achevé d’impr'mer le 5.	Achevé d'imprimer le 5.
jour de fanvier1684.	jour de fanvier1684.
NE PLAIDEUSE.	NE PLAIDEUSE.
N MARQUIS.	 MARQUIS.
ARLEQUIN PROCUREUR COMEDIE.	ARLEQUIN PROCUREUR COMÉDIE.
SCENE I.	SCÈNE I.
COQUINIERE, GRAPINIAN.	COQUINIERE, GRAPINIAN.
COQUINIERE.	COQUINIERE.
2 Eseς OVS ne ferez jamais rien dans nôtre Meſtier, ſi vous n’avez a voſtre diſpoſition un Notaire, un Sergent, & un Greffier;	2 Eseς OUS ne ferez jamais rien dans notre Métier, si vous n'avez a toujours disposition un Notaire, un Sergent, et un Greffier;
mais un jeune Procureur, qui a ces trois cordes à ſon Arc, peut tout riſquer & tout entreprendre.	mais un jeune Procureur, qui a ces trois cordes à son Arc, peut tout risquer et tout entreprendre.
GRAPINIAN.	GRAPINIAN.
Voila trois dangereuſes Beſtes à gouverner.	Voilà trois dangereuses Bêtes à gouverner.
COQUINIERE.	COQUINIERE.
Hé, j’en ſuis bien venu a bout ſans miracle.	Hé, j'en suis bien venu a bout sans miracle.
Dans toute ſorte deProfeſſions, il y a des Eſprits revéches & farouches, qui vont toujours droit, & qui ſe ſont fait un calus de l’honneur de leur Mêtier.	Dans toute sorte deProfessions, il y a des Esprits revèches et farouches, qui vont toujours droit, et qui se sont fait un calus de l'honneur de leur Métier.
Fy, ce n’eſt pas ces Gens-là qu’il faut chercher, ce ſont des Brutaux qui ne ſont bons à rien;	Fi, ce n'est pas ces Gens-là qu'il faut chercher, ce sont des Brutaux qui ne sont bons à rien;
mais il y en a d’autres plus humains, & plus ſociables, qu'on peut aprivoiſer avec de l’argent.	mais il y en a d'autres plus humains, et plus sociables, qu'on peut apprivaiser avec de l'argent.
C’eſt à ceux-là qu’on doit s’adreſſer, & c’eſt ſur leur avidité qu’il faut regler le ſuccés de toutes les Affaires.	C'est à ceux-là qu'on doit s'adresser, et c'est sur leur avidité qu'il faut régler le succès de toutes les Affaires.
GRAPINIAN.	GRAPINIAN.
Bonne morale!	Bonne morale!
A i COQUINIERE.	A À JOQUINIÈRE.
Un Homme qui voudroit faire ſon Meſtier dans l’ordre, n’auroit pas mille écus de profit au bout de l’an.	Un Homme qui voudrait faire son Métier dans l'ordre, n'aurait pas mille écus de profit au bout de l'an.
Autrefois nous avions plus de Pratiques que nous ne voulions;	Autrefois nous avions plus de Pratiques que nous ne voulions;
mais à preſent il les faut aller chercher;	mais à présent il les faut aller chercher;
& encore ſi un Procureur n’eſt alerte, il ne gagne pas pour déſrayer ſa Maiſon.	et encore si un Procureur n'est alerte, il ne gagne pas pour désrayer sa Maison.
GRAPINIAN.	GRAPINIAN.
Il eſt vray qu’on ne plaide plus qu’a ſon corps dercildance	Il est vrai qu'on ne plaide plus qu'a son corps dercildance
IINIERE.	IINIÈRE.
Mr Grapinian, je m’aſſure que vous n’avez pas trente ans.	Mr Grapinian, je m'assure que vous n'avez pas trente ans.
lell a l lalla lvs Hé, environ.	lell a l lalla lus , environ.
O UINIERE.	Ô OÙINIERE.
Le pel age pour bien travailler !	Le pel age pour bien travailler !
GRAPINIAN.	GRAPINIAN.
Ho, laiſſez-moy faire.	Ho, laissez-moi faire.
COQUINIERE.	COQUINIERE.
Il faut que vous ſoyez une Balourde, ſi apres les Préceptes que je vay vous donner, vous n’avez dans quatre ans ruiné cent Familles, & acquis dix MaiIons dans l'aris.	Il faut que vous soyez une Balourde, si après les Prèceptes que je vais vous donner, vous n'avez dans quatre ans ruiné cent Familles, et acquis une BaiIons dans l'aris.
3RAPINIAN.	3RAPINIAN.
Dix Maiſons dans Paris!	Dix Maisons dans Paris!
COQUINIERE.	COQUINIERE.
Oüy, dix Maiſons dans Paris;	Oui, dix Maisons dans Paris;
& par deſſus cela, un bon Carroſſe pour võtre Periilllo.	et par -dessus cela, un bon Carrosse pour votre Périilllo.
GRAPINIAN.	GRAPINIAN.
L’habile Homme!	L'habile Homme!
COQUINIERE.	COQUINIERE.
Tel que vous me voyez, à l’âge de quarante ans, j’avois déja amaſſé deux cens mille livres de bon Bien;	Tel que vous me voyez, à l'âge de quarante ans, j'avais déjà amassé deux cens mille livres de bon Bien;
& ſi en ce tempsla, les Femmes de Procureur euſſent oſé porter de la dorure ſur leurs Habits, & avoir des Carroſſes, la mienne en auroit eu a bonnes enſeignes;	et si en ce tempsla, les Femmes de Procureur eussent osé porter de la dorure sur leurs Habits, et avoir des Carrosses, la mienne en aurait eu a bonnes enseignes;
mais la mode n’en eſtoit pas encore venuë.	mais la mode n'en était pas encore venue.
GRAPINIAN.	GRAPINIAN.
M’Coquiniere, de grûce, donnez-moy de bonnes Inſtructions pour ne plus aller a pied.	M'Coquinière, de grûce, donnez-moi de bonnes Instructions pour ne plus aller à pied.
Je ſçay déja tout le petit Manége de l’Etude;	Je sais déjà tout le petit Manège de l'Eude;
mais je ne ſçay pas encore les coups de Maiſtre, qui font aller en Carroſſe.	mais je ne sais pas encore les coups de Maître, qui font aller en Carrosse.
COQUINIERE.	COQUINIERE.
Doucement, doucement, on ne va pas ſi viſte dans noſtre Meſtier.	Doucement, doucement, on ne va pas si vite dans notre Métier.
Dites-moy auparavant, aimez vous bien l’argent?	Dites-moi auparavant, aimez -vous bien l'argent?
Vous ſentez-vous d’humeur a tout faire pour en amaſſer?	Vous sentez-vous d'humeur a tout faire pour en amasser?
GRAPINIAN.	GRAPINIAN.
Malepeſte, ſi j’aime l’archt.	Malepeste, si j'aime l'archaît.
COQUINIERE.	COQUINIERE.
Bon, tant-mieux, vous voila deja à demy Procureur.	Bon, tant-mieux, vous voilà déjà à demi Procureur.
Mon Fils, attachetoy aux Saiſies réelles, aux Préferences de deniers;	Mon Fils, attachetoy aux Saisies réelles, aux Préférences de deniers;
remue Ciel & Terre pour eſtre Procureur des bonnes Directions;	remue Ciel et Terre pour être Procureur des bonnes Directions;
& ſur tout, ne t’endors jamais turmaeConſignation;	et sur tout, ne t'endors jamais turmaeConsignation;
c’eſt le vray Patrimoine des Procureurs.	c'est le vrai Patrimoine des Procureurs.
Qu’on ne vous voye que rarement aux Audiances;	Qu'on ne vous voit que rarement aux Audiances;
apliquezvous aux Procés par écrit, & multipliez ſi adroitement les Incidens, & la Procédure, qu’uncAffaire blanchiſſe dans voſtre Etude, avant que d’eſtre jugée.	apliquezvous aux Procès par écrit, et multipliez si adroitement les Incidents, et la Procédure, qu'uncAffaire blanchisse dans votre Étude, avant que d'être jugée.
Sur tout, prenez garde de ne conſentir jamais à aucun Arreſt définitif, c’eſt la peſte des Etudes.	Sur tout, prenez garde de ne consentir jamais à aucun Arrest définitif, c'est la peste des Éudes.
GRAPINIAN.	GRAPINIAN.
On voit bien que vous l’entendez.	On voit bien que vous l'entendez.
COQUINIERE.	COQUINIERE.
Dans noſtre Meſtier, le vray talent & le grand gain, c’eſt de beaucoup ccrire.	Dans notre Métier, le vrai talent et le grand gain, c'est de beaucoup ccrire.
GRAPINIAN.	GRAPINIAN.
Mais que dire en tant d’Ecritures?	Mais que dire en tant d'Écritures?
COQUINIERE.	COQUINIERE.
Que dire?	Que dire?
Le pauvre Homme!	Le pauvre Homme!
Il faut dire des ſottiſes, des impertinences, des ſupoſitions, des fauſſetez;	Il faut dire des sottises, des impertinences, des supositions, des faussetés;
& quand on eſt à bout, on a recours aux invectives, & aux injures.	et quand on est à bout, on a recours aux invectives, et aux injures.
GRAPINIAN.	GRAPINIAN.
Cent lencemure, velde	Cent lencemure, velde
COQUINIERE.	COQUINIERE.
Tu vois que je te parle en Pere, & que je te decouvre les entrailles de noſtre Profeſſion.	Tu vois que je te parle en Père, et que je te découvre les entrailles de notre Profession.
Que je ſeray conſole en mourant, ſi je te vois ſuivre le bon chemin où je te meus!	Que je serai console en mourant, si je te vois suivre le bon chemin où je te meus!
Voila, mon Fils, les Preceptes les plus ſolides que mon honneur & ma conſcience m’obligent de te donner, ſi tu veux ẽtablir ta fortune.	Voilà, mon Fils, les Préceptes les plus solides que mon honneur et ma conscience m'obligent de te donner, si tu veux ẽtablir ta fortune.
GRAPINIAN.	GRAPINIAN.
Mr Coquiniere;	Mr Coquinière;
la, franchement, dites-moy combien voſtre Etude me vaudra-t-elle par an?	la, franchement, dites-moi combien votre Étude me vaudra-elle par an?
COQUINIERE.	COQUINIERE.
Hé, cela n’ira pas loin de deux iiie fralles;	Hé, cela n'ira pas loin de deux jiie fralles;
la Maiſon défrayee.	la Maison défraie.
GRAPINIAN.	GRAPINIAN.
Deux mille francs deux mille francs!	Deux mille francs deux mille francs!
Vous vous nis queuyrs n’eſt pas là dequoy avoir un Habit d’Eté pour maFemme.	Vous vous nis queurir n'est pas là dequoy avoir un Habit d'Été pour maFemme.
Je ne veux point de voſtre claendue.	Je ne veux point de votre clendue.
COQUINIERE.	COQUINIERE.
Voſtre Femme le porte donc bien haut!	Votre Femme le porte donc bien haut!
GRAPINIAN.	GRAPINIAN.
Haut, comme les autres Procureuſes.	Haut, comme les autres Procureuses.
COQUINIERE.	COQUINIERE.
He, mon Dieu, doucement, les deux mille francs ne ſont que le courant de l’Etude;	He, mon Dieu, doucement, les deux mille francs ne sont que le courant de l'Etude;
mais le tour du Baſton, & le ſçavoir faire, valent encore mille bonnes Piſtoles par an.	mais le tour du Bâton, et le savoir faire, valent encore mille bonnes Pistoles par an.
GRAPINIAN.	GRAPINIAN.
Ha, ſi cela eſt, l’Affaire change de face.	Ha, si cela est, l'Affaire change de face.
Hé-bien, M Coquiniere, retenez pour vous le courant de l’Etude, & vendez-moy le tour du Baſton, & le ſçavoir fairc.	Hé-bien, M Oquinière, retenez pour vous le courant de l'Etude, et vendez-moi le tour du Bâton, et le savoir fairc.
COQUINIERE.	COQUINIERE.
L’un ne va pas ſans l’autre;	L'un ne va pas sans l'autre;
& puis que vous avez ſigné le Contract, vous aurez le tout enſemble.	et puis que vous avez signé le Contrat, vous aurez le tout ensemble.
He, que vous me remercirez avant qu’il ſoit un an!	He, que vous me remercirez avant qu'il soit un an!
GRAPINIAN.	GRAPINIAN.
Que je feray de mal avant qu’il ſoit ſix mois!	Que je ferai de mal avant qu'il soit six mois!
Un Chien enrage n’eſt pas ſi dangereux qu’un jeun e Procureur.	Un Chien enrage n'est pas si dangereux qu'un jeun eu Procureur.
Malheur à coun quicemberone lous ma coupe.	Malheur à coun quicembérone lous ma coupe.
SCENE II.	SCÈNE II.
LA MATRONE, GRAPINIAN.	LA MATRONE, GRAPINIAN.
A MATRONE.	À MATRONE.
E’-bien?	E'bien?
eſtes-vous i content de la Char ge que jevous ay achetée?	êtes-vous y content de la Char ge que jevous ai achetée?
GRAPINIAN.	GRAPINIAN.
Je viens d’eſtre inſtruit par un vieux Routier qui m’a donné de bonnes leçons.	Je viens d'être instruit par un vieux Routier qui m'a donné de bonnes leçons.
Il m'a découvert i ſqu’aux entrailles de la Profeſſion.	Il m'a découvert y squ'aux entrailles de la Profession.
A préſent que vcy clair, je feray merVLiS.	À présent que vci clair, je ferai merULiS.
EMMMRII	EMMRII
4 21 LA MATRONE.	4 21 LA MATRONE.
iincriu Mn Be Mais quand prétendezvous m’épouſer?	jincriv Mn Be Mais quand prétendezvous m'épouser?
GRAPINIAN.	GRAPINIAN.
Ne vous mettez en peine de rien.	Ne vous mettez en peine de rien.
En cinq ou ſix mois paſſez dans aà Charge, je batray bien du Païs.	En cinq ou six mois passez dans à Charge, je batrai bien du Pays.
De la maniere que j’ay le cœur fait, Fripon autant qu’on peut l’eſtre, je ſuis aſſuré que dans ces ſix mois j’auray amaſſé dequoy vous donner de la dorure par deſſus la teſte, avec un Carroſſe aubout.	De la manière que j'ai le cœur fait, Fripon autant qu'on peut l'être, je suis assuré que dans ces six mois j'aurai amassé dequoy vous donner de la dorure par -dessus la tête, avec un Carrosse aubout.
Ce ſera le moyen de faire bombance en nous mariant.	Ce sera le moyen de faire bombance en nous mariant.
b- LA MATRONE.	b- LA MATRONE.
Et vous me tiendrez parole quand vous aurez acquis tant de Bien?	Et vous me tiendrez parole quand vous aurez acquis tant de Bien?
GRAPINIAN.	GRAPINIAN.
Je vous la tiendray de reſte.	Je vous la tiendrai de reste.
Allez, il faut que acheve de dicter une Piece qui eſt fort preſſée.	Allez, il faut que achève de dicter une Pièce qui est fort pressée.
A ſon Clerc.	À son Clerc.
Prenez le rôle que vous avez commencé tantoſt.	Prenez le rôle que vous avez commencé tantôt.
Je me ſouviens de l’endroit où nous ſommes demeurez.	Je me souviens de l'endroit où nous sommes demeurez.
21I 22NE III.	21I 2NE III.
AVNM ARLEQUIN dans ſon Etude, qui dicte à un de ſes Clercs.	AUNM ARLEQUIN dans son Étude, qui dicte à un de ses Clercs.
GRAPINIAN dicte.	GRAPINIAN dicte.
hèiel.	hériel.
IU I pour faire connoiſtre la chicane de la Demandereſſe, il repete, la Chicane de la Demandereſſe, produit quatre Pieces, produit quatre Picces, ſous la Cotte G.	IV I pour faire connaître la chicane de la Demanderesse, il répète, la Chicane de la Demanderesse, produit quatre Pièces, produit quatre Picces, sous la Cotte G.
leſquelles.	lesquelles.
LE CLERC.	LE CLERC.
On n’écrit pas doucement;	On n'écrit pas doucement;
mais c’eſt que vous dietez tropvne, & qu'on ne peut vous ſuivre.	mais c'est que vous dietez tropUne, et qu'on ne peut vous suivre.
GRAPINIAN.	GRAPINIAN.
On ne peut me ſuivre?	On ne peut me suivre?
Oh ne vous y trõpez pas;	Oh ne vous y trommes pas;
a nie veux point de Clerc ceans, qu’il ne faſſe quatre-vingts rôles de Groſſes par jour.	a nie veux point de Clerc ans, qu'il ne fasse quatre-vingts rôles de Grosses par jour.
Vous ne pouvez me ſuivre?	Vous ne pouvez me suivre?
Voyons, s’il vous plaiſt, comment vous vous y prenez.	Voyons, s'il vous plaît, comment vous vous y prenez.
Il regarde le Papier où le Clerc a écrit, & le jettant ſur le Bureau, il dit, Comment diable?	Il regarde le Papier où le Clerc a écrit, et le jetant sur le Bureau, il dit, Comment diable?
Je ne m’etonne pas ſi vous allez ſi doucement;	Je ne m'étonne pas si vous allez si doucement;
vous mettez quatre mots à une ligne;	vous mettez quatre mots à une ligne;
voila le moyen de faire une bonne Maiſon.	voilà le moyen de faire une bonne Maison.
Que cela ne vous arrive plus.	Que cela ne vous arrive plus.
Je ne veux pas qu’on mette plus de deux mots & une virgule a chaque ligne.	Je ne veux pas qu'on mette plus de deux mots et une virgule a chaque ligne.
Peſtci De ce train-la, vous envoyeriez bien toſt le Procureur à l’Hôpital.	Pestci De ce train-la, vous envoyeriez bien tôt le Procureur à l'Hôpital.
Quatre mots a une ligné!	Quatre mots à une ligné!
Fy, c’eſt ſe moquer.	Fi, c'est se moquer.
Quatre mots à une ligne;	Quatre mots à une ligne;
Quand il eſt a ſon Bureau, il dit, A-t-on envoyé enlever les Meubles de ce Maître à dancer?	Quand il est à son Bureau, il dit, A-t-on envoyé enlever les Meubles de ce Maître à dancer?
LE CLERC.	LE CLERC.
Non, Monſieur.	Non, Monsieur.
GRAPINIAN.	GRAPINIAN.
Eſt- ce qu’il prétend payer ſon terme en gambades?	Est- ce qu'il prétend payer son terme en gambades?
LE CLERC.	LE CLERC.
Il dit qu’il ne peut tirer un double de ſes EcoHe18.	Il dit qu'il ne peut tirer un double de ses ÉcoHe18.
SCENE IV GRAPINIAN.	SCÈNE IV GRAPINIAN.
Un Voleur de grand Chemin.	Un Voleur de grand Chemin.
LE CLERC.	LE CLERC.
Oüy, Monſieur.	Oui, Monsieur.
LE VOLEUR à Grapinian.	LE VOLEUR à Grapinian.
Monſieur, je ſuis voſtre Perviteur.	Monsieur, je suis votre Perviteur.
GRAPINIAN ſe levant de ſa Chaiſe.	GRAPINIAN se levant de sa Chaise.
Monneur jujs rais le voſtre.	Monneur jujets rais le vôtre.
LE VOLEUR.	LE VOLEUR.
Un petit mot, Monſieur, s’il vous plaiſt.	Un petit mot, Monsieur, s'il vous plaît.
GRAPINIAN s’approchant de luy.	GRAPINIAN s'approchant de Seigneur.
De quoy s’agit-il pour voſtre ſervice?	De quoi s'agit-il pour votre service?
LE VOLEUR.	LE VOLEUR.
Comme vous eſtes le plus honneſte Homme de tous les Procureurs, je viens à vous, pour vous prier de m’aider de voſtre bon conſeil, dans une petite bagatelle qui m’eſt arrivée.	Comme vous êtes le plus honnête Homme de tous les Procureurs, je viens à vous, pour vous prier de m'aider de votre bon conseil, dans une petite bagatelle qui m'est arrivée.
SIIINCIANT.	SIINCIANT.
Dites, Monſieur.	Dites, Monsieur.
LE VOLEUR.	LE VOLEUR.
En paſſant ſur le grand chemin, j’ay rencontre un Homme monte ſur une Mazete, C’eſtoit un Marchand qui venoit de la Foire.	En passant sur le grand chemin, j'ai rencontre un Homme monte sur une Mazète, C'était un Marchand qui venait de la Foire.
En paſſant, il m’a heurté rudement.	En passant, il m'a heurté rudement.
Il heurte Grapinian, qui fait trois ou quatre pas, & ſe toüchant le coude, il répond, Aſſez, Monſieur.	Il heurte Grapinian, qui fait trois ou quatre pas, et se toüchant le coude, il répond, Assez, Monsieur.
LE VOLEUR continuë.	LE VOLEUR continue.
Moy me ſentant heurté, je luy ay dit, Que veut celuy-là avec ſa Roſſe?	Moi me sentant heurté, je lui ai dit, Que veut celui-là avec sa Rosse?
Cet Homme prenant le party de ſon Cheval, met pied à terre, & ſe jette à mon col.	Cet Homme prenant le parti de son Cheval, met pied à terre, et se jette à mon col.
Nous nous batons, & je le terraſſe.	Nous nous battons, et je le terrasse.
Comme il n’eſtoit pas le lus fort, il s’échape de	Comme il n'était pas le lus fort, il s'échappe de
LE VOLEUR.	LE VOLEUR.
Ii y pouvoit bien avoir environ vingt Piſtoles.	Ji y pouvait bien avoir environ vingt Pistoles.
GRAPINIAN.	GRAPINIAN.
Hom, hom.	Hom, hom.
LE VOLEUR.	LE VOLEUR.
voyant qu’il avoit gagne au pied, je ramaſſe l’argent, je monte ſur ſon Cheval, & je ſuis revenu comme ſi de rien n’eſtoit.	voyant qu'il avait gagne au pied, je ramasse l'argent, je monte sur son Cheval, et je suis revenu comme si de rien n'était.
A cette heure on m’a dit que ce Coquin-là, Monſieur, (Grapinian fait une revérence,) fait informer contre moy, comme contre un Voleur de grand chemin.	À cette heure on m'a dit que ce Coquin-là, Monsieur, (Grapinan fait une révérence,) fait informer contre moi, comme contre un Voleur de grand chemin.
Voyez s’il y a la moindre apparence.	Voyez s'il y a la moindre apparence.
Je vous prie de me dire, où peut bien aller cette Afſaire-là?	Je vous prie de me dire, où peut bien aller cette Afsaire-là?
GRAPINIAN.	GRAPINIAN.
Ma foy, ſi cette Affaire eſt menẽe un peu chaudement, elle pourroit bien aller tout droit à la Greve.	Ma foi, si cette Affaire est mène un peu chaudement, elle pourrait bien aller tout droit à la Greve.
EMIOLEUR.	EMIOLEUR.
Diable!	Diable!
* RAPINIAN.	* RAPINIAN.
herquumd-t-il vu l’action?	herquumd-t-il vu l'action?
LE VOLLON Non Monſieur.	LE VOLON Non Monsieur.
GRAPINIAN.	GRAPINIAN.
Tant-mieux.	Tant-mieux.
Il faut cõmencer par faire mettre le Cheval ſous la clef;	Il faut commencer par faire mettre le Cheval sous la clef;
car ſi ce Marchand vient A i a le découvrir, n’ayant point de Témoins, il ne manquera jamais de le faire interroger ſur Faits & Articles, & vous ſeriez perdu.	car si ce Marchand vient À j' a jamais découvrir, n'ayant point de Témoins, il ne manquera jamais de le faire interroger sur Faits et Articles, et vous seriez perdu.
LE VOLEUR.	LE VOLEUR.
Hé, Monſieur, il n’y a rien a craindre;	Hé, Monsieur, il n'y a rien a craindre;
c’eſt une Roſſe, qui ne peut pas deſſerrer les dents.	c'est une Rosse, qui ne peut pas desserrer les dents.
GRAPINIAN.	GRAPINIAN.
Ne vous fiez-pas à cela.	Ne vous fiez-pas à cela.
Nous voyons tous les jours un Témoin muet, faire bravement rouer ſonTroilnile.	Nous voyons tous les jours un Témoin muet, faire bravement rouer sonTroinile.
LE VOLEUR.	LE VOLEUR.
leite.	leite.
GRAPINIAN.	GRAPINIAN.
Ca, ça, il ne faut point perdre de temps, & il former le premier.	Ça, ça, il ne faut point perdre de temps, et il former le premier.
Les Témoins ieront diablement chers cette annee.	Les Témoins jeront diablement chers cette année.
LE VOLEUR.	LE VOLEUR.
Pourquoy?	Pourquoi?
GRAPINIAN.	GRAPINIAN.
C’eſt qu’on ne leur fait plus de quartier, & qu’on en pend autant qu’on en trouve;	C'est qu'on ne leur fait plus de quartier, et qu'on en pend autant qu'on en trouve;
cela eſt facheux.	cela est fâcheux.
Cependant il en faut avoir, à quelque prix que ce IOit.	Cependant il en faut avoir, à quelque prix que ce JOit.
LE VOLEUR.	LE VOLEUR.
Ma foy, Monſieur, vous aurez bien de la peine, car il ily avoit perreme fur le chemin.	Ma foi, Monsieur, vous aurez bien de la peine, car il y avait perreme fur le chemin.
GRAPINIAN.	GRAPINIAN.
Bon, bon.	Bon, bon.
Nous y en ſcrons bien trouver.	Nous y en scrons bien trouver.
Il eſt un peu de temps ſans rien dire, & apres il continue de la ſorte.	Il est un peu de temps sans rien dire, et après il continue de la sorte.
Je ſonge qu’il y a deux bas.	Je songe qu'il y a deux bas.
Normans qui travaillẽt ordinairement pour moy, mais ils ſont un peu batus de l’oyſeau, & ils ſortent d’une Affaire, ouſans moy, (vous m’entendez bien, ) ils ne ſe rembarqueront qu'a bonnes enſeignes.	Normand qui travaillient ordinairement pour moi, mais ils sont un peu battus de l'oiseau, et ils sortent d'une Affaire, ousans moi, (vous m'entendez bien, ) ils ne se rembarqueront qu'a bonnes enseignes.
LE VOLEUR.	LE VOLEUR.
Tenez, Monſieur, ſortons d’Affaires;	Tenez, Monsieur, sortons d'Affaires;
voila une Bource de vingt Piſtoles.	voilà une Bource de vingt Pistoles.
GRAPINIAN.	GRAPINIAN.
Cela n’eſt tout-au-plus que pour un Temoin, & HIOIERCGA.	Cela n'est tout-au-plus que pour un Temoin, et HIOIERCGA.
LE VOLEUR.	LE VOLEUR.
jen’ay plus d’argent,	j'ai plus d'argent,
GRAPINIAN.	GRAPINIAN.
N’avez-vous pas quelques Nippes, quelques Bijoux, quelque vieux Diamant?	N'avez-vous pas quelques Nippes, quelques Bijoux, quelque vieux Diamant?
En ces occaſions-cy, il ſe faut ſaigner.	En ces occasions-cy, il se faut saigner.
LE VOLEUR.	LE VOLEUR.
Tenez, Monſieur, voila un Diamant de trente Louis, & une Montre, qui en peut bien valoir douze;	Tenez, Monsieur, voilà un Diamant de trente Louis, et une Montre, qui en peut bien valoir douze;
ajuſtez l’Affaire.	ajustez l'Affaire.
GRAPINIAN.	GRAPINIAN.
Je pourray bien pour l’amour de vous, avancer encore cinq ou ſix Piſtores, ee puis tous compte.	Je pourrai bien pour l'amour de vous, avancer encore cinq ou six Pistores, ce puis tous compte.
rez a la fin.	rez a la fin.
LE VOLEUR.	LE VOLEUR.
Monſieur, faites;	Monsieur, faites;
je m’abandonne entre vos mains, je me remẽts à VOtre diſcrétion.	je m'abandonne entre vos mains, je me remens à VOtre discrétion.
GRAPINIAN.	GRAPINIAN.
Allez, laiſſez-moy faire;	Allez, laissez-moi faire;
ce ſera un grand hazard, ſi avec mes deux Têmoins, je n’envoye voſtre Iviar ciald dul Calcres.	ce sera un grand hasard, si avec mes deux Têmoins, je n'envoie votre Jéviar cia r Cialcres.
LE VOLEUR.	LE VOLEUR.
Adieu, Monſieur.	Adieu, Monsieur.
Il s’en va, & Grapinianl appelle.	Il s'en va, et Grapinianl appelle.
GRAPINIAN.	GRAPINIAN.
Monſieur, Monſieur.	Monsieur, Monsieur.
un petit mot.	un petit mot.
Vous avezla une Brandebourg remarquable;	Vous avezla une Brandebourg remarquable;
ſi voſtre Partie la reconnoit, il ne manquera jamais de vous faire arreſter.	si votre Partie la reconnaît, il ne manquera jamais de vous faire arrêter.
Croyezmoy, evitons les malheurs, laiſſez-moy voſtre Brandebourg;	Croyezmoi, évitons les malheurs, laissez-moi votre Brandebourg;
les Archers ſont alerte, & je ſerois fâchẽ qu’on vous priſt au ſortir d’icy.	les Archers sont alerte, et je serais fâchẽ qu'on vous prît au sortir d'ici.
Il luy oſte ſa Drandebourg.	Il était ôte sa Drandebourg.
LE VOLEUR.	LE VOLEUR.
Au moins, prenez garde qu’elle ne ſe perdê.	Au moins, prenez garde qu'elle ne se perdêmes.
GRAPINIAN.	GRAPINIAN.
N’ayez pas peur;	N'ayez pas peur;
je m’en vay la faire parapher ne varietur.	je m'en vais la faire parapher ne variétur.
Le Voleur s’en eſtant allé, Grapinian continuë.	Le Voleur s'en étant allé, Grapinian continue.
Vingt Piſtoles, un Diamant, une Montre, une Brandebourg.	Vingt Pistoles, un Diamant, une Montre, une Brandebourg.
Ne vaut-il pas autant que je profite de cela, qu’un Prevoſt?	Ne vaut-il pas autant que je profite de cela, qu'un Prévôt?
Auſſibien ce Coquin-la ſe va faire roüer au premier jour.	Aussibien ce Coquin-la se va faire rouer au premier jour.
Eſtant retourné à ſon Bureau, il dit.	Étant retourné à son Bureau, il dit.
Ces Marchands de Vin m’ont-ils envoyé les deux demy muids qu’ils m’avoient promis?	Ces Marchands de Vin m'ont-ils envoyé les deux demi muids qu'ils m'avaient promis?
LE CLERC.	LE CLERC.
Non, Monſieur.	Non, Monsieur.
IRAPINIAN.	JRAPINIAN.
22i?	22i?
Hé-bien, bien, leur Affaire ira comme je boiray.	Hé-bien, bien, leur Affaire ira comme je boirai.
SCENE IV GRAPINIAN, MARAUDIN Sergent.	SCÈNE IV GRAPINIAN, MARAUDIN Sergent.
MARAUDIN.	MARAUDIN.
Onſieur Grapinian EVZeſt-il icy?	Onsieur Grapinian EUZest-il ici?
GRAPINIAN.	GRAPINIAN.
Ha morbleu, Mr Maraudin, vous m’avez penſé perdre.	Ha morbleu, M Araudin, vous m'avez pensé perdre.
MARAUDIN.	MARAUDIN.
Comment?	Comment?
D	D
GRAPINIAN.	GRAPINIAN.
Je vous avois prié de faire un Commandement datté de l’an 1647.	Je vous avais prié de faire un Commandement datté de l'an 1647.
pour cette finuire qui eſt ſur le Bureau.	pour cette finuire qui est sur le Bureau.
MARAUDIN.	MARAUDIN.
Tie-Dien, ne Pajeje pas d’abord fait?	Tie-Dien, ne Paje pas d'abord fait?
GRAPINIAN.	GRAPINIAN.
De par tous les Diables, oüy, vous l’avez fait;	De par tous les Diables, oui, vous l'avez fait;
mais au lieu de le datter d’un jour utile, vous l’avez datte d’un Dimanche.	mais au lieu de le dater d'un jour utile, vous l'avez datte 'un Dimanche.
MARAUDIN.	MARAUDIN.
Il eſt vray que je n’avois point d’Almanach de l’an 1647.	Il est vrai que je n'avais point d'Almanach de l'an 1647.
& j’ay mis la datte à la bouleveue.	et j'ai mis la datte à la bouleveue.
GRAPINIAN.	GRAPINIAN.
Que-diable n’en veniez vous prendre un chez moy?	Que-diable n'en veniez -vous prendre un chez moi?
Vous ſçavez que en ay de plus de cent ans de ſuite.	Vous savez que en ai de plus de cent ans de suite.
MARAUDIN.	MARAUDIN.
Une autre fois je ſéray plus circonſpect.	Une autre fois je sérai plus circonspect.
GRAPINIAN.	GRAPINIAN.
Cependant ſi les Juges D I découvrent ce petit manége, ils ne manqueront pas de dire que je ſuis un Fripon;	Cependant si les Juges D I découvrent ce petit manège, ils ne manqueront pas de dire que je suis un Fripon;
& vous ſçavez dans voſtre conſcience, que ce que j’en ay fait, n’eſt que pour vous obliger, & pour faire gagner ma Partie;	et vous savez dans votre conscience, que ce que j'en ai fait, n'est que pour vous obliger, et pour faire gagner ma Partie;
car ſans cela, Il ſifle, le Procés eſtoit flambẽ.	car sans cela, Il sifle, le Procès était flambẽ.
A propos, M'Maraudin, ſouvenez-vous que dans le Decret de ces rraureiit as de Bois, j'Occupe pour neuf Perſonnes, ſous le nomdes Procureurs que je vous ay nommez ce matin.	À propos, M'Maraudin, souvenez-vous que dans le Décret de ces ravreiit as de Bois, j'Occupe pour neuf Personnes, sous le nomdes Procureurs que je vous ai nommez ce matin.
Que les Significations aillent alipeudanerai?	Que les Significations aillent alipeudanerai?
MARAUDIN.	MARAUDIN.
Ne vous en mettez pas en peine, je feray ma Charge.	Ne vous en mettez pas en peine, je ferai ma Charge.
De ce train-là, vous allez lalrc Mſſe Donne Maiſon.	De ce train-là, vous allez laleurc Msse Donne Maison.
GRAPINIAN.	GRAPINIAN.
Les cinq ou ſix premieres années, on travaille un peu chaudement à ſes affaires.	Les cinq ou six premières années, on travaille un peu chaudement à ses affaires.
D iij	 Dijà
MARAUDIN.	MARAUDIN.
Caetre le Hedre.	Caètre le Hèdre.
GRAPINIAN.	GRAPINIAN.
Bon, bon, guare le heurt.	Bon, bon, guare le heurt.
Mon Amy, il n’y a rien de tel que d’établir ſa fortune;	Mon Ami, il n'y a rien de tel que d'établir sa fortune;
apres on ſe fait des riiilisy orr tuene de ſe faire Marguillier.	après on se fait des riilisy orr tuène de se faire Marguillier.
MANAODIN.	MANANDIN.
Vous, Marguillier!	Vous, Marguillier!
GRAPINIAN.	GRAPINIAN.
Oüy-dea, Marguillier.	Oui-dea, Marguillier.
C’eſt un tres-bon Vernis ſur la réputation d’un Procureur.	C'est un très-bon Vernis sur la réputation d'un Procureur.
MARAUDIN en s’en allant.	MARAUDIN en s'en allant.
O le franc Scelerat, le Iralle Seclerat :	Ô le franc Scélérat, le Jralle Seclerat :
GRAPINIAN ſeul.	GRAPINIAN seul.
Il faut que je me défaſſe de ce Fripon-là, il gaſteroit toutes mes affaires.	Il faut que je me défasse de ce Fripon-là, il gâterait toutes mes affaires.
Voyez un peu quelle brutalité;	Voyez un peu quelle brutalité;
datter une Fauſſeté d’un Dimanche!	datter une Fausseté d'un Dimanche!
SCENE V LE MARQUIS, GRAPINIAN, UN PAGE, UN CLERC.	SCÈNE V LE MARQUIS, GRAPINIAN, UN PAGE, UN CLERC.
LE CLERC.	LE CLERC.
Onſieur, un Page vEdemande à vous parler.	Onsieur, un Page vÉdemande à vous parler.
GRAPINIAN.	GRAPINIAN.
Un Page!	Un Page!
La mode en eſt dõc revenuë?	La mode en est do revenuë?
Ces Gens-là ont-ils des Affaires?	Ces Gens-là ont-ils des Affaires?
N’eſtce pas plûtoſt quelque mauvais Train qu’on a délogé?	N'est pas plutôt quelque mauvais Train qu'on a délogé?
Faites le venir.	Faites le venir.
ſeul.	seul.
C’eſt peut-eſtre auſſi quelque Enfant de bonne Maiſon, qui voyant qu’il n’y a plus rien à ſaire avec les Gens de qualité, me vient demander une place dans mon Etude, mais je n’en ay point a luy donner.	C'est peut-être aussi quelque Enfant de bonne Maison, qui voyant qu'il n'y a plus rien à zaïre avec les Gens de qualité, me vient demander une place dans mon Étude, mais je n'en ai point a lui donner.
LE PAGE.	LE PAGE.
Monſieur, c’eſt Mr le Marquis de Grimouche, qui demande à vous parler.	Monsieur, c'est Mr le Marquis de Grimouche, qui demande à vous parler.
GRAPINIAN.	GRAPINIAN.
Qul:	Qul:
LE PAGE.	LE PAGE.
Je vous dis que Mr le Marquis de Grimouche deſſiaiide à vous parler.	Je vous dis que Mr le Marquis de Grimouche dessiaiide à vous parler.
GRAPINIAN.	GRAPINIAN.
Si c’eſt pour peu de temps, qu’il vienne.	Si c'est pour peu de temps, qu'il vienne.
ſeul.	seul.
Viſites de Marquis n’achalandent guëres une Etude;	Visites de Marquis n'achalandent guère une Étude;
car outre qu’ils ſont ignorans en Affaires.	car outre qu'ils sont ignorants en Affaires.
ils empeſchent un Procureur de faire les ſiennes.	ils empêchent un Procureur de faire les siennes.
LE MARQUIS paroiſt.	LE MARQUIS paraît.
Ha, bonjour, Mr Grapinian;	Ha, bonjour, Mr Grapinian;
bonjour, M' Grapinian.	bonjour, M' Grapinian.
Que je ſuis gros de vous voir!	Que je suis gros de vous voir!
Je me fais un vray plaiſir de vous embraſſer, & ſans une groſſe Affaire qui m’a un peu dérangé, je n’aurois pas eſté ſi longtemps ſans vous dire, que je ſuis, morbleu, tout a vous.	Je me fais un vrai plaisir de vous embrasser, et sans une grosse Affaire qui m'a un peu dérangé, je n'aurais pas été si longtemps sans vous dire, que je suis, morbleu, tout a vous.
Sans contredit, vous n’avez pas un meilleur Amy, & plus chaud que moy.	Sans contredit, vous n'avez pas un meilleur Ami, et plus chaud que moi.
En diſant cela, il le tient par la lmain, & luy ſecoue le bras.	En disant cela, il le tient par la lamain, et Ah secoue le bras.
GRAPINIAN.	GRAPINIAN.
Ny plus eſtropiant.	Ni plus estropiant.
LE MARQUIS.	LE MARQUIS.
Dieu ſçait comme je m’en explique.	Dieu serait comme je m'en explique.
GRAPINIAN.	GRAPINIAN.
Vous feriez bien mieux de vous expliquer de certains Frais qui me ſont encore dûs.	Vous feriez bien mieux de vous expliquer de certains Frais qui me sont encore dus.
Vous autres Gens de qualité, quand vous avez frapé deux coups ſur l’épaule du Procureur, vous croyez que c’eſt de l’argent comptant, & qu’un peu de bienveillance acquite vos debtes.	Vous autres Gens de qualité, quand vous avez frappé deux coups sur l'épaule du Procureur, vous croyez que c'est de l'argent comptant, et qu'un peu de bienveillance acquite vos débtes.
En luy montrant ſes Clercs.	En Elle montrant ses Clercs.
Mr le Marquis, on ne nourrit pas quatre Clercs avec des complimens;	Mr le Marquis, on ne nourrit pas quatre Clercs avec des compliments;
& n’ous autres Procureurs, nous n’ecrivons que pour toucher de l’argent.	et n'ous autres Procureurs, nous n'écrivons que pour toucher de l'argent.
LE MARQUIS.	LE MARQUIS.
– Ho, je le ſçay-bien, je le ſçay-bien;	– Ho, je le sais-bien, je le sçay-bien;
mais, Dieumercy, M' Grapinian, je ne vous dois plus rien.	mais, Dieumerci, M' Grapinian, je ne vous dois plus rien.
GRAPINIAN.	GRAPINIAN.
Vous ne me devez plus rien!	Vous ne me devez plus rien!
Et cette Requeſte de ſalvation de trente rôles, qui me la payera?	Et cette Requête de salvation de trente rôles, qui me la payera?
Vous ſçavez que j’y ay paſſé deux nuits.	Vous savez que j'y ai passé deux nuits.
à ſes Clercs.	à ses Clercs.
Hola, où eſt la Requeſte de Mr le Marquis?	Holà, où est la Requête de Mr le Marquis?
LE CLERC.	LE CLERC.
La voila, Monſieur.	La voilà, Monsieur.
GRAPINIAN.	GRAPINIAN.
Comme les Gens de qualité n’ont pas plus d’argent qu’il ne leur en faut, & que d’ailleurs vous me faites l’honneur de m’aimer, je ne prendray que vingt ſols du róle.	Comme les Gens de qualité n'ont pas plus d'argent qu'il ne leur en faut, et que d'ailleurs vous me faites l'honneur de m'aimer, je ne prendrai que vingt sols du rèle.
Il y a trente róles, ce n’eſt que trente francs.	Il y a trente rèles, ce n'est que trente francs.
LE MARQUIS.	LE MARQUIS.
S’il n’y a que cela, bien que le Jeu m’ait un peu coulé a fond, j’ay encore dequoy vous payer.	S'il n'y a que cela, bien que le Jeu 'ait un peu coulé a fond, j'ai encore dequoy vous payer.
Tenez, M' Grapinian, voila une Piece de quatre Piſtoles, prenez dix Ecus, & me rendez quat orze francs.	Tenez, M' Grapinian, voilà une Pièce de quatre Pistoles, prenez dix Écus, et me rendez quat orze francs.
Grapinian tenant la Piece, ſonge, & le Marquis continué.	Grapinian tenant la Pièce, songe, et le Marquis continué.
Quoy?	Quoi?
vous doiloes,	vous doiloes,
GRAPINIAN.	GRAPINIAN.
Je ſonge qu’il ne vous faut rien rendre.	Je songe qu'il ne vous faut rien rendre.
LE MARQUIS.	LE MARQUIS.
Il ne me faut rien rendre?	Il ne me faut rien rendre?
Ne m’avez-vous pas die qu’il fie vous falloit que vingt ſols du róle?	Ne m'avez-vous pas die qu'il fie vous fallait que vingt sols du rèle?
GRAPINIAN.	GRAPINIAN.
Oüy.	Oui.
LE MARQUIS.	LE MARQUIS.
De voſtre propre aveu, la Requeſte n’a que trente róles, qui font trente livres.	De votre propre aveu, la Requeste n'a que trente rèles, qui font trente livres.
GRAPINIAN.	GRAPINIAN.
Celd clc vlay.	Celd clc vlai.
LE MARQUIS.	LE MARQUIS.
Je vous en donne quarante-quatre.	Je vous en donne quarante-quatre.
GRAPINIAN.	GRAPINIAN.
’en demeure d’accord.	’en demeure d’accord.
LE MARQUIS.	LE MARQUIS.
Il me ſemble donc que je compte juſte, quand je vous en demande quatorze.	Il me semble donc que je compte juste, quand je vous en demande quatorze.
GRAPINIAN.	GRAPINIAN.
Vous comptez bien, mais vous redemandez mal.	Vous comptez bien, mais vous redemandez mal.
Quand je fis voſtre Requeſte, le Raporteur eſtoit ſi haſte de juger.	Quand je fis votre Requête, le Rapporteur était si hâte de juger.
que je fus contraint d’entaſſer vos raiſons les unes ſur les autres, & obligé de metre en trente rôles, ce qu’on ne pouvoit dire qu’en quarante-quatre.	que je fus contraint d'entasser vos raisons les unes sur les autres, et obligé de metre en trente rôles, ce qu'on ne pouvait dire qu'en quarante-quatre.
Préſentement que l’Affaire eſt jugée, & que nous avons loiſir d’étendre nos Defences, je m’en vais faire ajouter les quatorze rôles, qui manquent.	Présentement que l'Affaire est jugée, et que nous avons loisir d'étendre nos Défences, je m'en vais faire ajouter les quatorze rôles, qui manquent.
Aux Clercs.	Aux Clercs.
Hola, vous autres, brochez moy viſte quatorze rôles de Groſſe, pour achever la Requeſte de Mrle Marquis.	Holà, vous autres, brochez moi vite quatorze rôles de Grosse, pour achever la Requête de Mrle Marquis.
Je penſe qu’il y en a la de tous faits.	Je pense qu'il y en a la de tous faits.
LE MARQUIS.	LE MARQUIS.
Mon pauvre Mr Grapiman, puis que mon Affaire eſt jugée, pourquoy y ajouter encore queique choſe?	Mon pauvre Mr Grapiman, puis que mon Affaire est jugée, pourquoi y ajouter encore que chose?
GRAPINIAN.	GRAPINIAN.
Ce n’eſt pas par intereſt ce que j’en fais, mais pour mon honneur;	Ce n'est pas par intérêt ce que j'en fais, mais pour mon honneur;
& je ne veux pas qu’il ſorte une paire d’Ecriture de mon Etude, ſans y avoir donné la derniere main.	et je ne veux pas qu'il sorte une paire d'Écriture de mon Etude, sans y avoir donné la dernière main.
Attendez, cela va eſtre fait cout-a-Ineurc.	Attendez, cela va été fait coût-a-Ineurc.
LE MARQUIS.	LE MARQUIS.
Non, mon Amy, je ne puis pas, je cours ce ſoir le Bal;	Non, mon Ami, je ne puis pas, je cours ce soir le Bal;
j’eſtois venu pour vous parler d’une Affaire, mais ce ſera pour unẽ autre fois.	j'étais venu pour vous parler d'une Affaire, mais ce sera pour un autre fois.
Adieu, noſtre Amy.	Adieu, notre Ami.
GRAPINIAN.	GRAPINIAN.
Laiſſez-donc un de vos Gens pour emporter la Atquelte.	Laissez-donc un de vos Gens pour emporter la Atquelte.
LE MARQUIS.	LE MARQUIS.
Un de mes Gens?	Un de mes Gens?
Quoy.	Quoi.
irois moy ſeul dans les Rues avec trois Laquais?	irais moi seul dans les Rues avec trois Laquais?
Hé vous vous moquez, M' Grapinian, on me croiroit à l’Hôpital.	Hé vous vous moquez, M' Grapinian, on me croirait à l'Hôpital.
Laquais, rais courner inoſr Carroſſe.	Laquais, rais courner inosr Carrosse.
GRAPINIAN au Laquais.	GRAPINIAN au Laquais.
Prens-garde qu’il ne verſe.	Prends-garde qu'il ne verse.
LE MARQUIS.	LE MARQUIS.
Adieu, noſtre Amy.	Adieu, notre Ami.
He, un peu de part à vos bonnes graces.	He, un peu de part à vos bonnes grâces.
Je ſuis morDleu code a Vous.	Je suis morDleu code a Vous.
GRAPINIAN.	GRAPINIAN.
Vous la prẽdrez quand vous reviendrez.	Vous la prendrez quand vous reviendrez.
LE MARQUIS.	LE MARQUIS.
Oüy, oüy.	Oui, oui.
SCENE VI.	SCÈNE VI.
GRAPINIAN LE CHAPELIER.	GRAPINIAN LE CHAPELIER.
LE CHAPELIER.	LE CHAPELIER.
Onjour, Mr GrapiD'’hian.	Onjour, Mr GrapiD'hian.
GRAPINIAN à ſes Cleres.	GRAPINIAN à ses Cleres.
Qu’on prenne demain quinze Apointemens ſur ces quinze Doſſiers.	Qu'on prenne demain quinze Appointements sur ces quinze Dossiers.
LE CHAPELIER.	LE CHAPELIER.
Hé-bien, mon Affaire eſt-elle jugée?	Hé-bien, mon Affaire est-elle jugée?
GRAPINIAN.	GRAPINIAN.
Non.	Non.
LE CHAPELIER.	LE CHAPELIER.
Comment, non!	Comment, non!
& pour quoy?	et pour quoi?
GRAPINIAN.	GRAPINIAN.
Parce que voſtre Affaire ne vaut pas le Diable, & que je n’y veus pas travailler.	Parce que votre Affaire ne vaut pas le Diable, et que je n'y veux pas travailler.
LE CHAPELIER.	LE CHAPELIER.
Mon Affaire ne vaut pas le Diable!	Mon Affaire ne vaut pas le Diable!
C’eſt bien autre choſe que cela.	C'est bien autre chose que cela.
GRAPINIAN.	GRAPINIAN.
Je vous dis qu’elle ne vaut pas le Diable, ce qu’on appelle, pas le DIDIC.	Je vous dis qu'elle ne vaut pas le Diable, ce qu'on appelle, pas le DIDIC.
LE CHAPELIER.	LE CHAPELIER.
Que deviendra donc le Chapeau de Caſtor que ay donné au Secretaire de mon Raporteur?	Que deviendra donc le Chapeau de Castor que ai donné au Secretaire de mon Rapporteur?
GRAPINIAN.	GRAPINIAN.
Un Chapeau de Caſtori Vray Caſtor?	Un Chapeau de Castori Vrai Castor?
En s'élevant.	En s'élevant.
LE CHAPELIER.	LE CHAPELIER.
Et des meilleurs qui ſe faſſent.	Et des meilleurs qui se fassent.
Voila le pareil que je raporte chez moy.	Voilà le pareil que je rapporte chez moi.
GRAPINIAN le prenant entre ſes mains, & le maniant.	GRAPINIAN le prenant entre ses mains, et le maniant.
A propos de voſtre Affaire;	À propos de votre Affaire;
n’eſt-ce pas un Patiſſier avec qui vous avez eu du bruit dans là Ruë?	n'est-ce pas un Patissier avec qui vous avez eu du bruit dans là Rue?
L CLAPELIER.	 LLAPELIÈR.
Ouy, Monſieur.	Oui, Monsieur.
GRAPINIAN.	GRAPINIAN.
Qui vous a dit des injures?	Qui vous a dit des injures?
LE CHAPELIER.	LE CHAPELIER.
Oüy, Monſieur.	Oui, Monsieur.
GRAPINIAN.	GRAPINIAN.
Et qui vous à frapé?	Et qui vous à frappé?
LE CHAPELIER.	LE CHAPELIER.
Oüy, Monſieur.	Oui, Monsieur.
GRAPINIAN.	GRAPINIAN.
Vous avez rendu voſtre Plainte?	Vous avez rendu votre Plainte?
LE CHAPELIER.	LE CHAPELIER.
Vrayment!	Vraiment!
je le crois.	je le crois.
GRAPINIAN.	GRAPINIAN.
Préſentement que je l’ay en teſte, je vous dis que je la gagneray.	Présentement que je l'ai en tête, je vous dis que je la gagnerai.
Laiſſez-moy ſeulement quaon clitores pour commencer les Informations.	Laissez-moi seulement quaon clitores pour commencer les Informations.
LE CHAPELIER.	LE CHAPELIER.
Tres-volontiers.	Très-volontiers.
Mais au moins, Monſieur, que je n’en aye pas le démenty.	Mais au moins, Monsieur, que je n'en aie pas le démenti.
GRAPINIAN.	GRAPINIAN.
Tenez-moy pour le plus grand Fripon de tous les Procureurs, ſi je ne vous	Tenez-moi pour le plus grand Fripon de tous les Procureurs, si je ne vous
GRAPINIAN.	GRAPINIAN.
Ne vous embaraſſez point.	Ne vous embarrassez point.
Allez-vous-en, vous dis-je;	Allez-vous-en, vous dis-je;
je m'en vais luy faire bannir ſa Boutique à perpetuité.	je m'en vais toujours faire bannir sa Boutique à perpétuité.
LE CHAPELIER.	LE CHAPELIER.
Il’ert poul dil Troinme qui.	Il’ert poul dil Troinme qui.
GRAPINIAN.	GRAPINIAN.
Je vous dis encore un cõup, que j’ay voſtre Af.	Je vous dis encore un commup, que j'ai votre Af.
faire en teſte, & qu’elle n’en ſortira pas.	faire en tête, et qu'elle n'en sortira pas.
Seul.	Seul.
C’eſt un Pérou que l’Etude d’un Procureur.	C'est un Pérou que l'Etude d'un Procureur.
Aux Clercs.	Aux Clercs.
A-t-on achea cette Requelte.	A-t-on acha cette Requelte.
LE CLERC.	LE CLERC.
Il y en a déja deux cens roles de faits.	Il y en a déjà deux cens rôles de faits.
GRAPINIAN.	GRAPINIAN.
Achevez le reſte en diligence, car on dit que les Parties ſont en termes d’accommodement.	Achevez le reste en diligence, car on dit que les Parties sont en termes d'accommodement.
LE PATISSIER.	LE PÂTISSIER.
Je voudrois bien vous parrer , e Mvous plehe.	Je voudrais bien vous parrer , e Ûvous plehe.
LE PATISSIER.	LE PÂTISSIER.
Tres-volontiers.	Très-volontiers.
E.	E.
voyant un Garçon qui porte queimt enert.	voyant un Garçon qui porte queimt enert.
Approchez, mon Enfant.	Approchez, mon Enfant.
GRAPINIAN.	GRAPINIAN.
On m’a dit, Monſieur, que vous eſtiez Procureur contre moy dans une petite Affaire qui m’eſt arri vec.	On m'a dit, Monsieur, que vous étiez Procureur contre moi dans une petite Affaire qui m'est arry ec.
GRAPINIAN.	GRAPINIAN.
Qui eſt voſtre Partie?	Qui est votre Partie?
LE PATISSIER.	LE PÂTISSIER.
C’eſt un Chapelier.	C'est un Chapelier.
GRAPINIAN.	GRAPINIAN.
Tenez, il ne fait que de ſortir d’icy.	Tenez, il ne fait que de sortir d'ici.
LE PATISSIER.	LE PÂTISSIER.
Ha, Monſieur, c’eſt un mechant Homme.	Ha, Monsieur, c'est un méchant Homme.
GRAPINIAN.	GRAPINIAN.
Bon, a qui le dites-vous?	Bon, à qui le dites-vous?
n’ay jamais veu un Homme plus endiablé, & plus acharne au Proces.	n'ai jamais vu un Homme plus endiablé, et plus acharne au Proces.
LE PATISSIER.	LE PÂTISSIER.
Il ſe vante par tout qu’il me fera faire Amende MonOraDlc.	Il se vante par tout qu'il me fera faire Amende MonOraDlc.
GRAPINIAN.	GRAPINIAN.
Il fera bien pis, ſi je ne l’en empeſche;	Il fera bien pis, si je ne l'en empêche;
mais je ne veux pas qu’il pouſſe à bout un honneſte Homme comme vous.	mais je ne veux pas qu'il pousse à bout un honnête Homme comme vous.
GRAPINIAN touchant le Paſté.	GRAPINIAN touchant le Pasté.
C’eſt toûjours quelque choſe;	C'est toujours quelque chose;
mais, noſtre Amy, le Criminel va diablement viſte, & il y a déja bien du papier brouillé.	mais, notre Ami, le Criminel va diablement vite, et il y a déjà bien du papier brouillé.
LE PATISSIER.	LE PÂTISSIER.
Je m’en vais vous rendre lur le champ tout ce que vous avez débourſé.	Je m'en vais vous rendre lur le champ tout ce que vous avez déboursé.
GRAPINIAN.	GRAPINIAN.
Vous ne ſçauriez mieux dire.	Vous ne sauriez mieux dire.
Ecoutez, je ne ſuis pas un Tyran, & je vous en ſortiray pour peu de choſe.	Écoutez, je ne suis pas un Tyran, et je vous en sortirai pour peu de chose.
LE PATISSIER ouvrant ſa Bourſe, & la luy préſentant.	LE PÂTISSIER ouvrant sa Bourse, et la vie présentant.
Tenez, Monſieur, prenez.	Tenez, Monsieur, prenez.
GRAPINIAN.	GRAPINIAN.
Ha, vous me comblez.	Ha, vous me comblez.
Puis que vous en agiſſez ainſy, je ne prendray que vingt écus.	Puis que vous en agissez ains, je ne prendrai que vingt écus.
Vous voyez que ce n’eſt que le papier.	Vous voyez que ce n'est que le papier.
que vous tiriez l’Affaire eh longueur.	que vous tiriez l'Affaire est longueur.
GRAPINIAN.	GRAPINIAN.
Je vous vais mettre avec mes l'enſionnaires.	Je vous vais mettre avec mes l'ensionnaires.
LE PATISSIER.	LE PÂTISSIER.
Qui fone vos PeiOſnaires?	Qui fone vos PéiOsnaires?
GRAPINIAN.	GRAPINIAN.
Ce ſont de bonnes Gens comme vous, qui me donnent tous les ans quelque choſe pour les laiſſer en repos;	Ce sont de bonnes Gens comme vous, qui me donnent tous les ans quelque chose pour les laisser en repos;
les uns mille fracs, les autres quatre cens livres, les autres dix Piſtoles, qui plus, qui moins, ſuivant que l’Affaire eſt de conſéquence.	les uns mille fracs, les autres quatre cens livres, les autres dix Pistoles, qui plus, qui moins, suivant que l'Affaire est de conséquence.
Voyezvous ce gros Sac, C’eſt contre un Homme de la premiere qualité, que je laiſſe jouir de tout lon Bien à la barbe de ſes Creanciers.	Voyezvous ce gros Sac, C'est contre un Homme de la première qualité, que je laisse jouir de tout lon Bien à la barbe de ses Créanciers.
Ce ſeroit une terrible choſe, ſi nous faiſions tout le mal que nous pouvons faire!	Ce serait une terrible chose, si nous faisions tout le mal que nous pouvons faire!
Il faut eſtre humain en certaines occaſions, & ne pas pouſſer des Gens qui s’aident, qui viennent au devant de vous, & qui vous lient les mains, en vous donnant quelque choſe pour les laiſſer en repos.	Il faut être humain en certaines occasions, et ne pas pousser des Gens qui s'aident, qui viennent au devant de vous, et qui vous lient les mains, en vous donnant quelque chose pour les laisser en repos.
LE PATISSIER.	LE PÂTISSIER.
Dieu vous conſerve.	Dieu vous conserve.
M' Grapinian, pour tous ceux à qui vous rendez ſervice.	M' Grapinian, pour tous ceux à qui vous rendez service.
GRAPINIAN.	GRAPINIAN.
Vous eſtes bien heureux d’eſtre tombé entre mes draceinas.	Vous êtes bien heureux d'être tombé entre mes draceinas.
LE PATISSIER.	LE PÂTISSIER.
Pourveu que vous tiriez l’Affaire en longueur.	Pourvu que vous tiriez l'Affaire en longueur.
GRAPINIAN.	GRAPINIAN.
Allez, je vous promets, foy d’Homme d’honneur, que d’un an d’icy on ne fera une pance d’a contre vous.	Allez, je vous promets, foi d'Homme d'honneur, que d'un an d'ici on ne fera une pance d'a contre vous.
Seul.	Seul.
Vingt écus!	Vingt écus!
Si cela continue, il me faudra un Cofre fort.	Si cela continue, il me faudra un Cofre fort.
3 ii	3 ji
SCENE VIII.	SCÈNE VIII.
GRAPINIAN, UNE PLAIDEUSE.	GRAPINIAN, UNE PLAIDEUSE.
LA PLAIDEUSE entrant.	LA PLAIDEUSE entrant.
A, bon Dieu, je  Eſuis perdue, je ſuis ruinée.	À, bon Dieu, je Es perdue, je suis ruinée.
Ha, voleur de Grapinian, je t'etrangleray.	Ha, voleur de Grapinian, je t'étranglerai.
Les Clercs courent pour la retenir.	Les Clercs courent pour la retenir.
CIAPINIAN.	CIAPINIAN.
A qui en veut cette Fole?	À qui en veut cette Fole?
LA PLAIDEUSE.	LA PLAIDEUSE.
quin, apres m’avoir ruinée?	quin, après m'avoir ruinée?
Tu m’avois dit que ma Cauſe eſtoit bonne, & je viens de la perdre avec dépens.	Tu m'avais dit que ma Causse était bonne, et je viens de la perdre avec dépens.
GRAPINIAN.	GRAPINIAN.
qu’elle ne fuſt bonne, mais tres-bonne, & une des meilleures de mon Etude.	qu'elle ne fût bonne, mais très-bonne, et une des meilleures de mon Étude.
a part.	à part.
J’en ay déja touche plus de huit cens francs.	J'en ai déjà touche plus de huit cens francs.
LA PLAIDEUSE.	LA PLAIDEUSE.
C’eſt donc par cet endroit que tu la trouves bonne?	C'est donc par cet endroit que tu la trouves bonne?
GRAPINIAN.	GRAPINIAN.
Ha, que de babil!	Ha, que de babil!
Si vous n’eſtiez pas ſi emportee, je vous ferois voir au doigt & a l’œil, que vous gagnez voſtre Cauſe, en perdant voſtre Proces;	Si vous n'étiez pas si emporte, je vous ferais voir au doigt et à l'œil, que vous gagnez votre Causse, en perdant votre Proces;
mais comme je ſuis un Fripon, un Coquin.	mais comme je suis un Fripon, un Coquin.
LA PLAIDEUSE.	LA PLAIDEUSE.
Mais faites-moy donc comprendre par où je IEERISOT	Mais faites-moi donc comprendre par où je JERISOT
GRAPINIAN.	GRAPINIAN.
N’eſt-ce pas un coup de vray Amy, d’avoir tiré la principale Piece de voſtre Sac, pour en faire un Moyen infaillible de Requeſte Civile contre l’Arreſt d’aujourd’huy?	N'est-ce pas un coup de vrai Ami, d'avoir tiré la principale Pièce de votre Sac, pour en faire un Moyen infaillible de Requête Civile contre l'Arrêt d'aujourd'hui?
Vous pleurez préſentement;	Vous pleurez présentement;
mais que vous rirez dans cinq ou ſix ans d’icy, quand la Requeſte Civile ſera gagnée, & qu’il y aura de bons gros dommages & intereſts, qui excéderont deux fois la ſomme qu’on vous doibt!	mais que vous rirez dans cinq ou six ans d'ici, quand la Requête Civile sera gagnée, et qu'il y aura de bons gros dommages et intérêts, qui excéderont deux fois la somme qu'on vous doibt!
On ſçait bien qu’il n’y aura rien à perdre pour moy;	On naît bien qu'il n'y aura rien à perdre pour moi;
mais alors le Procureur ne ſera plus un Fripon.	mais alors le Procureur ne sera plus un Fripon.
C’eſt unc choſe pitoyable, de voir comme on traite les Gens d’honneur de noſtre Profeſſion.	C'est un chose pitoyable, de voir comme on traite les Gens d'honneur de notre Profession.
Nous avons beau travailler nuit & jour, paſſer les nuits à écrire, avancer noſtré argent, perdre noſtre temps;	Nous avons beau travailler nuit et jour, passer les nuits à écrire, avancer nostré argent, perdre notre temps;
apres tout cela, bon, les Procureurs ſont encore des Fripons.	après tout cela, bon, les Procureurs sont encore des Fripons.
Voila en un ſeul mot toute la récompenſe de nos peines.	Voilà en un seul mot toute la récompense de nos peines.
LA PLAIDEUSE.	LA PLAIDEUSE.
Mr Grapinian, je ne veux point tater de Requeſte Civile.	Mr Grapinian, je ne veux point tâter de Requête Civile.
GRAPINIAN.	GRAPINIAN.
Que vous eſtes fole!	Que vous êtes sole!
Sans Requeſte Civile, les Affaires n’ont point de gouſt;	Sans Requête Civile, les Affaires n'ont point de goût;
c’eſt la Roquembole du Proces.	c'est la Roquembole du Proces.
LA PLAIDEUSE.	LA PLAIDEUSE.
Gardez voſtre Ragouſt pour quelqu’autre Plaideuſe.	Gardez votre Ragoût pour quelque autre Plaideuse.
Pour moy, je veux m’accommoder, & pãſſer une Tranſaction qui termine toutes mes Affaircs.	Pour moi, je veux m'accommoder, et puisser une Transaction qui termine toutes mes Affaircs.
GRAPINIAN.	GRAPINIAN.
Toutes vos Affaires!	Toutes vos Affaires!
Le depuis quand plaidezvous, ne vous en déplaiſe?	Le depuis quand plaidezvous, ne vous en déplaise?
LA PLAIDEUSE.	LA PLAIDEUSE.
Depuis treize ans;	Depuis treize ans;
& me voila, Dieu mercy & vous, auſſi avancée que le premier jour.	et me voilà, Dieu merci et vous, aussi avancée que le premier jour.
GRAPINIAN.	GRAPINIAN.
Quoy, il n’y a que treize ans?	Quoi, il n'y a que treize ans?
On voit bien que vous n’eſtes qu’une Novice.	On voit bien que vous n'êtes qu'une Novice.
Allez, allez, il faut u joir plelede vous.	Allez, allez, il faut joir plelede vous.
LA PLAIDEUSE.	LA PLAIDEUSE.
Non, Mr Grapinian, je veux m’accommoder.	Non, Mr Grapinian, je veux m'accommoder.
GRAPINIAN.	GRAPINIAN.
Ce nie fera pas de moſ avis toûjours.	Ce nie fera pas de mos avis toujours.
LA PLAIDEUSE.	LA PLAIDEUSE.
Et pourquoy?	Et pourquoi?
GRAPINIAN.	GRAPINIAN.
Parce qu’un Procureur qui ſçait ſon meſtier, ne H conſent jamais aucun ACCOOChCIIC.	Parce qu'un Procureur qui sait son métier, ne H consent jamais aucun ACCOOChCIIC.
LA PLAIDEUSE.	LA PLAIDEUSE.
Mais.	Mais.
GRAPINIAN.	GRAPINIAN.
Mais, cela eſt contre les Statuts de nôtre Communauté.	Mais, cela est contre les Statuts de notre Communauté.
Malepeſté, je m’attircrois tous mes Confreres à dos, s’ils ſçavoient quà mon age euſſe cõſenty une Tranſaction.	Malepesté, je m'attircrais tous mes Confreres à dos, s'ils savaient quà mon âme eusse cõsenty une Transaction.
C’eſt tout ce que pourroit faire un de nos Anciens à l’agonie, encore y penſeroit-il à deux fois;	C'est tout ce que pourrait faire un de nos Anciens à l'agonie, encore y penserait-il à deux fois;
ouy.	oui.
LA PLAIDEUSE.	LA PLAIDEUSE.
ioy, ſi je vous priois de m endrener dile?	joi, si je vous priais de m endrener dile?
GRAPINIAN.	GRAPINIAN.
Vous auriez beau me prier, je ne le pourrois pas faire en conſcience.	Vous auriez beau me prier, je ne le pourrais pas faire en conscience.
Donnez-moy ſeulement quatre cens cinquante livres pour la conſignation de la Requeſte civile, & allez vous mettre au Lit pour vous repoſer, car vous eſtes bien échaufée.	Donnez-moi seulement quatre cents cinquante livres pour la consignation de la Requeste civile, et allez vous mettre au Lit pour vous reposer, car vous êtes bien échauffée.
à part.	à part.
Il faut avoüer que je n’ay guere de fiel!	Il faut avouer que je n'ai guère de fiel!
Un H ij autre que moy, apres les injures.	Un H aj autre que moi, après les injures.
Mais je mets tout cela lous les pleds.	Mais je mets tout cela lous les pleds.
LA PLAIDEUSE.	LA PLAIDEUSE.
Juſte Ciel!	Juste Ciel!
bailler encore quatre cens cinquante livres!	bailler encore quatre cens cinquante livres!
GRAPINIAN.	GRAPINIAN.
Le teſips de la ſcecolte viendra.	Le témips de la scolte viendra.
LA PLAIDEUSE.	LA PLAIDEUSE.
On a beau ſe fâcher contre ces boureaux de li bcureurs, ils attrapent toûjours voſtre argent.	On a beau se fâcher contre ces boureaux de li bcureurs, ils attrapent toujours votre argent.
à part.	à part.
Dans le dépit où je ſuis, je donnerois volontiers tout mon Bien à quelque honneſte Homme, qui m’en feroit jouir en patience le reſte de mes jours.	Dans le dépit où je suis, je donnerais volontiers tout mon Bien à quelque honnête Homme, qui m'en ferait jouir en patience le reste de mes jours.
A la ſui n faudra que je me mârie.	À la su n audra que je me mârie.
*RAPINIAN.	*RAPINIAN.
Avreccremone ne, colibieſ avez-vous de Bien?	Avreccémone ne, colibies avez-vous de Bien?
LA PLAIDEUSE.	LA PLAIDEUSE.
Combien j’ay.	Combien j'ai.
Ne leſçavez-vous pas?	Ne lesçavez-vous pas?
J’ay trois cens mille bonnes livres, & vous en avez tous les Papiers.	J'ai trois cens mille bonnes livres, et vous en avez tous les Papiers.
H iij	H Hijà
GRAPINIAN à part.	GRAPINIAN à part.
Trois cens mille livres!	Trois cens mille livres!
Peſte, quelle aubaine!	Peste, quelle aubaine!
Mademoiſelle, je ſuis vôtre Homme;	Mademoiselle, je suis votre Homme;
vous ne ſçauriez mieux faire que de m'épouſer.	vous ne sauriez mieux faire que de m'épouser.
LA PLAIDEUSE.	LA PLAIDEUSE.
Oüy, voüs épouſer!	Oui, vouds épouser!
Et on dit que vous eſtes marie avec la Matrõne?	Et on dit que vous êtes marie avec la Matrõne?
GRAPINIAN.	GRAPINIAN.
Ce n’eſt qu’en attendant mieux.	Ce n'est qu'en attendant mieux.
Quel âge avez-vous?	Quel âge avez-vous?
LA PLAIDEUSE.	LA PLAIDEUSE.
J’ay environ quatrevilists aiis.	J'ai environ quatrevilits aiis.
GRAPINIAN.	GRAPINIAN.
Hé, morbleu, touchezlà.	Hé, morbleu, touchezlà.
Pour trois ou quatre ans qu’il vous reſte encore a vivre, il faut vous Ies Iaire paici joyeuſcment.	Pour trois ou quatre ans qu'il vous reste encore a vivre, il faut vous Ies Jaire paici joyeuscment.
LA PLAIDEUSE.	LA PLAIDEUSE.
Mais, Mr Grapinian, ſi.	Mais, Mr Grapinian, si.
là Matrone reprend la Charge?	là Matrone reprend la Charge?
GRAPINIAN.	GRAPINIAN.
l’y ay mis bon ordre.	l'y ai mis bon ordre.
Le Contract n’eſt pas fait en fayeur de mariage;	Le Contrat n'est pas fait en faiseur de mariage;
c’eſt une Vente pure & ſimple, où j’ay fait mettre, compté, nombré, e 5 payé des deniers dudit s' Grapinian.	c'est une Vente pure et simple, où j'ai fait mettre, compté, nombré, e 5 payé des deniers dudit s' Grapinian.
Peſte!	Peste!
cela tient comme teigne.	cela tient comme teigne.
LA PLAIDEUSE.	LA PLAIDEUSE.
Mais, Mr Grapinian.	Mais, Mr Grapinian.
m’aimerez-vous du bon du cœur?	m'aimerez-vous du bon du cœur?
GRAPINIAN.	GRAPINIAN.
Si je vous aimeray!	Si je vous aimerai!
Peut-on haïr une Femme qui donne trois cens LA MATRONE qui l’entend parler de la ſorte.	Peut-on haïr une Femme qui donne trois cens LA MATRONE qui l'entend parler de la sorte.
Tu l’adoreras, perfide, traître!	Tu l'adoreras, perfide, traître!
mille livres?	mille livres?
Je vous adoreray.	Je vous adorerai.
GRAPINIAN ſe tournant vers ſa vieille Plaideuſe, luy met une Fontange, & ayant pris ſon Eventail, il l’évente.	GRAPINIAN se tournant vers sa vieille Plaideuse, était met une Fontange, et ayant pris son Éventail, il l'évente.
Ha, le joly cœur de Femme!	Ha, le joli cœur de Femme!
Allons, je vous veux mettre ſur un bon pied pour voſtre argent.	Allons, je vous veux mettre sur un bon pied pour votre argent.
SCENE VIII.	SCÈNE VIII.
GRAPINIAN, LA PLAIDEUSE, LE CHAPELIER, LE PATISSIER, M' LE BAILLY.	GRAPINIAN, LA PLAIDEUSE, LE CHAPELIER, LE PÂTISSIER, M' LE BAILLY.
LE CHAPELIER arreſtant Grapinian par le bras.	LE CHAPELIER arrêtant Grapinian par le bras.
96 Monſieur le Fripon.	96 Monsieur le Fripon.
LE PATISSIER.	LE PÂTISSIER.
Allons, Mr Grapinian, de bonne grace, ſans vous faire preſſer, rendezmoy mes vingt ecus.	Allons, Mr Grapinian, de bonne grâce, sans vous faire presser, rendezmoi mes vingt écus.
DiaSiei vos Penſions ſont trop cheres.	DiaSie vos Pensions sont trop chères.
GRAPINIAN.	GRAPINIAN.
Hé, Meſſieurs, ne me perdez pas;	Hé, Messieurs, ne me perdez pas;
c’eſt aujourd’huy le jour de mes Nôces.	c'est aujourd'hui le jour de mes Nôces.
Je feray plutoſt vos Arfai vol gratis.	Je ferai plutôt vos Arfai vol gratis.
LE CHAPELIER.	LE CHAPELIER.
Quoy, Fripon, tu veux que nous t’aidiõs à tromPer ule relilie s	Quoi, Fripon, tu veux que nous t'aidiõs à tromPer ule relilie s
LA PLAIDEUSE.	LA PLAIDEUSE.
Voila de bien honneſtes Gens!	Voilà de bien honnêtes Gens!
LE CHAPELIER.	LE CHAPELIER.
Il faut tout-à-l’heure que la juſtice en ſoit faite.	Il faut tout-à-l’heure que la justice en soit faite.
Don.	Don.
vond d propex M le Bailly.	vond d propex M le Bailly.
LE BAILLY.	LE BAILLY.
Qu’eſt-ce-cy, mes Enfans?	Qu'est-ce-cy, mes Enfants?
LE CHAPELIER.	LE CHAPELIER.
Ce n’eſt pas grand' choſe;	Ce n'est pas grand' ose;
c’eſt un Procureur qu’il faut faire pendre, Tripon s enc end.	c'est un Procureur qu'il faut faire pendre, Tripon s enc end.
Minique	Minique
LA PLAIDEUSE.	LA PLAIDEUSE.
Cera s'en va lans dire.	Cera s'en va lans dire.
LE BAILLY.	LE BAILLY.
B Il y a donc un grand deſordre dans cette Profeſſion?	B Il y a donc un grand désordre dans cette Profession?
J’en cherche un, qui fait plus de mal luy ſeul, que tous les autres enſemble.	J'en cherche un, qui fait plus de maliblé seul, que tous les autres ensemble.
Noſtre Greffe n’eſt remply que de Plaintes & d’Informations contre luy.	Notre Greffe n'est rempli que de Plaintes et d'Informations contre lui.
GRAPINIAN.	GRAPINIAN.
Franchement, M le Bailly, il y a bien des Fripons dans noſtre Mêtier;	Franchement, M le Bailly, il y a bien des Fripons dans notre Métier;
il n’en faut ainſi que trois ou quatre pour décrier tous les autres.	il n'en faut ainsi que trois ou quatre pour décrier tous les autres.
LE BAILLY.	LE BAILLY.
Celuy que je cherche, Sur pono Plu, Grapian, Gramian.	Celui que je cherche, Sur pono Plu, Grapian, Gramian.
115H I5.	115H I5.
IRAFTNIAN.	JRAFTNIAN.
Ouf.	Ouf.
LE CHAPELIER.	LE CHAPELIER.
Grapinian?	Grapinian?
LE BAILLY .	LE BAILLY .
Juſtement, c’eſt celuylà.	Justement, c'est celuilà.
quii I 1	quii I 1
LE CHAPELIER.	LE CHAPELIER.
de vona, Momcur.	de vona, Momcur.
LE BAILLY.	LE BAILLY.
Quoy, c’eſt là ce fameux Fripon dont tout le monde ſe plaint?	Quoi, c'est là ce fameux Fripon dont tout le monde se plaint?
Il tuuo qui tois pendu ſur le champ.	Il tuuo qui tais pendu sur le champ.
GRAPINIAN.	GRAPINIAN.
He, Momneur, pour l’honneur du Corps.	He, Momneur, pour l'honneur du Corps.
LE BAILLY.	LE BAILLY.
C’eſt pour l’honneur du Corps qu’il te faut pendre tout-a-l’heure, pour chatier un Scélerat, qui deſ-honore Meſſieurs les Procureurs.	C'est pour l'honneur du Corps qu'il te faut pendre tout-là-l'heure, pour châtier un Scélerat, qui des-honore Messieurs les Procureurs.
La Potence eſt dreſſée, qu’on I menc.	La Potence est dressée, qu'on I Jenc.
El f2 vn	El f2 un
