TREFACL.	TREFACL.
Ly a peu d’Hiſtoires auſſi connuës que celle de Medée, & de ſujets de Tragedie auſſi celebres que celuy-cy.	Ly a peu d'Histoires aussi connues que celle de Medée, et de sujets de Tragédie aussi célèbres que celui-cy.
Euripide l’a traitté parmi les Grecs.	Euripide l'a traité parmi les Grecs.
Ennius, Pacuvius, Accius, Ovide, & Seneque parmi les Romains.	Ennius, Pacuvius, Accius, Ovide, et Sénèque parmi les Romains.
Monſieur Corneille parmi nous.	Monsieur Corneille parmi nous.
La Tragedie d’Euripide & celle de Seneque nous reſtent encore avec quelques vers des autres.	La Tragédie d'Euripide et celle de Sénèque nous restent encore avec quelques vers des autres.
Je me ſuis laiſſé tenter aprés tant de grands hommes à la beauté de ce ſujet.	Je me suis laissé tenter après tant de grands hommes à la beauté de ce sujet.
Il m’a toûjours paru que les deux grands reſſorts de la Tragedie, la terreur & la pitié, s’y font ſentir vivement;	Il m'a toujours paru que les deux grands ressorts de la Tragédie, la terreur et la pitié, s'y font sentir vivement;
& que Medée toute méchante & toute criminelle qu’elle eſt, eſtant auſſi tres malheureuſe & trahie par celuy pour qui elle a tout fait & tout abandonné, eſt l’un des perſonnages du monde le plus propre à faire un grand effet ſur la Scene.	et que Medée toute méchante et toute criminelle qu'elle est, étant aussi très malheureuse et trahie par celui pour qui elle a tout fait et tout abandonné, est l'un des personnages du monde le plus propre à faire un grand effet sur la Scène.
La ſimplicité même du ſujet, quoy que du goût de peu de gens parmi nous, a eſté un nouvel attrait pour moy.	La simplicité même du sujet, quoi que du goût de peu de gens parmi nous, a été un nouvel attrait pour moi.
J’ay voulu tenter de donner au Public une Piece à peu prés dans le goût des Anciens:	J'ai voulu tenter de donner au Public une Pièce à peu près dans le goût des Anciens:
c’eſt à dire, une Piece dans laquelle une action grande, tragique & merveilleuſe, mais en même temps tres ſimple, fût ſoutenuë ſeulement par la nobleſſe des penſées, par la vivacité des mouvemens, & par la dignité de l’expreſſion;	c'est à dire, une Pièce dans laquelle une action grande, tragique et merveilleuse, mais en même temps très simple, fut soutenue seulement par la noblesse des pensées, par la vivacité des mouvements, et par la dignité de l'expression;
C’eſt ainſi que ces grands Maiſtres de l’art, ſur les ouvrages deſquels l’art même & les regles ont eſté formés, ont conſtitué leurs Tragedies, & ont compoſé ces chefs-d’œuvre merveilleux, qui ayant fait l’admiration de tous les ſiecles, font encore pleurer & fremir dans la ſimple lecture.	C'est ainsi que ces grands Maîtres de l'art, sur les ouvrages desquels l'art même et les règles ont été formés, ont constitué leurs Tragédies, et ont composé ces chefs-d'œuvre merveilleux, qui ayant fait l'admiration de tous les siècles, font encore pleurer et frémir dans la simple lecture.
Ces Genies ſublimes ſe ſentant aſſez de force pour ſoutenir un ſujet par luy même & par eux mêmes, ont dédaigné d’avoir recours à un grand attirail d’incidens & d’Epiſodes;	Ces Génies sublimes se sentant assez de force pour soutenir un sujet par lui même et par eux mêmes, ont dédaigné d'avoir recours à un grand attirail d'incidents et d'Episodes;
& ont rebutté les jeux de Theatre, les petites ſurpriſes & ces autres agremens frivoles, qui plaiſent dans la Comedie;	et ont rebuté les jeux de Théâtre, les petites surprises et ces autres agréments frivoles, qui plaisent dans la Comédie;
mais qui ne ſervent dans la Tragedie qu’à amortir & à éteindre le pathetique, qui en eſt l’ame.	mais qui ne servent dans la Tragédie qu'à amortir et à éteindre le pathétique, qui en est l'âme.
Ils auroient crû ſortir du caractere du Poëme tragique, & bleſſer en quelque maniere la raiſon, & les regles par conſequent, s’ils s’étoient écartez de cette ſimplicité d’action.	Ils auraient cru sortir du caractère du Poème tragique, et blesser en quelque manière la raison, et les règles par conséquent, s'ils s'étaient écartés de cette simplicité d'action.
Que penſeroient- ils donc s’ils entendoient dire à preſent qu’une Tragedie n’eſt pas Tragedie ny dans les regles, parce qu’elle eſt ſimple?	Que penseraient- ils donc s'ils entendaient dire à présent qu'une Tragédie n'est pas Tragédie ni dans les règles, parce qu'elle est simple?
ils jugeroient ſans doute que de pareils Critiques n’ont aucune idée de la Trageuie ny des Iegies;	ils jugeraient sans doute que de pareils Critiques n'ont aucune idée de la Trageuie après des Jegies;
& qu’ils n’en connoiſſent que le nom.	et qu'ils n'en connaissent que le nom.
On ſeroit tres faché cependant, que ceux qui ne connoiſſent pas les Tragedies des Anciens par elles mêmes, en vouluſſent juger par cette Piece qui leur eſt infiniment inferieure en tout.	On serait très fâché cependant, que ceux qui ne connaissent pas les Tragédies des Anciens par elles mêmes, en voulussent juger par cette Pièce qui leur est infiniment inférieure en tout.
Pour reſſembler à ces grands hommes, ce n’eſt pas aſſez de travailler dans leur goût & d’aprés eux;	Pour ressembler à ces grands hommes, ce n'est pas assez de travailler dans leur goût et d'après eux;
il faudroit encore avoir leur genie.	il faudrait encore avoir leur génie.
Cette Piece donc peut fort bien eſtre ſimple comme celles des Anciens ſans eſtre belle:	Cette Pièce donc peut fort bien être simple comme celles des Anciens sans être belle:
mais en ce cas, ceſt umquement ma faute;	mais en ce cas, cette umquement ma faute;
& cela n’empêche pas que la veritable grandeur ne ſe trouve preſques toujours jointe avec la ſimplicité.	et cela n'empêche pas que la véritable grandeur ne se trouve presques toujours jointe avec la simplicité.
Je ne répondray point à toutes les Critiques qui ſe ſont d’abord élevées contre cette Piece.	Je ne répondrai point à toutes les Critiques qui se sont d'abord élevées contre cette Pièce.
Je crois qu’on doit toûjours laiſſer au Public une liberté entiere d’en juger, & qu’un ouvrage doit ſe deffendre par luy-même.	Je crois qu'on doit toujours laisser au Public une liberté entière d'en juger, et qu'un ouvrage doit se défendre par lui-même.
Peut-eſtre que ceux à qui la grande ſimplicité d’action qui regne dans cette piece, n’auroit pas entierement pleu dans la repreſentation, en ſeront moins bleſſez dans la lecture;	Peut-être que ceux à qui la lecture simplicité d'action qui règne dans cette pièce, n'aurait pas entièrement pleu dans la représentation, en seront moins blessés dans la lecture;
& qu’ils trouveront que j’y ay ſupplée autant qu’il m’a eſté poſſible, par le ſoin que j’ay pris de l’expreſſion.	et qu'ils trouveront que j'y ai supplée autant qu'il m'a été possible, par le soin que j'ai pris de l'expression.
J’ay toûjours eſté perſuadé que c’eſt ce qui anime & ce qui ſoutient le plus un ouvrage, lorſque n’eſtant pas dans la bouche des Acteurs qui luy donnoient en quelque maniere la vie, il eſt comme mort ſur le papier.	J'ai toujours été persuadé que c'est ce qui anime et ce qui soutient le plus un ouvrage, lorsque n'étant pas dans la bouche des Acteurs qui avait donnaient en quelque manière la vie, il est comme mort sur le papier.
Auſſi avec quel ſoin les Anciens, & en particulier les Tragiques Grecs ne s’y ſont-ils pas attachez?	Aussi avec quel soin les Anciens, et en particulier les Tragiques Grecs ne s'y sont-ils pas attachez?
Il ſeroit trop long de parler icy de la ſublimité, de la force, de la richeſſe, de l’harmonie, de la vivacité de leurs expreſſions;	Il serait trop long de parler ici de la sublimité, de la force, de la richesse, de l'harmonie, de la vivacité de leurs expressions;
de ces tours ſi naturels en apparence, & pleins en effet d’un ſi grand art;	de ces tours si naturels en apparence, et pleins en effet d'un si grand art;
de ces hardieſſes nobles & heureuſes, où ne s’éleva jamais un mediocre genie;	de ces hardiesses nobles et heureuses, où ne s'éleva jamais un médiocre génie;
de ces belles Epithetes qui raſſemblant en un ſeul mot pluſieurs idées, leur donnent plus de force en les offrant ainſi en racourci;	de ces belles Épithètes qui rassemblant en un seul mot plusieurs idées, leur donnent plus de force en les offrant ainsi en racourci;
& qui par leurs peintures vives & nobles, font le charme de la Poëſie qu’elles animent & qu’elles enrichiſſent.	et qui par leurs peintures vives et nobles, font le charme de la Poésie qu'elles animent et qu'elles enrichissent.
Je diray ſeulement pour donner quelque idée du ſoin que ces grands hommes ont pris de l’expreſſion, qu’ils s’y ſont attachez, juſqu’à n’employer preſque que des mots conſacrez à la Poëſie & inconnus à la Proſe;	Je dirai seulement pour donner quelque idée du soin que ces grands hommes ont pris de l'expression, qu'ils s'y sont attachés, jusqu'à n'employer presque que des mots consacrez à la Poésie et inconnus à la Prose;
& que quand même on renverſeroit la ſtructure & l’arrangement de leurs vers, on ne laiſſeroit pas d’y ſentir encore la Poëne la plus magminque & la plus élevée.	et que quand même on renverserait la structure et l'arrangement de leurs vers, on ne laisserait pas d'y sentir encore la Poène la plus maginque et la plus élevée.
Je ne ſçaurois cependant m’empêcher de répondre à une des objections qu’on m’a faites.	Je ne saurais cependant m'empêcher de répondre à une des objections qu'on m'a faites.
On m’a accusé d’avoir pris pluſieurs penſées dans Monſieur Corneille.	On m'a accusé d'avoir pris plusieurs pensées dans Monsieur Corneille.
Mais pour me rendre juſtice, on devoit avoir dit que Monſieur Corneille ayant pris pluſieurs pensées dans Seneque, j’ay crû pouvoir auſſi puiſer dans la même ſource & y en prendre quelques unes.	Mais pour me rendre justice, on devait avoir dit que Monsieur Corneille ayant pris plusieurs pensées dans Sénèque, j'ai cru pouvoir aussi puiser dans la même source et y en prendre quelques unes.
Voilà la verité;	Voilà la vérité;
& je défie qu’on puiſſe citer un endroit de cette Piéce qui paroiſſe emprunté de Monſieur Corneille, & qui ne ſoit pas de Seneque.	et je défie qu'on puisse citer un endroit de cette Pièce qui paraisse emprunté de Monsieur Corneille, et qui ne soit pas de Sénèque.
J’ay crû qu’il ne m’étoit pas deffendu de ſuivre ce Poëte latin, & de m’enrichir de ſes beautez & de ſes penſées, à l’exemple de Monſieur Corneille lui-même.	J'ai cru qu'il ne m'était pas défendu de suivre ce Poète latin, et de m'enrichir de ses beautés et de ses pensées, à l'exemple de Monsieur Corneille lui-même.
Si ceux qui ont quelque diſcernement & quelque goûtpour ces ſortes de choſes, ſe donnent la peine de comparer avec l’Originaliles endroits que la Medée de Monſieur Corneille & celle-cy ont de communs;	Si ceux qui ont quelque discernement et quelque goûtpour ces sortes de choses, se donnent la peine de comparer avec l'Originaliles endroits que la Medée de Monsieur Corneille et celle-cy ont de communs;
ils connoiſtront aiſement, que ce que j’ay traduit ou imité, mnon pome une copie de copie;	ils connaîtront aisément, que ce que j'ai traduit ou imité, ménon pome une copie de copie;
mais que j’ay travaillé d’aprés l’original.	mais que j'ai travaillé d'après l'original.
Perſonne n’eſt plus admirateur que moi du merite de Monſieur Corneille.	Personne n'est plus admirateur que moi du mérite de Monsieur Corneille.
Perſonne n’a plus de veneration & d’eſtime pour un ſi grand homme:	Personne n'a plus de vénération et d'estime pour un si grand homme:
& cette veneration jointe au grand nom qu’il s’eſt acquis ſi juſtement, m’auroit peut-eſtre empêché de traiter un ſujet déja traité par luy, ſi je n’avois conſideré que dans ſa Medée, comme il le reconnoît luymême, ce grand genie qui s’eſt fait admirer depuis, ne s’eſtoit pas encore entierement developpé, quoy qu’à travers les nüages qui le couvrent, il ne laiſſe pas de faire briller déja des étincelles de ce beau feu, qui achevant bien-tôt aprés de diſſiper tout ce qui luy faiſoit ombre, a produit le Cid, Polieucte, Cinna, & les Horaces J’ay même traité ce ſujet ſi differemment de luy, que hors le fond de la Fable qui ne ſçauroit n’eſtre pas le même, & ce que nous a fourni Seneque;	et cette vénération jointe au grand nom qu'il s'est acquis si justement, m'aurait peut-être empêché de traiter un sujet déjà traité par même, si je n'avais considéré que dans sa Medée, comme il le reconnaît luymême : ce grand génie qui s'est fait admirer depuis, ne s'était pas encore entièrement développé, quoi qu’à travers les nuages qui le couvrent, il ne laisse pas de faire briller déjà des étincelles de ce beau feu, qui achevant bientôt après de dissiper tout ce qui lui faisait ombre, a produit le Cid, Polieute, Cinna, et les Horaces ay même ie ce ut si différemment de lui, que hors le fond de la Fable qui ne et être pas le même, et ce que nous a fourni Seneque;
je ne croy pas que le même ſujet puiſſe eſtre traitté plus diverſement.	je ne crois pas que le même sujet puisse être traité plus diversement.
Auſſi j’eſpere que tous les gens deſintereſſez me rendront la juſtice de croire, que quand Monſieur Corneille n’auroit jamais fait ſa Medée, je n’en aurois pas moins fait celle-cy, avec le ſecours de d’Euripide & de Seneque, qui ont eſté mes ſeuls & veritables guides.	Aussi j'espère que tous les gens désintéressez me rendront la justice de croire, que quand Monsieur Corneille n'aurait jamais fait sa Medée, je n'en aurais pas moins fait celle-cy, avec le secours de d'Euripide et de Sénèque, qui ont été mes seuls et véritables guides.
MEDE’E, Fille d’Æete, Roi de la Coiemde & femine de Jaſon.	MÈDE, Fille d'Hète, Roi de la Coiemde et fémine de Jason.
JASON, Prince de Theſſalie.	JASON, Prince de Thessalie.
CREON, Roi de Corinthe.	CREON, Roi de Corinthe.
CREUSE, fille de Creon.	CREUSE, fille de Creon.
Les ENFANS de Medée.	Les ENFANS de Medée.
ACITODOID 5 Coidente de Medée.	ACITODOID 5 Coidente de Medée.
ImIinID, Conndene de jaſon.	ImIinID, Conndène de jason.
CYDIPPE, Confidente de Créüſe.	CYDIPE, Confidente de Créüse.
SUITTE DE CREON.	SUITE DE CREON.
La Scene eſt à Corinthe, dans le Palais de Creon.	La Scène est à Corinthe, dans le Palais de Creon.
TRAGEDIE.	TRAGÉDIE.
ACTET	ACTET
SCENE FREMIERE.	SCÈNE FREMIÈRE.
IASON, IPHITE.	IASON, IPHITE.
ASON.	ASON.
E ſçais ce que je dois à l’amour.	 sçais ce que je dois à l'amour.
de Medée.	de Medée.
Ceſſe, Iphite, à mes yeux d’enretracer l’idée.	Cesse, Iphite, à mes yeux d'enretracer l'idée.
Ce qu’elle a fait pour moi, dans la Grece, à Colchos, Ne traverſe que trop ma joye & mon repos.	Ce qu'elle a fait pour moi, dans la Grèce, à Colchos, Ne traverse que trop ma joie et mon repos.
Mais du Sort, de l’Amour, la fatale puiſſance Fait taire mes remords & ma reconnoiſſancé, Et de ces deux Tyrans les violentes loix, Ne laiſſent ny l’amour, ny la haine à mon choix.	Mais du Sort, de l'Amour, la fatale puissance Fait taire mes remords et ma reconnaissancé, Et de ces deux Tyrans les violentes lois, Ne laissent ni l'amour, ni la haine à mon choix.
Oüi de leur joug preſſant l’invincible contrainte, Fixe enfin mes deſtins & mes vœux à Corinthe.	Oui de leur joug pressant l'invincible contrainte, Fixe enfin mes destins et mes vœux à Corinthe.
En vain Medée en proye à ſes tranſports jaloux, Se livre à la douleur, s’abandonne au courroux.	En vain Medée en proie à ses transports jaloux, Se livre à la douleur, s'abandonne au courroux.
Je la plains;	Je la plains;
mais, Ami, j’adore la Princeſſe:	mais, Ami, j'adore la Princesse:
Du deſtin de Jaſon ſouveraine Maiſtreſſe, Elle aſſervit mon ame à ſon pouvoir vainqueur:	Du destin de Jason souveraine Maîtresse, Elle asservit mon âme à son pouvoir vainqueur:
L’éclat de ſes beaux yeux triomphe de mon cœur;	L'éclat de ses beaux yeux triomphe de mon cœur;
Et ce tœur embrase d'unt ardeur violente, Ne ſçauroit s’affranchir du charme qui l’enchante.	Et ce tœur embrase d'unt ardeur violente, Ne saurait s'affranchir du charme qui l'enchante.
IPHITE.	IPHITE.
De ce nouvel amour la trompeuſe douceur, Seduit voſtre raiſon par ſon appas flatteur.	De ce nouvel amour la trompeuse douceur, Seduit votre raison par son appas flatteur.
Voſtre ame toute entiere avidement s’y livre;	Votre âme toute entière avidement s'y livre;
Mais ſi fuyant, Seigneur, le plaiſir qui l’enVous vouliez fepouner un dangereux poiſon;	Mais si fuyant, Seigneur, le plaisir qui l'envous vouliez fépouner un dangereux poison;
Si vous daigniez encor conſulter la raiſon, Vous banniriez bien-toſt Creüſe de voſtre ame;	Si vous daigniez encor consulter la raison, Vous banniriez bientôt Creüse de votre âme;
Et vous étoufferiez une funeſte ſlâme.	Et vous étoufferiez une funeste slâme.
JASON.	JASON.
Non, la raiſonicy d’accord avec mon cœur, Authoriſe ma flâme & ſoûtient mon ardeur.	Non, la raisonici d'accord avec mon cœur, Autorise ma flamme et soutient mon ardeur.
Exilez, fugitifs, le trépas de Pelie Souleve contre nous toute la Theſſalie.	Exilez, fugitifs, le trépas de Pelie Souleve contre nous toute la Thessalie.
Ce Tyran, de mon thrône injuſte uſurpateur, De ſes crimes enfin a lavé la noirceur.	Ce Tyran, de mon trône injuste usurpateur, De ses crimes enfin a lavé la noirceur.
Tu ſçais comme Medée ardente à la vengeance, Sur le flatteur appas d’une vaine eſperance, De ſes propres Enfans en a fait ſes bourreaux.	Tu sais comme Medée ardente à la vengeance, Sur le flatteur appas d'une vaine espérance, De ses propres Enfants en a fait ses bourreaux.
Ses Filles à l’envi le mirent par morceaux;	Ses Filles à l'envi le mirent par morceaux;
Et leur credule Amour armant leur bras timide, Commit par pieté cét affreux parricide.	Et leur crédule Amour armant leur bras timide, Commit par piété cet affreux parricide.
Son fils Acaſte armant pour vanger ſon trépas, J’obéïs au Deſtin, je quittay ſes eſtats;	Son fils Acaste armant pour venger son trépas, J'obéis au Destin, je quittai ses états;
Et Creon ſeul oſant plaindre noſtre diſgrace, Lors que d’un fier Tyran la haine nous ménace, M’a receu dans ſon ſein moi, Medée & mes Fils.	Et Creon seul osant plaindre notre disgrâce, Lors que d'un fier Tyran la haine nous ménace, M'a reçu dans son sein moi, Medée et mes Fils.
D’une triſte maiſon infortunez debris.	D'une triste maison infortuné débris.
Seul il pouvoit me tendre une main ſalutaire;	Seul il pouvait me tendre une main salutaire;
Et le Ciel de mon ſort le rend dépoſitaire.	Et le Ciel de mon sort le rend dépositaire.
En vainje chercherois en de nouveaux climats, L’azyle & le repos qu’il m’offre en ſes eſtats.	En vainje chercherais en de nouveaux climats, L'asile et le repos qu'il m'offre en ses états.
Pour moy ſon amour brille & ſon eſtime éclatte.	Pour moi son amour brille et son estime éclate.
Il me regarde en pere;	Il me regarde en père;
il m’applaudit, me flatte.	il m'applaudit, me flatte.
Cependant trop inſtruit par mes malheurs divers, Toûjours du Sort jaloux je crains quelque revers.	Cependant trop instruit par mes malheurs divers, Toujours du Sort jaloux je crains quelque revers.
Mon Ennemi demande & Medée, & ma tête:	Mon Ennemi demande et Medée, et ma tête:
Irrité d’un refus à la guerre il s’appreſte.	Irrité d'un refus à la guerre il s'apprête.
Creon m’aime, il eſt vray;	Creon m'aime, il est vrai;
Creon eſt genereux.	Creon est généreux.
Mais on porte à regret le poids des malheureux.	Mais on porte à regret le poids des malheureux.
Quelque noble panchant qui pouſſe à les défendre, Iphite, on craint de voir les chtuts ims en tendre, Ses peuples aſſervis, & ſon thrône ébranlé.	Quelque noble penchant qui pousse à les défendre, Iphite, on craint de voir les chuts ims en tendre, Ses peuples asservis, et son trône ébranlé.
Souvent même Creon flotte & paroiſt troublé.	Souvent même Creon flotte et paraît troublé.
D’ailleurs trop prevenu d’une haine ſecrette, A Medée à regret il donne une retraitte;	D'ailleurs trop prévenu d'une haine secrète, À Medée à regret il donne une retraite;
Et contr'elle avec peine il retient un courroux, Qui pourroit retomber juſques ſur ſon Epoux.	Et contr'elle avec peine il retient un courroux, Qui pourrait retomber jusques sur son Époux.
Je dos donc, profitant d’un rayon favorable, M’aſſurer en Creon un appui ferme & ſtable, Et l’attachant à moy par le nœud le plus fort, Prevenir & fixer l’inconſtance du Sort.	Je dos donc, profitant d'un rayon favorable, M'assurer en Creon un appui ferme et stable, Et l'attachant à moi par le nœud le plus fort, Prévenir et fixer l'inconstance du Sort.
Pour ſa Fille avec joye il voit briller ma flâme;	Pour sa Fille avec joie il voit briller ma flamme;
Elle regle ſes vœux & peut tout ſur ſon ame.	Elle règle ses vœux et peut tout sur son âme.
Creule leuic em peut i'andiereieon.	Creule levic em peut j'andiereieon.
Hé-bien!	Hé-bien!
l’Amour, Iphite, aveugle-t’il Jaſon	L'Amour, Iphite, aveugle-t-il Jason
IPHITE.	IPHITE.
C’eſt ainſi que l’Amour trop fertile en excuſes, Aveugle par ſon charme & ſeduit par ſes ruſes.	C'est ainsi que l'Amour trop fertile en excuses, Aveugle par son charme et séduit par ses ruses.
Meſme en nous égarant, il feint de nous guider.	Même en nous égarant, il feint de nous guider.
De ſes pieges flateurs ſongez à vous garder.	De ses pièges flatteurs songez à vous garder.
Hé quoi!	Hé quoi!
d’une autre amour voſtre ame poſſedée, Trahira les bien-faits & l’eſpoir de Medée?	d'une autre amour votre âme possédée, Trahira les bienfaits et l'espoir de Medée?
Ny les droits de l’hymen, ny ſa fidelle ardeur.	Ni les droits de l'hymen, ni sa fidèle ardeur.
JASON.	JASON.
Qu'un tel ſecours eſt foible & défend mal un cœur, Iphite.	Qu'un tel secours est foible et défend mal un cœur, Iphite.
Ah!	Ah!
quand l’Amour regne avec violence, Que peut la foible voix de la Reconnoiſſance?	quand l'Amour règne avec violence, Que peut la faible voix de la Reconnaissance?
Il eſt vray que Medée a tout ozé pour moi.	Il est vrai que Medée a tout osé pour moi.
Je m’accuſe & rougis de ce que je lui doy.	Je m'accuse et rougis de ce que je lui dois.
Mais tranſporté d’amour en voyant ce que j’aime, J’oublie & mon devoir, & Medée & moi-meſme.	Mais transporté d'amour en voyant ce que j'aime, J'oublie et mon devoir, et Medée et moi-même.
Je m’ennivre i longs-traits d’un aimable poiſon;	Je m'ennivre jour longs-traits d'un aimable poison;
L’amour devient alors ma ſupreme raiſon;	L'amour devient alors ma suprême raison;
Et d’un feu violent l’imperieuſe flâme, Etouffe tout le reſte & triomphe en mon ame.	Et d'un feu violent l'impérieuse flamme, Étouffe tout le reste et triomphe en mon âme.
Je ſens, je ſens alors, que mon trépas certain, Les bontez de Creon, le couroux du Deſtin, M’arreſtent moins icy que ne fait la Princeſſe;	Je sens, je sens alors, que mon trépas certain, Les bontés de Creon, le courroux du Destin, M'arrêtent moins ici que ne fait la Princesse;
Qu’animé du beau feu qui m’échauffe & me preſſe, Je mourrois, s’il falloit m’éloigner de ſes yeux;	Qu'animé du beau feu qui m'échauffe et me presse, Je mourrais, s'il fallait m'éloigner de ses yeux;
Et qu’enfin leur éclat m’enchante dans ces lieux.	Et qu'enfin leur éclat m'enchante dans ces lieux.
Ces beaux yeux plus puiſſans que Medée & ſes charmes, Si-toſt que je les vis, m’arracherent les armes.	Ces beaux yeux plus puissants que Medée et ses charmes, Sitôt que je les vis, m'arrachèrent les armes.
Et quel cœur ſoutiendroit leurs feux ébloüiſſans, Leur éclat dangereux, leurs regards languiſſans?	Et quel cœur soutiendrait leurs feux éblouissants, Leur éclat dangereux, leurs regards languissants?
Cette jeune pudeur ſur ſon viſage peinte, Et ſur ſon front ſerein cette nobleſſe empreinte, Cette douce fierté, cette aimable langueur;	Cette jeune pudeur sur son visage peinte, Et sur son front serein cette noblesse empreinte, Cette douce fierté, cette aimable langueur;
Un je ne ſçai quel charme innoc ent & flatteur;	Un je ne sais quel charme innoc ent et flatteur;
Ce ſouris dont l’appas reveille la tendreſſe, Et ce maintien auguſte, & cét air de Deeſſe:	Ce souris dont l'appas reveille la tendresse, Et ce maintien auguste, et cet air de Déesse:
Enfin en la voyant, ébloüi, tranſporté, Je crus voir, & je vis une Divinité.	Enfin en la voyant, ébloui, transporté, Je crus voir, et je vis une Divinité.
IPHITE.	IPHITE.
Mais quels ſont vos prolets?	Mais quels sont vos prolets?
que pouvez-vous pretendre?	que pouvez-vous prétendre?
JASON.	JASON.
D’écouter ma tendreſſe, & de tout entreprendre.	D'écouter ma tendresse, et de tout entreprendre.
L’amour ſe flatte, Iphite, & ſe croit tout permis, Que n’oſe point un cœur à ſon pouvoir ſoumis?	L'amour se flatte, Iphite, et se croit tout permis, Que n'ose point un cœur à son pouvoir soumis?
Le Roi me veut pour gendre;	Le Roi me veut pour gendre;
& ma belle Princeſſe, Semble favoriſer mes ſoins & ma tendreſſe:	et ma belle Princesse, Semble favoriser mes soins et ma tendresse:
Il offre ſa couronne & Créüſe à mes vœux.	Il offre sa couronne et Créüse à mes vœux.
M’oppoſerois-je au Sort qui veut me rendre heureux?	M'opposerais-je au Sort qui veut me rendre heureux?
Je ne puis reſiſter à ces douces amorces:	Je ne puis résister à ces douces amorces:
Et n’ay point oublié comme on fait les divorces.	Et n'ai point oublié comme on fait les divorces.
N’abandonuay-je pas Hypſipile à Lemnos, Pour chercher la ronon, ce roiera Colchos?	N'abandonvai-je pas Hypsipile à Lemnos, Pour chercher la ron, ce royera Colchos?
Et cependant, Ami, cette grande conqueſte, Valoit-elle le prix qu’icy l’Amour m’appreſte?	Et cependant, Ami, cette grande conquête, Valait-elle le prix qu'ici l'Amour m'apprête?
IPHITE.	IPHITE.
Dieux!	Dieux!
que fera Medée, & quel affreux couroux Ne l’enflâmera point contre un parjure Epoux?	que fera Medée, et quel affreux courroux Ne l'enflammera point contre un parjure Époux?
Si vous l’abandonnez, redoutez ſa vengeanee.	Si vous l'abandonnez, redoutez sa vengeance.
Vous ſçavez de ſon art juſqu’où-va la puiſſance, La Nature eſt ſoumiſe à ſes commandemens.	Vous savez de son art jusqu'où-va la puissance, La Nature est soumise à ses commandements.
Elle trouble le Ciel, l’Enfer, les Elemens.	Elle trouble le Ciel, l'Enfer, les Éléments.
Elle arreſte à ſon gré les Aſtres dans leur courſe.	Elle arrête à son gré les Astres dans leur course.
Les torrens les plus fiers femontent vers leur loulce.	Les torrents les plus fiers femontent vers leur loulce.
La Lune ſort du Ciel;	La Lune sort du Ciel;
les Manes des tombeaux.	les Manes des tombeaux.
Elle lance la foudre & change en ſang les eaux.	Elle lance la foudre et change en sang les eaux.
Vous ſçavez.	Vous savez.
JASON.	JASON.
Je le ſçais.	Je le sais.
Ceſſe de me le dire.	Cesse de me le dire.
Mais de l’Amour auſſi je ſçais quel eſt l’empire.	Mais de l'Amour aussi je sais quel est l'empire.
Plus puiſſant que ſon art, plus fort que ſon courroux, De Medée en fureur il ſuſpendra les eoups.	Plus puissant que son art, plus fort que son courroux, De Medée en fureur il suspendra les eoups.
Elle m’aime, il ſuffit;	Elle m'aime, il suffit;
& ſa tendreſſe extrême Par lera puiſſamment pour un Ingrat qu’elle aime.	et sa tendresse extrême Par lera puissamment pour un Ingrat qu'elle aime.
Je ſçauray la flêchir;	Je saurai la flêchir;
je ſçauray l’appaiſer.	je saurai l'apaiser.
Mais à tout ſon couroux deuſſay-je m’expoſer, Je n’ecoute & ne ſuis que l’ardeur qui me preſſe.	Mais à tout son courroux dussai-je m'exposer, Je n'oute et ne suis que l'ardeur qui me presse.
IPHITE.	IPHITE.
De grace examinez.	De grâce examinez.
ASON.	ASON.
Ah!	Ah!
je vois ma Princeſſe.	je vois ma Princesse.
Conſidere à loiſit, contemple tant d’appas.	Considère à loisit, contemple tant d'appas.
Peut-on la voir, Iphite, & ne l’adorer pas?	Peut-on la voir, Iphite, et ne l'adorer pas?
Rien n’eſt à redouter, à fuir, que ſa colere.	Rien n'est à redouter, à fuir, que sa colère.
SCENE II.	SCÈNE II.
JASON, CRE’USE, IPHITE, CYDIPPE.	JASON, CRE'USE, IPHITE, CYDIPE.
CRE’USE.	CRE'USE.
E croyois en ces lieux trouver le Roi mon Pere.	E croyais en ces lieux trouver le Roi mon Père.
On vient de m’aſſurer qu’il vous cherche, Seigneur.	On vient de m'assurer qu'il vous cherche, Seigneur.
JASON.	JASON.
Je n’ay point veu le Roi, Madame;	Je n'ai point vu le Roi, Madame;
mais mon cœur.	mais mon cœur.
Par de profonds reſpects, par l’amour le plus tendre, Ne pourra-t-il jamais meriter & pretendre Que vous daigniez auſſi me chercher quelque jour?	Par de profonds respects, par l'amour le plus tendre, Ne pourra-t-il jamais mériter et prétendre Que vous daigniez aussi me chercher quelque jour?
Cét eſpoir n’eſt-il pas permis à mon amour?	Cet espoir n'est-il pas permis à mon amour?
Jamais, vous le ſçavez, ardeur ſi violente Ne iegna dans un cœur & n’en fût triomphante.	Jamais, vous le savez, ardeur si violente Ne iegna dans un cœur et n'en fut triomphante.
Tout le iure à vos yeux;	Tout le jure à vos yeux;
ſoins, vœux, empreſſemens, Mes remords immolez, mes tranſports, mes ſermens;	soins, vœux, empressements, Mes remords immolez, mes transports, mes serments;
Et mes tendres reſpects, & mes ardens hommages, Vous ſont de cét amour d’inviolables gages.	Et mes tendres respects, et mes ardents hommages, Vous sont de cet amour d'inviolables gages.
Je ſens un feu ſi vif s’accroiſtre à chaque pas.	Je sens un feu si vif s'accroître à chaque pas.
Madame, a tant d’amour vous ne répondez pas?	Madame, a tant d'amour vous ne répondez pas?
CRE’USE.	CRE'USE.
Hé!	Hé!
le puis-je, Seigneur?	le puis-je, Seigneur?
une jeune Princeſſe Ne doit qu’à ſon Epoux déclarer ſa tendreſſe.	une jeune Princesse Ne doit qu'à son Époux déclarer sa tendresse.
Il eſt vrai que le Roi, qui doit regler mes vœux, Eſtime vos vertus, applaudit à vos feux.	Il est vrai que le Roi, qui doit régler mes vœux, Estime vos vertus, applaudit à vos feux.
Il m’a meſme ordonné d’écouter voſtre flâme;	Il m'a même ordonné d'écouter votre flamme;
Si j’oſe aprés cela vous découvrir mon ame;	Si j'ose après cela vous découvrir mon âme;
J’eſtime ainſi que luy cét illuſtre Jaſon, Qui ſurmonta Neptune & conquît la Toiſon;	J'estime ainsi que deux cet illustre Jason, Qui surmonta Neptune et conquit la Toison;
De la gloire amoureux, prodigue de ſa vie;	De la gloire amoureux, prodigue de sa vie;
L’ornement de la Grece, & l’effroi de l’Aſie, Le chef de nos Guerriers, la fleur de nos Heros, Dont le nom eſt vanté de Corinthe à Colchos.	L'ornement de la Grèce, et l'effroi de l'Asie, Le chef de nos Guerriers, la fleur de nos Héros, Dont le nom est vanté de Corinthe à Colchos.
Peut-eſtre un doux panchant m’entraîneroit ſans peine.	Peut-être un doux penchant m'entraînerait sans peine.
Mais un fatal obſtacle & m’arreſte & me geſne.	Mais un fatal obstacle et m'arrête et me gêne.
Medée eſt voſtre Epouſe, & des nœuds ſi puiſſans Mettent un frein trop juſte à mes vœux innocens.	Medée est votre Épouse, et des nœuds si puissants Mettent un frein trop juste à mes vœux innocents.
Pourrois-je à ce panchant abandonner mon ame, Tandis qu’un autre hymen vous attache.	Pourrais-je à ce penchant abandonner mon âme, Tandis qu'un autre hymen vous attache.
ASON.	ASON.
Ah!	Ah!
Madame, Ay Ceſſez, ceſſez de crai ndre un hymen odieux, Condamné par les Greecs, reprouvé par les Dieux.	Madame, Ai Cessez, cessez de crai ndre un hymen odieux, Condamné par les Greecs, reprouvé par les Dieux.
mus demain, des ce joui laucin omer ſes chaînes ?	mus demain, des ce joui lavin ömer ses chaînes ?
CRE'USE.	CRE'USE.
Mais qui m’aſſurera qu’inſenfible à ſes peines.	Mais qui m'assurera qu'insensible à ses peines.
Vous puiſſiez ſoûtenir ſa venë & ſa douleur, Sans lui rendre bien-toſt vos vœux & voſtre cœur?	Vous puissiez soutenir sa venue et sa douleur, Sans lui rendre bientôt vos vœux et votre cœur?
Je crains un long panchant;	Je crains un long penchant;
ſa tendteſſe, ſes larmes;	sa tendtesse, ses larmes;
Je redoute ſes yeux, je redoute ſes charmes:	Je redoute ses yeux, je redoute ses charmes:
Son art eſt au deſſus de tout l’effort humain, Seigneur, & de voſtre ame elle ſçait le chemin.	Son art est au dessus de tout l'effort humain, Seigneur, et de votre âme elle sait le chemin.
Tant que vous la tenen, que vous pourrez l’entendre, Je crains tout d’un amour & ſi long & ſi tendre.	Tant que vous la ten, que vous pourrez l'entendre, Je crains tout d'un amour et si long et si tendre.
Je crains.	Je crains.
JASON.	JASON.
Ah!	Ah!
diſſipez une indigne frayeur.	dissipez une indigne frayeur.
Quel outrage!	Quel outrage!
ainſi donc jugez-vous de mon cœur?	ainsi donc jugez-vous de mon cœur?
Connoiſſez mieux ce cœur, Madame & ma tendreſſe, Rien ne peut m’enlever à ma belle Princeſſe:	Connaissez mieux ce cœur, Madame et ma tendresse, Rien ne peut m'enlever à ma belle Princesse:
Je deffie à la fois les Mortels & les Dieux;	Je défie à la fois les Mortels et les Dieux;
Et tout l’art de Medée, & l’Enfer & les Cieux.	Et tout l'art de Medée, et l'Enfer et les Cieux.
Si ſa preſence icy vous allarme & vous bleſſe, Il faut vous delivrer du ſoupçon qui vous preſſe.	Si sa présence ici vous alarme et vous blesse, Il faut vous délivrer du soupçon qui vous presse.
Un veritable amour éclatte avec plaiſir.	Un véritable amour éclatte avec plaisir.
Commandez ſeulement;	Commandez seulement;
je ſuis preſt d’obéïr.	je suis prêt d'obéir.
Je donnerois mon ſang;	Je donnerais mon sang;
j’immolerois ma vie.	j'immolerais ma vie.
ravie.	ravie.
716175V	716175V
2 CRE'USE.	2 CRE'USE.
J’entens le Roi, Seigneur.	J'entends le Roi, Seigneur.
Il paroît à vos yeux.	Il paraît à vos yeux.
SCENE III.	SCÈNE III.
JASON, CRE’USE, CREON, ſuitte.	JASON, CRE'USE, CREON, suitte.
CREON.	CREON.
E vous cherchois, Seigneur.	E vous cherchais, Seigneur.
Sçavez-vous qu’en ces lieux Un nouvel Envoyé du Roi de Theſſalie, Vient demander raiſon du meurtre de Pelie?	Savez-vous qu'en ces lieux Un nouvel Envoyé du Roi de Thessalie, Vient demander raison du meurtre de Pélie?
De mes refus Acaſte offenſé juſtement, Veut bien ſuſpendre encor ſon fier reſſentiment, Et jurer avec nous une étroitte alliance, Si je livre en ce jour Medée à ſa vengeance, Ou qu’au moins la chaſſant du ſein de mes eſtats, je refuſe un azyle à ſes aſſaſſinats.	De mes refus Acaste offensé justement, Veut bien suspendre encor son fier ressentiment, Et jurer avec nous une étroitte alliance, Si je livre en ce jour Medée à sa vengeance, Ou qu'au moins la chassant du sein de mes états, je refuse un asile à ses assassinats.
il me preſſe.	il me presse.
JASON.	JASON.
Ah!	Ah!
Seigneur voſtre cœur magnanime Pourroit-il lui livrer une triſte victime?	Seigneur votre cœur magnanime Pourrait-il lui livrer une triste victime?
Pourroit-il.	Pourrait-il.
CREON.	CREON.
En faveur de vos Fils & de vous, Je ne veux point livrer Medée à ſon courroux.	En faveur de vos Fils et de vous, Je ne veux point livrer Medée à son courroux.
Mais eſt-il juſte auſſi, Jaſon, que de ſes crimes, Mes Sujets innocens deviennent les victimes, Et que d’une Etrangere appuyant les forfaits, De mes heureux eſtats je trouble ainſi la paix?	Mais est-il juste aussi, Jason, que de ses crimes, Mes Sujets innocents deviennent les victimes, Et que d'une Étrangère appuyant les forfaits, De mes heureux états je trouble ainsi la paix?
Non il faut qu’elle parte, & qu’une prompte fuite Nous délivre des maux qu’elle traîne à ſa ſuite.	Non il faut qu'elle parte, et qu'une prompte fuite Nous délivre des maux qu'elle traîne à sa suite.
Je le veux.	Je le veux.
Cét exil eſt ncceſſaire à tous;	Cet exil est nécessaire à tous;
Pour Acaſte, pour Moi, pour ma Fille pour Vous, Pour Medée elle-meſme.	Pour Acaste, pour Moi, pour ma Fille pour Vous, Pour Medée elle-même.
Il faut purger Corinthe, De ce funeſte objet qui la glace de crainte.	Il faut purger Corinthe, De ce funeste objet qui la glace de crainte.
Il faut nous épargner ſes cris & ſa fureur.	Il faut nous épargner ses cris et sa fureur.
Je hais juſqu’à ſaveuë;	Je hais jusqu'à sauve;
elle me fait horreur.	elle me fait horreur.
Des ſonges effrayans, des preſages ſiniſtres, Des redoutables Dieux les auguſtes Miniſtres, M’annoncent de leur part le plus affreux malheur, Si je ne l’abandonne à leur courroux vangeur.	Des songes effrayants, des présages sinistres, Des redoutables Dieux les augustes Ministres, M'annoncent de leur part le plus affreux malheur, Si je ne l'abandonne à leur courroux vengeur.
Rompez avec éclat le charme qui vous lie:	Rompez avec éclat le charme qui vous lie:
Expiez un hymen qui tache voſtre vie.	Expiez un hymen qui tache votre vie.
Aſſez & trop long-temps ſes liens mal tiſſus, Terniſſent voſtre gloire, & ſoüillent vos vertus.	Assez et trop longtemps ses liens mal tissus, Ternissent votre gloire, et souillent vos vertus.
Aſſez & trop long-temps avec douleur la Grece, Voit gemir ſous le joug de cette Enchantereſſe Le plus grand des Heros qu’elle conçeût jamais.	Assez et trop longtemps avec douleur la Grèce, Voit gémir sous le joug de cette Enchanteresse Le plus grand des Héros qu'elle conçut jamais.
Separez vos vertus d’elle & de ſes forfaits.	Séparez vos vertus d'elle et de ses forfaits.
Juſtifiez ainſi l’appui que je vous donne.	Justifiez ainsi l'appui que je vous donne.
Poſſedez à ce prix ma fille & ma couronne.	Possédez à ce prix ma fille et ma couronne.
Ie veux que dés demain l’Aſtre brillant du jour, Ait veu partir Medée en commençant ſon tour;	Je veux que dès demain l'Astre brillant du jour, Ait vu partir Medée en commençant son tour;
Et que Corinthe ainſi n’eſtant plus prophanée, Il ſe preſte avec joye à ce doux hymenée.	Et que Corinthe ainsi n'étant plus prophanée, Il se prête avec joie à ce doux hyménée.
IASON.	IASON.
Je cede à vos raiſons;	Je cède à vos raisons;
j’obéïs.	j'obéis.
Mais Seigneur, Daignez par vos bontez adoucir ſon malheur:	Mais Seigneur, Daignez par vos bontés adoucir son malheur:
Iui tout te qui pourra rendre ſon ſort moins rude, Conſolez ſes ennuis;	Jui tout te qui pourra rendre son sort moins rude, Consolés ses ennuis;
flatez ſa ſolitude.	flattez sa solitude.
CREON.	CREON.
Quoi qu'elle ayt merité des maux plus rigoureux, Ie conſens à remplir vos deſirs genereux;	Quoi qu'elle ait mérité des maux plus rigoureux, Je consens à remplir vos désirs généreux;
Et pour mieux adoucir ſon deplaiſir extrême, Ie veux à cét exil la preparer moi-même.	Et pour mieux adoucir son déplaisir extrême, Je veux à cet exil la préparer moi-même.
Mais allons publier cét hymen, ce départ.	Mais allons publier cet hymen, ce départ.
Qu’au bon-heur de leurs Rois nos Sujets prennent part.	Qu'au bonheur de leurs Rois nos Sujets prennent part.
Allons avec éclat annoncer à Corinthe La ſource de ſa joye & la fin de ſa crainte.	Allons avec éclat annoncer à Corinthe La source de sa joie et la fin de sa crainte.
Que des chants d’hymenée & d’aymables concerts, Commencent cette Feſte & rempliſſent les airs.	Que des chants d'hyménée et d'aimables concerts, Commencent cette Fête et remplissent les airs.
Que du Dieu de l’hymen les feux ſacrez s’allument;	Que du Dieu de l'hymen les feux sacrés s'allument;
91 Qu'on pare les Autels & que les Temples fument.	91 Qu'on pare les Autels et que les Temples fument.
Iaſon trouve une Epouſe enfin digne de lui.	Jason trouve une Épouse enfin digne de lui.
Daignent les juſtes Dieux m’exauçant aujourd’hui, Marquer de leurs faveurs cette grande journée, Et la rendre à jamais celebre & fortunée!	Daignent les justes Dieux m'exauçant aujourd'hui, Marquer de leurs faveurs cette grande journée, Et la rendre à jamais célèbre et fortunée!
Fin du premier Acte.	Fin du premier Acte.
ACTE II	ACTE II
SCENE PREMIERE.	SCÈNE PREMIÈRE.
MEDE’E, ſeule.	MÈDE, seule.
U ſuis-je, Malheureuſe?	V suis-je, Malheureuse?
où portay-je mes pas?	où portai-je mes pas?
Qqu’ay-je veu?	Qqu'ai-je vu?
qu’ay-je oüi?	qu'ai-je oui?
je ne me connois pas.	je ne me connais pas.
trieuſe je cours;	trieuse je cours;
& doute ſi je veille.	et doute si je veille.
Quel bruit, quels chants d’hymen ont frappé mon oreille ?	Quel bruit, quels chants d'hymen ont frappé mon oreille ?
Corinthe retentit de cris & de concerts.	Corinthe retentit de cris et de concerts.
Ses Autels ſont parez, ſes Temples ſont ouverts.	Ses Autels sont parés, ses Temples sont ouverts.
Tout à l’envi prepare une odieuſe pompe.	Tout à l'envi prépare une odieuse pompe.
1 Tout vante ma Rivale, & l’Ingrat qui me trompe.	1 Tout vante ma Rivale, et l'Ingrat qui me trompe.
Iaſon, il eſt donc vrai!	Jason, il est donc vrai!
juſques-là me trahit Iaſon honteuſement me chaſſe de ſon lit!	jusqu'là me trahit Jason honteusement me chasse de son lit!
Il m’oſte tout eſpoir!	Il m'ôte tout espoir!
Epouſe infortunée:	Épouse infortunée:
Que diſ-je, Epouſe!	Que dis-je, Épouse!
helas!	hélas!
pour nous plus d’hymenée;	pour nous plus d'hyménée;
L’Ingrat en romp les nœuds.	L'Ingrat en romp les nœuds.
Dieux juſtes, Dieux vangeurs, De la foi conjugale auguſtes Protecteurs, Garants de ſes ſermens, témoins de ſes parjures, Puniſſez ſon forfait & vengez nos injures.	Dieux justes, Dieux vengeurs, De la foi conjugale augustes Protecteurs, Garant de ses serments, témoins de ses parjures, Punissez son forfait et vengez nos injures.
Toi ſur tout, O Soleil, j’implore ton ſecours;	Toi sur tout, Ô Soleil, j'implore ton secours;
Toi qui donnas naiſſance à l’Auteur de mes jours:	Toi qui donnas naissance à l'Auteur de mes jours:
Tu vois du haut des Cieux l’affront qu’on me deſtine;	Tu vois du haut des Cieux l'affront qu'on me destine;
Et Corinthe joüit de ta clarté divine!	Et Corinthe jouit de ta clarté divine!
Retourne ſur tes pas & dans l’obſcurité Plonge tout l’Univers privé de ta clarté.	Retourne sur tes pas et dans l'obscurité Plonge tout l'Univers privé de ta clarté.
Ou plûtoſt, donne moi tes chevaux à conduire.	Ou plutôt, donne moi tes chevaux à conduire.
En poudre dans ces lieux je ſçauray tout reduire.	En poudre dans ces lieux je saurai tout réduire.
Ie tomberay ſur l’Iſthme avec ton char brûlant.	Je tomberai sur l'Isthme avec ton char brûlant.
I’abîmeray Corinthe & ſon peuple inſolent.	J'abîmerai Corinthe et son peuple insolent.
I’écraſeray ſes Rois;	J'écraserai ses Rois;
& ma fureur barbare Unira les deux mers que Corinthe ſepare.	et ma fureur barbare Unira les deux mers que Corinthe sépare.
Mais où vont mes tranſports?	Mais où vont mes transports?
eſt ce donc dans les Cieux, Que j’eſpere trouver du ſecours & des Dieux?	est ce donc dans les Cieux, Que j'espère trouver du secours et des Dieux?
Deitez de Medée, affreuſes Eumenides, Venez laver ma honte & me ſervir de guides.	Ditez de Medée, affreuses Eumenides, Venez laver ma honte et me servir de guides.
Armons nous.	Armons -nous.
De noſtre art déployons la noirceur.	De notre art déployons la noirceur.
Que toute pitié meure & s’éteigne en mon cœur;	Que toute pitié meure et s'éteigne en mon cœur;
Que de ſang alteré, que de meurtres avide A l’Iſthme il faſſe voir ce qu’a veu la Colchide.	Que de sang altéré, que de meurtres avide À l'Isthme il fasse voir ce qu'a vu la Colchide.
Que dis-je!	Que dis-je!
De bien loin ſurpaſſons ces forfaits.	De bien loin surpassons ces forfaits.
De ma tendre jeuneſſe ils furent les eſſais.	De ma tendre jeunesse ils furent les essais.
I’eſtois & foible & ſimple, & de plus innocente.	J'étais et foible et simple, et de plus innocente.
L’amour ſeul animoit ma main encor tremblante.	L'amour seul animait ma main encor tremblante.
La haine avec l’amour, le couroux, la douleur, M’embrazent à preſent d’une juſte fureur.	La haine avec l'amour, le courroux, la douleur, M'embrasent à présent d'une juste fureur.
Que n’enfantera point cette fureur barbare?	Que n'enfantera point cette fureur barbare?
Le crime nous unît;	Le crime nous unît;
il faut qu’il nous ſepare,	il faut qu'il nous sépare,
SCENE II.	SCÈNE II.
MEDE’E, RHODOPE.	MÈDE, RHODOPE.
2 MEDE’E.	2 MÈDE.
E' bien!	E' bien!
tu vois le prix que me gardoit H Iaſon.	tu vois le prix que me gardait H Iason.
L’Ingrat couronne enfin ſa noire trahiſon.	L'Ingrat couronne enfin sa noire trahison.
Il Epouſe Créüſe;	Il Épouse Créüse;
& la pompe s’appreſte.	et la pompe s'apprête.
Tout m’annonce ma mort.	Tout m'annonce ma mort.
Mais à quand cette Feſte?	Mais à quand cette Fête?
RHODOPE.	RHODOPE.
Madame, cét hymen ſe celebre demain.	Madame, cet hymen se célèbre demain.
MEDEE.	MÈDE.
Demain!	Demain!
le temps eſt court & le terme prochain.	le temps est court et le terme prochain.
Il faut en profiter.	Il faut en profiter.
RHODOPE.	RHODOPE.
Quel funeſte hymenée!	Quel funeste hyménée!
Helas!	Hélas!
à quels malheurs eſtes vous condamnée.	à quels malheurs êtes -vous condamnée.
MEDE’E.	MÈDE.
Ah!	Ah!
rien n’eſt comparable aux horreurs de mon fort.	rien n'est comparable aux horreurs de mon fort.
Rhodope, qui l’eût crû?	Rhodope, qui l'eût cru?
Iaſon jure ma mort.	Jason jure ma mort.
Au plus honteux deſtin ſon mépris me ravale.	Au plus honteux destin son mépris me ravale.
Il m’attache en Eſclave au char de ma Rivale.	Il m'attache en Esclave au char de ma Rivale.
I’ay tout ozé pour lui;	J'ai tout osé pour lui;
pour lui j’ay tout quitté, Païs, thrône, parens, gloire, felicité.	pour lui j'ai tout quitté, Pays, trône, parents, gloire, félicité.
Il me coûte, l’Ingrat!	Il me coûte, l'Ingrat!
juſqu’à mon innocence.	jusqu'à mon innocence.
Ie n’ay voulu que lui.	Je n'ai voulu que lui.
Crüelle recompenſe?	Cruelle récompense?
Pour prix de cét amour qui n’a voulu que luy, Il me laiſſe ſans rang, ſans honneur, ſans appui, Sous un Ciel eſtranger, criminelle, accablée, Proſcritte, fugitive, odieuſe, exilée;	Pour prix de cet amour qui n'a voulu que lui, Il me laisse sans rang, sans honneur, sans appui, Sous un Ciel étranger, criminelle, accablée, Proscritte, fugitive, odieuse, exilée;
Et ſeule à la merci d’un monde d’ennemis, Que m’ont fait les forfaits que pour luy j’ay conmis.	Et seule à la merci d'un monde d'ennemis, Que m'ont fait les forfaits que pour ra j'ai conmis.
RHODOPE.	RHODOPE.
Trop moigne de vous apres la facnemjure, Oubliez un Ingrat, dédaignez un Parjure.	Trop moigne de vous après la facnemjure, Oubliez un Ingrat, dédaignez un Parjure.
D’un genereux orgueüil vous armant en ce jour.	D'un généreux orgueil vous armant en ce jour.
MEDE’E.	MÈDE.
Hé!	Hé!
puis-je triompher de mon fatal amour?	puis-je triompher de mon fatal amour?
Malheureuſe!	Malheureuse!
tout cede à mon art redoutable.	tout cède à mon art redoutable.
La nature ſe trouble à ma voix formidable Tout tremble, tout fléchit ſous mon pouvoir vainqueur.	La nature se trouble à ma voix formidable Tout tremble, tout fléchit sous mon pouvoir vainqueur.
Et je ne puis bannir un Ingrat de mon cœur.	Et je ne puis bannir un Ingrat de mon cœur.
L’Amour brave ma force, & mépriſe mes charmes;	L'Amour brave ma force, et méprise mes charmes;
Hrit de ma fureur & m’arrache des larmes.	Hrit de ma fureur et m'arrache des larmes.
Pour un Perfide encore il trouble ma raiſon.	Pour un Perfide encore il trouble ma raison.
I’aime;	J'aime;
que dis-je, aimer?	que dis-je, aimer?
j’adore encor Iaſon.	j'adore encor Jason.
Pour lui je trahirois encor Pere & Patrie;	Pour lui je trahirais encor Père et Patrie;
Pour lui j’immolerois mon repos & ma vie.	Pour lui j'immolerais mon repos et ma vie.
D'un tyjunque fiilour trop barbare rigueur, Ceſſe pour un Ingrat de déchirer mon cœur.	D'un tyjunque fiour trop barbare rigueur, Cesse pour un Ingrat de déchirer mon cœur.
RHODOPE.	RHODOPE.
En ce funeſte état que vous eſtes à plaindre!	En ce funeste état que vous êtes à plaindre!
MEDE’E.	MÈDE.
Il eſt vrai, je le ſuis;	Il est vrai, je le suis;
mais plus encore à craindre.	mais plus encore à craindre.
On n’offenſa jamais Medée impunement.	On n'offensa jamais Medée impunément.
Mais, que dit ma Rivale, & que fait ſon Amant?	Mais, que dit ma Rivale, et que fait son Amant?
RODorE.	RODorE.
Ah!	Ah!
Madame, il ſoupire aux pieds de la Princeſſe;	Madame, il soupire aux pieds de la Princesse;
Et n’eſt plus occupé que du feu qui le preſſe.	Et n'est plus occupé que du feu qui le presse.
MEDE’E.	MÈDE.
Ton ſang vame vanger, lâche & perfide Epoux!	Ton sang vame venger, lâche et perfide Époux!
Tu mourras.	Tu mourras.
quelle horreur vient glacer mon courroux?	quelle horreur vient glacer mon courroux?
Et depuis quand Medée eſt elle ſi timide?	Et depuis quand Medée est -elle si timide?
Son cœur n’eſt-il hardi que pour un parricide?	Son cœur n'est-il hardi que pour un parricide?
Aprés tant d’innocens immolez ſans remords, Ie reſpecte un Ingrat digne de mille morts.	Après tant d'innocents immolés sans remords, Je respecte un Ingrat digne de mille morts.
Ah!	Ah!
qu’il meure.	qu'il meure.
Où m’emporte une jalouze rage?	Où m'emporte une jalouze rage?
Qu’il meure!	Qu'il meure!
ce Heros, ton amour, ton ouvrage;	ce Héros, ton amour, ton ouvrage;
Le fruit de tant de ſoins, de perils, d’attentats, L’objet de tant de vœux.	Le fruit de tant de soins, de périls, d'attentats, L'objet de tant de vœux.
non, il ne mourra pas.	non, il ne mourra pas.
Quelque juſte fureur dont je ſois poſſedée, Qu’il vive, & s’il ſe peut, qu’il vive pour Medée;	Quelque juste fureur dont je sois possédée, Qu'il vive, et s'il se peut, qu'il vive pour Medée;
Ou, ſi de mon bon-heur le Deſtin eſt jaloux, Qu’il vive, s’il le faut, pour d’autres que pour nous.	Ou, si de mon bonheur le Destin est jaloux, Qu'il vive, s'il le faut, pour d'autres que pour nous.
C’eſt Creon, qui le force à l’hymen qui m’accable;	C'est Creon, qui le force à l'hymen qui m'accable;
Creon merite ſeul mon courroux implacable, Lui, qui de ſon pouvoir ennivré follement, Me ravit mon Epoux, m’arrache mon Amant, Tait legner en lyran le emme & le urvorce;	Creon mérite seul mon courroux implacable, Lui, qui de son pouvoir ennivré follement, Me ravit mon Époux, m'arrache mon Amant, Tait legner en lyran le emme et le urvorce;
Et ne connoît de droits que l’injure & la force.	Et ne connaît de droits que l'injure et la force.
Qu’il periſſe & ſa Race.	Qu'il périsse et sa Race.
Accablons ſon orgueüil, Mettons ſon inſolence & ſa gloire au cercueüil.	Accablons son orgueil, Mettons son insolence et sa gloire au cercueil.
RHODOPE.	RHODOPE.
Ah!	Ah!
moderez, de grace, une douleur ſi forte.	modérez, de grâce, une douleur si forte.
Etouffez, ou cachez l’ardeur qui vous emports.	Étouffez, ou cachez l'ardeur qui vous emports.
I’entens du bruit.	J'entends du bruit.
On vient.	On vient.
Domptez ce fier couroux, Madame;	Domptez ce fier courroux, Madame;
c’eſt Creon qui s’avance vers vous,	c'est Creon qui s'avance vers vous,
SCENE III.	SCÈNE III.
MEDED, GRLON, RHODOPE, ſuite.	MÉDED, GRLON, RHODOPE, suite.
CREON.	CREON.
Aſon avec ma fille unit ſa deſtinée.	Ason avec ma fille unit sa destinée,
IVous entendez déja chanter leur hymenée, Madame;	JVous entendez déjà chanter leur hyménée, Madame;
à ce divorce il faut vous preparer.	à ce divorce il faut vous préparer.
De Iaſon & de nous il faut vous ſeparer.	De Jason et de nous il faut vous séparer.
Leur bon-heur ne feroit qu’aigrir voſtre infortune;	Leur bonheur ne ferait qu'aigrir votre infortune;
Fuyez ces lieux;	Fuyez ces lieux;
fuyez une pompe importune;	fuyez une pompe importune;
Obéiſſez au ſort, & quittant mes états, Cherchez un ſur azyle en de nouveaux climats.	Obéissez au sort, et quittant mes états, Cherchez un sur asile en de nouveaux climats.
Acaſte le demande, & Corinthe m’en preſſe:	Acaste le demande, et Corinthe m'en presse:
A ce prix entre-nous la guerre affreuſe ceſſe.	À ce prix entre-nous la guerre affreuse cesse.
Voſtre exil eſt le ſceau d’une éternelle paix.	Votre exil est le sceau d'une éternelle paix.
En vain m’oppoſerois-je aux vœux de mes Sûjets.	En vain m'opposerai-je aux vœux de mes Sûjets.
Leur haine contre vous chaque jour s’envenime.	Leur haine contre vous chaque jour s'envenime.
Malgré tout mon pouvoir vous ſeriez leur victime.	Malgré tout mon pouvoir vous seriez leur victime.
Quel joug ne briſe point un Peuple audacieux?	Quel joug ne brise point un Peuple audacieux?
Quel frein arreſteroit ce Monſtre furieux?	Quel frein arrêterait ce Monstre furieux?
A ſes crüels tranſports dérobez voſtre tête, Et par un prompt exil prevenez la tempeſte.	À ses cruels transports dérobez votre tête, Et par un prompt exil prévenez la tempête.
Le Sort, la paix, vos jours, tout ſemble y conſpirer.	Le Sort, la paix, vos jours, tout semble y conspirer.
I'ay voulu vous l’apprendre & vous y preparer.	J'ai voulu vous l'apprendre et vous y préparer.
MEDE’E.	MÈDE.
Qu'à ces rares bontez j’ay de graces à rendre!	Qu'à ces rares bontés j'ai de grâces à rendre!
Vous m’oſtez mon Epoux, vous le prenez pour gendre;	Vous m'ôtez mon Époux, vous le prenez pour gendre;
Vous me chaſſez enfin.	Vous me chassez enfin.
Dites-moi ſeulement Quel attentat m’attire un ſi doux traitement?	Dites-moi seulement Quel attentat m'attire un si doux traitement?
CREOR Quoi, Medée eſt ſurpriſe & demande ſes crimes!	CRER Quoi, Medée est surprise et demande ses crimes!
MEDE’E.	MÈDE.
A-t'on pour m’opprimer quelques droits legitimes?	A-t'-on pour m'opprimer quelques droits légitimes?
Un Tyran par la force agit dans ſes eſtats;	Un Tyran par la force agit dans ses états;
Un Roi juſte au coupable apprend ſes attentats.	Un Roi juste au coupable apprend ses attentats.
Parlez donc;	Parlez donc;
ou du moins forcez-vous à m’entendre, Si juſqu’à m’accuſer vous ne daignez deſcendre.	ou du moins forcez-vous à m'entendre, Si jusqu'à m'accuser vous ne daignez descendre.
l’ignore quel forfait vers vous peut me noircir :	l'ignore quel forfait vers vous peut me noircir :
Voiey les miens, Creon.	Voiéi les miens, Creon.
Vous n’avez qu’a choiſir.	Vous n'avez qu'a choisir.
I’ay ſauvé ces Heros que vous vantez ſans ceſſe, Le plus pur ſang des Dieux, & la fleur de la Grece.	J'ai sauvé ces Héros que vous vantez sans cesse, Le plus pur sang des Dieux, et la fleur de la Grèce.
Sans moi, pour conquerir la ſuperbe Toiſon.	Sans moi, pour conquérir la superbe Toison.
Qu’auroient pû ces Heros, & ce fameux laſon?	Qu'auraient pu ces Héros, et ce fameux lason?
Leur bouche a-t’elle ozé m’en dérober la gloires S’ils vous l’ont déguiſée, apprenez-en l’hiſtoire.	Leur bouche a-t-elle ozé m'en dérober la gloires S'ils vous l'ont déguisée, apprenez-en l'histoire.
Dans une foreſt ſombre un Dragon furieux, Conſervoit du Dieu Mars le dépoſt pretieux.	Dans une forêt sombre un Dragon furieux, Conservait du Dieu Mars le dépôt prétieux.
Ses yeux eſtincelloient d’une affreuſe lumiere;	Ses yeux estincelloient d'une affreuse lumière;
Iamais le doux Sommeil ne charma leur paupiere;	Jamais le doux Sommeil ne charma leur paupière;
Et veillant nuit & jour, ſes terribles regards Portoient l’effroi, l’horreur, la mort de toutes parts.	Et veillant nuit et jour, ses terribles regards Portaient l'effroi, l'horreur, la mort de toutes parts.
Farouches défenſeurs de la foreſt ſacrée, Deux Taureaux menaçans en occupoient l’entrée.	Farouches défenseurs de la forêt sacrée, Deux Te menaçans en occupaient l'entrée.
Il falloit mettre au joug ces Taureaux indontez.	Il fallait mettre au joug ces Taureaux indontés.
Des fureurs de Vulcain Miniſtres redoutez, Ils vomiſſoient au loin une brûlante haleine, Et de torrens de flâme ils inondoient la plaine.	Des fureurs de Vulcain Ministres redoutez, Ils vomissaient au loin une brûlante haleine, Et de torrents de flamme ils inondaient la plaine.
Il falloit à leur aide ouvrir d’affreux ſillons;	Il fallait à leur aide ouvrir d'affreux sillons;
Voir des dents d’un ſerpent naiſtre des bataillons;	Voir des dents d'un serpent naître des bataillons;
Et vaincre ces ſoldats enfantez par la Terre, Qui tous ne reſpiroient que le ſang & la guerre.	Et vaincre ces soldats enfantez par la Terre, Qui tous ne respiraient que le sang et la guerre.
Parmi tant de perils, quel Dieu, ſans mon ſecours, De vos triſtes Heros eût conſervé les jours?	Parmi tant de périls, quel Dieu, sans mon secours, De vos tristes Héros eût conservé les jours?
Sur le Deſtin jaloux j’emportay la victoire:	Sur le Destin jaloux j'emportai la victoire:
I’empeſchay leur trépas;	J'empêchai leur trépas;
je les couvris de gloire;	je les couvris de gloire;
Et leur ſacrifiay, remords, crainte, pudeur, Mon Pere, mon Païs, ma gloire, mon bon-heur.	Et leur sacrifiai, remords, crainte, pudeur, Mon Père, mon Pays, ma gloire, mon bonheur.
Ie n’ay voulu qu’un d’eux pour toute recompenſe.	Je n'ai voulu qu'un d'eux pour toute récompense.
Vous joüiſſez du reſte, & par mon aſſiſtance.	Vous jouissez du reste, et par mon assistance.
Pour les avoir ſauvez, je ne demande rien.	Pour les avoir sauvés, je ne demande rien.
Je vous les laiſſe tous.	Je vous les laisse tous.
Mais laiſſez-moi mon bien.	Mais laissez-moi mon bien.
CREON.	CREON.
Ainſi donc, à l’oüir, Medée eſt innocente.	Ainsi donc, à l'oüir, Medée est innocente.
On deviont comacier Ia vertu blen-faiſante.	On deviont compacier Ia vertu blenaisante.
La Grece.	La Grèce.
MEDE’E.	MÈDE.
Me doit tout, & ne ſçauroit jamais D’un aſſez digne prix couronner mes bien-faits.	Me doit tout, et ne saurait jamais D'un assez digne prix couronner mes bienfaits.
Toutes-fois que ſert-il d’affecter un fauxzele?	Toutefois que sert-il d'affecter un fauxzele?
J’ay tout fait pour Jaſon, & n’ay rien fait pour elle.	J'ai tout fait pour Jason, et n'ai rien fait pour elle.
Il me coute aſſez cher l’Ingrat!	Il me coute assez cher l'Ingrat!
pour eſtre à moy.	pour être à moi.
Si l’on veut méxiler & me manquer de foy, De quel droit ozez-vous ſeparer nos fortunes?	Si l'on veut méxiler et me manquer de foi, De quel droit zé-vous séparer nos fortunes?
Même ſort nous eſt dú;	Même sort nous est dîme;
nos cauſes ſont communcs.	nos causes sont communcs.
dneon Ah!	don Ah!
de grace avec-vous ne le confondez pas.	de grâce avec-vous ne le confondez pas.
Jaſon eſt innocent de tous vos attentats.	Jason est innocent de tous vos attentats.
MEDE’E.	MÈDE.
Non, il eſt criminel ce Heros magnanime.	Non, il est criminel ce Héros magnanime.
En tirer tout le fruit c’eſt commettre le crime, Tyrannique pouvoir qui cherche à m’offenſer.	En tirer tout le fruit c'est commettre le crime, Tyrannique pouvoir qui cherche à m'offenser.
CREON.	CREON.
Ma patience enfin commence à ſe laſſer, Et pourroit.	Ma patience enfin commence à se lasser, Et pourrait.
MEDE’E.	MÈDE.
Ah!	Ah!
Tyran, la mienne eſt déja laſſeVa, je ne veux de toi ny clemence ny grace.	Tyran, la mienne est déjà lasseVa, je ne veux de toi ici clémence est déjà.
Ordonne mon exil, ravis moi mon Epoux:	Ordonne mon exil, ravis moi mon Époux:
Tu le peux;	Tu le peux;
mais Tyran, redoute mon courroux.	mais Tyran, redoute mon courroux.
Crains.	Crains.
CREON.	CREON.
Ah!	Ah!
c’eſt trop long-temps contraindre ma colere.	c'est trop longtemps contraindre ma colère.
Va, ſors de mes Eſtats, ſors barbare Eſtrangere:	Va, sors de mes États, sors barbare Étrangère:
Abandonne Corinthe, & cours en d’autres lieux, Porter tes attentats & le courroux des Dieux.	Abandonne Corinthe, et cours en d'autres lieux, Porter tes attentats et le courroux des Dieux.
D’un monſtre tel que toy délivre mon Empire, Ceſſe d’infecter l’air qu’en ces lieux on reſpire, De ton horrible aſpect ne ſoüille plus mes yeux;	D'un monstre tel que toi délivre mon Empire, Cesse d'infecter l'air qu'en ces lieux on respire, De ton horrible aspect ne soüille plus mes yeux;
Et n’empoiſonne plus la lumiere des Cieux.	Et n'empoisonne plus la lumière des Cieux.
Va ſemer à Colchos l’horreur & l’epouvante:	Va semer à Colchos l'horreur et l'épouvante:
Vas y hâter des Dieux la juſtice ttop lente.	Vas y hâter des Dieux la justice top lente.
Deinain dés que l’Aurore allumera le jour, Precipite tes pas;	Deinain dès que l'Aurore allumera le jour, Précipite tes pas;
fuis loin, fuis ſans retour;	fuis loin, fuis sans retour;
Où contentant les Dieux las de tes injuſtices, Tu periras, Barbare, au milieu des ſupplices.	Où contentant les Dieux las de tes injustices, Tu périras, Barbare, au milieu des supplices.
Tu peux choiſir.	Tu peux choisir.
Adieu.	Adieu.
S ENE IV MEDE’E, RHODOPE.	 SNE IV MÈDE, RHODOPE.
MEDE’E.	MÈDE.
LYran, n’en doute pas;	LYran, n'en doute pas;
Mon choix eſt fait.	Mon choix est fait.
Demain je ſors de tes Eſtats.	Demain je sors de tes États.
Mais, malgré ton orgueil, je veux fuir avec gloire;	Mais, malgré ton orgueil, je veux fuir avec gloire;
Et forçant l’avenir d’en garder la memoire, Je veux lancer la foudre avant que de partir, Et voir Corinthe en cendre avant que d’en ſortir, Mais Rhodope, l’Ingrat que j’aime & qui m’offenſe, A-t’il pû conſentir.	Et forçant l'avenir d'en garder la mémoire, Je veux lancer la foudre avant que de partir, Et voir Corinthe en cendre avant que d'en sortir, Mais Rhodoppe, l'Ingrat que j'aime et qui m'offense, A-t-il pu consentir.
RHODOPE.	RHODOPE.
Je le voy qui s’avance.	Je le vois qui s'avance.
MEDE’E.	MÈDE.
O Toi, qui vois mon trouble & cauſes ma douleur, Amour, daigne amollir l’Ingrat en ma faveur;	Ô Toi, qui vois mon trouble et causes ma douleur, Amour, daigne amollir l'Ingrat en ma faveur;
Remets-le dans mes fers;	Remets-le dans mes fers;
efface ſon injure;	efface son injure;
Rens moi, Dieu tout puiſſant, le cœur de ce Parjure:	Rends moi, Dieu tout puissant, le cœur de ce Parjure:
Tout mon art n’y peut rien:	Tout mon art n'y peut rien:
ſeul tu peux le flechir.	seul tu peux le fléchir.
Prête un charme à mes pleurs qui puiſſe l’attendrir.	Prête un charme à mes pleurs qui puisse l'attendrir.
SCENE V.	SCÈNE V.
MEDE’E, JASON, RHODOPE.	MÈDE, JASON, RHODOPE.
MEDE’E.	MÈDE.
Nfin, c’en-eſt donc fait, mon Epoux m’aE bandonne.	Nfin, c'en-est donc fait, mon Époux m'a bandonne.
El conſeat qu’on m’exile, ou plâtoſt il l’ordonne.	Él conseat qu'on m'exile, ou plâtost il l'ordonne.
L’exil, vous le ſçavez, n’eſt pas nouveau pour moy.	L'exil, vous le savez, n'est pas nouveau pour moi.
J’ay ſceu pour vous, Jaſon, m’en impoſer la loiSa cauſe eſt-ce qui fait ma peine & ma diſgrace.	J'ai su pour vous, Jason, m'en imposer la loiSa cause est-ce qui fait ma peine et ma disgrâce.
Je fuyois pour Jaſon, & c’eſt lui qui me chaſſe.	Je fuyais pour Jason, et c'est lui qui me chasse.
N’importe;	N'importe;
obéyſſons aux lois de mon Epoux.	obéissons aux lois de mon Époux.
Partons, puis qu’il le veut.	Partons, puis qu'il le veut.
Mais où m’envoyez.	Mais où m'envoyez.
vous ?	vous ?
Reverray-je Yolcos?	Reverrai-je Yolcos?
iray-je en Theſſalie, Implorer les bontez des filles de Pelie?	irai-je en Thessalie, Implorer les bontés des filles de Pélie?
Iray-je ſur le Phaze, où mon Pere irrité Reſerve un juſte prix à mon impieté?	Jrai-je sur le Phase, où mon Père irrité Réserve un juste prix à mon impiété?
Helas!	Hélas!
du monde entier pour Jaſon ſeul bannie, Ay-je encor quelque azyle en Europe, en Aſie?	du monde entier pour Jason seul bannie, Ai-je encor quelque asile en Europe, en Asie?
Et pour vous les ouvrir me fermant tous chemins, Contre-moi n’ay-je pas armé tous les humains?	Et pour vous les ouvrir me fermant tous chemins, Contre-moi n'ai-je pas armé tous les humains?
Fille d’un Roi fameux qui regne ſur le Phaze, Dont l’empire s’étend du Boſphore au Caucaſe, Dans ces riches climats, où ſes heureux ſûjets De l’or le plus brillant parent juſqu’aux foreſts;	Fille d'un Roi fameux qui règne sur le Phaze, Dont l'empire s'étend du Bosphore au Caucase, Dans ces riches climats, où ses heureux sujets De l'or le plus brillant parent jusqu'aux forêts;
Threſors, Sceptre, Parens, j’ay tout quitté ſans peine, Pour ſuivre d’un banni la fortune incertaine.	Thresors, Sceptre, Parents, j'ai tout quitté sans peine, Pour suivre d'un banni la fortune incertaine.
Vous le Içavez, Jaſon;	Vous le Içavez, Jason;
pour vous j’ay tout quitté.	pour vous j'ai tout quitté.
Eſt-ce donc-là le prix que j’avois merité?	Est-ce donc-là le prix que j'avais mérité?
JASON.	JASON.
Ne me reprochez point un mal-heur neceſſaire, Où des Dieux contre nous me reduit la colere.	Ne me reprochez point un malheur nécessaire, Où des Dieux contre nous me réduit la colère.
Je partage vos maux;	Je partage vos maux;
je reſlens vos douleurs, Sans pouvoir qu’à ce prix détourner nos malheurs.	je réslends vos douleurs, Sans pouvoir qu'à ce prix détourner nos malheurs.
Voſtre perte autrement devient inevitable.	Votre perte autrement devient inévitable.
Vos perils, nos Emune, le Deitin qui m’accable, Les bontez de Créüſe & les bien-faits du Roi Me font.	Vos périls, nos Emune, le Ditin qui m'accable, Les bontés de Créüse et les bienfaits du Roi Me font.
MEDE’E.	MÈDE.
Ozes-tu bien en parler devant moi ?	Oz-tu bien en parler devant moi ?
Ingrat?	Ingrat?
quel vain détour!	quel vain détour!
quelle odieuſe excuſe!	quelle odieuse excuse!
Les bien-faits de Creon!	Les bienfaits de Creon!
les bontez de Créüſe!	les bontés de Créüse!
Que ſont-ils prés des miens?	Que sont-ils près des miens?
& quel prix doit jamais Balancer dans ton cœur le prix de mes bienfaits ?	et quel prix doit jamais Balancer dans ton cœur le prix de mes bienfaits ?
J’ay conſervé cent fois & ta vie & ta gloire.	J'ai conservé cent fois et ta vie et ta gloire.
Réſouvien-t’en, Ingrat, rapelle en ta memoire Ces temps, ou vil rebut du Deſtin & des flots, Tu vins chercher ta perte & la mort à Colehos.	Résouvien-t-en, Ingrat, rappelle en ta mémoire Ces temps, ou vil rebut du Destin et des flots, Tu vins chercher ta perte et la mort à Colhos.
En vain de la Toiſon tu tentois la Conqueſte.	En vain de la Toison tu tentais la Conquête.
Songe à tous les perils qui menaçoient ta tête.	Songe à tous les périls qui menaçaient ta tête.
Remets devant tes yeux ce fatal champ de Mars;	Remets devant tes yeux ce fatal champ de Mars;
Sous cent formes la Mort offerte à tes regards;	Sous cent formes la Mort offerte à tes regards;
Ces Enfans de la Terre affamez de carnage;	Ces Enfants de la Terre affamés de carnage;
Ces tourbillons de feux;	Ces tourbillons de feux;
ces Mouſtres pleins de rage.	ces Moustres pleins de rage.
Alors, Ingrat, alors;	Alors, Ingrat, alors;
qu’euſt fait Creon pour toi?	qu'eût fait Creon pour toi?
En butte à tant de morts qu’aurois-tu fait ſans moi ?	En bute à tant de morts qu'aurais-tu fait sans moi ?
Pour toi je déployay tout l’effort de mes charmes.	Pour toi je déployai tout l'effort de mes charmes.
J’immolay les Guerriers, & par leurs propres armes.	J'immolai les Guerriers, et par leurs propres armes.
Je domptay les Taureaux;	Je domptai les Taureaux;
j’aſſoupis le Dragon;	j'assoupis le Dragon;
Enfin, je te livray la fatale Toiſon.	Enfin, je te livrai la fatale Toison.
Je fis plus;	Je fis plus;
je quittay ma Patrie, & mon Pere;	je quittai ma Patrie, et mon Père;
ciouffay la Nature, & déchiray mon Frere;	ciouffai la Nature, et déchirai mon Frère;
J’affrontay le naurrage & la mort pour Jaſon.	J'affrontai le naurage et la mort pour Jason.
I’immolay ton Tyran, je rajeunis Æſon.	J'immolai ton Tyran, je rajeunis Æson.
Ta vie eſt un tiſſu des bien-faits de Medée.	Ta vie est un tissu des bienfaits de Medée.
Créüſe, Ingrat, peut-elle en effacer l’idée.	Créüse, Ingrat, peut-elle en effacer l'idée.
JASON.	JASON.
Juſques dans le tombeau rempli de vos bien-faits Jaſon en gardera la memoire à jamais.	Jusque dans le tombeau rempli de vos bienfaits Jason en gardera la mémoire à jamais.
Dans le fond de mon cœur ſi vos yeux pouvoient lire, Helas!	Dans le fond de mon cœur si vos yeux pouvaient lire, Hélas!
vous plaindriez l’horreur qui le déchire.	vous plaindriez l'horreur qui le déchire.
Mais, quand le ſort con plivu rouo laire perir, & poutois-je pour vous ente pen:	Mais, quand le sort con plivenu rouo laire périr, et poutais-je pour vous ente pen:
MEDE’E.	MÈDE.
Mourir.	Mourir.
Pour toi n’eſtoi-ce pas une gloire aſſez ample?	Pour toi n'étoice pas une gloire assez ample?
Je t’en aurois donné le courage & l’exemple;	Je t'en aurais donné le courage et l'exemple;
Et me perçant le flanc pour enhardir ta main, Je t’euſſe encore ouvert ce glorieux chemin.	Et me perçant le flanc pour enhardir ta main, Je t'eusse encore ouvert ce glorieux chemin.
Je ne te parle plus du prixque tu me coûtes, Pour attendrir ton cœur n’eſt-il point d’autres routes ?	Je ne te parle plus du prixque tu me coûtes, Pour attendrir ton cœur n'est-il point d'autres routes ?
Oublie, oublie Ingrat, mes bien-faits en ce jour.	Oublie, oublie Ingrat, mes bienfaits en ce jour.
Mais ſouviens-toi du moins de mon fidelle amour.	Mais souviens-toi du moins de mon fidèle amour.
Voy Medée à tes pieds gemir, verſer des larmes.	Vois Medée à tes pieds gémir, verser des larmes.
Au nom de noſtre amour jadis ſi plein de charmes, Au nom de noſtre hymen & de ſes ſacrez nœuds, Au nom des tendres fruits d’un hymen malheureux;	Au nom de notre amour jadis si plein de charmes, Au nom de notre hymen et de ses sacrés nœuds, Au nom des tendres fruits d'un hymen malheureux;
Si tes Fils te ſont chers ne trahis point leur Mere.	Si tes Fils te sont chers ne trahis point leur Mère.
Dans ces portraits vivans on reconnoiſt leur Pere.	Dans ces portraits vivants on reconnaît leur Père.
Prens pitié, non de moi, mais de ces Innocens;	Prends pitié, non de moi, mais de ces Inocents;
Et te laiſſe toucher à des traits ſi puiſſans.	Et te laisse toucher à des traits si puissants.
Helas!	Hélas!
Dans les malheurs dont le ſort les menace, Plus que jamais ſenſible à leur âge, à leur grace;	Dans les malheurs dont le sort les menace, Plus que jamais sensible à leur âge, à leur grâce;
Croyant te voir, de pleurs je ſens baigner mes yeux;	Croyant te voir, de pleurs je sens baigner mes yeux;
Et ton amour encor m’en eſt plus pretieux.	Et ton amour encor m'en est plus prétieux.
Sauve-moi, ſauve-les;	Sauve-moi, sauve-les;
& plains leur deſtinée.	et plains leur destinée.
Suivant dans ſon exil leur Mere infor tunée, Quels maux.	Suivant dans son exil leur Mère infor tunée, Quels maux.
JASON.	JASON.
Ceſſez pour eux de craindre un tel malheur.	Cessez pour eux de craindre un tel malheur.
Moi, bannir mes Enfans!	Moi, bannir mes Enfants!
j’en mourrois de douleur.	j'en mourrais de douleur.
Ah!	Ah!
d’un threſor ſi cher mon cœur eſt trop avare, Pour craindre que jamnais le Deitin men ſepare.	d'un trésor si cher mon cœur est trop avare, Pour craindre que jamnais le Ditin men sépare.
Rien ne peut les ravir à mes emhraſſemens.	Rien ne peut les ravir à mes emhrassements.
MEDE’E.	MÈDE.
Quoi tu pretens auſſi m’arracher mes Enfans!	Quoi tu prétends aussi m'arracher mes Enfants!
Tu pretens me ravir le ſeul bien qui me reſte :	Tu prétends me ravir le seul bien qui me reste :
Je ne joüiray pas de la douceur funeſte De voir leur innocence appaiſer mes fureurs;	Je ne jouirai pas de la douceur funeste De voir leur innocence apaiser mes fureurs;
Et de ſi cheres mains n’eſſuîront point mes pleurs.	Et de si chères mains n'essuîtront point mes pleurs.
Tu m’oſtes des objets que mon cœur idolâtre.	Tu m'ôtes des objets que mon cœur idolâtre.
Veux-tu les immoler, Crüel, à leur Maraſtre?	Veux-tu les immoler, Cruel, à leur Marâtre?
JASON.	JASON.
Je veux leur faire un ſort, leur aſſurer un rang, Qui les comble de gloire & réponde à leur ſang.	Je veux leur faire un sort, leur assurer un rang, Qui les comble de gloire et réponde à leur sang.
Prés du thrône élevez à l’ombre de leur Pere, Ils trouveront icy plus d’un Dieu tutelaire.	Prés du trône élevez à l'ombre de leur Père, Ils trouveront ici plus d'un Dieu tutélaire.
Creon fera pour eux plus qu’il ne m’a prom is;	Creon fera pour eux plus qu'il ne m'a prom is;
Et les confondra même avec ſes petits Fils.	Et les confondra même avec ses petits Fils.
MEDE’E.	MÈDE.
Perir plûtoſt cent fois qu’eſſuyer cét outrage!	Périr plutôt cent fois qu'essuyer cet outrage!
Lache, ſoüiller mon ſang par un vil aſſemblage!	Lache, soüiller mon sang par un vil assemblage!
Voir les fils du Soleil ſous le joug abattus, Avec ceux de Siſyphe unis & confondus!	Voir les fils du Soleil sous le joug abattus, Avec ceux de Sisyphe unis et confondus!
JASON.	JASON.
Enfin telle eſt pour eux ma tendreſſe infinie, Que vouloir m’en priver, c’eſt m’arracher la vie.	Enfin telle est pour eux ma tendresse infinie, Que vouloir m'en priver, c'est m'arracher la vie.
Je ne puis les quitter, & l’amour paternel.	Je ne puis les quitter, et l'amour paternel.
MEDE’E.	MÈDE.
Hé bien, n’en parlons plus!	Hé bien, n'en parlons plus!
ôte les moi, Crüel.	ôte les moi, Cruel.
Mais crains mon deſeſpoir, crains mon courroux funeſte.	Mais crains mon désespoir, crains mon courroux funeste.
Tu perds, me les ôtant, tout l’appui qui te Telte, Leur veuë & leurs ſoupirs ſuſpendoient ma fureur;	Tu perds, me les ôtant, tout l'appui qui te Telte, Leur vue et leurs soupirs suspendaient ma fureur;
Rien ne me parle plus, Perfide, en ta faveur.	Rien ne me parle plus, Perfide, en ta faveur.
JASON.	JASON.
Je croiois moderer la douleur qui vous preſſe.	Je croyais modérer la douleur qui vous presse.
Cependant je l’aigris;	Cependant je l'aigris;
ma preſence vous bleſſe.	ma présence vous blesse.
Le temps & la raiſon ouvrant enfin vos yeux, Vous me rendrez juſtice, en me connoiſſant mieux.	Le temps et la raison ouvrant enfin vos yeux, Vous me rendrez justice, en me connaissant mieux.
SCENEVI.	SCENEVI.
MEDE’E, RHODOPE.	MÈDE, RHODOPE.
MEDE’E.	MÈDE.
Ui je te la rendray, Crüel;	Oui je te la rendrai, Cruel;
je m’y prepare.	je m'y prépare.
Tu m’ôtes mes Enfans;	Tu m'ôtes mes Enfants;
tu me ravis, Barbare, Le ſeul bien qui pouvoit adoucir mon malheur.	tu me ravis, Barbare, Le seul bien qui pouvait adoucir mon malheur.
Ah!	Ah!
je t’en puniray;	je t'en punirai;
j’en jure ma douleur.	j'en jure ma douleur.
Tremble, Ingrat, c’en eſt fait.	Tremble, Ingrat, c'en est fait.
Ma haine inexorable Te va rendre jaloux de mon ſort déplorable.	Ma haine inexorable Te va rendre jaloux de mon sort déplorable.
Fin du ſecond Acte.	Fin du second Acte.
AGIDITI.	AGIDITI.
SCENE PREMIERE.	SCÈNE PREMIÈRE.
JASON, CREOSE, IPHITE.	JASON, CREOSE, IPHITE.
JASON.	JASON.
Adame, c’en eſt fait.	Adame, c'en est fait.
Medée aprés ce jour, Abandonne Corinthe & quitte cette Cour.	Medée aprés ce jour, Abandonne Corinthe et quitte cette Cour.
En menaces en vain elle oze ſe répandre.	En menaces en vain elle ose se répandre.
Dans un terme ſi court que peut-elle entreprendre?	Dans un terme si court que peut-elle entreprendre?
Et d’ailleurs pour ſes Fils tremblante dans ſon cœur Des ôtages fi chers retiennent ſa fureur.	Et d'ailleurs pour ses Fils tremblante dans son cœur Des ôtages fi chers retiennent sa fureur.
Je fais même obſerver ſes pas & ſa colere.	Je fais même observer ses pas et sa colère.
Ainſi rien ne s’oppoſe à l’hymen que j’eſpere.	Ainsi rien ne s'oppose à l'hymen que j'espère.
Tout m’annonce un bon-heur infaillible & prochain, Et les Dieux, de mon ſort ſeront jaloux demain, Que ce crüel delai me fait de violence;	Tout m'annonce un bonheur infaillible et prochain, Et les Dieux, de mon sort seront jaloux demain, Que ce cruel délai me fait de violence;
Et que ce jour eſt long à mon impatience!	Et que ce jour est long à mon impatience!
J’accuſe ſa lenteur de moment en moment.	J'accuse sa lenteur de moment en moment.
Elle irrite ma flâme & mon empreſſement.	Elle irrite ma flamme et mon empressement.
L’heureux Jaſon languit.	L'heureux Jason languit.
Mais ma belle Princeſſe, Partagez-vous du moins ma joye & ma tendreſſe?	Mais ma belle Princesse, Partagez-vous du moins ma joie et ma tendresse?
Aimez-vous des tranſports dont vous cauſez l’ardeur?	Aimez-vous des transports dont vous causez l'ardeur?
Sentez-vous du plaiſir à faire mon bon-heur ?	Sentez-vous du plaisir à faire mon bonheur ?
Vous ne me dittes rien.	Vous ne me dites rien.
Quelle raiſon ſecrette, Dans ces heureux momens peut vous rendre müette?	Quelle raison secrète, Dans ces heureux moments peut vous rendre muette?
Une ſombre langueur que vous cachez en vain, De voſtre front troublé ternit l’éclat ſerein.	Une sombre langueur que vous cachez en vain, De votre front troublé ternit l'éclat serein.
Que vois-je!	Que vois-je!
à vos yeux même il échappe des larmes.	à vos yeux même il échappe des larmes.
D’où viennent vos frayeurs?	D'où viennent vos frayeurs?
d’ou naiſſent vos allalſes.	d'ou naissent vos allalses.
Ay-je pû, ma Princeſſe, offenſer vos beaux yeux?	Ai-je pu, ma Princesse, offenser vos beaux yeux?
Qu'ay-je fait?	Qu'ai-je fait?
qu’ay-je dit?	qu'ai-je dit?
& vous ſuis-je odieux?	et vous suis-je odieux?
CRE’USE.	CRE'USE.
Moi, vous haïr, Seigneur!	Moi, vous haïr, Seigneur!
quelle injuſtice extrême!	quelle injustice extrême!
Et ma bouche & mes yeux ont avoüé que j’aime.	Et ma bouche et mes yeux ont avoué que j'aime.
Mon cœur ſuit mon devoir.	Mon cœur suit mon devoir.
Tous mes ſoins, tous mes vœux N’aſpirent qu’à vous plaire & qu’à vous rendre heureux.	Tous mes soins, tous mes vœux N'aspirent qu'à vous plaire et qu'à vous rendre heureux.
Mais dans noſtre bon-heur je ne ſçay quelle crainte M’allarme malgré moi;	Mais dans notre bonheur je ne sais quelle crainte M'alarme malgré moi;
tient ma joye en contrainte.	tient ma joie en contrainte.
N’a-t’on pas veu cent fois les Dieux mêmes jaloux Traverſer un bon-heur pour des Mortels trop doux.	N'a-t-on pas vu cent fois les Dieux mêmes jaloux Traverser un bonheur pour des Mortels trop doux.
Je plains même, je plains le deſtin de Medée, Et ce funeſte amour dont elle eſt poſſedée.	Je plains même, je plains le destin de Medée, Et ce funeste amour dont elle est possédée.
Daignent les juſtes Dieux ſoulageant ſa douleur, Ne pas faire ſur nous retomber ſon malheur.	Daignent les justes Dieux soulageant sa douleur, Ne pas faire sur nous retomber son malheur.
Helas!	Hélas!
ſi quelque jour leur fatale colere Empoiſonnoit le cours d’un deſtin ſi proſpere?	si quelque jour leur fatale colère Empoisonnait le cours d'un destin si prospère?
JASON.	JASON.
Ah!	Ah!
calmez ces frayeurs.	calmez ces frayeurs.
Les Dieux juſtes toûjours De vos proſperitez feront durer le cours.	Les Dieux justes toujours De vos prospérités feront durer le cours.
CRE’USE.	CRE'USE.
Mais quand des Dieux, Seigneur, je n’aurois rien à craindre, De vous n’auray-je pas quelque jour à me plaindre 2 Vous me repondez d’eux;	Mais quand des Dieux, Seigneur, je n'aurais rien à craindre, De vous n'aurai-je pas quelque jour à me plaindre 2 Vous me répondez d'eux;
repondez-moi de vous.	répondez-moi de vous.
He las!	He las!
ſi vous briſiez un jour des nœuds ſi doux, Et ſi vous m’immoliez à quelque ardeur nouvelle, Que deviendrois-je, O Ciel!	si vous brisiez un jour des nœuds si doux, Et si vous m'immoliez à quelque ardeur nouvelle, Que deviendrais-je, Ô Ciel!
dans ma douleur mortelle?	dans ma douleur mortelle?
JASON.	JASON.
Vous pleurez, ma Princeſſe, & vous pouvez penſer, Que jamais voſtre Amant puiſſe vous offenſer.	Vous pleurez, ma Princesse, et vous pouvez penser, Que jamais votre Amant puisse vous offenser.
Quel outrage crüel vous faites à ma ſlâme?	Quel outrage cruel vous faites à ma slâme?
Liſez-vous donc ſi mal dans mes yeux, dans mon ame?	Lisez-vous donc si mal dans mes yeux, dans mon âme?
Ah!	Ah!
rien ne peut jamais éreindre un feu ſi beau.	rien ne peut jamais éteindre un feu si beau.
On verra ſon ardeur durer juſqu’au tombeau.	On verra son ardeur durer jusqu'au tombeau.
Que n’en puis-je exprimer toute la violence!	Que n'en puis-je exprimer toute la violence!
Vos yeux ne ſont-ils pas garands de ma con ſtance?	Vos yeux ne sont-ils pas garant de ma con tance?
CRE'USE.	CRE'USE.
Hypſipile & Medée, objets de vos amours, Se ſont laiſſé ſurprendre à de pareils diſcours;	Hypsipile et Medée, objets de vos amours, Se sont laissé surprendre à de pareils discours;
Et de nouveaux objets voſtre ame poſſedée, A laiſſé cependant Hypſipile & Medée.	Et de nouveaux objets votre âme possédée, A laissé cependant Hypsipile et Medée.
JASON.	JASON.
Leur exemple inegal vous trouble ſans rai ſon, Madame;	Leur exemple inégal vous trouble sans rai son, Madame;
banniſſez un injuſte ſoupçon.	bannissez un injuste soupçon.
Hypſipile & Medée en prevenant mon ame, Avoient ſçeu m’engager à répondre à leur flâme.	Hypsipile et Medée en prévenant mon âme, Avaient su m'engager à répondre à leur flamme.
Touché de leurs bien-faits, ſenſible à leur amour, Mon cœur crut leur devoir quelques ſoins à ſon tour;	Touché de leurs bienfaits, sensible à leur amour, Mon cœur crut leur devoir quelques soins à son tour;
Et d’y répondre au moins ne pouvant me défendre, La crainte d’eſtre ingrat me força de me rendre.	Et d'y répondre au moins ne pouvant me défendre, La crainte d'être ingrat me força de me rendre.
Mais dés que je vous vis, un trouble imperieux, Aſſervit tout mon cœur au pouvoir de vos yeux.	Mais dès que je vous vis, un trouble impérieux, Asservit tout mon cœur au pouvoir de vos yeux.
D’une preſſante ardeur l’extrême violence, Surmonta ma raiſon, força ma reſiſtance;	D'une pressante ardeur l'extrême violence, Surmonta ma raison, força ma résistance;
Et je ſentis enfin que juſques à ce jour, Je n’avois pas connu le pouvoir de l’Amour.	Et je sentis enfin que jusques à ce jour, Je n'avais pas connu le pouvoir de l'Amour.
Un ſi parfait amour bravera la mort même.	Un si parfait amour bravera la mort même.
J’en atteſte des Dieux la puiſſance ſuprême.	J'en atteste des Dieux la puissance suprême.
Puiſſent ces Dieux vangeurs, ſi je trahis ma foi, Epuiſer leur courroux & leurs foudres ſur moi.	Puissent ces Dieux vengeurs, si je trahis ma foi, Épuiser leur courroux et leurs foudres sur moi.
Si voitre cœur m’aimoit, il prendroit ma deffenſe.	Si voitre cœur m'aimait, il prendrait ma défense.
Un veritable amour bannit la deffiance.	Un véritable amour bannit la défiance.
CRE’USE.	CRE'USE.
Un veritable amour eſt-il jamais ſans ſoins?	Un véritable amour est-il jamais sans soins?
Je ne craindrois pas tant, helas!	Je ne craindrais pas tant, hélas!
ſi j’aimois moins.	si j'aimais moins.
JASON.	JASON.
Si vous ſentez mes feux, ah!	Si vous sentez mes feux, ah!
ſentez donc ma joye;	sentez donc ma joie;
Et que dans vos tranfports voſtre amour ſe deploye.	Et que dans vos transports votre amour se déploie.
Si prez de rendre heureux voſtre fidelle Amant, Prenez part, s’il ſe peut, à ſon raviſſement.	Si près de rendre heureux votre fidèle Amant, Prenez part, s'il se peut, à son ravissement.
CREUSE.	CREUSE.
Vous le voulez, je cede & ma triſteſſe change.	Vous le voulez, je cède et ma tristesse change.
Je reſſens voſtre joye & pure & ſans méiange.	Je ressens votre joie et pure et sans méiange.
Oüi Jaſon, je me rens, & l’Amour eſt vainqueur.	Oui Jason, je me rends, et l'Amour est vainqueur.
Il comble tous mes vœux, m’aſſurant voſtre cœur.	Il comble tous mes vœux, m'assurant votre cœur.
Adieu.	Adieu.
Je vais au pied des Autels de ſa Mere, Implorer ardamment ſon ſecours tutelaire;	Je vais au pied des Autels de sa Mère, Implorer ardamment son secours tutélaire;
La preſſer d’augmenter nos fidelles ardeurs, Et de verſer ſur nous ſes plus douces faveurs.	La presser d'augmenter nos fidèles ardeurs, Et de verser sur nous ses plus douces faveurs.
SCENE II.	SCÈNE II.
JASON, IPHITE.	JASON, IPHITE.
IPHITE.	IPHITE.
Vec quel air charmant cette aimable PrinA ceſſe Répond à vos tranſports & ſent voſtre tendreſſe?	Vec quel air charmant cette aimable PrinA cesse Répond à vos transports et sent sent tendresse?
Tout flatte voſtre eſpoir;	Tout flatte votre espoir;
tout conſpire à vos vœux.	tout conspire à vos vœux.
Et vous ſemblez toucher au ſort le plus heureux.	Et vous semblez toucher au sort le plus heureux.
JASON.	JASON.
Que je ſerois heureux, je le confeſſe, Iphite, Si je pouvois calmer un trouble qui m’irrite;	Que je serais heureux, je le confesse, Iphite, Si je pouvais calmer un trouble qui m'irrite;
Et ſi goûtant en paix un ſi parfait bon-heur, J’étouffois à mon gré tout remord en mon cœur !	Et si goûtant en paix un si parfait bonheur, J'étouffais à mon gré tout remord en mon cœur !
Mais je ne puis bannir une importune idée.	Mais je ne puis bannir une importune idée.
A mes yeux malgré moi par tout s’offre Medée.	À mes yeux malgré moi par tout s'offre Medée.
Ce ſouvenir crüel m’afflige & me pourſuit.	Ce souvenir cruel m'afflige et me poursuit.
Juſqu’aux pieds de Créüſe il me trouble & me ſuit.	Jusqu'aux pieds de Créüse il me trouble et me suit.
Grands Dieux!	Grands Dieux!
quel ſort fatal, quelle loi trop ſevere Des plaiſirs les plus grands rend la douceur amere?	quel sort fatal, quelle lois trop sévère Des plaisirs les plus grands rend la douceur âme?
Quel noir poiſon ſe mêle au ſort le plus charmant ?	Quel noir poison se mêle au sort le plus charmant ?
Et ne ſçauroit-on eſtre heureux impuncment ?	Et ne saurait-on être heureux impuncment ?
Voſtre bonté jalouze avec caprice enchaîte Les biens & les tourmens, les plaiſirs & la peine.	Votre bonté jalouze avec caprice enchaîte Les biens et les tourments, les plaisirs et la peine.
Au faiſte du bon-heur on pouſſe des ſoupirs;	Au faîte du bonheur on pousse des soupirs;
Et l’amertume naiſt dans le ſein des plaiſirs.	Et l'amertume naît dans le sein des plaisirs.
Ah c’eſt trop.	Ah c'est trop.
De mon ſort ſoyons enfin le maître.	De mon sort soyons enfin le maître.
Déja je ſens le calme en mon ame renaître.	Déjà je sens le calme en mon âme renaître.
Déja.	Déjà.
je vois Medée!	je vois Medée!
ô dieux!	ô dieux!
trop juſtes Dieux !	trop justes Dieux !
Ne peut-on un moment ſe ſouſtraire à vos yeux?	Ne peut-on un moment se soustraire à vos yeux?
Quand je crois eſtre heureux, ſoudain voſtre juſtice Confond tous mes projets & m’offre mon ſupplice.	Quand je crois être heureux, soudain Rom justice Confond tous mes projets et m'offre mon supplice.
Que lui dire?	Que lui dire?
fuions.	fuyons.
SCENE III.	SCÈNE III.
JASON, MEDE’E, IPHITE, RHODOPE.	JASON, MEDE’E, IPHITE, RHODOPE.
MEDE’E.	MÈDE.
S Eigneur, où fuyez-vous ?	 Signeur, où fuyez-vous ?
Ie ne viens point brûlant d’un injuſte courroux.	Je ne viens point brûlant d'un injuste courroux.
Vous accabler ſans fruit de cris & de reproches.	Vous accabler sans fruit de cris et de reproches.
Ceſſez de redouter ma veuë & mes approches.	Cessez de redouter ma vue et mes approches.
Mes yeux s’ouvrent enfin;	Mes yeux s'ouvrent enfin;
je connois mon erreur.	je connais mon erreur.
L’amour & la raiſon ont vaincu ma fureur.	L'amour et la raison ont vaincu ma fureur.
Oüi je ſens que mon cœur dans ſes vives allarmes Vous excuſe, vous plaint, & vous preſte des armes.	Oui je sens que mon cœur dans ses vives alarmes Vous excuse, vous plaint, et vous prête des armes.
Je vois que le Deſtin vous force à me bannir.	Je vois que le Destin vous force à me bannir.
Que le Ciel romp les nœuds dont il ſceut nous unir;	Que le Ciel romp les nœuds dont il sut nous unir;
Et cedant ſans murmure au revers qui m’accable, Je n’impute qu’au Sort un coup inévitable.	Et cédant sans murmure au revers qui m'accable, Je n'impute qu'au Sort un coup inévitable.
Je viens donc reparer par un pront repentir Des fureurs où mon cœur ne pouvoit conſentir.	Je viens donc réparer par un pr repentir Des fureurs où mon cœur ne pouvait consentir.
Effacer mes tranſports, expier mes menaces, Par voſtte veuë encore adoucir mes diſgraces, Et condamnant l’éclat d’un mouvement jaloux, Pour la derniere fois pleurer auprés de vous.	Effacer mes transports, expier mes menaces, Par voste vue encore adoucir mes disgrâces, Et condamnant l'éclat d'un mouvement jaloux, Pour la dernière fois pleurer auprès de vous.
Oubliez mes tranſports, oubliez ma colere.	Oubliez mes transports, oubliés ma colère.
Pardonnez à l’amour un crime involontaire;	Pardonnez à l'amour un crime involontaire;
Di ne tous fou venant que d'unn tendre amour Recevez mes adieux en ce funeſte jour.	Dis ne tous fou venant que d'un tendre amour Recevez mes adieux en ce funeste jour.
JASON.	JASON.
C’en eſt trop.	C'en est trop.
Ah de grace, épargnez-moi, Madame.	Ah de grâce, épargnez-moi, Madame.
Aimez moins un Ingrat qui trahit voſtre ſſâme.	Aimez moins un Ingrat qui trahit votre ssame.
N’offrez point à ſes yeux cette tendre douleur.	N'offrez point à ses yeux cette tendre douleur.
C’eſt augmenter mon trouble & déchirer mon cœur.	C'est augmenter mon trouble et déchirer mon cœur.
C’eſt redoubler l’horreur du deſtin qui m’accable.	C'est redoubler l'horreur du destin qui m'accable.
Pour moi voſtre fureur eſtoit moins redoutable, Reprenez voſtre haine & vos tranſports jaloux.	Pour moi votre fureur était moins redoutable, Reprenez votre haine et vos transports jaloux.
Ah!	Ah!
je crains voſtre amour, plus que voſtre courroux.	Je crains votre amour, plus que votre courroux.
MEDE’E.	MÈDE.
Ah!	Ah!
laiſſez-moi l’amour dont je ſuis poſſedéeC’eſt lui ſeul qui m’anime;	laissez-moi l'amour dont je suis possedéeC’est lui seul qui m'anime;
& la triſte Medée Ne peut, tel eſt ſon ſort, ceſſer de vous cherir.	et la triste Medée Ne peut, tel est son sort, cesser de vous chérir.
Elle vous aimera juſqu’au dernier ſoupir.	Elle vous aimera jusqu'au dernier soupir.
Vivez;	Vivez;
regnez heureux.	régnez heureux.
Mais pour grace derniere Ne me refuſez pas une juſte priere.	Mais pour grâce dernière Ne me refusez pas une juste prière.
Souffrez que j’oſe encor vous preſſer en ce jour De m’accorder les fruits de noſtre tendte amour.	Souffrez que j'ose encor vous presser en ce jour De m'accorder les fruits de notre tendte amour.
Ils ſuffiront, Seigneur, pour conſoler leur Mere.	Ils suffiront, Seigneur, pour consoler leur Mère.
Je croiray, les voyant, revoir encor leur Pere, Et par ces doux objets mon amour affermi, Vous poſſedant en eux ne vous perd qu’à demi.	Je croirai, les voyant, revoir encor leur Père, Et par ces doux objets mon amour affermi, Vous possédant en eux ne vous perd qu'à demi.
Ce n’eſt pas pour long-temps que je vous les demande;	Ce n'est pas pour longtemps que je vous les demande;
Et je joüiray peu d’une faveur ſi grande.	Et je jouirai peu d'une faveur si grande,
Vous reverrez bien-toſt ces gages pretieux.	Vous reverrez bientôt ces gages prétieux.
Bien-toſt, au lieu de vous, m’ayant fermé les yeux, Ils reviendront, Seigneur, joüir de voſtre gloire, Et vous conter la fin de ma funeſte hiſtoire.	Bientôt, au lieu de vous, m'ayant fermé les yeux, Ils reviendront, Seigneur, jouir de votre gloire, Et vous conter la fin de ma funeste histoire.
JASON.	JASON.
Helas!	Hélas!
qu’exigez-vous?	qu'exigez-vous?
pourquoy me demander Le ſeul bien qu’à vos vœux je ne puis accorder.	pourquoi me demander Le seul bien qu'à vos vœux je ne puis accorder.
Demandez moi plûtoſt & mon ſang & ma vie, Que la Parque ſans eux m’auroit bien-toſt ravie.	Demandez -moi plutôt et mon sang et ma vie, Que la Parque sans eux m'aurait bientôt ravie.
Mais ne m’enlevez pas ces fruits de nos amours.	Mais ne m'enlevez pas ces fruits de nos amours.
MEDE’E.	MÈDE.
Hé bien!	Hé bien!
joüiſſez-en;	jouissez-en;
poſſedez les toûjours.	possédez les toujours.
Oüi, l’amour maternel ſe faiſant violence Cede enfin à vos vœux, & s’impoſe ſilence Conſervez cherement un ſi pretieux bien.	Oui, l'amour maternel se faisant violence Cède enfin à vos vœux, et s'impose silence Conservez chèrement un si prétieux bien.
Témoins de vos grandeurs, qu’ils en ſoient le ſoutien;	Témoins de vos grandeurs, qu'ils en soient le soutien;
Joüiſſez de leur veuë & goûtez leurs careſſes.	Jouissez de leur vue et goûtez leurs caresses.
Sans jalouſie entr’eux partagez vos tendreſſes.	Sans jalousie entr'eux partagez vos tendresses.
Faites leur un deſtin illuſtre & glorieux.	Faites leur un destin illustre et glorieux.
Rendez les s’il ſe peut dignes de leurs ayeux Enfin, qu’en les voyaut la tendreſſe de Pere Vous faſſe quelque-fois ſouvenir de leur Mere.	Rendez les s'il se peut dignes de leurs aïeux Enfin, qu'en les voyaut la tendresse de Père Vous fasse quelque-fois souvenir de leur Mère.
Et que pour adoucir les maux que je prevoi, Le bruit dans mon exil en vienne juſqu’a moi.	Et que pour adoucir les maux que je prévoi, Le bruit dans mon exil en vienne jusqu'a moi.
JASON.	JASON.
Qu’avec joye à vos vœux j’accorde cette grace!	Qu'avec joie à vos vœux j'accorde cette grâce!
Eſt-il rien que pour eux ma tendreſſe ne faſſe:	Est-il rien que pour eux ma tendresse ne fasse:
Les grandeurs, les plailirs vont les environner;	Les grandeurs, les plailirs vont les environner;
Et je ne me fais Roi, que pour les couronner.	Et je ne me fais Roi, que pour les couronner.
MEDE’E.	MÈDE.
Seigneur, je pars contente aprés cette aſſurance.	Seigneur, je pars contente après cette assurance.
Mais de Creon tantoſt j’ay bravé la clemence.	Mais de Creon tantôt j'ai bravé la clémence.
Je tremble avec raiſon que ſes reſſentimens Ne puniſſent mes Fils de mes emportemens;	Je tremble avec raison que ses ressentiments Ne punissent mes Fils de mes emportements;
Et que pour m’accabler, ſa trop juſte colere N eſe vange ſur eux du crime de leur Mere.	Et que pour m'accabler, sa trop juste colère NO ese venge sur eux du crime de leur Mère.
A Créüſe bien-toſt je vais les envoyer.	À Créüse bientôt je vais les envoyer.
Pour eux, au nom des Dieux, allez vous employer.	Pour eux, au nom des Dieux, allez vous employer.
Adouciſſez Creon, attendriſſez Créüſe.	Adoucissez Creon, attendrissez Créüse.
L’amour a fait mon crime, il fera mon excuſe:	L'amour a fait mon crime, il fera mon excuse:
C’eſt lui, c’eſt la douleur, qui m’a fait égarer, Et par un pront exil je vais tout reparer.	C'est lui, c'est la douleur, qui m'a fait égarer, Et par un pro exil je vais tout réparer.
JASON.	JASON.
Que vous connoiſſez mal Creon & ſa clemence!	Que vous connaissez mal Creon et sa clémence!
Un ſi pront repentir déſarmant ſa vengeance, Senſible à vos malheurs, ſes ſoins & ſes bienfaits Adouciront vos maux, combleront mes ſouhaits.	Un si pront repentir désarmant sa vengeance, Sensible à vos malheurs, ses soins et ses bienfaits Adouciront vos maux, combleront mes souhaits.
Je vais femplir vos vœux & camnerla colere.	Je vais femplir vos vœux et camnerla colère.
MEDE’E.	MÈDE.
Peignez luy bien, Seigneur, mon repentir ſincere.	Peignez lui bien, Seigneur, mon repentir sincère.
Je veur des ce lon iene abandomertes lieux.	Je veut des ce lon iene abandomertes lieux.
Pour la derniere fois recevez mes adieux.	Pour la dernière fois recevez mes adieux.
JASON.	JASON.
Puiſſe le juſte Ciel à mes vœux favorable Vous accorder, Madame, un repos deſirable.	Puisse le juste Ciel à mes vœux favorable Vous accorder, Madame, un repos désirable.
Jaſon à ſon deſtin cedant avec regret, Nourriſſant loin de vous un deplaiſir ſecret, Gardera cherement dans le fond de ſon ame, Le tendre ſouvenlr d’une ſi belle flâme.	Jason à son destin cédant avec regret, Nourrissant loin de vous un déplaisir secret, Gardera chèrement dans le fond de son âme, Le tendre souvenlir d'une si belle flamme.
L’abſence ny le temps n’effaceront jamais	L'absence ici le temps n'effaceront jamais
SCENE IV.	SCÈNE IV.
MEDE’E, RHODOPE,	MÈDE, RHODOPE,
MEDE’E IJ A, quand tu le voudrois, il y va de ma gloire;	MÈDE -JJEAU, quand tu le voudrais, il y va de ma gloire;
Je t’empeſcheray bien d’en perdre la memoire.	Je t'empêcherai bien d'en perdre la mémoire.
Je ſçais quand il me plaiſt, dans l’ame des ingrats Graver des ſouvenirs qui ne s’effacent pas.	Je sais quand il me plaît, dans l'âme des ingrats Graver des souvenirs qui ne s'effacent pas.
Que j’ay ſouffert, Rhodope, à cacher ma colere?	Que j'ai souffert, Rhodope, à cacher ma colère?
Quelle horrible contrainte il a fallu me faire?	Quelle horrible contrainte il a fallu me faire?
Ma rage en eſt accrüe;	Ma rage en est accrue;
& ce torrent fougueux Va plus rapidement ſe deborder contr’eux.	et ce torrent fougueux Va plus rapidement se déborder contr'eux.
ai ne me feite plus que devoquer iſecate, Et tous ces Dieux crüels dont la futeur me flate.	ai ne me féite plus que dévoquer ecate, Et tous ces Dieux cruels dont la futeur me flatte.
Mes plus mortels poiſons, mes charmes ſont tous preſts Hâtons nous de lancer nos redoutables traits	Mes plus mortels poisons, mes charmes sont tous prêts Hâtons nous de lancer nos redoutables traits
Rhodope tu connois cetterobe éclattante De rubis lumineuſe & d’or étincellante;	Rhodope tu connais cetterobe éclattante De rubis lumineuse et d'or étincellante;
Parure ineſtimable, ornement pretieux Où l’art & la richeſſe ébloüiſſent les yeux.	Parure inestimable, ornement prétieux Où l'art et la richesse éblouissent les yeux.
Le Soleil mon Ayeul, favoriſant mon Pere, Pour preſent nuptial en fit don à ma Mere;	Le Soleil mon Ayeul, favorisant mon Père, Pour présent nuptial en fit donc à ma Mère;
Et ſemble avoir mêlé pour enrichir ſes dons Le feu de ſa lumiere à l’or de ſes rayons.	Et semble avoir mêlé pour enrichir ses dons Le feu de sa lumière à l'or de ses rayons.
2 C’eſt de tous les threſors, où je pouvois pretendre, L’unique qu’en fuyant Medée ait daigné prendre.	2 C'est de tous les trésors, où je pouvais prétendre, L'unique qu'en fuyant Medée ait daigné prendre.
Tu ſçais qu’en arrivant en ces funeſtes lieux, De Créüſe ébloüie elle enchanta les yeux.	Tu sais qu'en arrivant en ces funestes lieux, De Créüse ébloüie elle enchanta les yeux.
Admirant ſon éclat & vantant ſa richeſſe, Elle a tout employé, prieres, dons, promeſſe, Pour pouvoir poſſeder ce ſuperbe ornement.	Admirant son éclat et vantant sa richesse, Elle a tout employé, prières, dons, promesse, Pour pouvoir posséder ce superbe ornement.
Il faut qu’à ma vengeance il ſerve d’inſtrument.	Il faut qu'à ma vengeance il serve d'instrument.
Je vais l’empoiſonner, & par mon art funeſte Mêler un pront veniu à ſon éclat celeſte;	Je vais l'empoisonner, et par mon art funeste Mêler un pront veniv à son éclat céleste;
Mille ſucs empeſtez, milles charmes divers;	Mille sucs empestez, milles charmes divers;
Et la Rage, & la Mort, & l’horreur des Enfers.	Et la Rage, et la Mort, et l'horreur des Enfers.
Je veux que mes Enfans, pour cacher ma vengeance, Et feignant d’implorer ſes ſoins & ſa clemence, Miniſtres non ſuſpects de mon courroux affreux, Portent à leur Marâtre un don ſi dangereux.	Je veux que mes Enfants, pour cacher ma vengeance, Et feignant d'implorer ses soins et sa clémence, Ministres non suspects de mon courroux affreux, Portent à leur Marâtre un don si dangereux.
Mais allons engager mes.	Mais allons engager mes.
Dieux dans ma querelle.	Dieux dans ma querelle.
J’entens déja leur voix qui m’anime & m’appelle.	J'entends déjà leur voix qui m'anime et m'appelle.
Terribles Dieux du Stix, je marche ſur vos pas.	Terribles Dieux du Stix, je marche sur vos pas.
Dans ce preſſant beſoin ne m’abandonnez pas.	Dans ce pressant besoin ne m'abandonnés pas.
Fin du troiſiéme Acte.	Fin du troisième Acte.
IV	IV
SCENE PREMIERE.	SCÈNE PREMIÈRE.
MEDE’E, RHODOPE.	MÈDE, RHODOPE.
2 MEDE’E.	2 MÈDE.
L eſt temps d’achever le charme & ma vengeance.	L est temps d'achever le charme et ma vengeance.
Hecate, vien pour moi ſignaler ta puiſſance.	Hecate, viens pour moi signaler ta puissance.
Hecate, triple Hecate, exauce enfin mes vœux.	Hecate, triple Hecate, exauce enfin mes vœux.
Vien;	Viens;
je vais conſommer mes myſteres affreux.	je vais consommer mes mystères affreux.
J’ay mis monart en œuvre;	J'ai mis monart en œuvre;
& ma robe empeſtée ii bu les ſucs mortels dont elle eſt infectée.	et ma robe empestée ji bu les sucs mortels dont elle est infectée.
Aux poiſons j’ay mêlé mes charmes les plus forts.	Aux poisons j'ai mêlé mes charmes les plus forts.
Mais que pourroient ſans toi mes impuiſſans efforts?	Mais que pourraient sans toi mes impuissants efforts?
Grande Divinité, tu rens mon art terrible.	Grande Divinité, tu rends mon art terrible.
Irrite les poiſons & la flâme inviſible, Que j’ay ſceu confier à ce don pretieux.	Irrite les poisons et la flamme invisible, Que j'ai su confier à ce don prétieux.
Sur tout cache la bien aux regards curieux;	Sur tout cache la bien aux regards curieux;
Et qu’au gré de mes veux impuiſſante oufatale, Elle devore ſeuls Creon & ma Rivale.	Et qu'au gré de mes veux impuissante oufatale, Elle dévore seuls Creon et ma Rivale.
Qu’elle épargne tout autre & ne conſume qu’eux.	Qu'elle épargne tout autre et ne consume qu'eux.
Hecate entens ma voix, & viens remplir mes vœux.	Hecate entends ma voix, et viens remplir mes vœux.
Elle vient.	Elle vient.
Je la ſens qui m’éehauffe & m’entraîne.	Je la sens qui m'éehauffe et m'entraîne.
Tout mon cœur en fremit & je reſpire à peine.	Tout mon cœur en frémit et je respire à peine.
Une ſoudaine horreur fait dreſſer mes cheveux.	Une soudaine horreur fait dresser mes cheveux.
Mes yeux percent la nuit du ſejour tenebreux.	Mes yeux percent la nuit du séjour ténébreux.
Je vais me faire oüir dans l’Empire des Manes, Je vais les evoquer.	Je vais me faire ouïr dans l'Empire des Manes, Je vais les Évoquer.
Loin d’icy, loin Prophancs	Loin d'ici, loin Prophancs
MEDE’E ſeule.	MÈDE seule.
SCENE II.	SCÈNE II.
Iniſtres rigoureux de mon courroux fatal, M Redoutables Tyrans de l’Empire infernal, Dieux, ô terribles Dieux du trepas & des Ombres, Et vous, Peuple cruel de ces royaumes ſombres, Noirs Enfans de la Nuit, Manes infortunez, Criminels ſans relâche à ſouffrir condamnez, Barbare Tiſiphone, implacable Megere, Nuit, Diſcorde, Fureur, Parques, Monſtres, Cerbere, Reconnoiſſez ma voix & ſervez mon courroux.	Inistres rigoureux de mon courroux fatal, M Redoutables Tyrans de l'Empire infernal, Dieux, ô terribles Dieux du trépas et des Ombres, Et vous, Peuple cruel de ces royaumes sombres, Noirs Enfants de la Nuit, Manes infortunés, Criminels sans relèche à souffrir condamnés, Barbare Tisiphone, implacable Mégère, Nuit, Discorde, Fureur, Parques, Monstres, Cerbère, Reconnoissez ma voix et servez mon courroux.
Dieux crüels, Dieux vangeurs, je vous évoque tous.	Dieux cruels, Dieux vengeurs, je vous évoque tous.
Venez ſemer icy l’horreur & les allarmes.	Venez semer ici l'horreur et les alarmes.
Venez remplir ces lieux & de ſang & de larmes.	Venez remplir ces lieux et de sang et de larmes.
Raſſemblez, déchaînez tous vos tourmens divers;	Rassemblez, déchaînez tous vos tourments divers;
Et, s’il ſe peut, icy tranſportez les Enfers.	Et, s'il se peut, ici transportez les Enfers.
On m’éxauce.	On m'eauxauce.
Le Ciel ſe couvre de tenebres.	Le Ciel se couvre de ténèbres.
L’air au loin retentit de hurlemens funebres.	L'air au loin retentit de hurlements funèbres.
Tout redouble en ces lieux le ſilence & l’horreur.	Tout redouble en ces lieux le silence et l'horreur.
Tout répand dans mon ame une affreuſe terreur.	Tout répand dans mon âme une affreuse terreur.
Ce Palais va tomber.	Ce Palais va tomber.
La terre mugit, s’ouvte;	La terre mugit, s'ouvte;
Son ſein vomit des feux & l’Enfer ſe découvre.	Son sein vomit des feux et l'Enfer se découvre.
Quel eſt ce Criminel qui cherche à ſe cacher?	Quel est ce Criminel qui cherche à se cacher?
Je reconnois Siſyphe à ce fatal rocher.	Je reconnais Sisyphe à ce fatal rocher.
Témoin des maux crüels qu’on prepare à ſa race, Il ſe cache de honte & pleure ſa diſgrace.	Témoin des maux cruels qu'on prépare à sa race, Il se cache de honte et pleure sa disgrâce.
Son deſeſpoir commence à ſoulager le mien.	Son désespoir commence à soulager le mien.
Le crime de ta race eſt plus noir que le tien, Audacieux Siſyphe, & le Roi du Tartare Ne ſçauroit vous trouver de peine aſſez barbare.	Le crime de ta race est plus noir que le tien, Audacieux Sisyphe, et le Roi du Tartare Ne saurait vous trouver de peine assez barbare.
Mais quels Fant ô mes vains ſortent de toutes parts Que de Spectres affreux s’offrent à mes regards?	Mais quels Fant ô mes vains sortent de toutes parts Que de Spectres affreux s'offrent à mes regards?
Quelle Ombre vient à moi.	Quelle Ombre vient à moi.
Que vois-je?	Que vois-je?
c’eſt mon Pere !	c'est mon Père !
Quel coup a pû ſi-toſt lui ravir la lumiere?	Quel coup a pu sitôt lui ravir la lumière?
Chere Ombre, apprens le moi.	Chère Ombre, apprends le moi.
Ma fuitte & ma fureur Helas!	Ma fuite et ma fureur Hélas!
t’ont fait ſans doute expirer de douleur.	t'ont fait sans doute expirer de douleur.
Tens moi les bras du moins.	Tends moi les bras du moins.
Mais quelle Ombre ſanglante Se jette entre nous deux terrible & menaçante?	Mais quelle Ombre sanglante Se jette entre nous deux terrible et menaçante?
De bleſſures, de ſang, couvert, defiguré, Ce Spectre furieux paroît tout déchiré.	De blessures, de sang, couvert, défiguré, Ce Spectre furieux paraît tout déchiré.
C’eſt mon Frere.	C'est mon Frère.
Oüi c’eſt lui;	Oui c'est lui;
je le connois à peine.	je le connais à peine.
Ah!	Ah!
pardonne, chere Ombre, à ma rage inhumaine, Pardonne.	pardonne, chère Ombre, à ma rage inhumaine, Pardonne.
L’Amour ſeul a cauſé ma fureur.	L'Amour seul a causé ma fureur.
Il fût ton aſſaſſin;	Il fût ton assassin;
il ſera ton vangeur;	il sera ton vengeur;
Et ſçaura t’immoler de ſi grandes victimes Qu’il obtiendra de toi le pardon de ſes crimes.	Et sçaura t'immoler de si grandes victimes Qu'il obtiendra de toi le pardon de ses crimes.
Le ſang.	Le sang.
tout diſparoît;	tout disparaît;
tout fuit devant mes yeux.	tout fuit devant mes yeux.
Tiſiphone avec moi reſte ſeule en ces lieux.	Tisiphone avec moi reste seule en ces lieux.
Noire Fille du Stix, Furie impitoyable, Ah!	Noire Fille du Stix, Furie impitoyable, Ah!
ceſſe d’attiſer mon courroux effroyable, Calme de tes ſerpens les affreux ſifflemens.	cesse d'attiser mon courroux effroyable, Calme de tes serpens les affreux siffléments.
Tu ne peux adjoûter à mes reſſentimens.	Tu ne peux ajouter à mes ressentiments.
Ne ſonge qu’à ſervir une fureur ſi grande.	Ne songe qu'à servir une fureur si grande.
Hecate le deſire, & je te le commande.	Hecate le désire, et je te le commande.
Nuit, Stix, Hecate, Enfers, terribles Deitez, ’ordonne.	Nuit, Stix, Hecate, Enfers, terribles Ditez, ôordonne.
Obeyſſez ſourdes Divinitez.	Obeissez sourdes Divinités.
Le charme a réüſſi Pourſuivons ma vengeante.	Le charme a réussi Poursuivons ma vengeante.
SCENE III.	SCÈNE III.
MEDE’E, RHODOPE.	MÈDE, RHODOPE.
MEDE’E.	MÈDE.
7 Ien, Rhodope;	7 Ien, Rhodope;
mon art ne craint plus ta preſence.	mon art ne craint plus ta présence.
Le charme eſt conſommé.	Le charme est consommé.
C’en eſt fait & jamais Un eſpoir plus certain ne flatta mes ſouhaits.	C'en est fait et jamais Un espoir plus certain ne flatta mes souhaits.
Apporte prontement ma Robbe pretieuſe.	Apporte prontement ma Robe prétieuse.
Pour mes Ennemis ſeuls elle eſt contagieuſe.	Pour mes Ennemis seuls elle est contagieuse.
Ne crains pas de toucher ce don pernitieux.	Ne crains pas de toucher ce don pernitieux.
Puis cherche mes Enfans;	Puis cherche mes Enfants;
conduis les en ces lieux.	conduis les en ces lieux.
Je veux les preparer à ſervir ma vengeance Et feignant d’obeit au Tyran qui m’offence Leur cacher mes deſſeins, afin qu’ils trompent mieux De leurs maux & des miens les Auteuts odieux	Je veux les préparer à servir ma vengeance Et feignant d'obéit au Tyran qui m'offense Leur cacher mes desseins, afin qu'ils trompent mieux De leurs maux et des miens les Auteuts odieux
SCENE IV MEDE’E, ſeule.	SCÈNE IV MÈDE, seule.
Nfin de mes Tyrans je vais punir les crimes.	Nfin de mes Tyrans je vais punir les crimes.
L Il ne me reſte plus qu’à parer mes victimes.	 Il ne me reste plus qu'à parer mes victimes.
Le ſacrifiee eſt preſt.	Le sacrifie est prêt.
L’heure approche;	L'heure approche;
& mon cœur Triomphe & s’applaudit déja de ſon bon-heur * Rhodo-* Cours chercher mes Enfans.	et mon cœur Triomphe et s'applaudit déjà de son bonheur * Rhodo-* Cours chercher mes Enfants.
O ſuperbe parure, la Robbe Preſent qui vas ſervir à vanger mon injure, de Medée Cache bien les treſors que mon art t’a çommis.	Ô superbe parure, la Robe Present qui vas servir à venger mon injure, de Medée Cache bien les trésors que mon art t'a çommis.
& ſort, Mes plus chers intereſts à toi ſeul ſont remis.	et sort, Mes plus chers intérêts à toi seul sont remis.
pour ame-Que j’ayme en ce moment l’éclat qui t’environne fans.	pour âme-Que j'aime en ce moment l'éclat qui t'environne sans.
Ah!	Ah!
ſeul tu me tiens lieu d’Empire & de couronne.	seul tu me tiens lieu d'Empire et de couronne.
SCENE V.	SCÈNE V.
MEDEE, SLS ENTANS RHODOPE.	MÈDE, SLS ENTANS RHODOPE.
A MEDE’E.	À MÊDE.
Pprochez, approchez, jeunes Infortunez;	Prochez, approchez, jeunes Infortunez;
Qu’au maux preſqu’en naiſſant le Ciel a condamnez.	Qu'au maux presqu'en naissant le Ciel a condamnés.
On va nous ſeparer par une loi ſevere.	On va nous séparer par une lois sévère.
C’en eſt fait, mes Enfans;	C'en est fait, mes Enfants;
vous n’avez plus de Mere.	vous n'avez plus de Mère.
Je ne joüiray plus de vos tranſports charmans.	Je ne jouirai plus de vos transports charmants.
Le Sort crüel m’arrache à vos embraſſemens.	Le Sort crois m'arrache à vos embrassements.
Voſtre veuë eſt un bien que ſa rigueur m’envie.	Votre vue est un bien que sa rigueur m'envie.
Vous n’adoucirez point les malheurs de ma vie;	Vous n'adoucirez point les malheurs de ma vie;
Et mes yeux, loin de vous, aux pleurs accoûtumez, Par vos mains en mourant ne ſeront point fermez.	Et mes yeux, loin de vous, aux pleurs accoutumés, Par vos mains en mourant ne seront point fermés.
Il vous eſt interdit d’accompagner ma fuitte.	Il vous est interdit d'accompagner ma fuite.
Sous un joug eſtranger le Ciel vous precipite;	Sous un joug étranger le Ciel vous précipite;
Et vous aſſerviſſant à de crüelles loix, Il vous donne des fers dont je ſens tout le poids.	Et vous asservissant à de crois lois, Il vous donne des fers dont je sens tout le poids.
Soumettons nous, mes Fils;	Soumettons -nous, mes Fils;
cedons à la Fortune.	cédons à la Fortune.
Quittez cette fierté prés des Rois importune.	Quittez cette fierté près des Rois importune.
Voſtre ſort a changé;	Votre sort a changé;
changez auſſi de vœux:	changez aussi de vœux:
L’abbaiſſement, mes Fils couvient aux malheureux.	L'abaissement, mes Fils couvient aux malheureux.
Oubliez voſtre ſang;	Oubliez votre sang;
oubliez vos Anceſtres:	oubliez vos Ancêtres:
Eſclaves, apprenez à menager vos Maiſtres;	Esclaves, apprenez à ménager vos Maîtres;
Et leur immolant tout, ainſi qu’a vos vrais Dieux, Eſſayez à trouver grace devant leurs yeux.	Et leur immolant tout, ainsi qu'a vos vrais Dieux, Essayez à trouver grâce devant leurs yeux.
Portez, pour commencer, ma robbe à la Princeſſe.	Portez, pour commencer, ma robe à la Princesse.
Offrez la de ma part;	Offrez la de ma part;
peignez lui ma triſteſſe;	peignez -lui ma tristesse;
Qu’un juſte repentir ſurmonte ma fureur;	Qu'un juste repentir surmonte ma fureur;
Que j’implore pour vous ſes bontez, ſa faveur.	Que j'implore pour vous ses bontés, sa faveur.
Allez;	Allez;
de vos deſtins à preſent Souveraine, Mes Fils, c’eſt voſtre Mere, & de plus voſtre Reine.	de vos destins à présent Souveraine, Mes Fils, c'est votre Mère, et de plus votre Reine.
Sans rougir, à ſes pieds d’abord proſternez vous.	Sans rougir, à ses pieds d'abord prosternez -vous.
Baiſez avec reſpect ſa robbe & ſes genoux;	Baisez avec respect sa robe et ses genoux;
Et par vos ſoins flatteurs, par vos tendres careſſes, Appuiez vivement la foi de mes promeſſes.	Et par vos soins flatteurs, par vos tendres caresses, Apuiez vivement la foi de mes promesses.
Qui vous peut retenir?	Qui vous peut retenir?
Mes Fils, vous ſoupirez;	Mes Fils, vous soupirez;
Et vous n’oſez lever vos yeux mal aſſurez.	Et vous n'osez lever vos yeux mal assurez.
Je le vois.	Je le vois.
Voſtre ſang repugne à ces foibleſſes.	Votre sang répugne à ces faiblesses.
Mais c’eſt l’arreſt du Sort.	Mais c'est l'arrêt du Sort.
Vous pouvez ſans rougir,	Vous pouvez sans rougir,
dope.	dope.
Imirer mon exemple, à mes loix obéïr.	Imirer mon exemple, à mes lois obéir.
Tu pourras au beſoin leur ſervir d’interprete, * Rhodope;	Tu pourras au besoin leur servir d'interprète, * Rhodope;
conduis-les, fais ce que je ſouhaitte;	conduis-les, fais ce que je souhaite;
x a RhoEt reviens avec eux m’informer prontement Comme on aura receu ce fatal veſtement.	X a Rhoût reviens avec eux m'informer prontement Comme on aura reçu ce fatal vêtement.
SCENE VI.	SCÈNE VI.
MEDE’E, ſeule.	MÈDE, seule.
r  Out ſuccede à mes vœux & mon deſſein L s’avance.	Ô Rut succède à mes vœux et mon dessein L 'avance.
Ne m’abandonnez pas, rempliſſez ma vengeance, Dieux, redoutables Dieux, qu’avec ardeur je ſers;	Ne m'abandonnez pas, remplissez ma vengeance, Dieux, redoutables Dieux, qu'avec ardeur je sers;
Qui venez de moüir du plus creux des Enfers.	Qui venez de mouir du plus creux des Enfers.
Dans le piege fatal faittes tomber ma proye.	Dans le piège fatal faites tomber ma proie.
Aveuglez mes Tyrans ennivrez de leur joye.	Aveuglez mes Tyrans ennivés de leur joie.
Que Medée aſſervie à tant d’abaiſſement, N’ayt pas eſté reduitte à feindre impunement.	Que Medée asservie à tant d'abaissement, N'ait pas été réduite à feindre impunément.
Montrez qu’on vous offenſe au moment qu’on m’outrage.	Montrez qu'on vous offense au moment qu'on m'outrage.
Déja je crois vous voir remplir toute ma rage.	Déjà je crois vous voir remplir toute ma rage.
Déja je vois tomber & Créüſe & Creon.	Déjà je vois tomber et Créüse et Creon.
Mais comment nous vanger du perfide Jaſon?	Mais comment nous venger du perfide Jason?
Comment punir aſſez ſon crime deteſtable?	Comment punir assez son crime détestable?
De tous mes Ennemis il eſt le plus coupable.	De tous mes Ennemis il est le plus coupable.
Enfantons quelque monſtre;	Enfantons quelque monstre;
inven tons quelque horreur, Qui de tous mes forfaits ſurp aſſe la noirceur.	inven tons quelque horreur, Qui de tous mes forfaits surp asse la noirceur.
Dieux!	Dieux!
que m’inſpirez-vous?	que m'inspirez-vous?
quelle barbare image Quel horrible attentat offrez-vous à ma rage?	quelle barbare image Quel horrible attentat offrez-vous à ma rage?
Moi-même je fremis à cét objet affreux.	Moi-même je frémis à cet objet affreux.
Ce crime m’épouvante & ſurpaſſe mes vœux.	Ce crime m'épouvante et surpasse mes vœux.
SCENE VII.	SCÈNE VII.
MEDDE,S ENTANS RHODOPE.	MÈDE,S ENTANS RHODOPE.
RHODOPE.	RHODOPE.
J Oſtre preſent, Madame, a charmé læ Princeſſe.	 Jotre présent, Madame, a charmé læ Princesse.
Ne pouvant ſe laſſer d’en vanter la richeſſe, Dés ce ſoir ſans ſoupçon elle veut s’en parer.	Ne pouvant se lasser d'en vanter la richesse, Dès ce soir sans soupçon elle veut s'en parer.
Creon même, Creon s’empreſſe à l’admirer.	Creon même, Creon s'empresse à l'admirer.
Jaſon & vos preſens les aſſurent, Madame, Que la raiſon éteint la colere en voſtre ame;	Jason et vos présents les assurent, Madame, Que la raison éteint la colère en votre âme;
Que pour vous, pour vos Fils, vous faiſant un effort, Vous cedez par devoir à la rigueur du Sort.	Que pour vous, pour vos Fils, vous faisant un effort, Vous cédez par devoir à la rigueur du Sort.
Enfin tous deux comblant vos Enfans de careſſes, Ont temoigné pour eux les dernieres tendreſſes.	Enfin tous deux comblant vos Enfants de caresses, Ont témoigné pour eux les dernières tendresses.
Que vois-je!	Que vois-je!
vous pleurez.	vous pleurez.
Si prés de vous vanQuel trouble vous ſaiſit & vient vous afſiger?	Si près de vous vanQuel trouble vous saisit et vient vous afsiger?
Helas!	Hélas!
MEDEE.	MÈDE.
RHODOPE.	RHODOPE.
Vous gemiſſez;	Vous gémissez;
d’où naiſſent ces allarmes?	d'où naissent ces alarmes?
Attachant ſur vos Fils vos yeux baignez de larmes, Vous fremiſſez, Madame;	Attachant sur vos Fils vos yeux baignés de larmes, Vous frémissez, Madame;
& changeant de couleur Vous détournez ſoudain la veuë avec horreur	et changeant de couleur Vous détournez soudain la vue avec horreur
MEDE’E.	MÈDE.
Quelque vive douceur qu’ayt pour moi la vengeance, Un trouble violent en ſecret la balance.	Quelque vive douceur qu'ait pour moi la vengeance, Un trouble violent en secret la balance.
Je pleure avec raiſon ces Enfans malheureux.	Je pleure avec raison ces Enfants malheureux.
Quel crime les condamne, & qu’ont-ils fait aux Dieux ?	Quel crime les condamne, et qu'ont-ils fait aux Dieux ?
Dans un âge ſi tendre ils vont perdre leur Mere;	Dans un âge si tendre ils vont perdre leur Mère;
Et les Infortunez n’ont déja plus de Pere.	Et les Infortunés n'ont déjà plus de Père.
Eſclaves, Eſtrangers, ſans appui, ſans ſecours, Quelle ſuitte de maux va marquer tous leurs jours.	Esclaves, Étrangers, sans appui, sans secours, Quelle suitte de maux va marquer tous leurs jours.
C’eſt en vain que je vais leur ravir leur Marâtre, De quelque objet nouveau mon Perfide idolatre, Les remettra bien-toſt ſous un joug odieux, Et les.	C'est en vain que je vais leur ravir leur Marâtre, De quelque objet nouveau mon Perfide idolâtre, Les remettra bientôt sous un joug odieux, Et les.
accablera d’un poids injurieux.	accablera d'un poids injurieux.
Quel Aſtre empoiſonnant voſtre triſte naiſſance, Mes Fils, verſa ſur vous ſa crüelle influence?	Quel Astre empoisonnant votre triste naissance, Mes Fils, versa sur vous sa cruelle influence?
, Languiſſans ſous le joug, gemiſſans dans les fers,	, Languissants sous le joug, gémissants dans les fers,
Le Deſtin vous condamne à cent malheurs divers.	Le Destin vous condamne à cent malheurs divers.
Vous vous conſumerez dans un vil eſclavage, Eſſuyant chaque jour quelque nouvel outrage.	Vous vous consumerez dans un vil esclavage, Essuyant chaque jour quelque nouvel outrage.
Quel ſort.	Quel sort.
Ah cette idée irrite ma douleur, Et l’amour maternel redouble ma fureur!	Ah cette idée irrite ma douleur, Et l'amour maternel redouble ma fureur!
Pour les Fils du Soleil quel indigne partage!	Pour les Fils du Soleil quel indigne partage!
Quel coup.	Quel coup.
mon amour meurt & ſe transforme en rage;	mon amour meurt et se transforme en rage;
C’en eſt fait.	C'en est fait.
Innocens, vous me tendez les bras.	Innocents, vous me tendez les bras.
Ces regards careſſans, ce ſouris plein d’appas, Reveillant la nature, augmentant ma foibleſſe, Juſqu’au fond de mon cœur vont chercher la tendreſſe.	Ces regards caressants, ce souris plein d'appas, Reveillant la nature, augmentant ma faiblesse, Jusqu'au fond de mon cœur vont chercher la tendresse.
Helas.	Hélas.
en ſourianr, vous repandez des pleurs.	en sourianr, vous répandez des pleurs.
Infortunez!	Infortunez!
déja ſentez vous vos malheurs!	déjà sentez -vous vos malheurs!
Que voulez-vous de moi par ces douces careſſes ?	Que voulez-vous de moi par ces douces caresses ?
Il nous faut renoncer à toutes ces tendreſſes.	Il nous faut renoncer à toutes ces tendresses.
De voſtre trïſte Mere il faut vous détacher;	De votre traite Mère il faut vous détacher;
A de ſi doux plaiſirs il faut nous arracher.	À de si doux plaisirs il faut nous arracher.
Enl van j’avois lur vous fonde mon eſperance.	Enl van j'avais lur vous fonde mon espérance.
En vain je me flattois d’élever voſtre Enfance.	En vain je me flattais d'élever votre Enfance.
Il nous eſt interdit de nous voir deſormais;	Il nous est interdit de nous voir désormais;
O mes Fils!	Ô mes Fils!
il nous faut ſeparcr pour jamais.	il nous faut séparcr pour jamais.
RHODOPE.	RHODOPE.
Epuiſez vos tranſports, Madame.	Épuisez vos transports, Madame.
La Princeſſe Pour un temps aſſez court s’en prive & vous les laiſſe.	La Princesse Pour un temps assez court s'en prive et vous les laisse.
Elle leur a preſcrit de venir en ceslieux, Recevoir prontement vos pleurs & vos adieux.	Elle leur a prescrit de venir en ceslieux, Recevoir prontement vos pleurs et vos adieux.
MEDE’E.	MÈDE.
L’Orgueilleuſe déja leur commande, & m’outrage!	L'Orgueilleuse déjà leur commande, et m'outrage!
O ma lente douleur!	Ô ma lente douleur!
ô mon foible courage!	ô mon faible courage!
A quels affronts crüels, à quel ſort odieux Livres tu lâchement le plus beau ſang des Dieux!	À quels affronts cruels, à quel sort odieux Livres tu lâchement le plus beau sang des Dieux!
Ma fureur ſe reveille, & l’amour la ranime.	Ma fureur se reveille, et l'amour la ranime.
Ozons les affranchir du joug qui les opprime.	Ozons les affranchir du joug qui les opprime.
Couronnons ma vengeance & bornons leur malheur.	Couronnons ma vengeance et bornons leur malheur.
Que dis-tu Miſerable, & que veut ta fureur?	Que dis-tu Misérable, et que veut ta fureur?
Non, pour im ieurs maux, n'n eit pras d’autre voye.	Non, pour im eurs maux, n'n eit pras d'autre voie.
Un moment de touleur va me combler de joye, Frappons.	Un moment de touleur va me combler de joie, Frappons.
Tappons.	Tapons.
UN DES ENFANS.	UN DES ENFANS.
Ah!	Ah!
Dieux.	Dieux.
MaMere!	MaMère!
qu’avez-vous?	qu'avez-vous?
L'AUTRE ENIANT.	L'AUTRE ENIANT.
Pourquoi nous menacer, & d’où vient ce courroux?	Pourquoi nous menacer, et d'où vient ce courroux?
Je tremble.	Je tremble.
MEDE'E.	MÈDE.
Je fremis.	Je frémis.
Leurs regards & leurs larmes Me troublent, & des mains me font tomber les armes.	Leurs regards et leurs larmes Me troublent, et des mains me font tomber les armes.
O mon ſang!	Ô mon sang!
ô mes Fils, ſi chers à mes deſirs !	ô mes Fils, si chers à mes désirs !
Objets de ma tendreſſe & de mes deplaiſirs, Infortunez auteurs de ma douleur amere, Approchez mes Enfans;	Objets de ma tendresse et de mes déplaisirs, Infortunés auteurs de ma douleur âme, Approchez mes Enfants;
embraſſez voſtre Mere.	embrassez votre Mère.
Emprenenatouo encor d'obeit ames roix;	Emprenatouo encor d'obéit âmes roix;
Et baiſez moi du moins pour la derniere fois.	Et baisez moi du moins pour la dernière fois.
Rhodope, conduis les dans la chambre prochaine.	Rhodope, conduis les dans la chambre prochaine.
Leur veuë accroît mon trouble & redouble ma peine.	Leur vue accroît mon trouble et redouble ma peine.
Qu’ils me coûtent de pleurs!	Qu'ils me coûtent de pleurs!
qu’ils me ſont' chers!	qu'ils me sont chers!
helas!	hélas!
Mon faene aſnour, mles pleurs ne les ſoulagent pas.	Mon faène ânour, mles pleurs ne les soulagent pas.
SCENE VIII.	SCÈNE VIII.
MEDE’E, ſeule.	MÈDE, seule.
TTU les aimes, Cruelle, & tu les laiſſes viP vre Aux malheurs les plus grands ta foibleſſe les livre;	TTU les aimes, Cruelle, et tu les laisses viP vre Aux malheurs les plus grands ta faiblesse les livre;
Et ta pitié barbare en reſpectant leurs jours, Du plus affreux deſtin leur prepare le cours.	Et ta pitié barbare en respectant leurs jours, Du plus affreux destin leur prépare le cours.
Ah !	Ah !
lache!	lèche!
ſuis tu donc un foible amour pout guide?	suis -tu donc un faible amour pout guide?
Sauve les;	Sauve les;
tu fais bien.	tu fais bien.
Leur Pere moins timide Pour vanger tes Tyrans leur percera le flanc.	Leur Père moins timide Pour venger tes Tyrans leur percera le flanc.
Quoi!	Quoi!
leur Pere à Créüſe immoleroit mon ſang!	leur Père à Créüse immolerait mon sang!
Non, mes Enfans jamais ne ſeront ſa victime:	Non, mes Enfants jamais ne seront sa victime:
Ils mourront de ma main.	Ils mourront de ma main.
Tout me force à ce crime.	Tout me force à ce crime.
Qu’ils meurent ces Enfans d’un infidelle Epoux:	Qu'ils meurent ces Enfants d'un infidèle Époux:
Adoptez par Créüſe, ils ne ſont plus à nous.	Adoptez par Créüse, ils ne sont plus à nous.
Ah!	Ah!
s’ils ſont innocens, auſſi l’eſtoit mon Frere!	s'ils sont innocents, aussi l'était mon Frère!
I'immolerois mes Fils!	J'immolerais mes Fils!
ô trop barbare Mere!	ô trop barbare Mère!
Ah!	Ah!
plûtoſt.	plutôt.
l’heure approche;	l'heure approche;
un exil rigoureux, Un divorce crüel va me ſeparer d’eux.	un exil rigoureux, Un divorce cruel va me séparer d'eux.
Ils n’adouciront point ma fuitte & mes allarmes.	Ils n'adouciront point ma fuite et mes alarmes.
S’attachant à leur Mere, & tout baignez de larmes, De mes bras, de mon ſein, on va les déta cher:	S'attachant à leur Mère, et tout baignez de larmes, De mes bras, de mon sein, on va les déta cher:
A l’amour maternel on va les arracher.	À l'amour maternel on va les arracher.
Non, ne l’endurons pas.	Non, ne l'endurons pas.
Qu’ils meurent pour leur Pere;	Qu'ils meurent pour leur Père;
Qu’ils meurent.	Qu'ils meurent.
Auſſi-bien ils ſont morts pour leur Mere.	Aussi-bien ils sont morts pour leur Mère.
O Jaſon!	Ô Jason!
ô mes Fils!	ô mes Fils!
Amour, Haine, Fureur, Ceſſez par vos combats de déchirer mon cœur!	Amour, Haine, Fureur, Cessez par vos combats de déchirer mon cœur!
Pour le percer ce cœur, trop de rigueur s’aſſemble.	Pour le percer ce cœur, trop de rigueur s'assemble.
Le Temps fuit;	Le Temps fuit;
le mal preſſe.	le mal presse.
Accordez-vous enſemble.	Accordez-vous ensemble.
Fin du quatriéme Acte.	Fin du quatrième Acte.
ACTE	ACTE
SCENE PREMIERE.	SCÈNE PREMIÈRE.
MEDE’E, RHODOPE.	MÈDE, RHODOPE.
RHODOPE.	RHODOPE.
H!	H!
Madame, fuyez un Peuple furieux.	Madame, fuyez un Peuple furieux.
Fuyez, ſans differer, de ces funeſtes lieux, Meriα Tandis qu’avec le trouble y regne l’épouvante.	Fuyez, sans différer, de ces funestes lieux, Méri Tandis qu'avec le trouble y règne l'épouvante.
Voſtre preſent fatal a paſſé voſtre attente;	Votre présent fatal a passé votre attente;
Et vos fiers Ennemis mourans, deſeſperez.	Et vos fiers Ennemis mourants, désespérez.
Succombent au poiſon dont ils ſont devorez.	Succombent au poison dont ils sont dévorés.
A peine, à peine encor voſtre aveugle Rivale Portoit avec plaiſir cette Robbe fatale, Qu’un feu ſombre & crüel, une inviſible ardeur Embraze tout ſon corps, & conſume ſon cœur.	À peine, à peine encor votre aveugle Rivale Portait avec plaisir cette Robe fatale, Qu'un feu sombre et cruel, une invisible ardeur Embrase tout son corps, et consume son cœur.
Un funeſte poiſon courant de veine en veine, Allume dans ſon ſang une flâme inhumaine, Qui penetre avec force & s’attache à ſes os.	Un funeste poison courant de veine en veine, Allume dans son sang une flamme inhumaine, Qui penetre avec force et s'attache à ses os.
C’eſt en vain qu’on s’empreſſe à ſoulager ſes maux.	C'est en vain qu'on s'empresse à soulager ses maux.
La Robbe devorante à ſon corps attachêe, Y nourrit le venin de ſa flame cachée;	La Robe dévorante à son corps attachène, Y nourrit le venin de sa flamme cachée;
Et du charme crüel l’impitoyable ardeur Triomphe ſans obſtacle & regne avec fureur.	Et du charme cruel l'impitoyable ardeur Triomphe sans obstacle et règne avec fureur.
Qui veut la ſecourir, de ſa perte complice, Loin de la ſoulager, redouble ſon ſupplice.	Qui veut la secourir, de sa perte complice, Loin de la soulager, redouble son supplice.
On ne peut de ce feu calmer l’embrazement.	On ne peut de ce feu calmer l'embrasement.
On ne peut arracher le fatal vêtement.	On ne peut arracher le fatal vêtement.
Creon ſaiſi d’horreur à l’arracher s’empreſſe.	Creon saisi d'horreur à l'arracher s'empresse.
Mais du charme auſfi-toſt la flâme vangereſſe, Dans ſon ſein embrazé porte les mêmes feux:	Mais du charme aussi-tôt la flamme vengeresse, Dans son sein embrasé porte les mêmes feux:
Il ſe ſent conſumer d’un poiſon rigoureux.	Il se sent consumer d'un poison rigoureux.
Chacun s’occupe encor du peril qui les preſſe.	Chacun s'occupe encor du péril qui les presse.
Servez-vous des momens que ce trouble vous laiſſe.	Servez-vous des moments que ce trouble vous laisse.
Profittez de l’horreur qui regne dans ces lieux.	Profittez de l'horreur qui règne dans ces lieux.
Et fuyez pour jamais leur aſpect odieux.	Et fuyez pour jamais leur aspect odieux.
MEDE’E.	MÈDE.
Que je fuye!	Que je fuie!
ah!	ah!
Rhodope, au comble de la gloire, Quand ſur mes Ennemis j’emporte la victoire, Que je fuye!	Rhodope, au comble de la gloire, Quand sur mes Ennemis j'emporte la victoire, Que je fuie!
ah!	ah!
le Sort m’eût-il reduitte à fuir, D’un ſpectacle ſi beau je reviendrois joüir;	le Sort m'eût-il réduite à fuir, D'un spectacle si beau je reviendrais jouir;
Je viendrois aſſiſter à ce grand Hymenée.	Je viendrais assister à ce grand Hyménée.
Laiſſe moi contempler ſa pompe fortunée;	Laisse -moi contempler sa pompe fortunée;
Et d’un objet ſi doux, d’un coup ſi glorieux,	Et d'un objet si doux, d'un coup si glorieux,
Repaiſtre avidement mes regards curieux Mes odieux Tyrans deviennent mes victimes!	Repaistre avidement mes regards curieux Mes odieux Tyrans deviennent mes victimes!
Ah!	Ah!
je cueille en ce jour le fruit de tous mes crimes.	je cueille en ce jour le fruit de tous mes crimes.
Mon courroux triomphant ne peut trop s’applaudir;	Mon courroux triomphant ne peut trop s'applaudir;
Et mon nom deſormais ne ſçauroit plus perir.	Et mon nom désormais ne saurait plus périr.
Ce n’eſt pas tout.	Ce n'est pas tout.
Rentrons;	Rentrons;
& perdant l’Innocence, Couronnons ce grand jour & comblons ma vengeance.	et perdant l'Innocence, Couronnons ce grand jour et comblons ma vengeance.
SCENE II JASON, en entrant.	SCÈNE II JASON, en entrant.
N vain, pour la trouver, je cours de toutes parts.	N , vain, pour la trouver, je cours de toutes parts.
Ah!	Ah!
ſans doute ſon art la cache à mes regards.	sans doute son art la cache à mes regards.
Elle croit éviter le courroux qui m’enflâme.	Elle croit éviter le courroux qui m'enflamme.
Mais qui l’en peut ſauver?	Mais qui l'en peut sauver?
SCENE III.	SCÈNE III.
JASON, CRE'USE, CYDIPE.	JASON, CRE'USE, CYDIPE.
CRE’USE.	CRE'USE.
AH!	AH!
Seigneur!	Seigneur!
JASON.	JASON.
Ah !	Ah !
Madame:	Madame:
Quel eſt mon deſeſpoir!	Quel est mon désespoir!
où portez vous vos pas?	où portez -vous vos pas?
CRE'USE.	CRE'USE.
Ah!	Ah!
Seigneur, le Roi vient de mourir dans mes bras.	Seigneur, le Roi vient de mourir dans mes bras.
Ce dernier coup manquoit au tourment qui m’accable.	Ce dernier coup manquait au tourment qui m'accable.
Joüet infortuné du Sort impitoyable, Preſte enfin d’aſſouvir ſon rigoureux courroux, Je viens du moins,je viens mourir auprés de vous:	Jette infortuné du Sort impitoyable, Preste enfin d'assouvir son rigoureux courroux, Je viens du moins,je viens mourir auprès de vous:
MEDE’E, Vous fermerez mes yeux.	MÉDÉE, Vous fermerez mes yeux.
JASON.	JASON.
D'eux!	D'eux!
qu’entens-je?	qu'entends-je?
ah!	ah!
Madame, On peut eſteindre encore une crüelle flâme.	Madame, On peut éteindre encore une cruelle flamme.
Les Dieux, les juſtes Dieux pour vous s’intereſſans, Prendront ſoin par pitié de vos jours innocens;	Les Dieux, les justes Dieux pour vous s'intéressants, Prendront soin par pitié de vos jours innocents;
Et vous verrez Medée à vos pieds expirante, Y ſervir de victime à ma fureur ſanglante.	Et vous verrez Medée à vos pieds expirante, Y servir de victime à ma fureur sanglante.
J’en atteſte ces Dieux.	J'en atteste cette Dieux.
J’en jure mon amour.	J'en jure mon amour.
CRE’USE.	CRE'USE.
En vain vous pretendez me rappeller au jour.	En vain vous prétendez me rappeler au jour.
Medée à ſe vanger eſt trop ingenieuſe.	Medée à se venger est trop ingénieuse.
Mon ſang doit aſſouvir ſa rage furieuſe;	Mon sang doit assouvir sa rage furieuse;
Et vos ſoins, voſtre amour, loin de me ſecourir Irritent le poiſon dont je me ſens mourir.	Et vos soins, votre amour, loin de me secourir Irritent le poison dont je me sens mourir.
Envieux du plaiſir que m’offre voſtre veuë, Son art haſte l’effet du charme qui me tuë;	Envieux du plaisir que m'offre votre vue, Son art hâte l'effet du charme qui me tue;
Et l’Amour ſeul, plus fort que ſes Enchantemens, M’anime & me ſoutient encor quelques momens.	Et l'Amour seul, plus fort que ses Enchantements, M'anime et me soutient encor quelques moments.
Ecoutez-moi, Seigneur.	Écoutez-moi, Seigneur.
Mes maux ny ma foibleſſe Ne ſçauroient rallentir l’ardeur de ma tendreſſe.	Mes maux Seigneur ma faiblesse Ne sauraient ralentir l'ardeur de ma tendresse.
La Mort même ne peut éteindre un feu ſi beau.	La Mort même ne peut éteindre un feu si beau.
Je l’emporte avec moi dans l’horreur du tombeau;	Je l'emporte avec moi dans l'horreur du tombeau;
oii neuc	oii neuc
Mon amour y vivra.	Mon amour y vivra.
La Fortune jalouze 7 N’a pû ſouffrir, Jaſon, de me voir voſtre Epouſe.	La Fortune jalouze 7 N'a pu souffrir, Jason, de me voir votre Épouse.
Mais la Crüelle au moins me laiſſe la douceur, De mourir prés de vous, poſſedant voſtre cœur.	Mais la Cruelle au moins me laisse la douceur, De mourir près de vous, possédant votre cœur.
Je goûte en mes tourmens cette douceur ſecrette.	Je goûte en mes tourments cette douceur secrète.
La vie & les grandeurs n’ont rien que je regrette.	La vie et les grandeurs n'ont rien que je regrette.
Unique & tendre objet de mes vœux les plus doux, Je ne plains en mourant, ne regrette que vous.	Unique et tendre objet de mes vœux les plus doux, Je ne plains en mourant, ne regrette que vous.
Trop heureuſe en effet ſi comblant mon attente Les Dieux.	Trop heureuse en effet si comblant mon attente Les Dieux.
ah!	ah!
quel touimemi quenle ardeur devorante .	quel touimemi quenle ardeur dévorante .
Mon ſupplice s’accroît;	Mon supplice s'accroît;
je me ſens déchirer:	je me sens déchirer:
Je brûle.	Je brûle.
Adieu, Jaſon;	Adieu, Jason;
il faut nous ſeparer.	il faut nous séparer.
IASON Nous ſeparer!	IASON Nous séparer!
ô Dieux!	ô Dieux!
ah!	ah!
rigueur qui me tuë.	rigueur qui me tue.
Nous ſeparer!	Nous séparer!
quel coup pour mon ame éperduë!	quel coup pour mon âme éperdue!
Ah!	Ah!
je ſouffre à la fois mille horribles tourmens.	je souffre à la fois mille horribles tourments.
1 51 Quoi tous les Dieux ſont ſourds à mes gemiſſemens!	1 51 Quoi tous les Dieux sont sourds à mes gémissements!
Je vous perds pour jamais;	Je vous perds pour jamais;
en vain je les implore.	en je vain les implore.
Et j’ay ſeul allumé ce feu qui vous devore!	Et j'ai seul allumé ce feu qui vous dévore!
Non je ne verrai point un ſi crüel malheur;	Non je ne verrai point un si cruel malheur;
Et par un pront trépas j’en previendray l’horreur.	Et par un prompt trépas j'en préviendrai l'horreur.
CRE’USE.	CRE'USE.
A trop de deſeſpoir voſtre ame s’abandonne.	À trop de désespoir votre âme s'abandonne.
Vivez, Jaſon, vivez.	Vivez, Jason, vivez.
C’eſt moi qui vous l’ordonne.	C'est moi qui vous l'ordonne.
Ne me refuſez pas dans mon ſort rigoureux L’unique & dernier bien qui flatte encor mes vœux.	Ne me refusez pas dans mon sort rigoureux L'unique et dernier bien qui flatte encor mes vœux.
Gardez le ſouvenir d’une triſte Princeſſe.	Gardez le souvenir d'une triste Princesse.
Conſervez lui, Jaſon, toute voſtre tendreſſe.	Conservez lui, Jason, toute votre tendresse.
Elle meurt voſtre Epouſe.	Elle meurt votre Épouse.
A la face des Dieux Recevez donc ma main & mes derniers adieux.	À la face des Dieux Recevez donc ma main et mes derniers adieux.
Que ne puis-je employer ces vains reſtes de vie, A vous prouver l’amour dont mon ame eſt remplie?	Que ne puis-je employer ces vains restes de vie, À vous prouver l'amour dont mon âme est remplie?
Helas!	Hélas!
on n’a jamais aimé ſi tendrement;	on n'a jamais aimé si tendrement;
Et jamais je n’aimay plus que dans ce moment.	Et jamais je n'aimai plus que dans ce moment.
J’en atteſte les Dieux.	J'en atteste les Dieux.
Mes forces s’affoibliſſent:	Mes forces s'affaiblissent:
Ma voix, mon ſang ſe glace;	Ma voix, mon sang se glace;
& mes yeux s’obſcurciſſent.	et mes yeux s'obscurcissent.
Malgré le Sort crüel, qui va nous déſunir, Mon cœur vous aime encore à ſon dernier ſoupir.	Malgré le Sort crûel, qui va nous désunir, Mon cœur vous aime encore à son dernier soupir.
CYDIPPE.	CYDIPE.
Elle expire, Seigneur.	Elle expire, Seigneur.
JASON.	JASON.
Deſtin impitoyable!	Destin impitoyable!
Elle eſt morte;	Elle est morte;
& je vis!	et je vis!
ô tourment effroyable!	ô tourment effroyable!
Ah!	Ah!
mon bras au deffaut de ma lente douleur De ce ſupplice affreux doit m’épargner l’horreur.	mon bras au défaut de ma lente douleur De ce supplice affreux doit m'épargner l'horreur.
Meurs, lâche;	Meurs, lâche;
meurs enfin.	meurs enfin.
Mais ma douleur m’abuſe.	Mais ma douleur m'abuse.
je dois un ſacrifice aux Manes de Créüſe.	je dois un sacrifice aux Manes de Créüse.
Pour appaiſer ſon Ombre & ſes reſſentimens, je veux livrer Medée au plus crüels tourmens;	Pour apaiser son Ombre et ses ressentiments, je veux livrer Medée au plus cruels tourments;
Et mon ame auſſi-toſt ſur le rivage ſomkre.	Et mon âme aussitôt sur le rivage somkre.
De ce ſang aſſouvie ira trouver ſon ombre.	De ce sang assouvie ira trouver son ombre.
La ſoif de te vanger ſeule arreſte mon bras.	La soif de te venger seule arrête mon bras.
Belle Ombre, attens;	Belle Ombre, attends;
j’y cours & vais ſuivre tes pas.	j'y cours et vais suivre tes pas.
Medée en vain me fuit;	Medée en vain me fuit;
en vain ſon art la cache.	en vain son art la cache.
A ma juſte fureur il n’eſt rien qui l’arrache.	À ma juste fureur il n'est rien qui l'arrache.
Je ſuivray la Barbare au bout de l’Univers.	Je suivrai la Barbare au bout de l'Univers.
Et je la trouveray même au fond des Enfers.	Et je la trouverai même au fond des Enfers.
Mon amour furieux me ſervira de guide.	Mon amour furieux me servira de guide.
CENEI V ASON, ME'DE’E.	CENEI V ASON, MÉDÉLÉE.
MEDE’E, [U Hhas pas n'iom poar me uouver, Perfide.	MÈDE, [U Has pas n'iom poar me ouver, Perfide.
C’eſt Medée.	C'est Medée.
Oüi, c’eſt elle.	Oui, c'est elle.
Barbare.	Barbare.
JASON.	JASON.
Ah!	Ah!
crains mon deſeſpoir	crains mon désespoir
MEDE’E, le frappant de ſa Baguettte.	MÈDE, le frappant de sa Baguettte.
Arreſte, Ingrat;	Arrête, Ingrat;
& connois mon pouvoir.	et connais mon pouvoir.
JASON.	JASON.
Quel prodige eſtonnant!	Quel prodige étonnant!
Dieux!	Dieux!
ma fureur eſt vaine!	ma fureur est vaine!
Je me ſens retenu par une eſtroitte chaîne.	Je me sens retenu par une étroitte chaîne.
Je demeure immobile, & malgré mes efforts Le pouvoir de lon art s’oppole à mes tranſports	Je demeure immobile, et malgré mes efforts Le pouvoir de lon art s'oppole à mes transports
MEDE’E.	MÈDE.
Juge, ſi c’eſt à moi de craindre ta vengeance.	Juge, si c'est à moi de craindre ta vengeance.
Un ſort comme le mien n’eſt pas en ta puiſſance;	Un sort comme le mien n'est pas en ta puissance;
Magnanime Heros, ne ſonge plus à moi;	Magnanime Héros, ne songe plus à moi;
Trop indigne auſſi-bien d’un Epoux tel que toi.	Trop indigne aussi-bien d'un Époux tel que toi.
Laiſſe une Infortunée, oublie une Eſtrangere, Sans appui, ſans couronne, errante & ſolitaire.	Laisse une Infortunée, oublie une Étrangère, Sans appui, sans couronne, errante et solitaire.
Un hymen plein d’appas, un thrône glorieux T’attendent en ce jour dans ces ſuperbes lieux.	Un hymen plein d'appas, un trône glorieux T'attendent en ce jour dans ces superbes lieux.
Eſt-il temps de reſter auprés d’une Jalouſe!	Est-il temps de rester auprès d'une Jalouse!
Va ſoupirer aux pieds de ta nouvelle Epouſe.	Va soupirer aux pieds de ta nouvelle Épouse.
Vante lui ton ardeur, aſſure lui ta foi:	Vante -lui ton ardeur, assure lui ta foi:
Tu luy voles le temps que tu perds avec moi.	Tu lui voles le temps que tu perds avec moi.
Dois-tu pas à ſon ſort unir tu dertmée?	Dois-tu pas à son sort unir tu dertmée?
Haſte-toi de conclurre un ſi doux hymenée, Le Sacrifice eſt preſt, & le Temple eſt orné;	Hâte-toi de conclurre un si doux hyménée, Le Sacrifice est prêt, et le Temple est orné;
On n’attend plus que toi.	On n'attend plus que toi.
Cours, Epoux fortuné	Cours, Époux fortuné
JASON.	JASON.
Quoi!	Quoi!
la Barbare encore & m’inſulte & m’outrage!	la Barbare encore et m'insulte et m'outrage!
Faut-il que par ſon art elle brave ma rage?	Faut-il que par son art -elle brave ma rage?
Je ne puis l’immoler à ma juſte fureur!	Je ne puis l'immoler à ma juste fureur!
Son ſang appaiſeroit Créüſe & ma douleur!	Son sang apaiserait Créüse et ma douleur!
MEDE’E.	MÈDE.
oiü, Jaſon, à Crétiſe il fauu quelque victime, D iiij Et mon ſang répandu doit effacer mon crime.	Oui, Jason, à Crétise il sauvais quelque victime, D ij à mon sang répandu doit effacer mon crime.
Sois content.	Sois content.
J’ay verſé le plus pur de ce ſang.	J'ai versé le plus pur de ce sang.
Comment?	Comment?
JASON.	JASON.
MEDE’E.	MÈDE.
A tes deux Fils j’ay ſceu percer le flanc.	À tes deux Fils j'ai su percer le flanc.
Regarde ce poignard & cette main ſanglante;	Regarde ce poignard et cette main sanglante;
C’eſt de mon ſang, du tien, qu’elle eſt teinte & fumante.	C'est de mon sang, du tien, qu'elle est teinte et fumante.
Mon bras pour dernier coup vient de les égor ger.	Mon bras pour dernier coup vient de les égor ger.
Crois moi, ſans t’occuper du ſoin de te vanSi déja ton ardeur languit pour la Princeſſe;	Crois -moi, sans t'occuper du soin de te vanSi déjà ton ardeur languit pour la Princesse;
Si tu fuis, Inconſtant, ta nouvelle Maîtreſſe;	Si tu fuis, Inconstant, ta nouvelle Maîtresse;
Cours du moins, Pere heureux, à tes Fils expirans, D 17 Rens leur les derniers ſoins, embraſle les mourans.	Cours du moins, Père heureux, à tes Fils expirants, D 17 Rends leur les derniers soins, embrâle les mourants.
JASON.	JASON.
Ah!	Ah!
Barbare!	Barbare!
MEDE’E.	MÈDE.
En eſt-ce aſſez, & connois-tu Medée?	En est-ce assez, et connais-tu Medée?
De ſon affreux pouvoir garderas-tu l’idée?	De son affreux pouvoir garderas-tu l'idée?
Oublîras-tu ſa haine, ainſi que ſon amour?	Oublîtras-tu sa haine, ainsi que son amour?
JASON.	JASON.
Monſtre, à tes propres Fils avoir ravi le jour?	Montre, à tes propres Fils avoir ravi le jour?
Pourquoy ſacrifier d’innocentes victimes!	Pourquoi sacrifier d'innocentes victimes!
MEDE’E.	MÈDE.
Ils eſtoient nez de toi, demandes-tu leurs crimes ?	Ils étaient nés de toi, demandes-tu leurs crimes ?
Ma trop juſte fureur a dû les en punir;	Ma trop juste fureur a dû les en punir;
J’ay dû finir leurs maux, j’ay dû les prevenir;	J'ai dû finir leurs maux, j'ai dû les prévenir;
Te delivrer d’un joug que ton eſprit abhorre;	Te délivrer d'un joug que ton esprit abhorre;
Rompre ces derniers nœuds qui nous ſerroient encore;	Rompre ces derniers nœuds qui nous serraient encore;
Et, pour mieux t’oublier, effacer ſans retour Juſqu’aux traces, Ingrat, de noſtre affreux amour.	Et, pour mieux t'oublier, effacer sans retour Jusqu'aux traces, Ingrat, de notre affreux amour.
ce n’eſt pas ſans remords que je m’y ſuis forcée.	ce n'est pas sans remords que je m'y suis forcée.
Tu men as impire T’audace & ia pemée;	Tu men as impire T'audace et ja pemée;
Tu m’as ſeul enhardie à ce crüel deſſein, Infidelle, & c’eſt toy qui leur perce le ſein.	Tu m'as seul enhardie à ce cruel dessein, Infidèle, et c'est toi qui leur perce le sein.
JASON.	JASON.
Quoi !	Quoi !
les Dieux iritez, pour te require en poudre Sur ta teſte à mes yeux ne lancent point la foudre.	les Dieux irités, pour te require en poudre Sur ta tête à mes yeux ne lancent point la foudre.
MEDE’E.	MÈDE.
Vangeurs des trahiſons, Ennemis des Ingrats, Les Dieux pour t’accabler ont employé mon bras;	Vengeurs des trahisons, Ennemis des Ingrats, Les Dieux pour t'accabler ont employé mon bras;
La foudre étoit trop peu pour punir ton offence.	La foudre était trop peu pour punir ton offense.
J’ay ſervi leur juſtice & rempli leur vengeance	J'ai servi leur justice et rempli leur vengeance
C’en eſt fait.	C'en est fait.
Pour repaiſtre & mes yeux & mon cœur, Moi-même j’ay voulu joüir de ta douleur.	Pour repaître et mes yeux et mon cœur, Moi-même j'ai voulu joüir de ta douleur.
Ua ſpectacle ſi doux met le comble à ma gloire:	Oùa spectacle si doux met le comble à ma gloire:
e ſavoure à longs traits ta peine & ma victoire Et je recouvre enfin ma gloire, mon repos, Mon Sceptre, mes Parens, la Toiſon & Colchos.	 savoure à longs traits ta peine et ma victoire Et je recouvre enfin ma gloire, mon repos, Mon Sceptre, mes Parents, la Toison et Colchos.
je pars;	je pars;
puis que ma fuitte a pour toi tant de charmes, Leve encor juſqu’à moi tes yeux chargez de larmes, Ingrat.	puis que ma fuite a pour toi tant de charmes, Léve encor jusqu'à moi tes yeux chargez de larmes, Ingrat.
Voi ces Dragons qui ſoûmis à ma loy, Et plus reconnoiſſans, plus fidelles que toi, Par des chemins nouveaux vont guider leur maîtreſſe.	Vois ces Dragons qui soumis à ma loi, Et plus reconnaissants, plus fidèles que toi, Par des chemins nouveaux vont guider leur maîtresse.
Tes vœux ſont ſatisfaits, pour juinais jete laiſſe.	Tes vœux sont satisfaits, pour juinais jetée laisse.
Adieu;	Adieu;
je t’abandonne aux horreurs de ten ſort.	Je t'abandonne aux horreurs de ten sort.
Le Ingrat, je te hais trop pour te donner la mort.	Le Ingrat, je te hais trop pour te donner la mort.
SCENE DERNIERE.	SCÈNE DERNIÈRE.
JASON, IPHITE.	JASON, IPHITE.
ASON.	ASON.
Lle fuit;	Lle fuit;
& ce Char l’enlevant dans les L nuës Ouvre à ſa cruauté des routes inconnuës.	et ce Char l'enlevant dans les L ues Ouvre à sa cruauté des routes inconnues.
La Barbare à mes yeux diſparoît pour jamais;	La Barbare à mes yeux disparoît pour jamais;
Elle brave ma haine aprés tant de forfaits;	Elle brave ma haine après tant de forfaits;
Et m’enleve en fuyant, malgré ma rage extrême, Beaupere, Enfans, Maîtreſſe, & ma vengeance même.	Et m'enlève en fuyant, malgré ma rage extrême, Beaupère, Enfants, Maîtresse, et ma vengeance même.
Je ne puis la punir de tant de crüauté.	Je ne puis la punir de tant de cruauté.
Le Ciel offre un aſile à ſon impieté.	Le Ciel offre un asile à son impiété.
C’en eſt trop.	C'en est trop.
Terminons ma vie & mon ſupplice.	Terminons ma vie et mon supplice.
Je ne puis me vanger;	Je ne puis me venger;
il faut que je periſſe.	il faut que je périsse.
TIop malneureux objets de l’amour de Jaſon, Déplorable Créüſe!	TIop malneureux objets de l'amour de Jason, Déplorable Créüse!
infortuné Creon!	infortuné Creon!
O mes Fils!	Ô mes Fils!
joüiſſez de la ſeule vengeance, Que les Dieux inhumains laiſſent en ma puiſſance.	jouissez de la seule vengeance, Que les Dieux inhumains laissent en ma puissance.
PHITE.	PHITE.
Ah!	Ah!
Seigneur.	Seigneur.
il n’eſt plus.	il n'est plus.
Quels horribles malheurs O trop funeſte Amour, produiſent tes fureurs.	Quels horribles malheurs Ô trop funeste Amour, produisent tes fureurs.
FIN.	FIN.
Exiran au Tnolege da Roy.	Exiran au Tnolege da Roi.
Ar Lettres Patentes de Sa Majeſté, données à Paris le vingt-quatriéme Mars 1694.	Ar Lettres Patentes de Sa Majesté, données à Paris le vingt-quatrième Mars 1694.
Signé;	Signé;
NOBLOT.	NOBLOT.
Il eſt permis au Sieur PIERRE EMERY Libraire de Päris, d’imprimer un Livre intitulé Medée, Tragedie nouvelle, pendant le temps de ſix années conſecutives :	Il est permis au Sieur PIERRE EMERY Libraire de Pris, d'imprimer un Livre intitulé Medée, Tragedie nouvelle, pendant le temps de six années consécutives :
Avec défenſes à tous autres de le vendre & le debiter ſans le conſentement dudit Expoſant à peine de confiſcation des Exemplaires contrefaits & de trois mil livres d’amende, ainſi qu’il eſt porté plus au long dans leſdittes Lettres.	Avec défenses à tous autres de le vendre et le débiter sans le consentement dudit Exposant à peine de confiscation des Exemplaires contrefaits et de trois mille livres d'amende, ainsi qu'il est porté plus au long dans lesdites Lettres.
Regiſtré ſur le Livre de la Communauté des Imprimeurs & Libraires de la Ville de Paris, le 26.	Registré sur le Livre de la Communauté des Imprimeurs et Libraires de la Ville de Paris, le 26.
dudit mois & an.	dudit mois et an.
Signé;	Signé;
P.	P.
AuBoüiN, Syndic.	AuBouiN, Syndic.
Achevé d’imprimer le premier Avril 1694.	Achevé d'imprimer le premier Avril 1694.
Ledit Sieur Emery a fait part dudit Privilege aux Sieur Auboüin & Clouzier.	Ledit Sieur Emery a fait part dudit Privilège aux Sieur Aubouin et Clouzier.
