A ANVERS, hez HENRY van DUNVALDT, Libraire au Marche aux Oeufs, aux trois Moines.	A ANVERS, hé HENRY van DUNVALDT, Libraire au Marque aux Oeufs, aux trois Moines.
1688.	1688.
ACI EUR.	ACY EUR.
DU PROLOGUE.	DU PROLOGUE.
MERCURE.	MERCURE.
MELPOMENE, Muſe de la Tragedie.	MELPOMENE, Muse de la Tragédie.
TERPSICORE, Muſe de la Muſique.	TERPSICORE, Muse de la Musique.
YHACIEI Mujo aet Cvunvate.	YHACIEI Mujo aet Cunevate.
Toupe de Genies qui ſuivent Melpomene.	Toupe de Génies qui suivent Melpomene.
Troupe de Genies qui ſuivent Terpſicore.	Troupe de Génies qui suivent Terpsicore.
Toupe de Genies qui ſuivent Thalie.	Toupe de Génies qui suivent Thalie.
UPITER.	OÙPITER.
a lu d d	a lu d 
Le Theatre repreſente unlieu propre à donner des ſpectacles, & qui peut conveuir à la Tragedie & à la Comedie;	Le Theatre représente unlieu propre à donner des spectacles, et qui peut convuir à la Tragédie et à la Comédie;
Ce lieu n’a plus la magniſicence qu’il paroiſt avoir ed autrefois, il eſt méme preſque détruit & ruine.	Ce lieu n'a plus la magnisicence qu'il paraît avoir ed autrefois, il est même presque détruit et ruine.
On y von Mripomene, Ierpneore Q’Anmn Jans aucune ſuite Meroure deſcend du Ciel,	On y von Mripomène, Jerpneore Q’Anmn Jans aucune suite Meroure descend du Ciel,
MERCURE, MELPOMENE.	MERCURE, MELPOMENE.
– TERPSICORE, THALIE.	Ce THÉRPSICORE, THALIE.
MERCURE.	MERCURE.
Cavantes Sœurs, arblttes de la Scene, Quel accident funeſte a fait ceſſet vos leux?	Cavantes Sœurs, arblttes de la Scène, Quel accident funeste a fait cesset vos leux?
Ie ne voy plus lcy vôtre appareil prompeux, Et je ne reconnols qu’a peine, Thalie, & Melpomeue;	Je ne vois plus lu votre appareil prompeux, Et je ne reconnols qu'a peine, Thalie, et Melpomève;
Et vons dout les charmans Concerts, En ces lleux autreſois, raitonnoient dans les Airs Quel trouble, ou quelle indifference Cauſe aujourd'huy votre ſilence!	Et vons dout les charmants Concerts, En ces lleux autres, raitonnaient dans les Airs Quel trouble, ou quelle indifférence Causse aujourd'hui votre silence!
MELPOMENE Ignorez.	MELPOMENE Ignorés.
vous, que le plus grand des Rols Etendant chaque jour ſes conquêtes Et ſigna’ant ſon bras, par de nouveaux fxploira A negligé nos plus ſuperbes Fêtes!	vous, que le plus grand des Rols Étendant chaque jour ses conquêtes Et signa son bras, par de nouveaux fxploira A négligé nos plus superbes Fêtes!
THALIE.	THALIE.
nepuls ce fatal moment.	nepuls ce fatal moment.
Nor Suectacles privez de leur magnificence, Nelçautoient plus avoir l’eclat & l’agrement Qu’ils ne dev oient qu’à la preſence.	Nor Suectacles privez de leur magnificence, Nelçautoient plus avoir l'éclat et l'agrément Qu'ils ne dev aient qu'à la présence.
TERPSICORE.	TERPSICORE.
La trlſteſſe reque en ces lieux, Nous rougiſtons de ne pouvoir lui pleire;	La trlstesse reque en ces lieux, Nous rougistons de ne pouvoir lui pleire;
Hetis?	Hétis?
ne ſçaurlons.	ne saurons.
nous rien taire Digne de jaroitre à ſes yeux !	nous rien taire Digne de jaroitre à ses yeux !
MELPOMENE, THALIE, TERPSICORE.	MELPOMENE, THALIE, TERPSICORE.
FHélas!	FHélas!
ne ſçaurions-nous rlen ſalre Digne de paroitre a ſes yeux ?	ne saurions-nous ren salre Digne de paraître à ses yeux ?
MERCURE.	MERCURE.
Terminez vos regrets, que vôtre douleur ceſſe.	Terminez vos regrets, que votre douleur cesse.
Dani vôtre ſort lupltei slimereſſe, Et veut ley revoir, dés ce iême moment vn ſpectacle charmant, Qu'un changement ſa vorable Redonne à cea tiiſtes lleux Tout ce qu’lls ont eſt d’aimable, en loiddo lire vcenelo.	Dani votre sort luplite limeresse, Et veut ley revoir, dès ce iême moment un spectacle charmant, Qu'un changement sa vorable Redonne à ce tiistes lois Tout ce qu'lls ont est d'aimable, en loisdo lire vcenelo.
Du Souveraln des Dieux.	Du Souvern des Dieux.
Ce lieu deſert & détruit reprend tout d’un coup ſa premiere magnificence.	Ce lieu désert et détruit reprend tout d'un coup sa première magnificence.
MELPOMENE.	MELPOMENE.
Vous, ſecourables Genies, C Si neceſſalies à nos eux, Hâtez-vour, ſecondez not vœux;	Vous, secourables Génies, Ç Si nécessalies à nos eux, Hâtez-vour, secondez not vœux;
Venez, & piêtez-nous vos graces infinies.	Venez, et piêtez-nous vos grâces infinies.
d dl d	 dl d
Le Theatre repreſente unlieu propre à donner des ſpectacles, & qui peut convenir à la Tagedie & à la Comedie;	Le Théâtre représente unlieu propre à donner des spectacles, et qui peut convenir à la Tagédie et à la Comédie;
Ce lieu n’a plus la magniſicence qu’il paroiſt avoir eu autreſois, il eſt méme priſque détruit & ruine.	Ce lieu n'a plus la magnisicence qu'il paraît avoir eu autresois, il est même prisque détruit et ruine.
On 3 vuit Meipomene, Ierpſivre Qu Inaſie ſauaucune ſuite Meroure deſcend du Ciel,	On 3 vit Meipomène, Jerpsivre Quel Inasie saucune suite Meroure descend du Ciel,
MERCURE.	MERCURE.
MELPOMENE.	MELPOMENE.
TERPSICORE, THALIE.	TERPSICORE, THALIE.
MERCURE.	MERCURE.
Cavantes Sœure, arbitres de la Scene, Quel areident tuneſte a fait ceſſer vos leux!	Cavantes Sœure, arbitres de la Scène, Quel areident tuneste a fait cesser vos leux!
Ie ne voy plus lcy vôtre arpareil prompeux, Et le ne reconnois qu’a peine.	Je ne vois plus lcy votre arpareil prompeux, Et le ne reconnais qu'a peine.
Thalie, & Melpomene;	Thalie, et Melpomene;
Et vous dont les charmans Concerts, En ces lleur autrefois, raiſonuoient dans les Aiis;	Et vous dont les charmands Concerts, En ces leur autrefois, raisonvaient dans les Ajis;
Quel trouble, ou quelle indifference Cauſe aujourd’huy vôtre ſilence!	Quel trouble, ou quelle indifférence Cause aujourd'hui votre silence!
MELPOMENE Ignorez-vous, que le plus grand des ſtols Etendant chaque jour ſes conquêtes Et ſigna'ant ſon bras, par de nouveanx fxploita ?	MELPOMENE Ignorés-vous, que le plus grand des stols Étendant chaque jour ses conquêtes Et signaant son bras, par de nouveanx fploita ?
negligé nos plus ſupeibes Fêtes!	négligé nos plus supeibes Fêtes!
THALIE.	THALIE.
Depuls ce ſatal moment, Nos Spectacles priuez de leur magni ficence, Ne ſçauroient plus avoir l’eelat & l'agrement Qu’ils ne dev oient qu’a ſa pteſence,	Dépuls ce satal moment, Nos Spectacles privez de leur magny ficence, Ne sauraient plus avoir l'celât et l'agrément Qu'ils ne dev aient qu'a sa ptesence,
TERPSICORE.	TERPSICORE.
La tilſteſſe regne en ces lieux, Nous rougiſtons de ne pouvoir lui plelte;	La tilstesse règne en ces lieux, Nous rougistons de ne pouvoir lui plelte;
Helis?	Hélis?
ne ſçauriots-nous tien faire Digne de jaroître à ſes yeux?	ne sauriots-nous tien faire Digne de jaroître à ses yeux?
MELPOMENE, THALIE.	MELPOMENE, THALIE.
TERPSICORE.	TERPSICORE.
fHlélat!	fHlélat!
ne ſçaurlons-nous rlen ſaire Digne de paroitre a ſes yeus?	ne saurons-nous rlen zaïre Digne de paraître à ses yeus?
MERCURE.	MERCURE.
Tetmlnez vos regréts, que vôtre douleur ceſſe.	Tetmlnez vos regrêts, que votre douleur cesse.
Dans vôtre fort luplter s’in eteſſe, Et veut ley revoir, dés ce intme moment vn ſpectacle charmant, Qu'un changemient fotorable Redonne à ces triſtes lieux Tout ce qu’lla ont eu d’aimable?	Dans votre fort luplter s'in etesse, Et veut ley revoir, dès ce intomme moment un spectacle charmant, Qu'un changement fotorable Redonne à ces tristes lieux Tout ce qu'lla ont eu d'aimable?
Oul Perinte ille veeaolo Du Souverain des Dleuz.	Oul Perinte ille veaolo Du Souverain des Dleus.
Ce lieu deſert & détruit reprend tout d’un coup ſa premiere mognificence.	Ce lieu désert et détruit reprend tout d'un coup sa première mognificence.
MELPOMENE.	MELPOMENE.
Vous, ſecoutables Genies, CSi neceſſaires à nos eux, Hâtez-vous, ſecondez nos vœux;	Vous, secoutables Génies, CSi nécessaires à nos eux, Hâtez-vous, secondez nos vœux;
venta, & prêtez-nous vos graces infinies.	venta, et prêtez-nous vos grâces infinies.
MELPOMENE, TERPSICORE.	MELPOMENE, TERPSICORE.
Animez d’une ardeur nouvelle, Venez remplir nos deſis, Et faites que nos plaiſirs Muvane nourcmmide uvoue zdle.	Animez d'une ardeur nouvelle, Venez remplir nos désis, Et faites que nos plaisirs Muvane nourcmide uvoue zdle.
Chœur de Genies.	Chœur de Génies.
Animez d'une ardeur nouvelle Nous venons remplir vos delirs, dauus nous ſldion qua vus pimnno Devront leur charme à nôire zéle.	Animez d'une ardeur nouvelle Nous venons remplir vos délirs, dauus nous sldion qua vus pimno Devront leur charme à nôire zèle.
THALIE.	THALIE.
Vous qui ſçavez ſi bien, par une heureuſe adreſſe Ommei ls none cnagtms, damime me toms facbeus, Favorilez mes Soeurs, & uielez dans leure leux quelques traits de votre allegreſſe.	Vous qui savez si bien, par une heureuse adresse Omi lois none cnagtms, damime me toms facbus, Favorilez mes Soeurs, et uielez dans lèvre leux quelques traits de votre allégresse.
MELPOMENE, THALIE, TERPSICORE.	MELPOMENE, THALIE, TERPSICORE.
Que nos leur vont avoit de charmies!	Que nos leur vont avait de charmiez!
Tous nos chant vont inſpirer l’Amout, Venez tous, rendez.	Tous nos chant vont inspirer l'Amout, Venez tous, rendez.
luy les armes, Il eſt doux dann cet heureux ſejous.	Ne les armes, Il est doux dann cet heureux séjous.
Que nos leux vont avolr de charmes!	Que nos leux vont avolr de charmes!
rous nas emis vous impherpaiuou Ce n’eſt plus le temps des allaimes, ces Plaifirs ſont euſin de retour, Que nos leux vont Avoir de charmes!	rous nas émis vous impherpaiuou Ce n'est plus le temps des allaimes, ces Plaifirs sont eusin de retour, Que nos leux vont Avoir de charmes!
Tous nus chants vont iuſpiret l'Amous.	Tous nus chants vont juspiret l'Amous.
MERCURE.	MERCURE.
luplter va patoitte, Redoubiez vos eftoits pour plaiſe à vone Mante.	luplter va pataitte, Redoubiez vos es pour plaise vone Mante.
Chœur.	Chœur.
Chœur.	Chœur.
Iupiter ve paroître.	Jupiter vue paraître.
Redoub ons nos effortt pour plaire à noire Mattre.	Redoub ons nos effortt pour plaire à noire Mattre.
Dans ce moment Jupiter paroiſt dans ſonChar.	Dans ce moment Jupiter paraît dans sonChar.
IPITER.	IPITER.
Il ne manque aux apprêts de la Fête nouvelle, Que Mereute à ſoit préparet, Que le choix du Heros qu'on y doit celebrer, Le ſoin de le choiſit aupres de vous m'appelle.	Il ne manque aux apprêts de la Fête nouvelle, Que Mèreute à soit préparet, Que le choix du Héros qu'on y doit célébrer, Le soin de le choisit auprès de vous m'appelle.
Renouvellez dans vos leux Le ſouvenir de l’invincible Achile, Et raprellez dans une Cour tranquile, L’H’ſtoire & les Combats de ce Guertier fameux.	Renouvelez dans vos leux Le souvenir de l'invincible Achille, Et raprellez dans une Cour tranquille, L'HIstoire et les Combats de ce Guertier fameux.
MELPGRENE, TERPOPGORE,	MELPGRENE, TERPOPGORE,
THALSE.	THALSE.
Renouvellone du nos letx, Le ſouv enh de lhrincibn Aemie:	Renouvelone du nos letx, Le souv enh de lhrincibn Emie:
Et roppellons dens une Cour uiauquile L’Hiſtoire de les Combats de et daenier fautm.	Et roppelons dens une Cour uiauquille L'Histoire de les Combats de et daenier fautm.
UTESER.	OUTESER.
I 6 Comatebious vee ieunue plus grand Roy du monO Formez ſut luy tous les Portraits De vos Heros les plus pat faits, L.	I 6 Comactebious ve jeunue plus grand Roi du mon Formés sut lui jours les Portraits De vos Héros les plus pat faits, L.
Sa valeur, ſa bonté, ſa lageſſe profonde, Vous prêteront d’inimitables traits.	Sa valeur, sa bonté, sa lagesse profonde, Vous prêteront d'inimitables traits.
A 4	A 4
Chœur.	Chœur.
Chœur.	Chœur.
Conſaerons tous nos leux au plus grand Roy du monde, Sa valeur, ſa bonté, ſa ſageſſe profonde Nous prêteront d’inimitables traits, Conſacrons tous nos leux au plus grand Roy du monde.	Consérons tous nos leux au plus grand Roi du monde, Sa valeur, sa bonté, sa sagesse profonde Nous prêteront d'inimitables traits, Cons tous nos leux au plus grand Roi du monde.
A	À
Sourc ffr ationale de France	Sourc ffr ationale de France
ACTEURS DE LA TRACEDIE.	ACTEURS DE LA TRACEDIE.
AXCHILE, Roy de Theſſalie.	AXCHILE, Roi de Thessalie.
PATROCLE, Amy d’Achile.	PATROCLE, Ami d'Achille.
DIONEDE, L’un des Chefs de l’Armée des Grecs.	DIONEDE, L'un des Chefs de l'Armée des Grecs.
VENUS.	VENUS.
Les Graces, les Amours, &les Plaiſirs qui ſuivins VINUS.	Les Grâces, les Amours, etles Plaisirs qui suivins VINUS.
ARCAS, Confdeut d’Achile.	ARCAS, Confdut d'Achille.
AGAMEMNON, Roy de Myeene, & d’Argo, Chef de tous les Grecs.	AGAMEMNON, Roi de Myeène, et d'Argo, Chef de tous les Grecs.
PRIAM, Roy de Troye.	PRIAM, Roi de Troie.
A	À
AN	AN
ANDROMAQUE, veuve d’Hector fils de Priam.	ANDROMAQUE, veuve d'Hector fils de Priam.
POLIAENE, fille de Priam.	POLIANE, fille de Priam.
BRIBEES, Princeſſe Priſonniere d’Achile.	BRIBES, Princesse Prisonnière d'Achille.
JURONO	JURONO
La Hayne, la Diſcorde, la Fureur, l'Envie.	La Haine, la Discorde, la Fureur, l'Envie.
Suite de la Diſcorde.	Suite de la Discorde.
Troupe de Troyens.	Troupe de Troyens.
Trcupe de Troyennes.	Trcupe de Troyennes.
Troupe de Theſſaliens.	Troupe de Thessaliens.
ACHI	ACHY
ACHILE, TRAGEDIE.	ACHILE, TRAGÉDIE.
ACTE PREMIER.	ACTE PREMIER.
Le Theatre repreſente l’Iſte de Tenede, ou Achille s’eſt retiré auprés de ſes Vaiſſeaux, depuis ſa querelle avec Agamemnon.	Le Théâtre représente l'Ite de Ténède, ou Achille s'est retiré auprès de ses Vaisseaux, depuis sa querelle avec Agamemnon.
DoAvon IliM Eo ACHILE, PATROCLE.	DoAvon IliM Eo ACHILE, PATROCLE.
PATROCLE.	PATROCLE.
On, je ne ſçaurois plus me talre, Ie vous dois un conſeil ſiticere;	On, je ne saurais plus me talère, Je vous dois un conseil sitice;
Ne rougiſtez-vous point d’un indigne repos?	Ne rougistez-vous point d'un indigne repos?
Quand les Grecs agitez de mortelles allatmes,	Quand les Grecs agités de mortelles allatmes,
A 8 Implorent à genoux le ſecours de vos armes, Contre Hector, aprét vous, le plus grand des Heros.	A 8 Implorent à genoux le secours de vos armes, Contre Hector, après vous, le plus grand des Héros.
Tantôt ce guerrler tertible, Des Grecs épouventez, embraſe les Vaiſſeaux;	Tantôt ce guerrler tertible, Des Grecs épouventez, embrase les Vaisseaux;
Taniôt ſon bras invincible, Fait rougir de leur ſang, & la terre & les eaux,j .	Taniôt son bras invincible, Fait rougir de leur sang, et la terre et les eaux,je.
Il court de victoire en victoire.	Il court de victoire en victoire.
52i Chaque lour, le bruit de la gloire, Va remplir l'Vnlvers & vole juſqu’à vous, Dei nomeuts qu'u oonen, nentes vous poirt jaloux?	52i Chaque lour, le bruit de la gloire, Va remplir l'Univers et vole jusqu'à vous, Di nomeuts qu'u oon, nentes vous poirt jaloux?
ACHILE.	ACHILE.
Ie vois avec plaiſir les pertes de la Gtece, La valeus d’Hector m';	Je vois avec plaisir les pertes de la Gtèce, La valeus d'Hector m';
vangé, Le fier Agameninon conroitra ſa foibleſſe, Et ſe repentira de m’avoir outrage.	vengé, Le fier Agameninon controitra sa faiblesse, Et se repentira de m'avoir outrage.
PATROCLE.	PATROCLE.
Dequoy ſert à ce Roy cour able D’avoir oſe vous ravir Briſes ?	Dequoy sert à ce Roi cour able D'avoir ose vous ravir Brises ?
Son attentat reçoit un digne prix, ( Et pour luy Brilels paroiſt inexorable, Quand un nva ponant vient toueſer nas alnours, Si l’oblet de nos vœux luy reſiſte icûjours, Eſt-il de plus douce vengeance Que de voir ce tival aimer ſans eſperance!	Son attentat reçoit un digne prix, ( Et pour moi Brilels paraît inexorable, Quand un néva ponant vient toueser nas alours, Si l'oblet de nos vœux était résiste icujours, Est-il de plus douce vengeance Que de voir ce tival aimer sans espérance!
ACHILE.	ACHILE.
Connoy mieux les raiſon de mon luſle coutrous, Ce n'eſt point ſeulement par un déplt jaloux, Que je tefuſe aux Grees un ſecours neceſlaire, Ils ont marqué trop de méprl pour moy, Ils m’ont laiſſe ſublr la vlolente Loy De leur Chef temeraire.	Connoi mieux les raison de mon lûle coutrous, Ce n'est point seulement par un déplt jaloux, Que je tefuse aux Grees un secours neceslaire, Ils ont marqué trop de méprl pour moi, Ils m'ont laisse sublr la vlolente Loi De leur Chef téméraire.
Non, jamais leurs malheurs ne ſ̧auroieut m’émouvoir, Lauts Volſſeaux embraſez, leurs Troupes fugluves;	Non, jamais leurs malheurs ne sauraient m'émouvoir, Lauts Volsseaux embrasés, leurs Troupes fugluves;
Leur Camp détruit, tout leuts Rois ſans pouvolr, Leura Lauis corps épais fur ces ſanglantes rives Scroient encor des obyets impulſſans, vourlempeuuteurmeeuel laccueopelen	Leur Camp détruit, tout luts Rois sans pouvolr, Leura Lavis corps épais fur ces sanglantes rives Scraient encor des objets impulssants, vourlempeuuteurmeeuel lacueopelen
PATROCLE.	PATROCLE.
* Eh bien!	* Eh bien!
d'un œll content regardez nos allarmes;	d'un œll content regardez nos alarmes;
Mais quand vous nous meptilez tous, Du moins accordez moy ces armes que Vilcain prepara pour vous;	Mais quand vous nous meptilez tous, Du moins accordez moi ces armes que Vilcain prépara pour vous;
I'irai combatre Hector, & me combler de gloire, Ic reimponeray la ticone s Où j’capireray ſous ces coups.	J'irai combattre Hector, et me combler de gloire, Ic reimponeray la ticomone s Où j'apirera sous ces coups.
ACHILE.	ACHILE.
Qu'oſes.	Qu'oses.
tu propoſer Dieurſque viens-je d'entendie?	tu proposer Dieursque viens-je d'entendie?
Ie commenre à trembler pour la premlere fois, Quand je ſonge au combat que tu veux entreprendre,	Je commenre à trembler pour la premère fois, Quand je songe au combat que tu veux entreprendre,
PAT ROCLE.	PAT ROCLE.
Au nom d’une amitié qui fut toſjours ſi tendre, Perinettez moy d’imiter vos exploits.	Au nom d'une amitié qui fut toujours si tendre, Périnettez moi d'imiter vos exploits.
Ie connois les perils uu mon deſſein m’engasc.	Je connais les périls u mon dessein m'engasc.
Tout ſenible m’onnoncer les ſers ou le trepas, Mait ſi j’en croy mon courare, Ce ſuperbe entemy ne tilomphera pas,	Tout sénible m'onnoncer les sers ou le trépas, Mait si j'en crois mon courare, Ce superbe entemi ne tilomphera pas,
ACHILE.	ACHILE.
D'une vaine teneur je n'oy plus l’ame attelnte, Va combattre;	D'une vaine teneur je n'ois plus l'âme attelte, Va combattre;
le Ciel prendra ſoin de ton fort, Puiſque ton cœur eſt ſant erainte,,, Ton bras ne ſera que trop fort.	le Ciel prendra soin de ton fort, Puisque ton cœur est sant erainte, Ton bras ne sera que trop fort.
PATROCLE.	PATROCLE.
Ie coure aſſurer ma memoire.	Je coure assurer ma mémoire.
I'ay tous les tentimens & les ſoins des Heros , Non, les jours les plus doux paſſen dans le repos Ne valent pas un juur marque par la victoire.	J'ai tous les tentiments et les soins des Héros , Non, les jours les plus doux passen dans le repos Ne valent pas un juur marque par la victoire.
ACHILE.	ACHILE.
SCENE SECONDE,	SCÈNE SECONDE,
ACHILE, ſeul.	ÀCHILE, seul.
Atrocle va combattre?	Atrocle va combattre?
& j'ay pſt conſentir Qu’il courut aux dangers qui menaſſent ſa vie!	et j'ai pût consentir Qu'il courut aux dangers qui menacent sa vie!
Ah!	Ah!
je de vois l’empécher de partlr, Hélas de qu'ela regrets ſa moit leroit ſirivie?	je de vois l'empêcher de partla Réglas de qu'ellea regrets sa moit lerait sirivie?
Si le ſort lirlté pour accabler mon cœur Le ſaiſoit expirer ſous le fer d’un vainqueur.	Si le sort lirlté pour accabler mon cœur Le saisait expirer sous le fer d'un vainqueur.
Prevenez juſtes Dieux, mon deſeſpoir funeſte!	Prévenez justes Dieux, mon désespoir funeste!
Cét amy genereur, eſt le ſeul qui me reſte, Conſervez ſes jours par plué!	Cet ami généreur, est le seul qui me reste, Conservez ses jours par plué!
On m’a privé de l'objet que j'adore, Ce ſeroit trop d’horreur de me prlver encore De P'objer de mon amitie.	On m'a privé de l'objet que j'adore, Ce serait trop d'horreur de me prêver encore De P'objer de mon amitié.
e MbA MB.	Je MA MB.
ACHILE, DIOMEDE.	ACHILE, DIOMEDE.
I DIOMEDE.	I DIOMEDE.
E répondrez-vous point aux deſtu de la Grece?	E répondrez-vous point aux destu de la Grèce?
Il ſaut qu’en ſa faveur voire colere ceſſe, eſſe ne peut tans vous miompner det Troyens, En vain nous aſſiegeons leur ville, Nos Dleux ſont moine forts que les ſiens, Sa priſe eſt reſeivée à la valeur d’Achile.	Il saut qu'en sa faveur voire colère cesse, esse ne peut tans vous miompner de Troyens, En vain nous assiégeons leur ville, Nos Dleux sont moine forts que les siens, Sa prise est reseivée à la valeur d'Achille.
ACHILE.	ACHILE.
De quel employ vous chargez-voue!	De quel emploi vous chargez-voue!
N emciez pas de nem moncounoui, Dlomede, Je veunacherer ma vangeance:	 Nemciez pas de ne moncounoui, Dlomede, Je veunacherer ma vengeance:
Vos Rois & vos Peuples ingian, olent encor pour moy li même indillerence, S'ils n’avolent beſoln de mon bras.	Vos Rois et vos Peuples ingian, olent encor pour moi li même indillerence, S'ils n'avolent besoln de mon bras.
DIOMEDE.	DIOMEDE.
Quoy!	Quoi!
leur prompt repentir ne peut vous ſatis-ſaire!	leur prompt repentir ne peut vous satî-zaïre!
Acui	Acui
A CHILE.	À CHILE.
Ils ont pris trop de ſoin d'attirer ma coleis.	Ils ont pris trop de soin d'attirer ma colis.
DIOMEDE.	DIOMEDE.
Mais pouvez vous, aimer un ſi triſte ſejour, Et languit en ces lieux dans une vle obſcurt.	Mais pouvez -vous, aimer un si triste séjour, Et languit en ces lieux dans une veule obscurt.
t.	t.
Vous ià qui les Deſtins promettoient chaque jout Quelque glorleuſe avanture.	Vous jà qui les Destins promettaient chaque jout Quelque glorleuse aventure.
ACHILE.	ACHILE.
Malgré mes cruels déplaiſirs, La béeſſe de Cytheie En faveur de Thetis ma mere Interromut mes iegren, & ſuſpend mes ſoſtpin, Cette charmante Déeſſe vient en ces lleux tous lesjouss, Ie vols avee elle ſans ceſſe Let glaces, les plaiſts, les jeus cc les amoura;	Malgré mes cruels déplaisirs, La béesse de Cysthéie En faveur de Thétis ma mère Interromut mes iegren, et suspend mes sostpin, Cette charmante Déesse vient en ces lleux tous lesjouss, Je vols ave elle sans cesse Let glaces, les plaîts, les jeus ç les ca;
Leur preſence eſt d’un grand ſecouta Contre la plus ſombre triteſſe,	Leur présence est d'un grand secouta Contre la plus sombre tritesse,
DIOMREE.	DIOMRE.
Oeſt poun ierris nos ennemis Qu’on prend ces ſoins mon els à votre gloire, Songez que de vars ſoul depend nôtee vlctoire, Et que tout notre loit en vos malns eſt remls, Faut-il que vôtre cœur ſe Ilvre A lamour des vains plaiſiis?	Oest poun jerris nos ennemis Qu'on prend ces soins mon ès à votre gloire, Songez que de vars soul dépend nôtee vlctoire, Et que tout notre loit en vos malns est remls, Faut-il que votre cœur se Ilvre A lamour des vains plaisiis?
Quelque douceur que l'on gonte à les ſuivie, vn Hleros doit ſoimez de plus uobles delite.	Quelque douceur que l'on gonte à les suivie, un Héros doit soimez de plus obles délite.
ACHILE La Déeſſe paroiſt?	ACHILE La Déesse paraît?
& oda ſa pieſence Donne à ces lieux millé beaures, I'admire ſes bien-faits, j’admire ſa puiſſines, Trop heureux de joliir, ſur tes bords écaitez DO plaiſlis innocens qui me ſont preſenter,	et oda sa pies Donne à ces lieux millé beaures, J'admire ses bienfaits, j'admire sa puissines, Trop heureux de joliir, sur tes bords écaitez DO plaislis innocents qui me sont présenter,
ACHILE, SCENE QUATRIB'ME.	ACHILE, SCÈNE QUATRIB'ME.
VENUS, ACHILE.	VENUS, ACHILE.
Venus paroiſt en l'air avec l’amour;	Venus paraît en l'air avec l'amour;
elle eſt accompagnée des Graces, & des Plaiſirs:	elle est accompagnée des Grâces, et des Plaisirs:
le nüage qui les porte deſcend juſques au bas du Amounnonuu en juinomtuu Ouuungeſe va perdre dans les Airi.	le nuage qui les porte descend jusques au bas du Amounonu en juinomtu Ouvunges va perdre dans les Airi.
ENUS.	ENUS.
Abandonne leà Cieux, je deſcends ſur la Terres Pour finir de tes maur le déplorable cours, En vain l’injuſte ſoit t'a déclaté la gueire, Eſpere tout de mon ſecouts.	Abandonne le Cieux, je descends sur la Terres Pour finir de tes maur le déplorable cours, En vain l'injuste soit t'a déclaté la guère, Espere tout de mon secouts.
Vous, Oivinitez almables, * Du plus grand des Heros chirmez le triſle cœus, Ef faites iuccéder à ſa vive douleur oophame de pur greables.	Vous, Oivinitez almables, * Du plus grand des Héros chirmez le trisle cœus, Ef faites iuccéder à sa vive douleur oophame de pur gréables.
* La Danſe de ce Divertiſſement à eſtéfaite par Monſieur de Leſtang.	* La Danse de ce Divertissement à estéfaite par Monsieur de Létang.
OSDENSANGVISME.	OSDENSANGUISME.
ACHILE, LES GRACES, LES PLAISIRS.	ACHILE, LES GRACES, LES PLAISIRS.
UNE DES GRACES.	UNE DES GRACES.
Rand Heros, le Ciel vous eſt propice, Vos tertus ſe ſontrendre.	Rand Héros, le Ciel vous est propice, Vos tertus se sontrendre.
juſtice.	justice.
Tout conſpire aulourd’huy A finir voite ennuy.	Tout conspire aulourd'hui A finir cette ennui.
UN PLATSIR.	UN PLATSIR.
cquiouscvauie vos eflarmes,	cquiouscvauie vos élarmes,
Sla lareun en ouront plus de charmes;	Sla lareun en ouront plus de charmes;
VLa Danſe de ce Divertiſſement à eſte faite pur.	VLa Danse de ce Divertissement à este faite pur.
Monſieur de Leſtang.	Monsieur de Létang.
TiepaPreparezvôtre cœur Au plus paifait tonheur.	TiepaPreparezvôtre cœur Au plus paifait tonheur.
DEUX GRACES ET UN PLAISIR.	DEUX GRACES ET UN PLAISIR.
quel mortel oſa jamais pretendte Les ſoins qu’iey nous venons vous rendre!	quel mortel osa jamais prétendte Les soins qu'ie nous venons vous rendre!
Quil veut les merlter Na quea vous ſmiter.	Quil veut les merlter Na que vous smiter.
UNE DES GRACES.	UNE DES GRACES.
C'eſt pour vous que venus nous oppelle, Profitez de nôtre ardeur fidelle, Vous auiez en ce ſeux Tous les plaiſirs des Dieux.	C'est pour vous que venus nous opelle, Profitez de notre ardeur fidèle, Vous aviez en ce seux Tous les plaisirs des Dieux.
UN PLAISIR.	UN PLAISIR.
C'eſt en vain que la haine & l'envle sont d’accord pour froubler tolte vis, Par notte heureur ſecours Vous en trlompherez todjours.	C'est en vain que la haine et l'envle sont d'accord pour froubler tolte vis, Par notte heureur secours Vous en tromphérez todjours.
DEUX GRACES ET UN PLAISIR.	DEUX GRACES ET UN PLAISIR.
Fuiſſicevou pbt nodioins lavonore.	Fuissicevou pt nodioins lavonore.
Ne paſſer que des louis agreables!	Ne passer que des louis agréables!
Eſt.	Est.
il rien de ſi dour Que de vivre avec nous s	il rien de si dour Que de vivre avec nous s
SCENE SIXIEME.	SCÈNE SIXIÈME.
ACHILE, LES GRACES, LES PLAISIRS, ARCAS.	ACHILE, LES GRACES, LES PLAISIRS, ARCAS.
ARCAS.	ARCAS.
O Deplomble coup du ſort!	Ô Ôplomble coup du sort!
ACHILE.	ACHILE.
Ie fremis par le!	Je frémis par le!
ARCAS.	ARCAS.
Pattocle eſt mort.	Pattocle est mort.
ACHI	ACHY
ACHILE.	ACHILE.
Ciel!	Ciel!
quelle aſſreuſe nouvelle!	quelle assreuse nouvelle!
Laiſſez,moy, ſuyez de ces lleux, Vos appos, vos Concerts, & tous les ſoins des Dieux Ne ſçauroient plus ciler mi mitene mortelle.	Laissez,moy, suivez de ces lleux, Vos appos, vos Concerts, et tous les soins des Dieux Ne sauraient plus ciler mi mitene mortelle.
SCENSSSETIEME.	SCENSETIEME.
ACHILE, ARCAS.	ACHILE, ARCAS.
N Ourons vanger cét amy que je pers, Que de ſang & de morus tous ces champs ſoient couveres!	 NOurons venger cet ami que je perds, Que de sang et de morus tous ces champs soient couverez!
Que ſon fier vainqueur perlſie!	Que son fier vainqueur perlsie!
Ie dois à P'amitté cejuſte ſacrifice.	Je dois à P'amitté cejuste sacrifice.
Manes de ce Guetrler dont je pleure le ſort, Ie yous promete uné prompie vangeance, I'en atteſte des Dieux la ſuptéme puiſſance, Ie cours chercher Hectoi, je coure hâter ſa morte Dans l'eternelle nuit fon ombre ve vous ſuivte, Ou moy même aujourd’huy je ceſſeray de vlvre,	Manes de ce Guetrler dont je pleure le sort, Je yous prometé uné prompie vengeance, J'en atteste des Dieux la suptéme puissance, Je cours chercher Hectoi, je coure hâter sa morte Dans l'éternelle nuit son ombre venge vous suivte, Ou moi -même aujourd'hui je cesserai de vlvre,
Fin du premier Aſte,	Fin du premier Aste,
ACTE SECOND.	ACTE SECOND.
Le Theatre repreſente le Camp des Grecs devant Troye;	Le Théâtre représente le Camp des Grecs devant Troie;
ćette ſuperbe Ville paroit dans I'eſoignoment.	ćette superbe Ville parait dans J'esoignoment.
SCENE PREMIERE.	SCÈNE PREMIÈRE.
AGAMEMNON, DIOMEDE.	AGAMEMNON, DIOMEDE.
DIOMEDE.	DIOMEDE.
Vis qu’Achile combat, nous allons triompher, Nôtre victoire eſt certaine, Ceſlez de le haïr, hâtez-vous d’étouffer Le malhéureur Amour qui cauſe vôtre haine.	Vis qu'Achille combat, nous allons triompher, Notre victoire est certaine, Céslez de le haïr, hâtez-vous d'étouffer Le malhéureur Amour qui cause votre haine.
Vous devez rendre à ee HeroLe charmant oujet de ſa flanie.	Vous devez rendre à ce HéroLe charmant oujet de sa flanie.
A e a m a d see.	A À a m à d zée.
Ah, a’ij faut à ce prir aſſute ſon repos, Dieux !	Ah, aj faut à ce prir assute son repos, Dieux !
qu’il en coſtera de tourmens à moneme!	qu'il en côtera de tourments à monème!
DIOMEHE.	DIOMEHÉ.
Si vous pouvlez fléchir la çruelle beauté, Bont votreteas cu camhantey Pexcuſetols une inſuſtles Qui finit oit votre ſort rigoureux:	Si vous pouvlez fléchir la çruelle beauté, Bont votreteas ç amhantey Pexcusets une insutles Qui finit oit votre sort rigoureux:
Mals je dois condamner un ſuneſte caprice Qui vous seud tout enſemble injuſte & malheureux	Mals je dois condamner un suneste caprice Qui vous seud tout ensemble injuste et malheureux
AGAMEMNON.	AGAMEMNON.
Il eſt vray que j'attaque un eour inexorable, ie ne puis flechir ſa rigueur;	Il est vrai que j'attaque un eour inexorable, tu ne puis fléchir sa rigueur;
Mais contez-vous pour rien la flateuſe douceut De rendre un ilval miſerable!	Mais contez-vous pour rien la flatteuse doucut De rendre un ilval misérable!
DIOMEDE.	DIOMEDE.
Le malheur d'un rival flate-t'il vôtte enpuy, Quand vous eſtes encor plus malheureux que luy!	Le malheur d'un rival flatte-t'-il vôtte enpui, Quand vous êtes encor plus malheureux que lui.
RoppelRappellez vôtre coutage, Que la talſon vous degege 8e dea iistq ameules	RopelRappelez votre coutage, Que la talson vous degege 8e dea jitq ameules
AGAMEMNON.	AGAMEMNON.
que peut de la ralſon le tilſte & vain ſeceurs Contie les tralts vainqueurs d’une beauté cruelle!	que peut de la ralson le tilste et vain seceurs Contie les tralts vainqueurs d'une beauté cruelle!
Quaod l’Amout à nos yeux vlent l'oſtut tous lerſouus Avec quelque grace nouvelle.	Quaod l'Amout à nos yeux vlent l'ôtut tous lersouus Avec quelque grâce nouvelle.
Ranimons toutefols mon courage abatu.	Ranimons toutefols mon courage abattu.
C'eſt noi rrii trop long-temps une vaine teudreſſe, auimanious ma foloſsne Ter un deruler effoit digne de ma vertu.	C'est noi ri trop longtemps une vaine teudresse, auimanious ma folossne Ter un deruler effait digne de ma vertu.
DIOMEDE.	DIOMEDE.
Achile eſt trlomphant, Je le vols qui s’avance Suluy de nos Soſdats, charmez de ſi valeur.	Achile est tromphant, Je le vols qui s'avance Sului de nos Sosdats, charmés de si valeur.
ACAASANON Flolgnons.	ACASANON Flolgnons.
nous, evitons la preſence, Ie ne lçaurou encor repondre de mon eœur.	nous, évitons la présence, Je ne laurou encor répondre de mon eœur.
MeidOO.	MeidOO.
ACHILE, CHETS ET SOLDATS	ACHILE, CHÉTS ET SOLDATS
GRECS.	GRECS.
S Gbœur.	S Gbœur.
Verilet tetilble, Soyez toulours invinclble.	Vérilet tetilble, Soyez toulours invinclble.
Que vos 'x plolu Faſſent trembler tous les Rolt Ciel equitable;	Que vos 'x plolu Fassent trembler tous les Rolt Ciel équitable;
Sois luy toujours favorable, Que ſon ronheur .	Soisblé toujours favorable, Que son ronheur .
Soit egal à ſa valeur Guertlen terrlelẽ &o4.	Soit égal à sa valeur Guertlen terrlement et4.
*La Danſe de ce d'vertiſſement à eſté faite par Mr.	*La Danse de ce d'évertissement à doute faite par Mr.
Pecoure.	Pecoure.
Quelle allerteſſe!	Quelle allertesse!
Quel irlouphe pour la Giece!	Quel irlouphe pour la Gièce!
Ses ennemle Luy ſeront blen-tot ſoumle.	Ses ennemle Lui seront blen-tôt soumle.
Guetdler tetrible soyez tpâjours lnvinclble, Que vos erulolte Faſſent trembler tout les Rois.	Guetler tetrible soyez tpâjours lnvinclble, Que vos erulolte Fassent trembler tout les Rois.
DEUX CAPITAINES GRECE.	DEUX CAPITAINES GRÈCE.
Venez tous à l'envy ſecondes nôtte atdeur, Honnoiez votre heureux hetenſeur, Celebrez ſe victoire, Chantez là valeur & ſe ploire.	Venez tous à l'envi secondes nôtte atdeur, Honnoyez votre heureux hétendeur, Clébrez se victoire, Chantez là valeur et se ploire.
que tous nos Rois Charmez de ſes Explolts colent ſoſuls à les loiz.	que tous nos Rois Charmés de ses Explolts colent sosuls à les lois.
Chœur.	Chœur.
suivons, ſuivons ſans ceſſe Ce Hero, ce fameux valnqueur, C’eſt à ſon bras, que la Grece Doit ſa fozce & ſon bonheut.	suivons, suivons sans cesse Ce Hero, ce fameux valnqueur, C'est à son bras, que la Grèce Doit sa fozce et son bonheut.
Chœur.	Chœur.
Chantous la valeur & ſa plojre Du Hleros qui nous a ſauvez, Qu’il jouiſle, apres ſe victolre Des honneurs éclatans à luy ſeul relervez;	Chantous la valeur et sa plojère Du Héros qui nous a sauvez, Qu'il jouisle, après se victolre Des honneurs éclatants à lui seul relevez;
Chamons là valeur & la glolre un Helos quinous Alauvez.	Chamons là valeur et la glolère un Hélos quinous Alauvez.
De ſts heuteux travaus theuſtons la memolte, Conſacrons.	De sts heuteux travaus theutons la mémolte, Consacrons.
luy des jours qu’il nous a conlervez, Chantons la valeur & la gloire Du Heros qui nous a ſaurez.	eux des jours qu'il nous a conlervez, Chantons la valeur et la gloire Du Héros qui nous a saurez.
AGHILE.	AGHILE.
Allez, que chaeun coure ou ſon devolr l'appelle, Vos ſoins pour moy ferolent trop de jaloux, E domes ennenils la vangeance cruelle Ne pourant m’accables tetomberoit ſur vous.	Allez, que chaeun coure ou son dévolr l'appelle, Vos soins pour moi ferolent trop de jaloux, dômes ennenils la vengeance cruelle Ne pourrant m'accables tomberait sur vous.
SCENE	SCÈNE
ACHILE, SCENE TROISIE'ME.	ACHILE, SCÈNE TROISIE'ME.
ARCAS, PRIAM, ANDROMACl.	ARCAS, PRIAM, ANDROMACl.
Ponlaune	Ponlaune
ARGAS.	ARGAS.
Unes, marchez ſans défionce, Les Grecs vous ont donné leur ſoy.	Unes, marchez sans défionce, Les Grecs vous ont donné leur soi.
Achile eſt gencreur, cralgnen iuoins ia preſence, A qu’unomue, dicenes Succéde à vbue eſſtoy.	Achille est gencreur, cralgnen juoins ja présence, A unomue, dicenes Succède à vbue esstoy.
SCENB QUATRIBME.	SCENB QUATRIBME.
PRIAM, ANDROMAQUE, POLIXENE.	PRIAM, ANDROMAQUE, POLIXENE.
H PRIAM.	H PRIAM.
Eſtes infortenez du plus beau ſaus du monde, Pollxene, ma ſne, & vous reuve d’Hector, Melen vcs pleurs aux mieru, & s ’il ſe peut encor.	Êtes infortenez du plus beau saus du monde, Pollxène, ma sne, et vous reve d'Hector, Melen us pleurs aux mierv, et s 'il se peut encor.
Que tour redouble ley noue douleur profonde.	Que tour redouble lei noue douleur profonde.
u du de yveau ucdncos, POLIXENE.	Uu du de yveau ucdncos, POLIXENE.
Pulſſons.	Pulssons.
nou attendelr le coeus De ce ſuperbe vainqueur!	nou attendelr le cœur a ce superbe vainqueur!
SGBNE ENNQVIEME.	SGBNE ENQUIEME.
ACHILE, ARCAS, PRIAM, ANDROMAQUE, POLIXENE.	ACHILE, ARCAS, PRIAM, ANDROMAQUE, POLIXENE.
PRIAM.	PRIAM.
Ous voyes, Guerrler in domptable, Vn Roy qui ſut long teure le plus pulſſant de Rois;	Ous voyez, Guerrler in domptable, Un Roi qui sut long ture le plus pulssant de Rois;
c'eſt ce même Prlam, qui louoit ſous le loix Des Troyeur reuummes, l'Empire redoutable;	c'est ce même Prlam, qui louait sous le lois Des Troyeur revummes, l'Empire redoutable;
C'eſt luy que le dernier de vos fameur Explolu, viens de rendre plus miſerable, Qu’il ne ſut heuieux auueſois.	C'est lui que le dernier de vos fameur Explolu, viens de rendre plus misérable, Qu'il ne sut hévieux auvesais.
AGHILE.	AGHILE.
Le ſort ne peut changer l’auguſte caractere, Donit les Dleux vous ont retêtu, Ie le reſpecte en vous, je plyns votre ventu, Ie ſens expirer mia colere, du deme du teuu duddo puel pure euu sltot que je les vols ou valncus ou ſoumis.	Le sort ne peut changer l'auguste caractère, Donit les Dleux vous ont retêtu, Je le respecte en vous, je plins votre ventu, Je sens expirer mia colère, du dème du trou duddo puel pure eu soltôt que je les vols ou valncus ou soumis.
ANDROMAQUE.	ANDROMAQUE.
I'ay perdu mon époux dons un combat ſuneſle, voire uoleur me l’e rary Mon amour, ches les morte, l'aurolt deja ſurvy.	J'ai perdu mon époux dons un combat sunèle, voire oleur me l'e rari Mon amour, chez les morte, l'aurolt déjà survi.
Sant les ſoins que je doia au ſeul ſih qui me reſte, Vous le ſçavent, Dleux que j'atteſte.	Sant les soins que je doia au seul sih qui me reste, Vous le savent, Dleux que j'atteste.
Au ſort de eet euſunt, mon ſorz eſt aſſeiry i Ie l’ay perdu cet épour que l'adore, Et pour comble d'honeut, je ſtay q'’il eſt encore Indigne.	Au sort de cet eusunt, mon sorz est asseiry y Ie j'ai perdu cet épour que l'adore, Et pour comble d'honeut, je stay je sais il est encore Indigne.
nent prlré, par des ordres cruels D'un drolt que le trepai donne à tous les mortel:	nent prlré, par des ordres cruels D'un drolt que le trepai donne à tous les mortel:
Souſſrez què je le rende auy murs qui l'ont vd nalire, Qu’un ſuperbe Tombeau laſſe du moins connolue La ſplendeur de ſon ſans, ſon ſort & mon amour:	Soussés qu ' un rende avi murs qui l'ont voit nalire, Qu'un superbe Tombeau lasse du moins connue La splendeur de son sans, son sort et mon amour:
Ce Tombeaui ſervii de Temple à voire glolre, Puis que tout l’aveult y verie quelque lour Lhiſtoire de nos maux & de votre victolm, .	Ce Tombeaui servi de Temple à voire glolre, Puis que tout l'aveult y vérie quelque lour Lhistoire de nos maux et de votre victolm, .
4	4
AGEILE.	AGEILE.
Quels regrets!	Quels regrets!
quele triſtes accei!	quele tristes accei!
Dleux!	Dleux!
que ſa douleur eſt tendre!	que sa douleur est tendre!
Que ſes ſoupirs ſout puiſſans!	Que ses soupirs sout puissants!
Que je ſouſſre à les entendre!	Que je soussre à les entendre!
PE i	PE y
PRIAM.	PRIAM.
Par vos ſacrez Ayeux, par le nom de Thedle, Laiſlez, moy reclſelllir le cendies de mon file.	Par vos sacrés Aïeux, par le nom de Thédle, Laislez, moi reclselllir le cendies de mon file.
Pour m’accorder la grace que j'eſpere Souvenez-tous de votte Pere, Et ſonſes que l'Amour il eut toûjours pour vous Ie ſentols pour mon fils une égale tendteſſe;	Pour m'accorder la grâce que j'espère Souvenez-tous de votte Père, Et sonses que l'Amour il eut toujours pour vous Je sentols pour mon fils une égale tendtesse;
Ah t jugez pat l’excés de cet Amour ſi doux Quel doit étre aujour d’huy l’excés de ina iuſteſſe.	Ah t jugez pat l'excès de cet Amour si doux Quel doit être aujour d'hui l'excès de ina justesse.
POLIXENE.	POLIXENE.
Que pourrojrle eſperer du ſecoura de nies pleur, Si mon Pere & ma Soour vous trouvent luſterible!	Que pourrojrle espérer du secoura de nies pleur, Si mon Père et ma Sœur vous trouvent lustérible!
Si vous mépriſez leuis douleurs, A mes plainies, helas!	Si vous méprisez levis douleurs, À mes plainies, hélas!
lereravous plus ſenſible;	lereravous plus sensible;
Sorty du ſang des Dieux imitez leur bonté, as ſer ſcuyna scuuci eu ſavondle, N’augmenter-polut l’exces de nôtre adreiſité Par untefus impitorable.	Sorty du sang des Dieux imitez leur bonté, as ser scuyna scuci eu savondle, N'augmenter-polut l'excès de notre adreisité Par untefus impitorable.
AGHALE.	AGHALE.
Que peut on reſuſer au pouvoir de voe yeux!	Que peut on ressuser au pouvoir de voe yeux!
Vous pouvez tout en ees lieux.	Vous pouvez tout en ces lieux.
Raſſurez-vous, calmez la douleur qui vous preſſe, Emuortez daia vos iurs ce Heros glorieux, Ne cralgnez-point.	Rassurez-vous, calmez la douleur qui vous presse, Emuortez daia vos jurs ce Héros glorieux, Ne cralgnez-point.
les eſforts de la Gtece, I'arréteray ſes deſſelns furieux;	les esforts de la Grèce, J'arrêterai ses desselns furieux;
Sulvez paiueur qui vous anime, Rien ne jous troublera dans ce loin leglilme;	Sulvez paiveur qui vous anime, Rien ne jou troublera dans ce loin léglilme;
le he vals ſonger déſormals Qu'à vous donnet uné éteinelle paix.	le hé us songer désormals Qu'à vous donnet uné éteinelle paix.
Fin du ſecond Acte.	Fin du second Acte.
SCENB PREMIERE.	SCENB PREMIÈRE.
ACHILE, ARCAS.	ACHILE, ARCAS.
ACHILE.	ACHILE.
En eſt ſatt, cher Arcas, j’adore Polizene luoy qu’il en coſte enſin, le veux la poſſeder, C’eſt toy que f'ay cholſi pour l'alles demandet, Coute à Troye, Il eſt temps de ſoulages ma pelne,	En est satt, cher Arcas, j'adore Polisène luoi qu'il en côte ensin, le veux la posséder, C'est toi que s'ai choli pour l'allés demandet, Coute à Troie, Il est temps de soulages ma pelne,
ARCAL Son Pere à vôtre Amour voudra.	ARCAL Son Père à votre Amour voudra.
t’il l'accorées!	t'il l'accorées!
ACHILE.	ACHILE.
Ieu suop euuniou dde desemeues d M.	Jeu suop évuniou dde desemeues d M.
Et de me volt devenir ſon épour;	Et de me volt devenir son épour;
L'amitié que ce nœud fera naitte entre noue soutiendia deſormais ſon Thone & ſa fauille,	L'amitié que ce nœud fera naite entre noue soutiendia désormais son Thone et sa faville,
ARCAt.	ARCAt.
luſte Ciel!	luste Ciel!
dee Troyens vous devenez l’appuy?	dee Troyens vous devenez l'appui?
Loin de les accabler vous voulez les deſendre?	Loin de les accabler vous voulez les désendre?
ACHILE.	ACHILE.
Contte un Peuple abatu, que pourolt-je entte-preudre Aprés ce que mon bras vlent de ſaire aujourd'huy!	Contte un Peuple abattu, que pourolt-je entte-preudre Après ce que mon bras vlent de zaïre aujourd'hui!
Hector ſeul meritoit la ploire De mourls par mes coups, reſte des Troyens apres cette vlctolre Eſt indigue de mon couttoux,	Hector seul méritait la ploire De mourls par mes coups, reste des Troyens après cette vlctolre Est indigue de mon coutoux,
didymxa ulv and alxl dMo.	didymxa ulv and axl dMo.
ACHILE.	ACHILE.
vand apres un cruel tourment IL'aymen ſuccede P Aux tendres deſirs d’un Amant, Que le trouble qui precede Ce bleu heurcux moinent Eſt dour & charmant!	vand après un cruel tourment IL'aimen succède P Aux tendres désirs d'un Amant, Que le trouble qui précède Ce leu heurcux moinent Est dour et charmant!
Mals on vlent en ces Lleux, ma ſurpriſt eſt estémel C'eſt Agame.	Mals on veulent en ces Lleux, ma surprît est estémel C'est Agame.
nnon luy-mſme.	nnon lui-mensme.
SLENDEGME.	SLENDEGME.
ACHILE, AGAMEMNON.	ACHILE, AGAMEMNON.
AGANEMNON.	AGANEMNON.
IE ne ſçaurois plus long-temps Conſecrer cohire vous mes chagrlns & ma halne, M Amtes lu euplonsseicens ( Vn mouvement plus doux pres de vous me tamene:	JE ne saurais plus longtemps Consecrer cohire vous mes chagrîns et ma halne, M Amtes lu euplonsseicens ( Un mouvement plus doux pres de vous me tamène:
Avec les jours d’Hector nos perils ſont paſſez, Troye a perdu le bras qui pouvoit la deiendre.	Avec les jours d'Hector nos périls sont passez, Troie a perdu le bras qui pouvait la deviendre.
ACHILE.	ACHILE.
I'er falt mon det olr, c’eſt aſſet, Vons n’avez point de graces à me rendre:	J'er fallt mon dét ol, c'est asset, Vons n'avez point de grâces à me rendre:
Ie n’ay point cil ſervir ceux qul m'ont outrage.	Je n'ai point cil servir ceux qu 'ont outrage.
Et c'eſt fetroele ſeul que mon bras a vaugé.	Et c'est fétroèle seul que mon bras a vaugé.
ACAMEMNON.	ACAMEMNON.
vâtre colere dure encore, Elle éclate dans vos diſcours:	votre colère dure encore, Elle éclate dans vos discours:
Il faut pour en finir le coure Vous rendre la beauté qui vous aime toſſours, Et que vôtre cœur adore.	Il faut pour en finir le coure Vous rendre la beauté qui vous aime tossours, Et que votre cœur adore.
neues, chamant oblet, reroyez votre amant.	névés, chamant oblet, reroyez votre amant.
SCE	SCE
A ACAMEMNON.	A ÀCAMEMNON.
Mes reſpecte, mes ſouplre, les maiques de ma ſlame N’ont falt qu’allumer ſon courtoux;	Mes respecte, mes souplre, les maiques de ma slame N'ont sal allumer son courtoux;
Ses conſtantes rigueur m’ont appils que ſon ame Ne peut brſler que pour vous.	Ses constantes rigueur m'ont appils que son âme Ne peut brsler que pour vous.
DIOMRDE.	DIOMRDE.
Louïſſez du bouheur que l'amour vous preſente, Que voite ardeur s’augmente Dè moment en moment!	Louissez du bouheur que l'amour vous présente, Que voite ardeur s'augmente Dées moment en moment!
queven un plaur enamaus Aprés une ablence cruelle De ieuouver ſa Maltreſſe fidelle!	queven un plaur enamaus Après une ablence cruelle De ieuouver sa Maltresse fidèle!
SCENE CINQUIEME.	SCÈNE CINQUIÈME.
ACHILE, BRISEIS.	ACHILE, BRISEIS.
BRISESS.	BRISES.
Vel triſte acceüll, Dieux?	Vel triste accevll, Dieux?
qu'eſt ce que le voy?	qu'est ce que le vois?
auu iy cuol bmen ?	auu ji cuol bmen ?
Nſies Vuux mus Achile?	Nysies Vuux mus Achille?
Pouvez-vouz me tevoir, & demeuler tranquie Qu'eſt devenu l'Amour dont vous brûllez pour moy?	Pouvez-vouz me tevoir, et demeuler tranquie Qu'est devenu l'Amour dont vous brûllez pour moi?
Vous ne répondez-point?	Vous ne répondez-point?
BRI	BRY
Helas ACHILE.	Hélas ACHILE.
B a	B a
BRISEIS.	BRISEIS.
que me teur dite Ce tegard, ce ſoſpir echapé malgre vous!	que me teur dite Ce tegard, ce sospir échappé malgré vous!
Ah que mon deſin ſera dour cle en encorpon inoy que tous tamiouple?	Ah que mon désin sera dour clé en encorpon inoi que tous tamiouple?
AGHILE.	AGHILE.
o Clel!	ô Clel!
que le ſuis malheureur!	que le suis malheureur!
Dans quel temps venez-vous m'accables de vos larIDet que ne ſuls.	Dans quel temps venez-vous m'accables de vos larIDet que ne suls.
le à mon gré le maitte de mes vœur!	le à mon gré le maite de mes vœur!
Ie hnron blen-or vos mortens dAines.	Je hannron blen-or vos morts dAines.
Mals un charme fatal.	Mals un charme fatal.
BRISEIS.	BRISEIS.
Perſide, c’eſt aſſer.	Perside, c'est asser.
Ie voy toute mon infortune, Vn autre Amour te rend ma tendreſſo importune, Ie te ſatlgue enſin par mes ſolns empreſſea?	Je vois toute mon infortune, Un autre Amour te rend ma tendresso importune, Je te satlgue ensin par mes solns empressea?
L.	L.
e brult de ceute amour nourelle Eſtols venu juſques à moy, Mals le n’ay pa le croire & ſoupçonner ta ſoy, I'ay cil toncdeur trop grand pour n'ure pas fidele.	eut brult de cute amour nourelle Étols venu jusqu' à moi, Mals le n'ai pay le croire et soupçonner ta soi, J'ai cil toncdeur trop grand pour n'ure pas fidèle.
C'en eſt donc fait?	C'en est donc fait?
Ie ne doit plus peuſtr A I'hymen qul faiſoit toute mon eſperance, A ce luprême honneur il me faut renoncer, D’un Amour ſi par falt, fuueſte recompenſe!	Je ne doit plus peustr A J'hymen qul faisait toute mon espérance, À ce luprême honneur il me faut renoncer, D'un Amour si par fallt, fuueste récompense!
Dleur!	Dleur!
quelle eſt ma douleur?	quelle est ma douleur?
Ie céde à ſon effort.	Je cède à son effort.
Cruel, peux.	Cruel, peux.
tu la voir avec indifference!	tu la voir avec indifférence!
Et ne ſçali-tu pas que ma mort sultra de prés ton Inconſtaucel	Et ne sçali-tu pas que ma mort sultra de près ton Inconstaucel
ACHILE.	ACHILE.
Ie ne puls entendre vne plainte ſi tendte.	Je ne puls entendre une plainte si tendte.
Ie ſouffre autant que vous les Dleux m'en ſont témolns, Faut.	Je souffre autant que vous les Dleux m'en sont témolns, Faut.
il vous lumoler ma viel Ordonnea, ce ſera le plus doux de mes ſoinDe ſatie faire à vone envle?	il vous lumoler ma viel Ordonnea, ce sera le plus doux de mes soinDe satie faire à vonè le?
Mals calmez vos tranſporis & ne m’affligez plue Par dez reproches ſuperſus, vous eonnoiſſes mon cœur incapable de feindre, Ie ſuls moins criminel que le ne ſies à plaindie, Du ſort & de l’Amour l’indiſpenſible loy M emiune miems duganoj.	Mals calmez vos transporis et ne m'affligés plue Par de reproches supersus, vous eonnaisses mon cœur incapable de feindre, Je suls moins criminel que le ne sies à plaindie, Du sort et de l'Amour l'indispensible loi M emiune miems duganoj.
SGENB STATEME.	SGENB STATEME.
BRISEIS.	BRISEIS.
Vel Amant m'eſt ravy?	Vel Amant m'est ravi?
ſa valeur, ſa nobleſſe L elevent au deſſus du teſte des mortels, La vlclolre le ſuli lant ceſſe, Ee ſus moludres vertua merltent des Autele, Pans lę haut rang où ſon deſtin l’appelle I eut eſte patfait, s’il eut eſté fidelle.	sa valeur, sa noblesse L' lèvent au dessus du tête des mortel, La vlclolre le suli lant cesse, Ee sus moludres vertua merltent des Autele, Pans lę haut rang où son destin l'appelle I eut este fait, s'il eut été fidèle.
Mais n’eſt-il pas quęlqua moyen De dltoumner l'Hrmen dùſon cœur ſe prepate?	Mais n'est-il pas quęlqua moyen De dltoumner l'Hrmen dùson cœur se prépatte?
Ahi falſom que luuon couite luy ſe declaie.	Ahjet fallom que luon couite lui se déclaie.
Elle haït tout le ſang Troyen, Et ne ſouffilra pasque cet hymen funeſte Sauvę ain peuyle qu’eſle deteſte.	Elle hait tout le sang Troyen, Et ne souffilra pâque cet hymen funeste Sauv ain peuyle esle deteste.
Tulſſante Reyne des cleux!	Tulssante Reine des cleux!
Eſeoutez.	Éseoutez.
moy, dalgnez jetjer les yeur Sur le malheut qul me menuſſe, Prevencs mi honte & ma moit, En prennant pliſe de mon ſort.	moi, dalgnez jetier les y Sur le malheut qul me menusse, Prévencs mi honte et ma moit, En prennant plise de mon sort.
Des pe-ſides Troyens vous conſondrez l'audire, Mes vœux lont exaucez, lunon deſeend des cleur, Es pour nie ſecourlr s’opproche de ces lieun	Des pé-sides Troyens vous consondrez l'audire, Mes vœux lont exaucez, lunon des des cleur, Es pour nie secourr s'opproche de ces lieun
Junon deſcend ſur ſon Char.	Junon descend sur son Char.
SCENE SEPTIF'ME.	SCÈNE SEPTIF'ME.
duens s RloBra	duens s EloBra
UNON.	UNON.
Alme tes deplaiſlre, ne verſe plus de larmes, LHymen qui cauſe tes ellarmes Ne lere ſamais aclieyé.	Alme tes deplaislre, ne verse plus de larmes, LHymen qui cause tes élarmes Ne le samais aclieyé.
En vain Prlam eroit ſon paü ſauré, Son Throne doit tomber, & de toute ſa gloire Il ne reſtera rlen qu'une giſte memole.	En vain Prlam erait son paü sauré, Son Throne doit tomber, et de toute sa gloire Il ne restera ren qu'une gîte mémole.
Ie vals éroquer des Enſer Là hayne, le Fureur, la Diccorde & l’Envle, Leur preſence ſera ſuivle De cent prodlzes dlrera Sortez de la nult inſurnale Nolres divluitez, vos antres ſont ourera Dans le tenops qu’elles ſorteut des Enſers, ious le Tuoatre eſt obſeures.	Je vals éroquer des Enser Là haine, le Fureur, la Diccorde et l'Envle, Leur présence sera suivle De cent prodses dléra Sortez de la nult insurnale Nolres divluités, vos antres sont ourera Dans le tenops qu'elles sorteut des Ensers, jous le Tuatre est obsures.
ERISEIS L'Horreur deleur Selour, ſe répand caus les Alu:	ERISEIS L'Horreur déleur Selour, se répand caus les Alu:
NON.	NON.
Volez, portez par tout voire rage fatele, veſez dans tous les Cœurs vôtie monel polſou, Chaſſte la Palx de cette tene, Et faites y reyner la Guerre, La vangeance, & la Tralllon.	Volez, portez par tout voire rage fatele, vez dans tous les Cœurs vôtie monel polsou, Chasste la Palx de cette tene, Et faites y reiner la Guerre, La vengeance, et la Tralllon.
Verlez dans tous les Coours voſtre mortel polſon.	Verlez dans tous les Coours votre mortel polson.
BRISEIe.	BRISEIe.
Favorable Deeſſe Taitene le ſucces de ves ſoins.	Favorable Déesse Taitène le succès de vez soins.
NON.	NON.
uu vusla da dss duva sss yesasesms usese De l'effet de ina proieſſe.	Uu vûla da dss duva suss yesases usée De l'effet de ina proiesse.
* La danſe des Furies a eſtt ſiue par Mr.	* La danse des Furies a est siue par Mr.
Le Paug.	Le Paug.
SCENB HUITIBME.	SCENB HUITIBME.
BRISEIS.	BRISEIS.
vnon pout moy vient de ſte deelaref, Elle a Sit à mes y eux celater ſa puiſſanc, It doy tout eſperer De ſa divlne aſtiſtance.	un pout moi vient de sainte délaref, Elle a Sit à mes y eux celater sa puissanc, It dois tout espérer De sa divlne astistance.
Onentend un bruit de Haut-bois & de Flûtes.	Onentend un bruit de Haut-bois et de Flûtes.
Maie quel bruit hermonleux Se fait entendre dans ces lieux!	Maie quel bruit hermonleux Se fait entendre dans ces lieux!
Aur le voy les Berges que lhorleur de la Guenrs Avoit chaſſez de cetus teue, La treve les r’appgle à leur premierdeleer, Et deja leurs chanſons annoncent leur retont.	Aur le vois les Berges que lhorleur de la Guenrs Avait chassez de cet sue, La trouve les rappgle à leur premierdeleter, Et déjà leurs chansons annoncent leur retont.
Que leurs chante irrlient la peles Et la douleur que je ſens!	Que leurs chante irrient la peles Et la douleur que je sens!
13 Fuyons, je ne puis voit leuts plalſirs Innocens Fuls-qu’ils ſont dûs à Polizene.	13 Fuyons, je ne puis voit luts plalsirs Inocents Fuls-qu'ils sont dus à Polizene.
SCE	SCE
SCENENEUFVIE'ME.	SCENENEUFVIE'ME.
TROUPE DE BERGERS ET DE DEROERES.	TROUPE DE BERGERS ET DE DEROURES.
UN BERGER.	UN BERGER.
Prés tant de trouble & de larmes * vn doux repos ſu ccéde à nos allarmes, Bouinell eſeldeis Le genereux Vainqueur qui nous donne la paix,	Près tant de trouble et de larmes * un doux repos su cède à nos alarmes, Bouinel élis Le généreux Vainqueur qui nous donne la paix,
UN BERGER, ET UME BERGERE.	UN BERGER, ET UME BERGÈRE.
Cet heureux jour doit nous charmer, louio Von enaupe mine ſseuis vons renaſſse, Recommençons d'aymer En les toyant paroitre.	Cet heureux jour doit nous charmer, louio Von enaupe mine scevis vons renassse, Recommençons d'aimer En les toyant paraître.
TROIS BERGERS.	TROIS BERGERS.
Cherchons avec empreſſement Ces rettaiis, ces lieux paiſibles Que le Ciel a fait ſeulement Pour le plaſir des cours ſenſibles,	Cherchons avec empressement Ces retaiis, ces lieux paisibles Que le Ciel a fait seulement Pour le plasir des cours sensibles,
UN BERGER, ET UME BERGERE.	UN BERGER, ET UME BERGÈRE.
Triſles bocages Reprener vos ſellillages, ſervez nous roujours D'azlle à nos Amours.	Trisles bocages Reprener vos sellillages, servez nous roujours D'azlle à nos Amours.
Le Chœur.	Le Chœur.
* La danſe de ce divertiſſement a eſté fait par Mr.	* La danse de ce divertissement a été fait par Mr.
P cours.	 Pours.
UN BERGER, ET UNE BEROERE.	UN BERGER, ET UNE BEROURE.
Paix adotable Scyez toujours durable, Sans vous helas!	Paix adotable Scyez toujours durable, Sans vous hélas!
Ces lieux n'ont point d’appas.	Ces lieux n'ont point d'appas.
Le Chœur.	Le Chœur.
Pain aconoſe, Ac.	Pain aconose, Ac.
Le Chœur.	Le Chœur.
Aprés tant de trouble & de larmes Vn doux repos ſuccéde à nos allarmes, Beniſſons à lamais Le genereux Vainqueur qui nous donne la Paiz.	Après tant de trouble et de larmes Un doux repos succède à nos alarmes, Bénissons à lamais Le généreux Vainqueur qui nous donne la Paiz.
Fin du troiſiéme Acte.	Fin du troisième Acte.
Le Theatre repreſente le magnifique Falais de AviRus.	Le Théâtre représente le magnifique Falais de AviRus.
SCERS EREMIERE.	SCERS EREMIÈRE.
POLIXENE, ſeul.	POLIXENE, seul.
Nſin je me voy ſeule, & je puis ſans contrainte, Faire éclater les divers mouvemens Dont mon anie eſt atteiute, Et connoitre du moins quels ſont mes ſentimens.	Nsin je me vois seule, et je puis sans contrainte, Faire éclater les divers mouvements Dont mon anie est atteivte, Et connaître du moins quels sont mes sentiments.
Depuis l’inſtant fatal ou l'invincible Achile A daigné par ſes ſoins ſoulager nôtre ennuy, te lujs cent fois moins tranquile, Et je ſonne toujours à Iny.	Depuis l'instant fatal ou l'invincible Achille A daigné par ses soins soulager notre ennui, te lujet cent fois moins tranquille, Et je sonne toujours à Inui.
Seroit ce qu’en effet una indigne foibleſſe Me previeudroit en ſa faveur?	Serait ce qu'en effet una indigne faiblesse Me previeudroit en sa faveur?
Nou, non, je nie ſouvlen ſans ceſſe Des maux que m'a eauſe ſa ſuneſte veleus, Et le vainqueur d’Hector, le vangeur de la Grers Ne peut avolr aucun droit ſur mon cœur.	No, non, je nie souvlen sans cesse Des maux que m'a eauze sa suneste veleus, Et le vainqueur d'Hector, le vengeur de la Grèrs Ne peut avolr aucun droit sur mon cœur.
C'en eſt fait je trlomphe, & dés ce moment même Ie ne veux plus m'en ſouvenir.	C'en est fait je tromphe, et dès ce moment même Je ne veux plus m'en souvenir.
Tuiſſe, grands Dieux, vôtre pouvoir ſuprême Me condamner & me punir!	Tuisse, grands Dieux, votre pouvoir suprême Me condamner et me punir!
Si jamais.	Si jamais.
Clel!	Clél!
que fais-je!	que fais-je!
& quel manſpoit m’inſplre?	et quel manspait m'insplre?
Malheurenſe, qu'allois.	Malheurense, qu'allais.
je dire?	je dire?
Doit-je faire un ſerment pour ie le pas tenir?	Doit-je faire un serment pour venir le pas tenir?
Ie ſouffre trop dans les cruels combats.	Je souffre trop dans les cruels combats.
Qu’il m'en coſte pour me défendte!	Qu'il m'en côte pour me défendte!
Et je trouve mille appas A me rendre.	Et je trouve mille appas À me rendre.
Mats puils je avouei tans honte, Que l’Amour tienumonte!	Mats puils je avouei tans honte, Que l'Amour tiennonte!
N'éN’écouteray.	N'éN'écouterai.
Je plus uy raiſon ny devoir?	Je plus ui raison était devoir?
Contre ce Dieu leur forte eſt impuiſſante , Eſt il un cœur qui a'exempte De reconnoltte ſon pouvoir!	Contre ce Dieu leur forte est impuissante , Est il un cœur qui a'exempte De reconnoltte son pouvoir!
Ie luy céde aiourd'huy, Tous mes efferts ſont vaine.	Je te cède aiourd'hui, Tous mes efferts sont vaine.
Ie ne puis reſiſter à l'ardeur qui m’enflame;	Je ne puis résister à l'ardeur qui m'enflamme;
Mais de moins, ſi lAmour anpole de ion amne, Cur en laveur au plus bland des numaino.	Mais de moins, si lAmour anpole de ion amne, Cur en laveur au plus bland des numaino.
SCENE SECONDE.	SCÈNE SECONDE.
ANDROMAQUE- POLIXENE.	ANDROMAQUE- POLIXENE.
I AN DROMAQUE.	I AN DROMAQUE.
HI ma ſœur, ſȩavez.	HI ma sœur, savez.
vous qu'Achile Se flate qu’iin hy men tranquile Avant la fin du jour doit vous nuir tous deux!	vous qu'Achille Se flatte qu'yin hy men tranquille Avant la fin du jour doit vous nuir tous deux!
Souffrirez-vous que ce meud s’accompliſſe!	Souffrirez-vous que ce meud s'accomplisse!
Et pouvez vous ſans injuſtice De ce fier ennemy ſavoriſer les vœux?	Et pouvez -vous sans injustice De ce fier ennemi savoriser les vœux?
Auriez-vous oublié que ſa veleur barbate Iyun frere tant aymé pour jamaie vous ſepare!	Auriez-vous oublié que sa veleur barbate Iiun frère tant aimé pour jamaie vous sépare!
D auiſere la teneus ce Pamour des moitels 3 Cette ſanglante mort, ceite affreuſe victoire Toûjouts preſente à ma memoite A condamme mes yeux A des pleurs cternels.	D avisère la teneus ce Pamour des moitels 3 Cette sanglante mort, ce affreuse victoire Toujouts présente à ma mémoite A condamme mes yeux À des pleurs cternels.
POLIXENE.	POLIXENE.
Eſt-ce de moy que mon ſort doit dependre?	Est-ce de moi que mon sort doit dépendre?
Priam ſeul en peut diſpoſer.	Priam seul en peut disposer.
ANEROMAQUE.	ANEROMAQUE.
Par ce détour croyez-vous m'abuſer?	Par ce détour croyez-vous m'abuser?
Non, noa, je cominence à comprendre Qneh ſont vos ſentimens ſecrets, Vos yeux timides & diſtralts Ne me les font que trop eutendre,	Non, nous, je continence à comprendre Qh sont vos sentiments secrets, Vos yeux timides et distralts Ne me les font que trop eutendre,
POLIXENE.	POLIXENE.
haromtouoemo unonos que ioupçonfiez-voue?	haromtouoemo unonos que ioupçonfiez-voue?
ANDRGMAQUE.	ANDRGMAQUE.
Que loln de ſeconder ma haine Vous veriez ſans peine Ce ſuneſte ennemy devenir vôtre époux.	Que loln de seconder ma haine Vous vériez sans peine Ce suneste ennemi devenir votre époux.
Vous voulez jouïr de la gloire De triompher de ſa fierté,  en diremeuol eltode Pour vôtre vanité.	Vous voulez jouir de la gloire De triompher de sa fierté, en diremuol eltode Pour votre vanité.
POLIXENE.	POLIXENE.
Quand je voy ce Heror digne de mon eſtime, centis poun ine, danmoule plus pulant Eſt-ce un grand crime De m’en applaudir en ſecret!	Quand je vois ce Héror digne de mon estime, centis poun ine, danmoule plus pulant Est-ce un grand crime De m'en applaudir en secret!
ADDROMAQUE.	ADROMAQUE.
Aprés un tel aveu je n'ay plus rien à craindre, C'eſt le dernier malheur que je puis redouter Helasf que me ſert de me plaindre?	Après un tel aveu je n'ai plus rien à craindre, C'est le dernier malheur que je puis redouter Hélasf que me sert de me plaindre?
Perſonne ne veut m'écoutes.	Personne ne veut m'écoutes.
Cher époux dont l'illuſtre vie Fut ſi digne d’envie, Tout ion ſang te trahit pour plaire à ton Vainqueur, Ie pleure en valn ta mort, triſte effet de ſes armes, Ie voy mépriſer mes larmes Et par ton Pere & par ta ſœur:	Cher époux dont l'illustre vie Fut si digne d'envie, Tout ion sang te trahit pour plaire à ton Vainqueur, Je pleure en valn ta mort, triste effet de ses armes, Je vois mépriser mes larmes Et par ton Père et par ta sœur:
Mais leur exemple au moine ne peut rien ſur mon ame, Ie ſens encor la mêmeflame Et la même douleur.	Mais leur exemple au moine ne peut rien sur mon âme, Je sens encor la mêmeflame Et la même douleur.
Le ſeul eſpoir dont mon cœur eſt flaté, Ceſt qu’en donnant toujours des pleurs à ta memoiIe reudray ma tidelité Auſſi faineuſe que ta gloire,	Le seul espoir dont mon cœur est flatté, Ç 'en donnant toujours des pleurs à ta mémoiIe revdrai ma tidélité Aussi faineuse que ta gloire,
SCENE TROISIE'ME.	SCÈNE -TROISIE'ME.
POLIXENE, ſeule.	POLIXENE, seule.
Vel reproche fatalt Je tougls de l'entendre, il me fait ſouvenit des conſeils de Caſſandre, Elle me prédit chaque lour Que ſi jamais inon cœur s’abandonne à l’Amour Ma foibieue Iera ſuivie D'éfernelles douleurs;	Vel reproche fatalt Je tougls de l'entendre, il me fait souvenit des conseils de Cassandre, Elle me prédit chaque lour Que si jamais inon cœur s'abandonne à l'Amour Ma faibieue Iera suivie D'éfernelles douleurs;
Elle m'annonce enfin de ſi cruela maſhieure Qu’ils pourront me courer la vie:	Elle m'annonce enfin de si cruela mashieure Qu'ils pourront me courer la vie:
N'importe, je ne puïs changet de ſentiment, Mon cœur eſt occupé d’un objet tiop charmant, Malgré les conſeils qu’on me donne D’une plus vive ardeur je me ſens enflamer, Vn cœur que le peril eſtonne N’eſt pas digne d’aimer.	N'importe, je ne puais changet de sentiment, Mon cœur est occupé d'un objet tiop charmant, Malgré les conseils qu'on me donne D'une plus vive ardeur je me sens enflamer, Un cœur que le péril étonne N'est pas digne d'aimer.
SCENE QUATRIEME.	SCÈNE QUATRIÈME.
PRIAM, POLIXENE, ARCAS ſuite de PRIAM & d’ARCAS.	PRIAM, POLIXENE, ARCAS suite de PRIAM et d'ARCAS.
M PRIAM.	M PRIAM.
A fille, il n'eſt plus tempe de répandte des pleura, volcy le jour heureux qui finit nos malheurs:	À fille, il n'est plus tempe de répandte des pleura, volci le jour heureux qui finit nos malheurs:
Le ſier Achile rend les atmes A tes charmes, Et malgté tous les Greca jaloux de ton honheur.	Le sier Achille rend les atmes A tes charmes, Et malgté tous les Greca jaloux de ton honheur.
4 Il te donne aujourd’huy ſon Empire & ſon Cœur,	4 Il te donne aujourd'hui son Empire et son Cœur,
ARCAS.	ARCAS.
Hinceſſe, ce Heros ne cherche qu'a vous plairg Vous avez en vos mains & ſi vle & ſa mort;	Hincesse, ce Héros ne cherche qu'a vous plaig Vous avez en vos mains et si veule et sa mort;
C'eſt à vous de regler ſon ſort;	C'est à vous de régler son sort;
Il a déja l'aveu de vôtre Pere, Mais pour aſfûrer ſon bonheur, Il veut ſçavoir ſi vôtre cœur toumci dems ne ſela pas coutraire,	Il a déjà l'aveu de votre Père, Mais pour asfûrer son bonheur, Il veut savoir si votre cœur toumci dems ne sela pas coutraire,
POLIXENE.	POLIXENE.
Qeit anez que is Egoy in oruome c’obeir, Ie connois mon devoir, ſe nè le pule trahit.	Qit anez que is Égoi in orvome c'obéir, Je connais mon devoir, se né le pule trahit.
PRIAM.	PRIAM.
Quel changement ſavotable Flate aujourd’huy mes deſirs!	Quel changement savotable Flate aujourd'hui mes désirs!
Aiuois.	Aivais.
le ciſ moulcour endor capable De ſentir quelques plaiſirs?	le cis moulcour endor capable De sentir quelques plaisirs?
Malgré ce changement un chagrin legitime nã trouble la douceur &e s’oppoſe à ſa paix;	Malgré ce changement un chagrin légitime nôtre trouble la douceur été s'oppose à sa paix;
Mais le ſoin de l'Etat eſt le leul qui m'anime, Et je preſere à tout le bien de mes Sujets.	Mais le soin de l'État est le leul qui m'anime, Et je présère à tout le bien de mes Sujets.
Vous, que vôtre ſort intereſſe Dani cet evenem eut leureur, Peuples, montrez vôtre allegreſſe, Par los leux les plus pompens,	Vous, que votre sort intéresse Dani cet événement eut leureur, Peuples, montrez votre allégresse, Par los leux les plus pompents,
SCE	SCE
SCENE CINQUIEME.	SCÈNE CINQUIÈME.
POLIXENE, ARCAS, TROUPE DE TROYENS ET DE TROYENNRS.	POLIXENE, ARCAS, TROUPE DE TROYENS ET DE -THROYENNRS.
UN TRGYEN.	UN TRGYEN.
Os beaux yeux, adorable Princeſſe, » Ont détruit les deſſeins de la Grece, Vn ſeul de vos regdrdꝰ a rangé ſous vos loix Vn Heros dont le noin fait trembler touiſes Rois.	Os beaux yeux, adorable Princesse, " Ont détruit les desseins de la Grèce, Un seul de vos regdrd à rangé sous vos lois Un Héros dont le noin fait trembler touises Rois.
Le Chœur.	Le Chœur.
Vos beaux yeux, auniable Irinceſſe, ac.	Vos beaux yeux, auniable Irincesse, ac.
UNE TROYENNE.	UNE TROYENNE.
Que ne peuvent point vos charmes!	Que ne peuvent point vos charmes!
Tout leur eſt ſoumis, dia diacemama nu dlimen A nos amemis Que ne peuvent point vos charmes, Torvouuponnnute,	Tout leur est soumis, dia diacema nu dlimen A nos amemis Que ne peuvent point vos charmes, Torvouuponnnute,
Le Chœur.	Le Chœur.
Qre m peuvent vos charmes!	Qre m peuvent vos charmes!
DEUX TROTENS.	DEUX TROTENS.
Que l’amôur el puillanr lur les ecruai :	Que l'amôur elle puillanr lur les ecruai :
I enchalee  Peins Les plus redoriddles vain, ueurt.	I enchalée Peins Les plus redoridèles vain, uteurt.
** --4 La Danſe de ce divertiſſement à eſté fatte par Mr.	** --4 La Danse de ce divertissement à été fatte par Mr.
Pecourt.	Pécourt.
UNS TROVENNE.	UNS TROUENNE.
Qu'aprés une grande victoire Vn Guerrjer eſt heureux, Heigait melet aux charmes de la glore L9 daik anuuement des plaiſirs amoureur.	Qu'après une grande victoire Un Guerrier est heureux, Héigait mèlet aux charmes de la glore L9 daik anuement des plaisirs amoureur.
2 UNE TROYENNE.	2 UNE TROYENNE.
vous nioigeieue buin de comeis iejour.	vous nioigeieue buin de coméis toujours.
leux chirmans, revenez dans cette auguſte Cour.	leux chirmants, revenez dans cette auguste Cour.
UN TROYEN, La Pair ramelne ier l'abondance, Faites voir vôtre magificence, Par vos chants redoublez, celebrez ce grand jour, Et de vôtre bonheur reudez grace à l’Amour,	UN TROYEN, La Pair ramelne jer l'abondance, Faites voir votre magificence, Par vos chants redoublés, célébrez ce grand jour, Et de votre bonheur reudez grâce à l'Amour,
Le Chœur.	Le Chœur.
La Paix rameine iey l'abondance, faiſons von nons mſuneenes, Tar nos chants redou blez, celebrons ce grand jour, Et de noue bonheur rendone grace à l’Ainous,	La Paix ramène menti l'abondance, faisons von nons msuneenes, Tar nos chants redou lez, célébrons ce grand jour, Et de noue bonheur rendone grâce à l'Ainous,
Fin du quatriíme Ade.	Fin du quatrime Ade.
TRAGEDIE.	TRAGÉDIE.
ACTE CINQUIE'ME.	ACTE CINQUIE'ME.
Le Theatre repreſente l’avenuë & le Temple d EsFesalay	Le Théâtre représente l'avenue et le Temple d EsFesalay
J iivi l iuurl n De	 Jivi lu jourl n De
ACHILE.	ACHILE.
H, que lur moy l'Amour regne avee violence?	H, que lur moi l'Amour règne ave violence?
Que de tranſports puiſſans mon cœur eſt agite.	Que de transports puissants mon cœur est agite.
Mais j'apperçoy la divine beauté Qui cauſe mon impatlence, Son Pere la couduit, & vient ſur ces Autels Eniendee & conſirmez nc ſermens iautuele.	Mais j'aperçois la divine beauté Qui cause mon impatlence, Son Père la couduit, et vient sur cette Autels Eniendée et consirmés n sermens cole.
ACHILE, ARCAS, POLIXENE, CHOEUR DE GRECS DE LA SUITE D'ACHILE, CHOEUR DE IROIENS ET DE FILLES TROYENNES QUI SUIVENZ PRIAMET POLIXENE.	ACHILE, ARCAS, POLIXENE, CHOEUR DE GRECS DE LA SUITE D'ACHILE, CHOEUR DE JROIENS ET DE FILLES TROYENNES QUI SUIVENZ PRIAMET POLIXENE.
ACHIL’E.	ACHIL'E.
Rinceſſe enſin le Ciel feponcu mou aiunte;	Rincesse ensin le Ciel féponcu mou aiunte;
Il aſſure à mon cœur les plaiſirs les plus doux, Alil que mon lort doit falre de jaloux!	Il assure à mon cœur les plaisirs les plus doux, Alil que mon lort doit falère de jaloux!
Si l'Hymen dont l’eſpoir m’enchante N’eſt pus un ſupplice pour vous.	Si l'Hymen dont l'espoir m'enchante N'est pus un supplice pour vous.
Quoy?	Quoi?
Quoy?	Quoi?
ce tranſport ne ſert qu’à vous confondre?	ce transport ne sert qu'à vous confondre?
Craignez-vous de me répondre) Tourquoy tourner vos yeur de tomes parts?	Craignez-vous de me répondre) Tourquoi tourner vos yeur de tomes parts?
N’oſez-voris ſur moy ſeul arreter vos tegarde!	N'osez-voris sur moi seul arrêter vos tegarde!
Parler, beauté charmante, Le don de votre cœur ſuivre t’il vôire ſoy	Parler, beauté charmante, Le don de votre cœur suivre t'il vôire soi
POLIXENE.	POLIXENE.
Hélas!	Hélas!
plus je vous voy, Ei plus mon trouble s’augmente	plus je vous vois, Ei plus mon trouble s'augmente
ACHILE.	ACHILE.
ns en Ma faveu Erpliquer ce profond ſilencet	ns en Ma faveu Erpliquer ce profond silencet
POLIXSNE.	POLIXSNE.
Vn Heros tel que vous, quan dil donne ſon eœus, N'eſt-il pas aſſuré de la reconnoiſſance?	Un Héros tel que vous, quan dil donne son eœus, N'est-il pas assuré de la reconnaissance?
ACHILE.	ACHILE.
D'en eſt nop;	D'en est nop;
ves bontez pallent mon elbeninee.	vez bontés pallent mon elbeninee.
SCENE TROISIE'ME.	SCÈNE -TROISIE'ME.
ACHILE, PRIAM, POLIXENE, ARCRS, TROUPEDE GRECS, TROUPHDE TROYENS REBETROTANNEO.	ACHILE, PRIAM, POLIXENE, ARCRS, TROUPEDE GRECS, TROUPHÉ TROYENS REBETROTANNE.
PRIAM.	PRIAM.
» Ommençons à joüir en ee lour Des plaiſirs que la paix nous rameine Let Fux de la haitte Cedent à ceux de l’Amour.	" Ommençons à jouir en ce lour Des plaisirs que la paix nous ramène Let Fux de la haite Cédent à ceux de l'Amour.
PRIAM, ACHILE, POLIXENE.	PRIAM, ACHILE, POLIXENE.
Commençons à jouïr en ce jour Des planita que in pain hous mmeme Les feux de la haine Cadent àceux de l'Amour.	Commençons à jouir en ce jour Des planita que in pain ous même Les feux de la haine Cadent àceux de l'Amour.
ACHILE.	ACHILE.
Peuples ſoumia à mes loir, Secondez les tranſports de mon ame;	Peuples soumia à mes loir, Secondez les transports de mon âme;
loigner vos voir Pour chanter les beautez de l'Objet qui m'enſlime,	loigner vos voir Pour chanter les beautés de l'Objet qui m'enslime,
PRIAM.	PRIAM.
Peüples ſoumis à mes loint, vous jouïſſez d'un ſon tranquile, Ioignez vos voix Pour charuer les vertus & le bonheur d'Achlle.	Peüples soumis à mes loint, vous jouissez d'un son tranquille, Joignez vos voix Pour charuer les vertus et le bonheur d'Achille.
Le Chœur.	Le Chœur.
Que tous ces lieux tetentiſſent Du nom de ces heureux époux, 1 Que l’Amont & l’tiymen les uniſſent De leurs nœuds les plus doux.	Que tous ces lieux tentissent Du nom de ces heureux époux, 1 Que l'Amont et l'timen les unissent De leurs nœuds les plus doux.
* La Danſe de ce Divertiſſement à eſtífaite par Monſieur Leſtang.	* La Danse de ce Divertissement à estífaite par Monsieur Létang.
UN GRBC.	UN GRBC.
Ah que vos chaines ſont belles!	Ah que vos chaines sont belles!
Tendres Amans, que vous ſerez heureur!	Tendres Amants, que vous serez heureur!
Seuls dignes l'un de l'autre, & pleine des mêmes ſeur, Egalement charmes, égelemeni fidelles, Tendres Amant, que vous ſerez henreur,	Seuls dignes l'un de l'autre, et pleine des mêmes sûr, Également charmes, égelemeni fidèles, Tendres Amant, que vous serez henreur,
Le Chœur.	Le Chœur.
Tendies Amans, que vous ſerez heureur!	Tendies Amants, que vous serez heureur!
UN GaEC, ET DEUX TROTENNES.	UN GaC, ET DEUX TROTENNES.
Chacun de vous connoit le prlx de ce qu’il alme, Et luy conſuere tous ſes vœux, Gnaeun de ſon Amour rait la gloire ſuprême, Tendies Amans, que vous ſerez heuseus!	Chacun de vous connaît le près de ce qu'il alâme, Et tu consuère tous ses vœux, Gnaeun de son Amour rait la gloire suprême, Tendies Amants, que vous serez heus!
Le Cnœur.	Le Cnœur.
Tendres Amans, que vous ſerez heureur	Tendres Amants, que vous serez heureur
PRIAM.	PRIAM.
Ne perdons plus de precieux momens, Allons ſur les Autels conſacrer les Serment D'une paix éternelle.	Ne perdons plus de précieux momens, Allons sur les Autels consacrer les Serment D'une paix éternelle.
ACHILE, POLIXENE.	ACHILE, POLIXENE.
Ne perdons plus de precleux momens, Allous ſur les Autels conſacrer les Sermens, D'une paix éternelle, Et d’ui.	Ne perdons plus de precleux Dents, Allous sur les Autels consacrer les Serments, D'une paix éternelle, Et d'ui.
Amour tendre & fidele.	Amour tendre et fidèle.
SCE	SCE
TRAGEDIE.	TRAGÉDIE.
SCENE QUATRIFME.	SCÈNE QUATRIFME.
BRISEIS.	BRISEIS.
ve vols jerc'en eſt fait, & mon patſait Amiant Eſpouſe en ee moment Sa nouvelle Maitreſſe.	ve vols jerc'en est fait, et mon patsait Amiant Épouse en ce moment Sa nouvelle Maîtresse.
Ah!	Ah!
Iunon, eſt-ce ainſi que tu tient ta promeſſe!	Junon, est-ce ainsi que tu tient ta promesse!
Eſt-ce ainſ que tu rompa ces funeſtes litne, Oul vont cauſer ma mort & lauver les Troyene?	Est-ce ains que tu rompa ces funestes litne, Oul vont causer ma mort et lauver les Troyène?
vn ſuſte deſeſpoir m’anime, Mon Amour outragé demande une vistime, Courons l’immoler ou perlr;	un suste désespoir m'anime, Mon Amour outragé demande une vistime, Courons l'immoler ou perlrer;
si mes traulpoits ſaloux me font commeftre un crlmePour l'expier je ſuis prète à mourls.	si mes traulpoits saloux me font commeftre un crlmePour l'expier je suis prête à mourls.
SCENECINQUIE'MR.	SCENCINQUIE'MR.
BRISEIS, Chœur de Grecs qui ſortent en deſordre du Temple d’Apollon, ARCAS.	BRISEIS, Chœur de Grecs qui sortent en désordre du Temple d'Apollon, ARCAS.
Le Chœur.	Le Chœur.
Vyons une mort certaine, Nous n'avons plus de deffenſeur.	Vions une mort certaine, Nous n'avons plus dé senseur.
BRISEIS.	BRISEIS.
On courenvous;	On courenvous;
quene iesteur Loin de ces lleux vous entraſne 3	quène jeteur Loin de ces loin vous entrasne 3
Achile ne vit plus.	Achille ne vit plus.
ARCAS.	ARCAS.
BRISEII.	BRISEII.
Ciel!	Ciel!
quel eſt ſon valnqueur?	quel est son valnqueur?
AR	AR
ARCAS.	ARCAS.
Lindigne raviſſeur d’Hlelene Auesannaons aimue ſiole	Lindigne ravisseur d'Hlelene Auesannaons aimue siole
BRISEIS.	BRISEIS.
Quey aimauorauoporaueaeas de la mont	Quei aimavorauoporaveaeas de la mont
SCENE SIXIE'ME TOLIAEND, ERISEIS.	SCÈNE SIIXIE'ME TOLIAND, ERISEIS.
POLIXENE.	POLIXENE.
leux!	leux!
quel horrible ſpectace!	quel horrible spectace!
Le perſide Parla triomphe ſant obſtsele, Iljoilit de ſon crime, & ne me permer peD'embraſſer mon époux mè:	Le perside Parla triomphe sant obstèle, Iljoilit de son crime, et ne me permer péD'embrasser mon époux mèle:
ne aprés ſon trépas, D'uq chux iontel l'ay vl hioper Acllle, I'ay retlé le treit dont il eſtoit percé, Helus!	ne après son trépas, D'uq chux iontel l'ai vl hioper Acllle, J'ai retlé le treit dont il était percé, Hélus!
dans les douleurs dont mon cœur eſt preſſe Ce trait ſacal peur m’eſtre niile.	dans les douleurs dont mon cœur est presse Ce trait sacal peur m'être niile.
BAISSIS Ie vay preſſer nos Cheſt & nos Soldats, De vanser le meurtré d’Achile.	BAISSIS Je vay presser nos Chest et nos Soldats, De vanser le meurtré d'Achille.
Oüy, daut mon deſeſvoir le conduiray leurs paSur les remnparts de vôtre vllle.	Oui, daut mon desesvoir le conduirai leurs paySur les remnparts de votre vll.
Puiſſe le juſte Ciel ſe dechret pour nous!	Puisse le juste Ciel se déchret pour nous!
Et puiſſent auſour d’huy les Teoy ens peris tous.	Et puissent ausour d'hui les Teoi ens péris tous.
SCENE SEPTIE'ME.	SCÈNE SEPTIE'ME.
ET DERNIERE.	ET DERNIÈRE.
POLIXENE A punir les Troyens, cours hlier la vangeance Deun Heros qu’ou vlent d’immoler Laiſſe, moy ſeule icy, ne vien plus me troublePar ton odieuſe preſence.	POLIXENE A punir les Troyens, cours hlier la vengeance Deun Héros qu'ou vlent d'immoler Laisse, moi seule ici, ne viens plus me troublePar ton odieuse présence.
Par c& ſoins éclatans va prouver ton Amour, Pourſuy Paris, fais luy ravit le jour, Au Heros que iu perds l’on te verra lurvivre, Depuis qu’il ne vit plus, rleu ne plaiſt à mes veux, vne ſanglante mort va finir en ces lieux Les horribles tourmens ou lu pene me livie, Ah!	Par ciel soins éclatants va prouver ton Amour, Poursui Paris, fais deux ravit le jour, Au Héros que ju perds l'on te verra lurvivre, Depuis qu'il ne vit plus, rleu ne plaît à mes veux, une sanglante mort va finir en ces lieux Les horribles tourments où lu pene me livie, Ah!
n’eſt il pas moins glorieux De le vanger que de le ſuivre;	n'est il pas moins glorieux De le venger que de le suivre;
Mais quels tuſtes obleis viennenr s’oſttir à moy?	Mais quels tûtes obleis viennenr s'ôttir à moi?
Dieux:	Dieux:
quel ſaiſiſſement!	quel saisissement!
quels tranſporllilquel effroyt Ali!	quels transporllilquel effrait Ali!
je voy mon Epour ſur l’inſernile rivs I'enteuds les crls de ſon ombre plaintive, Elle m'appelle, elle mie tend les bras, Clel!	je vois mon Épour sur l'insernile rivs J'enteuds les crois de son ombre plaintive, Elle m'appelle, elle mie tend les bras, Clél!
je voy dans ſes yeux éclater ſa colere Chere ombre, attends, je vais te lacleſaire S'il ne faut pour te plaire Que caurr au trépes.	je vois dans ses yeux éclater sa colère Chère ombre, attends, je vais te laclesaire S'il ne faut pour te plaire Que caur au trépes.
Quelloil d’uns Amour Etendre!	Quelloil d'uns Amour Étendre!
I'eprouve enfin tous les malſſurs Que Caſſandie cenuio apt me de leſ(mreur voulût eu vain i efaire entcng Et toy qul ieint encorqu, uux de mion Il bu At paſle, dans mes mains pu eciner mar Funtite trait, ſicopt.	J'éprouve enfin tous les malssurs Que Cassandie cenvio apt me de les (mreur voulut eu ici y éfaire entng Et toi qu' ieint encor, ouvux de myon Il bu At pâle, dans mes mains pu eciner mar Funtite trait, sicopt.
iudu Que ton ſecours me ſeie u Si tu franchimon cœur d’une attci .	iudu Que ton secours me seie u Si tu franchimon cœur d'une attci .
elle, lls-avagte Ihy-même au deuant dett q upTiop Top heureux ſi tu m'es fidelle.	elle, l'avagte Ihy-même au devant dét upT opTiop Top heureux si tu m'es fidèle.
C'en eſt taii, le ſucais rdpoud à mon attente, Ie n'ay plus guere à ſouſſtir, Ie ſens quels vais mourlr .	C'en est taii, le suçais rdpoud -à mon attente, Je n'ai plus guère à sousstir, Je sens quels vais mourlir .
Et e'eſt aſſez pour me rendre contente.	Et ép'est assez pour me rendre contente.
Reçoy mon Sant aprés mes pleurs Acuile;	Reçois mon Sant après mes pleurs Acuile;
c’eſt à toy que ſe me ſacrifie;	c'est à toi que se me sacrifie;
Sans tor ſe dételte la vle.	Sans tor se dételte la vle.
Ouy je le juie.	Oui je le juie.
helas.	hélas.
je ſtiiſonne.	je stiisonne.
i meuse.	y meuse.
Fu du cinquiéme, & dernler Ade.	Fu du cinquième, et dernler Ade.
Source gallica.	Source galica.
bnf.	bnf.
fr (Bibliothèque nationale de France	fr (Bibliothèque nationale de France
