B A 2 DESMVSLO A	B A 2 DESMUSLO A
ARGVMENT.	ARGUMENT.
Es Muſes charmées de la glorieuſe reputation de noſtre Monarque, & du ſoin que ſa Majeſté prend de faire fleurir tous les Arts dans l’étenduë de ſon Empire;	Es Muses charmées de la glorieuse réputation de notre Monarque, et du soin que sa Majesté prend de faire fleurir tous les Arts dans l'étendue de son Empire;
quittent le Parnaſſe pour venir à ſa Cour.	quittent le Parnasse pour venir à sa Cour.
Mnémoſine * qui dans les grandes C’eſt la meImages qu’elle conſerue de l’Antiquité, moire.	Mnémosine * qui dans les grandes C'est la meImages qu'elle conserve de l'Antiquité, moire.
ne trouue rien d’égal à cét Auguſte Prince, prend l’occaſion du voyage de ſes Filles pour contenter le juſte deſir qu’elle a de le voir;	ne trouve rien d'égal à cet Auguste Prince, prend l'occasion du voyage de ses Filles pour contenter le juste désir qu'elle a de le voir;
& lors qu’elles arriuent icy fait auec elles l’ouuerture du Theatre par le Dialogue qui ſuit.	et lors qu'elles arrivent ici fait avec elles l'ouverture du Théâtre par le Dialogue qui suit.
DIALOGVE DE MNEMOSINE, ET DES MVSES.	DIALOGUE DE MNEMOSINE, ET DES MUSES.
MNEMOSINE.	MNEMOSINE.
Nfin apres tant de hazards Nous découurons les heureuſes Prouinces Où le plus ſage & le plus grãd des Princes Fait aſſembler de toutes parts La gloire, les Vertus, l’abondance & les Arts.	Nfin après tant de hasards Nous découurons les heureuses Provinces Où le plus sage et le plus grands des Princes Fait assembler de toutes parts La gloire, les Vertus, l'abondance et les Arts.
LES MVSES Rangeons nous ſous ſes loix Il eſt beau de les ſuiure Rien n’eſt ſi doux que de viure A la Cour de LovYs le plus parfait des RoYS.	LES MUSES Rangeons nous sous ses lois Il est beau de les suivre Rien n'est si doux que de vivre À la Cour de Louvis le plus parfait des RoYS.
MNEMOSINE.	MNEMOSINE.
Viuant ſous ſa conduite, Muſes, dans vos Concerts ChanteZ ce qu’il a fait, chantez ce qu’il médite, Et portez-en le bruit au bout de l’Vniuers.	Vivant sous sa conduite, Muses, dans vos Concerts Chantez ce qu'il a fait, chantez ce qu'il médite, Et portez-en le bruit au bout de l'Univers.
Dans ce recit charmant faites ſans ceſſe entendre A l’Empire François ce qu'il doit eſperer,	Dans ce récit charmant faites sans cesse entendre À l'Empire Français ce qu'il doit espérer,
Au monde entier ce qu’il doit admirer, dann dioys ce quus aoinent aprendre,	Au monde entier ce qu'il doit admirer, dann diois ce quus a aprendre,
MNEMOSINE.	MNEMOSINE.
Rangeons nous ſous ſes loix, Il eſt beau de les ſuiure, Rien n'eſt ſi doux que de viure A la Cour de LOVYS, le Modele des ROYS.	Rangeons nous sous ses lois, Il est beau de les suivre, Rien n'est si doux que de vivre A la Cour de LOUIS, le Modèle des ROIS.
t T Ous les Arts établis des-ja dans le RoyauY me ( s’eſtant aſſemblez de mille endroits pour receuoir plus dignement ces doct es Filles de Iupiter, auſquelles ils croyent deuoir leur origine) prennent reſolution de faire en faueur de chacune d’elles vne entrée particuliere.	 TELLES Ous les Arts établis déjà dans le RoyauY me ( s'étant assemblés de mille endroits pour recevoir plus dignement ces doct es Filles de Jupiter, auxquelles ils croient devoir leur origine) prennent résolution de faire en faveur de chacune d'elles une entrée particulière.
Apres quoy pour les honorer toutes enſemble, ils repreſentent la celebre victoire qu’elles remporterent autrefois ſur les neuf Filles de Pierus.	Après quoi pour les honorer toutes ensemble, ils représentent la célèbre victoire qu'elles remportèrent autrefois sur les neuf Filles de Pierus.
Les neuf Sœurs.	Les neuf Sœurs.
Muſes Chantantes.	Muses Chantes.
Meſſieurs le Gros, Fernon l’aiſné, Fernon le jeune, Lange, Cottereau, S.	Messieurs le Gros, Fernon l'aîné, Fernon le jeune, Lange, Cotteau, S.
Iean, & Buffequin Pages de la Muſique de la Chambre.	Jean, et Buffequin Pages de la Musique de la Chambre.
Auger, & Luden Pages de la Chapelle.	Auger, et Luden Pages de la Chapelle.
Les ſept Arts.	Les sept Arts.
Meſſieurs Hedoüin, d’Eſtiual, Gingan, Blondel, Rebel, Magnan, & Gaye.	Messieurs Hédouin, d'Estival, Gingan, Blondel, Rebel, Magnan, et Gaie.
PREMIERE ENTRE’E.	PREMIÈRE ENTRE'E.
II.	II.
ENTRE’E.	ENTRE.
4 Our honorer Melpomene qui preſide à T la Tragedie, l’on fait paroiſtre Pyrâme & Thisbé qui ont ſeruy de ſujet à l’vne de nos plus anciennes pieces de Theatre.	4 Our honorer Melpomene qui preside à T ha Tragedie, l'on fait paraître Pyrâme et Thisbé qui ont servi de sujet à l'une de nos plus anciennes pièces de Théâtre.
Pirâme & Thisbé.	Pirme et Thisbé.
Pyrâme, Monſieur le Grand.	Pyrâme, Monsieur le Grand.
Thisbé, Le Marquis de Mirepoix.	Thisbé, Le Marquis de Mirepoix.
III.	III.
ENTRE’E.	ENTRE.
TAlie, à qui la Comedie eſt conſacrée a Y pour ſon partage vne piece comique repreſentée par les Comediens du Roy, & com-Moliere poſée par celuy de tous nos Poëtes, qui dans Troupe.	TAlie, à qui la Comédie est consacrée a Y pour son partage une pièce comique représentée par les Comédiens du Roi, et com-Moliere posée par celui de tous nos Poètes, qui dans Troupe.
ce genre d’écrire peut le plus juſtement ſe comPalel ada allcelells,	ce genre d'écrire peut le plus justement se comPalel ada allcells,
PASTORALE COMIQVE.	PASTORALE COMIQUE.
NOMS DES ACTEVRS.	NOMS DES ACTEURS.
Iris jeune Bergere.	Iris jeune Bergère.
Lycas riche Paſteur.	Lycas riche Pasteur.
Filene riche Paſteur.	Filène riche Pasteur.
Coridon jeune Berger.	Coridon jeune Berger.
La Grange.	La Grange.
Berger enjoüé.	Berger enjoüé.
Vn Paſtre.	Un Pastre.
Madlle.	Madlle.
de Brie.	de Brie.
Moliere.	Molière.
Deſtiual.	Destiual.
Blondel.	Blondel.
Chaſteau-neuf.	Château-neuf.
Les Sieurs la Pierre, & Fauier.	Les Sieurs la Pierre, et Favier.
Les trois Magiciens aßiſtans & chantans ſont.	Les trois Magiciens assistants et chant sont.
Meſſieurs le Gros, Don, & Gaye.	Messieurs le Gros, Don, et Gaye.
Ils chantent.	Ils chantent.
Eeſſe des appas Ne nous refuſe pas La grace qu’implorent nos bouches, Nous t’en prions par tes rubans, Par tes boucles de diamans, 2 Ton rouge, ta poudre, tes mouches, Ton maſque, ta coëffe & tes gans.	Eesse des appas Ne nous refuse pas La grâce qu'implorent nos bouches, Nous t'en prions par tes rubans, Par tes boucles de diamants, 2 Ton rouge, ta poudre, tes mouches, Ton masque, ta coëffe et tes gans.
82 O toy?	82 Ô toi?
qui peux rendre agreables Les viſages les plus mal-fais, Répens, Venus, de tes attrais Deux ou trois dozes charitables Sur ce muſeau tondu tout frais.	qui peux rendre agréables Les visages les plus malhais, Répens, Venus, de tes attrais Deux ou trois doses charitables Sur ce museau tondu tout frais.
Ah!	Ah!
qu’il eſt beau Le jouuenceau,	qu'il est beau Le jouuenceau,
Deeſſe des appas Ne nous, &c.	Deesse des appas Ne nous, etc.
Ah!	Ah!
Ah!	Ah!
qu’il eſt beau!	qu'il est beau!
ah!	ah!
qu’il eſt beau!	qu'il est beau!
Qu’il va faire mourir de belles:	Qu'il va faire mourir de belles:
Aupres de luy les plus cruelles Ne pouront tenir dans leur peau, Ah!	Auprès de Seigneur les plus cruelles Ne pourront tenir dans leur peau, Ah!
qu’il eſt beau Le jouuenceau!	qu'il est beau Le jouuenceau!
An!	An!
qu u eſt veau:	 est veau:
un:	un:
qu'it eſt beau!	qu'it est beau!
Hſo, ho, ho, ho, ho, ho.	Hso, ho, ho, ho, ho, ho,
S23 u’il eſt joli, Gentil, poli, u’il eſt joly, qu’il eſt joly, Eſt-il des yeux qu’il ne rauiſſe?	 il est joli, Gentil, poli, il est joli? qu'il est joli, Gentil des yeux pil ne y,
Il paſſe en beauté feu Narciſſe Qui fut vn blondin accompli.	Il passe en beauté feu Narcisse Qui fut un blondin accompli.
Auit ep jolr, Gentil, poli, Qu’il eſt joli, qu’il eſt joli, Hi, hi, hi, hi, hi, hi.	Àuit ép jolr, Gentil, poli, Qu'il est joli, qu'il est joli, Hi, hi, hi, hi, hi, hi.
Les ſix Magiciens aſſiſtans, & dançans ſont.	Les six Magiciens assistants, et dançans sont.
Les Sieurs Chicaneau, Bonard, Noblet le cadet, Arnald, Mayeu, & Foignard.	Les Sieurs Chicaneau, Bonard, Noblet le cadet, Arnald, Majeu, et Foignard.
A troiſiéme Scene eſt entre Lycas & FiElene, riches Paſteurs.	À troisième Scène est entre Lycas et FiÉlène, riches Pasteurs.
Filene chante.	Filène chante.
Aiſſez cheres brebis les herbettes naiſſantes I Ces prés & ces ruiſſeaux ont dequoy vous charmer;	Aissez chères brebis les herbettes naissantes I Es près et ces ruisseaux ont dequoy vous charmer;
Mais ſi vous deſirez viure touſiours contentes, Petites innocentes Gardez vous bien d’aymer.	Mais si vous désirez vivre toujours contentes, Petites innocentes Gardez vous bien d'aimer.
Lycas voulant faire des Vers nomme le nom d’iris la Maiſtreſſe en preſence de Filene ſon Riual, dont Filene en colere chante.	Lycas voulant faire des Vers nomme le nom d'iris la Maîtresse en présence de Filène son Rival, dont Filène en colère chante.
ILENE.	ILENE.
Eſt-ce toy que j'entens, temeraire, eſt-ce toy Qui nommes la beauté qui me tient ſous ſa loy?	Est-ce toi que j'entends, téméraire, est-ce toi Qui nommes la beauté qui me tient sous sa loi?
CYCAS, reſpond.	CYCAS, répond.
Ouy c’eſt moy, ouy c'eſt moy.	Oui c'est moi, oui c'est moi.
LENE.	LENE.
Oſes-tu bien en aucune façon Proferer ce beau nom?	Oses-tu bien en aucune façon Proférer ce beau nom?
LAS.	LAS.
Hé pourquoy non?	Hé pourquoi non?
hé pourquoy non?	hé pourquoi non?
LENE.	LENE.
Iris charme mon ame, Et qui pour elle aura Le moindre brin de flâme Il s’en repentira.	Iris charme mon âme, Et qui pour elle aura Le moindre brin de flamme Il s'en repentira.
Ie me moque de cela, Ie me moque de celã.	Je me moque de cela, Je me moque de celants.
LENE.	LENE.
Ie t’eſtrangleray, mangeray, Si tu nommes jamais ma belle:	Je t'étranglerai, mangerai, Si tu nommes jamais ma belle:
Ce que je dis je le feray, Ie t'eſtrangleray, mangeray, Il ſuffit que j'en ay juré:	Ce que je dis je le ferai, Je t'étranglerai, mangerai, Il suffit que j'en ai juré:
Quanu tes Dieux prenuroient ia querele Ie t’eſtrangleray, mangeray, Si tu nommes jamais ma belle.	Quanu tes Dieux prenuraient ja querele -là t'étranglerai, mangerai, Si tu nommes jamais ma belle.
A S Bagatelle, bagatelle.	À S Bagatelle, bagatelle.
A quatriéme Scene eſt entre Lycas & Iris Ejeune Bergere, dont Lycas eſt amoureux.	À quatrième Scène est entre Lycas et Iris Ejeune Bergère, dont Lycas est amoureux.
La cinquiéme Scene eſt entre Lycas & vn Paſtre, qui aporte vn cartel à Lycas de la part de Filene ſon riual.	La cinquième Scène est entre Lycas et un Pastre, qui aporte un cartel à Lycas de la part de Filène son rival.
La ſixiéme Scene eſt entre Lycas & Coridon.	La sixième Scène est entre Lycas et Coridon.
La ſeptiéme Scene eſt entre Lycas & Filene:	La septième Scène est entre Lycas et Filène:
Filene venant pour ſe battre chante.	Filène venant pour se battre chante.
Arreſte, malheureux, Tourne, tourne viſage, Et voyons qui des deux Obtiendra l’auantage.	Arrête, malheureux, Tourne, tourne visage, Et voyons qui des deux Obtiendra l'avantage.
Lycas parle, & Filene reprend.	Lycas parle, et Filène reprend.
C’eſt par trop diſcourir, Allons il faut mourir.	C'est par trop discourir, Allons il faut mourir.
A huitiéme Scene eſt de huit Payſans Lqui venant pour ſeparer Filene & Lycas, prennent querelle & dançent en ſe battant.	À huitième Scène est de huit Paysans Lqui venant pour séparer Filène et Lycas, prennent querelle et dançent en se battant.
Les huit Payſans, ſont.	Les huit Paysans, sont.
Les Sieurs Doliuet, Payſan, Deſonets, Du Pron, La Pierre, Mercier, Peſan, & le Roy.	Les Sieurs Doliuet, Paysan, Désonets, Du Préon, La Pierre, Mercier, Pesan, et le Roi.
A neufiéme Scene eſt entre Coridon jeune LBerger, & les huit Payſans, qui par les perſuaſions de Coridon ſe reconcilient, & apres s’eſtre reconciliez dançent.	À neuvième Scène est entre Coridon jeune LImerger, et les huit Paysans, qui par les persuasions de Coridon se réconcilient, et après s'être réconciliez dançent.
La dixiéme Scene eſt entre Filene, Lycas, & Coridon.	La dixième Scène est entre Filène, Lycas, et Coridon.
L’onziéme Scene eſt entre Iris Bergere, & Coridon Berger.	L'onzième Scène est entre Iris Bergère, et Coridon Berger.
La douziéme Scene eſt entre Iris Bergere, Filene, Lycas, & Obriuon:	La douzième Scène est entre Iris Bergère, Filène, Lycas, et Obrivon:
rhene chante.	rhène chante.
N'attendez pas qu’icy je me vante moy-meſme, Pour le choix que vous balancez:	N'attendez pas qu'ici je me vante moi-même, Pour le choix que vous balancez:
Vous auez, des yeux, je vous ayme;	Vous avez, des yeux, je vous aime;
C’est vous en dire aſſez.	C'est vous en dire assez.
La A treiziéme Scene eſt entre Filene & Lycas, E qui rebutez par la belle Iris, chantent enſemble leur deſelpoir.	La A treiziéme Scène est entre Filène et Lycas, E qui rebutez par la belle Iris, chantent ensemble leur déselpoir.
FILENE.	SILÈNE.
Helas!	Hélas!
peut-on ſentir de plus viue douleur?	peut-on sentir de plus vive douleur?
Nous preferer vn ſeruie Paſteur.	Nous préférer un servie Pasteur.
Ho Ciel!	Ho Ciel!
Hoj0 .	Hoj0 .
YCAS.	YCAS.
LENE.	LENE.
Quelle rigueur?	Quelle rigueur?
Quel coup, LYCAS.	Quel coup, LYCAS.
FILENE.	SILÈNE.
Quoy?	Quoi?
tant de pleurs,	tant de pleurs,
LYCAS.	LYCAS.
2 7 Tant de perſeuerance,	2 7 Tant de persévérance,
Tant de langueur, ILENE.	Tant de langueur, ILENE.
CAS.	CAS.
Tam ue jougrance,	Tam ue jougrance,
Tant de vœux, FILENE.	Tant de vœux, SILÈNE.
CA S Tant de ſoins,	ÇA S Tant de soins,
I ILENE.	I ILENE.
Tant d’ardeur,	Tant d'ardeur,
LYCAS.	LYCAS.
Tant d’amour.	Tant d'amour.
ILENE.	ILENE.
Auec tant de meſpris ſont traittez en ce jour.	Avec tant de mépris sont traités en ce jour.
Ha!	Ha!
cruelle,	cruelle,
Cœur dur.	Cœur dur.
CAS.	CAS.
I ILENE.	I ILENE.
Inhumaine, FILENE.	Inhumaine, SILÈNE.
Inflexible, TCAS.	Inflexible, TCAS.
DENE.	DENE.
Ingrate,	Ingrate,
LYCAS.	LYCAS.
Impitoyable.	Impitoyable.
ILENE.	ILENE.
Tu veux donc nous faire mourir?	Tu veux donc nous faire mourir?
Il te faut contentes	Il te faut contentes
CAS.	CAS.
Il te faut obeïr.	Il te faut obéir.
Mourons Lycas, ILENE.	Mourons Lycas, ILENE.
CAS Mourons Filene.	CAS Mourons Filène.
LENE.	LENE.
Auec ce fer finiſſons noſtre pene.	Avec ce fer finissons notre pene.
Pouſſe, AS.	Pousse, AS.
Ferme.	Ferme.
FILENE.	SILÈNE.
YCAS.	YCAS.
Corap c.	Corap ç.
ILENE.	ILENE.
Allons, va le premier.	Allons, va le premier.
AS.	AS.
Non je veux marcher le dernier.	Non je veux marcher le dernier.
LENE.	LENE.
Puis qu'vn meſme malheur aujourd’huy nous Allons partons enſemble Caſſemble, A quatorziéme Scene eſt d’vn jeune BerLger enjoüé, qui venant conſoler Filene, & Lycas, chante.	Puis qu'autre même malheur aujourd'hui nous Allons partons ensemble Cassemble, À quatorzième Scène est d'un jeune Berger enjoüé, qui venant consoler Filène, et Lycas, chante.
Ha!	Ha!
quelle folie De quitter la vie Pour vne beauté Dont on eſt rebuté:	quelle folie De quitter la vie Pour une beauté Dont on est rebuté:
On peut pour vn objet aymable, Dont le cœur nous eſt fauorable,	On peut pour un objet aimable, Dont le cœur nous est favorable,
SECOND	SECOND
SECOND AIR.	SECOND AIR.
NRoyez-moy, hastons-nous ma Siluie, OVſons bien des momens precieux, ’ontentons icy nostre enuie, De nos ans le feu nous y conuie Nous ne ſçaurions vous & moy faire mieux:	NRoyez-moi, hâtons-nous ma Silvie, OUsons bien des moments précieux, 'ontentons ici notre envie, De nos ans le feu nous y convie Nous ne saurions vous et moi faire mieux:
uand l’Hyuer a glacé nos guerets, Le Printemps vient reprendre ſa place, Et ramene à nos champs leur atrais, Mais helas!	Mais hélasHyuer a glacé nos guérets, Le Printemps vient reprendre sa place, Et ramène à nos champs leur atrais, Mais hélas!
quand l’âge nous glace, Nos beaux jours ne reuiennent jamais.	quand l'âge nous glace, Nos beaux jours ne reviennent jamais.
282 Ne cerchons tous les jours qu’à nous plaire, Soyons y l’vn & l’autre empreſſe?	282 Ne cherchons tous les jours qu'à nous plaire, Soyons y l'un et l'autre empresse?
Du plaiſir faiſons noſtre affaire, 9 Des chagrins ſongeons à nous défaire;	Du plaisir faisons notre affaire, 9 Des chagrins songeons à nous défaire;
Il vient vn temps où l’on en prend aſſez.	Il vient un temps où l'on en prend assez.
uand l’Hyuer à glacé nos guërets, Le Printemps vient reprendre ſa place;	uand l'Hiver à glacé nos guërets, Le Printemps vient reprendre sa place;
Et ramene à nos champs leur atrais, Mais helas!	Et ramène à nos champs leur atrais, Mais hélas!
quand l’âge nous glace, Nos beaux jours ne reuiennent jamais.	quand l'âge nous glace, Nos beaux jours ne reviennent jamais.
Le Berger continuë.	Le Berger continue.
Haſtez-vous d’aimer de meſme, Les momens ſont precieux;	Hâtez-vous d'aimer de même, Les moments sont précieux;
Toſt ou tard il faut qu’on aime, Et le pluſtoſt c’eſt le mieux.	Tôt ou tard il faut qu'on aime, Et le plustost c'est le mieux.
Le Chœur repete.	Le Chœur répète.
Vn autre Berger chante, M.	Un autre Berger chante, M.
le Gros.	le Gros.
En douceurs l’Amour abonde, Tout ſe rend à ſes appas;	En douceurs l'Amour abonde, Tout se rend à ses appas;
Le Chœur repete ces deux vers.	Le Chœur répète ces deux vers.
Le berger conende.	Le berger conende.
Dans vn endroit ſolitaire Fuyons les yeux des jaloux.	Dans un endroit solitaire Fuyons les yeux des jaloux.
Le Chœur.	Le Chœur.
Viuons heureux, aimons nous, Bergere, Vinons heureux aimons nous.	Vivons heureux, aimons nous, Bergère, Vinons heureux aimons nous.
Le Berger.	Le Berger.
Dançons deſſus la fougere, Ionons aux jenx tes pins doux.	Dançons dessus la fougère, Ionons aux jenx tes pins doux.
Le Chœur.	Le Chœur.
Viuons heureux, aimons nous, Bergere, Viuons heureux, aimons nous, Vn autre Berger chante les deux premiers vers, & le Chœur les repete.	Vivons heureux, aimons nous, Bergère, Vivons heureux, aimons nous, Un autre Berger chante les deux premiers vers, et le Chœur les répète.
Aimons, aimons nous touſiours, Siluie, Aimons, aimons nous touſiours.	Aimons, aimons -nous tousiours, Syluie, Aimons, aimons nous toujours.
de perger continue.	de perger continue.
Sans vne ſi douce enuie, A quoy paſſer nos beaux jours?	Sans rendre si douce envie, A quoi passer nos beaux jours?
Le Chœur.	Le Chœur.
Aimons, aimons nous touſiours, Siluie, Aimono s'ummons nous iouſiours.	Aimons, aimons -nous tousiours, Silvie, Aimono s'ummons nous iousiours.
Le Berger.	Le Berger.
Les vrais plaiſirs de la vie Sont dans les tendres Amours.	Les vrais plaisirs de la vie Sont dans les tendres Amours.
Le Chœur.	Le Chœur.
Aimons, aimons nous touſiours, Siluie, Aimons, aimons nous touſiours.	Aimons, aimons -nous tousiours, Syluie, Aimons, aimons nous toujours.
Quatre Bergers, & quatre Bergeres.	Quatre Bergers, et quatre Bergères.
2 Bergers.	2 Bergers.
LE ROY.	LE ROY.
N Le Marquis de Villeroy, les Sieurs Raynal, & la Pierre.	N Le Marquis de Villeroy, les Sieurs Rainal, et la Pierre.
Bergeres.	Bergères.
MADAME.	MADAME.
Madame de Monteſpan, Mademoiſelle de la Valliere, & Mademoiſelle de Touſſy.	Madame de Montespan, Mademoiselle de la Vallière, et Mademoiselle de Touss.
Huit Bergers chantants.	Huit Bergers chantants.
Meſſieurs d’Eſtiual, Hedoüin, Gingan, Blondel, Magnan, Gaye, Buffeguin, & Auger Pages.	Messieurs d'Estival, Hedouin, Gingan, Blondel, Magnan, Gaie, Buffeguin, et Auger Pages.
Huit Bergeres chantantes.	Huit Bergères chantantes.
Meſſieurs le Gros, Fernon l’aiſné, Fernon le jeune, Reber, Cottereau, Eange, & S.	Messieurs le Gros, Fernon l'aîné, Fernon le jeune, Reber, Cotteau, Éange, et S.
Iean, & Luden Pages.	Jean, et Luden Pages.
V.	V.
ENTRE’E.	ENTRE.
N faueur de Clio qui preſide à l’hiſtoire, L( voulant repreſenter quelque grande action des Siecles paſſez ) on n’a pas crû pouuoir en choiſir vne plus illuſtre ny plus propre pour le Ballet que la bataille donnée par Alexandre contre Porrus, & la generoſité que pratiqua ce grand Monarque apres ſa victoire, rendant aux vaincus tout ce que le droit des armes leur auoit oſté.	N rendant aux Clio qui preside à l'histoire, L( voulant représenter quelque grande action des Siècles passez ) on n'a pas crû pouuoir en choisir quelque plus illustre ici plus propre pour le Ballet que la bataille donnée par Alexandre contre Porrus, et la générosité que pratiqua ce grand Monarque après sa victoire, rendant aux vaincus tout ce que le droit des armes leur avait ôté.
AAichunedre ce rorrda einq urecs, & cinq Indiens.	AJchunedre ce rorrda éinq urecs, et cinq Indiens.
Alexandre.	Alexandre.
Monſieur Beauchamp.	Monsieur Beauchamp.
Cinq Grecs.	Cinq Grecs.
Monſieur de Souuille, Meſſieurs La Marre, du Pron, Des-Airs le cadet, & Mayeu.	Monsieur de Souville, Messieurs La Marre, du Pron, Des-Airs le cadet, et Majeu.
Deſcouſteaux Tambour.	Descousteaux Tambour.
Philebert, & Iean Hottere.	Philebert, et Jean Hottère.
Fluſtes.	Flustes.
Porrus.	Porrus.
Monſieur Cocquet.	Monsieur Cocet.
Cinq Indiens.	Cinq Indiens.
Meſſieurs Payſan, du Feu, Arnald, Ioüan, & Noblet le cadet.	Messieurs Paysan, du Feu, Arnald, Ioüan, et Noblet le cadet.
Vagnart.	Vagnart.
Tambour.	Tambour.
Pieſche, & Nicolas Hottere Fluſtes.	Pièche, et Nicolas Hotte Flustes.
VI.	VI.
ENTRE’E.	ENTRE.
Our Calliope Mere des beaux vers, les I Comediens de la ſeule Troupe Royale repreſente vne petite Comedie ou ſont introduits des Poëtes de differents caracteres.	Our Calliope Mère des beaux vers, les I Comédiens de la seule Troupe Royale représente exe petite Comédie ou sont introduits des Poètes de différents caractères.
Nododdoddodeod onou ococonocos  LA SCENE EST DANS la Galerie du Chaſteau-neuf de S.	Nododdoddodeod onou occoconocos LA SCÈNE EST DANS la Galerie du Château-neuf de S.
Germain.	Germain.
A Premiere Scene eſt entre Ariſte & Siluandre qui ſe demandent l’vn à l’autre des auis en attendant le Bal.	À Première Scène est entre Ariste et Silvandre qui se demandent l'Un à l'autre des avis en attendant le Bal.
A Seconde Scene eſt de Monſieur Lira qui offre ſes Sonnets à Siluandre pour la petité Comedie qu’il doit faire.	À Seconde Scène est de Monsieur Lira qui offre ses Sonnets à Silvandre pour la petité Comédie qu'il doit faire.
A troiſieſme Scene eſt d’vne Maſcarade qu’Ariſte a fait preparer pour le Bal, compoſée d’vne dance d’Eſpagnols & d’Eſpagnoles, dont vne partie dance au lon des Inſtruments, & l’autre dance au chant de deux Dialogues.	À troisième Scène est d'une Mascarade qu'Ariste a fait préparer pour le Bal, composée d'une dance d'Espagnols et d'Espagnoles, dont une partie dance au lon des Instruments, et l'autre dance au chant de deux Dialogues.
CASCARADE ESPAGNOLE.	CASCARADE ESPAGNOLE.
Deux Conducteurs de la Maſcarade.	Deux Conducteurs de la Mascarade.
Monſieur le Due de S.	Monsieur le Due de S.
Aignan, & M.	Aignan, et M.
Beauchamp.	Beauchamp.
Espagnols qui dançent.	Espagnols qui dançent.
{ LE RCY.	 CE RECY.
E Monſieur le Grand, le Marquis de Villeroy, le Marquis de Mirepoix, le Marquis de Raſſan.	E Monsieur le Grand, le Marquis de Villeroy, le Marquis de Mirepoix, le Marquis de Rassan.
Eſpagnoles qui dançent.	Espagnoles qui dançent.
MADAME.	MADAME.
Madame de Monteſpan, Madame de Curſol, Meſdemoiſelles de la Valiere, & de Touſſy.	Madame de Montespan, Madame de Cursol, Mesdemoiselles de la Valière, et de Toussy.
Eſpagnols qui chantent en dançant.	Espagnols qui chantent en dançant.
loſeph de Prado, Aguſtin Manuel, Simon Aguado, Marcos Garces.	loseph de Prado, Agustin Manuel, Simon Aguado, Marcos Garces.
Eſpagnoles qui chantent en dançant.	Espagnoles qui chantent en dançant.
Franciſca Vezon, Maria de Anaya, Maria de Valdes, leronima de Olmedo.	Francisca Vezon, Maria de Anaya, Maria de Valdes, léronima de Olmédo.
Eſpagnols qui joüent de la Harpe & des Guitarres.	Espagnols qui joüent de la Harpe et des Guitarres.
Iuan Nauarro, Ioſeph de Loeſia, Pedro Vaſques.	Juan Navarro, Joseph de Loesia, Pedro Vasques.
SEGVNDO DIALOGO.	SÉGUNDO DIALOGO.
Canta Simon Aquado.	Canta Simon Aquado.
Sin amor, la hermoſura No tiene balor, Que ſe aumentan las graçias Teniendo aficion.	Sin amor, la hermosura No tiene balor, Que se aumentan las graçias Teniendo aficion.
Canta Franciſca Vezon.	Canta Francisca Vezon.
Aunque quiera en ſus lazos Prenderme el Amor, No ſeras nunca el dueño De mi coraçon.	Aunque quiera en sus lazos Prenderme elle Amor, No seras elle elle dueoño De mi coraçon.
Cantan todos los miſmos verſos.	Cantan todos los mismos versos.
IMITATION DES Dialogues Eſpagnols, DEVX PREMIER DIALOGVE.	IMITATION DES Dialogues Espagnols, DEUX PREMIER DIALOGUE.
Maria de Anaya.	Maria de Anaya.
A!	À!
qu'en aymant A de maux on s’expoſe!	qu'en aimant A de maux on s'expose!
On ſouffre de tourment!	On souffre de tourment!
Franciſca Vezon.	Francisca Vezon.
Quelque tourment, quelques maux qu'Amour cauſe, Pour tout payer, il ne faut qu’vn moment.	Quelque tourment, quelques maux qu'Amour cause, Pour tout payer, il ne faut qu'un moment.
SECOND DIALOGVE.	SECOND DIALOGUE.
Simon Aquado.	Simon Aquado.
La plus belle Ieuneſſe Sans l’Amour n'eſt rien;	La plus belle Jeunesse Sans l'Amour n'est rien;
Quelque peu de tendreſſe Fait touſiours grand bien.	Quelque peu de tendresse Fait toujours grand bien.
Franciſca Vezon.	Francisca Vezon.
On ne peut s’en deffendre, L’Amour eſt trop doux:	On ne peut s'en défendre, L'Amour est trop doux:
Mais ſi j'ay le cœur tendre Ce n'eſt pas pour vous.	Mais si j'ai le cœur tendre Ce n'est pas pour vous.
SVITE DV PREMIER DIALOGVE.	SVITE DU PREMIER DIALOGUE.
Maria de Anaya.	Maria de Anaya.
Que tous les cœurs Craignent l’Amour pour Maiſtre, Que voi te ceehrs Euitent ſes rigueurs.	Que tous les cœurs Craignent l'Amour pour Maître, Que voi te ceehrs Euitent ses rigueurs.
Franciſca Vezon.	Francisca Vezon.
Jl plaiſt touſiours, tout cruel qu’il puiſſe eſtre, Tous en tſe doux juſques à ſes langueurs.	Il plaît toujours, tout cruel qu'il puisse être, Tous en tse doux jusques à ses langueurs.
ITE DV SECOND DIALOCVE.	ITE DU SECOND DIALOCUE.
Simon Aquado.	Simon Aquado.
Apez, su eſt poßible, Cent fois plus d’appas:	Apez, su est possible, Cent fois plus d'appas:
C’est vn deffaut horrible ue ne m'aimer pas.	C'est un défaut horrible ue ne m'aimer pas.
Franciſca Vezon.	Francisca Vezon.
Vne heureuſe colere Uient vous animer:	Une heureuse colère Uient vous animer:
011 Si vous manquez à plaire Moquez-vous d’aimer.	011 Si vous manquez à plaire Moquez-vous d'aimer.
Baſques.	Basques.
Monſieur le Grand, Monſieur le Marquis de Villeroy, le Marquis de Raſſan, Monſieur de Souuille, Meſſieurs Beauchamp, Chicanneau, Fauier, & la Pierre.	Monsieur le Grand, Monsieur le Marquis de Villeroy, le Marquis de Rassan, Monsieur de Souville, Messieurs Beauchamp, Chicanneau, Favier, et la Pierre.
&*2	et*2
VII.	VII.
ENTREE.	ENTRE.
& recit.	et récit.
N fait paroiſtre Orphée fils de cette O Muſe, qui par les diuers ſons de ſa Lire, exprimant tantoſt vne douleur languiſſante, & tantoſt vn dépit violent, inſpire les meſmes mouuemens à ceux qui le ſuiuent, & entreautre vne Nymphe que le hazard a fait rencontrer ſur l’vn des rochers qu’il attire apres luy, eſt tellement tranſportée par l’effet de cette armonie, qu’elle découure ſans y penſer les ſecrets de ſon cœur par cette Chanſon.	N fait paraître Orphée fils de cette Ô Use, qui par les divers sons de sa Lire, exprimant tantôt douleur languissante, et tantôt un dépit violent, inspire les mêmes mouvements à ceux qui le suivent, et entreautre quelque Nymphe que le hasard a fait rencontrer sur l'un des rochers qu'il attire après lui, est tellement transportée par l'effet de cette armonie, qu'elle découvre sans y penser les secrets de son cœur par cette Chanson.
Amour trop indiſcret, deuoir trop rigoureux, Ie ne ſçay lequel de vous deux Me cauſe le plus de Martyre:	Amour trop indiscret, devoir trop rigoureux, Je ne sais lequel de vous deux Mère cause le plus de Martyre:
Mais que c’eſt vn mal dangereux D’aimer & ne le pouuoir dire.	Mais que c'est un mal dangereux D'aimer et ne le pouvoir dire.
Orphée.	Orphée.
Monſieur de Lully.	Monsieur de Lully.
Nymphe.	Nymphe.
Mademoiſelle Hylaire.	Mademoiselle Hylaire.
Huit Traciens.	Huit Traciens.
Meſſieurs Des-Airs l’aiſné, Des-Airs galand, Nobler l’aiſné, Bonard, Fauier, S.	Messieurs Des-Airs l'aîné, Des-Airs galant, Nobler l'aîné, Bonard, Favier, S.
André, Deſonets, & Foignac.	André, Désonets, et Foignac.
7III.	7III.
ENTRE’E.	ENTRE.
JOur Erato que l’on inuoque particuliereY ment en amour, on a tiré ſix Amans de nos Romans les plus fameux, comme Theagene & Cariclée, Mandane & Cyrus, Polexandre & Alcidiane.	JOur Erato que l'on invoque particulière ment en amour, on a tiré six Amants de nos Romans les plus fameux, comme Théagène et Cariclée, Mandane et Cyrus, Polexandre et Alcidiane.
Trois Amants, & trois Amantes.	Trois Amants, et trois Amantes.
Amans.	Amants.
&Cyrus.	eTCyrus.
LE ROY.	LE ROY.
& Polexandre.	et Polexandre.
Le Marquis de Villeroy.	Le Marquis de Villeroy.
Theagene.	Théagène.
M.	M.
Beauchamp.	Beauchamp.
[Cariclée.	[Cariclée.
Le S.	Le S.
La Pierre.	La Pierre.
Amantes.	Amantes.
Mandane.	Mandane.
M.	M.
Raynal.	Raînal.
Alcidiane.	Alcidiane.
Le Marquis de Mirepoix.	Le Marquis de Mirepoix.
IX.	IX.
IX.	IX.
ENTRE’E.	ENTRE.
Our Polimnie de qui le pouuoir s’eſtend Y ſur l’éloquence & la dialectique, trois Philoſophes Grecs & deux Orateurs Romains ſont repreſentez en ridicule par des Comediens François & Italiens, auſquels on a laiſſé la liberté de compoſer leur rooles.	Our Polimnie de qui le pouvoir s'étend Y sur l'éloquence et la dialectique, trois Philosophes Grecs et deux Orateurs Romains sont représentez en ridicule par des Comédients Français et Italiens, auxquels on a laissé la liberté de composer leur rôles.
Orateurs Latins, & Philoſophes Grecs.	Orateurs Latins, et Philosophes Grecs.
Orateurs Latins.	Orateurs Latins.
Ciceron.	Cicéron.
Harlequin.	Harlequin.
Hortence.	Hortence.
Scaramouche.	Scaramouche.
Senateur.	Sénateur.
Valerio.	Valerio.
Philoſophes Grecs.	Philosophes Grecs.
Democrite.	Democrite.
Montfleury.	Montfleuri.
Heraclite.	Héraclite.
Poiſſon.	Poisson.
Le Cynique.	Le Cynique.
Brecourt.	Brecourt.
ABnIReDns	ÀBnIReDns
Our Terpſicore à qui l’inuention des chans I & des dances ruſtiques eſt attribüée, on fait danſer quatre Faunes & quatre Femmes ſauuages, qui pliant en diuerſes façons des branches d’arbres, en font mille tours differens, & leur danſe eſt agreablement interrompuë par la voix d’vn jeune Satyre.	Our Terpsicore à qui l'invention des chans I et des dances rustiques est attribüée, on fait danser quatre Faunes et quatre Femmes sauvages, qui pliant en diverses façons des branches d'arbres, en font mille tours différents, et leur danse est agréablement interrompue par la voix d'un jeune Satire.
RECIT.	RÉCIT.
du Satyre.	du Satire.
E ſoin de gouſter la vie L'Eſt icy noſtre employ;	E soin de goûter la vie L'Est ici notre emploi;
Chacun y ſuit ſon enuie, C’eſt noſtre vnique loy.	Chacun y suit son envie, C'est notre Tique loi.
1289 E Xiour touſtours nlous injpire Ce qu’il a de plus doux;	1289 E Xjour toujours nlous injpire Ce qu'il a de plus doux;
Ce n'eſt jamais que pour rire Qu'on ayme parmy nous.	Ce n'est jamais que pour rire Qu'on aime parmi nous.
Satyre.	Satire.
M.	M.
Le Gros.	Le Gros.
Quatre Faunes.	Quatre Faunes.
M.	M.
Doliuet, Les Sieurs S.	Dolivet, Les Sieurs S.
André, Noblet l’aiſné, & Des-Airs galand.	André, Noblet l'aîné, et Des-Airs galant.
Quatre Femmes ſauuages.	Quatre Femmes sauvages.
Les Sieurs Bonard, Deſonets, Fauier & Foignac.	Les Sieurs Bonard, Desonets, Favier et Foignac.
AENIREL.	AENIREL.
Pierides.	Pierides.
61 16	61 16
Es neuf Muſes & les neuf Filles de Pierus Ldanſent à l’enuy, tantoſt ſeparément, & tantoſt enſemble, chacune de ces deux troupes aſpirant auec meſme ardeur à triompher de cenle qui luy en oppoſée.	Es neuf Muses et les neuf Filles de Pierus Ldansent à l'envi, tantôt séparément, et tantôt ensemble, chacune de ces deux troupes aspirant avec même ardeur à triompher de cenle qui lui en opposée.
MADAME.	MADAME.
Madame de Monteſpan.	Madame de Montespan.
Madame de Curſol.	Madame de Cursol.
Mademoiſelle de la Valliere.	Mademoiselle de la Vallière.
Mademoiſelle de Touſſy.	Mademoiselle de Toussy.
Mademoiſelle de la Mothe.	Mademoiselle de la Mothe.
Mademoiſelle de Fiennes.	Mademoiselle de Fiennes.
Madame du Ludre.	Madame du Ludre.
Mademoiſelle de Brancas.	Mademoiselle de Brancas.
Muſes.	Muses.
Madame de Villequier.	Madame de Villequier.
Madame de Rochefort.	Madame de Rochefort.
Madame de la Valliere.	Madame de la Vallière.
Madame la Comteſſe du Pleſſis.	Madame la Comtesse du Plessis.
Madame d’Vdicourt.	Madame d'Udicourt.
Madlle.	Madlle.
d’Arquien.	d'Arquien.
Mademoiſelle de Longueual.	Mademoiselle de Longual.
Madlle, de Cologon.	Madlle, de Cologon.
Mademoiſelle de la Marc.	Mademoiselle de la Marc.
XII.	XII.
ENTREE.	ENTRE.
TTRois Nymphes qu’elles auoient choiſies Y pour Iuges de leur diſpute, viennent pour la terminer par leur jugement.	TTRais Nymphes qu'elles avaient choisies Y pour Juges de leur dispute, viennent pour la terminer par leur jugement.
Trois Nymphes Iuges du combat.	Trois Nymphes Juges du combat.
LE ROY.	LE ROY.
8 Le Marquis de Villeroy, & M.	8 Le Marquis de Villeroy, et M.
Beauchamp.	Beauchamp.
XIII.	XIII.
ET DERNIERE ENTREE.	ET DERNIÈRE ENTRE.
Ais les Pierides condamnées ne voulant VTpas ceder, & recommençant la conteſtation auec plus d’aigreur qu’auparauant, forcent Iupiter à punir leur inſolence, en les changeant en oyſeaux.	Ais les Pierides condamnées ne voulant VTpas céder, et recommençant la contestation avec plus d'aigreur qu'auparavant, forcent Jupiter à punir leur insolence, en les changeant en oiseaux.
Iupiter.	Jupiter.
Monſieur Le Grand.	Monsieur Le Grand.
XII	XII
XIV.	XIV.
ENTRE’E.	ENTRE.
Pres tant de Nations differentes que les TA Muſes ont fait paroiſtre dans les aſſemblages diuers dont elles auoient composé le diuertiſſement qu’elles donnent au Roy, il manquoit à faire voir des Turcs & des Maures, & c’eſt ce qu’elles s’auiſent de faire dans cette derniere Entrée, où elles meſlent vne petite Comedie pour donner lieu aux beautez de la Muſique & de la Dance, par où elles veulent finir.	Pres tant de Nations différentes que les TA Muses ont fait paraître dans les assemblages divers dont elles avaient composé le divertissement qu'elles donnent au Roi, il manquait à faire voir des Turcs et des Maures, et c'est ce qu'elles s'avisent de faire dans cette dernière Entrée, où elles mêlent une petite Comédie pour donner lieu aux beautés de la Musique et de la Dance, par où elles veulent finir.
OMEDIE.	OMEDIE.
PERSONNAGES.	PERSONNAGES.
Dom Pedre Gentilhomme Sicilien.	Dom Pèdre Gentilhomme Sicilien.
Moliere.	Molière.
Adraſte Gentilhomme François.	Adraste Gentilhomme Français.
La Grange.	La Grange.
Iſidore Eſclaue Grecque.	Isidore Esclave Grecque.
Madlle.	Madlle.
de Brie.	de Brie.
Zaide Eſclaue.	Zaide Esclave.
Madlle.	Madlle.
Moliere.	Molière.
Haly Turc Eſclaue d’Adraſte.	Hali Turc Esclave d'Andraste.
La Thoriliere.	La Thorilière.
Magiſtrat Sicilien.	Magistrat Sicilien.
Du Croiſy.	Du Croisy.
SCENE PREMIERE.	SCÈNE PREMIÈRE.
Aly amene trois Muſiciens Turcs par TY l’ordre de ſon Maiſtre, pour donner vne Serenade.	Ali amène trois Musiciens Turcs par TY l'ordre de son Maître, pour donner une Serenade.
Les trois Muſiciens ſont.	Les trois Musiciens sont.
Miemeuis bionder, Gaye, & Noblet.	Mièmeeuis bionder, Gaie, et Noblet.
SCENE SECONDE.	SCÈNE SECONDE.
Draſte demande les trois Muſiciens, & pour oonger iidore à metue la ceite à la fencſtre, leur fait chanter entre-eux vne Scene de Comedie.	Draste demande les trois Musiciens, et pour oonger jidore à metue la cite à la fenctre, leur fait chanter entre-eux une Scène de Comédie.
SCENE DE COMEDIE CHANTE’E.	SCÈNE DE COMÉDIE CHANTE.
Blondel, repreſentant le Berger Filene.	Blondel, représentant le Berger Filène.
I du triſte recit de mon inquietude, e guouble le repos de copre fomruue, Rochers ne ſoyeZ point facheZ Quand vous ſçaurez l’exces de mes peines ſecrettes, Tous Rochers que vous eſtes Vous en ſerez touchez.	I du triste récit de mon inquiétude, est guzouble le repos de copre fomrue, Rochers ne soyez point fâchez Quand vous saurez l'excès de mes peines secrètes, Tous Rochers que vous êtes Vous en serez touchez.
AYE, le Berger Tircis:	AYE, le Berger Tircis:
Les oyſeaux réjoüis dés que le jour s’auance, Recommancent leur chants dans ces vaſtes foreſts, Et moy j’y recommance Mes foupiis unguipans & mes triſtes regrets, Ah!	Les oiseaux réjoüis tes que le jour s'avance, Recommancent leur chants dans ces vastes forêts, Et moi j'y recommance Mes soupiis unguipants et mes tristes regrets, Ah!
mon cher Filene.	mon cher Filène.
BLONDEL.	BLONDEL.
Ah!	Ah!
mon cher Tircis.	mon cher Tircis.
AYE.	AYE.
Que je ſens de peines.	Que je sens de peines.
LONDEL.	LONDEL.
Que j’ay de joucn.	Que j'ai de joucn.
YE.	IE.
Rouſours fourde u mes ouux eſt tigratte Climene.	Rousours sourde ouv mes œux est tigratte Climène.
BLONDEL.	BLONDEL.
Cloris n’a point pour moy de regards adoucis.	Cloris n'a point pour moi de regards adoucis.
SAYE, & BLONDEL, chantent enſemble.	SAYE, et BLONDEL, chantent ensemble.
O Loy trop inhumaine, Amour ſi tu ne peux les contraindre d’aymer, Pourquoy leur laiſſe-tu le pouuoir de charmer?	Ô Loi trop inhumaine, Amour si tu ne peux les contraindre d'aimer, Pourquoi leur laisse-tu le pouvoir de charmer?
N OBLET Berger, les interrompt en chantant.	N OBLET Berger, les interrompt en chant.
Pauures Amans, quelle erreur D’adorer des inhumaines;	Pauvres Amants, quelle erreur D'adorer des inhumaines;
Iamais les ames bien ſaines Ne ſe payent de rigueur, Et les faueurs ſont les chaines Qui doiuent lier vn cœur.	Jamais les âmes bien saines Ne se paient de rigueur, Et les faveurs sont les chaînes Qui doivent lier un cœur.
& On voit cent belles icy Auprés de qui je m’empreſſe, A leur voüer ma tendreſſe Ie mets mon plus doux ſoucy;	et On voit cent belles ici Auprès de qui je m'empresse, À leur vendre ma tendresse Je mets mon plus doux souci;
Mais lors que l’on eſt tigreſſe, Ma foy je ſuis tigre außi.	Mais lors que l'on est tigresse, Ma foi je suis tigre aussi.
Blondel & Gaye, reſpondent enſemble.	Blondel et Gaie, répondent ensemble.
ſatureux nelas?	satureux nélas?
qui peut aymer ainſi.	qui peut aimer ainsi.
CENE TROISIESME.	CÈNE -TROISIÈME.
Om Pedre ſort en robe de chambre dans D l'obſcurité, pour taſcher de connoiſtre qui donne la Serenade.	Om Pedre sort en robe de chambre dans D 'obscurité, pour tâcher de connaître qui donne la Serenade.
SCENE	SCÈNE
SCENE ( 'ATRIESME.	SCÈNE ( 'ATRIESME.
Aly promet à ſon Maiſtre de trouuer quelLIque inuention pour faire iȩauoir à Iſidole raſſour qu’on a pour enc.	Aly promet à son Maître de trouver quelLIque invention pour faire iȩauoir à Isidole rassour qu'on a pour enc.
CENE CINQVIESME.	CÈNE CINQUIÈME.
Sidore le plaint a Doin redre du ſoin qu’il  Pillndo nmener pal tout auec Iuy.	Sidore le plaint a Doin redre du soin qu'il Pillndo nener pal tout avec Jui.
CENE SIXIESME.	CÈNE SIXIÈME.
Aly taſchant de deſcouurir à Iſidore la TLpaſſion de ſon Maiſtre, ſe ſert adroitement de cinq Eſclaues Turcs, dont vn chante, & les quutre autres dançent, les propoſant à Dom Pedre comme Eſclaues agreables, & capables de luy donner du diuertiſſement.	Aly tâchant de découvrir à Isidore la TLpassion de son Maître, se sert adroitement de cinq Esclaues Turcs, dont un chante, et les quutre autres dançent, les proposant à Dom Pèdre comme Esclaves agréables, et capables de lui donner du divertissement.
Le Sieur Gaye.	Le Sieur Gaie.
Les quatre Eſclaues Turcs qui dancent, ſont.	Les quatre Esclaves Turcs qui dancent, sont.
M.	M.
Le Preſtre, les Sieurs Chicaneau, Mayeu, & Peſan.	Le Prêtre, les Sieurs Chicaneau, Majeu, et Pesan.
L’Eſclaue Turc Muſicien chante d’abord ces paroles, par leſquelles il pretend exprimer la paſſion d’Adraſte, & la faire connoiſtre à Iſidore, en preſence meſme de Dom Pedre.	L'Esclave Turc Musicien chante d'abord ces paroles, par lesquelles il prétend exprimer la passion d'Andraste, et la faire connaître à Isidore, en présence même de Dom Pèdre.
Vn cœur ardent en tous lieux, SVn amant ſuit vne belle, Mais d’vn jaloux odieux La vigilance eternelle Fait qu’il ne peut que des yeux S’entretenir auec elle, Eſt-il peine plus cruelle Pour vn cœur bien amoureux?	Un cœur ardent en tous lieux, SUn amant suit un belle, Mais d'un jaloux odieux La vigilance éternelle Fait qu'il ne peut que des yeux S'entretenir avec elle, Est-il peine plus cruelle Pour un cœur bien amoureux?
Enſuite dequoy les quatres autres Eſclaues Turcs dancent, puis le Muſicien Eſclaue recom	Ensuite dequoy les quatres autres Esclaves Turcs dancent, puis le Musicien Esclave recom
mence.	menée.
Chiribirida, &c.	Chiribirida, etc.
Lequel perſuadé que Dom Pedre ne ſoupçonne rien, chante encor ces paroles, qui s’adreſſent à Iſidore.	Lequel persuadé que Dom Pèdre ne soupçonne rien, chante encor ces paroles, qui s'adressent à Isidore.
V’Eſt vn ſuplice à tous coups Sous qui cet amant expire, Mais ſi d’vn œil vn peu doux La belle voit ſon martire, Et conſent qu’aux yeux de tous Pour ſes atrais il ſoüpire, Il pouroit bien-toſt ſe rire De tous les ſoins du jaloux.	V'Est un suplice à tous coups Sous qui cet amant expire, Mais si d'un œil un peu doux La belle voit son martyre, Et consent qu'aux yeux de tous Pour ses atrais il soüpire, Il pourrait bientôt se rire De tous les soins du jaloux.
Auſſi-toſt qu’il a chanté craignant toûjours que Dom Pedre ne s’aperçoiue de quelque choſe, il recommence.	Aussitôt qu'il a chanté craignant toujours que Dom Pèdre ne s'aperçoive de quelque chose, il recommence.
Chiribirida, &c.	Chiribirida, etc.
Puis les quatre Eſclaues redançant, enfin Dom Pedre venant à s’aperceuoir de la fourberie, chante à ſon tour ces paroles.	Puis les quatre Esclaves redançant, enfin Dom Pedre venant à s'apercevoir de la fourberie, chante à son tour ces paroles.
CaueZ-vous mes drolles O Que cette Chanſon Sent ſur vos épaules Les coups de baſtons, Chiribirida houcha la, Mi ti non comprara, Ma ti baſtonara, Si ti non andara, Andara, andara, O' ti baſtonara.	Cavez-vous mes drolles Ô Que cette Chanson Sent sur vos épaules Les coups de bâtons, Chiribirida houcha la, Mi ty non comprara, Ma ty bâtonara, Si ty non andara, Andara, Andara, Ô ty bâtonara.
SCENE SEPTIESME.	SCÈNE SEPTIÈME.
Aly rend conte à ſon Maiſtre de ce qu’il Ya fait, & ſon Maiſtre luy fait confidance de l’inuention qu’il a trouuée.	Ali rend compte à son Maître de ce qu'il Ya fait, et son Maître lui fait confidance de l'invention qu'il a trouvée.
Draſte va chez Dom Pedre pour peindre A Iſidore.	Draste va chez Dom Pèdre pour peindre A Isidore.
SCENE HVITIESME.	SCÈNE HVITIESME.
CENE NEVFIESME.	CÈNE NEUFIESME.
SCENE	SCÈNE
SCENE DIXIESME.	SCÈNE DIXIÈME.
Sidore loüe à Dom Pedre les manieres ciuiTles drlaruite.	Sidore loue à Dom Pèdre les manières civitles drlaruite.
SCENE ONZIESME.	SCÈNE ONZIÈME.
7 Aide vient ſe jetter entre les bras de Dom L reure pour le ieruir du relnt couroux d’Adraſte.	7 Aide vient se jeter entre les bras de Dom L ure pour le jervir du relt courroux d'Andraste.
SCENE REVHIDUME.	SCÈNE REUHIDUME.
Draſte feint de vouſoir tuër Zaide, mais n.	Draste feint de vousoir tuer Zaide, mais n.
om pouic obeient de ſuy de moderer ſon couroux.	om pouic obéient de suis de modérer son courroux.
SCENE TREIZIESME.	SCÈNE -TREIZIÈME.
Om Pedre remet Iſidore entre les mains Dd’Adraſté ſous le voile de Zaide.	Om Pedre remet Isidore entre les mains Déd'Adrasté sous le voile de Zaide.
SCENE QVATORZIESME.	SCÈNE QUATORZIÈME.
7 Aide reproche à Dom Pedre ſa jalouſie, & L luy dit qu’Iſidore n’eſt plus en ſon pouuoir.	7 Aide reproche à Dom Pedre sa jalousie, et LE luy dit qu'Isidore n'est plus en son pouvoir.
SCENE.	SCÈNE.
Om Pedre va faire ſes plaintes à vn MaDygiſtrat Sicilien, qui ne l’entretient que d’vne Maſcarade de Maures, qui finit la Comedie, & tout le Balet.	Om Pedre va faire ses plaintes à un MaDygistrat Sicilien, qui ne l'entretient que d'une Mascarade de Maures, qui finit la Comédie, et tout le Balet.
Cette Maſcarade eſt compoſée de pluſieurs ſortes de Maures.	Cette Mascarade est composée de plusieurs sortes de Maures.
Maures, & Maureſques de qualité.	Maures, et Mauresques de qualité.
4 LE I LOY.	4 LE I LOI.
ſioniſeur le Orand, les Marquis de villeroy, & de Raſſan:	sioniseur le Orand, les Marquis de villeroy, et de Rassan:
MADAME.	MADAME.
Mademoiſelle de la Valiere, Madame de Rochefort.	Mademoiselle de la Valière, Madame de Rochefort.
& Mademoiſelle de Brancas.	et Mademoiselle de Brancas.
A N 9 VR LA PERSONNE & le Perſonnage de ceux qui danſent au Ballet.	À NA 9 VR LA PERSONNE et le Personnage de ceux qui dansent au Ballet.
RECIT DE LA MEMOIRE, qui n’eſt point chanté.	RÉCIT DE LA MÉMOIRE, qui n'est point chanté.
Eſt moy qui de l'oubly ſauue les Noms celebres, lEt des temps éloignez, dißipe les tenebres, En vain pour l’Auenir trauaille vn puiſſant ROY, C’eſt autant de perdu ſans moy.	Est moi qui de l'oubli sauve les Noms célèbres, lEt des temps éloignez, dissipe les ténèbres, En vain pour l'Avenir travaille un puissant ROY, C'est autant de perdu sans moi.
εεντε2 Iamais rien n'égala ſa force & ſa lumiere, Mon employ n’eut jamais de ſi noble matiere, Außi quoy que le monde entreprenne aujourd’huy, C'eſt autant de perdu ſans luy.	εεντε2 Jamais rien n'égala sa force et sa lumière, Mon emploi n'eut jamais de si noble matière, Aussi quoi que le monde entreprenne aujourd'hui, C'est autant de perdu sansfois.
PREMIERE ENTRE’E.	PREMIÈRE ENTRE'E.
ASTRES ET PLANETTES.	ASTRES ET PLANETTES.
Pour les Aſtres & les Planettes.	Pour les Astres et les Planètes.
Stres, ce point n’eſt pas en éuidance IXSi c’eſt par vous que le Monde ſe meut, Vous voila tous occupez à la dance, Le Monde va cependant comme il peut.	Stres, ce point n'est pas en éuidance IXSi c'est par vous que le Monde se meut, Vous voilà tous occupez à la dance, Le Monde va cependant comme il peut.
II.	II.
ENTRE’E.	ENTRE.
Pour Monſieur le Grand.	Pour Monsieur le Grand.
Pyrâme.	Pyrâme.
Trame eſtoit vn peu plus triſtes que vous n'étes, LVous auez neantmois, ſon air, & ſes atraits, Thisbé s’y fut mépriſe, & ſans doute vous faites, Tout ce qu’il fit au meurtre prés, Außi pouuoit-il bien ce ſemble à moins de frais Marquer ſa paßion extreſme, D'autres preuues d’amour il eſt vn milion, Vous auriez plus de peine à vous tuer vous meſme Que vous n'auriez de peine à tuer vn Lion:	Trame était un peu plus tristes que vous n'êtes, LUous auez neantmois, son air, et ses atraits, Thisbé s'y fut méprise, et sans doute vous faites, Tout ce qu'il fit au meurtre prés, Aussi pouvait-il bien ce semble à moins de frais Marquer sa passion extrême, D'autres preuves d'amour il est un milion, Vous auriez plus de peine à vous tuer vous même Que vous n'auriez de peine à tuer un Lion:
Si voſtre Ame inquiete, adorable Pyrâme, Vouloit quitter ainſi le beau corps qui la joint, Elle ſeroit vne Ame injuste au dernier point, Et je ne croyrois pas qu’il fut vne pire Ame.	Si votre Âme inquiète, adorable Pyrâme, Voulait quitter ainsi le beau corps qui la joint, Elle serait une Âme injuste au dernier point, Et je ne crois pas qu'il fut une pire .
Pour le Marquis de Mirepoix.	Pour le Marquis de Mirepoix.
Thisbé.	Thisbé.
TOus auez bonne mine, & ne prétendez, pas V Que pour voſtre beauté l’on ſouffre le trépas, Außi la Fable ingénieuſe & ſage Sur l’accident funeſte ou Pyraſme eſt tombé uand elle parle de Thisbé N'accuſe que ſon voule, & non pas ſon viſage.	TOut auez bonne mine, et ne prétendez, pas V Que pour votre beauté l'on souffre le trépas, Aussi la Fable ingénieuse et sage Sur l'accident funeste ou Pyrasme est tombé and elle parle de Thisbé N'accuse que son voule, et non pas son visage.
III.	III.
ENTRE’E.	ENTRE.
Comedie, Moliere & ſa Troupe.	Comédie, Molière et sa Troupe.
Pour Moliere.	Pour Molière.
E célebre Moliere eſt dans vn grand éclat ESon merite eſt connu de Paris juſqu’à Romme Il est auantageux par tout d’eſtre honneſte homme Mais il eſt dangereux auec luy d’eſtre vn Fat.	 célebre Molière est dans un grand éclat ESon mérite est connu de Paris jusqu'à Romme Il est avantageux par tout d'être honnête homme Mais il est dangereux sans avoir avoir Fat.
V.	V.
ENTRE’E.	ENTRE.
BERGERS, ET BERGERES.	BERGERS, ET BERGERES.
Pour LE ROY.	Pour LE ROY.
Berger.	Berger.
IE Berger n’eſt jamais ſans quelque choſe à faire, Et jamais rien de bas n’occupe ſon loiſir, Soit plaiſir, ſoit affaire, Mais l’affaire touſiours va deuant le plaiſir.	JE Berger n'est jamais sans quelque chose à faire, Et jamais rien de bas n'occupe son loisir, Soit plaisir, soit affaire, Mais l'affaire toujours va devant le plaisir.
Il mene des Troupeaux dont la bizarerie Quelque fois tire à gauche au lieu d’aller à droit, Pour telle Bergerie Iamais Paſteur ne fut plus ferme, & plus adroit.	Il mène des Troupeaux dont la bizarerie Quelque fois tire à gauche au lieu d'aller à droit, Pour telle Bergerie Jamais Pasteur ne fut plus ferme, et plus adroit.
Il pouroit de ce faix ſoulager ſa penſée, Mais il ne s’en veut pas repoſer ſur les ſiens;	Il pourrait de ce faix soulager sa pensée, Mais il ne s'en veut pas reposer sur les siens;
La ſaiſon eſt paſſée Où les Bergers dormoient ſur la foy de leurs Chiens.	La saison est passée Où les Bergers dormaient sur la foi de leurs Chiens.
Paiſſez, Brebis, pendant qu’il s’aprejre a détruire Auec tant de Vigueur tous les Loups s’il en vient, Et laiſſez-vous conduire A qui ſçait mieux que vous tout ce qui vous conuient.	Paissez, Brebis, pendant qu'il s'appréjre a détruire Vec tant de Vigueur tous les Loups s'il en vient, Et laissez-vous conduire À qui sait mieux que vous tout ce qui vous convient.
Pour MADAME.	Pour MADAME.
Bergere.	Bergère.
On je ne penſe pas que jamais rien égale N Ces manieres, cet air, & ces charmes vainqueurs, Cep en uouute.	On je ne pense pas que jamais rien égale N Es manières, cet air, et ces charmes vainqueurs, Ce en uouute.
Pour tous les cœurs.	Pour tous les cœurs.
Elle vous prend d’abord, vous enchaiſne, vous tuë, Vous pille juſqu'à l’ame, & puis apres cela Sans eſtre émeuë Vous laiſſe-là.	Elle vous prend d'abord, vous enchaîne, vous tue, Vous pille jusqu'à l'âme, et puis après cela Sans être émue Vous laisse-là.
Telle erreur deuroit eſtre excuſable & legere Qui trompe les plus fins, & leur fait préfumer Qu'eſtant Bergere On peut l’aymer.	Telle erreur devrait avoir excusable et légère Qui trompe les plus fins, et leur fait présumer Qu'étant Bergère On peut l'aimer.
Mais la temerité d’écouure ſa ruyne Pour la jeune Bergere oſant plus qu’il ne faut, Son origine Vient de trop haut.	Mais la témérité d'écouure sa ruine Pour la jeune Bergère osant plus qu'il ne faut, Son origine Vient de trop haut.
Qu'icy tous les reſpects les plus profonds s’aſſemblent Dans vn cœur, vn tel cœur n'en a pas à demy, Tous les Loups tremblent Deuant Mimy.	Qu'ici tous les respects les plus profonds s'assemblent Dans un cœur, un tel cœur n'en a pas à demi, Tous les Loups tremblent Dévant My.
Pour Madame de Monteſpan.	Pour Madame de Montespan.
Bergere.	Bergère.
Ve nous ſerions heureux (Diſent les Loups entr'eux) Sy nous mettions la pate Sur chair ſi delicate, Ne faiſant qu’vn morceau De Bergere & Troupeau:	Ve nous serions heureux (Disent les Loups entr'eux) Sy nous mettions la payte Sur chair si délicate, Ne faisant qu'un morceau De Bergère et Troupeau:
Elle eſt prompte à la fuite, Et garde vne conduite Dont chacun eſt ſurpris;	Elle est prompte à la fuite, Et garde une conduite Dont chacun est surpris;
Mais nous en auons pris Qui tenoient meſme route, Et nous ſerions ſans doute Au comble du bon-heur N’eſtoit ſon chien d’honneur:	Mais nous en avons pris Qui tenaient même route, Et nous serions sans doute Au comble du bonheur N'était son chien d'honneur:
Ce mot poura déplaire, Mais qui ſçaurions nous faire?	Ce mot pourra déplaire, Mais qui saurions nous faire?
Il ne ſort rien de doux De la gueule des Loups.	Il ne sort rien de doux De la gueule des Loups.
Pour Mademoiſelle de la Valiere, Bergere.	Pour Mademoiselle de la Valière, Bergère.
Eune Bergere, en qui le Ciel a mis TTout ce qu’il donne à ſes meilleurs amis, De la beauté, du cœur, de la ſageſſe, Et ſi j’en croy vos yeux, de la tendreſſe, Ne penſeZ pas que je veüille en ce jour Vous cajoller, ny vous parler d’amour, Ie ſçay qu’il eſt dangereux de le faire, Et je craindrois plus que vostre colere:	Éune Bergère, en qui le Ciel a mis TTout ce qu'il donne à ses meilleurs amis, De la beauté, du cœur, de la sagesse, Et si j'en crois vos yeux, de la tendresse, Ne pensez pas que je veuille en ce jour Vous cajoler, ni vous parler d'amour, Je sais qu'il est dangereux de le faire, Et je craindrais plus que votre colère:
D’autres que moy s’en acquiteront mieux, Ie baiſe icy les mains à vos beaux yeux, Et ne veux point d’vn joug comme le voſtre, Ie vous le dy tout franc j’en ayme vn autre, ue cela donc ſoit certain entre nous, Et crû d’ailleurs außi bien que de vous,	D'autres que moi s'en acquitteront mieux, Je baise ici les mains à vos beaux yeux, Et ne veux point d'un joug comme le vôtre, Je vous le dis tout franc j'en aime un autre, ue cela donc soit certain entre nous, Et crû ailleurs aussi bien que de vous,
Sur vn tel point ſoyez deſabusée, Mais, mon amy, qu'elle eſt voſtre visée Me direz-vous, & qui vous force ainſi A me parler d’vn ton ſi radoucy, Et m'attaquer en ſtile d’Elegie Qui de l’amour étale l’énergie?	Sur un tel point soyez désabusée, Mais, mon ami, qu'elle est votre visée Me direz-vous, et qui vous force ainsi À me parler d'un ton si radouci, Et m'attaquer en style d'Elegie Qui de l'amour étale l'énergie?
Moy de l’amour?	Moi de l'amour?
ha jamais ce n’en fut, Mon veritable, & mon vnique but Est de loüer icy voſtre perſonne, C’eſt de l’encens tout pur que je vous donne, Uous me ſemblez, l’ornement du Hameau, Et j'ayme à voir dans vn objet ſi beau Parfaitement l’vne à l’autre aſſortie Et tant de gloire, & tant de modeſtie:	ha jamais ce n'en fut, Mon véritable, et mon unique but Est de louer ici votre personne, C'est de l'encens tout pur que je vous donne, Uous me semblez, l'ornement du Hameau, Et j'aime à voir dans un objet si beau Parfaitement l'une à l'autre assortie Et tant de gloire, et tant de modestie:
Que vous peut-on ſouhaiter, & quel bien?	Que vous peut-on souhaiter, et quel bien?
Ie croy qu’il faut ne vous ſouhaiter rien, L’on ne ſçauroit croiſtre vn bonheur extreſme, Et pour tout dire, enfin que ſçay-je meſme Si meritant tant de proſperitez Vous n'auez point ce que vous meritez.	Je crois qu'il faut ne vous souhaiter rien, L'on ne saurait croître bonheur mme, Et pour tout dire, enfin que sais-je même Si méritant tant de prospérités Vous n'avez point ce que vous méritez.
Si vous l’allez garder ainſi que voſtre Mere Garda touſiours le ſien, Elle s’en aquita de ſi bonne maniere Qu'il ne s’y peut ajouſter rien, Ot mnumienn onore elle garde le Bien En qui toute la France eſpere.	Si vous l'allez garder ainsi que votre Mère Garda toujours le sien, Elle s'en aquita de si bonne manière Qu'il ne s'y peut ajouter rien, Ot mnumienn onore elle garde le Bien En qui toute la France espère.
Pour le Marquis de Villeroy.	Pour le Marquis de Villeroy.
Berger.	Berger.
F Ous aueZ vn air languiſſant V Dont voſtre Troupeau ſe reſſent, En prendre plus de ſoin ſeroit aſſeZ honneſte, Mais à ſi vil employ voſtre cœur ne s’arreſte:	F Un aueZ Mais à si V Emploi votre Troupeau se ressent, En prendre plus de soin serait assez honnête, Mais à si vil emploi votre cœur ne s'arrête:
Quand le Berger eſt jeune & beau Il ne peut durer dans ſa peau, Et volontiers a dans la teſte Autre choſe que ſon Troupeau.	Quand le Berger est jeune et beau Il ne peut durer dans sa peau, Et volontiers a dans la tête Autre chose que son Troupeau.
V.	V.
ENTRE’E.	ENTRE.
COMBAT D’ALEXANDRE	COMBAT D'ALEXANDRE
ET DE PORVS.	ET DE PORUS.
Lexandre & Porus aymoient tant les baL tailles, Qu'enuiron deux mille ans apres leurs funerailles Vous les voyez icy prés à recommencer, Quand on ayme la guerre on ne s’en peut paſſer,	Lexandre et Porus aimaient tant les baL tailles, Qu'environ deux mille ans après leurs funérailles Vous les voyez ici près à recommencer, Quand on aime la guerre on ne s'en peut passer,
VI.	VI.
ENTRE’E.	ENTRE.
Pour des Poëtes.	Pour des Poètes.
Ouuent les Medecins O Ne ſont pas les plus ſains, Encore que leur art de tous maux nous déliure:	Ouvent les Médecins Ô Ne sont pas les plus sains, Encore que leur art de tous maux nous délivre:
Les beaux Eſprits ſont tels, Ils rendent immortels, Et la pluſpart du temps ils n’ont pas dequoy viure.	Les beaux Esprits sont tels, Ils rendent immortels, Et la plupart du temps ils n'ont pas dequoy vivre.
RECIT D’ORPHEE, ui n’eſt point chanté.	RÉCIT D'ORPHÉE, ui n'est point chanté.
E ne vien point icy par mes triſtes accens IDes ſenſibles objets ſuſpendre tous les ſens, Attirer apres moy les Rochers & les Marbres, Faire marcher les Arbres:	E ne viens point ici par mes tristes accends IDes sensibles objets suspendre tous les sens, Attirer après moi les Rochers et les Marbres, Faire marcher les Arbres:
Ma triſteſſe par la ne ſe peut amoindrir, Et c’eſt vn effort inutile, Helas!	Ma tristesse par la ne se peut amoindrir, Et c'est un effort inutile, Hélas!
ce que je veux n’eſt pas ſi difficile, Ie ne veux que toucher vn cœur & l’atendrir.	ce que je veux n'est pas si difficile, Je ne veux que toucher un cœur et l'attendrir.
Non je ne prétens point que l’Amour par ma voix Vienne contraindre icy la Nature & ſes loix, S’il y faut de la force & de la violance, I'ayme mieux le Silance.	Non je ne prétends point que l'Amour par ma voix Vienne contraindre ici la Nature et ses lois, S'il y faut de la force et de la violance, J'aime mieux le Silance.
Aiau viie pai la, dc.	Aiau viie pai la, dc.
II.	II.
ENTR’EE.	ENTRCE.
Pour Monſieur de Lully.	Pour Monsieur de Lully.
Orphée.	Orphée.
VEt Orphée a le gouſt tres-delicat, & fin, I C’eſt l’ornement du ſiecle, & n'eſt rien qu’il n’atire, Soit Hommes, Animaux, Bois, & Rochers enfin Du ſon melodieux de ſa charmante Lire:	VEt Orphée a le goût très-délicat, et fin, I J'est l'ornement du siècle, et n'est rien qu'il n'atire, Soit Hommes, Animaux, Bois, et Rochers enfin Du son mélodieux de sa charmante Lire:
outes ces choſes là le ſuiuent pas à pas, Et de ſon harmonie elles ſont les conqueſtes, Mais ſi vous l’en preſſez il vous dira tout bas Qu'il eſt cruellement fatigué par les Beſtes.	outes ces choses là le suivent pas à pas, Et de son harmonie elles sont les conquêtes, Mais si vous l'en pressez il vous dira tout bas Qu'il est cruellement fatigué par les Bêtes.
VIII.	VIII.
ENTRE’E.	ENTRE.
Cfrus e ideuundre.	Cfrus é devundre.
Pour LE ROY.	Pour LE ROY.
CYRVS.	CYRUS.
Vperbe Antiquité, dont ſi mal à propos OLe ſiecle trop long-temps a ſouffert les repre ches, Et qui vouleZ touſiours à l’égard des Heros Que les plus éloigneZ terniſſent les plus proche Si vous en auez eu nous en auons außi, Et la choſe entre nous doit eſtre égale icy, Mais n'en ſoyons point crûs ny les vns ny l autres Attendons ſur le prix & du Noſtre, & d Voſtres De la Poſterite le juſte Tribunal, L’inuincible LOVIS ne perd rien à l’atter dré, Tantoſt c’eſt vn CYRVS, tantoſt vn Alt	Verbe Antiquité, dont si mal à propos OLe siècle trop longtemps a souffert les repre chez, Et qui voulez toujours à l'égard des Héros Que les plus éloignez ternissent les plus proche Si vous en auez eu nous en avons aussi, Et la chose entre nous doit être égale ici, Mais n'en soyons point crûs les Étendons point ni l' autres Attendons sur le prix et du Notre, et d Vostres De la Postérite le juste Tribun, LOSEinvincible LOUIS ne perd rien à l'ater dré, Tantôt c’est tan TÔT, tantôt un Alt
XANDRE, Et touſiours la Copie atteint l’Original.	XANDRE, Et toujours la Copie atteint l'Original.
Ils ont eu leurs defaux, ces Démons des combas, L’vn ſentit au couroux ſa grande Ame aſſeruie, Et l’Autre eut dans ſa fin quelque choſe de bas Que ceux qui l'ont loüé n'ont point mis dans à vie:	Ils ont eu leurs défauts, ces Démons des combas, L'un sentit au courroux sa grande Âme asservie, Et l'Autre eut dans sa fin quelque chose de bas Que ceux qui l'ont loüé 'ont point mis dans à vie:
LOVIS eſt touſiours ſage, il reigle ſes deſirs, Et ne fait que gliſſer par deſſus les plaiſirs, Sa Vertu forte & plaine eſt vne vertu rare Qui releue, affermit, fortifie, & repare, C’eſt vn fleuue qu’on croit qui va tout renuerſer, Qui ne rencontre point de digue à ſon épreuue, Enfin l’on ſe raſſure, & l’on voit que ce fleuue Tnnonde la campagne afin de l’engraiſſer.	LOUIS est toujours sage, il règle ses désirs, Et ne fait que glisser par -dessus les plaisirs, Sa Vertu forte et plaine est une vertu rare Qui relève, affermit, fortifie, et répare, C'est un fleuve qu'on croit qui va tout renverser, Qui ne rencontre point de digue à son épreuve, Enfin l'on se rassure, et l'on voit que ce fleuve Tondonde la campagne afin de l'engraisser.
Pour le Marquis de Villeroy.	Pour le Marquis de Villeroy.
POLEXANDRE.	POLEXANDRE.
Ve c’eſt vn grand bonheur d’eſtre jeune & 1 bien fait, De l’eſprit & du corps également parfait, Ainſi que Polexandre errant par tout le monde A deſſein de luy reſſembler, Et de pouuoir faire trembler Conſtantinople & Trebiſonde:	Ve c'est un grand bonheur d'être jeune et 1 bien fait, De l'esprit et du corps également parfait, Ainsi que Polexandre errant par tout le monde A dessein de rendre ressembler, Et de pouvoir faire trembler Constantinople et Trébisonde:
Et puis quand vous eſtes tenté D'aller ſecrettement vous embarquer ſur l’onde Eſtre tout à coup arreſté Par vn Geant terrible, & qui porte couronne Dont le fameux pouuoir vous retient enchanté Dans vne des Tours de Peronne:	Et puis quand vous êtes tenté D'aller secrètement vous embarquer sur l'onde Estre tout à coup arrêté Par un Géant terrible, et qui porte couronne Dont le fameux pouvoir vous retient enchanté Dans une des Tours de Peronne:
Faire tous les EſteZ quelque trait de Roman Par où vous ſoyeZ mis les Hyuers en Ecran, Bruſler touſiours d’vn feu qui n’ait rien de profane, Ioint à de grands reſpects pour quelque Alcidiane Deſquels on ſe défait quand il en eſt ſaiſon, Et ſur tout ſe garder de la demangeaiſon De raconter ſes auantures, Et de monirer des cemiures.	Faire tous les Étants quelque trait de Roman Par où vous soyeZ mis les Hivers en Écran, Brûler toujours d'un feu qui n'ait rien de profane, Joint à de grands respects pour quelque Alcidiane Desquels on se défait quand il en est saison, Et sur tout se garder de la démangeaison De raconter ses aventures, Et de monirer des cémivres.
IX.	IX.
ENTRE’E.	ENTRE.
Orateurs & Philoſophes.	Orateurs et Philosophes.
Eſt-ce pas eſtre né ſous vn noble aſcendant N Que d’eſtre vn Orateur, & d’eſtre vn Philoſophe, Quoy qu’il en ſoit beaucoup de fort petite étoffe?	Est-ce pas être né sous un noble ascendant N Que d'être un Orateur, et d'être un Philosophe, Quoi qu'il en soit beaucoup de fort petite étoffe?
Car par vn ordinaire & fatal accident Qui cauſe à la Science vn éternel oprobre, De ces deux compoſeZ il ſe forme vn Pedant Ridicule animal, tres-craſſeux, & peu ſobre.	Car par vn ordinaire et fatal accident Qui cause à la Science un éternel oprobre, De ces deux composez il se forme un Pédant Ridicule animal, très-crasseux, et peu sobre.
X.	X.
ENTRE’E.	ENTRE.
Pour les Paunes.	Pour les Paunes.
l Es gens-cy tiennent en affaire I Vn procedé fort ingenu, L’honneur leur ſemble vne chimere, Et chez eux l’Amour eſt tout nu Comme dans les bras de ſa Cere.	 Las gens-cy tiennent en affaire I n procédé fort ingénu, L'honneur leur semble un chimère, Et chez eux l'Amour est tout nu Comme dans les bras de sa Cere.
I.	I.
ENTRE’E.	ENTRE.
CONTESTATION DES PIERIDES DES MVSES.	CONTESTATION DES PIÉRIDES DES MUSES.
MADAME.	MADAME.
Pieride.	Pierde.
Velle étrange diſpute eſt-ce donc qui s’apreſte?	Velle étrange dispute est-ce donc qui s'apprête?
Qui vous a, je vous prie, ozé mettre en la teſte, Muſes, que nous eſtions jalouſes de vous, nous?	Qui vous a, je vous prie, zé mettre en la tête, Muses, que nous étions jalouses de vous, nous?
Adame, nous auons vn grand reſpect M pour vous;	Adame, nous avons un grand respect M pour vous;
Auous dire le vray de perſonne à perſonne D'vne commune voix vous aurez la couronne:	Avous dire le vrai de personne à personne D'une commune voix vous aurez la couronne:
Mais ſi voſtre bonté nous permet vne fois D’apuyer nos raiſons, & ſoûtenir nos droits, Pour noſtre gain de cauſe à la face des Hommes Il ſuffit en ce lieu d’alleguer que nous ſommes Filles de Iupiter, vous de Pierius:	Mais si votre bonté nous permet une fois D'appuyer nos raisons, et soutenir nos droits, Pour notre gain de cause à la face des Hommes Il suffit en ce lieu d'alléguer que nous sommes Filles de Jupiter, vous de Pierce:
Encore qu'Alexandre effaçaſt Darius, Leurs Soldats pouuoient bien ſe comparer enſemble, Et cela nettement veut dire ce me ſemble, Que l’on peut vous tirer hors de comparaiſon, Et contre tout le reste auoir quelque raiſon.	Encore qu'Alexandre effaçât Darius, Leurs Soldats pouvaient bien se comparer ensemble, Et cela nettement veut dire ce me semble, Que l'on peut vous tirer hors de comparaison, Et contre tout le reste avoir quelque raison.
Mademoiſelle de la Valliere.	Mademoiselle de la Vallière.
Pieride.	Pierde.
On, non, point de détour, & point de V ſtratagéme, Il n’eſt pas queſtion de ce reſpect extréme, Et ſur le point où roule icy noſtre entretien La perſonne y fait tout, & la qualité rien;	On, non, point de détour, et point de V stratagéme, Il n'est pas question de ce respect extrême, Et sur le point où roule ici notre entretien La personne y fait tout, et la qualité rien;
Il faut examiner quel eſt noſtre merite, Mais vn merite illuſtre, & que rien ne l’imite, Brillant & reconnu d’vn aueu ſolemnel Comme vn merite à nous purement perſonel, Point d’apuys étrangers, que toutes y renoncent, Apres que l’on décide, & que les Dieux prononcent.	Il faut examiner quel est notre mérite, Mais un mérite illustre, et que rien ne l'imite, Brillant et reconnu d'un aveu solennel Comme un mérite à nous purement person, Point d'appuis étrangers, que toutes y renoncent, Après que l'on décide, et que les Dieux prononcent.
Mademoiſelle de Longueual.	Mademoiselle de Longual.
Muſe.	Muse.
Es Dieux?	Es Dieux?
nous retombons en pire extreL mité, Sçait-on pas que les Dieux ſont de voſtre coſté?	nous retombons en pire extrL ité, Sait-on pas que les Dieux sont de votre côté?
Eux qui ſont ſi puiſſans ſur la terre & ſur l’onde Et qui deuroient ſans doute eſtre pour tout le monde, Cependant par mal-heur on voit qu’ils n’y ſont point.	Eux qui sont si puissants sur la terre et sur l'onde Et qui devraient sans doute être pour tout le monde, Cependant par malheur on voit qu'ils n'y sont point.
Madame de Monteſpan.	Madame de Montespan.
Pieride.	Pierde.
Aiſſons les Dieux à part & reuenons au point:	Aissons les Dieux à part et revenons au point:
Parlons de bonne foy, qu’elle erreur eſt la voſtre?	Parlons de bonne foi, qu'elle erreur est la vôtre?
Selon vous eſtre Muſe eſt-ce eſtre plus qu'vne autre?	Selon vous être Muse est-ce être plus qu'une autre?
Si ce Nom fut jadis en admiration Il a ſuiuy du temps la reuolution, La mode en eſt paßée, & ſi je ne m’abuſe L’on peut valoir beaucoup quoy qu’on ne ſoit pas Cuſe.	Si ce Nom fut jadis en admiration Il a suivi du temps la révolution, La mode en est passée, et si je ne m'abuse L'on peut valoir beaucoup quoi qu'on ne soit pas Cuse.
Mademoiſelle d’Arquien.	Mademoiselle d'Arquien.
Muſe.	Muse.
Ais je tien qu’eſtre Muſe außi n’empeſM che pas Qu'on n'ait lieu de pretendre aux plus charmans apas, Ce ſeroit grand pitié que pour eſtre vn peu Belle On dût aprehender d’eſtre ſpirituelle, u’il falut renoncer à ces diuins threſors, Et que l’Eſprit donnaſt l’excluſion au Corps.	Ais je tien qu'être Muse aussi n'empesM che pas Qu'on n'ait lieu de prétendre aux plus charmants apas, Ce serait grand pitié que pour être un peu Belle On dût appréhender d'être spirituelle, il salut renoncer ces diuins thresors, Et que Esprit donnât exclusion au Corps.
Madame de Cruſſol.	Madame de Crussol.
Pieride.	Pierde.
DOur moy bien que touſiours les Muſes m’ayent E cherie, Par elles tendrement éleuée & nourie, Que j’aye eſté bercée au doux bruit des Chanſons Que font de tems en tems leurs doctes Nouriſſons, Ie m'eſtime bien plus d’eſtre icy Pieride, Et je tien mon eſtat meilleur & plus ſolide.	DOur moi bien que toujours les Muses m'aient E chérie, Par elles tendrement élevée et nourie, Que j'aie été bercée au doux bruit des Chansons Que font de temps en temps leurs doctes Nourissons, Je m'estime bien plus d'être ici Pierde, Et je tien mon état meilleur et plus solide.
VE que vous dites-là ne fait rien contre nous ONy contre noſtre ſort qui nous ſemble aſſez doux, Quoy que vous poſſediez vn eſprit admirable, Si voſtre ſentiment ne nous eſt fauorable, Se peut-il pas changer dans vne autre ſaiſon Eſtant de voſtre gouſt non de voſtre raiſon?	VE que vous dites-là ne fait rien contre nous ONi contre notre sort qui nous semble assez doux, Quoi que vous possédiez un esprit admirable, Si votre sentiment ne nous est favorable, Se peut-il pas changer dans une autre saison Étant de votre goût non de votre raison?
Mademoiſelle de la Mothe.	Mademoiselle de la Mothe.
Pieride.	Pierde.
Fin de terminer le debat ou nous ſommes NIe ne ſuis pas d’auis que l’on s’adreſſe aux Hommes.	Fin de terminer le débat ou nous sommes NIe ne suis pas d'avis que l'on s'adresse aux Hommes.
Ainſi qu’à nos moutons retournons à nos Dieux, Noſtre accommodement par là ſe fera mieux, Quoy que de haut en bas ces Dieux peu fauorables Regardent les Mortels comme des miſerables.	Ainsi qu'à nos moutons retournons à nos Dieux, Notre accommodement par là se fera mieux, Quoi que de haut en bas ces Dieux peu favorables Regardent les Mortels comme des misérables.
Iugez comme ils iront traitter noſtre querelle, De nous meſmes taſchons d’adoucir noſtre fiel Tenons nous à la Terre, & laiſſons-là le Ciel.	Jugez comme ils iront traiter notre querelle, De nous mêmes tâchons d'adoucir notre fiel Tenons nous à la Terre, et laissons-là le Ciel.
Mademoiſelle de Touſſy.	Mademoiselle de Toussy.
Pieride.	Pierde.
JOſtre moralité paſſe ma ſuffiſance, V Quant à moy je ſuis jeune, & j'ariue, & je dance, A l’heure que je parle il ne me manque rien, Et tout allant ainſi je croy que tout va bien, Que je me trompe ou non, mais enfin je ſoupçonne Qu'eſtant comme je ſuis l’on ne cede à perſonne.	JOtre moralité passe ma suffisance, V Quant à moi je suis jeune, et j'arive, et je dance, A l'heure que je parle il ne me manque rien, Et tout allant ainsi je crois que tout va bien, Que je me trompe ou non, mais enfin je soupçonne Qu'étant comme je suis l'on ne cède à personne.
Mademoiſelle	Mademoiselle
Mademoiſelle de Fiennes.	Mademoiselle de Fiennes.
Pieri de.	Pieri de.
St-ce qu'on s’en tient-là quand on a bonne cauſe?	St-ce qu'on s'en tient-là quand on a bonne cause?
Veut-on pas que le monde en ſçache quelque choſe?	Veut-on pas que le monde en sçache quelque chose?
Il s’agit du Triomphe en ſuite du combat, S’il y va de la gloire, il y faut de l’éclat, Meſme que plus d’vn Iuge en ait la connoiſſance, Et dans vn intereſt de pareille importance, Il faut que l’Equité faſſe turon u omemn, Et pour y voir bien clair deux yeux valent plus qu'vn.	Il s'agit du Triomphe en suite du combat, S'il y va de la gloire, il y faut de l'éclat, Même que plus d'un Juge en ait la connaissance, Et dans un intérêt de pareille importance, Il faut que l'Équité fasse turon omemn, Et pour y voir bien clair deux yeux valent plus qu'.
Madame de la Valliere.	Madame de la Vallière.
Muſe.	Muse.
J Ous pourieZ ajouſter encore à voſtre affaire V Que l’auis de pluſieurs ne ſe raportant guere Lors que le differend ſe trouue mal reglé, De quelqu’vn à quelqu’autre il en eſt appellé, Moy comme je me ſens contre vous bien fondée I’entens que ſans retour l’affaire ſoit vuidée.	 Jus pourquez ajouter encore à votre affaire V Que l'avis de plusieurs ne se rapportant guère Lors que le différend se trouve mal règlé, De quelqu' à quelque autre il en est appelé, Moi comme je me sens contre vous bien fondée J'entends que sans retour l'affaire soit vuidée.
Madame de Ludre.	Madame de Ludre.
Pieride.	Pierde.
Our corrompre perſonne au moins je ne croy pas I Qu’on me ſoupçonne icy de faire bien des pas, Pourquoy meſler le droit & la chicane enſemble?	Our corrompre personne au moins je ne crois pas I Qu'on me soupçonne ici de faire bien des pas, Pourquoi mêler le droit et la chicane ensemble?
Quand on eſt raiſonnable il ſuffit ce me ſemble	Quand on est raisonnable il suffit ce me semble
Sans que la ruſe & l’art s’y trouuent employe De ſe monſtrer au Iuge, & luy dire, voyez.	Sans que la ruse et l'art s'y trouvent emploie De se montrer au Juge, et Seigneur dire, voyez.
Mademoiſelle de Cologon.	Mademoiselle de Cologon.
Muſe.	Muse.
T Rayement vous en parleZ icy bien à voſtre aiſe, Parce que vous croyeZ n’auoir rien qui ne plaiſe, Si la Iuſtice auoit vn bandeau ſur les yeux Peut-eſtre que pour vous il n’en iroit pas mieux, Queiques traits etiatans, & quuy que von poſſede Auecque tout cela bon droit a beſoin d’aide.	TY Rayement vous en parlez ici bien à votre aise, Parce que vous croissez n'avoir rien qui ne plaise, Si la Justice avait un bandeau sur les yeux Peut-être que pour vous il n'en irait pas mieux, Que traits etiatans, et quuy que von posse Avec tout cela bon droit a besoin d'aide.
Mademoiſelle de Brancas.	Mademoiselle de Brancas.
Pieride.	Pierde.
Velque riche qu’on ſoit en beauté c’eſt vn 1 bien Dont l’on ne ſouffre pas qu’il ſe retranche rien, Ie n'auois pas quinZe ans que l’on m'en donna ſeiZe 'ela me fit dépit, & je n’en fus point aiſe, Il n’en eſt pas des ans de meſme que de l’or, Plus vous en amaſſeZ moins en vaut le threſor.	Velque riche qu'on soit en beauté c'est un 1 bien Dont l'on ne souffre pas qu'il se retranche rien, Je n'avais pas quinZe ans que l'on m'en donna seize ' me fit dépit, et je en fus point aise, Il en est pas des ans de même que de or, Plus vous en amasseZ moins en vaut le thresor.
Mademoiſelle de la Mark.	Mademoiselle de la Mark.
Muſe.	Muse.
I vous ne vous fondieZ que ſur cét auantage, I'ay dequoy diſputer du coſté de mon âge, Il eſt vray que le Blond fait par tout bien du bruit, Mais eſt-ce que le Brun n’a jamais rien produit?	I vous ne vous fondiez que sur cet avantage, J'ai dequoy disputer du côté de mon âge, Il est vrai que le Blond fait par tout bien du bruit, Mais est-ce que le Brun n'a jamais rien produit?
En quantité de lieu ſa puiſſance on redoute, Oinne mo u pue au suuu e eſe que ſe m'en doute.	En quantité de lieu sa puissance on redoute, Oinne mo u pue au sue eue eze que se m'en doute.
MADAME.	MADAME.
VEtte longue diſpute à la fin me déplaiſt,  Qu'on ſe taiſe, & laiſſons la choſe comme elle eſt.	VEtte longue dispute à la fin me déplaît, Qu'on se taise, et laissons la chose comme elle est.
AIDENEREL.	ÀIDENEREL.
Nymphes.	Nymphes.
Pour LE ROY.	Pour LE ROY.
Nymphe.	Nymphe.
A Nymphe merueilleuſe agreable & terrible, Des Ours & des Lyons médite vn meurtre horrible, Et va rendre à nos bois leur antique bonheur:	À Nymphe merveilleuse agréable et terrible, Des Ours et des Lyons médite meurtre horrible, Et va rendre nos bois leur antique bonheur:
L’Enuie à beau gronder, elle n’en peut rien dire, Et des Antres obſcurs ne ſort point de Satyre Qu'elle craigne, & qui donne atteinte à ſon hõneur.	L'Envie à beau gronder, elle n'en peut rien dire, Et des Antres obscurs ne sort point de Satyre Qu'elle craigne, et qui donne atteinte à son honneur.
A ſon rare merite on rend vn juſte hommage, Le chant melodieux des Cignes de noſtre âge S’apreſte à le loüer par des tons redoublez, Et ce meſme merite au Temple de Memoire D'vne commune voix attent la meſme gloire, Iugez par l’Auenir les Siecles aſſembleZ	À son rare mérite on rend un juste hommage, Le chant mélodieux des Cignes de notre âge S'apprête à le loubler par des tons redoublés, Et ce même mérite au Temple de Mémoire D'une commune voix attent la même gloire, Jugez par l'Avenir les Siècles assemblés
Pour le Marquis de Villeroy.	Pour le Marquis de Villeroy.
Nymphe.	Nymphe.
Cette mine langoureuſe, ANymphe, il pareſt que vous auez beſoin Qu'vne autre Nymphe prenne ſoin De vous ayder à deuenir heureuſe.	Cette mine langoureuse, ANymphe, il parêt que vous avez besoin Qu'une autre Nymphe prenne soin De vous aider à devenir heureuse.
XIII.	XIII.
ET DERNIERE ENTRE’E.	ET DERNIÈRE ENTRE'E.
Iupiter.	Jupiter.
Pour Monſieur le Grand.	Pour Monsieur le Grand.
Iupiter.	Jupiter.
Vprés de Iupiter tous les Dieux ne ſont rien, AEt ſi-toſt qu’il pareſt on le reconeſt bien, A Cheual, dans le Cercle, aux Bals, aux Promenades, De nos moindres plaiſirs il forme ſes ébas, Et deſcend quelque fois juſqu’aux Turlupinades CheZ les pauures mortels on ne va point plus bas:	Vprès de Jupiter tous les Dieux ne sont rien, AEt si-tôt qu'il parêt on le reconest bien, À Cheval, dans le Cercle, aux Bals, aux Promenades, De nos moindres plaisirs il forme ses ébas, Et descend quelque fois jusqu'aux Turlupines Che les autures mortels on ne va point plus bas:
Au cœur il a touſiours quelque galanterie, Mais Iunon dans le Ciel n'entend pas raillerie.	Au cœur il a toujours quelque galanterie, Mais Junon dans le Ciel n'entend pas raillerie.
ENTRE’E	ENTRE'E
ENTRE’E DES ESPAGNOLS, AGNOLES.	ENTRE DES ESPAGNOLS, AGNOLES.
Pour le Duc de S.	Pour le Duc de S.
Aignan.	Aignan.
Eſpagnol déguisé allant en maſque.	Espagnol déguisé allant en masque.
LVelque Eſpagnol que je ſois I'ay ſçeu me déguiſer auecque tant de gloire Qu'en cent ocaſions d’eternelle memoire I’ay paſſé pour tres-bon François, Et m'en ſuis d’autant mieux ſignalé dans l’Hiſtoire.	LUelque Espagnol que je sois J'ai su me déguiser avec tant de gloire Qu'en cent occasions d'éternelle mémoire J'ai passé pour très-bon Français, Et m'en suis d'autant mieux signalé dans l'Histoire.
Pour Mr le Grand, les Marquis de Villeroy, Mirepoix, & Raſſan.	Pour Mr le Grand, les Marquis de Villeroy, Mirepoix, et Rassan.
Eſpagnols.	Espagnols.
Eßieurs les Eſpagnols, pour vous faire NT plaiſir Ie voudrois vous loüer séparement tous quatre, Mais je n’en feray rien, & deußiez-vous me batre, Non manque de ſujet, mais faute de loiſir:	Essieurs les Espagnols, pour vous faire NT plaisir Je voudrais vous louer séparement tous quatre, Mais je n'en ferai rien, et deviez-vous me battre, Non manque de sujet, mais faute de loisir:
L’on m’a preſcrit trop tard ce que j’auois à faire, J'ay mon Prince à loüer, honneur qui m’eſt ſi doux, I'ay cinq jeunes Beautez encore à ſatisfaire, Et je ne ſuis pas homme à les laiſſer pour vous:	L'on m'a prescrit trop tard ce que j'avais à faire, J'ai mon Prince à louer, honneur qui m'est si doux, J'ai cinq jeunes Beautez encore à satisfaire, Et je ne suis pas homme à les laisser pour vous:
Enſemble eſtant Amis vous ſereZ à voſtre aiſe, Et je ne vous vnis que pour vous obliger, Si vous eſtes Riuaux ( pourtant à Dieu ne plaiſe) Il vous ſera permis de vous entre-manger.	Ensemble étant Amis vous serez à votre aise, Et je ne vous unis que pour vous obliger, Si vous êtes Rivaux ( pourtant à Dieu ne plaise) Il vous sera permis de vous entre-manger.
Pour LE ROY, repreſentant VN ESPAGNOL.	Pour LE ROY, représentant VN ESPAGNOL.
Ve pour cet Eſpagnol les Dieux ont d’amitié?	Ve pour cet Espagnol les Dieux ont d'amitié?
Außi c’eſt vn Chef-d’œuure admirable, & celeſte, Le Sang & la Nature en firent la moitié, La Paix, & l'Alliance ont composé le reſte.	Aussi c'est un Chef-d'œuvre admirable, et celeste, Le Sang et la Nature en firent la moitié, La Paix, et l'Alliance ont composé le reste.
Son Equité ſoûtient le commun intereſt De ces deux Nations qui font mouuoir l’Europe:	Son Équité soutient le commun intérêt De ces deux Nations qui font mouvoir l'Europe:
Dure à jamais ce Nœu ſerre comme il pareſt, Et qui de tant d’Eſtats la fortune enuelope.	Dure à jamais ce Nœu serre comme il parêt, Et qui de tant d'États la fortune enveloppe.
L’vne ſort d’vn ſi noble Sang MADAQu'on ne ſçauroit jamais atteindre à cette Belle, Toute la Grauité qui conuient à ſon Rang Oſte la liberté de ſoûpirer pour Elle.	L'une sort d'Hôte si noble Sang MADQute on ne saurait jamais atteindre à cette Belle, Toute la Gravité qui convient à son Rang Oste la liberté de soupirer pour Elle.
ME.	ME.
L'autre a le cœur peu partagé, Ie ne ſçay s’il eſt plain, je ne ſçay s’il eſt vuide, Mais je tien s’il s’eſtoit vne fois engagé Qu'il auroit de la peine à deuenir perfide.	L'autre a le cœur peu partagé, Je ne sais s'il est plain, je ne sçay s'il est vide, Mais je tien s'il s'était une fois engagé Qu'il aurait de la peine à devenir perfide.
De celle-cy l’intention Eſt de faire aux Humains vne mortelle guerre Et ſon vray caractere eſt de la Nation Qui voudroit maiſtriſer le reſte de la Terre.	De celle-cy l'intention Est de faire aux Humains une mortelle guerre Et son vrai caractère est de la Nation Qui voudrait maîtriser le reste de la Terre.
Celle-là d'Vn air noble & haut Eſt ſage autant qu’aymable, & toute cette flâme ui fait tant de rauage en vn climat ſi chaud 1 Elle l’a dans l’Eſprit & ne l’a point dans l’Ame.	Celle-là d'Un air noble et haut Est sage autant qu'aimable, et toute cette flamme ui fait tant de ravage en un climat si chaud 1 Elle l'a dans l'Esprit et ne l'a point dans l'Âme.
Que cette jeune Beauté plaiſt Mais à quelle fortune eſt-elle reſeruée?	Que cette jeune Beauté plaît Mais à quelle fortune est-elle réservée?
ianet tant de Tprefors airiez-Vous pas qu'elle est Des Indes en ce lieu fraiſchement ariuée?	janet tant de Tréfors airiez-Vous pas qu'elle est Des Indes en ce lieu fraîchement ariuée?
Pour vos fléches changez de but Amour, & quittez-là des entrepriſes folles, Vous auez voſtre ſens;	Pour vos flèches changés de but Amour, et quittez-là des entreprises folles, Vous avez votre sens;
mais la raiſon conclut Qu'il eſt tres ungerend u aimer ces ESPAGNOLES.	mais la raison conclut Qu'il est très ungerend aimer ces ESPAGNOLES.
ENTRE’E DES MAVRES.	ENTRE DES MAURES.
Pour LE ROY.	Pour LE ROY.
Maure.	Maure.
E Maure ſi fameux ſoit en paix ſoit en guerre D’vn merite éclatant, & d’vn rang ſingulier Pouroit mettre à ſes pieZ tout l’orgueil de la Terre, Et difficilement ſouffriroit le colier:	E Maure si fameux soit en paix soit en guerre D'un mérite éclatant, et d'un rang singulier Pourrait mettre à ses piqués tout l'orgueil de la Terre, Et difficilement souffrirait le colier:
Il ne ſçait ce que c’eſt d’eſtre ſans la victoire, Et tous les pas qu’il fait le ménent à la gloire, Sur vn chemin ſi noble il efface en allant Tout ce que les ZEGRIS, & les ABENCERRAGES es illuſtres Courages Firent de plus galant.	Il ne sait ce que c'est d'être sans la victoire, Et tous les pas qu'il fait le mènent à la gloire, Sur un chemin si noble il efface en allant Tout ce que les ZÉGRIS, et les ABENCERAGES es lustres Courages Firent de plus galant.
22 Lors qu’il fait le Berger il eſt incomparable, Repreſentant Cyrus il prend vn plus haut vol, Qu’il ſe déguiſe en Nymphe il a l’air admirable, 'eſt la meſme fierté s’il dance en Eſpagnol, Sous l’habit Afriquain luy meſme il ſe ſurmonte, Mais de ces jeux diuers quand il faut qu’il remonte A ſon vray, naturel, & ſerieux employ Ou pas vn ne l’égale, ou Nul ne le ſeconde, Perſonne dans le Monde Ne fait ſi bien le ROY.	22 Lors qu'il fait le Berger il est incomparable, Représentant Cyrus il prend un plus haut vol, Qu'il se déguise en Nymphe il a l'air admirable, 'est la même fierté il dance en Espagnol, Sous habit Afriquain lui même il se surmonte, Mais de ces jeux diuers quand il faut il remonte A son vrai, naturel, et sérieux emploi Ou pas ne égale, ou Nul ne le seconde, Personne dans le Monde Ne fait si bien le ROY.
Pour MADAME.	Pour MADAME.
Maureſque.	Mauresque.
Ve ces yeux ont de force, & qu’il eſt dangereux De croire tenir ferme à la longue contr'eux, Qu’il y faut de ſageſſe, & que de politique Malheureux eſt celuy qui ſe trouue bruſlé Par les jardans rayons de ces Soleils d’Afrique, Plus malheureux encor quiconque en est haſlé, La brûlure au dedans peut demeurer paiſible, Mais le haſle au dehors la rend toute viſible, Leſſet en eſt iemoie, & crueu tout a ſait, Et l’aparance pire encore que l’effet.	Ve ces yeux ont de force, et qu'il est dangereux De croire tenir ferme à la longue contr'eux, Qu'il y faut de sagesse, et que de politique Malheureux est celui qui se trouve brûlé Par les jardents rayons de ces Soleils d'Afrique, Plus malheureux encor quiconque en est hâle, La brûlure au dedans peut demeurer paisible, Mais le hâle au dehors la rend toute visible, Lesset en est émoie, et crueu tout a sait, Et l'apparance pire encore que l'effet.
Pour Mademoiſelle de la Valiere.	Pour Mademoiselle de la Valière.
Maureſque.	Mauresque.
Eauté du premier rang, DVous dont la gloire eſt infinie, Auec vn Teint ſi blanc Venez-vous de Mauritanie?	Eauté du premier rang, DUous dont la gloire est infinie, Avec Teint si blanc Venez-vous de Mauritanie?
Que de pompe, que d’apareil Sur voſtre marche, & pour voſtre conduite!	Que de pompe, que d'appareil Sur votre marche, et pour votre conduite!
Les Autres n’ont rien de pareil, Quels Eſclaues, & quelle ſuite!	Les Autres n'ont rien de pareil, Quels Esclaves, et quelle suite!
Pour Madame de Rochefort.	Pour Madame de Rochefort.
Maureſque.	Mauresque.
Oute la noirceur du Climat INon ſans vn tendre & vif éclat Dans vos beaux yeux s’eſt retirée, Et c’eſt vne preuue aſſurée De leur mauuais deſſein Contre le genre humain.	Oute la noirceur du Climat INon sans un tendre et vif éclat Dans vos beaux yeux s'est retirée, Et c'est e preuue assurée De leur mauvais dessein Contre le genre humain.
Pour Mademoiſelle de Brancas.	Pour Mademoiselle de Brancas.
Maureſque.	Mauresque.
Vel éclat!	Vel éclat!
quelle fraiſcheur!	quelle fraîcheur!
Non perſonne de blancheur Aupres de vous ne ſe pique, El ceſt vne rarere Que vous ayez aporté Tant de nége de l’Afrique.	Non personne de blancheur Auprès de vous ne se pique, El est une rarerecHeur vous ayez apporté Tant de nége de l'Afrique.
Pour Monſieur le Grand.	Pour Monsieur le Grand.
Maure.	Maure.
JOus eſtes bien fait, Maure, & vous aueZ la mine D'eſtre vn des principaux de voſtre Nation, Il ne vous manque rien, & qui vous examine Ne trouue de defaut qu’en voſtre expreßion.	JOus êtes bien fait, Maure, et vous avez la mine D'être un des principaux de votre Nation, Il ne vous manque rien, et qui vous examine Ne trouve dé faut qu'en votre expression.
cuonou En parlant vous péchez, dit on contre les formes, Et vous vous énoncez trop peu vulgairement, S’il faut qu’aux Nations les Langues ſoient conformes Vn Maure doit il pas parler obſcurément?	cuonou En parlant vous péchez, dit on contre les formes, Et vous vous énoncez trop peu vulgairement, S'il faut qu'aux Nations les Langues soient conformes Un Maure doit il pas parler obscurément?
{000 Il est des délicas dont le chagrin s’aplique A trouuer tout mauuais, & vous donner à dos Comme ſi vous laſchiez tous les Monſtres d’Afrique Quand vous laiſſeZ aller trois ou quatre bons mots.	{000 Il est des délicas dont le chagrin s'applique A trouver tout mauvais, et vous donner à dos Comme si vous lâchiez tous les Monstres d'Afrique Quand vous laissez aller trois ou quatre bons mots.
Pour le Marquis de Villeroy.	Pour le Marquis de Villeroy.
Maure.	Maure.
Aure, qui me ſemblez jeune, galant, & IT braue, Eſtes-vous voſtre Maiſtre, ou bien ſi vous ſerueZ!	Aure, qui me semblez jeune, galant, et IT brave, Êtes-vous votre Maître, ou bien si vous servez!
Car le grand air que vous auez Ne ſent point du tout ſon Eſclaue:	Car le grand air que vous avez Ne sent point du tout son Esclave:
D’autre coſté cette triſte langueur Qui ſemble auoir ſa ſource dans le cœur Met les curieux à la geſne, Vous n’aueZ ny colier, ny cheſne, Ou ſi vous en aüez il ne pareſſent point, Mais toute choſe miſe en vn juſte équilibre VouleZ-vous me laiſſer décider ſur ce point?	D'autre côté cette triste langueur Qui semble avoir sa source dans le cœur Met les curieux à la gêne, Vous n'avez ici collier, ni chaîne, Ou si vous en avez il ne paressent point, Mais toute chose mise en un juste équilibre Voulez-vous me laisser décider sur ce point?
Ma foy vous n’eſtes pas de condition libre.	Ma foi vous n'êtes pas de condition libre.
S’il faut qu’aux Nations les Langues ſoient conformes Vn Maure doit il pas parler obſcurément?	S'il faut qu'aux Nations les Langues soient conformes Un Maure doit il pas parler obscurément?
{000 Il est des délicas dont le chagrin s’aplique A trouuer tout mauuais, & vous donner à dos Comme ſi vous laſchiez tous les Monſtres d’Afrique Quand vous laiſſeZ aller trois ou quatre bons mots.	{000 Il est des délicas dont le chagrin s'applique A trouver tout mauvais, et vous donner à dos Comme si vous lâchiez tous les Monstres d'Afrique Quand vous laissez aller trois ou quatre bons mots.
Pour le Marquis de Villeroy.	Pour le Marquis de Villeroy.
Maure.	Maure.
Aure, qui me ſemblez jeune, galant, & IT braue, Eſtes-vous voſtre Maiſtre, ou bien ſi vous ſerueZ!	Aure, qui me semblez jeune, galant, et IT brave, Êtes-vous votre Maître, ou bien si vous servez!
Car le grand air que vous auez Ne ſent point du tout ſon Eſclaue:	Car le grand air que vous avez Ne sent point du tout son Esclave:
D’autre coſté cette triſte langueur Qui ſemble auoir ſa ſource dans le cœur Met les curieux à la geſne, Vous n’aueZ ny colier, ny cheſne, Ou ſi vous en aüez il ne pareſſent point, Mais toute choſe miſe en vn juſte équilibre VouleZ-vous me laiſſer décider ſur ce point?	D'autre côté cette triste langueur Qui semble avoir sa source dans le cœur Met les curieux à la gêne, Vous n'avez ici collier, ni chaîne, Ou si vous en avez il ne paressent point, Mais toute chose mise en un juste équilibre Voulez-vous me laisser décider sur ce point?
Ma foy vous n’eſtes pas de condition libre.	Ma foi vous n'êtes pas de condition libre.
