Le tres-humble, tres-obeïſſant, & tres-fidelle ſerviteur & ſujet, B.	Le très-humble, très-obeïssant, et très-fidelle serviteur et sujet, B.
P.	P.
MOLIERE.	MOLIÈRE.
AU LECTEUR.	AU LECTEUR.
AMAIS entrepriſe au Theatre ne fut ſi precipitée que celle-cy;	AMAIS entreprise au Théâtre ne fut si précipitée que celle-cy;
& c’eſt Vamune choſe, je croy, toute nouvelle, qu’une Comedie ait eſté conceue, faite, appriſe, & repreſentée en quinze jours.	et c'est Vamune chose, je crois, toute nouvelle, qu'une Comédie ait été conçue, faite, apprise, et représentée en quinze jours.
Je ne dis pas cela pour me piquer de l’im promptu, & en pretendre de la gloire;	Je ne dis pas cela pour me piquer de l'im omptu, et en prétendre de la gloire;
mais ſeulement pour prevenir certaines gens, qui pourroient trouver à redire, que je n’aye pas mis icy toutes les eſpeces de Fâcheux, qui ſe trouvene:	mais seulement pour prévenir certes gens, qui pourraient trouver à redire, que je n'aie pas mis ici toutes les espèces de Fâcheux, qui se trouvène:
Je ſçay que le nombre en eſt grand, & à la Cour, & dans la Ville, & que ſans Epiſodes, j’euſſe bien pû en compoſer A 4 une une Comedie de cinq Actes bien fournis, & avoir encor de la matiere de reſte.	Je sais que le nombre en est grand, et à la Cour, et dans la Ville, et que sans Épisodes, j'eusse bien pu en composer A 4 une une Comédie de cinq Actes bien fournis, et avoir encor de la matière de reste.
Mais dans le peu de temps qui me fut donné, il m’eſtoit impoſſible de faire un grand deſſein, & de reſver beaucoup ſur le choix de mes Perſonnages, & ſur la diſpoſition de mon ſujet.	Mais dans le peu de temps qui me fut donné, il m'était impossible de faire un grand dessein, et de rêver beaucoup sur le choix de mes Personnages, et sur la disposition de mon sujet.
Je me reduiſis donc à ne toucher qu’un petit nombre d’Importuns;	Je me réduis donc à ne toucher qu'un petit nombre d'Importuns;
& je pris ceux qui s’offrirent d’abord à mon eſprit, & que je creus les plus propres à réjoüir les auguſtes perſonnes devant qui-j’avois à paroiſtre;	et je pris ceux qui s'offrirent d'abord à mon esprit, et que je crus les plus propres à réjouir les augustes personnes devant qui-j'avais à paraître;
& pour lier promptement toutes ces choſes enſemble, je me ſervis du premier nœud que je pus trouver.	et pour lier promptement toutes ces choses ensemble, je me servis du premier nœud que je pus trouver.
Ce n’eſt pas mon deſſein d’examiner maintenant ſi tout cela pouvoit eſtre mieux, & ſi tous ceux qui s’y ſont divertis, ont ry ſelon les regles:	Ce n'est pas mon dessein d'examiner maintenant si tout cela pouvait été mieux, et si tous ceux qui s'y sont divertis, ont ri selon les règles:
Le temps viendra de faire imprimer mes remarmarques ſur les Pieces que j’auray faites;	Le temps viendra de faire imprimer mes remarmarques sur les Pièces que j'aurai faites;
& je ne deſeſpere pas de faire voir un jour, en grand Autheur, que je puis citer Ariſtote, & Horace.	et je ne désespère pas de faire voir un jour, en grand Auteur, que je puis citer Aristote, et Horace.
En attendant cet examen, qui peut-eſtre ne viendra point, je m’en remets aſſez aux deciſions de la multitude;	En attendant cet examen, qui peut-être ne viendra point, je m'en remets assez aux décisions de la multitude;
& je tiens auſſi difficile de combattre un Duvrage que le public approuque d’en deffendre un qu’il damne.	et je tiens aussi difficile de combattre un Duvrage que le public approuque d'en défendre un qu'il damne.
Il n’y a perſonne qui ne ſçache pour quelle réjoüiſſance la Piece fut compoſée, & cette feſte a fait un tel éclat, qu’il n’eſt pas neceſſaire d’en parler;	Il n'y a personne qui ne sache pour quelle réjoüissance la Pièce fut composée, et cette fête a fait un tel éclat, qu'il n'est pas nécessaire d'en parler;
maïs il ne ſera pas hors de propos de dire deux paroles des ornemens qu’on a meſlez avec la Comedie.	maîts il ne sera pas hors de propos de dire deux paroles des ornements qu'on a mêlez avec la Comédie.
Le deſſein eſtoit de donner un Ballet auſſi;	Le dessein était de donner un Ballet aussi;
& comme il n’y avoit A y ¶u diſ qu’un petit nombre choiſi de Danceurs excellens, on fut contraint de ſeparer les Entrées de ce Ballet, & l’advis fut de les jetter dans les Entre-Actes de la Comedie, afin que ces intervalles donnaſſent temps aux meſmes Baladins de revenir ſous d’autres habits.	et comme il n'y avait À y „ dis qu'un petit nombre choisi de Danceurs excellents, on fut contraint de séparer les Entrées de ce Ballet, et l'avis fut de les jeter dans les Entre-Actes de la Comédie, afin que ces intervalles donnassent temps aux mêmes Baladins de revenir sous d'autres habits.
De ſorte que pour ne point rompre auſſi le fil de la Piece, par ces manieres d’intermedes, on s’aviſa de les coudre au ſujet du mieux que l’on put, & de ne faire qu’une ſeule choſe du Ballet, & de la Comedie:	De sorte que pour ne point rompre aussi le fil de la Pièce, par ces manières d'intermèdes, on s'avisa de les coudre au sujet du mieux que l'on put, et de ne faire qu'une seule chose du Ballet, et de la Comédie:
mais comme le temps eſtoit fort precipité, & que tout cela ne fut pas reglé entierement par une meſme teſte, on trouvera peut-eſtre quelques endroits du Ballet, qui n’entrent pas dans la Comedie auſſi naturellement que d’autres.	mais comme le temps était fort précipité, et que tout cela ne fut pas réglé entièrement par une même tête, on trouvera peut-être quelques endroits du Ballet, qui n'entrent pas dans la Comédie aussi naturellement que d'autres.
Quoy qu’il en ſoit, c’eſt un meſſange qui eſt nouveau S – D’abord que la toille fut levée, un des Acteurs, comme vous pourriez dire moy, parut ſur le Theatre en habit de Ville, & s’adreſſant au Roy avec le viſage d’un homme ſurpris, fit des excuſes en deſordre ſur ce qu’il ſe trouvoit là ſeul, & manquoit de temps, & d’Acteurs pour donner à ſa Majeſté le divertiſſement qu’elle ſembloit attendre.	Quoi qu'il en soit, c'est un mésange qui est nouveau S § D'abord que la toille fut levée, un des Acteurs, comme vous pourriez dire moi, parut sur le Théâtre en habit de Ville, et s'adressant au Roi avec le visage d'un homme surpris, fit des excuses en désordre sur ce qu'il se trouvait là seul, et manquait de temps, et d'Acteurs pour donner à sa Majesté le divertissement qu'elle semblait attendre.
En meſmotemps, au milieu de vingt jets d’eau naturels, s’ouvrit cette coquille, que tout le monde a veue;	En mesmotemps, au milieu de vingt jets d'eau naturels, s'ouvrit cette coquille, que tout le monde a vue;
& l’agreable Nayade qui pour nos Theatres, & dont on pourroit chercher quelques authoritez dans l’Antiquité;	et l'agréable Nade qui pour nos Théatres, et dont on pourrait chercher quelques autorités dans l'Antiquité;
& comme tout le Monde l’a trouvé agreable, il peut ſervir d’idée à d’autres choſes, qui pourroient eſtre meditées avec plus de loiſir.	et comme tout le Monde l'a trouvé agréable, il peut servir d'idée à d'autres choses, qui pourraient être méditées avec plus de loisir.
parut dedans s’avança au bord du Theatre, & d’un air heroique prononça les Vers, que Monſieur I eliſſon avoit faits, & qui ſervent de Prologue.	parut dedans s'avança au bord du Théâtre, et d'un air héroïque prononça les Vers, que Monsieur I élisson avait faits, et qui servent de Prologue.
PROLOGUE.	PROLOGUE.
DOur voir en ces beaux lieux le plus grand Roy du Monde, Mortels, je viens à vous de ma grotte profonće.	DOur voir en ces beaux lieux le plus grand Roi du Monde, Mortels, je viens à vous de ma grotte profone.
Faut-il en ſa faveur, que la Terre ou que l’Eau Produiſent à vos yeux un ſpectacle nouveau?	Faut-il en sa faveur, que la Terre ou que l'Eau Produisent à vos yeux un spectacle nouveau?
Qu’il parle, ou qu’il ſouhaitte:	Qu'il parle, ou qu'il souhaite:
Il n’eſt rien d’impoſſible:	Il n'est rien d'impossible:
Luy-meſme n'eſt-il pas un miracle viſible?	Lui-même n'est-il pas un miracle visible?
Son regne ſi fertile en miracles divers, N’en demande-t-il pas à tout cet Univers?	Son règne si fertile en miracles divers, N'en demande-t-il pas à tout cet Univers?
Jeune, Victorieux, Sage, Vaillant, Auguſte, Auſſi doux que ſevere, auſſi puiſſant que juſte, Reigler, & ſes Eſtats, & ſes propres deſirs, Joindre aux nobles travaux les plus nobles plaiſirs, En ſes juſtes projects jamais ne ſe méprendre, Agir inceſſamment, tout voir, & tout entendre;	Jeune, Victorieux, Sage, Vaillant, Auguste, Aussi doux que sévère, aussi puissant que juste, Reigler, et ses États, et ses propres désirs, Joindre aux nobles travaux les plus nobles plaisirs, En ses justes projects jamais ne se méprendre, Agir incessamment, tout voir, et tout entendre;
Qui peut cela, peut tout;	Qui peut cela, peut tout;
il n’a qu’à tout oſer;	il n'a qu'à tout oser;
Et le ciel à ſes vœux ne peut rien refuſer.	Et le ciel à ses vœux ne peut rien refuser.
ne Ces Arbres parleront mieux que ceux de Dodone :	ne Ces Arbres parleront mieux que ceux de Dodone :
Hoſteſſes de leur tronc, moindres Divinitez, C’eſt Louis qui le veut, ſortez Nymphes, ſortez;	Hôtesses de leur tronc, moindres Divinités, C'est Louis qui le veut, sortez Nymphes, sortez;
* Je vous monſtre l’exemple, il s’agit de luy plaire, Quittez pour quelque temps voſtre forme ordinaire, Et paroiſſons enſemble aux yeux des ſpectateurs, Pour ce nouveau Theatre, autant de vrais Acteurs.	* Je vous montre l'exemple, il s'agités de lui plaire, Quittez pour quelque temps quelque forme ordinaire, Et paraissons ensemble aux yeux des spectateurs, Pour ce nouveau Théâtre, autant de vrais Acteurs.
Vous, Soin de ſes ſujets, ſa plus charmante eſtude, Heroïque ſoucy, Royale inquietude, Laiſſez-le reſpirer, & ſouffrez qu’un moment Son grand cœur s’abandonne au divertiſſement:	Vous, Soin de ses sujets, sa plus charmante étude, Héroïque souci, Royale inquiétude, Laissez-le respirer, et souffrez qu'un moment Son grand cœur s'abandonne au divertissement:
Vous le verrez demain d’une force nouvelle Sous le fardeau penible, où voſtre voix l’appelle, Faire obeïr les loix, partager les bien faits, Par ſes propres conſeils prevenir nos ſouhaits, Maintenir l’Univers dans une paix profonde, Et s’oſter le repos pour le donner au monde.	Vous le verrez demain d'une force nouvelle Sous le fardeau pénible, où votre voix l'appelle, Faire obéir les lois, partager les bien faits, Par ses propres conseils prévenir nos souhaits, Maintenir l'Univers dans une paix profonde, Et s'ôter le repos pour le donner au monde.
Qu’auPluſieurs Driades accompagnées de Faunes & de Satyres ſortent des Arbres & des Termes.	Qu'auPlusieurs Driades accompagnées de Faunes et de Satyres sortent des Arbres et des Termes.
Qu’aujourd’huy tout luy plaiſe, & ſemble conſentir A l’unique deſſein de le bien divertir.	Qu'aujourd'hui tout lui plaise, et semble consentir A l'unique dessein de le bien divertir.
Faſcheux retirez-vous;	Fâcheux retirez-vous;
ou s’il faut qu’il vous voye, Nle jets joutenent pour escelrer ja jojt.	ou s'il faut qu'il vous voie, Nle jets joutnent pour écelrer ja jojt.
La Nayade emmenne avec elle, pour la Comedie, une partie des gens qu’elle a fait paroiſtre, pendant que le reſte ſe met à danſer au ſon des Hauts-bois, qui ſe joignent aux Violons.	La Nayade emmenne avec elle, pour la Comédie, une partie des gens qu'elle a fait paraître, pendant que le reste se met à danser au son des Hauts-bois, qui se joignent aux Violons.
L c 1 D R.	 ç 1 D .
10.	10.
11 HTSE.	11 HTSE.
A 8 C RE.	À 8 Ç RE.
AEHOIMDRE.	AÉHOIMDRE.
ALCIPE.	ÀLCIPE.
RANTE.	RANTE.
CLYMENE.	CLYMENE.
LES FASCHEUX.	LES FÂCHEUX.
COMEDIE.	COMÉDIE.
ACTE PREMIER.	ACTE PREMIER.
OCERE FREMIERE.	OCERE FREMIÈRE.
ERASTE, LAMONTAGNE.	ERASTE, LAMONTAGNE.
ERASTE.	ERASTE.
Ous quel aſtre, bon Dieu, faut il que je ſois né, Pour eſtre de Fâcheux toûjours aſſaſſiné!	Ous quel astre, bon Dieu, faut -il que je sois né, Pour être de Fâcheux toujours assassiné!
Il ſemble que par tout le ſort me les adreſſe, Et j’en vois, chaque jour, quelque nouvelle eſpece.	Il semble que par tout le sort me les adresse, Et j'en vois, chaque jour, quelque nouvelle espèce.
Mais il n’eſt rien d’égal au Fâcheux d’aujourd’huy;	Mais il n'est rien d'égal au Fâcheux d'aujourd'hui;
J’ay creu n’eſtre jamais debaraſſé de luy;	J'ai cru n'être jamais débarrassé de Seigneur;
Et, cent fois, j’ay maudit cette innocente envie Qui m’a pris à diſné, de voir la Comedie, Où, penſant m’égayer, j’ay miſerablement, Trouvé de m  le rude chaſtiment.	Et, cent fois, j'ai maudit cette innocente envie Qui m'a pris à dîné, de voir la Comédie, Où, pensant m'égayer, j'ai misérablement, Trouvé de m le rude châtiment.
Il faut que je te faſte un recit de l’affaire;	Il faut que je te faste un récit de l'affaire;
2 Car je m’en ſens encor tout eſmû de colere.	2 Car je m'en sens encor tout ému de colère.
J’eſtois ſur le Theatre, en humeur d’éconter La piece, qu’à pluſieurs j’avois ouï vanter;	J'étais sur le Théâtre, en humeur d'éconter La pièce, qu'à plusieurs j'avais ouï vanter;
Les Acteurs commençoient, chaci n preſtoit ſilence.	Les Acteurs commençaient, chaci n prêtait silence.
Lors que d’un air bruyant, & plein d’extravagance.	Lors que d'un air bruyant, et plein d'extravagance.
Un homme à grans canons eſt entré bruſquement En criant, hola-ho, un ſiege promptement:	Un homme à grans canons est entré brusquement En criant, holà-ho, un siège promptement:
Et de ſon grand fracas ſurprenant l’aſſemblée, Dans le plus bel endroit a la piece troublée.	Et de son grand fracas surprenant l'assemblée, Dans le plus bel endroit à la pièce troublée.
Hé mon Dieu!	Hé mon Dieu!
nos François ſi ſouvent redreſſez, Ne prendront-ils jamais un air de gens ſenſez, Ay-je dit, & faut-il, ſur nos defauts extrémes, Qu’en theatre public nous nous joüions nous-meſmes, Et confirmions ainſi, par des éclats de foux, Ce que chez nos voiſins on dit par tout de nous !	nos Français si souvent redressez, Ne prendront-ils jamais un air de gens sensé, Ai-je dit, et faut-il, sur nos défauts extrêmes, Qu'en théâtre public nous nous jouions nous-mêmes, Et confirmions ainsi, par des éclats de foux, Ce que chez nos voisins on dit par tout de nous !
Tandis que là deſſus je hauſſois les eſpaules, Les Acteurs ont voulu continuer leurs Rôles:	Tandis que là dessus je haussais les épaules, Les Acteurs ont voulu continuer leurs Rôles:
Mais l’homme, pour s’aſſeoir, a fait nouveau fiacas, Et traverſant encor le Theatre à grans pas, Bien que dans les coſtez il puſt eſtre à ſon aiſe, Au milieu du devant il a planté ſa chaiſe, Et de ſon large dos morguant les ſpectateurs, Aux trois quarto du parterre a caché les Acteurs.	Mais l'homme, pour s'asseoir, a fait nouveau fiacas, Et traversant encor le Théâtre à grans pas, Bien que dans les côtés il pût être à son aise, Au milieu du devant il a planté sa chaise, Et de son large dos morguant les spectateurs, Aux trois quarto du parterre a caché les Acteurs.
Un bruit s’eſt ele e, dont un autre euſt eu honte;	Un bruit s'est éle est, dont un autre eût eu honte;
Mais luy, ferme & conſtant, n’en a fait aucun conte;	Mais quelque, ferme et constant, n'en a fait aucun compte;
Et ſe ſeroit tenu comme il s’eſtoit poſé, Si, pour mon infortune, il ne m’euſt aviſé.	Et se serait tenu comme il s'était posé, Si, pour mon infortune, il ne m'eût avisé.
Ha Marquis, m’a-t-il dit, prenant prés de moy place, Comment te portes-tu?	Ha Marquis, m'a-t-il dit, prenant près de moi place, Comment te portes-tu?
Souffre, que je t’embraſſe.	Souffre, que je t'embrasse.
Au viſage, ſur l’heure, un rouge m’eſt monté, Que l’on me viſt connu d’un pareil eventé.	Au visage, sur l'heure, un rouge m'est monté, Que l'on me vît connu d'un pareil éventé.
Je l’eſtois peu pourtant, mais on en voit paroiſtre, De ces gens qui de rien veulent fort vous connoiſtre, Dont il faut au ſalut les balleis entyer,	Je l'étais peu pourtant, mais on en voit paraître, De ces gens qui de rien veulent fort vous connaître, Dont il faut au salut les balleis entier,
De dire que j’avois certain repas à rendre.	De dire que j'avais certain repas à rendre.
Et qui ſont familiers juſqu’à vous tutoyer.	Et qui sont familiers jusqu'à vous tutoyer.
Il m’a fait, à l’abord, cent queſtions frivoles, Plus haut que les Acteurs eſlevant ſes paroles.	Il m'a fait, à l'abord, cent questions frivoles, Plus haut que les Acteurs élevant ses paroles.
Chacun le maudiſioit, & moy pour l’arreſter, Je ſerois, ay-je dit, bien aiſe d’eſcouter.	Chacun le maudisiait, et moi pour l'arrêter, Je serais, ai-je dit, bien aise d'écouter.
Tu n’as point veu cecy, Marquis;	Tu n'as point vu ceci, Marquis;
ah!	ah!
Dieu me danne, le le trouve aſſez drole, & je n’y ſuis pas aſne;	Dieu me danne, le le trouve assez drôle, et je n'y suis pas âne;
Ie ſçais par quelles loix un ouvrage eſt parfait, Et Corneille me vient lire tout ce qu’il fait.	Je sais par quelles lois un ouvrage est parfait, Et Corneille me vient lire tout ce qu'il fait.
La deſſus de la piece il m’a fait un ſommaire, Scene, à Scene, averty de ce qu’il falloit faire, Et juſques à des vers qu’il en ſçavoit par cœur, Il me les recitoit tout haut avant l’Acteur.	La dessus de la pièce il m'a fait un sommaire, Scène, à Scène, averti de ce qu'il fallait faire, Et jusques à des vers qu'il en savait par cœur, Il me les récitait tout haut avant l'Acteur.
avois beau m’en deffendre, il a pouſſé ſa chance, Et s’eſt, devers la fin, levé long-temps d’avance;	avais beau m'en défendre, il a poussé sa chance, Et s'est, devers la fin, levé longtemps d'avance;
Car les gens du bel air pour agir galamment Se gardent bien, ſur tout, d’oüir le dénoument.	Car les gens du bel air pour agir galamment Se gardent bien, sur tout, d'ouïr le dénoument.
Je rendois grace au Ciel, & croyois de juſtice, Qu’avec la Comedie euſt finy mon ſuplice:	Je rendais grâce au Ciel, et croyais de justice, Qu'avec la Comédie eût fini mon suplice:
Mais, comme ſi c’en euſt eſté trop bon marché, Sur nouveaux frais mon homme à moy s’eſt attaché;	Mais, comme si c'en eût été trop bon marché, Sur nouveaux frais mon homme à moi s'est attaché;
M’a conté ſes exploits, ſes vertus non communes;	M'a compté ses exploits, ses vertus non communes;
Parlé de ſes chevaux, de ſes bonnes fortunes, Et de ce qu’à la Cour il avoit de faveur, Diſant, qu’à m’y ſervir il s’offroit de grand cœur.	Parlé de ses chevaux, de ses bonnes fortunes, Et de ce qu'à la Cour il avait de faveur, Disant, qu'à m'y servir il s'offrait de grand cœur.
Je le remerciois doucement de la teſſe, Minutant à tous coups quelque retraite honneſte:	Je le remerciais doucement de la tesse, Minutant à tous coups quelque retraite honnête:
Mais luy, pour le quitter, me voyant ébranlé, Sortons, ce m’a-t-il dit, le monde eſt écoulé:	Mais ainsi, pour le quitter, me voyant ébranlé, Sortons, ce m'a-t-il dit, le monde est écoulé:
Et ſortis de ce lieu me la donnant plus ſeche, Murquis, allons au Cours faire voir ma galeche;	Et sortis de ce lieu me la donnant plus seche, Murquis, allons au Cours faire voir ma galeche;
Elle eſt bien entenduë, & plus d’un Duc & Pair, En fait, à mon faiſeur, faire une du meſme air.	Elle est bien entendue, et plus d'un Duc et Pair, En fait, à mon faiseur, faire une du même air.
Moy de luy rendre grace, & pour mieux m’en defendre,	Moi de Seigneur rendre grâce, et pour mieux m'en défendre,
Ah par bleu j’en veux eſtre, eſtant de tes amis, Et manque au Mareſchal à qui j’avois promis.	Ah par bleu j'en veux être, étant de tes amis, Et manque au Maréchal à qui j'avais promis.
De la chere, ay-je fait, la doze eſt trop peu fortPour oſer y prier des gens de voſtre ſorte.	De la chère, ai-je fait, la dose est trop peu fortPour oser y prier des gens de votre sorte.
Non;	Non;
m’a-t-il reſpondu, je ſuis ſans compliment, Et j’y vais pour cauſer avec toy ſeulement;	m'a-t-il répondu, je suis sans compliment, Et j'y vais pour causer avec toi seulement;
Je ſuis des grans repas fatigué, je te jure:	Je suis des grans repas fatigué, je te jure:
Mais ſi l’on vous attend, ay-je dit, c’eſt injure.	Mais si l'on vous attend, ai-je dit, c'est injure.
Tu te moques, Marquis, nous nous connoiſſont tous;	Tu te moques, Marquis, nous nous connaissont tous;
Et je trouve avec toy des paſſe-temps plus doux.	Et je trouve avec toi des passetemps plus doux.
Je peſtois contre moy, l’ame triſte & confuſe Du funeſte ſuccés qu’avoit eu mon excuſe, Et ne ſçavois à quoy je devois recourir, Pour ſortir d’une peine à me faire mourir;	Je pétais contre moi, l'âme triste et confuse Du funeste succès qu'avait eu mon excuse, Et ne savais à quoi je devais recourir, Pour sortir d'une peine à me faire mourir;
Lors qu’un caroſſe fait de ſuperbe maniere, Et comblé de laquais, & devant, & derriere, S’eſt avec un grand bruit devant nous arreſté;	Lors qu'un carosse fait de superbe manière, Et comblé de laquais, et devant, et derrière, S'est avec un grand bruit devant nous arrêté;
D’où ſautant un jeune homme amplement ajuſté, Mon importun & luy courant à l’embraſſade Ont ſurpris les paſſans de leur bruſque incartade;	D'où sautant un jeune homme amplement ajusté, Mon importun et lui courant à l'embrassade Ont surpris les passants de leur brusque incartade;
Et tandis que tous deux eſtoient precipitez Dans les convulſions de leurs civilitez, je me ſuis doucement eſquivé ſans rien dire;	Et tandis que tous deux étaient précipités Dans les convulsions de leurs civilités, je me suis doucement esquivé sans rien dire;
Non ſans avoir long-temps gemi d’un tel martyre, Et maudit ce Fâcheux dont le zele obſtiné M’oſtoit au rendé-vous qui m’eſt icy donné.	Non sans avoir longtemps gémi d'un tel martyre, Et maudit ce Fâcheux dont le zèle obstiné M'ôtait au rendé-vous qui m'est ici donné.
DAMONIAGNE.	DAMONIAGNE.
Ce ſont chagrins meſlez aux plaiſirs de la vie.	Ce sont chagrins mêlés aux plaisirs de la vie.
Tout ne va pas, Monſieur, au gré de noſtre envie.	Tout ne va pas, Monsieur, au gré de notre envie.
Le Ciel veut qu’icy bas chacun ait ſes Fâcheux;	Le Ciel veut qu'ici bas chacun ait ses Fâcheux;
Et les hommes ſeroient, ſans cela, trop heureux.	Et les hommes seraient, sans cela, trop heureux.
ERASTE.	ERASTE.
Mais de tous mes Fâcheux, le plus fâcheux encore, Eſt Lyſandre, tuteur de celle que j’adore;	Mais de tous mes Fâcheux, le plus fâcheux encore, Est Lysandre, tuteur de celle que j'adore;
Qui rompt ce qu’à mes tœua ene domne u'eſpoir, Et fait qu’en ſa preſence elle n’oſe me voir.	Qui rompt ce qu'à mes tœua ene domne espoir, Et fait en sa présence elle ose me voir.
Je crains d’avoir déja paſſé l'heure promiſe, Et c'eit dans cette allée, ou devoit eſtre Orphiſe,	Je crains d'avoir déjà passé l'heure promise, Et c'éit dans cette allée, ou devait être Orphise,
LA MONTAGNE.	LA MONTAGNE.
L’heure d’un rendez-vous d’ordinaire s’eſtend:	L'heure d'un rendez-vous d'ordinaire s'étend:
Et n’eſt pas reſſerrée aux bornes d’un inſtant.	Et n'est pas resserrée aux bornes d'un instant.
ERASTE.	ERASTE.
ai oir rlay y lllais jetrenibie;	ai oir rlai y lllais jetrenibie;
ce mon amour extréme D’un rien ſe fait un crime envers celle que j’ayme.	ce mon amour extrême D'un rien se fait un crime envers celle que j'aime.
LA MONTAGNE.	LA MONTAGNE.
Si ce parfait amour, que vous prouvez ſi bien, Se fait vers voſtre objet un grand crime de rien, Ce que ſon cœur, pour vous, ſent de feux legitimes.	Si ce parfait amour, que vous prouvez si bien, Se fait vers votre objet un grand crime de rien, Ce que son cœur, pour vous, sent de feux légitimes.
En revanche, luy fait un rien de tous vos ciimes.	En revanche, Seigneur fait un rien de tous vos cimes.
ERASTE.	ERASTE.
Mais, tout de bon, ciois-tu que je lois d’elle aymé?	Mais, tout de bon, ciais-tu que je lois d'elle aimé?
LA MONTAGNE.	LA MONTAGNE.
Quoy?	Quoi?
vous doutez encor d’un amour confirmé.	vous doutez encor d'un amour confirmé.
ERASTE.	ERASTE.
Ah c’eſt mal-aiſément qu'en pareille matiere, Un cœur bien entiamiie prend ulleulance entiere.	Ah c'est malaisément qu'en pareille matière, Un cœur bien entiamiie prend ulleulance entière.
Il craint de ſe flatter, & dans ſes divers ſoins, Ce que plus ii ſounaite, eit ce qu’il croit le moins.	Il craint de se flatter, et dans ses divers soins, Ce que plus ji souhaite, eit ce qu'il croit le moins.
Mais ſongeons à trouver une beauté ſi rare.	Mais songeons à trouver une beauté si rare.
LA MONTAGNE.	LA MONTAGNE.
Monſieur, voſtre rabat par devant ſe ſepare.	Monsieur, votre rabat par devant se sépare.
N’importe.	N'importe.
ERASTE.	ERASTE.
LA MONTAGNE.	LA MONTAGNE.
Laiſiez-moy l'ajuiter, s’il vous plaiſt.	Laisiez-moi l'ajuiter, s'il vous plaît.
ERASTE.	ERASTE.
Ouf, tu m'eſtrangles, fat, laiſſe-le, comme il eſt,	Ouf, tu m'étrangles, fat, laisse-le, comme il est,
LA MONTAGNE.	LA MONTAGNE.
Souffrez qu’on peigne un peu.	Souffrez qu'on peigne un peu.
ERASTE.	ERASTE.
oultne ialpaemle:	oultne jalpaemle:
Tu m’as, d’un coup de dent, preſque emporté l’oTeine.	Tu m'as, d'un coup de dent, presque emporté l'oTeine.
LA MONTAGNE.	LA MONTAGNE.
Vos canons.	Vos canons.
ERASTE.	ERASTE.
Laiſſe-les;	Laisse-les;
tu prens trop de ſoucy.	tu prends trop de souci.
LA MONTAGNE.	LA MONTAGNE.
Ils ſont tout chifonnez.	Ils sont tout chifonnés.
EMASTL.	ÉMASTL.
Je veux qu’ils ſoient ainſi.	Je veux qu'ils soient ainsi.
LA MONTAGNE.	LA MONTAGNE.
Accordez-moy du moins, pour grace ſinguliere, De frotter ce chapeau, qu’on voit plein de pouſſiere.	Accordez-moi du moins, pour grâce singulière, De frotter ce chapeau, qu'on voit plein de poussière.
ERASTE.	ERASTE.
Plotte done, puis qu'arlaut que j’en paſſe par là.	Plotte donce, puis qu'arlaut que j'en passe par là.
LA MONTAGNE.	LA MONTAGNE.
Le voulez-vous porter fait comme le vona?	Le voulez-vous porter fait comme le vona?
ERASTE.	ERASTE.
Mon Dieu dépeſche-toy.	Mon Dieu dépêche-toi.
D MONTACNE.	 DONTACNE.
Ce ſeroit conſcience.	Ce serait conscience.
LRASTE apres avoir attendu.	LRASTE après avoir attendu.
C'eſt aſſez.	C'est assez.
LA MONTAGNE.	LA MONTAGNE.
Donnez-vous un peu de patience.	Donnez-vous un peu de patience.
Il me tuë.	Il me tue.
ERASTE.	ERASTE.
LA MONTAGNE.	LA MONTAGNE.
En quel lieu vous eſtes-vous fourré?	En quel lieu vous êtes-vous fourré?
ERASTE.	ERASTE.
T'es-tu de ce chapeau pour toûjours emparé?	T'es-tu de ce chapeau pour toujours emparé?
C’eſt fait.	C'est fait.
LA MONTAGNE.	LA MONTAGNE.
ERASTE.	ERASTE.
Donne-moy donc.	Donne-moi donc.
LAMONTAGNE laiſſant tomber le chapeau.	LAMONTAGNE laissant tomber le chapeau.
Hay .	Hais .
ERASTE.	ERASTE.
Le voila par terre:	Le voilà par terre:
Je ſuis fort avancé:	Je suis fort avancé:
que la fiévre te ſerre.	que la fièvre te serre.
LA MONTAGNE.	LA MONTAGNE.
Permettez qu’en deux coups j’oſte.	Permettez qu'en deux coups j'ôte.
ERASTE.	ERASTE.
Il ne me plaiſt pas.	Il ne me plaît pas.
Au diantre tout valet qui vous eſt ſur les bras;	Au diantre tout valet qui vous est sur les bras;
Qui fatigue ſon Maiſtre, & ne fait que déplaire A force de vouſoir trancher du neceſſaire.	Qui fatigue son Maître, et ne fait que déplaire A force de vousoir trancher du nécessaire.
SCENE II.	SCÈNE II.
Daerlion, Anoindry nRsTE;	Daerlion, Anoindri nRsTE;
LA MONTAGNE.	LA MONTAGNE.
ERASTE.	ERASTE.
Ais voy-je pas Orphiſe?	Ais vois-je pas Orphise?
ouy c’eſt elle, qui vient.	oui c'est elle, qui vient.
Ou va-t-elle ſi viſte, & quel homme la tient?	Ou va-t-elle si vite, et quel homme la tient?
Il la ſaluë comme elle paſſe, & elle en paſſant detourne la teſte.	Il la salue comme elle passe, et elle en passant détourne la tête.
Quoy, me voir en ces lieux devant elle paroiſtre, Et paſſer en feignant de ne me pas connoiſtre!	Quoi, me voir en ces lieux devant elle paraître, Et passer en feignant de ne me pas connaître!
Que croire?	Que croire?
qu’en dis-tu?	qu'en dis-tu?
parle donc, ſi tu veux.	parle donc, si tu veux.
LA MONTAGNE.	LA MONTAGNE.
Monſieur, je ne dis rien de peur d’eſtre fâcheux.	Monsieur, je ne dis rien de peur d'être fâcheux.
ERASTE.	ERASTE.
Et c'eſt l'eſtre en effet que de ne me rien dire Dans les extremitez d’un ſi cruel martyre.	Et c'est l'être en effet que de ne me rien dire Dans les extrémités d'un si cruel martyre.
Fais donc quelque reſponce à mon cœur abbatu?	Fais donc quelque réponse à mon cœur abattu?
Que dois-je preſumer?	Que dois-je présumer?
parle, qu’en penſes-tu?	parle, qu'en penses-tu?
Dy-moy ton ſentiment.	Dis-moi ton sentiment.
LA MONTAGNE.	LA MONTAGNE.
Monſieur, je veux me taire, Et ne deſire pomt tranchel du necenanle.	Monsieur, je veux me taire, Et ne désire pompt tranchel du necenanle.
ERASTE.	ERASTE.
Peſte l’impertinent!	Peste l'impertinent!
va-t'en ſuivre leurs pas:	va-t'en suivre leurs pas:
Voy ce qu’ils deviendront, & ne les quitte pas.	Vois ce qu'ils deviendront, et ne les quitte pas.
LA MONTAGNE revenant.	LA MONTAGNE revenant.
Il faut ſuivre de loin?	Il faut suivre de loin?
ERASIE.	ERASIE.
Ouy.	Oui.
LA MONTAGNE revenant.	LA MONTAGNE revenant.
Sans que l’on me voye Ou faire aucun ſemblant qu’apres eux on m’envoye?	Sans que l'on me voie Ou faire aucun semblant qu'après eux on m'envoie?
DRASTE.	DRASTE.
Non, tu feras bien mieux de leur donner avis, Que par moroidle caples ioiont de toy laivis.	Non, tu feras bien mieux de leur donner avis, Que par moroidle caples joiont de toi laivis.
LA MONTAGNE revenant.	LA MONTAGNE revenant.
Vous trouveray-je icy?	Vous trouverai-je ici?
ERASTE.	ERASTE.
Que le Ciel te confonde, Homme, à mon ſentiment, le plus fâcheux du monde.	Que le Ciel te confonde, Homme, à mon sentiment, le plus fâcheux du monde.
La Montagne s’en va.	La Montagne s'en va.
Ah!	Ah!
que je ſens de trouble, & qu’il m’euſt eſté doux, Qu’on me l’euſt fait manquer, ce fatal rendez-vous.	que je sens de trouble, et qu'il m'eût été doux, Qu'on me l'eût fait manquer, ce fatal rendez-vous.
Je penſois y trouver toutes choſes propices;	Je pensais y trouver toutes choses propices;
Et mes yeux pour mon cœur y trouvent des ſuplices.	Et mes yeux pour mon cœur y trouvent des suplices.
SCENE III.	SCÈNE III.
LYSANDRE, ERASTE.	LYSANDRE, ERASTE.
LYSANDRE.	LYSANDRE.
COus ces arbres, de loin, mes yeux t’ont reconnu, Cher Marquis, & d’abord je ſuis à toy venu.	COus ces arbres, de loin, mes yeux t'ont reconnu, Cher Marquis, et d'abord je suis à toi venu.
Comme à de mes amis il faut que je te chante Certain air, que j’ay fait, de petite courante,	Comme à de mes amis il faut que je te chante Certain air, que j'ai fait, de petite courante,
Qui  Cour contente les experts, Et ſi quenlue de vingt ont desja fait des vers.	Qui Cour contente les experts, Et si quenlue de vingt ont déjà fait des vers.
den a naiſſance, & quelque employ paſſable, en France aſſez conſiderable;	den a naissance, et quelque emploi passable, en France assez considérable;
udrois pas, pour tout ce que je ſuis, nnt fait cét air, qu’icy je te produis.	Udrais pas, pour tout ce que je suis, nnt fait cet air, qu'ici je te produis.
hem, hem:	hem, hem:
écoute avec ſoin, je te prie.	écoute avec soin, je te prie.
N’eit-elle pas belle?	N'éit-elle pas belle?
Il chante ſa courante.	Il chante sa courante.
ERASTE.	ERASTE.
Ah !	Ah !
LYSANDRE.	LYSANDRE.
Cettemt er jolie.	Cettemt er jolie.
Il rechante la fin quatre ou cinq fois de ſuitte.	Il rechante la fin quatre ou cinq fois de suite.
conſnent la tlouves tu:	consnent la tlouves -tu:
ERASTE.	ERASTE.
Fort belle aſſeurément.	Fort belle assurément.
LYSANDRE.	LYSANDRE.
Les pas que j’en ay faits n’ont pas moins d’agrément, Et ſur tout la figure a merveilleuſe grace.	Les pas que j'en ai faits n'ont pas moins d'agrément, Et sur tout la figure a merveilleuse grâce.
Il chante, parle & danſe tout enſemble, & faic faire à Eraſte les figures de la ſemme.	Il chante, parle et danse tout ensemble, et faic faire à Eraste les figures de la semme.
Tien, l’homme paſſe ainſi:	Tiens, l'homme passe ainsi:
puis la femme repaſſe:	puis la femme repasse:
Enſemble:	Ensemble:
puis on quitte, & la femme vient là.	puis on quitte, et la femme vient là.
Vois-tu ce petit trait de feinte que voila?	Vois-tu ce petit trait de feinte que voilà?
Ce fieuret?	Ce fieuret?
ces coupez courant aprés la belle?	ces coupez courant après la belle?
Dos à dob.	Dos à dob.
lace à lace, en le prenaut lur ene.	lace à lace, en le prenaut lur ene.
Aprés avoir acheve.	Après avoir achève.
Que t'en lemble Marquis :	Que t'en lemble Marquis :
ERASTE.	ERASTE.
Tous ces pas là ſont fins.	Tous ces pas là sont fins.
LY SANDRE.	LI SANDRE.
Je me mocque, pour moy, des maiſtres Baladins.	Je me moque, pour moi, des maîtres Baladins.
On le voit.	On le voit.
ERASTE.	ERASTE.
LYSANDEE.	LYSANDE.
Les pasuone	Les pasuone
ERASTE.	ERASTE.
N’ont rien qui ne ſurptenne.	N'ont rien qui ne surptenne.
LYSANDRE.	LYSANDRE.
Veux-tu, par amitié, que je te les apprenne?	Veux-tu, par amitié, que je te les apprenne?
ERASTE.	ERASTE.
Ma foy, pour le preſent, j’ay certain embarras.	Ma foi, pour le présent, j'ai certain embarras.
LYSANDRE.	LYSANDRE.
Et bien donc, ce ſera, lors que tu le voudras.	Et bien donc, ce sera, lors que tu le voudras.
Si j’avois deſſus-moy ces paroles nouvelles, Nous les lirions enſemble, & verrions les plus belles.	Si j'avais dessus-moi ces paroles nouvelles, Nous les lirions ensemble, et verrions les plus belles.
Une autre fois.	Une autre fois.
ERASTE.	ERASTE.
LYSANDRE.	LYSANDRE.
Adieu:	Adieu:
Baptiſte le tres-cher R u ponle vou ma coulalce, cejolo tad cnefcher.	Baptiste le très-cher R u ponle vou ma coulalce, colo tad cnefcher.
Nous avons, pour les airs, de grandes ſimpathies, Et je veux le prier d’y faire des parties.	Nous avons, pour les airs, de grandes sympathies, Et je veux le prier d'y faire des parties.
Il s’en va chantant tousjours.	Il s'en va chant toujours.
ERASTE.	ERASTE.
Ciel!	Ciel!
faut-il que le rang, dont on veut tout couvrir, De cent ſots, tous les jours, nous oblige à ſouffrir;	faut-il que le rang, dont on veut tout couvrir, De cent sots, tous les jours, nous oblige à souffrir;
Et nous faſſe abaiſſer juſques aux complaiſances D’applaudir bien ſouvent à leurs impertinences?	Et nous fasse abaisser jusques aux complaisances D'applaudir bien souvent à leurs impertinences?
CENE IV.	CÈNE IV.
LA MONTAGNE, ERASTE.	LA MONTAGNE, ERASTE.
LA MONTAGNE.	LA MONTAGNE.
[Onſieur, Orphiſe eſt ſeule, & vient de ce coſté.	[Onsieur, Orphise est seule, et vient de ce côté.
ERASTE.	ERASTE.
Ah, d’un trouble bien grand je me ſens agité!	Ah, d'un trouble bien grand je me sens agité!
J’ay de l’amour encor pour la belle inhumaine, Et hia fitomau aurore, que peurle de la naine?	J'ai de l'amour encor pour la belle inhumaine, Et hia fitomau aurore, que peurle de la naine?
LA MONTAGNE.	LA MONTAGNE.
Monſieur, voſtre raiſon ne ſçait ce qu’elle veut;	Monsieur, votre raison ne sait ce qu'elle veut;
Ny ce que ſur un cœur une Maiſtreſſe peut.	Ni ce que sur ce cœur une Maîtresse peut.
Bien que de s’emporter on ait de juſtes cauſes, Une belle, d’un mot, rajuſte bien des choſes.	Bien que de s'emporter on ait de justes causes, Une belle, d'un mot, rajuste bien des choses.
ERASTE.	ERASTE.
Helas, je te l’avouë, & déja cét aſpect A toute ma corcre maipraine le leipeets	Hélas, je te l'avoue, et déjà cet aspect À toute ma corcre maipraine le leipeets
SCENE V.	SCÈNE V.
ONTAIOE, BEMORE, uM MONTAGNE.	ONTAIOE, BEMORE, UM MONTAGNE.
ORPHISE.	ORPHISE.
IJ Oſtre front à mes yeux monſtre peu d’allegreſſe.	JJ Ostre front à mes yeux montre peu d'allégresse.
Seroit-ce ma preſence, Eraſte, qui vous bleſſe?	Serait-ce ma présence, Eraste, qui vous blesse?
Qu’eſt-ce donc?	Qu'est-ce donc?
qu’avez-vous?	qu'avez-vous?
& ſur quels déplaiſirs, Lors que vous me voyez, pouſſez-vous des ſoûpirs?	et sur quels déplaisirs, Lors que vous me voyez, poussez-vous des soupirs?
ERASTE.	ERASTE.
Helas, pouvez-vous bien me demander, cruelle, Ce qui fait de mon cœur la triſteſſe mortelle?	Hélas, pouvez-vous bien me demander, cruelle, Ce qui fait de mon cœur la tristesse mortelle?
Et d’un eſprit méchant n’eſt-ce pas un effet, Que feindre d’ignorer ce que vous m’avez fait?	Et d'un esprit méchant n'est-ce pas un effet, Que feindre d'ignorer ce que vous m'avez fait?
Celuy dont l’entretien vous a fait, à ma veuë, Paſſer.	Celui dont l'entretien vous a fait, à ma vue, Passer.
ORPHISE riant.	ORPHISE riant.
C’eſt de cela, que voſtre ame eſt eſmeuë?	C'est de cela, que votre âme est émue?
ERASTE.	ERASTE.
Inſultez inhumaine, encor à mon malheur.	Insultez inhumaine, encor à mon malheur.
Allez, il vous ſied mal de railler ma douleur;	Allez, il vous sied mal de railler ma douleur;
Et d’abuſer, ingrate, à maltraiter ma flâme, Du foible, que pour vous, vous ſçavez, qu’a mon ame.	Et d'abuser, ingrate, à maltraiter ma flamme, Du faible, que pour vous, vous savez, qu'a mon âme.
ORPHISE.	ORPHISE.
Certes il en faut rire, & confeſſer icy, Que vous eſtes bien fou, de vous troubler ainſi.	Certes il en faut rire, et confesser ici, Que vous êtes bien fou, de vous troubler ainsi.
L’homme, dont vous parlez, loin qu’il puiſſe me plaire, Eſt un homme Fâcheux dont j’ay ſeeu me defaire;	L'homme, dont vous parlez, loin qu'il puisse me plaire, Est un homme Fâcheux dont j'ai sû me défaire;
Un de ces importuns, & ſots officieux, Qui ne ſçauroient ſouffrir qu’on ſoit ſeule en des lieux;	Un de ces importuns, et sots officieux, Qui ne sauraient souffrir qu'on soit seule en des lieux;
ui Et viennent auſſi-toſt, avec un doux langage, Vous donner une main, contre qui l’on enrâge.	Oui Et viennent aussitôt, avec un doux langage, Vous donner une main, contre qui l'on enrâge.
J’ay feint de m’en aller, pour cacher mon déſſein:	J'ai feint de m'en aller, pour cacher mon déssein:
Lt, juſqu’à mon caroſſe, il m’a preſté la main.	Lét, jusqu'à mon carosse, il m'a prêté la main.
Je m’en ſuis promptement defaite de la ſorte, Et j’ay pour vous trouver, rentré par l’autre porte.	Je m'en suis promptement défaite de la sorte, Et j'ai pour vous trouver, rentré par l'autre porte.
ERASTE.	ERASTE.
A vos diſeours, Orphiſe, adjouſteray-je foy?	À vos diseours, Orphise, ajouterai-je foi?
Et voſtre cœur eſt-il tout ſincere pour moy?	Et votre cœur est-il tout sincère pour moi?
ORPHISE.	ORPHISE.
Je vous trouve fort bon, de tenir ces paroles;	Je vous trouve fort bon, de tenir ces paroles;
Quand je me juſtifie à vos plaintes frivoles.	Quand je me justifie à vos plaintes frivoles.
Je ſuis bien ſimple encor, & ma ſotte bonté.	Je suis bien simple encor, et ma sotte bonté.
ERASTE.	ERASTE.
Ah ne vous faſchez pas, trop ſevere beauté.	Ah ne vous fâchez pas, trop sévère beauté.
Je veux croire en aveugle, eſtant ſous voſtre empire, Tout ce que vous aurez la bonté de me dire.	Je veux croire en aveugle, étant sous votre empire, Tout ce que vous aurez la bonté de me dire.
Trompez, ſi vous voulez, un malheureux Amant;	Trompez, si vous voulez, un malheureux Amant;
j’athiay pour vous reipect, juiques au monument.	j'athiai pour vous rejet, juiques au monument.
Maltraitez mon amour, refuſez-moy le voſtre;	Maltraitez mon amour, refusez-moi le vôtre;
Expoſez à mes yeux le triomphe d’un autre, Ouy je ſouffriray tout de vos divins appas, J’en mourray, mais enfin je ne m’en plaindray pas.	Exposez à mes yeux le triomphe d'un autre, Oui je souffrirai tout de vos divins appas, J'en mourrai, mais enfin je ne m'en plaindrai pas.
ORPHISE.	ORPHISE.
Quand de tels ſentimens regneront dans voſtre ame, Je igauray de ma part.	Quand de tels sentiments régneront dans votre âme, Je igaurai de ma part.
COMEDIE.	COMÉDIE.
SCENE VI.	SCÈNE VI.
ALCANDRE, ORPHISE, ERASTE, LA MONTAGNE.	ÀLCANDRE, ORPHISE, ERASTE, LA MONTAGNE.
ALCANDRE.	ÀLCANDRE.
Arquis un mot.	Arquis un mot.
Madame, De grace pardonnez, ſi je ſuis indiſcret, En oſant, devant vous, luy parler en ſecret.	Madame, De grâce pardonnez, si je suis indiscret, En osant, devant vous, lui parler en secret.
Avec peine, Marquis, je te fais la priere;	Avec peine, Marquis, je te fais la prière;
Mais un homme vient-là de me rompre en viſiere, Et je ſouhaite fort, pour ne rien reculer, Qu’à l’heure de ma part, tu l’ailles appeller.	Mais un homme vient-là de me rompre en visière, Et je souhaite fort, pour ne rien reculer, Qu'à l'heure de ma part, tu l'ailles appeler.
Tu ſçais, qu’en pareil cas, ce ſeroit avec joye, Que je te le rendrois en la meſme monnoye.	Tu sais, qu'en pareil cas, ce serait avec joie, Que je te le rendrais en la même monnaie.
ERASTE Apres auoir un peu demeuré ſans parler.	ERASTE Après avoir un peu demeuré sans parler.
Je ne veux point icy faire le Capitan;	Je ne veux point ici faire le Capitan;
Mais on m’a veu ſoldat, avant que Courtiſan.	Mais on m'a vu soldat, avant que Courtisan.
J’ay ſervy quatorze ans, & je croy eſtre en paſſe, De pouvoir d’un tel pas me tirer avec grace, Et de ne craindre point, qu’à quelque laſcheté Le refus de mon bras me puiſſe eſtre imputé.	J'ai servi quatorze ans, et je crois être en passe, De pouvoir d'un tel pas me tirer avec grâce, Et de ne craindre point, qu'à quelque lâcheté Le refus de mon bras me puisse être imputé.
Un duel met les gens en mauvaiſe poſture, Et noſtre Roy n’eſt pas un Monarque en peinture.	Un duel met les gens en mauvaise posture, Et notre Roi n'est pas un Monarque en peinture.
Il ſçait faire obeïr les plus grans de l’Eſtat, Et je trouve qu’il fait en digne Potentat.	Il sçait faire obéir les plus grans de l'État, Et je trouve qu'il fait en digne Potentat.
Quand il faut le ſervir, j’ay du cœur, pour le faire?	Quand il faut le servir, j'ai du cœur, pour le faire?
Mais je ne m’en ſens point, quand il faut luy déplaite.	Mais je ne m'en sens point, quand il faut venir déplaite.
Je me fais de ſon ordre une ſupréme Loy.	Je me fais de son ordre une suprême Loi.
Pour luy deſobeïr, cherche un autre que moy.	Pour ra désobéir, cherche un autre que moi.
Je te parle, Vicomte, avec franchiſe entiere, Et ſuis ton ſerviteur en toute autre matiere, Adieu.	Je te parle, Vicomte, avec franchise entière, Et suis ton serviteur en toute autre matière, Adieu.
Cinquante fois au Diable les Fâcheux.	Cinquante fois au Diable les Fâcheux.
Ou donc s’eit retlle cer objet de mles vœux?	Ou donc s'éit retlle cer objet de mles vœux?
Je ne ſçay.	Je ne sais.
LA MONTAGNE.	LA MONTAGNE.
ERASTE.	ERASTE.
Pour ſçavoir où la belle eſt allée, Va-t’en cherener par tout, j attens dans cette allée.	Pour savoir où la belle est allée, Va-t-en chérener par tout, attends dans cette allée.
Fin du premier Acte.	Fin du premier Acte.
BALCOMEDIE.	BALCOMEDIE.
BALLET Dut premier Acte.	BALLET Dut premier Acte.
PREMIERE ENTRE’E.	PREMIÈRE ENTRE'E.
Es Joüeurs de Mail, en criant, gare, D'l’obligent à ſe retirer:	Es Joüeurs de Mail, en criant, gare, D'obligent à se retirer:
& comme il veut revenir lors qu’ils ont fait,	et comme il veut revenir lors qu'ils ont fait,
Des Curieux viennent qui tournent autour de luy pour le connoiſtre, & font qu’il ſe retire ncore pour un moment.	Des Curieux viennent qui tournent autour de Dieux pour le connaître, et font qu'il se retire nécore pour un moment.
B 4	 4
ACTE	ACTE
ACTE II.	ACTE II.
SCENE PREMIERE.	SCÈNE PREMIÈRE.
ERASTE.	ERASTE.
Es Faſcheux à la fin ſe ſont-ils eſcartez?	Es Fâcheux à la fin se sont-ils écartés?
e penſe qu’il en pleut icy de tous coſtez.	Je pense qu'il en pleut ici de tous côtés.
Je les fuis, & les trouve, & pour ſecond martire, Je ne ſçaurois trouver celle que je deſire.	Je les fuis, et les trouve, et pour second martyre, Je ne saurais trouver celle que je désire.
Le tonnerre, & la pluye ont promptement paſſé, Et n’ont point, de ces lieux, le beau monde chaſſé.	Le tonnerre, et la pluie ont promptement passé, Et n'ont point, de ces lieux, le beau monde chassé.
Pluſt au Ciel, dans les dons que ſes ſoins y prodiguent, Qu’ils en euſſent chaſſé tous les gens, qui fatiguent!	Plût au Ciel, dans les dons que ses soins y prodiguent, Qu'ils en eussent chassé tous les gens, qui fatiguent!
Le Soleil baiſſe fort, & je ſuis eſtonné, Que mon Valet encor ne ſoit point retourné.	Le Soleil baisse fort, et je suis étonné, Que mon Valet encor ne soit point retourné.
SCENE II.	SCÈNE II.
ALCIPE, ERASTE.	ÀLCIPE, ERASTE.
DOn jour.	DOn jour.
A LCIPE.	À LCIPE.
ERASTE.	ERASTE.
Et quoy, tousjours ma flâme divertie!	Et quoi, toujours ma flamme divertie!
ALCIPE.	ÀLCIPE.
Conſole-moy, Marquis, d’une étrange partie, Qu’au Piquet je perdis, hier, contre un S.	Console-moi, Marquis, d'une étrange partie, Qu'au Piquet je perdis, hier, contre un S.
Bouvain, A qui je donnerois quiine pomts, ce la mailiC’eſt C’eſt un coup enragé, qui depuis bier m’accable, Et qui feroit donner tous les Joüeurs au Diable;	Bouvain, À qui je donnerais quiine pompts, ce la mailiC'est C'est un coup enragé, qui depuis bier m'accable, Et qui ferait donner tous les Joueurs au Diable;
Un coup aſſeurément à ſe pendre en public.	Un coup assurément à se pendre en public.
Il ne m’en faut que deux;	Il ne m'en faut que deux;
l’autre a beſoin d’un pic.	l'autre a besoin d'un pic.
Ie donne;	Je donne;
il en prend ſix, & demande à refaire:	il en prend six, et demande à refaire:
Moy, me voyant de tout, je n’en voulus rien faire.	Moi, me voyant de tout, je n'en voulus rien faire.
Je porte l’as de trefle, admire mon malheur, L’as, le Roy, le valet, le huict, & dix de cœur;	Je porte l'as de trèfle, admire mon malheur, L'as, le Roi, le valet, le huit, et dix de cœur;
Et quitte, comme au point alloit la politique, Dame, & Roy de carreau;	Et quitte, comme au point allait la politique, Dame, et Roi de carreau;
dix, & Dame de pique.	dix, et Dame de pique.
Sur mes cinq cœurs portez la Dame arrive encor, ui me fait juſtement une quinte major:	Sur mes cinq cœurs portez la Dame arrive encor, ui me fait justement une quinte major:
Mais mon homine, avec l’as, non ſans ſurpriſe extréme,  Reili Des bas carreaux, ſur table, étale une ſixiéme.	Mais mon homine, avec l'as, non sans surprise extrême, Reili Des bas carreaux, sur table, étale une sixième.
l’en avois écarté la Dame, avec le Roy;	l'en avais écarté la Dame, avec le Roi;
Mais luy fallant un pic, je ſortis hors d’effroy, Et croïois bien du moins faire deux points uniques.	Mais était fallant un pic, je sortis hors d'effroi, Et croïois bien du moins faire deux points uniques.
Avec les ſept carreaux, il avoit quatre piques;	Avec les sept carreaux, il avait quatre piques;
Et, jettant le dernier, m’a mis dans l’embarras, De ne ſçavoir lequel garder de mes deux as.	Et, jetant le dernier, m'a mis dans l'embarras, De ne savoir lequel garder de mes deux as.
J’ay jetté l’as de cœur, avec raiſon me ſemble;	J'ai jeté l'as de cœur, avec raison me semble;
Mais il avoit quitté quatre trefles enſemble, et par un na de cueul je me idis veucapor, Sans pouvoir, de depit, proferer un ſeul mot.	Mais il avait quitté quatre trèfles ensemble, et par un na de cueul je me idis veucapor, Sans pouvoir, dé dépit, proférer un seul mot.
Morbleu fais-moy raiſon de ce coup effroyable.	Morbleu fais-moi raison de ce coup effroyable.
16 an momts que l'avon veu, pent-n'eme cioyanies	16 an moments que l'avon vu, pent-n'eme cioyanies
ERASTE.	ERASTE.
121121 C’eſt dans le jeu, qu’on voit les plus grands coupe du ſort.	121121 C'est dans le jeu, qu'on voit les plus grands coupe du sort.
ALCIPE.	ÀLCIPE.
Parbleu tu jugeras, toy-meſme, ſi j’ay tort;	Parbleu tu jugeras, toi-même, si j'ai tort;
Et ſi c’eſt ſans raiſon, que ce coup me tranſporte;	Et si c'est sans raison, que ce coup me transporte;
Car voicy nos deux jeux, qu’exprés ſur moy je porte ne obaor-SAMaG.	Car voici nos deux jeux, qu'exprès sur moi je porte ne obaor-SAMaG.
Tien, c’eſt icy mon port, comme je te l’ay dit;	Tiens, c'est ici mon port, comme je te l'ai dit;
Etvoi.	Évoi.
OEGGSER ASTIE.	OÉGGSER ASTIE.
HH.	HH.
J’ay compris le tout, par ton recit, Et voy de la juſtice au tranſport qui t’agite;	J'ai compris le tout, par ton récit, Et vois de la justice au transport qui t'agite;
Ciiuo, pour certaine affaire, il faut que je te quitte:	Civo, pour certaine affaire, il faut que je te quitte:
Adieu conſole-toy, pourtant, de ton malheur.	Adieu console-toi, pourtant, de ton malheur.
YALCIPE.	YALCIPE.
VE Qui?	VE Qui?
moy?	moi?
j’auray tousjours ce coup là ſur le cœur:	j'aurai toujours ce coup là sur le cœur:
Et c’eſt, pour ma raiſon, pis qu’un coup de tonnerre, Je le veux faire, moy, voir à toute la dIts en va, & pret a rentrer, ti die par rentexi es 1 aa n u Un ſix de cœur!	Et c'est, pour ma raison, pis qu'un coup de tonnerre, Je le veux faire, moi, voir à toute la dIts en va, et prêt a rentrer, ty die par rentexi ès 1 a n u Un six de cœur!
deux points !	deux points !
6	6
21 ERASTE.	21 ERASTE.
En quel lieu ſommes-nous!	En quel lieu sommes-nous!
De quelque part qu’on tourne, on ne voit que des  foux.	De quelque part qu'on tourne, on ne voit que des foux.
o io Ah!	ô jo Ah!
que tu fais languir ma juſte impatience.	que tu fais languir ma juste impatience.
SCENE III.	SCÈNE III.
LA MONTAGNE, ERASTE.	LA MONTAGNE, ERASTE.
LA MONTAGNE.	LA MONTAGNE.
n 11 M iinoi Men dao.	n 11 M jinai Men dao.
MOnſieur, je n’ay pû faire une autre diligence.	MOnsieur, je n'ai pu faire une autre diligence.
A(ORUEOR AOS T E.	A(ORUEOR AOS T E.
OVA ISUpeniOHI A Mais me raportes-tu quelque nouvelle enfin?	OUA ISUeniOHI A Mais me rapportes-tu quelque nouvelle enfin?
LA MONTAGNE.	LA MONTAGNE.
Sans doute;	Sans doute;
& de l’objet qui fait voſtre deſtin, J’ay par un ordre expres quelque choſe à vous dire.	et de l'objet qui fait votre destin, J'ai par un ordre exprès quelque chose à vous dire.
ERASTE.	ERASTE.
Et quoy?	Et quoi?
déja mon cœur aprés ce mot ſoûpire, Parle, an e 39ug OII	déjà mon cœur après ce mot soupire, Parle, an eût 39ug OI
HLAMONTAGNE (IOVI Souhaittez-vous de ſçavoir ce que c’eſt, 1 ERASTE	HLAMONTAGNE (IOUI Souhaitez-vous de savoir ce que c'est, 1 ÉRASTE
Ouj, dy viltes ERASTE.	Ouj, dis viltes ERASTE.
LA MONTAGNE.	LA MONTAGNE.
Monſieur, attendez, s’il vous plaiſt.	Monsieur, attendez, s'il vous plaît.
j'ie luis, 3Mar, preſque mis hors d’haleine.	j'ie luis, 3Mar, presque mis hors d'haleine.
ERASTE.	ERASTE.
Pus-tu quelque plaiſir à me tenir en peine?	Pus-tu quelque plaisir à me tenir en peine?
LA MONTAGNE.	LA MONTAGNE.
Puiſque vous deſirez de ſçavoir promptement L’ordre que j’ay receu de cét objet charmant, Je vous diray.	Puisque vous désirez de savoir promptement L'ordre que j'ai reçu de cet objet charmant, Je vous dirai.
Ma foy, ſans vous vanter mon zele, j’ay bien fait du chemin, pour trouver cette belle, Et ſi.	Ma foi, sans vous vanter mon zèle, j'ai bien fait du chemin, pour trouver cette belle, Et si.
ERASTE.	ERASTE.
Peſte ſoit fait de tes digreſſions.	Peste soit fait de tes digressions.
LA MONTAGNE.	LA MONTAGNE.
Ah!	Ah!
il faut moderer un peu ſes paſſions, Et Seneque.	il faut modérer un peu ses passions, Et Sénèque.
ERASTE.	ERASTE.
Seneque eſt un ſot dans ta bouche, Puis qu’il ne me dit rien de tout ce qui me touche.	Sénèque est un sot dans ta bouche, Puis qu'il ne me dit rien de tout ce qui me touche.
2y May tonoldle, tole.	2i May tonoldle, tole.
LA MONTAGNE.	LA MONTAGNE.
Pour contenter vos veux, Voſtre Orphiſe.	Pour contenter vos veux, Votre Orphise.
Une beſte eſt là dans vos cheveux.	Une bête est là dans vos cheveux.
Laiſſe.	Laisse.
ERASTE.	ERASTE.
LA MONTAGNE.	LA MONTAGNE.
Cetté beaiſle de la pait vous lait dire.	Ceté beaisle de la paît vous lait dire.
Quoy?	Quoi?
ERASTE.	ERASTE.
LA MONTAGNE.	LA MONTAGNE.
Devinez.	Devinez.
ERASTE.	ERASTE.
Sçais-tu que je ne veux pas rire?	Sais-tu que je ne veux pas rire?
LA MONTAGNE.	LA MONTAGNE.
Son ordre eſt qu’en ce lieu vous devez vous tenir, Aſſeuré que dans peu vous l’y verrez venir, Lors qu’elle aura quitté quelques provinciales, Aux perſonnes de Cour fâcheuſes animales.	Son ordre est qu'en ce lieu vous devez vous tenir, Assuré que dans peu vous l'y verrez venir, Lors qu'elle aura quitté quelques provinciales, Aux personnes de Cour fâcheuses animales.
ERASTE.	ERASTE.
Tenons-nous donc au lieu qu’elle a voulu chomr?	Tenons-nous donc au lieu qu'elle a voulu chomr?
Mais, puiſque l’ordre icy m’offre quelque loiſir, Laiſſe moy mediter, j’ay deſſein de luy faire Quelques vers, ſur un air, où je la voy ſe plaire.	Mais, puisque l'ordre ici m'offre quelque loisir, Laisse moi méditer, j'ai dessein de donner faire Quelques vers, sur un air, où je la vois se plaire.
Il ſe promene en reſvant.	Il se promène en rêvant.
SCENE IV.	SCÈNE IV.
ORANTE, CLIMENE, ERASTE.	ORANTE, CLIMENE, ERASTE.
ORANTE.	ORANTE.
I Out le monde ſera de mon opinion.	I Out le monde sera de mon opinion.
CLIMENE.	CLIMENE.
Croyez-vous l’emporter par obſtination?	Croyez-vous l'emporter par obstination?
* .	* .
OTANTLE Je penſe mes raiſons meilleures que les voſtres.	OTANTLE Je pense mes raisons meilleures que les vôtres.
CLIMENE.	CLIMENE.
Je voudrois qu’on ouyſt les unes & les autres.	Je voudrais qu'on ouïst les unes et les autres.
ORANTE.	ORANTE.
J’aviſe un homme icy qui n’eſt pas ignorant;	J'avise un homme ici qui n'est pas ignorant;
Il pourra nous juger ſur noſtre different.	Il pourra nous juger sur notre différent.
mnarquis, de piace, un mot.	ménarquis, de piace, un mot.
soufrez qu’on vous appelle, Pour eſtre, entre nous deux, juge d’une querelle, D’un debat, qu’ont émeu non divers ſentimens, Sur ce qui peut marquer les plus parfaits Amants.	souffrez qu'on vous appelle, Pour donner, entre nous deux, juge d'une querelle, D'un débat, qu'ont ému non divers sentiments, Sur ce qui peut marquer les plus parfaits Amants.
ERASTE.	ERASTE.
C’eſt une queſtion à vuider difficile, Et vous devez chercher un Juge plus habile.	C'est une question à vider difficile, Et vous devez chercher un Juge plus habile.
ORAN	ORAN
ORANTE.	ORANTE.
Non, vous nous dites-là d’inutiles chanſons:	Non, vous nous dites-là d'inutiles chansons:
Voſtre eſprit fait du bruit, & nous vous connoiſſons;	Votre esprit fait du bruit, et nous vous connaissons;
Nous içavons que chacun vous donne à juſte tittre.	Nous içavons que chacun vous donne à juste tittre.
Hé de grace,.	Hé de grâce,.
ERASTE.	ERASTE.
ORANTE.	ORANTE.
Eii tiii mot rous leren hoſtre arbitre, Et ce ſont deux momens qu’il vous faut nous donCLIMENE.	Éjà ty mot rous leren hotre arbitre, Et ce sont deux moments qu'il vous faut nous donCLIMENE.
ner.	ner.
Vous retenez icy qui vous doit condamner:	Vous retenez ici qui vous doit condamner:
Car enfin, s’il eſt vray ce que j’en oſe croire, Monſieur, à mes raiſons, donnera la victoire.	Car enfin, s'il est vrai ce que j'en ose croire, Monsieur, à mes raisons, donnera la victoire.
BAADEES.	BADES.
Que ne puis-je à mon traiſtre inſpirer le ſoucy, D’inventer quelque choſe à me tirer d’icy!	Que ne puis-je à mon traître inspirer le souci, D'inventer quelque chose à me tirer d'ici!
ORANTE.	ORANTE.
Pour moy de ſon eſprit j’ay trop bon témoignage, Pour craindre qu’il prononce à mon deſavantage, En fin ce grand debat qui s’allume entre nous, alat de rȩaron s'i fatit qu'uil iriſiane tor jaloux.	Pour moi de son esprit j'ai trop bon témoignage, Pour craindre qu'il prononce à mon désavantage, En fin ce grand débat qui s'allume entre nous, alat de raron s'y fatit qu'il irisiane tor jaloux.
CLIMENE.	CLIMENE.
Ou, pour mieux expliquer ma penlée & la voitre, Lequel doit plaire plus d’un jaloux ou d’un autre.	Ou, pour mieux expliquer ma penlée et la voitre, Lequel doit plaire plus d'un jaloux ou d'un autre.
ORANTE.	ORANTE.
Pour moy, ſans contredit, je ſuis pour le dernier.	Pour moi, sans contredit, je suis pour le dernier.
OHIMENE.	OHIMENE.
Et dans mon ſentiment je tiens pour le premier.	Et dans mon sentiment je tiens pour le premier.
ORANTE.	ORANTE.
je croy que noſtre cœur doit donner ion funrage A qui fait éclater du reſpect davantage.	je crois que notre cœur doit donner ion funrage À qui fait éclater du respect davantage.
CLIMENE.	CLIMENE.
Et moy, que ſi nos vœux doivent paroiſtre au jour, C’eſt pour celuy qui fait éclater plus d’amour.	Et moi, que si nos vœux doivent paraître au jour, C'est pour celui qui fait éclater plus d'amour.
ORANTE.	ORANTE.
Ouy, mais on voit l’ardeur uont uiiie umne eirſaiſie, B7 Bien Bien mieux dans le reſpect, que cans la jalouſie.	Oui, mais on voit l'ardeur uont uivie umne eirsaisie, B7 Bien Bien mieux dans le respect, que cans la jalousie.
CLIMENE.	CLIMENE.
Et c’eſt mon ſentiment, que qui s’attachei nous, Nous ayme d’autant plus, qu’il le monnie falous.	Et c'est mon sentiment, que qui s'attachei nous, Nous aime d'autant plus, qu'il le monnie falous.
ORANTE.	ORANTE.
Fi, ne me parlez point, pour eſtre Amans, Climene.	Fi, ne me parlez point, pour être Amants, Climène.
De ces gens dont l’amour eſt fait comme la haine Et qui, pour tous reſpects, & toute oſtre de vœux Ne s’appliquent jamais, qu’à ſe rendre Faſcheux;	De ces gens dont l'amour est fait comme la haine Et qui, pour tous respects, et toute otre de vœux Ne s'appliquent jamais, qu'à se rendre Fâcheux;
Dont l’ame, que ſans ceſſe un noir tranſport anime, Des moindres actions cherche à nous faire un crime;	Dont l'âme, que sans cesse un noir transport anime, Des moindres actions cherche à nous faire un crime;
En ſoûmet l’innocence à ſon aveuglement, Et veut, ſur un coup d’œil, un éclairciſſement:	En soumet l'innocence à son aveuglement, Et veut, sur un coup d'œil, un éclaircissement:
Qui de quelque chagrin nous voyant l’apparence, Se plaignent auſſi-toſt, qu’il naiſt de leur preſence;	Qui de quelque chagrin nous voyant l'apparence, Se plaignent aussitôt, qu'il naît de leur présence;
Et lors que dans nos yeux brille un peu d’enjoûment, Veulent que leurs Rivaux en ſoient le fondement:	Et lors que dans nos yeux brille un peu d'enjoument, Veulent que leurs Rivaux en soient le fondement:
En fin, qui prenant droit des fureurs de leur zele.	En fin, qui prenant droit des fureurs de leur zèle.
Ne vous parlent jamais, que pour faire querelle, Oiefit denendre a tous l'approche de nos cœurs, Et ſe font les tyrans de leurs propres vainqueurs.	Ne vous parlent jamais, que pour faire querelle, Oiefit denendre à tous l'approche de nos cœurs, Et se font les tyrans de leurs propres vainqueurs.
Moy je veux des Amans que le reſpect inſpife;	Moi je veux des Amants que le respect inspife;
Et leur ſoûmiſſion marque mieux noſtre empire.	Et leur soumission marque mieux notre empire.
CLIMENE.	CLIMENE.
Fi, ne me parlez point, pour eſtre vrais Amans, De ces gens, qui pour nous n’ont nuls emportements;	Fi, ne me parlez point, pour être vrais Amants, De ces gens, qui pour nous n'ont nuls emportements;
De ces tiedes Galans, de qui les cœurs paiſibles Tiennent desja pour eux les choſes infaillibles;	De ces tièdes Galants, de qui les cœurs paisibles Tiennent déjà pour eux les choses infaillibles;
N’ont point peur de nous perdre, & laiſſent chaque jour, Sur trop de confiance endormir leur amour;	N'ont point peur de nous perdre, et laissent chaque jour, Sur trop de confiance endormir leur amour;
Sont avec leurs Rivaux en bonne intelligence, Et laiſſent un champ libre à leur perſeverance.	Sont avec leurs Rivaux en bonne intelligence, Et laissent un champ libre à leur persévérance.
Un amour ſi tranquille excite mon courroux.	Un amour si tranquille excite mon courroux.
C’eſt aimer froidement que n’eſtre point jaloux;	C'est aimer froidement que n'être point jaloux;
Et je veux, qu’un Amant pour me prouver ſa flâme, Sur d’eternels ſoupçons laiſſe flotter ſon ame, par de prompts tranſports, donne un ſigne éclatant De l’eſtime qu’il fait de celle qu’il pretend.	Et je veux, qu'un Amant pour me prouver sa flamme, Sur d'éternels soupçons laisse flotter son âme, par de prompts transports, donne un signe éclatant De l'estime qu'il fait de celle qu'il prétend.
On s’applaudit alors de ſon inquietude, Et s’il nous fait par fois un traitement trop rude, Le plaiſir de le voir ſoûmis à nos genous, S’excuſer de l’éclat qu’il a fait contre nous, Ses pleurs, ſon deſeſpoir d'avoir pu nous deplaire, Eſt un charme à calmer toute noſtre colere.	On s'applaudit alors de son inquiétude, Et soumis à nous fait par fois un traitement trop rude, Le plaisir de le voir soumis à nos genous, S'excuser de l'éclat qu'il a fait contre nous, Ses pleurs, son désespoir d'avoir pu nous déplaire, Est un charme à calmer toute notre colère.
ORANTE.	ORANTE.
Si pour vous plaire il faut beaucoup d’emportement, Je ſçais qui vous pourroit donner contentement;	Si pour vous plaire il faut beaucoup d'emportement, Je sais qui vous pourrait donner contentement;
Et je connois des gens dans Paris plus de quatre, Qui, comme ils le font voir, aiment jufques à batre.	Et je connais des gens dans Paris plus de quatre, Qui, comme ils le font voir, aiment jufques à battre.
CLIMENE.	CLIMENE.
Si pour pous plaire il faut n’eſtre jamais jolous, uijais certaines gens fort commodes pour vous;	Si pour pous plaire il faut n'être jamais jolous, uijais certaines gens fort commodes pour vous;
.	.
Des hommes en amour d’une humeur ſi ſouffrante, Qis vous verroient ſans peine entre les bras de Heilte.	Des hommes en amour d'une humeur si souffrante, Qis vous verraient sans peine entre les bras de Heilte.
ORANTE.	ORANTE.
Enfin, par voſtre arreſt vous devez déclarer, Celuy de qui l’amour vous ſemble à preferer.	Enfin, par votre arrêt vous devez déclarer, Celui de qui l'amour vous semble à préférer.
ERASTE.	ERASTE.
Puiſqu'à moins d’un arreſt je ne m’en puis deffaire, Toutes deta a la lois je vous veuxiatisraley Et pour ne point blaſmer ce qui plaiſt à vos yeux, Le jaloux aime plus, & l’autre aime bien mieux.	Puisqu'à moins d'un arrêt je ne m'en puis défaire, Toutes déta à la lois je vous veuxiatisralei Et pour ne point blâmer ce qui plaît à vos yeux, Le jaloux aime plus, et l'autre aime bien mieux.
CLIMENE.	CLIMENE.
L’arreſt eſt plein d’eſprit;	L'arrêt est plein d'esprit;
mais.	mais.
ERASTE.	ERASTE.
Suffit, j’en ſuis quitte.	Suffit, j'en suis quitte.
Aprés ce que j’ay dit, ſouffrez que je vous quitte-	Après ce que j'ai dit, souffrez que je vous quitte-
SCE	SCE
SCENE V.	SCÈNE V.
ORPHISE, ERASTE.	ORPHISE, ERASTE.
ERASTE.	ERASTE.
Ue vous tardez, Madame, & que j’eſprouve * bien.	Que -vous tardez, Madame, et que j'éprouve * bien.
ORPHISE.	ORPHISE.
Non, non, ne quittez pas un ſi doux entretien.	Non, non, ne quittez pas un si doux entretien.
A tort vous m’accuſez d’eſtre trop tard venue, Et vous avez dequoy vous paſſer de ma veuë.	A tort vous m'accusez d'être trop tard venue, Et vous avez dequoy vous passer de ma vue.
ERASTE.	ERASTE.
Sans ſujet contre moy voulez-vous vous aigrir, Et me reprochez-vous ce qu’on me fait ſoufrir?	Sans sujet contre moi voulez-vous vous aigrir, Et me reprochez-vous ce qu'on me fait souffrir?
Ha!	Ha!
de grace attendez.	de grâce attendez.
ORPHISE.	ORPHISE.
2 Laiſſez-moy, je vous prie Et courez vous xejoindre à voſtre compagnie.	2 Laissez-moi, je vous prie Et courez -vous xejoindre à votre compagnie.
Ellé ſort.	Éllé sort.
ERASTE.	ERASTE.
Ciel, faut-il qu’aujourd'huy Fâcheuſes, & Fâcheux, Compirent a troubier les prugeners de mes veux!	Ciel, faut-il qu'aujourd'hui Fâcheuses, et Fâcheux, Compirent a troubier les prugeners de mes veux!
Mais allons ſur ſes pas, malgré ſa reſiſtance, Et faiſons à ſes yeux briller noſtre innocence.	Mais allons sur ses pas, malgré sa résistance, Et faisons à ses yeux briller notre innocence.
2	2
SCENE VI.	SCÈNE VI.
DORANTE, ERASTE.	DORANTE, ERASTE.
DORANTE.	DORANTE.
1 A Marquis, que l’on voit de Faſcheux tous les jours, Venir de nos plaiſirs interrompre le cours!	1 A Marquis, que l'on voit de Fâcheux tous les jours, Venir de nos plaisirs interrompre le cours!
Tu me vois enragé d’une aſſés belle chaſſe Qu'un fat.	Tu me vois enragé d'une assez belle chasse Qu'un fat.
C’eſt un recit qu’il faut que je te faſſe;	C'est un récit qu'il faut que je te fasse;
ERA	ERA
ANASTE.	ANASTE.
Je cherche icy quelqu’un, & ne puis m’arreſter.	Je cherche ici quelqu'un, et ne puis m'arrêter.
DORANTE le retenant.	DORANTE le retenant.
Parbleu chemin faiſant je te le veux conter.	Parbleu chemin faisant je te le veux conter.
ous eſtions une troupe, aſſez bien aſſortie, Qui pour courir un Cerf avions hier fait partie;	ous étions une troupe, assez bien assortie, Qui pour courir un Cerf avions hier fait partie;
Et nous fuſmes coucher ſur le païs exprés, C’eſt à dire, mon cher, en fin fond de forets.	Et nous fûmes coucher sur le pays exprès, C'est à dire, mon cher, en fin fond de forets.
Comme cét exercice eſt mon plaiſir ſupréme, Je voulus pour bien faire, aller au bois moy-meſme;	Comme cet exercice est mon plaisir suprême, Je voulus pour bien faire, aller au bois moi-même;
Et nous concluſmes tous d’attacher nos efforts Sur un Cerf, qu’un chacun nous diſoit Cerf-dix-cors;	Et nous conclûmes tous d'attacher nos efforts Sur un Cerf, qu'un chacun nous disait Cerf-dix-cors;
Mais moy, mon jugement, ſans qu’aux marques j’arreſte, Fut qu’il n'eſtoit que Cerf à ſa ſeconde teſte.	Mais moi, mon jugement, sans qu'aux marques j'arrête, Fut qu'il n'était que Cerf à sa seconde tête.
Nous avions, comme il faut, ſeparé nos relais, Et desjeunions en haſte, avec quelques œufs frais;	Nous avions, comme il faut, séparé nos relais, Et déjeunions en hâte, avec quelques œufs frais;
Lors qu’un franc Campagnard, avec longue rapiere, Montant ſuperbement ſa Jument pouliniere, Qu’il honoroit du nom de ſa bonne Jument, S’en eſt venu nous faire un mauvais compliment, Nous preſentant auſſi, pour ſurcroiſt de colere, Un grand beneſt de fils, auſſi ſot que ſon pere.	Lors qu'un franc Campagnard, avec longue rapière, Montant superbement sa Jument poulinière, Qu'il honorait du nom de sa bonne Jument, S'en est venu nous faire un mauvais compliment, Nous présentant aussi, pour surcroît de colère, Un grand benêt de fils, aussi sot que son père.
Il s’eſt dit grand Chaſſeur, & nous a priés tous, Qu’il puſt avoir le bien de courir avec nous Dieu preſerve, en chaſſant, toute ſage perſonne, I'un porteur de huchet, qui mal à propos ſonne;	Il s'est dit grand Chasseur, et nous a priés tous, Qu'il pût avoir le bien de courir avec nous Dieu preserve, en chassant, toute sage personne, J'un porteur de huchet, qui mal à propos sonne;
De ces gens, qui ſuivis de dix Hourets galeux Diſent ma meute, & font les chaſſeurs merveilleux.	De ces gens, qui suivis de dix Hourets galeux Disent ma meute, et font les chasseurs merveilleux.
Sa demande receuë, & ſes vertus priſées, Nous avons eſté tous frapper à nos briſées.	Sa demande reçue, et ses vertus prisées, Nous avons été tous frapper à nos brisées.
A trois longueurs de trait, tayaut;	À trois longueurs de trait, taiaut;
voila d’abord Le Cerf donné aux chiens, J’appuye, & ſonne fort.	voilà d'abord Le Cerf donné aux chiens, J'appuie, et son fort.
Mon Cerf débuche, & paſſe une aſſez longue plaine, Et mes chiens aprés luy;	Mon Cerf débuche, et passe une assez longue plaine, Et mes chiens après femme;
mais ſi bien en haleine, Qu’on Qu’on les auroit couverts tous d’un ſeul juſte aucorps.	mais si bien en haleine, Qu'on Qu'on les aurait couverts tous d'un seul juste aucorps.
Il vient à la Foreſt.	Il vient à la Forêt.
Nous luy donnons à lors La vieille meute;	Nous était donnons à lors La vieille meute;
& moy, je prens en diligence Mon Cheval Allezan.	et moi, je prends en diligence Mon Cheval Allezan.
Tu l’as ven?	Tu l'as ven?
ERASTE.	ERASTE.
Non je penle.	Non je penle.
DORANTE.	DORANTE.
Comment?	Comment?
c’eſt un Cheval auſſi bon qu’il eſt beau, Et que ces jours paſſez, j’achetay de Gaveau.	c'est un Cheval aussi bon qu'il est beau, Et que ces jours passés, j'achetai de Gaveau.
* Marchand de Chevaux celebre a la Cour.	* Marchand de Chevaux célèbre à la Cour.
Je te laiſſe à penſer, ſi, ſur cette matiere, Il voudroit me tromper, luy qui me conſidere:	Je te laisse à penser, si, sur cette matière, Il voudrait me tromper, Seigneur qui me considère:
Auſſi je m’en contente, & jamais, en effet, Il n’a vendu Cheval, ny meilleur, ny mieux fait.	Aussi je m'en contente, et jamais, en effet, Il n'a vendu Cheval, ni meilleur, ni mieux fait.
Une teſte de Barbe, avec l’eſtoile nette;	Une tête de Barbe, avec l'étoile nette;
L’encolure d’un cigne, effilée, & bien droite;	L'encolure d'un cigne, effilée, et bien droite;
Point d’eſpaules non plus qu’un liévre;	Point d'épaules non plus qu'un lièvre;
court-jointé.	court-jointé.
Et qui fait dans ſon port voir ſa vivacité.	Et qui fait dans son port voir sa vivacité.
Des piez, morbleu, des piez!	Des pieds, morbleu, des pieds!
le rein double:	le rein double:
à vray dire, J’ay trouvé le moyen, moy ſeul, de le reduire, Et ſur luy, quoy qu’aux yeux il montraſt beau ſemblant, Petit Jean de Gaveau ne montoit qu’en tremblant Une croupe, en largeur, à nulle autre pareille;	à vrai dire, J'ai trouvé le moyen, moi seul, de le réduire, Et sur notre, quoi qu’aux yeux il montrât beau semblant, Petit Jean de Gaveau ne montait qu'en tremblant Une croupe, en largeur, à nulle autre pareille;
Et des gigots, Dieu ſçait!	Et des gigots, Dieu sait!
bref c’eſt une merveille, Et j’en ay refuſé cent piſtoles, croy moy, Au retour d’un cheval amené pour le Roy.	bref c'est une merveille, Et j'en ai refusé cent pistoles, crois moi, Au retour d'un cheval amené pour le Roi.
Je monte donc deſſus, & ma joye eſtoit pleine, De voir filer de loin les coupeurs dans la plaine;	Je monte donc dessus, et ma joie était pleine, De voir filer de loin les coupeurs dans la plaine;
Je pouſſe, & je me trouve en un fort à l’eſcart, A la queuë de nos chiens moy ſeul avec Drecar.	Je pousse, et je me trouve en un fort à l'écart, A la queue de nos chiens moi seul avec Décar.
Piqueur renommé.	Piqueur renommé.
Une heure là dedans noſtre Cerf ſe fait battre.	Une heure là dedans notre Cerf se fait battre.
J’appuye alors mes chiens, & fais le diable à quatre:	J'appuie alors mes chiens, et fais le diable à quatre:
Enfin jamais Chaſſeur ne ſe vit plus joyeux, Je le relance ſeul, & tout alloit des mieux;	Enfin jamais Chasseur ne se vit plus joyeux, Je le relance seul, et tout allait des mieux;
Lors que d’un jeune Cerf s’accompagne le noſtre, Une part de mes chiens ſe ſepare de l’autre, Et je les voy, Marquis, comme tu peux penſer.	Lors que d'un jeune Cerf s'accompagne le nôtre, Une part de mes chiens se sépare de l'autre, Et je les vois, Marquis, comme tu peux penser.
Chaſſer tous avec crainte, & finaut balancer.	Chasser tous avec crainte, et finaut balancer.
Il ſe rabat ſoudain, dont j’eus l’ame ravie;	Il se rabat soudain, dont j'eus l'âme ravie;
Il empaume la voye, & moy je ſonne & crie, A finaut, à finaut:	Il empaume la voie, et moi je sonne et crie, A finaut, à finaut:
j’en revois à plaiſir, Sur une taupiniere, & reſſonne à loiſir.	j'en revois à plaisir, Sur une taupinière, et résonne à loisir.
Quelques chiens revenoient à moy, quand pour diſgrace, Le jeune Cerf, Marquis, à mon Campagnard paſſe.	Quelques chiens revenaient à moi, quand pour disgrâce, Le jeune Cerf, Marquis, à mon Campagnard passe.
Mon étourdy ſe met à ſonner comme il faut, Et crie à pleine voix, tayaut, tayaut, tayaut.	Mon étourdi se met à sonner comme il faut, Et crie à pleine voix, taiaut, taiaut, taiaut.
Mes chiens me quittent tous, & vont à ma pecore, I'y pouſſe, & j’en revois dans le chemin encore;	Mes chiens me quittent tous, et vont à ma pécore, J'y pousse, et j'en revois dans le chemin encore;
Mais à terre, mon cher, je n’eus pas jetté l’œil, Que je connus le change, & ſentis un grand dueil.	Mais à terre, mon cher, je n'eus pas jeté l'œil, Que je connus le change, et sentis un grand deuil.
J’ay beau luy faire voir toutes les differences Des pinces de mon Cerf & de ſes connoiſſances;	J'ai beau lui faire voir toutes les différences Des pinces de mon Cerf et de ses connaissances;
Il me ſouſtient tousjours, en Chaſſeur ignorant, Que c’eſt le Cerf de meute, & par ce different Il donne temps aux chiens d’aller loin:	Il me soutient toujours, en Chasseur ignorant, Que c'est le Cerf de meute, et par ce différent Il donne temps aux chiens d'aller loin:
j’en enrage, Et peſtant de bon cœur contre le perſonnage, je pouſſe mon cheval, & par haut, & par bas, Qui plioit des gaulis auſſi gros que les bras:	j'en enrage, Et pestant de bon cœur contre le personnage, je pousse mon cheval, et par haut, et par bas, Qui pliait des gaulis aussi gros que les bras:
Je ramene les chiens à ma premiere voye, Qui vont, en me donnant une exceſſive joye, Requerir noſtre Cerf, comme s’ils l’euſſent veu :	Je ramène les chiens à ma première voie, Qui vont, en me donnant une excessive joie, Requérir notre Cerf, comme s'ils l'eussent vu :
Ils le relancent;	Ils le relancent;
mais, ce coup eſt-il preveu?	mais, ce coup est-il prévu?
A te dire le vray, cher Marquis, il m’aſſomme.	À te dire le vrai, cher Marquis, il m'assomme.
Noſtre Cerf relancé va paſſer à noſtre homme, Qui croyant faire un trait de chaſſeur fort vanté, D’un piſtolet d’arçon qu’il avoit apporté, Luy donne juſtement au milieu de la teſte;	Notre Cerf relancé va passer à notre homme, Qui croyant faire un trait de chasseur fort vanté, D'un pistolet d'arçon qu'il avait apporté, Lui donne justement au milieu de la tête;
Et de fort loin me crie, ah!	Et de fort loin me crie, ah!
j’ay mis bas la beſte.	j'ai mis bas la bête.
A-t-on jamais parlé de piſtolets, bon Dieu !	A-t-on jamais parlé de pistolets, bon Dieu !
Pour courre un Cerf?	Pour courre un Cerf?
pour moy venant deſſus le lieu, J’ay trouvé l’action tellement hors d’uſage, Que j’ay donné des deux à mon cheval, de rage, me in emidio teremtr enenmoj touojouis courant, Sans vouloir dire un mot à ce ſot ignorant.	pour moi venant dessus le lieu, J'ai trouvé l'action tellement hors d'usage, Que j'ai donné des deux à mon cheval, de rage, me in emidio tèremtr enenmoj ouïs courant, Sans vouloir dire un mot à ce sot ignorant.
ERASTE.	ERASTE.
Tu ne pouvois mieux faire, & ta prudence eſt rare:	Tu ne pouvais mieux faire, et ta prudence est rare:
C’eſt ainſi, des Faſcheux, qu’il faut qu’on ſe ſepare;	C'est ainsi, des Fâcheux, qu'il faut qu'on se sépare;
Adieu.	Adieu.
DORANTE.	DORANTE.
Quallu ta votdias;	Quallu ta votdias;
flotis nons quelque part.	flotis nons quelque part.
Où nous ne craindrons point de chaſſeur Campagnard.	Où nous ne craindrons point de chasseur Campagnard.
ERASTE.	ERASTE.
Fort bien.	Fort bien.
Je croy qu’en fin je perdray patience.	Je crois qu'en fin je perdrai patience.
Cherchons à m’excuſer avecque diligence.	Cherchons à m'excuser avec diligence.
Fin du deuxieſme Acte.	Fin du deuxième Acte.
BAL.	BAL.
DEUXLESME ENTRE’E.	DEUXLESME ENTRE'E.
De petits Frondeurs les viennent interrompre, qui ſont chaſſez enſuite.	De petits Frondeurs les viennent interrompre, qui sont chassés ensuite.
TROSIESME ENTRE’E.	TROSIESME ENTRE'E.
Tur ues ouvellers, gques ou vetieres;	Tur ouvres ouvellers, gques ou vétières;
leurs peres, & autres, qui ſont auſſi chaſſez à leur tour.	leurs pères, et autres, qui sont aussi chassés à leur tour.
QUATRIES ME ENTRE’E.	QUATRIES ME ENTRE'E.
Par un Jardinier, qui dance ſeul, & ſe retire pour faire place au troiſieſme Acte.	Par un Jardinier, qui dance seul, et se retire pour faire place au troisième Acte.
ACTE	ACTE
ACTE III.	ACTE III.
SCENE PREMIERE.	SCÈNE PREMIÈRE.
ERASTE, LA MONTAGNE.	ERASTE, LA MONTAGNE.
E9 Po ERASTE.	E9 Po ERASTE.
L eſt vray, d’un coſté mes ſoins ont reüſſy :	L est vrai, d'un côté mes soins ont réussi :
Cét adorable objet enfin s’eſt adoucy:	Cet adorable objet enfin s'est adouci:
Mais d’un autre on m’accable, & les Aſtres ſeveres Ont, contre mon amour, redoublé leurs coleres.	Mais d'un autre on m'accable, et les Astres sévères Ont, contre mon amour, redoublé leurs colères.
Ouy, Damis ſon tuteur, mon plus rude fâcheux, Tout de nouveau s’oppoſe aux plus doux de mes veux, A ſon aymable niece a deffendu ma veuë, Et veut d’un autre Eſpoux la voir demain pourveuë.	Oui, Damis son tuteur, mon plus rude fâcheux, Tout de nouveau s'oppose aux plus doux de mes veux, À son aimable nièce a défendu ma vue, Et veut d'un autre Époux la voir demain pourvue.
Orphiſe toutefois, malgré ſon deſaveu, Daigne accorder ce ſoir une grace à mon feu;	Orphise toutefois, malgré son désaveu, Daigne accorder ce soir une grâce à mon feu;
Et j’ay fait conſentir l’eſprit de cette belle, A ſouffrir qu’en ſecret je la viſſe chez elle.	Et j'ai fait consentir l'esprit de cette belle, A souffrir qu'en secret je la visse chez elle.
L’amour ayme ſur tout les ſecrettes faveurs, Dans l'obſtacle, qu’on force, il trouve des doucedlo 3 Et le moindre entretien de la beauté qu’on ayme, Lors qu’il eſt deffendu, devient grace ſupréme.	L'amour aime sur tout les secrètes faveurs, Dans l'obstacle, qu'on force, il trouve des doucédo 3 Et le moindre entretien de la beauté qu'on aime, Lors qu'il est défendu, devient grâce suprême.
Je vais au rendés-vous:	Je vais au rendez-vous:
c’en eſt l’heure à peu prés:	c'en est l'heure à peu près:
Puis, je veux m’y trouver pluſtoſt avant qu’aprés.	Puis, je veux m'y trouver plutôt avant qu'après.
ERA	ERA
LA MONTAGNE.	LA MONTAGNE.
Suivray-je vos pas?	Suivrai-je vos pas?
ERASTE.	ERASTE.
Non, je craindrois que peut-eſtre a queiques yeux luipects tu me fiſſes connoiſtre.	Non, je craindrais que peut-être a queiques yeux luipects tu me fisses connaître.
Mais.	Mais.
LA-MONTAGNE.	LA-MONTAGNE.
ERASTE.	ERASTE.
Je ne le veux pas.	Je ne le veux pas.
LA MONTAGNE.	LA MONTAGNE.
je dois luivre vox loix:	je dois luivre vox lois:
Mais au moins ſi de loin.	Mais au moins si de loin.
ERASTE.	ERASTE.
Te tairas-tu, vingt fois?	Te tairas-tu, vingt fois?
Et ne veux-tu jamais quitter cette methode, De te rendre, à toute heure, un valet incommode!	Et ne veux-tu jamais quitter cette méthode, De te rendre, à toute heure, un valet incommode!
SCENE II.	SCÈNE II.
CARITIDES, ERASTE.	CARITIDES, ERASTE.
CARITIDES.	CARITIDES.
Onſieur, le temps repugne à l’honneur de vous voir.	Onsieur, le temps répugne à l'honneur de vous voir.
Le matin eſt plus propre à rendre un tel devoir:	Le matin est plus propre à rendre un tel devoir:
Mais de vous rencontrer il n’eſt pas bien facile;	Mais de vous rencontrer il n'est pas bien facile;
Car vous dormez toûjours, ou vous eſtes en ville;	Car vous dormez toujours, ou vous êtes en ville;
Au moins, Meſſieurs vos gens me l’aſſeurent ainſy, Et j’ay, pour vous trouver, pris l’heure que voicy.	Au moins, Messieurs vos gens me l'assurent ains, Et j'ai, pour vous trouver, pris l'heure que voici.
Encor eſt-ce un grand heur, dont le deſtin m’honnore;	Encor est-ce un grand heur, dont le destin m'honore;
Car deux momens plus tard, je vous manquois encore.	Car deux moments plus tard, je vous manquais encore.
ERASTE.	ERASTE.
Monſieur, ſouhaitez-vous quelque choſe de moy?	Monsieur, souhaitez-vous quelque chose de moi?
CARITIDES.	CARITIDES.
Je m’acquitte, Monſieur, de ce que je vous doy;	Je m'acquitte, Monsieur, de ce que je vous dois;
Et vous viens.	Et vous viens.
Excuſez l’audace, qui m’inſpire.	Excusez l'audace, qui m'inspire.
Si.	Si.
ERASTE.	ERASTE.
Sans tant de façons, qu'avez vous à me dire?	Sans tant de façons, qu'avez -vous à me dire?
CARITIDES.	CARITIDES.
Comme le rang, l’eſprit, la generoſité, Que chacun vante en vous.	Comme le rang, l'esprit, la générosité, Que chacun vante en vous.
ERASTE.	ERASTE.
Paſſons, Monſieur.	Passons, Monsieur.
Oay je luis foit vanté ,	Oai je luis soit vanté ,
CARITIDES.	CARITIDES.
Monſieur, c’eſt une peine extréme, Lors qu’il faut à quelqu’un ſe produire ſoy-meſme, Et toûjours, prés des Grans on doit eſtre introduit, Par des gens, qui de nous faſſent un peu de bruit;	Monsieur, c'est une peine extrême, Lors qu'il faut à quelqu'un se produire soi-même, Et toujours, prés des Grans on doit être introduit, Par des gens, qui de nous fassent un peu de bruit;
Dont la bouche ecoutée, avecque poids debite, Ce qui peut faire voir noſtre petit mente.	Dont la bouche ecoutée, avec poids debite, Ce qui peut faire voir notre petit mente.
Enfin j’aurois voulu que des gens bien inſtruits, Vous euſſent pû, Monſieur, dire ce que je ſuis.	Enfin j'aurais voulu que des gens bien instruits, Vous eussent pu, Monsieur, dire ce que je suis.
ERASTE.	ERASTE.
Je vois aſſez, Monſieur, ce que vous pouvez eſtre, Et voſtre ſeul abord le peut faire connoiſtre.	Je vois assez, Monsieur, ce que vous pouvez être, Et votre seul abord le peut faire connaître.
CARITIDES.	CARITIDES.
Ouy je ſuis un ſçavant charmé de vos vertus.	Oui je suis un Savant charmé de vos vertus.
Non pas de ces ſçavans, dont le nom n’eſt qu’en us:	Non pas de ces savants, dont le nom n'est qu'en us:
Il n’eſt rien ſi commun, qu’un nom à la Latine.	Il n'est rien si commun, qu'un nom à la Latine.
Ceux qu’on habille en Grec ont bien meilleure mine y Et pour en avoir un qui ſe termine en es, Je me fais appeller Monſieur Caritides.	Ceux qu'on habille en Grec ont bien meilleure mine y Et pour en avoir un qui se termine en es, Je me fais appeler Monsieur Caritides.
ER AS.	ER AS.
T.	T.
E.	E.
Monſieur Caritides ſoit, qu’avez-vous à dire?	Monsieur Caritides soit, qu'avez-vous à dire?
CARITIDES.	CARITIDES.
C’eſt un placet, Monſieur, que je voudrois vous lire;	C'est un placet, Monsieur, que je voudrais vous lire;
Et que dans la poſture, ou vous met voſtre employ, J’oſe vous conjurer de preſenter au Roy.	Et que dans la posture, ou vous met votre emploi, J'ose vous conjurer de présenter au Roi.
ERASTE.	ERASTE.
Hé!	Hé!
Monſieur, vous pouvez le preſenter vousmeiine.	Monsieur, vous pouvez le présenter vousmeiine.
CARITIDES.	CARITIDES.
Il eſt vray que le Roy fait cette grace extréme;	Il est vrai que le Roi fait cette grâce extrême;
Mais par ce meſme excés de ſes rares bontez, Tant de méchans placets, Monſieur, ſont preſentez, Qu'ils eſtouffent les bons;	Mais par ce même excès de ses rares bontés, Tant de méchants placets, Monsieur, sont présentés, Qu'ils étouffent les bons;
& l’eſpoir où je fonde, Eſt qu’on donne le mien, quand le Prince eſt ſans monde.	et l'espoir où je fonde, Est qu'on donne le mien, quand le Prince est sans monde.
ERASTE.	ERASTE.
Et bien vous le pouvez, & prendre voſtre temps.	Et bien vous le pouvez, et prendre votre temps.
CARITIDES.	CARITIDES.
Ah, Monſieur!	Ah, Monsieur!
les Huiſſiers ſont de terribles gens.	les Huissiers sont de terribles gens.
Ils traitent les Sçavans de faquins à naſardes;	Ils traitent les Savants de faquins à nasardes;
Et je n’en puis venir qu’à la falle des Gardes.	Et je n'en puis venir qu'à la salle des Gardes.
Les mauvais traitemens qu’il me faut endurer, Pour jamais de la Cour me feroient retirer, Si je n’avois conceu l’eſperance certaine, Qu’aupres de noſtre Roy vous ſerez mon Mecene.	Les mauvais traitements qu'il me faut endurer, Pour jamais de la Cour me feraient retirer, Si je n'avais conçu l'espérance certaine, Qu'auprès de notre Roi vous serez mon Mécène.
Ouy, voſtre credit m’eſt un moyen aſſeuré.	Oui, votre crédit m'est un moyen assuré.
ERASTE.	ERASTE.
Et bien donnez-moy donc, je le prefenteray.	Et bien donnez-moi donc, je le présenterai.
CARITIDES.	CARITIDES.
Le voicy;	Le voici;
mais au moins oyez en la lecture.	mais au moins oyez en la lecture.
Non.	Non.
ee	ce
CARITIDES.	CARITIDES.
C’eſt pour eſtre inſtruit, Monfieur, je vous coniure.	C'est pour être instruit, Monfieur, je vous conjure.
AU	AU
LES FASCHEUX, AU ROY.	LES FÂCHEUX, AU ROY.
DIRE, Voſtre tres-humble, tres-obeïſſant, tres-fidelle, & rres-ſçavant ſubjet & ſerviteur Caritides, François de nation, Grec de profeſſion;	DIRE, Votre très-humble, très-obeïssant, très-fidelle, et rres-sçavant sujet et serviteur Caritides, François de nation, Grec de profession;
Ayant conſideré les grand, & notables abus, qui ſe commettent aux inſcriptions des enſeignes des Maiſons, Boutiques, Cabarets, Jeux de Boule, & autres lieux de voſtre bonne Ville de Paris;	Ayant considéré les grand, et notables abus, qui se commettent aux inscriptions des enseignes des Maisons, Boutiques, Cabarets, Jeux de Boule, et autres lieux de votre bonne Ville de Paris;
en ce que certains ignorans compoſiteurs deſdites inſcriptions, renverſent, par une barbare, pernicieuſe & deteſtable prthographe toute ſorte de ſens & raiſon, ſans aucun egard d'Etimologie, Analogie, Energie, ny Allegorie quelconque;	en ce que certains ignorants compositeurs dédites inscriptions, renversent, par une barbare, pernicieuse et détestable prthographe toute sorte de sens et raison, sans aucun égard d'Etimologie, Analogie, Energie, ni Allegorie quelconque;
au grand ſcandale de la Republique des Lettres, & de la nation Françoiſe, qui ſe décrie & deshonore par leſdits abus, & fautes groſſieres, envers les Eſtrangers, &y notamment envers les Allemans, curieux lecteurs & inſpectateurs deſdites inſcriptions.	au grand scandale de la République des Lettres, et de la nation Française, qui se décrie et déshonore par lesdits abus, et fautes grossières, envers les Étrangers, eti notamment envers les Allemands, curieux lecteurs et inspectateurs dédites inscriptions.
HMAASTE.	HMASTE.
Ce Placet eſt fort long, & pourroit bien fâcher.	Ce Placet est fort long, et pourrait bien fâcher.
ARITIDES.	ARITIDES.
Ah!	Ah!
Monſieur, pas un mot ne s’en peut retrancher.	Monsieur, pas un mot ne s'en peut retrancher.
ERASTE.	ERASTE.
Achevez promptement.	Achevez promptement.
CARITIDES continuë.	CARITIDES continue,
Supplie humblement Voſtre Majeſté de créer, pour le bien de ſon Eſtat, & la gloire de ſon Empire, une Charge de Controlleur, Intendant, Correcteur, Reviſeur & Reſtaurateur general deſdites inſcriptions;	Supplie humblement Votre Majesté de créer, pour le bien de son État, et la gloire de son Empire, une Charge de Controlleur, Intendant, Correcteur, Reviseur et Restaurateur général dédites inscriptions;
& d’icelle honnorer le ſuppliant, tant en conſideration de ſon rare & eminent ſçavoir, que des grands & ſignalez ſervices qu’il a rendus à l'Eſtat, & à Voſtre Majeſté, en faiſant l'Anagramme de Voſtre-dite Majeſté en François, Latin, Grec, Hebreu, Siriaque, Caldeen, Arabe.	et d'icelle honorer le suppliant, tant en considération de son rare et éminent savoir, que des grands et signalés services qu'il a rendus à l'État, et à Votre Majesté, en faisant l'Anagramme de Votre-dite Majesté en Français, Latin, Grec, Hébreu, Siriaque, Calde, Arabe.
ERASTE l'interrompant.	ERASTE l'interrompant.
Fort bien:	Fort bien:
donnés-le viſte, & faites la retraitte;	donnez-le vite, et faites la retraite;
miela veu du Noy, c’eſt une affaire faite.	miela vu du Noi, c'est une affaire faite.
CARITIDES.	CARITIDES.
Helas!	Hélas!
Monſieur, c’eit tout que monſtrer mon placet.	Monsieur, c'it tout que montrer mon placet.
Ei le Roy le peut voir, je ſuis ſeur de mon fait:	Ei le Roi le peut voir, je suis sûr de mon fait:
Car comme ſa juſtice en toute choſe eſt grande, Il ne pourra jamais refuſer ma demande.	Car comme sa justice en toute chose est grande, Il ne pourra jamais refuser ma demande.
Au reſte, pour porter au Ciel voſtre renom, Donnez-moy par écrit voſtre nom, & ſur-nom, J’en veux faire un poëme, en forme d’acroſtiche, Dans les deux bouts du Vers, & dans chaque hemiſtiche.	Au reste, pour porter au Ciel vôtre renom, Donnez-moi par écrit notre nom, et surnom, J'en veux faire un poème, en forme d'acrostiche, Dans les deux bouts du Vers, et dans chaque hémistiche.
ERASTE.	ERASTE.
Ouy, vous l’aurez demain, Monſieur Caritides.	Oui, vous l'aurez demain, Monsieur Caritides.
Ma ſoy de teis içavarits ione des ailles bien faits.	Ma soi de teis içavarits ione des ailles bien faits.
J’aurois dans d’autres temps bien ry de ſa ſottiſe.	J'aurais dans d'autres temps bien ri de sa sottise.
SCENE III.	SCÈNE III.
ORMIN, ERASTE.	ORMIN, ERASTE.
ORMTNE Dlen qu’une grande affaire en ce lieu me conduiſe, J’ay voulu qu’il ſortiſt, avant que vous parler.	ORMTNE Dlen qu'une grande affaire en ce lieu me conduise, J'ai voulu qu'il sortît, avant que vous parler.
ERASTE.	ERASTE.
Fort bien, mais dépeſchons, car je veux m’en aller.	Fort bien, mais dépêchons, car je veux m'en aller.
ORMIN.	ORMIN.
Je me doute à peu prés que l’homme qui vous quitte, Vous a fort ennuyé, Monſieur, par ſa viſite.	Je me doute à peu prés que l'homme qui vous quitte, Vous a fort ennuyé, Monsieur, par sa visite.
C’eſt un vieux importun, qui n’a pas l’eſprit ſain, Et pour qui j’ay tousjours quelque defaite en main.	C'est un vieux importun, qui n'a pas l'esprit sain, Et pour qui j'ai toujours quelque défaite en main.
Au Mail, à Luxembourg, & dans les Tuilleries, Il fatigue le monde, avec ſes réveries:	Au Mail, à Luxembourg, et dans les Tuilleries, Il fatigue le monde, avec ses rêveries:
Et des gens, comme vous, doivent fuir l’entretien De tous ces ſçavants-la, qui ne ſont bons à lien.	Et des gens, comme vous, doivent fuir l'entretien De tous ces Savants-la, qui ne sont bons à lien.
Pour moy je ne crains pas, que je vous importene, Puiſque je viens, Monſieur, faire voitre Ionu c.	Pour moi je ne crains pas, que je vous importène, Puisque je viens, Monsieur, faire voitre Ionv ç.
ERASTE.	ERASTE.
Voicy quelque ſoufleur, de ces gens qui n’ont rien, Et vous viennent tousjours promettre tant de bienvous avez lart, hroiſteury cette ueme pierre, Qui peut, ſeule, entichir tous les Roys de la terre.	Voici quelque souleur, de ces gens qui n'ont rien, Et vous viennent toujours promettre tant de bien avez lart, hroisteuri cette ume pierre, Qui peut, seule, entichir tous les Rois de la terre.
ORMIN.	ORMIN.
La plaiſante penſée, helas, où vous voilà !	La plaisante pensée, hélas, où vous voilà !
Dieu me garde, Monſieur, d’eſtre de ces foux-là.	Dieu me garde, Monsieur, d'être de ces foux-là.
Je ne me repais point de viſions frivoles, Et je vous porte icy les ſolides paroles D'un avis, que pour vous je veux donner au Roy, Et que tout cacheté je conſerve ſur moy.	Je ne me repais point de visions frivoles, Et je vous porte ici les solides paroles D'un avis, que pour vous je veux donner au Roi, Et que tout cacheté je conserve sur moi.
Non de ces ſots projets, de ces chimeres vaines, Dont les Sur-intendants ont les oreilles pleines;	Non de ces sots projets, de ces chimères vaines, Dont les Sur-intendants ont les oreilles pleines;
Non de ces gueux d’avis, dont les pretentions Ne parlent que de vingt ou trente millions:	Non de ces gueux d'avis, dont les prétentions Ne parlent que de vingt ou trente millions:
Mais un, qui tous les ans, à ſi peu qu’on le monte, En peut donner au Roy quatre cent, de bon conte:	Mais un, qui tous les ans, à si peu qu'on le monte, En peut donner au Roi quatre cent, de bon conte:
Avec facilité, ſans riſque, ny ſoupçon, Et ſans fouler le peuple en aucune façon.	Avec facilité, sans risque, ni soupçon, Et sans fouler le peuple en aucune façon.
Enfin c’eſt un avis d’un gain inconcevable, Et que du premier mot on trouvera faiſable.	Enfin c'est un avis d'un gain inconcevable, Et que du premier mot on trouvera faisable.
Ouy, pourveu que par vous je puiſſe eſtre pouſſé.	Oui, pourvu que par vous je puisse être poussé.
E le A o l Le Soit, nous en parlerons, je ſuis un peu preſſé.	E le À ô l Le Soit, nous en parlerons, je suis un peu pressé.
ORMIN.	ORMIN.
Si vous me promettiez de garder le ſilence, Je vous découvrirois cét avis d’importance.	Si vous me promettiez de garder le silence, Je vous découvrirais cet avis d'importance.
ERASTE.	ERASTE.
Non, non, je ne veux point ſçavoir voſtre ſecret.	Non, non, je ne veux point sçavoir vôtre secret.
ORMIN.	ORMIN.
Monſieur, pour le tralur;	Monsieur, pour le tralur;
je vous croy tiop uiſeret, Et veux, avec franchiſe, en deux mots vous l’apprendre.	je vous crois tiop uiseret, Et veux, avec franchise, en deux mots vous l'apprendre.
Il faut voir ſi quelqu’un ne peut point nous entendre.	Il faut voir si quelqu'un ne peut point nous entendre.
Cét avis merveilleux, dont je ſuis l’inventeur, Eſt que.	Cet avis merveilleux, dont je suis l'inventeur, Est que.
la n a l Es D’un peu plus loin, & pour cauſe, Monſieur.	la n a ' Es D'un peu plus loin, et pour cause, Monsieur.
OR MIN.	OR MIN.
Vous voyez le grand gain, ſans qu’il faille le dire, Que de ces ports de mer le Roy tous les ans tire.	Vous voyez le grand gain, sans qu'il faille le dire, Que de ces ports de mer le Roi tous les ans tire.
Or l’avis dont encor nul ne s’eſt aviſé, Eſt qu’il faut de la France, & c’eſt un coup aiſé, dir fuirieux porto de ler mhettre toutes les coſtes.	Or l'avis dont encor nul ne s'est avisé, Est qu'il faut de la France, et c'est un coup aisé, dir fuirieux porto de ler mhettre toutes les côtes.
Ce ſeroit pour monter à des ſommes tres-hautes.	Ce serait pour monter à des sommes très-hautes.
Et ſi.	Et si.
ERASTE.	ERASTE.
L’avis eſt bon, & plaira fort au Roy.	L'avis est bon, et plaira fort au Roi.
tedieu, nous nous verrons.	tedieu, nous nous verrons.
ORMIN.	ORMIN.
Au moins appuyez-moy, Pour en avoir ouvert les premieres paroles.	Au moins appuyez-moi, Pour en avoir ouvert les premières paroles.
Ouy, ouy.	Oui, oui.
ERASTE.	ERASTE.
ORMIN.	ORMIN.
Si vous vouliez me preſter deux piſtoles, Que vous reprendriez ſur le droit de l’avis, Monſieur.	Si vous vouliez me prêter deux pistoles, Que vous reprendriez sur le droit de l'avis, Monsieur.
ERASTE.	ERASTE.
Ouy volontiers.	Oui volontiers.
Pluſt à Dieu, qu’à ce prix, De tous les importuns je puſſe me voir quitte!	Plût à Dieu, qu'à ce prix, De tous les importuns je pusse me voir quitte!
Voyez quel contretemps prend icy leur viſite!	Voyez quel contretemps prend ici leur visite!
Je penſe qu’à la fin je pourray bien ſortir.	Je pense qu'à la fin je pourrai bien sortir.
Viendra-t-il point quelqu’un encor me divertir?	Viendra-t-il point quelqu'un encor me divertir?
SCENE	SCÈNE
SCENE IV.	SCÈNE IV.
FILINTE, ERASTE.	FILINTE, ERASTE.
FLLINTE.	FLLINTE.
riiquis, je vienis d'apprendre une eſtrange nouvelle.	riquis, je vienis d'apprendre une étrange nouvelle.
Quoy?	Quoi?
ERASIE.	ERASIE.
FLLINTE.	FLLINTE.
Qu’un homme, tantoſt, t’a fait une querelle.	Qu'un homme, tantôt, t'a fait une querelle.
A moy?	À moi?
ERASTE.	ERASTE.
FILINTE.	FILINTE.
Que te ſert-il de le diſſimuler?	Que te sert-il de le dissimuler?
ſe ſçay de bonne part qu’on t’a fait appeller;	se sais de bonne part qu'on t'a fait appeler;
Et comme ton amy, quoy qu’il en reüſſiſſe, Je te viens, contre tous, faire offre de ſervice.	Et comme ton ami, quoi qu'il en réussisse, Je te viens, contre tous, faire offre de service.
ERASTE.	ERASTE.
Je te ſuis obligé;	Je te suis obligé;
mais croy que tu me fais.	mais crois que tu me fais.
FILINTE.	FILINTE.
Tu ne l’avoûras pas, mais tu ſors ſans valets :	Tu ne l'avouras pas, mais tu sors sans valets :
Demeure dans la ville, ou gagne la campagne;	Demeure dans la ville, ou gagne la campagne;
Tu n’iras nulle part que je ne t’accompagne.	Tu n'iras nulle part que je ne t'accompagne.
Minepemdece.	Minepemde.
ERASTE.	ERASTE.
FLLINTE.	FLLINTE.
A quoy bon de te cacher de moy?	À quoi bon de te cacher de moi?
ERASTE.	ERASTE.
Je te jure, Marquis, qu’on s’eſt moqué de toy.	Je te jure, Marquis, qu'on s'est moqué de toi.
FILINTE.	FILINTE.
En vain tu t'en deffens.	En vain tu t'en défends.
ERASTE.	ERASTE.
Que le Ciel me foudroye, si d’aucun démeſlé.	Que le Ciel me foudroie, si d'aucun démêlé.
FILINTE.	FILINTE.
Tu penles qu’on te croye?	Tu penles qu'on te croie?
ERASTE.	ERASTE.
Eh mon Dieu!	Eh mon Dieu!
je te dis, & ne deguiſe point, Que.	je te dis, et ne déguise point, Que.
PIMINTE.	PIMINTE.
Ne me crois pas dupe, & credule à ce point.	Ne me crois pas dupe, et crédule à ce point.
HRASTE.	HRASTE.
Veux-tu m’obliger?	Veux-tu m'obliger?
FELINTE.	FELINTE.
Non.	Non.
ERASTE.	ERASTE.
Laiſſe-moy, je te prie.	Laisse-moi, je te prie.
FPLINTE.	FPLINTE.
Point d’affaire, Marquis.	Point d'affaire, Marquis.
ERASTEEn certain lieu, ce ſoir.	ERASTEn certain lieu, ce soir.
Une galanterie,	Une galanterie,
FILINTE.	FILINTE.
Je ne te quitte pas:	Je ne te quitte pas:
En quel lieu que ce ſoit, je veux ſuivre tes pas.	En quel lieu que ce soit, je veux suivre tes pas.
ERASTE.	ERASTE.
Parbleu, puilque tu veux que j’aye une quereſſe, Je conſens à l’avoir pour contenter ton zele:	Parbleu, puilque tu veux que j'aie une quéresse, Je consens à l'avoir pour contenter ton zèle:
Ce ſera contre toy qui me fais enrager, Et dont je ne me puis par douceur degager.	Ce sera contre toi qui me fais enrager, Et dont je ne me puis par douceur dégager.
FILINTE.	FILINTE.
C’eſt fort mal d’un amy recevoir le ſervice:	C'est fort mal d'un ami recevoir le service:
Mais, puiſque je vous rens un ſi mauvais office, Adieu, vuidez ſans moy tout ce que vous aurez.	Mais, puisque je vous rends un si mauvais office, Adieu, videz sans moi tout ce que vous aurez.
ERASTE.	ERASTE.
Vous ſerez mon amy quand vous me quitterez.	Vous serez mon ami quand vous me quitterez.
Mais voyez quels malheurs ſuivent ma deſtinée!	Mais voyez quels malheurs suivent ma destinée!
Ils m’auront fait paſſer l’heure qu’on m’a donnée.	Ils m'auront fait passer l'heure qu'on m'a donnée.
SCENE V.	SCÈNE V.
DAMIS, L’ESPINE, ERASTE, LA MVIERE.	DAMIS, L'ÉPINE, ERASTE, LA MVIERE.
DAMIS.	DAMIS.
Oojramigroaney gietlamuberpere robtenir ?	Ojouramigroaney gietlamuberpere robtenir ?
Ah!	Ah!
mon juſte courroux le ſçaura prevenir.	mon juste courroux le saura prévenir.
ERASTE.	ERASTE.
J’entrevoy-là quelqu’un ſur la porte d’Orphiſe.	J'entrevoi-là quelqu'un sur la porte d'Orphise.
Quoy, tousjours quelque obſtacle aux feux qu’elle authoriſe!	Quoi, toujours quelque obstacle aux feux qu'elle autorise!
e il in l ds Ouy, j’ay ſceu que ma Niece, en dépit de mes ſoins, Doit voir ce ſoir chez elle Eraſte ſans teſmoins.	eu il in l Âce, j'ai su que ma Nièce, en dépit de mes soins, Doit voir ce soir chez elle Eraste sans témoins.
LA RIVIERE.	LA RIVIERE.
Qu’entens-je à ces gens-là dire de noſtre Maiſtre?	Qu'entends-je à ces gens-là dire de notre Maître?
Approchons doucement, ſans nous faire connoiſtre.	Approchons doucement, sans nous faire connaître.
DAMIS.	DAMIS.
Mais avant qu’il ait lieu d’achever ſon deſſein, Il faut de mille coups percer ſon traiſtre ſein.	Mais avant qu'il ait lieu d'achever son dessein, Il faut de mille coups percer son traître sein.
Va-t’en faire venir ceux que je viens de dire, Pour les mettre en embuche aux lieux que je deſire;	Va-t-en faire venir ceux que je viens de dire, Pour les mettre en embûche aux lieux que je désire;
Afin, qu’au nom d’Eraſte, on ſoit preſt à vanger Mon honneur, que ſes feux ont l’orgueil d’outrager;	Afin, qu'au nom d'Eraste, on soit prêt à venger Mon honneur, que ses feux ont l'orgueil d'outrager;
A rompre un rendez-vous, qui dans ce lieu l’appelle;	A rompre un rendez-vous, qui dans ce lieu l'appelle;
El lloyer dans ſon fang la fiâme criminelle.	Él oyer dans son sang la fime criminelle.
LARIV IERE l’attaquant avec ſes compagnons.	LARIV IERE l'attaquant avec ses compagnons.
Avant qu’à tes fureurs on puiſſe l’immoler, Traiſtre, tu trouveras en nous à qui parler.	Avant qu'à tes fureurs on puisse l'immoler, Traître, tu trouveras en nous à qui parler.
ERASTE mettant l'eſpée à la main.	ERASTE mettant l'épée à la main.
Bien qu’il m’ait voulu perdre, un point d’honneur me preſſe De ſecourir icy l’oncle de ma Maiſtreſſe.	Bien qu'il m'ait voulu perdre, un point d'honneur me presse De secourir ici l'oncle de ma Maîtresse.
je luis avous, Momeul.	je luis avous, Momeul.
DAMIS apres leur fuite.	DAMIS après leur fuite.
O Ciel, par quel ſecours, P'un trépas aſſeuré vois-je ſauver mes jours !	Ô Ciel, par quel secours, P'un trépas assuré vois-je sauver mes jours !
A qui ſuis-je obligé d’un ſi rare ſervice?	À qui suis-je obligé d'un si rare service?
ERAS.	ERAS.
TE.	TE.
Je n’ay fait, vous ſervant, qu’un acte de juſtice.	Je n'ai fait, vous servant, qu'un acte de justice.
DAMIS.	DAMIS.
Ciel!	Ciel!
puis-je à mon oreille ajouſter quelque foy?	puis-je à mon oreille ajouter quelque foi?
Eſt-ce la main d’Eraſte.	Est-ce la main d'Éraste.
ERASTEOuy, ouy, Monſieur, c’eſt moy.	ERASTEOui, oui, Monsieur, c'est moi.
Trop heureux, que ma main vous ait tiré de peine, Trop malheureux d’avoir merité voſtre haine.	Trop heureux, que ma main vous ait tiré de peine, Trop malheureux d'avoir mérité votre haine.
DAMIS.	DAMIS.
Quoy, celuy, dont j’avois reſolu le trépas, Eit celuy, qui pour moy vient d’employer ſon bras?	Quoi, celui, dont j'avais résolu le trépas, Eit celui, qui pour moi vient d'employer son bras?
Ah!	Ah!
c’en eſt trop, mon cœur eſt contraint de ſe rendre;	c'en est trop, mon cœur est contraint de se rendre;
Et quoy que voſtre amour, ce ſoir, ait pû pretendre, Ce trait ſi ſurprenant de generoſité Doit étoufer en moy toute animoſité.	Et quoi que votre amour, ce soir, ait pu prétendre, Ce trait si surprenant de générosité Doit étouffer en moi toute animosité.
Je rougis de ma faute, & blaſme mon caprice.	Je rougis de ma faute, et blâme mon caprice.
Ma hayne trop long-temps vous a fait mjuſtice;	Ma haine trop longtemps vous a fait miustice;
Et pour la condamner par un éclat fameux, Je vous joins, dés ce ſoir, à l’objet de vos veux.	Et pour la condamner par un éclat fameux, Je vous joins, dès ce soir, à l'objet de vos veux.
SCENE VI.	SCÈNE VI.
ORPHISE, DAMIS, ERASTE, ſuitte.	ORPHISE, DAMIS, ERASTE, suitte.
ORPHISE venant avec un flambeau d’argent à la main.	ORPHISE venant avec un flambeau d'argent à la main.
Onſieur, quelle avanture a d’un trouble effroyable.	Onsieur, quelle aventure a d'un trouble effroyable.
D A	D A
DAMIS.	DAMIS.
Ma Niece, elle n’a rien que de tres-agreable, Puis qu’apres tant de veux que j’ay blâmez en vous, C’eſt elle qui vous donne Eraſte pour Eſpoux.	Ma Nièce, elle n'a rien que de très-agréable, Puis qu'après tant de veux que j'ai blâmez en vous, C'est elle qui vous donne Eraste pour Époux.
Son bras a repouſſé le trépas, que j’évite;	Son bras a repoussé le trépas, que j'évite;
Et je veux, envers luy, que voſtre mair m’acquitte.	Et je veux, envers jours, que votre mair m'acquitte.
ORPHISE.	ORPHISE.
si ceit poul iuy payeree que rouoluy devez, J’y conſens, devant tout aux jours qu’il a ſauvez.	si ceit poul jui paye que rouoluy devez, J'y consens, devant tout aux jours qu'il a sauvez.
ERASTE.	ERASTE.
Mon cœur eſt ſi ſurpris d’une telle merveille, Qu’en ce raviſſement, je doute, ſi je veille.	Mon cœur est si surpris d'une telle merveille, Qu'en ce ravissement, je doute, si je veille.
DAMIS.	DAMIS.
eciebrons i'hetreuriort, dont vous allés joüir, Et que nos violons viennent nous réjoüir.	eciebrons j'hètreuriort, dont vous allez jouir, Et que nos violons viennent nous réjouir.
comme les Vioions veutent jouer, on frappe fort à la porte.	comme les Vioyons veutent jouer, on frappe fort à la porte.
ERASTE.	ERASTE.
Qui frappe là ſi fort?	Qui frappe là si fort?
LESPINE.	LÉPINE.
Monſieur, ce ſont des Maſques, Qui portent des crin-crins, & des tambours de Baſques.	Monsieur, ce sont des Masques, Qui portent des crin-crins, et des tambours de Basques.
Les Maſques entrent, qui occupent toute la place.	Les Masques entrent, qui occupent toute la place.
ERASTE.	ERASTE.
Quoy, tousjours des Faſcheux?	Quoi, toujours des Fâcheux?
hola Suiſſes icy, Qu’on me faſſe ſortir ces gredins que voicy.	holà Suisses ici, Qu'on me fasse sortir ces gredins que voici.
FIN.	FIN.
le France	le France
e France	eu France
e France	eu France
