TRAGI-COMEDIE.	TRAGI-COMÉDIE.
PAR Monpem de SOODERY.	PAR Monpem de SODERY.
M.	M.
DC.	DC.
LIX.	LIX.
aſſeuré qu'vne erreur en appelle vne autre ie m’empeſcheray bien d’adjouſter à la faute que ie commets, en vous donnant vne choſe de ſi peu d’importance, celle de vous loüer de mauuaiſe grace:	assuré qu'une erreur en appelle une autre femme m'empêcherai bien d'ajouter à la faute que je commets, en vous donnant une chose de si peu d'importance, celle de vous louer de mauvaise grâce:
que s’il faut toutefois que ie le faſſe, pour ſuiure la couſtume que les autres ont eſtablie, ie penſe auoir aſſez d’adrelle pour m’en acquites plus dignement ſans eloquence, qu’ils ne feroient auec toutes les regles & toutes les beautez de leur art.	que s'il faut toutefois que je le fasse, pour suivre la coutume que les autres ont établie, ie pense avoir assez d'adrelle pour m'en acquîtes plus dignement sans éloquence, qu'ils ne feraient sous toutes les règles et toutes les beautés de leur art.
Et cela, MADAME, en diſant ſeulement que vous eſtes de l’illuſtre Sang de BOVRBON, ſi Noble & ſi pur, qu’il a moins de taches que le Soleil;	Et cela, MADAME, en disant seulement que vous êtes de l'illustre Sang de BOURBON, si Noble et si pur, qu'il a moins de taches que le Soleil;
de ſorte que vo' auriez plus de peine à faillir, que les autres n’en ont à bien faire;	de sorte que vo' auriez plus de peine à faillir, que les autres n'en ont à bien faire;
Et s’il faut encor adioûter à cette gloire eſſentielle vne qui vous vienne d’ailleurs;	Et s'il faut encor ajouter à cette gloire essentielle un qui vous vienne d'ailleurs;
apres auoir remarqué que vous auez l'honneur d’appartenir au plus grand Monarque de la terre:	après avoir remarqué que vous avez l'honneur d'appartenir au plus grand Monarque de la terre:
Ie diray que vous eſtes Sœur d’vn Prince, qui poſſede toutes les bonnes qualitez que doit auoir vn homme de la ſienne & femme d’vn autre, de qui le cœur & I’eſprit diſputent de grandeur auec ſa naiſſance:	Je dirai que vous êtes Sœur d'un Prince, qui possède toutes les bonnes qualités que doit avoir un homme de la sienne et femme d'un autre, de qui le cœur et J'esprit disputent de grandeur avec sa naissance:
C’eſt tout ce que vous peut dire,	C'est tout ce que vous peut dire,
MADAME, Voſtre tres-humble & tres-obeïſſan ſeruiteur, DE SCVDERY.	MADAME, Votre très-humble et très-obeïssan serviteur, DE SCUDERY.
DDC DLCIDOIJ.	DDC DLCIDOII.
ISIMANDRE Fils du Gouuerneur de Naples.	ISIMANDRE Fils du Gouverneur de Naples.
ORANTE Dame Napolitaine.	ORANTE Dame Napolitaine.
ROUiMORD Many dimandre,	ROUiMORD Mani dimandre,
ORMIINV Gouuerneur de Piſe.	ORMIINU Gouverneur de Pise.
PALINICE Femme dOOrmin.	PALINICE Femme dOrmin.
LVCINDE Mere d’Orante.	LUCINDE Mère d'Orante.
FLORANGE Gentil-homme Piſan.	FLORANGE Gentilhomme Pisan.
NERINE Demoiſelle d’Orante.	NERINE Demoiselle d'Orante.
monimtiadnelo aIſimandre.	monimtiadnelo aIsimandre.
Cerr(Dore Elcuyer d’Iſimandre.	Cerr (Dore Elcuyer d'Isimandre.
LINDOMAN Valet de Chambre d’Orante.	LINDOMAN Valet de Chambre d'Orante.
LERISTE Page d’Ormin.	LERISTE Page d'Ormin.
ARGAMOR Braue.	ARGAMOR Brave.
GERTIMANT Braue.	GERTIMANT Brave.
L.	L.
SCENE P Las I PREMIERE.	SCÈNE P As I PREMIÈRE.
ROSIMOND, ISIMANDRE.	ROSIMOND, ISIMANDRE.
ROSIMOND.	ROSIMOND.
Algré le vœu diſcret d'vne bouche muetis, Minfin ie vous connou amoureux & Poete;	Algré le vœu discret d'une bouche muétis, Minfin ici vous connou amoureux et Poète;
Non, non, ie vous y prends;	Non, non, Seigneur vous y prends;
que ſert de le celes?	que sert de le cèles?
C’eſt trop en meſme temps, que ſe taire, & braſlez, Voyons dans et ſountt ja on vatmi tomme vn crime, Des regrets meſurez.	C'est trop en même temps, que se taire, et braslez, Voyons dans et sount ja on vatmi tomme un crime, Des regrets mesurez.
& des ſouſpirs en rime.	et des soupirs en rime.
ISIMANDRE.	ISIMANDRE.
deendecie moj, ener Amy:	deendecie moj, en Ami:
ROSIMOND.	ROSIMOND.
I'j ſais bien reſelu, Mais es ne ſera pas avant que l'auoir leu.	J'j sais bien réélu, Mais es ne sera pas avant que l'avoir lu.
ISIMANDRE.	ISIMANDRE.
Comme tous mes plaiſirs ont deſia fait naufrage, Le deſordre des ſens en met en mon ouurage, Et mes vers ſont con fus autant que mon humeer.	Comme tous mes plaisirs ont déjà fait naufrage, Le désordre des sens en met en mon ouvrage, Et mes vers sont con fus autant que mon humeer.
ROSIMOND.	ROSIMOND.
Icy l’humilité ne ſent point le Rimeur, Il falloit preparer mes yeux & mes oreilles, Me dire qu'à genoux on doit voir des merusilles, Me reciter vos vers en accents releuez:	Ici l'humilité ne sent point le Rimeur, Il fallait préparer mes yeux et mes oreilles, Me dire qu'à genoux on doit voir des mérusilles, Me réciter vos vers en accents relevez:
C’eſt tout leur ornement, & vous les en priuez, Les Maiſtres du meſtier ont bien vne autre emphaze, Pour vous rauir l’eſprit ils tombent en extaze A chaque fin de ſtance on les voit ſe paſmer, Pour vous donner le temps qu’il faut à l’eſtimer, Et faiſants les yeux doux ils ſemblent vonloir dire, Vous deuez m'adorer, par ce que ie m'admire, Mais mon viſage froid deſeſpere vn Autheur, Et ie le fais tomber d vne belle hauteur.	C'est tout leur ornement, et vous les en privez, Les Maîtres du métier ont bien une autre emphase, Pour vous ravir l'esprit ils tombent en extaze A chaque fin de stance on les voit se pâmer, Pour vous donner le temps qu'il faut à l'estimer, Et faisant les yeux doux ils semblent vonloir dire, Vous devez m'adorer, par ce que ie j'admire, Mais mon visage froid désespère un Auteur, Et ie le fais tomber le tomber belle hauteur.
Or vous dont ie connous, & l’adreſſe, & la force, Me faiſant vn refus me iettez vne amorce, En vn mot ie veux voir, en voyant ce ſonnet, Et que vous enfantez uans vojne Caumtt.	Or vous dont Madame connous, et l'adresse, et la force, Me faisant un refus me jetez une amorce, En un mot arrêt veux voir, en voyant ce sonnet, Et que vous enfantez ans vojne Caumt.
SONNET.	SONNET.
V'on me faſſe vn tombeau ie ne me puis 2 promettre De viure deſormais l’eſpace d’vn moment, Mille ans ont fait leur cours depuis l’éloigne ment, De l’homme pariſſeux qui doit lendre mi lettre.	V'on me fasse un tombeau personne ne me puis 2 promettre De vivre désormais l'espace d'un moment, Mille ans ont fait leur cours depuis l'éloigne ment, De l'homme parisseux qui doit lendre mi lettre.
Dieux Dieux, Parques, & Deſtins, me voulez vous permettre, Immortel comme vous d’eſtre éternellement?	Dieux Dieux, Parques, et Destins, me voulez -vous permettre, Immortel comme vous d'être éternellement?
Si vous eſtes puiſſants, faites-le moy pareſtre.	Si vous êtes puissants, faites-le moi paraître.
Me donnãt le repos qu’on trouue au monumẽt.	Me donnant le repos qu'on trouve au monument.
Auoir vécu mille ans, n’eſt-ce pas vn bel âpe Mais que l’impatience nelas.	Avoir vécu mille ans, n'est-ce pas un bel âpe Mais que l'impatience nélas.
me red peu ſage Mon eſprit agité ſoy-meſme ne s’entend.	me red peu sage Mon esprit agité soi-même ne s'entend.
Depuis que i’écriuis, i’ay cõpté mille années Et tout conſideré, ce n’eſt que ſix iournées.	Depuis que j'écrivis, j'ai compté mille années Et tout considéré, ce n'est que six journées.
Dieux!	Dieux!
que le temps eſt long pour vn bien qu’on attend.	que le temps est long pour un bien qu'on attend.
Quoy donc, vous en tenez;	Quoi donc, vous en tenez;
& cette humeur ribille Enſin dans trmuers a pl voir vne Belle?	et cette humeur ribille Ensin dans tramuers a pl voir une Belle?
Il ſe trouue vn objet qui merite vos ſoins, Si ce diſcours eſt vray, c’eſt Venus pour le moins.	Il se trouve un objet qui mérite vos soins, Si ce discours est vrai, c'est Venus pour le moins.
ISIMANDRE.	ISIMANDRE.
Celle dont le Berceau fut pris d’vne Coquille, Pourroit ſeruir de luſtre à cette belle fille;	Celle dont le Berceau fut pris d'une Coquille, Pourrait servir de lustre à cette belle fille;
Et l’on doit confeſſer malgré ſes cruautez, Qu’on n’a veu qu’en ce temps la Reyne des beautez;	Et l'on doit confesser malgré ses cruautés, Qu'on n'a vu qu'en ce temps la Reine des beautés;
La liberté s’onfuit d’où la Belle ſe treuue, Pour les coups de ſes yeux il n'eſt rien à l’eſpreuue, Et bien qu’vn arbre, vn rot, s'en laiſſaſſent charmir, Elle a plus fait encor, en me faiſant aimer.	La liberté s'onfuit d'où la Belle se trouve, Pour les coups de ses yeux il n'est rien à l'épreuve, Et bien qu'Han arbre, un rot, s'en laissassent charmir, Elle a plus fait encor, en me faisant aimer.
ROSIMOND.	ROSIMOND.
De ſçauoir quille elle eſt, la deſir vient de naiſtre.	De sçauoir quille elle est, la désir vient de naître.
ISIMANDRE.	ISIMANDRE.
Sans te dire ſon nom tu la pourras connaiſtre, On ne voit rian d'eſgal au moindre de ſes traicts, Eſcoute-moy parler pour voir de ſes Pourtraicts, Forme-toy dans l’eſprit toutes les belles choſes, Meſle confusément, & des bu, & des Roſes, Que l’imaginatius en ſoy figure encor, L'Albâtre, le Corail, & les Perlis, & l’or, Feins-toy deux cents amours qui vont baiſer ſes tracit Penſe de voir vn port, qui fait rougir les Graces, Songe à tous les attraits ſonge à tous les appas, Leue ej cesle cluada dadeu da paos	Sans te dire son nom tu la pourras connaître, On ne voit rian à égal au moindre de ses traits, Escoute-moi parler pour voir de ses Pourtraits, Forme-toi dans l'esprit toutes les belles choses, Mègle confusément, et des bu, et des Roses, Que l'imaginatius en soi figure encor, L'Albâtre, le Corail, et les Perlis, et l'or, Feins-toi deux cents amours qui vont baiser ses tracit Pense de voir une port, qui fait rougir les Graces, Songe tous les attraits songe à tous les appas, Euge à tous les a paos
ROS MOND.	ROS MOND.
Mon ame en eſt rauie & non moins ignorante.	Mon âme en est ravie et non moins ignorante.
IS MANDRE.	IS MANDRE.
Eſſ-il beſoin encor de te nemmer Orante?	Ess-il besoin encor de te nemmer Orante?
Iniurienx amy, confeſſe-moy ce point.	Injurienx ami, confesse-moi ce point.
d'iuger des pourtraits tu ne te connois point.	d'ivger des pourtraits tu ne te connais point.
ROSIMOND.	ROSIMOND.
Le moyen de la voir à trauers la querelle, Et cette inimitié qui vous eſt naturelle?	Le moyen de la voir à travers la querelle, Et cette inimitié qui vous est naturelle?
ISIMANDRE.	ISIMANDRE.
Eſpouſe qui voudra ſes iniuſtes fureurs, Ie dois cherir mon pere, & non pas ſes erreurs, Ces vieux reſſentimens que la colere attiſe, N’ont rien de genereux, & choquent la franchiſe, Mon courroux tient du foudre, en ce qu’en vn inſiant, Il punit, ou pardonne en ouuuge uapcitant, Et duuſt ma lâcheté me comblis d’infamis, Ie baiſeray les pas de ma belle ennemie, Mon eſprit ne ſçauroit en eſtre diuerty, Malgré mon intereſt, il eſt de ſon party.	Espouse qui voudra ses injustes fureurs, Je dois chérir mon père, et non pas ses erreurs, Ces vieux ressentiments que la colère attise, N'ont rien de généreux, et choquent la franchise, Mon courroux tient du foudre, en ce qu'en un insiant, Il punit, ou pardonne en ouuuge uapcitant, Et duust ma lâcheté me comblis infamis, Ie baiseray les pas de ma belle ennemie, Mon esprit ne sçauroit en être diuerty, Malgré mon intérêt, il est de son party.
ROSIMOND.	ROSIMOND.
Eſtes-vous aſſeuré que le ſien eſt du voſtre?	Êtes-vous assuré que le sien est du vôtre?
ISIMANDRE.	ISIMANDRE.
A quiconque aime bien, qu’importe l’vn ou l’autre?	À quiconque aime bien, qu'importe l'un ou l'autre?
Le veritable amant ne doit rien eſperes, Rien demander aux Dieux, c’eſt aſſez d’adorer, Ie me tiens ſatis fait ſeulement quand i’y penſe, L'amour qui fait ma peine, en eſt la retiuptnſe, Les bonnes actions ont vn certain plaiſir.	Le véritable amant ne doit rien espères, Rien demander aux Dieux, c'est assez d'adorer, Je me tiens satî fait seulement quand j'y pense, L'amour qui fait ma peine, en est la retiuptnse, Les bonnes actions ont un certain plaisir.
Npeue peu vues quint jan is atſr.	Népue peu vues quint jan is atsr.
ROSIMOND.	ROSIMOND.
Pourquoy donc defirer reſponce d'vne lettre?	Pourquoi donc désirer réponse d'une lettre?
ISLMANDRE.	ISLMANDRE.
Ha!	Ha!
que is hay ces vers, parce qu’vn d’eux eſt traiſire, Il apprend vn ſecret qui me deſcouurira, Et le meitent au iour ta voix m'en priuera, Duy ueude nepuuona, a tinit vicinte.	que ais ha ces vers, parce qu'un d'eux est traisire, Il apprend un secret qui me découvrira, Et le mitent au jour ta voix m'en privera, Duy œude nepuuona, a tinit vicinte.
Sçache que pour cela is craindrois le filence, Tout endormy qu’il eſt d’vne froide vapeur, Son ſommeil de pauots éueilleroit ma peur.	Sache que pour cela is craindrais le silence, Tout endormi qu'il est d'une froide vapeur, Son sommeil de pauls éveillerait ma peur.
ROSIMOND.	ROSIMOND.
Que ma fidelité me pleige & veus conſole, Sçachez que mon deuoir commande à ma parole, Vn ſecret en mon ame augmente ſon credit, Ne le dirs qu'à moy, c’eſt ne l’auoir point dit.	Que ma fidélité me pleige et veux console, Scachez que mon devoir commande à ma parole, Un secret en mon âme augmente son crédit, Ne le dirs qu'à moi, c'est ne l'avoir point dit.
ISIMANDRE.	ISIMANDRE.
Ie le crois cher amy, tu pleure ois ma perte, C’eſt pour toy ſeul außi que mon ame eſt ouuirte;	Je le crois cher ami, tu pleure ois ma perte, C'est pour toi seul aussi que mon âme est ouvirte;
Is deſcouure à toy ſeul l’injuſice du ſort, Qui m’eſloigne d’Orante, & me donne la mort.	Is découvre à toi seul l'injusice du sort, Qui m'éloigne d'Orante, et me donne la mort.
Ie te montre vne flâme à tout autre inuiſible, Voy commi mon mal-heur ſe va rendre inuincible, Le pouuoir de mon pere eſtoigne de ces lieux, Celle qui mit au iour la merueille des yeux, Car Orante & ſa mere ont quiité la Contrée, Elles ſont en des lieux où ie n’ay point d’entrée, Elles ſont chez Ormin, qui leur proche parent, Meſle ſes intereſts dans noſtre different, Mais ſi le Ciel permet qu’Orante puiſſe lire, Les termes pleins de feu qu'amour m'a fait eſcrirt Et que ſes volontez m’ordonnent de la voir, En deſpit du mal-heur ie feray mon diueir.	Je te montre une flamme à tout autre invisible, Vois commi mon malheur se va rendre invincible, Le pouvoir de mon père étoigne de ces lieux, Celle qui mit au jour la merveille des yeux, Car Orante et sa mère ont quiité la Contrée, Elles sont en des lieux où on n'ai point d'entrée, Elles sont chez Ormin, qui leur proche parent, Mêle ses intérêts dans notre différent, Mais si le Ciel permet qu'Orante puisse lire, Les termes pleins de feu qu'amour m'a fait écrirt Et que ses tés m'ordonnent de la voir, En dépit du malheur ie ferai mon diueir.
ROSIMOND.	ROSIMOND.
Leqio amuubuijereu uiuje qu'auant fidelle, Puis qu’elle vous cherit, conſeruez-vous pour elle, Si vous allez à Piſe, où giſt voſtre bon-heur, Souuenez-vous qu’Ormin en eſt le Goauerneur.	Léqio amubuijereu uivie qu'avant fidèle, Puis qu'elle vous chérit, conservez-vous pour elle, Si vous allez à Pise, où gît votre bonheur, Souvenez-vous qu'Ormin en est le Goaverneur.
ISIMANDRE.	ISIMANDRE.
La force de l’amour rendra la ſienne vaine, Mon cœur tout genereux ſe mocque de ſa haine, Et ſçache que pour voir ce que i’aime le mieu x, I’aitaquetois l’Enfer, & forcerois les Cieux	La force de l'amour rendra la sienne vaine, Mon cœur tout généreux se moque de sa haine, Et sache que pour voir ce que j'aime le mieu , aitaquetois Enfer, et forcerois les Cieux
CEBRR TI.	CEBR TY.
ORMIN.	ORMIN.
Vde & foible raiſon, abandonne mon ame, N Ta froideur ne ſçauroit s’oppoſer à ma flâme, L’amitié vient du ſang, & i’eſpreuue en ce iour Qu’elle n’eſt qu’vn chemin qui conduit à l’amour.	Vède et faible raison, abandonne mon âme, N' a froideur ne saurait s'opposer à ma flamme, L'amitié vient du sang, et j'épreuve en ce jour Qu'elle n'est qu'un chemin qui conduit à l'amour.
I’aime (is le cenfeſſe) Orante me peſſede, Is ſuis homme, elle eſt belle, on m’attaque & ie cede Ses regaids ont des traicts qui percent iuſqu’ax tœn Le mien eſt bon eſclaue, il aime ſon vainqueur, Et ponrroit-on blaſmer ce qui n’eſt point blaſmable Pour eſtre ma parente eſt-elle moins aimable?	J'aime (is le cenfesse) Orante me pessede, Is suis homme, elle est belle, on m'attaque et et cede Ses regaids ont des traits qui percent jusqu'ax tœn Le mien est bon esclave, il aime son vainqueur, Et ponrait-on blâmer ce qui n'est point blâme Pour est ma parente est-elle moins aimable?
Loix, qui nous deffendez lis plaiſirs innocens, Laiſſez-nous l’eſprit libre, ou nous oſtez les ſens, L’objet de mon deſir luy peat ſeruir d’excuſe, Il arrache de force vn cœur qu’on luy reſuſe, La raiſon & la crainte ont beau le ſecourir, L’eſperance le flatte en le faiſant mourir, Et treuuant que l’amour eſt fille de l’eſtime, Tout ce qu’on luy deffend luy ſemble legitime:	Lois, qui nous défendez lis plaisirs innocents, Laissez-nous l'esprit libre, ou nous ôtés les sens, L'objet de mon désir quelque péat servir d'excuse, Il arrache de force un cœur qu'on accuse résuse, La raison et la crainte ont beau le secourir, L'espérance le flatte en le faisant mourir, Et trouvant que l'amour est fille de l'estime, Tout ce qu'on ç rend était semble légitime:
Vne conqueſte ai ſée eſt digne de mépris:	Une conquête ai zée est digne de mépris:
La peine eſt vne amorce aux genereux eſprits;	La peine est assez amorce aux généreux esprits;
Et quoy qu’vn ſot diſcours en pareille aduanturs, Oppoſe aux loix d'Amour celles de la Naiure, Il les faut mépriſer pour eſtre poſſeſſeur, Si i’aime vne Couſine, vn Dieu cherit ſa ſœur.	Et quoi qu’un sot discours en pareille aduanturs, Oppose aux lois d'Amour celles de la Naiure, Il les faut mépriser pour être possesseur, Si j'aime un Cousine, un Dieu chérit sa sœur.
Ouy, puiſqu’amour li veut, la ſonienes eſt dennée, Allumons ſon flambeau par celuy d’Hrmenée.	Oui, puisqu'amour li veut, la sonienes est dennée, Allumons son flambeau par celui d'Hrmenée.
Laiſſons cuëillir la fleur, pour recuëillir le fruit, Et tirons cent bons iours d’vne mauuaiſe nais, Orante ſira mienne eſtant à ce Florange, Les deffauts d’vn mary la porteront au change.	Laissons cuëillir la fleur, pour recueillir le fruit, Et tirons cent bons jours d'une mauvaise nais, Orante sira mienne étant à ce Florange, Les défauts d'un mari la porteront au change.
Et didans ſon eſprit toutes ſis actions, Pourront ſeruir de luſtre à mes perfections, C’eſt de là que mon bien prendra ſon origins;	Et didans son esprit toutes sis actions, Pourront servir de lustre à mes perfections, C'est de là que mon bien prendra son origins;
Ie baſtis ſur l’eſpoir de ſa mauuaiſe mine, L’entretien d’vn brutal eſt capable d’aider, Au deſſein que i’ay pris de la perſuader, I’ay le vent fauorable, & i’apperçoy la rius, Pour poſſeder Orante, il faut que ie m'en prius, Le Ciel entend mes vœux, & mon bon-heur s’y lit, Mais, amour auic eux n’entre pas dans le lit.	Je bâtis sur l'espoir de sa mauvaise mine, L'entretien d'un brutal est capable d'aider, Au dessein que j'ai pris de la persuader, J'ai le vent favorable, et j'aperçois la rius, Pour posséder Orante, il faut que deux m'en prius, Le Ciel entend mes vœux, et mon bonheur s'y lit, Mais, amour avic eux n'entre pas dans le lit.
SCENE III.	SCÈNE III.
CLINDOR, NERINE.	CLINDOR, NERINE.
CLINDOR.	CLINDOR.
Rine, qu'a propus ie vous aſ rencontrée!	Rine, qu'a propus après vous as rencontrée!
NN Vous pouuez au Chaſteau me dõner libre entrée, Mon maiſtre vous en prie & l’Amour comme luj.	NN Vous pouvez au Château me domme libre entrée, Mon maître vous en prie et l'Amour comme luj.
Demande que vos ſoings l’aſſiſtent anjourd’huy.	Demande que vos soings l'assistent anjourd'hui.
NERINE.	NERINE.
Ha!	Ha!
fidelle Clindor, vn bon demon t’ameine, Si ton Maiſtre pâtit, Orante eſt bien en peine?	fidèle Clindor, un bon démon t'amène, Si ton Maître pâtre, Orante est bien en peine?
Florange la recherche, & ſa mert y couſent, Iuge par là des maux que ſon eſprit reſſint:	Florange la recherche, et sa mert y cousent, Juge par là des maux que son esprit ressint:
nanu que fait (pmnanant en teitt ſongue abſencs,	nanu que fait (pmnanant en teitt songue absencs,
CLINDOR.	CLINDOR.
Il defire la mort, il maudit ſa naiſſance, Il accuſe le ſort, il attaque les Cieux Et croit que pour pleurer Nature fit lis yeux.	Il désire la mort, il maudit sa naissance, Il accuse le sort, il attaque les Cieux Et croit que pour pleurer Nature fit lis yeux.
Son ame ſuit Orante, & n’a point d’autre idée, Son feu ne peut ſeuffrir celuy de Celidé:	Son âme suit Orante, et n'a point d'autre idée, Son feu ne peut seuffrir celui de Celidé:
, Il croit qu’auprés de l'œil, dont le ſien eſt eſpris, Vne Déeſſe meſme, eſt digne de meſpris.	, Il croit qu'auprès de l'œil, dont le sien est épris, Une Déesse igné, est digne de mépris.
Il rend les Bois teſmoins de ſon inquietude, Son vnique recours eſt en la ſolitude, C’eſt là que librement dans le mat qui u point, Il ſe plaint à l’ammr qui ne le quitte point, C’eſt là que ce grand Diru luy dicta les pensé.	Il rend les Bois témoins de son inquiétude, Son unique recours est en la solitude, C'est là que librement dans le mat qui u point, Il se plaint à l'ammr qui ne le quitte point, C'est là que ce grand Diru lui dicta les pensé.
s,	s,
Il luy baille vne lettre.	Il te baille était lettre.
Que garde ce pappier, que ſa main a tracées.	Que garde ce papier, que sa main a tracées.
Et qu’il adreſſe aux yeux qui luy font endurer, Vn mal ſi viotent qu’il ne ſçauroit durer.	Et qu'il adresse aux yeux qui était font endurer, Un mal si viotent qu'il ne saurait durer.
NERINE, Ma Maiſtreſſe auiourd’huy n’eſt point accompagnés, Sa fieure à ce matin a voulu la ſa gnée, Elle garde la chambre, où ie m’en vay courir, Mieux que le Medecin ie la puis ſecourir, Son remedt conſiſte au papier que ie porte, Dont ie vay r’animer ſon eſperance morte, Toy, fidille Clindor ſuü-moy dans le Chaſteas, Paſſe la baſſe-court, le nez dans le manteau Monte au grand eſcalier où ie m’en vais t’attindre.	NERINE, Ma Maîtresse aujourd'hui n'est point accompagnés, Sa fièvre à ce matin a voulu la sa g, Elle garde la chambre, où belle m'en vais courir, Mieux que le Médecin ie la puis secourir, Sonde remèdt consiste au papier que tu porte, Dont iegray ranimer son espérance morte, Toi, fidille Clindor sujet-moi dans le Chasteas, Passe la basse-court, le nez dans le manteau Te au grand escalier où mille m'en vais t'attindre.
CLINDOR.	CLINDOR.
I’oſe tout;	J'ose tout;
ie fau tout, pour ſeruis Iſimandye.	Elle fau tout, pour servis Isimandie.
SCENE IV.	SCÈNE IV.
LVCINDE, FLORANGE, PALINICE,	LUCINDE, FLORANGE, PALINICE,
LVCINDE.	LUCINDE.
JOus l'actuſez à tort, elle a plus de bonté, V Son cœur ne prend de loy que de ma volonté, Mon eſprit eſt fort doux, i’en diſpoſe abſoluë, Florange, elle eſt à vous, ſi i’y ſuis reſoluë Et puis qu’Ormin l'agrée, & Palinice encor, Quand vous auriez les ans que l’on donne à Neſtor.	JOus l'actusez à tort, elle a plus de bonté, VAlon cœur ne prend de loi que de ma volonté, Mon esprit est fort doux, j'en dispose absolue, Florange, elle est à vous, si j'y suis résolue Et puis qu'Ormin l'agrée, et Palinice encor, Quand vous auriez les ans que l'on donne à Nestor.
Quand plus de cert Hyuers horribles en tmpeſte Aurorent urnſe quunn enampe nogeſur voſtre teſſe;	Quand plus de cert Hivers horribles en tmpeste Aurorent urnse quunn enampe nogesur votre tesse;
Croyez (puis qu’il eſt vray) que i’aurou le peuuoir De la mittre en ves bras comme dans ſon deuoir.	Croyez (puis qu'il est vrai) que j'aurou le peuvoir De la mittre en vez bras comme dans son devoir.
FLORANGE.	FLORANGE.
Mon âge luy fait peur ſa triſteſſe m’eſtonne, Et ie plains la douleur que mon plaiſir luy donne, 1.	Mon âge avait fait peur sa tristesse m'étonne, Et tu plains la douleur que mon plaisir quelque donne, 1.
ne ia lrouut point fauorable à mis vœux.	ne ja louut point favorable à mis vœux.
L’or ne ſçauroit cacher l’argent de mes cheueux,	L'or ne saurait cacher l'argent de mes cheveux,
PALINICE.	PALINICE.
La foy de mon mary vous aſſeure la ſitnne.	La foi de mon mari vous assure la sitnne.
LVCINDE.	LUCINDE.
Puis que ie l'ay promis il faut que ie le tienne, On ne peut vous l’oſter, Orante eſt voſtre bien, Eſperez tout Florange, & ne craignez plus rion, Condamnez deſormais cette plainte au ſilence, Außi-toſt que ſon mil perdra ſa violence, Guariſſant la douleur par qui vous ſouſpinta, 2e Jpauraj biin ta meitre où vous ta deſitiz.	Puis que ie l'ai promis il faut que ainsi le tienne, On ne peut vous l'ôter, Orante est quelque bien, Espérez tout Florange, et ne craignez plus rion, Condamnez désormais cette plainte au silence, Aussi-tôt que son mil perdra sa violence, Guérissant la douleur par qui vous soupinta, 2e Jpauraj in ta me vous ta desitiz.
FLORANGE.	FLORANGE.
Ce diſcours me rauit n'en parlons plus, Madame, L’excez di ce plaiſir me deiobυνont l’ame.	Ce discours me ravit n'en parlons plus, Madame, L'excè s ce plaisir me deiobυνont l'âme.
Ie mourrois à vos jeux, & mon cœur a deſſein Ds prendre pour Tombeau l' ilbâtre de ſon ſein, Couronné de lauriers d'vat victoire inſigne Puis qu’il me faut meurir ie veux mourir en Cigne, Et chanter les beautez & vanter les appas Que ie trouue en ſes yeux, que ie gouſit au trépas,	Je mourrais à vos jeux, et mon cœur a dessein Ds prendre pour Tombeau l' ilbattre de son sein, Couronné de lauriers d'évat victoire insigne Puis qu'il me faut mûrir ie veux ai en Si, Et chanter les beautés et vanter les appas De son trouve en ses yeux, que sans goûit au trépas,
SCENE 9 V	SCÈNE 9 V
einue Elle eſt dans ſa chambre le bras en eſcharpe	einue Elle est dans sa chambre le bras en écharpe
STANCES.	STANCES.
Mour ie veux ſuiure l’enuie, A Qui me pouſſe à mourir, Et trouuer pour me ſeçourir, La fin de mes mal-heurs dans celle de ma vie:	Mourc ie veux suivre l'envie, A Qui me pousse à mourir, Et trouver pour me seçourir, La fin de mes malheurs dans celle de ma vie:
Mais puis qu’il me faut vn Tombeau Amour, fais au moins qu’il ſoit beau, Inuiſible Demon de flame, Qui cauſe mon tourment, Parois deſſus ce monument, Mais auſſi triomphãt, que tu l’es dãs mon am	Mais puis qu'il me faut un Tombeau Amour, fais au moins qu'il soit beau, Invisible Démon de flamme, Qui cause mon tourment, Parais dessus ce monument, Mais aussi triomphant, que tu l'es dans mon am
Puis que ie t’ay fait immortel, Prens mon Sepulchre pour Autel.	Puis que ici t'ai fait immortel, Prends mon Sépulcre pour Autel.
Pour éterniſer la memoire Des maux que i’ay ſoufferts, Peinds y bien mes feux & mes fers, Qui ſont les ſeuls tableaux qui font bien voir ta gloire:	Pour éterniser la mémoire Des maux que j'ai soufferts, Peinds y bien mes feux et mes fers, Qui sont les seuls tableaux qui font bien voir ta gloire:
Et fais y paroiſtre mon cœur, Deſſous les pieds de ſon vainqueur.	Et fais y paraître mon cœur, Dessous les pieds de son vainqueur.
Mais pour acheuer la ſtruêture, D’en ſi noble deſſein.	Mais pour achever la struêture, D'en si noble dessein.
Prends le traict qui m’ouurit le ſein, Et graue ces deux vers deſſus ma ſepulture:	Prends le trait qui m'ouvrit le sein, Et grave ces deux vers dessus ma sépulture:
Sa conſtance a cauſé ſa mort, Paſſe, va t’en, & plains ſon ſort.	Sa constance a causé sa mort, Passe, va -t-en, et plains son sort.
Ce n’eſt pas tout, fais qu’Iſimandre, En ſa paſle couleur, Y teſmoigne vn peu de douleur.	Ce n'est pas tout, fais qu'Isimandre, En sa pâle couleur, Y témoigne un peu de douleur.
Pour la perte d’vn bien qu’il n’aura pû deffẽdre;	Pour la perte d'un bien qu'il n'aura pu défendre;
Et qu’il ſemble dire à par ſoy, Helas !	Et qu'il semble dire à par soi, Hélas !
elle eſt morte pour moy.	elle est morte pour moi.
Fantaſliques propos fonges, chimeres vaines.	Fantasliques propos fonges, chimères vaines.
2 Vous irritez mes pleurs vous augmintez mes puïnes, Et le temps que ie perds à diſcourir icy, Ne doit eſtre employé qu’à fiuir mon ſoucy.	2 Vous irritez mes pleurs vous augmintez mes puînés, Et le temps que sans perds à discourir ici, Ne doit être employé qu'à fivir mon souci.
I’aſpirt apres vn bien qui n’a point d’apparince, C'eſt me nourrir de vent que viure d’eſperance, Orante infortunée, & bien ne viuons plus, Bornons auec nos iours cis regrets ſaperflus, Innecent criminel, vieil importun Florange, Par mon triſte deſſein, vou où le tien me range, Ifimandre fidelle, apprends que ie le ſuis, Sans paitager ma mort, partage mes ennuü, Et iuge par le ſang que ie m’en vais répandre, Qu'Orante n’atma rien que le ſeul ſimandre, Viuant en ton penſer;	J'aspirait après un bien qui n'a point d'apparince, C'est me nourrir de vent que vivre d'espérance, Orante infortunée, et bien ne vivons plus, Bornons ainsi nos jours cis regrets saperflus, Innecent criminel, vieil importun Florange, Par mon triste dessein, voulez où le tien me range, Ifimandre fidèle, apprends que ie le suis, Sans paitager ma mort, partage mes ennu, Et juge par le sang que promen vais répandre, Qu'Orante n'atma rien que le seul simandre, Vivant en ton penser;
ie mourray ſans douleur,	Ne mourrai sans douleur,
Elle ſe débande le bras.	Elle se débande le bras.
Dieux ce ſang eſt de flâme il en a la couleur, Reçois au liieu d’encens l’agreable fumée, Qui ſort parmy le ſang de la perſonne aimée, Ce ſont là des eſprits qui vont chercher le tien, La mort n’eſt point vn mal à qui la connoiſt bien, Mais puiſque ce pappier ſe trouue fauorable, Taſchons de conſoler l’oſprit d’vn miſernort,	Dieux ce sang est de flamme il en a la couleur, Reçois au liieu d'encens l'agréable fumée, Qui sort parmi le sang de la personne aimée, Ce sont là des esprits qui vont chercher le tien, La mort n'est point un mal à qui la connaît bien, Mais puisque ce papier se trouve favorable, Tâchons de consoler l'osprit d'un misernort,
Elle eſcrit de Ion ſang.	Elle écrit de Ion sang.
Faiſons voir que la mort ne prui non jur l’amour, Adieu ches Iſimandre adieu, ie peids le iour.	Faisons voir que la mort ne prui non jur l'amour, Adieu chez Isimandre adieu, quelque péids le jour.
NERINE.	NERINE.
SCENE VI	SCÈNE VI
Ve me donneriez vous d’vne bonne nouuelle?	Ve me donneriez -vous d'une bonne nouvelle?
Madame, vous dormez, c’eſt en vain que i’a pelle:	Madame, vous dormez, c'est en vain que j'a pelle:
Ha Ciil!	Ha Ciil!
quel accident?	quel accident?
au ſicouts mes amis, Dieux!	au sicouts mes amis, Dieux!
vous l’auez veu faire, & vous l’auez permis Elle nage en ſon ſang;	vous l'avez vu faire, et vous l'avez permis Elle nage en son sang;
ô l’horrible ſpectacle!	ô l'horrible spectacle!
Son funeſte projet n’a point trouué d’obſtacle:	Son funeste projet n'a point trouvé d'obstacle:
Et ce pappier m'apprend que ſa fidelité, Aiius paula more ue mnuortetrer.	Et ce papier m'apprend que sa fidélité, Ajus paula more ue mnuortetrer.
SCENE VII.	SCÈNE VII.
CLINDOR, NERINE.	CLINDOR, NERINE.
CLINDOR.	CLINDOR.
L faut que is m’aduance à la chambre voiſine:	L faut que is m'avance à la chambre voisine:
&8 Quel prodige eſt-ce la?	et8 Quel prodige est-ce la?
que faites-vo' Nerinti	que faites-vo' Nérinti
NERINE.	NERINE.
Retourne vers lon Maifire, & var t’in l’aduertir, Qu’Orante ne vit plus, qu’il eſt temps de partir:	Retourne vers lon Majire, et var t'in l'avertir, Qu'Orante ne vit plus, qu'il est temps de partir:
Porte-luy ce pappier.	Porte-lui ce papier.
CLINDOR.	CLINDOR.
O funeſte meſſage!	Ô funeste message!
NERINE.	NERINE.
Qu’il puniſſe Florange autheur de ce dommage, On la vouloit forcer de viurs ſous ſa Loy, Aditu, ne ſois point veu quel qu’vn vient, ſauut-toj	Qu'il punisse Florange auteur de ce dommage, On la voulait forcer de vivres sous sa Loi, Aditu, ne sois point vu quel qu'un vient, savut-toj
SCENE VIII.	SCÈNE VIII.
LVCINDE, ORMIN, FLORANGE, PALINICE, NERINE, ORANTE,	LUCINDE, ORMIN, FLORANGE, PALINICE, NERINE, ORANTE,
LVCINDE.	LUCINDE.
Vel bruit ay-je entendu?	Vel bruit ai-je entendu?
ORMIN.	ORMIN.
Bons Dieux, Orante eſt mort	Bons Dieux, Orante est mort
FLORANGE.	FLORANGE.
Quel homme, ou quel Oemon, l’a miſe de la ſerte?	Quel homme, ou quel Oémon, l'a mise de la serte?
PALINICE.	PALINICE.
E lle s’eſt fait ſaigni?	ELLE lèle s'est fait saigni?
& ſon bras s’eſt ouuert, Mais ie vois qu’elle vit par le ſang qu’elle pert,	et son bras s'est ouvert, Mais je vois qu'elle vit par le sang qu'elle pert,
Ma Fille.	Ma Fille.
LVCINDE.	LUCINDE.
Ma Couſine.	Ma Cousine.
PALINICE.	PALINICE.
ORMIN.	ORMIN.
Orante.	Orante.
TPORANGE.	TOPORANGE.
Ma Maiſtreſſe.	Ma Maîtresse.
NERINE.	NERINE.
Qu'on luy iette de l’eau remettons la compreſſe,	Qu'on lui jette de l'eau remettons la compresse,
ORMIN.	ORMIN.
Ha Cidl!	Ha Cidl!
elle reuient.	elle revient.
NERINE.	NERINE.
Ouy, mais c’eſt pour mourir,	Oui, mais c'est pour mourir,
ORANTE, deurangt iuy uiſpiaiſt, ja mirt ta manire	ORANTE, devrangt jui uispiaist, ja mir a manire
ORMIN.	ORMIN.
Et vmit luy feroit mal, que chacun ſe retire,	Et vit lui ferait mal, que chacun se retire,
Il parle bas.	Il parle bas.
Viuez, aimable Orante, on ne vous peut forcer,	Vivez, aimable Orante, on ne vous peut forcer,
ORHAGIL.	ORHAGIL.
Ie conjure les Dieux de vous récompenſer.	Je conjure les Dieux de vous récompenser.
TISITE	TISITE
SCENE PREMIERE.	SCÈNE PREMIÈRE.
PALINICE.	PALINICE.
Nuiſible ſerpent, cruelle ialouſie, I Qui vomit ton vinin dans noſtre fantaiſie.	Nuisible serpent, cruelle jalousie, I Qui vomit ton vin dans notre fantaisie.
Bourreau de mon repos, vray monſtre des enfers, Qui meis l’ame à la geſne, & l’eſprit dans les fers;	Bourreau de mon repos, vrai montre des enfers, Qui me l'âme à la gêne, et l'esprit dans les fers;
Ceſſe de me monſtrer ta vaine, & paſte image, Ceſſe de me pridire vn funeſti dommage, Orante ayme l'honneur.	Cesse de me montrer ta vaine, et pâte image, Cesse de me pridire un funesti dommage, Orante aime l'honneur.
Ormin ſçait ſon deuoir.	Ormin sait son devoir.
Mais Amour eſt aueugle, il ne ſçauroit rien voir, La plus forte raiſon cide à cettt manie.	Mais Amour est aveugle, il ne saurait rien voir, La plus forte raison cide à celt manie.
Et bien qu’elle ſoit Reynt, elle eſt ſouuent banye.	Et bien qu'elle soit Reine, elle est souvent banie.
Le change a des attraits plus forts que la beauté Touſiouts l’eſprit d’vn homme ayme la nouueauté, L’Hymen eſt vn fardeau qu’il iuge inſuportable;	Le change a des attraits plus forts que la beauté Touiouts l'esprit d'un homme aime la nouveauté, L'Hymen est un fardeau qu'il juge insupportable;
Lius vn bien eſt aiſé, moins il eſt delectable;	Lius un bien est aisé, moins il est délectable;
Ca que nous poſſidone, eſt prijme jaus praſites	Ça que nous possidone, est prime jaus prasites
L’amour trouue ſa fin en celle da deſir, 2 Lors qu’il eſt au ſommet il tommence a de ſcendrs, Et ce braſier s’eſteint dedans ſa propre cendre.	L'amour trouve sa fin en celle da désir, 2 Lors qu'il est au sommet il tommence a de scendrs, Et ce brasier s'éteint dedans sa propre cendre.
Dieux!	Dieux!
ie l’experimente en ma iuſte doulenr, Ormin eſt touſiours triſſe, il cbange de couleur, Des ſouſpirs continus deſcouurent ſa folie, Son cœur ſuit par les yeux la bille qui le lie, Il ne me parle plus qu’en termes de meſpris, Orants eſt vn miracle entre les beaux eſprits, Elle ſeule merits vne extréme loüange.	nos l'expérimente en ma juste doulenr, Orin est toujours trisse, il cbange il couleur, Des soupirs continus découvrent sa folie, Son cœur suit par les yeux la bille qui le lie, Il ne me parle plus qu'en termes de mépris, Orants est un miracle entre les beaux esprits, Elle seule mérits une extrême louange.
Il la peint des couleurs, dont on peindroit vn Ange Il luy donne l’encens qu’on offriroit aux Dieux, Il mépriſe la terre, & ſe moque des Cieux Afin de l’obliger il manque à ſa promeſſe.	Il la peint des couleurs, dont on peindrait un Ange Il avait donne l'encens qu'on offrirait aux Dieux, Il méprise la terre, et se moque des Cieux Afin de l'obliger il manque à sa promesse.
Florangę n’eſtant qu’homme effence ſa Decſſe.	Florangę n'étant qu'homme essence sa Décsse.
Pour poſſeder ce corps il faut eſtre immortel, Bref, pour auoir ſa couche il luy dreſſe vn autel, Il eſt vray, ie le voy;	Pour posséder ce corps il faut être immortel, Bref, pour avoir sa couche il était dresse un autel, Il est vrai, ie le vois;
ſon ams en eſt bleßée.	son ams en est blessée.
Elle eſt l’vnique objet qu’il a dans la penſée, Il mépriſe ma flâme außi-bien que ſa foy, Pour rendre Orante à luy, l’ingrat n’eſt pius à moy Mais il manque d’amour.	Elle est l'unique objet qu'il a dans la pensée, Il méprise ma flamme aussi-bien que sa foi, Pour rendre Orante à lui, l'ingrat n'est pius à moi Mais il manque d'amour.
& non moy de courage On connoiſt le Pilote au milieu de l’orage, Faiſens agir l’eſprit pour rompre ſes deſſeins Taſchons de luy donner des ſentimens plus ſains, Qu’il prenne pour guarir la medecine amire, Et que ſon pouuoir cide à celuy d’vne mers,	et non moi de courage On connaît le Pilote au milieu de l'orage, Faisens agir l'esprit pour rompre ses desseins Tâchons de lui donner des sentiments plus sains, Qu'il prenne pour garir la médecine amire, Et que son pouvoir cide à celui d'une mers,
SCENE ORMIN.	SCÈNE ORMIN.
II.	II.
STANCES.	STANCES.
8E fais gloire de mes mal-heurs, al2 Ie me vante de mes douleurs, Tant ie cheris ma ſeruitude:	8E fais gloire de mes malheurs, al2 Ie me vante de mes douleurs, Tant ie chéris ma servitude:
Et bien que dãs mes maux l’eſpoir me ſoit oſté (Sans l’accuſer d’ingratitude) I’adore ma maiſtreſſe, & hay ma liberté.	Et bien que dans mes maux l'espoir me soit ôté (Sans l'accuser d'ingratitude) J'adore ma maîtresse, et haï ma liberté.
Ie la ſers, mais c’eſt par deuoir, Qui peut n’aimer pas & la voir?	Je la sers, mais c'est par devoir, Qui peut n'aimer pas et la voir?
A ſes beaux yeux tout eſt poſſible:	À ses beaux yeux tout est possible:
Et qui n’eſt point touché par de ſi doux appas, A la qualité d’inſenſible, Ou malgré ſes rigueurs, mon cœur n’aſpire pas.	Et qui n'est point touché par de si doux appas, À la qualité d'insensible, Ou malgré ses rigueurs, mon cœur n'aspire pas.
La peine me ſemble vn plaiſir, Ie fuy l’eſpoir & le deſir, Qui font aimer les ames baſſes:	La peine me semble un plaisir, Je fuis l'espoir et le désir, Qui font aimer les âmes basses:
Vn tombeau glorieux ne peut eſtre que doux, Et mourir pour vne des graces.	Un tombeau glorieux ne peut être que doux, Et mourir pour une des grâces.
Eſt vn ſort qui peut rẽdre vn Dieu meſme ialoux, C’en eſt fait, i’y ſuis reſolu, Le Ciel, & mon cœur l’ont voulu, Ie ſuis content des deſtinées,	Est un sort qui peut rẽdre un Dieu même jaloux, C'en est fait, j'y suis résolu, Le Ciel, et mon cœur l'ont voulu, Je suis content des destinées,
Ie quitte ſans regret, la lumiere du jour;	Je quitte sans regret, la lumière du jour;
Mais dans la fin de mes années, On ne verra iamais celle de mon amour Les eſpines me ſont des fleurs;	Mais dans la fin de mes années, On ne verra jamais celle de mon amour Les épines me sont des fleurs;
Dans l’oubly, comme dans les pleurs, Ie conſerueray ſa memoire:	Dans l'oubli, comme dans les pleurs, Je conserverai sa mémoire:
Et mon eſprit ſans corps, & ſans legereté, olnera mes ſeux & ſa gloire, Dans l’Empire des morts à l’immortalité.	Et mon esprit sans corps, et sans légèreté, olnera mes seux et sa gloire, Dans l'Empire des morts à l'immortalité.
Ouy, ie la veux aimer iuſqu’en la ſepulture, Elle merite bien qu’on force la Nature, On doit à ſes vertus vn amour eternel, S’il eſtoit periſſable il ſeroit criminel, On ne peut trop aimer vn objet tant aimable, Iamais l’excez du bien ne peut eſire blaſmable, ( S’il eſt permis de mettre vn excez dans le bien) Il faut que mon eſprit prenne la toy du ſien.	Oui, Seigneur la veux aimer jusqu'en la sépulture, Elle mérite bien qu'on force la Nature, On doit à ses vertus un amour éternel, S'il était périssable il serait criminel, On ne peut trop aimer un objet tant aimable, Jamais l'excès du bien ne peut esire blâmable, ( il est permis de mettre un excès dans le bien) Il faut que mon esprit prenne la toi du sien.
Et que ſes volontez regnent ſur mes penſées, Que Florange n’ait plu ſes flâmes inſensées, Puis qu’il déplaiſt à l’œil que ie veux adorer Le reſpect qu’il me doit luy deffond d’eſperer, Et mes commandemens l’obligent à ſe taire, O toy de mes penſers, fidele Secretaire, Amour, qui les fau naiſtre & ſeul les vois au cœur, Viens rendre vne viſite au bil œil mon vainqueur.	Et que ses volontés règnent sur mes pensées, Que Florange n'ait plu ses flammes insensées, Puis qu'il déplaît à l'œil que tu veux adorer Le respect qu'il me doit ainsi défond d'espérer, Et mes commandements l'obligent à se taire, Ô toi de mes pensers, fidèle Secrétaire, Amour, qui les fau naître et seul les vois au cœur, Viens rendre une visite au bil œil mon vainqueur.
Et pour faire vn miracle, en voyant ma Rebelle.	Et pour faire un miracle, en voyant ma Rebelle.
Suy-moy dans mon retour, & demeure chez elle.	Sui-moi dans mon retour, et demeure chez elle.
SCENE III.	SCÈNE III.
ORANTE NERINE.	ORANTE NERINE.
ORANTE.	ORANTE.
Empethaneue mouin, vonjuours me conduit, M Du repos à la peine, & du ſilence au bruit.	Empethaneue mouin, vonjuours me conduit, M Du repos à la peine, et du silence au bruit.
NERINE, Vous irez (ſi le ſort talme ſa violence, De la peint au repos & du bruit au ſilence.	NERINE, Vous irez (si le sort talme sa violence, De la peint au repos et du bruit au silence.
ORANTE.	ORANTE.
Ha!	Ha!
ne me flatte point d’vn eſpoir deceuant, I’arreſterous pluſieſt les ondes & le vent, Que la ſuite des maux dont ie ſuis trauerſet, L’eſperance eſt trop foible, elle en eſt renuerſée, La rigueur de ma mere, & celle de mon ſort Ne laiſſent à mon choix que Florange, ou la mort;	ne me flatte point d' espoir décevant, J'arresterous plusiest les ondes et le vent, Que la suite des maux dont je suis traverset, L'espérance est trop faible, elle en est renversée, La rigueur de ma mère, et celle de mon sort Ne laissent à mon choix que Florange, ou la mort;
Toutes mes volontez panchint vers la derniere, Elle déliurera mon ame priſonniere.	Toutes mes volontés penchint vers la dernière, Elle délivrer mon âme prisonnière.
Et malgré tous vos ſoins mon eſprit enflâmé Fera voir que le feu ne peut eſtre enfermé.	Et malgré tous vos soins mon esprit enflammé Fera voir que le feu ne peut être enfermé.
Vne ame gentreuſt à la clif di ſa porte, Rien ne peut empeſcher que la mienne ne ſorte, Ie meuts ſans deſeſpotr, ie finis par raiſon, Cnoinié vaut mieux que ne fait la priſon.	Une âme gentreust à la clis di sa porte, Rien ne peut empêcher que la mienne ne sorte, Je meuts sans désespotr, ie finis par raison, Cnoinié vaut mieux que ne fait la prison.
NERINE.	NERINE.
La parole d’Ormin doit bannir cette crainte.	La parole d'Ormin doit bannir cette crainte.
ORANIE.	ORANIE.
La crois-tu veritable?	La crois-tu véritable?
NERINE.	NERINE.
Et la croyez-vous feinte, 21 Non, eſperez Madame, vn traittement plus doux Viuez pour Iſimandre ainſi qu’il vit pour vous Et croyez que te Ciel par ſes Loix ſouueraines Meſurera vos biens aux grandeurs de vos peines, Il vous a fait vn mat dont il aura pitté Faites que le Deſtin cede à voſtre amitié;	Et la croyez-vous feinte, 21 Non, espérez Madame, un traitement plus doux Vivez pour Isimandre ainsi qu'il vit pour vous Et croyez que te Ciel par ses Lois souveraines Mesurera vos biens aux grandeurs de vos peines, Il vous a fait un mat dont il aura pitté Faites que le Destin cède à votre amitié;
Le Sage (à ce qu’on dit) ſe fait ſes deſtinées, Le Pilote ſe rit des vagats mutinées, C’eſt parmy les mal-heurs que paroiſt la vertu, La fortant hprije in gamage aobata, On gaigne ſes faueurs auec la refiſtance, Elle eſt fille, elle eſt belle, on la vainc par conſtancs.	Le Sage (à ce qu'on dit) se fait ses destinées, Le Pilote se rit des vagats mutinées, C'est parmi les malheurs que paraît la vertu, La sortant hprije in gamage aobata, On gagne ses faveurs avec la résistance, Elle est fille, elle est belle, on la vainc par constancs.
ORANTE.	ORANTE.
Et bien donc, ie viuray, puus qu’il te plaiſt airſ, Maù Nerine, mon cœur, tire moy de ſouc M1ou Quand la perte du ſang eſtant eſuanoist, M’euſt dérobé la tiue uupuoren dur Poxre 41 Apprends-moy que deuint vn pappier, vn eſcrit, Où l’Amour par ma plume aupit peint mon eſprit, Ne l’apperceus-tu point il eſtoit ſur ma table:	Et bien donc, Madame vivrai, puus qu'il te plaît airs, Maù Nerine, mon cœur, tire moi de souc M1ou Quand la perte du sang étant esuanoist, M'eût dérobé la tive upuoren dur Poxre 41 Apprends-moi que devint un papier, Un écrit, Où l'Amour par ma plume aupit peint mon esprit, Ne l'aperçus-tu point il était sur ma table:
NERINE.	NERINE.
Ha!	Ha!
Madame pardon, ma memoire eſt cou pable:	Madame pardon, ma mémoire est cou pable:
Le ſoin de ſoûtager voſtre torps aſſoibty, A fait que mes penſers ont mis tout en oubly.	Le soin de soutager votre torps assoibty, A fait que mes pensers ont mis tout en oubli.
Ouy, Madame ie leus cette honorable marque, que laiſſoit voſtre amour en deſpit de la parque;	Oui, Madame ie leus cette honorable marque, que laissait votre amour en dépit de la parque;
Et Clindor la receut à l’inſtant de ma main,	Et Clindor la reçut à l'instant de ma main,
ORANTE.	ORANTE.
Sindor eſt duonc i&.	Sindor est duonc jet.
NERINE.	NERINE.
Non, il partit ſoudain, Es porta ce billet, & la mort à ſon Maiſtre, De qui i'auous receu pour vous vns autre lettre, Muu ujant te uigtin à ueto ppagner vos pas, Is veulois que ſa fin ſuiaiſt noſtre treſpas.	Non, il partit soudain, Es porta ce billet, et la mort à son Maître, De qui j'avou reçu pour vous uns autre lettre, Mu jant te éguigtin à ueto ppagner vos pas, Is veulais que sa fin suiaist notre trépas.
ORANTE.	ORANTE.
O mal-beur ſans égal!	Ô malheur sans égal!
ô faute incomparable!	ô faute incomparable!
Vojons te qu'eſerinon tet Amamt atpiorable.	Vojons te qu'eserinon tet Amamt atpiorable.
LETTRE.	LETTRE.
E ne ſçaurois plus endurer, I Mon mal eſt trop grand pour duret, Voſtre abſence me tyranniſe, Bornant mes iours ou mon ſoucy Permettez-moy d’aller à Piſe, Ou ſouffrez que ie meure icy.	E ne saurais plus endurer, I Mon mal est trop grand pour duret, Votre absence me tyrannise, Bornant mes jours ou mon souci Permettez-moi d'aller à Pise, Ou souffrez que mille meure ici.
Faites Orante ( au nom des Dieux) Qu’vn miroir vous montre vos yeux, Da glace vous fendant lennale, Mes Soleils verront clairement.	Faites Orante ( au nom des Dieux) Qu'un miroir vous montre vos yeux, Da glace vous fendant lennale, Mes Soleils verront clairement.
Que ſans doute il n’eſt pas poſſible, De ſouffrir leur eſloignement.	Que sans doute il n'est pas possible, De souffrir leur éloignement.
*	*
Naples me paroiſt vn deſert, Mon œil perd tout quand il vous pert.	Naples me paraît un désert, Mon œil perd tout quand il vous pert.
Ie ne me ſçaurois plus deffendre D’aller voir les Roys de moi cœur;	Je ne me saurais plus défendre D'aller voir les Rois de moi cœur;
Adicu, ie ſuis	Adicu, Seigneur suis
Voſtre	Votre
ISIMANDRE.	ISIMANDRE.
C'eſt le deſſus de la tettre.	C'est le dessus de la tettre.
Au diuin Obj ect mor tarliqueur.	Au divin Obj ect mór tarliqueur.
Ma Ciel!	Ma Ciel!
tout eſt perdu ſi ton conſeil ne m’aide.	tout est perdu si ton conseil ne m'aide.
NERINE.	NERINE.
Ie vous ay fait vn mai dont voicy le remede, Eſcriuez ſeulement trois mots de voſtre main, Que Lindoman les porit, O quu paitt dimain	Je vous ai fait un mai dont voici le remède, Écrivez seulement trois mots de votre main, Que Lindoman les porit, Ô paitt dimain
ORANTE.	ORANTE.
Eſt-il aſſez diſcret pour luy montrer ma flâme?	Est-il assez discret pour lui montrer ma flamme?
NERINE.	NERINE.
Vn ſicret important l’eſt touſiours dans ſon ame.	Un sicret important l'est toujours dans son âme.
Iſimandre, ſans donte, a beſoin de celx.	Isimandre, sans donte, a besoin de celx.
ORANTE, lote tena.	ORANTE, lote tena.
mab Horan.	ma Horan.
NERINE.	NERINE.
Madame, le voilà.	Madame, le voilà.
CENE IV.	CÈNE IV.
FLORANGE, ORANTEL IERINE.	FLORANGE, ORANTEL IERINE.
FLORANGE.	FLORANGE.
On abord vous déplaiſt mon reſpect vous offence, M Mais contre vos rigueurs, amour prẽd ma deffence:	On abord vous déplaît mon respect vous offense, M Mais contre vos rigueurs, amour prend ma défense:
Et promit à mon cœur, pour le reconfortez La forte de les vainere, ou de let ſupporter.	Et promit à mon cœur, pour le réconfortez La forte de les vaine, ou de let supporter.
ORANTE luy offrant vn ſiege.	ORANTE était offrant un siège.
dtnox-vous en repos, ſans parler dauantage, Ie vous dois du reſpect à cauſe de voſtre âge.	dtnox-vous en repos, sans parler davantage, Je vous dois du respect à cause de votre âge.
FLORANGE.	FLORANGE.
Mon feu ne peut ſoeffrir vn ſi froid complimint, Vous me traittez en Pire & non pas en Amans.	Mon feu ne peut souffrir un si froid complimint, Vous me traités en Pire et non pas en Amants.
Ha!	Ha!
vueillez adoucir mes peines obſtinées, Et compter mon argent pluſtoſt que mes années, Pour faire que mon aſtre ait vn aſpect plus doux, Sengez que mon amour eſt ieunt comme vous.	veuillez adoucir mes peines obstinées, Et compter mon argent plutôt que mes années, Pour faire que mon astre ait un aspect plus doux, Séngez que mon amour est jeunt comme vous.
ORIIIE.	ORIIIE.
Songez que le Sepulchre eſt prés de voſtre couche, Et qu’Ormin vous deffend d’en ouurir plus la bouche.	Songez que le Sépulcre est près de votre couche, Et qu'Ormin vous défend d'en ouvrir plus la bouche.
FLORANGE.	FLORANGE.
Oimin peut tout ſur moy, mais rien ſur men amous, Il ne peut me l’oſter qu’en me priuant dù iour, Sa foy me veut trahir, mais en cette aduanture Mon Amour outragé s’adreſſe à la Naturs.	Oimin peut tout sur moi, mais rien sur men amous, Il ne peut me l'ôter qu'en me privant dù jour, Sa foi me veut trahir, mais en cette aventure Mon Amour outragé s'adresse à la Naturs.
Lucinde arriue.	Lucinde arrive.
Madame, c'eſt de vous que i’attends aujourd'buy, Ou ma premiere ioye, ou mon derniez ennuy, Ormin eſt ſans parole, Orante me mépriſe, Et ce iour pour mon ame eſt bien vn iour de criſe, Prononçant vn arreſt que i’attends à genoux, Paid:	Madame, c'est de vous que j'attends aujourd'hui, Ou ma première joie, ou mon derniez ennui, Ormin est sans parole, Orante me méprise, Et ce jour pour mon âme est bien un jour de crise, Prononçant un arrêt que j'attends à genoux, Paid:
z le diffirent qui s’eſmeut entre nous.	z le diffirent qui s'émut entre nous.
SCENE V.	SCÈNE V.
LVCINDE, FLORARSET ORANTE, NERINE.	LUCINDE, FLORARSET ORANTE, NERINE.
LVCINDE.	LUCINDE.
A parole tiendra, puis que ie l’ay donnée.	À parole tiendra, puis que sans l'ai donnée.
ORAMIE.	ORAMIE.
Amour eſt bien vn Dieu plus puiſſant qu’Hymenée,	Amour est bien un Dieu plus puissant qu'Hyménée,
Ormin paroiſt.	Ormin paraît.
Ha, Monſieur, ontejoitt;	Ha, Monsieur, ontejait;
O urcuux ennemi Veulent m’oſter vn bien que vous m’auez promis.	Ô aucuux ennemi Veulent m'ôter un bien que vous m'avez promis.
CENE VI ORMIN, FLORANGE, ORANTE, LVCINDE, NERINE.	CÈNE VI ORMIN, FLORANGE, ORANTE, LUCINDE, NERINE.
ORMIN Vi vous fait ſi hardy, que de m'eſtre ribelle?	ORMIN Vi vous fait si hardi, que de m'être ribelle?
FLORANGE.	FLORANGE.
Fermez l’œil pour ma faute, & voyez cette Belle.	Fermez l'œil pour ma faute, et voyez cette Belle.
ORMIN.	ORMIN.
Allez, ſi iamais plus vous procedez ainſi, Ie vous fer ay bien veir que ie commande icy, Madame, ce Mary n'eſt pas bon peur drinin, Leur âge eſt inégal, leur humeur differente, Pour agir là deſſus auecque iugement Souffrez que ie vous meine à voſtre appartement.	Allez, si jamais plus vous procédez ainsi, Je vous fer ai bien veir que mon commande ici, Madame, ce Mari n'est pas bon peur drin, Leur âge est inégal, leur humeur différente, Pour agir là -dessus après jugement Souffrez que je vous mène à votre appartement.
Seruons-nous du loiſir qui nous vient ſans l'attendre.	Servons-nous du loisir qui nous vient sans l'attendre.
Deſpeſihons Lindoman, au fidelle ſimandre, Afin que ſon eſprit où regne la raiſon, Tire le mien de peins, & mon corps de priſon.	Despesihons Lindoman, au fidèle simandre, Afin que son esprit où règne la raison, Tire le mien de peins, et mon corps de prison.
deLivn VTA.	deLivn VTA.
ISIMANDRE.	ISIMANDRE.
Ve l’attente eſt faſcheuſs à l’amant qui ſoûpire Qu'vn bien ſemble tardi f alors qu’on le deſire!	Ve l'attente est fâcheuss à l'amant qui soupire Qu'un bien semble tardi f alors qu'on le désire!
Le cours d’vn ſiecle entitr a bien moins de moments, Que la crainte & l’eſpoir ne donnent de tourments, Pareſſeux Meſſager, qui fais languir mon ame.	Le cours d'un siècle entitr a bien moins de moments, Que la crainte et l'espoir ne donnent de tourments, Paresseux Messager, qui fais languir mon âme.
Reſouds-toy de quitter les beaux yeux de ma Dame, Voy mes maux.	Résouds-toi de quitter les beaux yeux de ma Dame, Vois mes maux.
ſonge à moy, regarde ton deuoir, Et ſois prompt à venir ſi tu me veux reuoir, Penſe que ta longueur m’aſſaßine, & me tuë, Toy ſeul peux releuer ma pauure ame abatuë:	songe à moi, regarde ton devoir, Et sois prompt à venir si tu me veux revoir, Pense que ta longueur m'assassine, et me tue, Toi seul peux relever ma pauvre âme abattue:
Souffre que mes deſirs t'arrachent de ce Ciel, Voudrois-tu du Nectar, quand ie n’ay que du fich Ton immortalité me couſteroit la vie, He!	Souffre que mes désirs t'arrachent de ce Ciel, Voudrais-tu du Nectar, quand quelque n'ai que du fich Ton immortalité me coûterait la vie, He!
ſois plus pitoyable en ſaiuant mon enuie, Tu m’as cent fois promis d’aider à mon deſſein, Ha, bons Dieux!	sois plus pitoyable en saisant mon envie, Tu m'as cent fois promis d'aider à mon dessein, Ha, bons Dieux!
le voicy, le cœur me bat au ſein, Ie tremble en remarquant qu’il s’eſt peint le viſage De la paſle couleur d’vn funeſte preſage, La triſteſſe le ſuit & marche ſur ſes pas;	le voici, le cœur me bat au sein, Je tremble en remarquant qu'il s'est peint le visage De la pâle couleur d'vn funeste présage, La tristesse le suit et marche sur ses pas;
Is lis dedans ſes yeux ce qu’il ne me dit pas, Et dans l’incertitudt bumuut ſon ſilence, L’excez de mon ſuplice accroiſt ſa violince, Mes pleurs ſoiuent lis ſiens ſans en voir le ſujet, Toy qui fais ma douleur, mentre-luy ſon objet, Ne me le cele point veut-on forcer Orante?	Is lis dedans ses yeux ce qu'il ne me dit pas, Et dans l'incertitudt bumuut son silence, L'excès de mon supplice accrois sa violince, Mes pleurs soivent lis siens sans en voir le sujet, Toi qui fais ma douleur, mentre-lui son objet, Ne me le cèle point veut-on forcer Orante?
As-tu veu les abou de ſa vertu mourante?	As-tu vu les abou de sa vertu mourante?
As-tu veu ſon eſprit à trauers ſon diſcours?	As-tu vu son esprit à travers son discours?
Suu-je deſeſpere?	Su-je désespère?
n’ay-je plus de ſecours?	n'ai-je plus de secours?
N’implore·t’elle point le pouvoir de mes armes?	N'imploret-elle point le pouvoir de mes armes?
N’as-tu point veu ſes pleurs côme tu vois mes larmes Ne m’eſcrit-elle pas?	N'as-tu point vu ses pleurs côme tu vois mes larmes Ne m'écrit-elle pas?
que ſert de le celer?	que sert de le celer?
Enfin dou-je mourir, ou ſi tu dois parler?	Enfin dou-je mourir, ou si tu dois parler?
SCENE VIII.	SCÈNE VIII.
CLINDOR, ISIMANDRE.	CLINDOR, ISIMANDRE.
GCIIVDON, Vſte Ciil, ie voudrois dans le mal qui me touche A Qu’vn ſilence éternel me vint jeiautrta bouchez	GCIVDON, Vste Ciil, ie voudrais dans le mal qui me touche A Qu'amour silence éternel me vint jeiautrta bouchez
ISIMANDRE.	ISIMANDRE.
N’adiouſte point aux miens tes regrets ſuperfius;	N'ajoute point aux miens tes regrets superfius;
Prononce mon arreſt.	Prononce mon arrêt.
CLINDOR.	CLINDOR.
Orante ne vit plus, Elle a vonlu mourir pluſtoſt qu’aller au change, Elle vous adoroit & n’aimoit point Florange;	Orante ne vit plus, Elle a vonlu mourir plutôt qu'aller au change, Elle vous adorait et n'aimait point Florange;
Que le pouvoir d’Ormin luy donnoit pour Eſpoux, Enfin, que vous diray-je, elle eſt morte pour vous.	Que le pouvoir d'Ormin lui donnait pour Époux, Enfin, que vous dirai-je, elle est morte pour vous.
Et trouuant vn remide aux rigueurs de ſes petnts, Sa gentroſité s’eſt fait coupper les veints,	Et trouvant un remide aux rigueurs de ses petnts, Sa gentrosité s'est fait coupper les veints,
28 Il luy baille le billet d’Orante.	28 Il avait baille le billet d'Orante.
Ce tragique teſmoin vous dira mieux que moy, Quelle fut ſon amour, ſa conſance & ſa foy.	Ce tragique témoin vous dira mieux que moi, Quelle fut son amour, sa consance et sa foi.
ISIMANDRE.	ISIMANDRE.
Tout ce que tu me dis eſt remply de menſonge, Et ton cerueau debile a fait vn mauuais ſonge.	Tout ce que tu me dis est rempli de mensonge, Et ton cerveau débile a fait un mauvais songe.
Orants ne vit plus!	Orants ne vit plus!
Orante eſt au cercueil!	Orante est au cercueil!
Deueſe trauria roix?	Deves trauria roix?
dois-je croire mon œil?	dois-je croire mon œil?
C’eſt de toy cher pappier, que ie le veux apprendre.	C'est de toi cher papier, que ie le veux apprendre.
il lit ce billet.	il lit ce billet.
BILLET.	BILLET.
Tienne ie meurs, mon Iſimandre, Il n’en faut plus douter;	Tienne femme meurs, mon Isimandre, Il n'en faut plus douter;
par la rigueur du ſort La veriu ne vit plus, & le Soleil eſt mort.	par la rigueur du sort La vériv ne vit plus, et le Soleil est mort.
Il n’en faut plus douter ſa plume veritable Ne m’a que trop bien peint ſa perte lamentable;	Il n'en faut plus douter sa plume véritable Ne m'a que trop bien peint sa perte lamentable;
Il n’en faut plus douter;	Il n'en faut plus douter;
elle abandonnt aux vers Le plus rare threſor qui fuſt on l’Vniuers, Orante ne vit plus!	elle abandonnt aux vers Le plus rare tor qui fût on l'Univers, Orante ne vit plus!
Orante n’eſt que poudre:	Orante n'est que poudre:
Et moy ie ne meurs pas aprés ce coup de foudre, Aprés l’auoir ſouffert, ie reſpire vn moment, Ha!	Et moi ici ne meurs pas après ce coup de foudre, Après l'avoir souffert, toujours respire un moment, Ha!
ie ne me crois plus vn veritable amant, Ie flattois mon eſprit en l’eſtimant fidelle.	On ne me crois plus un véritable amant, Je flattais mon esprit en l'estimant fidèle.
S’il euſt ſçeu bien aimer, il ſeroit aupres d’elle, Quand la bliſſure eſt grande on finit ſans parler, Et ciluy qui ſe plaint taſche à ſe conſoler, Chere Ombre, it te ſuy ſi tu me veux attendre.	S'il eût su bien aimer, il serait auprès d'elle, Quand la blissure est grande on finit sans parler, Et cilui qui se plaint tâche à se consoler, Chère Ombre, it te suis si tu me veux attendre.
BILLET.	BILLET.
il lit.	il lit.
Tienne ie meurs mon Iſimandre, He!	Tienne ici meurs mon Isimandre, He!
n’eſt-ce pas répondre à mon cœur, à ma voix Diſant ce qu’elle a fait, on dit ce que is dois.	n'est-ce pas répondre à mon cœur, à ma voix Disant ce qu'elle a fait, on dit ce que is dois.
Caracteres ſanglans, entrez dans ma penſée, Repreſentez-j bien mon Orante bl.	Caractères sanglants, entrez dans ma pensée, Représentez-jà bien mon Orante bl.
ßée, Que le trait de la mort la peigne en mon eſprit, En l’eſtat qu’elle eſtoit, en traçant cét eſcrit, Ha!	ssée, Que le trait de la mort la peigne en mon esprit, En l'état qu'elle était, en traçant cet écrit, Ha!
ie voy ce Fantoſme, & ſa main taſche à mettre Les derniers traits de l’ame en ceux de cette léttre;	ici vois ce Fantôme, et sa main tâche à mettre Les derniers traits de l'âme en ceux de cette lettre;
Et l’Amour ſemble dire à mon cœur priſonnier, Tout le ſang eſt ſorty, i’y reſte le dernier, Suy-moy dans les Enfers où ie m'en vay deſcendre.	Et l'Amour semble dire à mon cœur prisonnier, Tout le sang est sorti, j'y reste le dernier, Sui-moi dans les Enfers où tu m'en vais descendre.
BILLET.	BILLET.
il relit.	il relit.
Tienne, ie meurs mon Iſimandre, Attends, Orante, attends mon ame qui te ſuit, Ne t’en va point ſans elle en l’eternelle nuit, Remarque l’vn & l’autre en mon ob-iſſance, Mais ſouffre que ie pouſſe en vn meſme chemin, Et le traiſire Florange, & le cruel Ormin, Permets que nous gouſtions cette douce allegeance.	Tienne, Seigneur meurs mon Isimandre, Attends, Orante, attends mon âme qui te suit, Ne t'en va point sans elle en l'éternelle nuit, Remarque l'un et l'autre en mon obissance, Mais souffre que Un pousse en un même in, Et le traisire Florange, et le cruel Ormin, Permets que nous goûtions cette douce allégeance.
Que les cœurs irritez trouuent en la vangeance, Mon eſprit au tombtau ne peut eſtre endormy, S’il ne meſle à mon ſang celuy de l’ennemy:	Que les cœurs irrités trouvent en la vengeance, Mon esprit au tombav ne peut être endormi, S'il ne mêle à mon sang celui de l'ennemi:
Ma Deeſſe dimandt vn pareil ſacrifice.	Ma Déesse dimandt un pareil sacrifice.
Partons Clindor, allons luy rendre cét office, Et quand i’auray puny ces volleurs de mon bien, e reſpandray mon ſang ſur les marques du fien.	Partons Clindor, allons Seigneur rendre cet office, Et quand j'aurai puni ces volleurs de mon bien, e répandrai mon sang sur les marques du sien.
D i	D y
A C – II SCENL INERVMICL	À Ç „ II SCENL INERUMICL
FLORANGE.	FLORANGE.
A peine que ie ſens leur eſt indifferenss, LAmour, que dou-je faire, on me rauit Orante O toy qui le fais naiſtre aßiſte mon ennuy, Ou ſi iu vis d’eſpoir, meurs auß-bien que luy, Mon extréme douleut n’a rien qui la conſole, Orante eſt ſans amour.	À peine que ici sens leur est indifférents, LAmour, que dou-je faire, on me ravit Orante ORANTE ois qui le fais naître aussi mon ennui, Ou si ju vis d'espoir, mûrs auss-bien que lui, Mon extrême douleut n'a rien qui la console, Orante est sans amour.
Ormin eſt ſans parole;	Ormin est sans parole;
Que dis-je mal-heureux elle a donné ſa foy.	Que dis-je malheureux elle a donné sa foi.
Elle eſt bien ſans amour mais ce n’eſt que pour moy, I’ay ſçeu comme Iſimandre occupe ſa belle ame, Son cœur eſt conſommé d’vne ſecrette flâme, Mais croyant que mon œil ne le ſçauroit ouurir, L’amour qu’elle a caché me l’a fait deſiouuris, Ha qu’on voit clairement en deſpit de la feinte, Si le cœur eſt ſans playe.	Elle est bien sans amour mais ce n'est que pour moi, J'ai su comme Isimandre occupe sa belle âme, Son cœur est consommé d'une secrète flamme, Mais croyant que mon œil ne le saurait ouvrir, L'amour qu'elle a caché me l'a fait desiouuris, Ha qu'on voit clairement en dépit de la feinte, Si le cœur est sans plaie.
ou ſi l’ame eſt atteinte.	ou si l'âme est atteinte.
L’œil d’vn amant ialoux voit tout peut tout percer, Et meſme dans l’eſprit il ſurprend vn penſez Vn ſouſru vne la-me vn ſouſpir vne œi llade, Sont irdices certai s que l’eſprit eſt malade, Sur quoy l’bomme ſubtil fonde ſon iugement, Celuy qui ſou ffec vn mal le connoiſt aiſement.	L'œil d'un amant jaloux voit tout peut tout percer, Et même dans l'esprit il surprend un pensez Un sousru une la-me un soupir quelque œi ade, Sont irdices certai s que l'esprit est malade, Sur quoi l'âme subtil fonde son jugement, Celui qui sou sec un mal le connaît aisément.
Il n’eſt que trop certain qu’Orante aime Iſimandre, Hais puis qu'elle eſt à moy, ie ſçauray la d ffendre, Naples n’eſt pas ſi loing ny ſon bon-heur ſi prée, Tel cherche du laurie?	Il n'est que trop certain qu'Orante aime Isimandre, Hais puis qu'elle est à moi, té sçauray la ffendre, Naples n'est pas si loin ici son bonheur si prée, Tel cherche du laurie?
qui trouas du Cyprés, Et bien que ce Riual ait la place octupée, Il faudra qu’il la prenne au bont de mon eſpée, Ormin la Mere Orante ſimandrt & li ſort, ne peuuent mt tuper qu'en m' donnant la mort.	qui trouas du Cyprès, Et bien que ce Rival ait la place octupée, Il faudra qu'il la prenne au bont de mon épée, Ormin la Mère Orante simandrt et li sort, ne peuvent mut tuper qu'en m' donnant la mort.
SCENE ISIMANDRE, LINDOMA II.	SCÈNE ISIMANDRE, LINDOMA II.
J.	J.
CLINDOR.	CLINDOR.
IS MANDRE.	IS MANDRE.
Rante n’eſt pas morte!	Rante n'est pas morte!
Orante vit entore!	Orante vit entore!
O Fidelle Meſſagν il faut que ie t’adore.	Ô Fidèle Messag il faut que ie ore.
LINDOMAN.	LINDOMAN.
Quoy.	Quoi.
Monſieur, doutez-vous d’vn bon-heur aſſeusé?	Monsieur, doutez-vous d'un bonheur asseusé?
Vos yeux verront bien-toſt ce que i’ay tant iuré.	Vos yeux verront bientôt ce que j'ai tant juré.
Nous approthens de Piſe, & dans l’heure où nous ſommes.	Nous approthens de Pise, et dans l'heure où nous sommes.
Vous vous con feſſerez le plus heureux des hommes, Cet habit de Mar hand rauira vos eſprits, Dans vne autre deſſain que vous ne l’auisz pris:	Vous vous con fesserez le plus heureux des hommes, Cet habit de Mar hand ravira vos esprits, Dans quelque autre dess que vous ne l'avisz pris:
Et ſans vous en ſetuir contre voſtre aduerſaire, Pour approcher d’Orante il vous eſt necejjaire.	Et sans vous en setuir contre votre adversaire, Pour approcher d'Orante il vous est necejjaire.
ISIMANDRE.	ISIMANDRE.
Orante!	Orante!
Ce beau nom me charme, & me rauis Mais bion-heureux pappier, redix-moy qu'elit er	Ce beau nom me charme, et me ravis Mais bionheureux papier, redix-moi qu'élit er
Mon ſang a marqué mon courage, Mais apprenez de ce diſcours, que pour ſauuer le reſte aprés ce grand orage I’ay beſoin de voſtre ſecours.	Mon sang a marqué mon courage, Mais apprenez de ce discours, que pour sauver le reste après ce grand orage J'ai besoin de votre secours.
Vous l’aurez, chere Orãte, & pour voir tãt de charmes Amour ioindra ſa force à celle de mes armis, I’auray pour obeïr à ce diuin eſcrit, Autant de force au bras, comme vous en l’eſprit.	Vous l'aurez, chère Orance, et pour voir tant de charmes Amour joindra sa force à celle de mes armis, J'aurai pour obéir à ce divin écrit, Autant de force au bras, comme vous en l'esprit.
il it.	il it.
LETTRE.	LETTRE.
L’eſperance m’eſtant oſtée, Le treſpas me ſembla fort doux, Lamnoui me fit mourir, & m’a reſſuſcitée, Mais ie veux que ce foit pour vous,	L'espérance m'étant ôtée, Le trépas me sembla fort doux, Lamouni me fit mourir, et m'a ressuscitée, Mais tu veux que ce soit pour vous,
Ha trop heureux amant!	Ha trop heureux amant!
ô tro?	ô tro?
fidelle Amante!	fidèle Amante!
Dieux que le calme plaiſt lors qu’il ſuit la tourmẽ:	Dieux que le calme plaît lors qu'il suit la tourment:
e Migacle de nos iours:	é Migacle de nos jours:
incomparable foy.	incomparable foi.
Que ue vous dois-je point?	Que ue vous dois-je point?
viure & mourir pour moy.	vivre et mourir pour moi.
il acheue de lire.	il achève de lire.
Soyez diſcret, ſoyez fidelle, Sans eſtre connû dans ce lieu, Orante vous permet de venir auprés d’elle, Vollez s’il eſt poſſible;	Soyez discret, soyez fidèle, Sans être connu dans ce lieu, Orante vous permet de venir auprès d'elle, Vollez s'il est possible;
adieù.	adieù.
Obſeruons de tout point les loix de ma Maiſtreſſe, Aiue par tes adais au deſir qui me preſſe, Apprenás moy, Lindoman, par ton ſage canſeil.	Observons de tout point les lois de ma Maîtresse, Ajue par tes adais au désir qui me presse, Apprens moi, Lindoman, par ton sage canseil.
cuns sſiit ven à autun, à approcher du Soleit.	cuns sit ven à autun, à approcher du Soleit.
LINDOMAN.	LINDOMAN.
La ruſe d’vn Demon ne verroit pas la noſire, Cét habit vous déguiſe, & vous fait tout vn autre, Ie vous laiſſou paſſer quaud vous eſtes venu, Si Clindor par mal-heur ne m’euſt pas reconna.	La ruse d'un Démon ne verrait pas la nosire, Cet habit vous déguise, et vous fait tout un autre, Je vous laisser passer quaud vous êtes venu, Si Clindor par malheur ne m'eût pas reconna.
Ie vau marcher deuant, afin qu’on ne ſoupçonne, vinex unoil aa Chapeau ſans parler à perſoane, Clindor vous conduir a dans ſon Apartement.	Je vau marcher devant, afin qu'on ne soupçonne, vinex unoil à Chapeau sans parler à persoane, Clindor vous conduir a dans son Appartement.
CLINDOR.	CLINDOR.
I'en ſçau bien le chemin, quittez-nous ſeulemint.	J'en sau bien le chemin, quittez-nous seulemint.
ISIMANDRE.	ISIMANDRE.
Prepare mon Orante apprends-luy ma venuë, Allons voir le Soleil à trauers cette nisë C’eſt ainſi que ſans crime on peut eſtre tosmpeur;	Prépare mon Orante apprends-lui ma venue, Allons voir le Soleil à travers cette nisë C'est ainsi que sans crime on peut être tosmpeur;
Qu'Argus ſoit en ce lieu, ie n’en ay point de peur, Comme le feu ſe cache en ſa Sphere ſupréme, Le miin pra par quetayjz tainera de meme, Mon cœur eſt ſon vray centre, où ſon eſclat ne luis, Que pour moy qui le ſens, & pour pura produit.	Qu'Argus soit en ce lieu, on n'en ai point de peur, Comme le feu se cache en sa Sphère suprême, Le yin prise par quetaijà tainera de même, Mon cœur est son vrai centre, où son éclat ne luis, Que pour moi qui le sens, et pour pura produit.
SCENE III.	SCÈNE III.
PALINICE, LVCINDE, NERINE.	PALINICE, LUCINDE, NERINE.
PALINICE.	PALINICE.
E n'eſt pas ſans rougir que it me vois contrainte O D’obliger voſtre eſprit à partagez ma crainte, I’ay balancé long-timps auant que de parler.	ELLE n'est pas sans rougir que it me vois contrainte Ô D'obliger votre esprit à partagez ma crainte, J'ai balancé longtemps avant que de parler.
Et ie ſouffrois vn mal qui ie vouĺois celts,	Et ici souffrais un mal qui ie voudrais cels,
I’en eſloignou mes pas, i'on de tournois ma veuë, I’aucuſou ma raiſon d’in eſtre depourutuë, Ie choquois ſis aduu au lieu dy conſentir, Et flattou ma douleur pour ne la pas ſentir.	J'en éloignou mes pas, j'on de tournois ma vue, J'aucusou ma raison d'in être dépourutue, Je choquais sis avis au lieu dis consentir, Et flattou ma douleur pour ne la pas sentir.
Mau enfin le peril eſt tiop grand pour le taire, On ne plaint pas vn mal quand il eſt volontaire, Vos intereſis communs ſe doiuent conſiiller.	Mau enfin le péril est tiop grand pour le taire, On ne plaint pas un mal quand il est volontaire, Vos interesis communs se doivent consiller.
Et puiſque vous dormez ic vous veux réveiller.	Et puisque vous dormez ic vous veux réveiller.
Ne remarquez-vous point qu'Ormin n’aimt qu’Orante?	Ne remarquez-vous point qu'Ormin n'aimt qu'Orante?
Mau vous me répondrez c’eſt qu’elle eſt ſa parente;	Mau vous me répondrez c'est qu'elle est sa parente;
On diſcerne aiſement l'ardeur & la pitié.	On discerne aisément l'ardeur et la pitié.
Les ſentimens d amour & ceux de l’amnié.	Les sentiments d amour et ceux de l'amnié,
Le ſang ne peur donner vne ſi baute eſtime, Croyez-moy, ſes deſſains n’ont rien de legitime, Ie connou mieux que vous ſes incling ions, I'ay leu dedans ſon tœur ſes folles poßiens, Le feu le plus cache ierte vn peu de fumée, Orante n’amme point mais elle eſt trop aimée, I’eſtime ſon eſprit, i’adore ſa vertu.	Le sang ne peur donner une si baute estime, Croyez-moi, ses sains n'ont rien de légitime, Je connou mieux que vous ses incling jons, J'ai lu dedans son tœur ses folles possiens, Le feu le plus cache jerte un peu de fumée, Orante n'amme point mais elle est trop aimée, J'estime son esprit, j'adore sa vertu.
Le vice qui l'attaque eſt touſious batu, Mais ſungez qui la ferci eſt vne unoſe iſtrange, Voyez qu’il a manqué de parole à Florange, Il ſuit l’humeur d’Orante afin de l’obliger.	Le vice qui l'attaque est toujours battu, Mais sungez qui la sercy est une ose istrange, Voyez qu'il a manqué de parole à Florange, Il suit l'humeur d'Orante afin de l'obliger.
Crojue que mon aduis n'eſt pas à negliger.	Crojue que mon avis n'est pas à négliger.
LVCINDE.	LUCINDE.
Vos penſers & les miens ont de la ſimpaibie, Ie preuoyois le mal dont ie ſuis aduertie.	Vos pensers et les miens ont de la simpaibie, Je prévoyais le mal dont ie suis avertie.
Et taſchous de trouuer par mon raiſonnement, Dans la fin de ce feu cille de mon tourment:	Et tâchous de trouver par mon raisonnement, Dans la fin de ce feu cille de mon tourment:
Mais que peut toutt ſeult vne venfut a fligée?	Mais que peut tout seult une venfut a fligée?
Vne femme ſans force, vne Mere outragee, Qui trouue en ſod Axile vn enn.	Une femme sans force, une Mère outrage, Qui trouve en sod Axile un enn.
my cathe.	mi cathe.
Mon mal eſt ſans remede en vain i’in ay cherché;	Mon mal est sans remède en vain j'in ai cherché;
Pour moy le cidl eſt ſoutá, ma pritre inutile.	Pour moi le cidèl est soutante, ma pritre inutile.
Eſt vn grain que ie ſeme en vn champ inſertile;	Est un grain que ici sème en un champ insertile;
ume s'aureſſe au vier qui ne la reçoit point;	Âme s'auresse au vier qui ne la reçoit point;
Il paſſe;	Il passe;
& mon mal-heur eſt touſiours en vn point.	et mon malheur est toujours en un point.
PALINICE.	PALINICE.
Suiurez vous vn moyen que l eſprit me ſuggere;	Suivrez -vous un moyen que l esprit me sugère;
LVCINDE.	LUCINDE.
Toute diſficulté me paroiſtraligert;	Toute disficulté me paroistraligert;
Propoſiz ſeulement:	Propposis seulement:
PALINICE.	PALINICE.
Oſiez vous de ce luu, Ne voyez plus Ormin, partez ſans dire adisu;	Osiez -vous de ce lu, Ne voyez plus Ormin, partez sans dire avisu;
Que Florange vous ſuiue & qu’apres dans Florince Il reçoiue le fruit de ſa perſiuerance;	Que Florange vous suive et qu'après dans Florince Il reçoive le fruit de sa persiverance;
Le temps qui change tout, pourra changer Ormin:	Le temps qui change tout, pourra changer Ormin:
EYCISDE.	EYCISDE.
Dans ſix iours au plus tard ie me mets en chemin.	Dans six jours au plus tard endre me mets en chemin.
PACINICE 81 Vous ſerez en repos & noſtre Amant en peine:	PACINICE 81 Vous serez en repos et notre Amant en peine:
LVCINDE.	LUCINDE.
I’aimt plus mon honneur que ie ne cralls ſa haine.	J'aimt plus mon honneur que je ne cralls sa haine.
NERINE.	NERINE.
Dieux on la veut forcer, ie n’ypuis conſentir;	Dieux on la veut forcer, ie n'ypuis consentir;
Elle a eſcouté.	Elle a écouté.
Mais ce mal eſt preſſant, ie vay l’en aduertir.	Mais ce mal est pressant, ie vay l'en avertir.
SCENE IV ORANTE, LINDOMAN.	SCÈNE IV ORANTE, LINDOMAN.
ORANTE.	ORANTE.
E ne puis te payer, ie le voy plus i’y penſe.	ET ne puis te payer, ie le vois plus j'y pense.
HTADOMAN.	HTADOMAN.
En faiſant mon deuoir i’ay pris ma récompenſe.	En faisant mon devoir j'ai pris ma récompense.
ORANIE.	ORANIE.
lo vuy deſia preſent ir croy le regarder.	lo vi déjà présent ir crois le regarder.
LINDOMAN.	LINDOMAN.
Aaααmt, uſeuren iunifuiiiuuſpauroit tarder.	Aaααmt, usuren iunifuiiiuuspauroit tarder.
ORANTE.	ORANTE.
Mais s’il eſt reconnu le dangur eſt extréme.	Mais s'il est reconnu le dangur est extrême.
LINDOMAN.	LINDOMAN.
Il eſt ſi fort changé, que ce n’eſt plus luy-meſmi.	Il est si fort changé, que ce n'est plus lui-mesmi.
Sous l’habit d’vn Marchand qui cache ſes appas, rout qui l’auez au cœur ne le connoiſtrez pas	Sous l'habit d'Hommes Marchand qui cache ses appas, rout qui l'avez au cœur ne le connaîtrez pas
ORANTE.	ORANTE.
Souz vn mauudis habit paroiſt ſa bonne mine, Ainſi que l’or eſclate en l’obſcur d’vne mine.	Souz un maudis habit paraît sa bonne mine, Ainsi que l'or éclate en l'obscur d'une mine.
SCENE V.	SCÈNE V.
NERINE, ORANIE, LINDOMAN.	NERINE, ORANIE, LINDOMAN.
NERINE.	NERINE.
Elle luy parle à l’oreille.	Elle avait parle à l'oreille.
A Madame, eſcoutez.	A Madame, écoutez.
ORANTE.	ORANTE.
Ie n’in ay point de peur.	Je n'in ai point de peur.
Mon projet eſt certain, leur eſpoir eſt trompeur, Ie verray leur pratique aujourd huy renuerſee, Si ie ſuis Andromide,Iſimandre eſt Perſée, bon dil ajtaitera le mdastal qume fl.	Mon projet est certain, leur espoir est trompeur, Je verrai leur pratique aujourd' hui renversée, Si jour suis Andromide,Isimandre est Persée, bon dil ajtaitera le mdastal me fl.
LINDOMAN.	LINDOMAN.
Ie l’apperçoy, Madame & Clindor le conduit.	Je l'aperçois, Madame et Clindor le conduit.
ORANTE.	ORANTE.
Mon cœur nage en la ioye, & rien ne l’importune.	Mon cœur nage en la joie, et rien ne l'importune.
Il ne craint plus les traicts que tire la fortune.	Il ne craint plus les traits que tire la fortune.
SCENEVT ISIMANDRE, ORANTE, NERINE, GLINDOR, LINDOMAN.	SCENEUT ISIMANDRE, ORANTE, NERINE, GLINDOR, LINDOMAN.
ISIMANDRE.	ISIMANDRE.
Iſez dedans mes yeux voyez en ma couleur, L Que l’extréme plaiſir reſſimble à la douleur, Ma bouche en eſt muette & mon eſprit ſe paſme, Fermez-la d’vn baiſer, pour retenir mon ams.	Isez dedans mes yeux voyez en ma couleur, L Que 'extrême plaisir réssimble à la douleur, Ma bouche en est muette et mon esprit se pâme, Fermez-la d'un baiser, pour retenir mon ams.
ORANTE.	ORANTE.
Vous me faite pitié, ie veux vbas ſetourir;	Vous me faite pitié, votre veux vbas setourir;
Viuez cher Iſimandre, eù i’ay voulu mourir.	Vivez cher Isimandre, Eù j'ai voulu mourir.
ISIMANDRE.	ISIMANDRE.
Lieux ſacrez à l’amour, pleins d'appas, & de charmes Montréz-moy ce beau ſaug que i’y meſle mts larmes Mau non, ie me repens de ma temerité, Conſeruez-le tout pur à la poſterité.	Lieux sacrés à l'amour, pleins d'appas, et de charmes Montréz-moi ce beau saug que j'y mêle mens larmes Mau non, je me repens de ma témérité, Conservez-le tout pur à la postérité.
Quand on vous couuriroit des richeſſes du Gange, Cét eſmail eſt ſi beau que veus perdriez au change.	Quand on vous couvrirait des richesses du Gange, Cet émail est si beau que ès perdriez au change.
Puiſſe bien-toſt l’Aurore en orner ſes habits, Et le meſler au Ciel auecque ſes rubis, Ce threſor eſt trop grand pour reſter ſur la terre.	Puisse bientôt l'Aurore en orner ses habits, Et le mêler au Ciel avec ses rubis, Ce sor est trop grand pour rester sur la terre.
OANIE.	ÔANIE.
On triomphe en la paix & nous ſommes en guerre, On me veut enleuer quil remede auons-nous?	On triomphe en la paix et nous sommes en guerre, On me veut enlever quil remède avons-nous?
ISIMANDRE.	ISIMANDRE.
On vous veut enleuer!	On vous veut enlever!
y conſentirez vous;	y consentirez -vous;
ORANTE.	ORANTE.
Cherchez noſtre ſecours dedans voſtre induſtrie.	Cherchez notre secours dedans votre industrie.
ISIMANDRE.	ISIMANDRE.
Sur les aiſls d’amour vollons en ma patris:	Sur les ails d'amour vollons en ma patris:
Que Naples vous reuoye en ieune Caualier, Ce remede eſt faſcheux, mais il eſt ſingulier, L’amour s’eſt touſiours pleu dans les metamorphoſes, Le temps en s’enfuyant ameine toutes choſes;	Que Naples vous revoie en jeune Cavalier, Ce remède est fâcheux, mais il est singulier, L'amour s'est toujours pleu dans les métamorphoses, Le temps en s'enfuyant âme toutes choses;
Sous le nem d’vn Amy mon pere vous peut voir.	Sous le nem d'Hô Ami mon père vous peut voir.
ORANTE.	ORANTE.
Il ſe fait vn cembat d’amour & du deuoir.	Il se fait un cémbat d'amour et du devoir.
ISIMANDRE.	ISIMANDRE.
Le deuoir & lamour, obligent ma Maiſtreſſe, A fuir ſagement l’ennimy qui a preſſe,	Le devoir et lamour, obligent ma Maîtresse, A fuir sagement l'ennimi qui a presse,
ORANTE.	ORANTE.
Mais ſe peut il trouuer vn Amoureuu conſtant	Mais se peut il trouver un Amoureu constant
laimlavulen.	Laimlavulen.
Ha!	Ha!
ſi vous en doutez, que ie meure à l’inſtant.	si vous en doutez, que ici meure à l'instant.
OMANIE.	OMANIE.
Où prendre des habits:	Où prendre des habits:
le moyen, l’apparence?	le moyen, l'apparence?
ISIMANDRE.	ISIMANDRE.
Ie feray ſourdement l’equipags à Florence, Et dans trois iours Clindor vous les apportera, dumer preleule juua uls Puoleuna quis anin.	Je ferai sourdement l'équipags à Florence, Et dans trois jours Clindor vous les apportera, dumer preleule ra us Pua quis anin.
ORANTE.	ORANTE.
Ne laiſſons pas Nerine elle eſt de la querelle.	Ne laissons pas Nerine elle est de la querelle.
ISIMANDRE.	ISIMANDRE.
Et biun, i’en feray faire, & pour vous & pour elle Et les ayant viſtus ſopez le iour ſuiuant Dans le Temple de Mars dés le Soliil leuant, nau rono me tronuerie e vbaueit u vne autre ſorte, Les cheuaux ſeront preſts à cent pas de la porte, Et pourueu que le cœurne vous manque au beſoin, Quand on vous cherchera, nous ſerons deſia leing,	Et biun, j'en ferai faire, et pour vous et pour elle Et les ayant vîtus sopez le jour suivant Dans le Temple de Mars dés le Solia levant, nau rono me tronverie eût vu u ne autre sorte, Les chevaux seront prêts à cent pas de la porte, Et pourvu que le cœurne vous manque au besoin, Quand on vous cherchera, nous serons déjà leing,
ORANTE.	ORANTE.
Vous auez deſſus luy la puiſſanct abſoluë.	Vous avez dessus beau la puissanct absolue.
Puis que vous le voulez, m’y voilà reſoluë.	Puis que vous le voulez, m'y voilà résolue.
Et deuſſay-j' trouuer la mort à mon chemin, Ie vous ſuiuray par tout.	Et dûs-j' trouver la mort à mon chemin, Je vous suivrai par tout.
NERINE, Voicy venir Oimin.	NERINE, Voici venir Oimin.
ISIMANDRE prenant vn Tableau.	ISIMANDRE prenant un Tableau.
Ladame, remarquez comme en cette peinture, D’Ait plus diuin qu'humain, imite la Nature, 'oyεz comme Adonis ſemble admirer Venus, Cenme à trauers le creſpe on voit ſes membres nuds;	Ladame, remarquez comme en cette peinture, D'Ait plus divin qu'humain, imite la Nature, 'oyés comme Adonis semble admirer Venus, Cenme à travers le crêpe on voit ses membres nus;
Cét autre eſt rauiſſant, où le Pinteau prophant, Offre aux yeux d'Actoon les beautez de Diane.	Cet autre est ravissant, où le Pinteau prophant, Offre aux yeux d'Actoon les beautés de Diane.
il prend le ſecond.	il prend le second.
Poyez que ce viſage eſt en colere & beau, Et que ce corps plongé ſe fait vn habit d’eau.	Poyez que ce visage est en colère et beau, Et que ce corps plongé se fait un habit d'eau.
ORANTE.	ORANTE.
Ormin arriue.	Ormin arrive.
Ha!	Ha!
Menſieur approchez, venez voir des merueilles, Qui chez les plus grands Rois n’auroient point de pareilles;	Mensieur approchez, venez voir des merveilles, Qui chez les plus grands Rois n'auraient point de pareilles;
Tout ainſi que les miens vos yeux ſeront charmez,	Tout ainsi que les miens vos yeux seront charmés,
SCENE VII.	SCÈNE VII.
ORMIN, ISMANDRE, ORANTE, NERINE, CLINDOR, LINDOMAN.	ORMIN, ISMANDRE, ORANTE, NERINE, CLINDOR, LINDOMAN.
ORMIN LLES vallent beaucoup, ſi vous les eſtimez.	ORMIN LLES valent beaucoup, si vous les estimez.
Pu ISIMANDRE.	Pu ISIMANDRE.
il prend le troiſiéme.	il prend le troisième.
Veerz dans ce tableau cette hiſtoire conneuë, Cà le fol Ixion n’embraſſs que la nuë, Foyez de iæpiter le regard inhumain, Commé il hauſſe le bras la loudre dans la mam.	Veerz dans ce tableau cette histoire connue, Cà le fol Ixion n'embrasss que la nue, Foyez de jæpiter le regard inhumain, Commé il hausse le bras la loudre dans la mam.
ORMIN.	ORMIN.
Certes, Peintre, ou Marchand, ou tous les deux an ſemble, La langue & le pinceau, font tres-bien ce mi ſeuISIMANDRE prenant le quatrieſme.	Certes, Peintre, ou Marchand, ou tous les deux an semble, La langue et le pinceau, font très-bien ce mi seuISIMANDRE prenant le quatrième.
Voyez comme Appoïon court apres ſa Dafné!	Voyez comme Appoïon court après sa Dafné!
Elle deuient vn bois dont il eſt couronné;	Elle devient un bois dont il est couronné;
Pour atteindre pluſtoſt cette Nimphe ſuperbe, Il laiſſe cheoir ſa lire, & ſon carquois ſas l’hbς, Il la ſuit, elle fuit, & va de toutis parts, La robe retroußée, & les cheueux sſpars,	Pour atteindre plutôt cette Nymphe superbe, Il laisse choir sa lire, et son carquois sas l'hbς, Il la suit, elle fuit, et va de toutis parts, La robe retroussée, et les cheveux sépars,
ORANTE Que me demandez-vous de ves quatre Peinurs?	ORANTE Que me demandez-vous de vez quatre Peinurs?
ORMIN.	ORMIN.
Allez cherches ai leurs vos bonnes aduantures, Deſia voſtre marché ſans mat chander eſt fait.	Allez cherches ai leurs vos bonnes aventures, Déjà votre marché sans mat chander est fait.
Qu’on le meine là bas, & qu’ã ſoit ſatufaĩt;	Qu'on le mène là bas, et qu'en soit satufaint;
Le prix ſe mefaruni auorqua jauiuunde, Qu’il ait ce qu’il dira puis que ie le commande.	Le prix se mefaruni avorqua jauivunde, Qu'il ait ce qu'il dira puis que ie le commande.
GRANIE.	GRANIE.
Et cét autre Tableau?	Et cet autre Tableau?
1S MAISDRE.	1S MAISDRE.
ie l’ennoiray, ma foy.	Il l'ennoirai, ma foi.
ORANTE.	ORANTE.
Adieu, n’y manquez pas, ſouuenez-vous de ns	Adieu, n'y manquez pas, souvenez-vous de ns
ISIMANDRE.	ISIMANDRE.
Cet honme qui me ſert l’apportera, Maduras,	Cet honme qui me sert l'apportera, Maduras,
il dit ce vers bas.	il dit ce vers bas.
Ha!	Ha!
que n’ay-je ſon cœur, ainſi qu'il a mon ame.	que n'ai-je son cœur, ainsi qu'il a mon âme.
ORANTE tenaut le premier Tableau.	ORANTE tenaut le premier Tableau.
Monſieur, cet Ixion me ſemble le pius beau:	Monsieur, cet Ixion me semble le pius beau:
ORMN.	ORMN.
Il eut vnhaut deſſein & le Ciel pour Tombrau;	Il eut unhaut dessein et le Ciel pour Tombrau;
Iu far meureax en fouge, & te tuy porte enuis;	Ju far meureax en fouge, et te tui porte envis;
Sa mort fut glorieu ſe außs bien que ſa vis.	Sa mort fut glorieu se aussi bien que sa vis.
ORANIE.	ORANIE.
Mais le fondre punit ſes proitcts orgueilleux,	Mais le fondre punit ses proits orgueilleux,
ORMIN.	ORMIN.
Les deſſ-ins eſluuez ſont touſiours perilleux:	Les dess-ins esluuez sont toujours périlleux:
Ce grand sœur rencontra la fortune irritée, at n'ent pas iu couronne & vauon mritee;	Ce grand sœur rencontra la fortune irritée, at n'ent pas ju couronne et vavon mritee;
Mais ſi i’auois ſon ſort, ie uiout rois ſans regret;	Mais si j'avais son sort, ie uiout rois sans regret;
Il deſcouurit ſon mol, & le mien eſt ſecret:	Il découvrit son mol, et le mien est secret:
ORANTE.	ORANTE.
Second Tableau.	Second Tableau.
Que Diane me plaiſt que i'aime ce riuag.	Que Diane me plaît que j'aime ce rivag.
ORMIN.	ORMIN.
Dieux?	Dieux?
elle n’a pas ſeule vn naturel ſauuage, vn'autre nait mes jeux qui l'oſent adorer, Et fait que mis penſers me viennent diuores, Miſerable Acteon, ie l’eſprouue rebelle, Mai n'importe mon oœαν mourons, car elle eſt bille	elle n'a pas seule un naturel sauvage, une autre naît mes jeux qui l'osent adorer, Et fait que mis pensers me viennent divores, Misérable Acteon, Seigneur l'éprouve rebelle, Mai n'importe mon oe mourons, car elle est bille
ORANTE.	ORANTE.
Troiſieſme Tableau.	Troisième Tableau.
Cette Nimphe qui fuis io iouontue puu.	Cette Nymphe qui fuis jo uontue puu.
ORMIN.	ORMIN.
Ie ſeray plus heureux que ne fut Encelade:	Je serai plus heureux que ne fut Encelade:
Si ces lambris d’azur peuuent plaire à vos yeux, I’oſeray vous placer dans le Throſne des Dieux;	Si ces lambris d'azur peuvent plaire à vos yeux, J'oserai vous placer dans le Thrône des Dieux;
Voſtre ſeule froideur a borné ma puiſſance;	Votre seule froideur a borné ma puissance;
Eſprouuez mon amour pur mon ob ïſſance.	Éprouvez mon amour pur mon ob issance.
ORANTE.	ORANTE.
amuneoregtant, aibapeur, tuſqu en vn ſi haut point Vous me croirez iagrate, & ie ne la ſuis point.	amuneoregtant, aibapeur, tusqu en un si haut point Vous me croirez jagrate, et ie ne la suis point.
ORMIN.	ORMIN.
Ie crois qu’vne Deeſſ eſt touſtours veritable.	Je crois qu'une Déess est toustours véritable.
Mais ce long entretien vous eſt iuſupportable;	Mais ce long entretien vous est iusupportable;
Et mon eſprit großier auprés de ves appas, doupanimpaneintement quit ne vous donne pat.	Et mon esprit grossière auprès de vez appas, doupanimpaneintement quit ne vous donne pat.
Adiou, voicy la nuit lis obiects ſe terniſſent;	Ajou, voici la nuit lis objets se ternissent;
1e joubaite a vas puux Vn bien qu’ils me rauiſſent.	1e joubaite a vas puux Un bien qu'ils me ravissent.
ORANTE.	ORANTE.
De ce diſcours obſcur i’ay l’eſprit eſtonné.	De ce discours obscur j'ai l'esprit étonné.
Ormin s’en va.	Ormin s'en va.
Mais prenez le repos que vous m’auez donné:	Mais prenez le repos que vous m'avez donné:
Touſiours quelque malheur le Deſtan me ſuſcite:	Toujours quelque malheur le Destan me suscite:
Florange me pourſait, Ormin me ſolicite;	Florange me poursait, Ormin me solicite;
Sa femme veut ma perte;	Sa femme veut ma perte;
& ma Mere y conſent;	et ma Mère y consent;
Helus!	Hélus!
que d’ennemis contre vn cœur innocent.	que d'ennemis contre un cœur innocent.
Mais i’apper çoy le port en deſpit de l’orage;	Mais j'aper çoy le port en dépit de l'orage;
Ie ſortiray des fers ſi i’en ay le courage;	Je sortirai des fers si j'en ai le courage;
Comment!	Comment!
i’heſité encor?	j'hésité encor?
ſur vn point aſſuré!	sur un point assuré!
Non, non, il faut partir;	Non, non, il faut partir;
Orante l’a iuré,	Orante l'a juré,
MAPE SCENE PREMIERE.	MAPE SCÈNE PREMIÈRE.
LVCINDE, PALINICE, ORANTE, NERINE.	LUCINDE, PALINICE, ORANTE, NERINE.
PALINICE.	PALINICE.
Ous ſerez dans le calme & rirez des tempeſtes, V Car pour voſtre départ toutes choſes ſont preſles.	Ous serez dans le calme et rirez des tempêtes, V Car pour notre départ toutes choses sont presles.
RMRREE.	RMRRE.
Dimain ſans diff ror m'éloignant de ce lieu, Mon eſprit affugé vous derobe vn Adieu	Dimain sans dis or m'éloignant de ce lieu, Mon esprit affugé vous derobe un Adieu
ORANIE & Neflne en habit d’hommes les rencontrants.	ORANIE et Neflne en habit d'hommes les rencontrants.
Ha!	Ha!
is tremble Nerine:	Y tremble Nerine:
NERINE.	NERINE.
O bon-heur ſans exemple!	Ô bonheur sans exemple!
Madame ſauuons-nous, ent rons dedans le Temple.	Madame sauvons-nous, ent ons dedans le Temple.
Sous cét habit trompeur on ne vous connoiſt pas.	Sous cet habit trompeur on ne vous connaît pas.
ORANTE.	ORANTE.
Vueille Amour qu’I ſimandre ait deuancé mes pas.	Veuille Amour qu'I simandre ait devancé mes pas.
SCENE II.	SCÈNE II.
FLORANGE, ISIMANDRE, CLINDOR.	FLORANGE, ISIMANDRE, CLINDOR.
FLORANGE.	FLORANGE.
N'Eſt en vain qu’on me fuit, c’eſt in vain qu’on O ſe cathe Ie ſuis ſeule ils ſont deux mais l’vn& l’autre eſt lâche Qu'lque mauuau deſſtin les obuge à courir, T.	N'Est en vain qu'on me fuit, c'est in vain qu'on Ô se cathe Je suis seule ils sont deux mais l'Homme l'autre est lâche Qu'lque mauvau desstin les obuge à courir, T.
m.	m.
raire Iſi mantre apprends qu’il faut mourir.	raire Isi mantre apprends qu'il faut mourir.
ISIMANDRE.	ISIMANDRE.
Bons Oieux que d’accidens chocquent mon intrepriſe ul et na mt vals puens, ia me jainta buns lijs.	Bons Oieux que d'accidents chocquent mon intreprise ul et na mt us puments, ja me jainta buns lijs.
CLINDOR.	CLINDOR.
Ouurons-nous par ſa mort le chemin du bou-heur.	Ouurons-nous par sa mort le chemin du bouheur.
ISTMANDRE.	ISTMANDRE.
Ie ſuiuray ton conſeil, & celuy de l’honneur.	Je suivrai ton conseil, et celui de l'honneur.
Cét arbre, & cette eſcharpe aſſeureront Florange.	Cet arbre, et cette écharpe assureront Florange.
il le lie à vn arbre.	il le lie à un arbre.
Que ma main ſans ſicond ſçait bien comme on ſe vange.	Que ma main sans sicond sais bien comme on se venge.
FLGMNGE.	FLGMNGE.
Me montrez-vous mes yeux ce que ie penſe voir ?	Me montrez-vous mes yeux ce que je pense voir ?
CLINDOR.	CLINDOR.
Monfieus que faites-vous?	Monfieus que faites-vous?
ISIMANDRE.	ISIMANDRE.
Ce que veut mon denoir, O toy' que le mel-heur oppoſs à mon paſſage.	Ce que veut mon denoir, Ô toy' que le melheur opposs à mon passage.
Vieux ſpectre que les ans n’ont pas rendu plus ſage, Souuiins-toy du beau ſang qu’Orante a répandu, 3 OMRIES Et reçoſ de mon uias ie iopir qu' t’eſt deu;	Vieux spectre que les ans n'ont pas rendu plus sage, Souvins-toi du beau sang qu'Orante à répandu, 3 OMRIES Et reços de mon uias Seigneur jopir qu' qu'est dev;
FLORANGE ton bant.	FLORANGE ton bant.
Temtrité ſans force!	Temtrité sans force!
eſperant trompée!	espérant trompée!
IS MANDRE.	IS MANDRE.
Demande moy la vie.	Demande moi la vie.
& me rends ton eſpée:	et me rends ton épée:
FLORANGE It jau ivn, prineat auiit.	FLORANGE It jau jour, prineat aujit.
& gουιιε μες Guerriers Ne ſoüillez point de ſang l’eſe at de vos lauriers.	et gουιιε et Guerriers Ne soüillez point de sang l'es at de vos lauriers.
CLINDOR.	CLINDOR.
Monſieur puniſſez-le du trauail qu’il vous donne;	Monsieur punissez-le du travail qu'il vous donne;
FLORANGE Ie vous cide mon droict	FLORANGE Je vous cide mon droit
ISIMANDRE.	ISIMANDRE.
& moy it vous pardonnt;	et moi it vous pardonnt;
Ciel!	Ciel!
de quelle douleur ay-ie le cœur percé;	de quelle douleur ai-je le cœur percé;
Clindor que ferons-nous?	Clindor que ferons-nous?
ie me trouue bleßé;	Ne me trouve blesié;
Le moyen que ſanglant i’aille où l'Amour m’appelle, Ha chetif fimandre!	Le moyen que sanglant j'aille où l'Amour m'appelle, Ha chétif simandre!
ô fortune infidelle!	ô fortune infidèle!
Trauerjanaueud tunuem uapunou re fuu, Sans eſtre reconnu, c’eſt ce que ie ne puis:	Traverjanaveud tunuem uappunou re fu, Sans être reconnu, c'est ce que personne ne puis:
il délie ſon Eſcuyer.	il délie son Écuyer.
On m’attend cependaut helas!	On m'attend cependaut hélas!
que dois is faire;	que dois is faire;
CLINDOR.	CLINDOR.
Deſchargez vous ſur moy du poidz de cette affaire?	Déchargez -vous sur moi du poids de cette affaire?
I’auray par mou trauail la fin de vos trauaux Allez vous repoſer auprés de nos cheuaux;	J'aurai par mou travail la fin de vos travaux Allez -vous reposer auprès de nos chevaux;
Mais de peur qu’il ne parle il faut garder ce traiſtre,	Mais de peur qu'il ne parle il faut garder ce traître,
ISIMANDRE.	ISIMANDRE.
C’eſt au Temple de Mars que ma Venus doit eſtre,	C'est au Temple de Mars que ma Venus doit être,
CLINDOR.	CLINDOR.
Cachez-vous dans le bois, & ſopez ſans effroy.	Cachez-vous dans le bois, et soppez sans effroi.
ISIMANDRE.	ISIMANDRE.
Taſche donc de voller;	Tâche donc de voler;
Florange, ſuiuez-moy.	Florange, suivez-moi.
FLORANGE.	FLORANGE.
Que deſirez-vous plus de mon ebeïſſance?	Que désirez-vous plus de mon ebeïssance?
ISIMANDRE.	ISIMANDRE.
CE ſeuret iſt trop Daui pour voſtre connoiſſance, Le vaincu doit ploper ſous lis toix du vainqueur.	CE sûret ist trop Davi pour votre connaissance, Le vaincu doit ploper sous lis toix du vainqueur.
FLORANGE bas.	FLORANGE bas.
Que n’auois-je le bras außι bon que le cœur?	Que n'avais-je le bras aussi bon que le cœur?
SCENE 21I.	SCÈNE 21I.
POLIANTE.	POLIANTE.
Ve n’es-tu le teſmoin de mon inquietude?	Ve n'es-tu le témoin de mon inquiétude?
Ie te ferois rougir de ton ingratitude?	Je te ferais rougir de ton ingratitude?
Fils ſans obëïſſance, en fant ſans amitié, A qui mes chiueux blanc, n'ont ſçeu faire pitié.	Fils sans obéissance, en fant sans amitié, À qui mes chiueux blanc, n'ont su faire pitié.
Quel exploict genereux, quelle belle aduanturs Oblige ton eſprit à chocquer la nature?	Quel exploit généreux, quelle belle aduanturs Oblige ton esprit à chocquer la nature?
Iſimandre crucl, ton dé part m’eſt ſuſpict, Le veritable amour n’eſt iamais ſans reſpect, Il s’impoſe luy-meſme vne loüable crainte.	Isimandre crucl, ton dé part m'est suspict, Le véritable amour n'est jamais sans respect, Il s'impose Roy-même une louable crainte.
Il eſtime le joug qu'il porte ſans contrainte, Et deuant qu’entreprendre vn deſſ-in qu’il aure Sans ſonger s’il luy plaiſt, il penſe s’il plaira, Toutes ſes volontez ne font rien en tumulte, L’Oracle Paternel eſt le ſeul qu’il conſulte,	Il estime le joug qu'il porte sans contrainte, Et devant qu'entreprendre un dess-in qu'il aure Sans songer s'il avait plaît, il pense s'il plaira, Toutes ses volontés ne font rien en tumulte, L'Oracle Paternel est le seul qu'il consulte,
El combat ſes deſirs ſans en eſire abatu, Et ſuit heureuſement les pas de la Vertu, Si ſon ame a des fiux la raiſon les tempere, Il penſe qu’il eſt fils & qu’il doit eſtre pere, Et touſiours l’amitié l’emportant ſur l’amour, Il rend le meſme bonneur qu'on luy doit rendre vn tour:	Elle combat ses désirs sans en esire abattu, Et suit heureusement les pas de la Vertu, Si son âme a des fiux la raison les tempère, Il pense qu'il est fils et qu'il doit chang père, Et toujours l'amitié l'emportant sur l'amour, Il rend le même bonneur qu'on lu doit rendre un tour:
Ha!	Ha!
que tu marches loing de cette houreuſe trace:	que tu marches loing de cette houreuse trace:
Ton eſprit libertin ne craint point ma diſgrace.	Ton esprit libertin ne craint point ma disgrâce.
Tu peris ſans mon congé tu vas quittant cus lieux, bans ſonger que mes pleurs ſont apperçeus des Dieux Sat Peres comme moy prendront part à l’outrage, Mais celeſtes Clements!	Tu péris sans mon congé tu vas quittant cvs lieux, bans songer que mes pleurs sont aperçus des Dieux At Pères comme moi prendront part à l'outrage, Mais célestes Cléments!
ſauuez-le du naufrage, Et ne puuiſſants point ſes deſirs mutinez.	sauvez-le du naufrage, Et ne puuissants point ses désirs mutinés.
Pardannez-luy ſa faute.	Pardannez-lui sa faute.
& me le ramenez, Que i’ay le ſens troublé que i’ay l’eſprit en guerre!	et me le ramenez, Que j'ai le sens troublé que j'ai l'esprit en guerre!
Il a de ſia touru tous les coings de la terre;	Il a de zia touru tous les coings de la terre;
Ingenieux qu’il eſt, il feint mille dangers Que trouue ce cher fils aux climats eſtrangers, le le crois voir aux mains auec vn aduerſaite.	Ingénieux qu'il est, il feint mille dangers Que trouve ce cher fils aux climats étrangers, le le crois voir aux mains avec un aversaite.
e le crois voir ſur l’Onde, & pris par vn Corſaire;	Je le crois voir sur l'Onde, et pris par un Corsaire;
le crois que ſon argent tente les Matelots, e trains comme les vents les rochers & les ſlots, Leur calmt le plus doux deſbend de la fortune, It l’inconſtante y regne auß-bien que Neptuns, e le deſcends à terre auecque mes douleurs, ẽ le vois dans vn bois attaqué des voleurs e l'appar çoy combattre au muteu u vat armes, eSrois voir ſa valeur par le nombre opprimée, Ie le vois tout ſanglant, ie le vois qui paſlit, Ie le crois poir malade & mourir daus vn lit, Abandonné tout ſeul, & priue d oſſiſtance.	le crois que son argent tente les Matelots, eût trains comme les vents les rochers et les slots, Leur calmt le plus doux débend de la fortune, It l'inconstante y règne aussi-bien que Neptuns, eût le descends à terre avec mes douleurs, endre le vois dans un bois attaqué des voleurs eût l'appar çoy combattre au muteu armes, eSrois voir sa valeur par le nombre opprimée, Ie le vois tout sanglant, ie le vois qui pâlit, Ie le crois poir malade et mourir daus lit, Abandonné tout seul, et priue ossistance.
Brefi tous les acuidens eſprouuent ma conſiance.	Brefi tous les acuidens éprouvent ma constance.
Et pour luy mon amour ſe porte en vn tel poinct, Que ie veſſens les maux que peut-eſire il n'a poent, Grands Oieux de qui lis mains tieunent nes deſtinéts Pour aſonger ſes touts cetranchez mes années, Et bornant ſon voyage ainſi que mon ennuy, Que ie meure en moy-meſme & que ie viue en luy,	Et pour notre mon amour se porte en un tel point, Que quelque vessens les maux que peut-esire il n'a poutent, Grands Oieux de qui lis mains tieunent nés destinets Pour asonger ses touts cetranchés mes années, Et bornant son voyage ainsi que mon ennui, Que deux meure en moi-même et que ie viue en même,
SCENE IV.	SCÈNE IV.
ORANTE, NERINE.	ORANTE, NERINE.
ORANIE dans le Temp le auec verine.	ORANIE dans le Temp le Seigneur vérine.
E leux il ne ſonge point au tourment qui me preſe U Pour auoir tant d’amour il a trop de pareſſe.	E leux il ne songe point au tourment qui me prese V Pour avoir tant d'amour il a trop de paresse.
Si ne me trouuant pas on ſa mir imataue Vn lieu touſiours ouueit pourra-t'il me cacher, Et ſi par ces habits on conno ſt mon enuie, Riin ins peisl-n ſouder Ce tuonneur Ce uatir.	Si ne me trouvant pas on sa mir imatave Un lieu toujours ouvit pourra-t'-il me cacher, Et si par ces habits on conn st mon envie, Riin ins peisl-n souder On tuonneur Ce ouvatir.
NERINE.	NERINE.
Ie ne ſçay que iuger de ſon retardement;	Je ne sais que juger de son retardement;
Mais qu’il manque d’amour Madame, nullement.	Mais qu'il manque d'amour Madame, nullement.
ORANTE.	ORANTE.
Quand Clindor te donna ces habiliements d'hommes Ne te marqua-t’il pas le lieu meſme vù nous ſommes.	Quand Clindor te donna ces habiliements d'hommes Ne te marqua-t-il pas le lieu même vù nous sommes.
N RINE.	 NINE.
Il me marqua le lieu, le iour & le matis.	Il me marqua le lieu, le jour et le matis.
DRANTE.	DRANTE.
Sans doute que leur faute eſt celle du DeſtinQui ialoux de mon aiſe, & l’apant reconnuë, Pour me deſeſperer em peſche leur venuë:	Sans doute que leur faute est celle du DestinQui jaloux de mon aise, et l'apant reconnue, Pour me désespérer em pêche leur venue:
Quelque obſtacle faſcheux leur deffend de venir, Mais ie n'en auray point quand ie voudray finir, Dans l’excez des mat-heurs où perſonne ne m’aide, L ay Ioupours cru ta mort vn ſoauerain remede, Qui l’a pru vne fou le prendra bien encor.	Quelque obstacle fâcheux leur défend de venir, Mais tu n'en aurai point quand ie voudray finir, Dans l'excès des mat-heurs où personne ne m'aide, L ai Ioupours cru ta mort un sognerain remède, Qui l'a pru une fou le prendra bien encor.
NERINE.	NERINE.
O Ciel!	Ô Ciel!
voicy venir le fidille Clindor.	voici venir le fidille Clindor.
CENE V .	CÈNE V .
CLINDOR, ORANTE, NERINE.	CLINDOR, ORANTE, NERINE.
CLINDOR.	CLINDOR.
vous me voyez ſeul, qu’il ne vous ſemble eſt range;	vous me voyez seul, qu'il ne vous semble est range;
Mon Maiſtre par mal-heur a tencontré Florange, Mais ſouffrez en fupant la colere d’Ormin, Cartraijtones je Jajje dart uonre chimin.	Mon Maître par malheur a tencontré Florange, Mais souffrez en fupant la colère d'Ormin, Cartraijones je Jajje dart uonre chimin.
ORANTE.	ORANTE.
Prends pitié de mon cœur, en luy faiſant connaiſtre.	Prends pitié de mon cœur, en était faisant connaître.
Si vainqueur ou blße, ie dois reuoir ton Maiſtre.	Si vainqueur ou bleue, Seigneur dois revoir ton Maître.
CLINDOR.	CLINDOR.
Et vainqueur, & bleſſé, mais fort legerement, Quel qu’vn nous ſur prendra ſauuons-nous viſtement.	Et vainqueur, et blessé, mais fort légèrement, Quel qu'un nous sur prendra sauvons-nous vite.
SCENE	SCÈNE
SCENE VI.	SCÈNE VI.
LVCINDE, PALINICE.	LUCINDE, PALINICE.
LVCINDE.	LUCINDE.
Elas de mon ſupport ie me trouue priuée;	Élas de mon supportune me trouve privée;
I TMadame c’en eſt fait, ma fille eſt enleuée:	I TMadame c'en est fait, ma fille est enlevée:
Elle n’eſt plus icy, Nerine a diſparu, En vain tout le Chaſt.	Elle n'est plus ici, Nerine a disparu, En vain tout le Chât.
au i’ay quatre fous couru, Son cabinit eſt vu de & ſa chambis eſt ouuerte, Ha, ie n’en doute plus, cela me dit ma perte, Ie ſuis au deſeſpoir, & ie perds la raiſon Souffrez-vous des voleurs dedans voſtve maiſon?	au j'ai quatre fous couru, Son cabinit est vu de et sa chambis est ouverte, Ha, je n'en doute plus, cela me dit ma perte, Je suis au désespoir, et Seigneur perds la raison Souffrez-vous des voleurs dedans vostve maison?
Suulagez ma douteur, pau qu’ele vous affige.	Suulagez ma douteur, pau qu'elle vous affige.
Vn mal eſt incurable alors qu’on le neglige.	Un mal est incurable alors qu'on le néglige.
Il eſt encore temps, faits courir aprés.	Il est encore temps, faits courir après.
PALIN CE.	PALIN CE.
nuocuurenamu pui ſi loin, nauuumumu peut prée.	nuocuurenamu puy si loin, nauvumumumu peut prée.
Le principe du mal m’en filt preuoir l’iſſuë, Ormin a fait ce coup, ou ie ſuis fort deceuë.	Le principe du mal m'en filt prévoir l'issue, Ormin a fait ce coup, ou tu suis fort déçue.
Mais allons deſcouurir la route qu’elle a pris.	Mais allons découvrir la route qu'elle a pris.
LVCINDE.	LUCINDE.
Vous redoublez encor la geſne à mes eſprits,	Vous redoublez encor la gêne à mes esprits,
SUENNE ORMIN.	SUENNE ORMIN.
VXIe	VXIe
E feu de mon courroux ſe meſle auec ma flâme, COn enleue mon Cœuν, on deſtobe mon ame, Au moins, cruel deſtin, fay voir à mis deſirs L’inuiſible ennemy qui détruit mes plaiſirs.	E feu de mon courroux se mêle avec ma flamme, COn enlève mon Cœu, on destobe mon âme, Au moins, cruel destin, fais voir à mis désirs L'invisible ennemi qui détruit mes plaisirs.
Deſcouurs-moy le Ciel où mon Soleil demeure, Que ie meure vangé puis qu’il faut que ie meure:	Descouurs-moi le Ciel où mon Soleil demeure, Que tu meure vengé puis qu'il faut que ici meure:
Et permets que ſon ſang puiſſe effacer l’affront Qui me perce le cœur & me rougit le front Mais à tort ce ſoupçon m'entre en la fantaiſie, Et ie donnt à l'amour vn trait de ialouſie:	Et permets que son sang puisse effacer l'affront Qui me perce le cœur et me rougit le front Mais à tort ce soupçon m'entre en la fantaisie, Et avoir donnt à l'amour trait de jalousie:
Sans doutt que ma fimme a fait ce beau deſſein, Mau vn coup de poignard luy va percez le ſein, Si ſa ruſe entreprend de faire l’ignorante, Elle perdra le iour, ſi ie perds mon Orante.	Sans dout que ma fimme a fait ce beau dessein, Mau un coup de poignard lui va percez le sein, Si sa ruse entreprend de faire l'ignorante, Elle perdra le jour, si tu perds mon Orante.
SCENE VIII.	SCÈNE VIII.
PLORAROE, ISIMAICDRIa	PLORAROE, ISIMAICDRIa
FLORANGE.	FLORANGE.
A fortune a trahy tout l’eſpoir que i’aucï.	À fortune a trahi tout l'espoir que j'aucai.
IS MANDRE.	IS MANDRE.
Außi vieux qu’vn rocher vous n’auez que la voix.	Aussi vieux qu'Han nocher vous n'avez que la voix.
FLORANGE Ii eſt vray, mau ſouffrez qu’elie me ſerue à pleindre.	FLORANGE Ii est vrai, mau souffrez qu'elle me serve à pleindre.
ISIMANDRE.	ISIMANDRE.
Otformau vous ny moy n'auons plus rien à craindre	Otformau vous ni moy n'avons plus rien à craindre
FLORANGE.	FLORANGE.
Le plus grand des mal-heurs enfin m’eſt aduena.	Le plus grand des malheurs enfin m'est avena.
IS MANDRE.	IS MANDRE.
Le mal dont vous parlez ne vous eſt pas connû.	Le mal dont vous parlez ne vous est pas connu.
TCORANGE.	TOCORANGE.
Que ſçauroit adiouſter la fortunt à ma peine?	Que saurait ajouter la fortunt à ma peine?
ISIMANDRE.	ISIMANDRE.
L’inéuitable fin d’vne eſperance vaine.	L'inévitable fin d'une espérance vaine.
FLORANGE.	FLORANGE.
Donnez-moy cette fin en ceutut mis iours,	Donnez-moi cette fin en cututut mis jours,
ISIMANDRE.	ISIMANDRE.
Le Fou Patεvrut mat au tque ce diſcours.	Le Fou Pat mat au que ce discours.
FLORANGE.	FLORANGE.
Et cs diſcours s’accorde auec mon aduanture,	Et cs discours s'accorde avec mon aventure,
ISIMANDRE.	ISIMANDRE.
Par luy vous renuerſez l’ordre de la Nature.	Par lui vous renversez l'ordre de la Nature.
LBORIANGE Comment l’entendez vous y expliquez ce propos:	LBORIANGE Comment l'entendez -vous y expliquez ce propos:
IS MANDRE.	IS MANDRE.
Songez que la virilleſſe a beſoin de repos.	Songez que la virillesse a besoin de repos.
FLORANGE.	FLORANGE.
L’âge dont vous parlez n’a rien qui ſoit infams:	L'âge dont vous parlez n'a rien qui soit infams:
ISIMANDRE.	ISIMANDRE.
Mais l’Amoux eſt aueugle, & la fort une eſt femme	Mais l'Amoux est aveugle, et la fort une est femme
FLORANGE.	FLORANGE.
Deſia depuis long-iemps s'en ay ſenty les coups;	Déjà depuis long-je s'en ai senti les coups;
A ISIMANDRE.	À ISIMANDRE.
Vous en verez bien toſt de prus he reux que vous.	Vous en verez bien tôt de prus hé reux que vous.
FLORANTE.	FLORANTE.
Ne pouuant l’empeſcher il fa dra m'y reſoudre;	Ne pouvant l'empêcher il fa dra m'y résoudre;
ISIMANDRE.	ISIMANDRE.
Que voſtre œil ſe prepart à voir tomber la foudre.	Que votre œil se prépart à voir tomber la foudre.
FLORAN GE.	FLORAN GE.
que ia ne meurt point d'vn to pinopmne;	que ja ne meurt point d'ins to pinopmne;
Orante vient icy;	Orante vient ici;
ISIMANDRE, Approche mon eſpoir.	ISIMANDRE, Approche mon espoir.
Vous l’auez deuiné.	Vous l'avez deviné.
Ene arſue.	Une arsue.
SCENE IX.	SCÈNE IX.
ORANTE, ISIMANDRE, FLORANGE, CLINDOR, NERINE.	ORANTE, ISIMANDRE, FLORANGE, CLINDOR, NERINE.
ORANTE.	ORANTE.
A efans Jujens ma vie;	À eans Jujens ma vie;
Noſtre heur eſt aſſez grand pour exiter l’enuie.	Notre heur est assez grand pour exiter l'envie.
ISIMANDRE montrant Forange.	ISIMANDRE montrant Forange.
Nous la tenons captiue elle eſt priſe en ces lieux;	Nous la tenons captive elle est prise en ces lieux;
ORANTE.	ORANTE.
Ha!	Ha!
chaſſez ce tantoſme il deſplaiſt à mes yeux.	chassez ce tantôme il déplaît à mes yeux.
FLORANGE bas.	FLORANGE bas.
Que par l’ombre du bien l’amt eſt ſouuent trompét:	Que par l'ombre du bien l'amt est souvent trompét:
ISIMANDRE.	ISIMANDRE.
Allez, retirez-vous, reprenez voſtre eſpée, Et ſur vos paßions ayez plus de pouuoir.	Allez, retirez-vous, reprenez votre épée, Et sur vos passions ayez plus de pouvoir.
FLORANGE s’en allant.	FLORANGE s'en allant.
Ie meurs de voir Orante, & de ne la plus voir.	Je meurs de voir Orante, et de ne la plus voir.
ISIMANDRE.	ISIMANDRE.
Icy la diligence eſt bien fort neceſſaire, Ce vieux monſtre amoureux, ce debile aduerſairs, Va chercher du ſecours, & nous ſerons ſuiuis, Si-toſt que de ma route on aura quelque aduis.	Ici la diligence est bien fort nécessaire, Ce vieux monstre amoureux, ce débile aversairs, Va chercher du secours, et nous serons suivis, Sitôt que de ma route on aura quelque avis.
Clindor, volle diuant & forme vne chimere, Qui puiſſe trouuer place en l’eſprit de mon pert, Dis-luy qu’ayant quitté le logis paternel, Ie me ſuis repentr de me voir criminel, Et que par mes douleurs iugeant de ſa ſouffrance, I’ay rompu le deſſein d’vn voyage de France.	Clindor, volle divant et forme un chimère, Qui puisse trouver place en l'esprit de mon pert, Dis-lui qu'ayant quitté le logis paternel, Je me suis repentr de me voir criminel, Et que par mes douleurs jugeant de sa souffrance, J'ai rompu le dessein d'un voyage de France.
Dis-luy que deux Guerriers m’ont tiré da danger, Où mettent les volleurs l’vn & l’autre eſtranger, Du-luy quegie les meine, & qu’il faſſe conneſtre, En les bien receuant, la grandeur de mon eſtre, La bleſſure que i’ay prouuera ton diſcours, Mais les meilleurs conſeils ſont icy les plus courts, Donne viſte vn cheual, que i’enleue ma proye, Elle vaut mieux qu’Helene & Naples moĩs que Troyt Et premier que ie rende vn bien que i’ay vollé, Bruſle comme mon cœur mon païs deſolé.	Dis-lui que deux Guerriers m'ont tiré da danger, Où mettent les volleurs l'un et l'autre étranger, Du-lui quegie les mène, et qu'il fasse connaître, En les bien recevant, la grandeur de mon soins, La blessure que j'ai prouvera ton discours, Mais les meilleurs conseils sont ici les plus courts, Donne vite un cheval, que j'enlève ma proie, Elle vaut mieux qu'Helene et Naples mods que Tro Et premier que ie rende pr bien que j'ai vollé, Brusle comme mon cœur mon païs desolé .
SCENE X.	SCÈNE X.
ORMIN, PALINICE;	ORMIN, PALINICE;
LVCINDE, LERISTE.	LUCINDE, LERISTE.
ORMIN.	ORMIN.
A belle inuention!	À belle invention!
ô Dieux qu’elle eſt ſubtils!	ô Dieux qu'elle est subtils!
TALINICE.	TALINICE.
Mon ſonge bien penſé!	Mon songe bien pensé!
mais pourtant inutile.	mais pourtant inutile.
ORMIN.	ORMIN.
Teu fiours voſtre chagrin ſe plaiſt à me faſcher.	Teu fjours votre chagrin se plaît à me fâcher.
PALINICE.	PALINICE.
Otuuiop umtonuuuo que jeit de la cachir.	Otuop umtonuo que jeit de la cachir.
ORMIN.	ORMIN.
naun ejpn aſige n'inent point raillerse.	naun éjpn asige n'inent point raillerse.
PALINICE.	PALINICE.
Ep-ellé au cabintt ou dans la gallerie?	Epellé au cabint ou dans la gallérie?
ORMIN.	ORMIN.
Vous qui la retenez pouuez m’en eſclaireir:	Vous qui la retenez pouvez m'en éclaireir:
a vaulnvrec.	a vauleuvrec.
Vn deſſein deſcouuert ne ſçauroit reüßir.	Un dessein découvert ne saurait réussir.
ONMIN.	ONMIN.
Vous me croyez aueugle & i’ay fort bonne veuët	Vous me croyez aveugle et j'ai fort bonne vêt
PALINICE.	PALINICE.
Ie ne m’eſtonne point ſa perte eſtoit prentuë!	Je ne m'étonne point sa perte était prentue!
ORMIN.	ORMIN.
Voſtre ruſe paroiſt plus claire que le iour.	Votre ruse paraît plus claire que le jour.
PALINICE.	PALINICE.
Voſtre haine deſcouure, & fait voir voſtre amour.	Votre haine découvre, et fait voir votre amour.
ORMIN 77 Liſiouart mon amour:	ORMIN 77 Lisiouart mon amour:
pour que:	pour que:
pour ma parente;	pour ma parente;
PALINICE.	PALINICE.
Vous n’aimez pas le ſang, mais la brauté d’Orante	Vous n'aimez pas le sang, mais la brauté d'Orante
ORMIN.	ORMIN.
Et bien;	Et bien;
ſoit;	soit;
il eſt vray:	il est vrai:
mai ie la veux auoir.	mai ici la veux avoir.
A llelrreſ.	À llelrres.
Puus qu’ille eſt en tes mains, perfide, va la voir.	Puus qu'ille est en tes mains, perfide, va la voir.
ORMIN.	ORMIN.
Ha!	Ha!
ne conteſtez plus, rendez-la moy, vous dis-ie?	ne contestez plus, rendez-la moi, vous dis-je?
il la veut frapper d’vn poignard.	il la veut frapper d'une poignard.
Quoy!	Quoi!
vous n’en ferez rien?	vous n'en ferez rien?
Lleln u da O bons Dieux quel prodige, Page, ſecourez-moy, ie ne le puis tenir:	Lleln u , Ô bons Dieux quel prodige, Page, secourez-moi, toujours ne le puis tenir:
PALINICE.	PALINICE.
Ciel!	Ciel!
peux-tu voir ſon crimt & ne le pas punir?	peux-tu voir son crimt et ne le pas punir?
a u la d E lo FLORANGE, LVCINDE, ORMIN, PALINICE, LERISTE.	a la a E lo FLORANGE, LUCINDE, ORMIN, PALINICE, LERISTE.
TColellltoc.	TColellltoc.
I vous cherchez Orante, elle n'eſt plus à Piſe, DEt ſes charmes ont pris vn Amant qui la priſe, Ifimandre l’ameine aprés m’auoir vaincu.	I vous cherchez Orante, elle n'est plus à Pise, DEt ses charmes ont pris un Amant qui la prise, Ifimandre l'amène après m'avoir vaincu.
LVCINDE.	LUCINDE.
Pour auoir moins de maux, que n’ay-je moins reſca.	Pour avoir moins de maux, que n'ai-je moins réca.
ORMIN.	ORMIN.
Reſoluons nous mon cœur, ma perte eſt aſſeurée;	Résoluons -nous mon cœur, ma perte est assurée;
Orante la precure & le Ciel l’a iurée;	Orante la précure et le Ciel l'a jurée;
Vn autre la poſſide!	Un autre la posside!
ô penſer aſſaßin!	ô penser assassin!
Iamais voleur ne ſit vn ſi riche laruin.	Jamais voleur ne sit un si riche laruin.
Bie-heureux Iſimandre, en ceit, douce guerre, Tu pilles les threſors du Ciel & de la Terre;	Bie-heureux Isimandre, en ceit, douce guerre, Tu pilles les trésors du Ciel et de la Terre;
Ce fameux conquerant, qu’on a fait immortel, Prit l’Vniuers entier, & ne prit rien de tel.	Ce fameux conquérant, qu'on a fait immortel, Prit l'Univers entier, et ne prit rien de tel.
Mais quand Naples ſeroit en ces plages deſertes, Qui par les Matelots ne ſont pas deſcouuertes:	Mais quand Naples serait en ces plages désertes, Qui par les Matelots ne sont pas découvertes:
Quand tu la cacherois en ces lieux retirez, Que les rayons du iour n’ont iamaus eſclairez:	Quand tu la cacherais en ces lieux retirés, Que les rayons du jour n'ont jamaus éclairez:
Quand tu te logerois au milieu d’vne armée.	Quand tu te logerais au milieu d'une armée.
Quanu tu uiſparoiprou tomme vn corps de fumée:	Quanu tu uisparoiprou tomme un corps de fumée:
Quand tu pourrois voller, perfide aſſeure-toy, Que tu me la tendrou.	Quand tu pourrais voler, perfide assure-toi, Que tu me la tendrou.
Leriſte ſututz-moy.	Lériste sutz-moi.
LVCINDE.	LUCINDE.
Et combien d’accidents chocquent noſtre famille!	Et combien d'accidents chocquent notre famille!
Les plus grands ennemis ſont aimez de ma fille, Mais i’iray la trouuer pour en auoir raiſon, Deuſt mon païs natal deuenir ma priſon.	Les plus grands ennemis sont aimés de ma fille, Mais j'irai la trouver pour en avoir raison, Deut mon pays natal devenir ma prison.
PACINICE.	PACINICE.
Souffrez en ce deſſein que ie vous accompagne, Car ſans doute qu’Ormin ſe va mottre en campagne, Mon intireſt au voſtre icr ſe m ſlera.	Souffrez en ce dessein que je vous accompagne, Car sans doute qu'Ormin se va mottre en campagne, Mon intirest au vôtre icr se m êlera.
LVCINDE.	LUCINDE.
Peurueu que nous partions, tout ce qu’il vous plaira.	Pourvu que nous partions, tout ce qu'il vous plaira.
FLORANGE.	FLORANGE.
FLORANGE.	FLORANGE.
Comme i’auois des feux il auoit de la flame:	Comme j'avais des feux il avait de la flamme:
L’excez de ma douleur m’a fait lire en ſon ame:	L'excès de ma douleur m'a fait lire en son âme:
Et comme ſon eſprit adoroit mon vainqueur, Il n’a pû retenir les ſent mens du cœur.	Et comme son esprit adorait mon vainqueur, Il n'a pu retenir les sent mens du cœur.
Sa raiſon a perdu ſon ordinaire vſage;	Sa raison a perdu son ordinaire usage;
Sa fole paſſion s’eſi painte en ſon viſage;	Sa sole passion s'esi painte en son visage;
32 Ses ſouſpirs ont fait voir en meſme timps au iour, Le feux de la colere, & celuy de l’amour.	32 Ses soupirs ont fait voir en même timps au jour, Le feux de la colère, et celui de l'amour.
L’v.	L'une.
& l’autre eſclatoit;	et l'autre éclatait;
l’vn & l’autre viſible, Me l’ont fait veconnoiſtri, amoureux & ſenſible.	l'autre et l'autre visible, Me l'ont fait veconnoistri, amoureux et sensible.
Et i’ay veu par les pleurs que reſpandoient ſes yeux, Qu’il perdoit comme moy.	Et j'ai vu par les pleurs que répandaient ses yeux, Qu'il perdait comme moi.
cequ’il aimoit le mieux.	cequ'il aimait le mieux.
Ouy i’ay veu clairement quelle eſt ſa maladie:	Oui j'ai vu clairement quelle est sa maladie:
L’amour qu'il a pour elle, a fait ſa perfidie;	L'amour qu'il a pour elle, a fait sa perfidie;
Le traiſtre a fait mon mal pour eſtablir ſon bien, Et rompu mon deſſein pour acheuer le ſien, Ce coup eſt ſans semede, & moy ſans allegeance, Si ie ne la rencontre aueique la vangeance, Ouy, vangeons-nous mon cœur des outrages ſouffeits, Afin de t’exciter, voy le bien que eu perds, Figure-toy les traicts de la beauté d’Oranté, Songe que le perfide a trompé ton attente, Qu'aprés t’auoir promis il t’a manqué de foy, Ie rariſſant vn bien qu’il reſeruoit pour toy, Voudrois-ru le ſouſſrir, veſponds à ma demande, Non non qu’il ſoit puny puis qu’amour le commande, Vangeant la foy rompuë, & qu’il eus à meſpris.	Le traître a fait mon mal pour établir son bien, Et rompu mon dessein pour achever le sien, Ce coup est sans seme, et moi sans allégeance, Si tu ne la rencontre aurique la vengeance, Oui, vengeons-nous mon cœur des outrages souffits, Afin de t'exciter, vois le bien que eu perds, Figure-toi les traits de la beauté d'Oranté, Songe que le perfide a trompé ton attente, Qu'aprés t'avoir promis il t'a manqué de foi, Je rarissant un bien qu'il réservait pour toi, Voudrais-ru le nir, vesponds ma demande, Non non il soit puni puis amour le commande, Vangeant la nô rompuë, et quil eus mépris.
Os'il n'ait peint de retour au voyage enerepris.	Os'il n'ait peint de retour au voyage enerepris.
Suiuons, ſuiuons ſes pai & loing de la patrie, Faiſons agir la force auecque l'inauſtrie, Deux BRAVES employez ſeconderons mes coups, Ce ſont là des exploits qui ſont dignes de nous, Aux combats inégaux la victoire eſt certaine.	Suivons, suivons ses pai et loin de la patrie, Faisons agir la force avec l'inaustrie, Deux BRAVES employez seconderons mes coups, Ce sont là des exploits qui sont dignes de nous, Aux combats égaux la victoire est certaine.
Quand on veut rompre en lice, ou courre à la quincaine, L’egalité ſied bien, car elle eſt ſans danger, Ie ne veux point mourir is cherche à me vanger, Ie veux choiſir le temps & le moyen propice, Ie veux qu’il tombe ſeul dedans le precipice, Ie veux qu’aprés ſa perte en perdant les teſmoins, Ie ſois celuy de tous qu’on en ſoupçonne moins, Ha!	Quand on veut rompre en lice, ou courre à la quincaine, L'égalité sied bien, car elle est sans danger, Je ne veux point mourir is cherche à me venger, Je veux choisir le temps et le moyen propice, Ie veux il tombe seul dedans le précipice, Je veux qu'après sa perte en perdant les témoins, Je sois celui de tous qu'on en soupçonne moins, Ha!
ie nage deſia dans leſang du perfide, I'obtïs au courroux, ie n’en tiens plus la bride, Il m’emporte, il m’entraiſne, il me force à courir, Ie te ſuy, ie te titus, Ormin, il faut mourir.	Elle nage déjà dans lesang du perfide, J'obtis au courroux, toujours n'en tiens plus la bride, Il m'emporte, il m'entraîne, il me force à courir, Je te suis, tu te titus, Ormin, il faut mourir.
lit.	lit.
53 Simandre, Orante trompée,  Oblige Ormin à te punir;	53 Simandre, Orante trompée, Oblige Ormin à te punir;
Ie t’attends auet vnc erpee, Souuiens-toy que tu dois venir.	Je t'attends avet unc erpée, Souviens-toi que tu dois venir.
4 A l i ENTE PREMIERE.	4 A l ' OPTE PREMIÈRE.
IIMANDRE, LERISTE.	IIMANDRE, LERISTE.
IS!	IS!
MANDRE.	MANDRE.
CARTEL.	CARTEL.
Si tu ſatisfaits mon enuie, Autre que moy ne te nuira, Viens m’oſter, ou perdre la vie.	Si tu satisfaits mon envie, Autre que moi ne te nuira, Viens m'ôter, ou perdre la vie.
Ou ce rage te conduira.	Ou ce rage te conduira.
Dures extremitez où le deſtin m'engage:	Dures extrémités où le destin m'engage:
Amour oſte le cœur, & non pas le courag:	Amour ôte le cœur, et non pas le courag:
Si ie fais ce combat, ie hazarde mon heur Et i’en ſerois indigne en viuant ſans honneur, Ha!	Si personne fais ce combat, ie hasarde mon heur Et j'en serais indigne en vivant sans honneur, Ha!
mon affliction n’a rien qui la conſole, Où me dou-tu moner?	mon affliction n'a rien qui la console, Où me dou-tu moner?
LERISTE.	LERISTE.
Da tope de rouxzote, Mais ſans vous deſigner expreſſément le lieu, Ie vous y conduiray.	Da tope de rouxzote, Mais sans vous désigner expressément le lieu, Je vous y conduirai.
ISIMANDRE.	ISIMANDRE.
Ie le veux bien;	Je le veux bien;
adieu.	adieu.
Separons nous, ie crains que mon pere ne forte, Ie te ſuy pas à pas, va m’attendre à la porte, Touſiours l’homme eſt ſujet aux caprices du ſert, Et ſon premier repos eſt celuy de la mort, Si tu dounes ta vie au dangez qui la preſſe, Amant infortuné que fera ta Maïſtreſſe?	Séparons nous, Seigneur crains que mon père ne forte, Je te suis pas à pas, va m'attendre à la porte, Toujours l'homme est sujet aux caprices du sert, Et son premier repos est celui de la mort, Si tu dounes ta vie au dangez qui la presse, Amant infortuné que fera ta Maîtresse?
Quoy!	Quoi!
la veux-tu laiſſer ſous vn habit trompeur?	la veux-tu laisser sous un habit trompeur?
Ne mourra-t’elle pas?	Ne mourra-t-elle pas?
n’en as tu point de peur;	n'en as tu point de peur;
Veux-tu que ſans ſupport elle ſoit vagabonde, L’opprobre le meſpris, & la fable du monde?	Veux-tu que sans support elle soit vagabonde, L'opprobre le mépris, et la fable du monde?
O dangereux voiſins temeraires Gaulois Dont lis meuuaiſes mœurs ont perueriy nos leis,	Ô dangereux voisins téméraires Gaulais Dont lis mauvaises mœurs ont perveri nos leis,
Que par vous mon eſprit ſouffre vns peine amire, Suiuant ce point d'honneu qui n’eſt qu’vne chimere, Il le faut cependant, le deſtin l’a voula, Mon honneur le commarde & i’y ſuis reſolu, Ha!	Que par vous mon esprit souffre uns peine amire, Suivant ce point d'honnu qui n'est qu'une chimère, Il le faut cependant, le destin l'a voula, Mon honneur le commarde et j'y suis résolu, Ha!
voicy mon Orante, & mon ame contrainte, Aura peine à cacher ſa douleur & ſa crainte;	voici mon Orante, et mon âme contrainte, Aura peine à cacher sa douleur et sa crainte;
Mais ie luy veux donner vn conſeil au beſoin, Afin ſi is perus que quelqu’vn en ait ſoin, Veux-tu pas te reſoudre à parler à mon pere, Tu ſçaus bien comme vn cœur ſouffre quand il eſpere, Le danger nous tallonne.	Mais grande femme veux donner un conseil au besoin, Afin si is perus que quelqu'un en ait soin, Veux-tu pas te résoudre à parler à mon père, Tu sçaus bien comme un cœur souffre quand il espère, Le danger nous tallonne.
& le mal va croiſſant, Fais agir ſur le ſien ton eſprit tout puiſſant, Force-le par raiſon, flechis-le par des larmis, Vne ame de rocher cederoit à ces aimes, Fay combattre pour toy l’amour & la pitié, Et fay-luy voir qu’Orante a pris ſon amitié.	et le mal va croissant, Fais agir sur le sien ton esprit tout -puissant, Force-le par raison, fléchis-le par des larmis, âme de rocher céderait à ces aimes, Fay combattre pour toi l'amour et la pitié, Et fais-lui voir qu'Orante a pris son amitié.
Quitte cette pudeur, elle nous eſt contraire, Reſſuſcite I ſimandre, & fais mourir ſon frere, Que ce nom deſormais Joit banny d’entre nous:	Quitte cette pudeur, elle nous est contraire, Ressuscite I simandre, et fais mourir son frère, Que ce nom désormais Joit banni d'entre nous:
Veux-iu pour l’obtenir que ie ſois à genoux?	Veux-ju pour l'obtenir que Il sois à genoux?
SCENE II.	SCÈNE II.
ORANIE, ISIMANDRE,	ORANIE, ISIMANDRE,
ORANTE.	ORANTE.
NRuel, que ne fais-tu ce que ta voix m’ordonne?	NRuel, que ne fais-tu ce que ta voix m'ordonne?
ISIMANDRE.	ISIMANDRE.
Le Ciel m’a refusé les graces qu’il te donne, Et mon diſcours n'a point l'art de perſuader, Hilas!	Le Ciel m'a refusé les grâces qu'il te donne, Et mon discours n'a point l'art de persuader, Hilas!
ie le vois bien ta ne veux pas m’aider,	ie Le vois bien ta ne veux pas m'aider,
ORANTE.	ORANTE.
Charmeur, tes velontez ſont touſiours ſouueraines, malo ciumoist fuinmey ta quattte uv Neines.	Charmeur, tes velontés sont toujours souveraines, malo ciumoist fuminme ta quatte uv Neines.
ISMANDRE.	ISMANDRE.
L’eſpreuue en fera foy, le voicy, tu le vois,	L'épreuve en fera foi, le voici, tu le vois,
il dit ce vers bas.	il dit ce vers bas.
Adieu;	Adieu;
peut-eſtre a lieu, pour la derniere fois.	peut-être a lieu, pour la dernière fois.
SCENE III.	SCÈNE III.
POLIANTE, ORANIE.	POLIANTE, ORANIE.
POLIANTE.	POLIANTE.
Equoy s’entretenoit le braue Cleomire?	Equoi s'entretenait le brave Clomire?
ORANTE.	ORANTE.
Des vertus d’vn Seigneur que tout le monde admire;	Des vertus d'un Seigneur que tout le monde admire;
De ce fils que le Ciel accomplit de tout point;	De ce fils que le Ciel accomplit de tout point;
Et certes ce penſer ne m’abandonne point.	Et certes ce penser ne m'abandonne point.
POLIANTE.	POLIANTE.
L’amitié vous deçoit ainſi qu'elle m'abuſe, Les d ffauts d’vn amy ne manquent pas d’extuſe;	L'amitié vous deçoit ainsi qu'elle m'abuse, Les sauts d'un ami ne manquent pas d'extuse;
L’œil flatte ce qu’il aime & mon fils n’eſt parfait, Dõſirant vous ſeruir qu’au vœu qu’il en a fait	L'œil flatte ce qu'il aime et mon fils n'est parfait, Dõsirant vous servir qu'au vœu qu'il en a fait
ORANTE.	ORANTE.
Dn ne ſçauroit cacher vne ſi belle vie, Qui fais parler l'hiſtoire, & fait taire l’enuie.	Den ne saurait cacher une si belle vie, Qui fais parler l'histoire, et fait taire l'envie.
mais comme ſa valeur dés ſes plus iegnis ans, A mis la poudre aux yeux à tous les Courtiſans, Et que ſuiuant vos pas aux dangers de l’armée, Dl a pris ponne part à voſtre renommée.	mais comme sa valeur dès ses plus Ognis ans, A mis la poudre aux yeux à tous les Courtisans, Et que suivant vos pas aux dangers de l'armée, Dl a pris ponne part à votre renommée.
Vous deuriz deſormais l’arreſter en cis lieux, Fanpez que la fortune eſt vn monſtre ſans yeux, Ls qu’elle peut frapey ceux qu’elle fauoriſe, Huscnuns-luj dis ueſns qie te vopte autnonſe, æpon que l’arreſtant comme il eſt à propos, Les derniers de vos touts ſe coulent en ripos.	Vous devris désormais l'arrêter en cis lieux, Fanpez que la fortune est un monstre sans yeux, Lis qu'elle peut frappei ceux qu'elle favorise, Huscuns-luj dis uesns qie te vopte autnonse, æpon que l'arrêtant comme il est à propos, Les derniers de vos touts se coulent en ripos.
POLIANTE.	POLIANTE.
Ce que vous propoſez eſt le but où i’aſpire, C eſt vn bien queietmmro por prie ſouſpire, Mais ie ne trouue point où borner ce deſir.	Ce que vous proposez est le but où j'aspire, C' est un bien queiétmro por prie soupire, Mais ie ne trouve point où borner ce désir.
ORANTE.	ORANTE.
Pent-eſtre eu cét bymen voulez-vous trop choiſir.	Pent-être eu cet bymen voulez-vous trop choisir.
POLIANTE.	POLIANTE.
Nallemint:	Nallemint:
mon eſprit n’a point cette foibleſſe, reuruen que la vertu ſe ioigne à la Nobleſſe, e foray ſatu fait ie ne cherche point l’or, Lus qualιtεz chez moy tiendront lieu de threſor.	mon esprit n'a point cette faiblesse, reurven que la vertu se joigne à la Noblesse, est forai satu fait assez ne cherche point l'or, Lus qualιtεz chez moi tiendront lieu de trésor.
ORANTE.	ORANTE.
εκως ομlἰιιz vn peint d’vne importance extréme,	εκως ομlἰιιz un peint d'une importance extrême,
Quel?	Quel?
POLIANTE.	POLIANTE.
ORANTE.	ORANTE.
Qu'il aime vne fille, & qu’vne fille l’aime.	Qu'il aime une fille, et qu'une fille l'aime.
POLIANTE.	POLIANTE.
Ie ne l’oubliris pas i’y ſuis trep diſpeſí;	Je ne l'oublieris pas j'y suis tre dispes;
Mais eſtant neceſſaire, il eſt preſupposé.	Mais étant nécessaire, il est presupposé.
Ces marchez d’inttreſt ſont des maux qu’on doil, craindre;	Ces marchés d'inttrest sont des maux qu'on doil, craindre;
Et i’aime trop mon fils pour le voullois contraind ra, Außi loin d’y ſongez, ie blaſuit ſes parents, Qui peres comme moy diuimnneni dis tuans.	Et j'aime trop mon fils pour le voullais contraind ra, Aussi loin d'y songez, toujours blasuit ses parents, Qui pères comme moi divimneni dis tuants.
ORANTE.	ORANTE.
dejl aa tum asamn vni jea Jianse.	déjl a tum asamn uni jea Jianse.
Honneſle noble, riches & qui peus eſt, dimóe, I conſentiriez-vous?	Honnêle noble, riches et qui pus est, dimée, I consentiriez-vous?
POLIANTE.	POLIANTE.
N’en doutez nullemeur Mais Naples n’en a point, ſeion monti alqienc, Et ſi vous le ſçauez, mon ame eſt iguorante.	N'en doutez nullemeur Mais Naples n'en a point, seion monty alqienc, Et si vous le savez, mon âme est iguorante.
ORANTE.	ORANTE.
Iugez ſi ie me trompe en vous vomment Orant?	Jugez si belle me trompe en vous vomment Orant?
POLIANTE.	POLIANTE.
Orante, à ce qu’on dit, a ces trois qualitez, Mais on ne peut finir ce que vous proiettez, La haine heriditaire (execrable folie.	Orante, à ce qu'on dit, a ces trois qualités, Mais on ne peut finir ce que vous proyettez, La hé riditaire (exécrable folie.
Qui ſemble eſtre fatale à toute l’Italie) Bien que contre mon ſeus & tontre la raiſos.	Qui semble être fatale à toute l'Italie) Bien que contre mon zeus et tontre la raisos.
A touſiours diuisé les fiens & ma maiſon, Et it ne puis penſer, comme ſans la connaiſtre,	À toujours divisé les siens et ma maison, Et it ne puis penser, comme sans la connaître,
ORANTE, C uinour uont vois pantez auevil tamau pu naiſtré.	ORANTE, Ç uinour uont vois pantez auevil tamau pu naistré.
ORANTE.	ORANTE.
II eſt né cependant, & s’eſt bien rendu tel, Que d’vne part & d’aαite il doit eſtre immortel, Les haiues dis parents ſont de foibles obſtacles, Et l'Amour eſt vn Dëtu qui ſe plaiſt aux miracles, Cette vieille querelle a deſia trop duré.	II est né cependant, et s'est bien rendu tel, Que d'une part et d'aite il doit être immortel, Les haives dis parents sont de faibles obstacles, Et l'Amour est un Déestu qui se plaît aux miracles, Cette vieille querelle a déjà trop duré.
ille déplaiſt aa Ciel, ſoyez en aſieuté:	ille déplaît aa Ciel, soyez en asieuté:
l n’aſſemble les tœurs d’vn fils & d’vne fille, Que pour mettre en repos l’vue & l’autre famille, Mais pourtant leurs eſprits qui ſçauent leus deuoir, Rangent leurs volontez deſſaus voſtre poauoir.	 l'assemble les tœurs d'un fils et d'une fille, Que pour mettre en repos l'une et l'autre famille, Mais pourtant leurs esprits qui savent lus devoir, Rangent leurs volontés dessaus votre pavoir.
Tous preſts de ſe priuer de iour qui les eſclaire.	Tous prêts de se priver de jour qui les éclaire.
Pluſtoſt que d’acheuer rien qui vous pût déplaire.	Plutôt que d'achever rien qui vous pût déplaire.
POLIANTE.	POLIANTE.
Pardonnez, Cleomire à mon eſtonnement, Mon eſprit penſe faire vn beoa ſonge en dormant, Ce que vous m’apprenez eſt ſi plein de merueille, Que meſme en vous parlant ie doute ſi ie veille, Que ce penſer profond ne vous ſoit pas ſeſpect, ’eſtime cét amour autaut que ſon reſpect.	Pardonnez, Clomire à mon étonnement, Mon esprit pense faire un beoa songe en dormant, Ce que vous m'apprenez est si plein de merveille, Que même en vous parlant ie doute si je veille, Que ce penser profond ne vous soit pas sespect, 'estime cet amour autaut que son respect.
Et pour voir amomnd buy jes peints teimmées, Ma volonté ſaiura cille des deſtinéts Duy dites à ce fils qui vous a fait parles, Que i’approuue le feu dont il oſa bruſler.	Et pour voir amomnd bui jes peints teimmées, Ma volonté saisura cille des destinets Dui dites à ce fils qui vous a fait parles, Que j'approuve le feu dont il osa brûler.
ORANTE.	ORANTE.
Ha' formez quelques pas que i’en baiſe les traces, 4ußi-bien que te fils ie vois dοn renare gracts, C'eſt moy qui ſais.	Ha formez quelques pas que j'en baise les traces, 4ussi-bien que te fils ie vois dîn renare grâces, C'est moi qui sais.
qui ſes.	qui ses.
SCENE IV.	SCÈNE IV.
CLINDOR, POLIANTE, ORANTE.	CLINDOR, POLIANTE, ORANTE.
CLINDOR.	CLINDOR.
It viens vous aduertir, Que mon Maiprt a quirele, & qu’on l’a veu ſortir, Auec ſa longue eſpét, & ſans nul tquipage;	It viens vous avertir, Que mon Maiprt à quirele, et qu'on l'a vu sortir, Avec sa longue espêt, et sans nul typage;
POLIANTE.	POLIANTE.
Quelqu’vn le conduit-il?	Quelqu'un le conduit-il?
CLINDOR.	CLINDOR.
ouy Monſ-igneur, vn Page, De liurée inconnuë, & qui nous fait iuger, Que tiuey qui b'enuoye eſt ſans doute Eſtranger.	oui Oui-onigneur, un Page, De livrée inconnue, et qui nous fait juger, Que tivei qui b'envoie est sans doute Étranger.
ORANTE:	ORANTE:
Quelles ſont ſes couleurs?	Quelles sont ses couleurs?
CLINDOR.	CLINDOR.
Si mon œil ne s’abuſe, Incarnat, blanc, & verd:	Si mon œil ne s'abuse, Incarnat, blanc, et verd:
ORANTE Das.	ORANTE Das.
Dieux que ie ſuis confuſe!	Dieux que ie suis confuse!
POLIANTE.	POLIANTE.
Que ne le ſuiuiez vous?	Que ne le suiviez -vous?
CLINDOR.	CLINDOR.
En vain ie l’ay taſché;	En vain ici l'ai tâché;
Et contre mon deuoir il a paru faſché.	Et contre mon devoir il a paru fâché.
POLIANTE.	POLIANTE.
viſte, viſte, à cheual, qu’on baute la campagne,	vite, vite, à cheval, qu'on baute la campagne,
ORANTE, Empéſebons er auts.	ORANTE, Empésebons er auts.
ORANTE.	ORANTE.
Quel mal-heur m'acompagne!	Quel malheur m'acompagne!
Sans doute c’eſt Ormin, car ce Page eſt à luy.	Sans doute c'est Ormin, car ce Page est à lui.
Reprenons nos habits, il eſt temps auieura buy;	Reprenons nos habits, il est temps auieura bui;
Afin que ſi du ſort les loix me ſont fatales, Ie les puiſſe changer en celuy des Veſtales:	Afin que si du sort les lois me sont fatales, Je les puisse changer en celui des Vestales:
C’eſt vn port aſſuré qui s’offre à ma douleur:	C'est un port assuré qui s'offre à ma douleur:
Mes feux ſont eternels außi-bien que le leur.	Mes feux sont éternels aussi-bien que le leur.
SCENE V.	SCÈNE V.
ORMIN.	ORMIN.
’Eſt icy que ma main ſe va remplir ds gloire;	’Est icy que ma main se va remplir ds gloire;
CC’eſt icy qu’on verra le champ de ma victoire;	CC'est ici qu'on verra le champ de ma victoire;
Icr i’effaceray la marque d’vn affrous.	Icr j'effacerai la marque d'il affrous.
Par la rougeur du ſang o ſtant cello du front.	Par la rougeur du sang ô stant cello du front.
Le terrain eſt fort bons dans l'ardeuν qui me preſle, Que n’auous nous au moins entre nous la Maiſtreſſe;	Le terrain est fort bons dans l'ardeu des me presle, Que n'avous nous au moins entre nous la Maîtresse;
Pour la faire reſter commo vn prix amoureux, Non pas au plus ruſe, mais au plas genereux.	Pour la faire rester commo un prix amoureux, Non pas au plus ruse, mais au plas généreux.
Afin que le peril plus aiſement i’eſclate, Dois-ie porter en tierce?	Afin que le péril plus aisément j'éclate, Dois-je porter en tierce?
ou bian plus toſt en quarts?	ou bian plu tôt en quarts?
Non par vn autré coup, ie prepare ſa mort, Ie paſſeray ſur luy, car ie ſuu aſſez fort.	Non par un autré coup, une prépare sa mort, Je passerai sur lui, car ie suiv assez fort.
SCENE V I.	SCÈNE V I.
FLORANGE, ARGAMOR.	FLORANGE, ARGAMOR.
GERTIMANT;	GERTIMANT;
ORMIN,	ORMIN,
FLORANGE.	FLORANGE.
Ain baſſe, Compagnons.	Ain basse, Compagnons.
ONMIN Que faites-vous Florange.	ONMIN Que faites-vous Florange.
FLORANGE.	FLORANGE.
L jau ce que ie dois;	 Lau ce que vertu dois;
ie punis, ie me vange.	Elle punis, Seigneur me venge.
ORMIN.	ORMIN.
Oubliez-vous l’honneus?	Oubliez-vous l'honnus?
FLORANGE.	FLORANGE.
Ie le troaut à punir, Vn qui donne ſa fop pour ne ia pas tenit.	Je le troaut à punir, Un qui donne sa fop pour ne ja pas tenit.
SCENE VII.	SCÈNE VII.
ISIMANDRE, LERISTE, GERTIMANT, ARGAMOR, FLORANGE, ORMIN.	ISIMANDRE, LERISTE, GERTIMANT, ARGAMOR, FLORANGE, ORMIN.
IS MANDRE.	IS MANDRE.
Entends vn bruit d’eſpée aduançont;	Entends un bruit d'épée aduançont;
L LERISTE Ha!	 LERISTE Ha!
le traiſtre, Florange, Monſei gneur aſſaßine mon Maiſtre.	le traître, Florange, Monsei gneur assassine mon Maître.
SIMANDRE.	SIMANDRE.
Ie ne ſçaurois ſouffrir ce complot inhumain, Ls Ciel te deſtinoit à mourir de ma main;	Je ne saurais souffrir ce complot inhumain, Ls Ciel te destinait à mourir de ma main;
vu ſeconue rentontre atntue la premiere:	vu seconue rentontre atntue la première:
Frjons, ARCAMOR.	Frons, ARCAMOR.
FLORANGE Ie perds l’eſpoir, auecque la lumiere.	FLORANGE Je perds l'espoir, auecque la lumière.
ISIMANDRE.	ISIMANDRE.
Le ſort pour m’obliger, en ce iour a permis.	Le sort pour m'obliger, en ce jour a permis.
Qu’vn ennemy pour vous tombat vos ennemis;	Qu'un ennemi pour vous tombât vos ennemis;
Afin que l’honneur ſauf, ſa voix vous faſſe entendre Qu'amour & la raiſon ont conduit ſimandre, Ie ſuu ce mal-heureux que vous aliez cherchant, Vous le voyez Seldat, & l’auez veu Marchand.	Afin que l'honneur sauf, sa voix vous fasse entendre Qu'amour et la raison ont conduit simandre, Je su ce malheureux que vous aliez cherchant, Vous le voyez Seldat, et l'avez vu Marchand.
ORMIN.	ORMIN.
Pour vn cœur genereux les bien-faits ont des charmes Et vous me deſarmez en conſeruant mes armes.	Pour un cœur généreux les bienfaits ont des charmes Et vous me désarmés en conservant mes armes.
Vous venez de me vaincre en me rendant vainqueur, Au lieu d’en teſmoigner ie manquerois de cœur, Si ie vous diſputois vne palms obtenuë.	Vous venez de me vaincre en me rendant vainqueur, Au lieu d'en témoigner ici manquerais de cœur, Si ie vous disputois une palms obtenue.
Ma colert s’en va comme elle eſtoit venuë, Elle s’eſuanoüit & dedans ce moment, Vous auez triomphé de mon reſſentiment.	Ma colert s'en va comme elle était venue, Elle s'esuanoüit et dedans ce moment, Vous avez triomphé de mon ressentiment.
Ia connois mon erreur elle eſt toute apparente.	Ia connais mon erreur elle est toute apparente.
Mais ne vous ſouuenez que des beautez d’hrante:	Mais ne vous souvenez que des beautés d'hrante:
eſſed2-la pa ſible & m’aciordez ce point, Au nom de voſtre amour ) de ne me haïr point.	esséd2-la pay sible et m'acjordez ce point, Au nom de votre amour ) de ne me haïr point.
uuns enfin le cours d’vns hains ancienne, ed voſtre Maiſon & qui deſtruit la mienns, oujertus vn pere autoque mon deſir.	uuns enfin le cours d'uns hains ancienne, ed votre Maison et qui détruit la mienns, oujertus un père autoque mon désir.
ISIMANDRE.	ISIMANDRE.
Mon ame eſt dans mes yeux iugez de ſon plaiſir.	Mon âme est dans mes yeux jugés de son plaisir.
Ie ne puis exprimer les tranſports de ma ioye Et mon cœur veut s’ouurir, à deſſ-in qu’on la voye Ouy ouy, ſoyons vnis, mon pere eſt appaiſé;	Je ne puis exprimer les transports de ma joie Et mon cœur veut s'ouvrir, à dess-in qu'on la voie Oui oui, soyons unis, mon père est apaisé;
Le chemin de ſon ame eſt vn chimin aiſé;	Le chemin de son âme est un chimin aisé;
Le repos eſt vn bien que ſon eſprit ſouhaite:	Le repos est un bien que son esprit souhaite:
Mαa Monſeur n eſ timps de faire la retraite;	 Majeur n ' imps de faire la retraite;
Naplis vous peut reuoir, y venant quant & moy:	Naplis vous peut revoir, y venant quant et moi:
ORANTE.	ORANTE.
Ie marche ſans fraysur, marchant ſur veſtrs foy.	Je marche sans fraysur, marchant sur vêtrs foi.
SCENE VIII.	SCÈNE VIII.
LVCINDT.	LUCINDT.
PALINICE.	PALINICE.
LVCINDE.	LUCINDE.
7 Ojant ce rauiſſeur, qui paſſoit dans la ruë, V I’ay quitté la feneſtre & i’y ſuis accouruë;	7 Ojant ce ravisseur, qui passait dans la rue, V 'ai quitté la fenêtre et j'y suis accourue;
Mais comme il ſe cachoit de peur d’eſtre connu, Ie n’ay ſçeu dans trois pas ce qu'il eſt deuenu, con cxtrejme vitrjje à trompz ma pouijuie, Apeine mes regards ont deſcouuert ſa faitte, (Choſe qui m’a faſthés & qui l’a reſiouy) Qu’en eſclair en fantoſme il s’eſt eſuanouy.	Mais comme il se cachait de peur d'être connu, Je n'ai su dans trois pas ce qu'il est devenu, con cxtrejême vitrij à tromps ma pouijuie, Apeine mes regards ont découvert sa faites, (Chose qui m'a fasthés et qui l'a réjoui) Qu'en éclair en fantôme il s'est évanoui.
PALINICE.	PALINICE.
Patientez vn pex, nous le verrons ſans doute Ie me mocque d’vn mal que veſtos eſprit redoutt;	Patientez un pex, nous le verrons sans doute Je me moque d'un mal que vêtos esprit redout;
Puis qu’il paroiſt icy, ie le tiens innocent Voſtre fille eſt ſa femme & ſon pire y cenſent, nmnouueau poſſeſſeur eſt ardent & fidelle, il la tenoit cachée il ſeroit auprés d'elle, es plaiſirs deſrobez attachent tout le iour, Microiς plus à luy, puis qu’il a moins d’amous.	Puis qu'il paraît ici, je le tiens innocent Votre fille est sa femme et son pire y censent, nmnouueau possesseur est ardent et fidèle, il la tenait cachée il serait auprès d'elle, ais plaisirs dérobez attachent tout le jour, Microivez plus à Se, puis d'il a moins d'amous.
LVCINDE.	LUCINDE.
ûs au Ciel que ce mal euſt en fin bonne iſſuë qu’elle fuſt ainſi que vous l’auez conçeuë.	 eut Ainsi que ce mal eût en fin bonne issue qu'elle fût ainsi que vous l'avez conçue.
it cunjoieron, mna fluli durait bien jaits.	it cunjoyeron, ména fluli durait bien jaits.
eſt noſtre ennemy mais il eſt tout parfait	est notre ennemi mais il est tout parfait
PALINICE.	PALINICE.
det tenamummmmm jaiuiquii la poige, tous le deſcouurirons, ſoit qu’il entre ou qu’il ſorte	dét tenamummmmm jaiuiquii la poige, tous le découvrirons, soit qu'il entre ou qu'il sorte
SCENE IX.	SCÈNE IX.
POLIANTE, CLINDOR.	POLIANTE, CLINDOR.
POLIANTE.	POLIANTE.
’Amitié m’abuſoit, ſon conſeil eſtoit faux.	Amitié m'abusait, son conseil était faux.
CEn le confiderant i’en ay veu les deffauts, Sιις ſuiuois mon fils en ſaiuant mon enuie, eperdrois ſon honneur pour luy ſauuer la vie:	CEn le considérant j'en ai vu les défauts, Sιις suiuois mon fils en saivant mon envie, éperdrais son honneur pour lui sauver la vie:
u’il reuienne vainqueur ou qu’il reſte vaincu, e deſire qu’il meure ainſi qu’il a veſcu.	Ou'il revienne vainqueur ou qu'il reste vaincu, e ire qu'il meure ainsi qu'il a vécu.
eſt vn iuſte tribut qu’on doît à la Nature, a vorant ſon berctau ie vis ſa ſepulture, naſquis pous mourir is l’ay fait naiſtre til, Eais vne belle mort le peut rendre immorteb.	est un juste tribut qu'on doît à la Nature, a vorant son berctau avait vis sa sépulture, nasquis pous mourir is l'ai fait naître ty,Rés belle mort le peut rendre immorteb.
CLINDOR.	CLINDOR.
Etta Chiloſophis eſt vn peu trop auſtere.	Etta Chilosophis est un peu trop austère.
POLIANTE.	POLIANTE.
Tu vesrois dans mon cœur que ie ſais homme & pt I’en ay le ſent ment, mau il eſt combâtu.	Tu vesrois dans mon cœur que tu sais homme et pt Yen ai le sent ment, mau il est combattu.
Des armes du diſcours que preſte la vertu.	Des armes du discours que prête la vertu.
CLINDOR.	CLINDOR.
Ha!	Ha!
Monſieur, le voicy.	Monsieur, le voici.
POLIANTE.	POLIANTE.
n’ay-ie pas bonne ver;	n'ai-je pas bonne ver;
Mon ame de raiſon eſt-elle bien pourueuë?	Mon âme de raison est-elle bien pourvue?
Ie reconnois Oimin, ce n’eſt point vne erreu?	Je reconnais Oimin, ce n'est point une erreu?
Ie l’ay veu maintes fois aupres de l’Empereur.	Je l'ai vu maintes fois auprès de l'Empereur.
Ued lau X.	Uéd lau X.
ORMIN, POLIANTE, IGIMANDRE, CLINDOR, LERISTE.	ORMIN, POLIANTE, IGIMANDRE, CLINDOR, LERISTE.
ORMIN.	ORMIN.
L n'oſt ritn d’éternel en la terre où neus ſomm· I La haine doit finir außi-bien que les hommes, Le merite d’vn jils eſteignant mon courroux, Is viens vous aſſeurer que ie ſuis tout à vous.	 L'ost ritn d'éternel en la terre où nus somm· I La haine doit finir aussi-bien que les hommes, Le mérite d'H jils éteignant mon courroux, Is viens vous assurer que je suis tout à vous.
POCIANTE.	POCIANTE.
Dans l’accommodement ainſi qu’à la victoire, Qui marche le premiez a la primiere gloire;	Dans l'accommodement ainsi qu'à la victoire, Qui marche le premiés a la primière gloire;
Mais puis que vos bantez me la veulent reuis, Ie garderay pour moy celle de vous ſereir.	Mais puis que vos bantez me la veulent revis, Je garderai pour moi celle de vous sereir.
SCENE XI.	SCÈNE XI.
LVCINDE, PALINICE, POLIANTE, ORMIN, ISIMANDRE, CLINDOR, LERISIE.	LUCINDE, PALINICE, POLIANTE, ORMIN, ISIMANDRE, CLINDOR, LERISIE.
LVCINDE.	LUCINDE.
Ay ma part à la paix auſſi bun qu’à la guerre;	Ai ma part à la paix aussi bun qu'à la guerre;
I Ie crois auoir acquis le reſte de la terre, Puiſque par cét accord on me donne pouuoir, D’habiter vn païs que ie n’oſois reuoir.	I Je crois avoir acquis le reste de la terre, Puisque par cet accord on me donne pouvoir, D'habiter un pays que sans n'osais revoir.
POLIANTE.	POLIANTE.
Madame, eſperez tout de mon obeïſſance:	Madame, espérez tout de mon obéissance:
raupres que le goηHεrhι c' in vaſre puiſſants;	rauprès que le goηHεrhι hommes in vasre puissants;
Et tant que i’y ſeray, voſtre commandiment, Mura touſours le droict d’agit abſolument.	Et tant que j'y serai, votre commandiment, Mura tous le droit d'agit absolument.
ORMIN.	ORMIN.
Dublions le paſſe, mon cœur, is ten coniure:	Dublions le passe, mon cœur, is ten conjure:
PALINICE.	PALINICE.
oſtre ſaul repentir efface mon iniure.	ôtre saul repentir efface mon injure.
ISIMANDRE.	ISIMANDRE.
9uy qui pauiez danner à mon cœur amoureux, La fortune proſpere ou le ſort mal-heureux, Si vous auez pitié de me voir dans la flame, Commandez à ce corps dalier querir jon ume.	9ui qui paviez danner à mon cœur amoureux, La fortune prospère ou le sort malheureux, Si vous avez pitié de me voir dans la flamme, Commandez à ce corps dalier quérir jon ume.
Iæmais	Iæmais
POLIANTE.	POLIANTE.
I parle d’vn amy que la ſienne cherit:	I parle d'un ami que la sienne chérit:
Allez;	Allez;
qu’il vienne voir cemme ls ciel nous rit:	qu'il vienne voir cème l âme nous rit:
Iamais deux volontez ne furent mieux vnies;	Jamais deux volontés ne furent mieux unies;
Leur acord va paſſant toutes les harmouiss Chaque iour l’vn & l’autre ils parent en ſecret, Et la nuit les ſepare autc bien du regres.	Leur acord va passant toutes les harmouiss Chaque jour l'un et l'autre ils parent en secret, Et la nuit les sépare aut bien du rères.
ORMIN.	ORMIN.
Ie me doute à pu pres quel amy ce peut eſtre;	Je me doute à pu pres quel ami ce peut être;
aaur juns jaute t’eſtiuy em teil voj paroifre, Mau ſoubz vn autre habit que vous ne l’autz veu.	aaur juns jaute t'estiuy emil te voj parfre, Maute sous un autre habit que vous ne l'auts vu.
T'OLIANTE.	T'OLIANTE.
Quel prodigt nouueau m’aisaque a l’impourueu?	Quel prodigt nouveau m'aisaque à l'impouru?
SCENE DERNIERE.	SCÈNE DERNIÈRE.
ISIMANDRE, LVCINDE, ORANTEORMIN, POLIANTE, PALINICE, NERINE, CLINDOR, LERISTE.	ISIMANDRE, LUCINDE, ORANTEORMIN, POLIANTE, PALINICE, NERINE, CLINDOR, LERISTE.
Pour l'amour à ſimandre il faut luy pardonnez:	Pour l'amour à simandre il faut venir pardonnés:
Et it ne la reprens que pour vous la donner,	Et it ne la reprends que pour vous la donner,
ISIMAINDRE.	ISIMAINDRE.
Adame, ie vous rends vn bien ineſtimable, me malt ſtuvuy puit tu jaute ens n eſ poiut blaſmable:	Adame, je vous rends un bien inestimable, me malt stuv puit tu jaute ens n ' ai blâmable:
LVCINDE.	LUCINDE.
ORANTE.	ORANTE.
Mon filence, & mon teint vous parlent de ina hont?	Mon silence, et mon teint vous parlent de ina hont?
LVCINDE.	LUCINDE.
Sovez deſormais ſage ayant eſté trop prompte:	Souez désormais sage ayant été trop prompte:
Oubliant le paſſé qui ne nous ſert de rien Ne parlons plus d’vn mal qui nous produit vn bien.	Oubliant le passé qui ne nous sert de rien Ne parlons plus d'un mal qui nous produit un bien.
ORMIN.	ORMIN.
C’eſt de vous maintenant que o touple fidelle, Atiend vne faueur qu’il vient de prendre d’elle, Monſieur, ſoyez bon pers en exauçant leurs væux.	C'est de vous maintenant que ô touple fidèle, Atiend une faveur qu'il vient de prendre d'elle, Monsieur, soyez bon pers en exauçant leurs væux.
POLIANTE parlant d’Orante.	POLIANTE parlant d'Orante.
Ce braue Caualier ſçait bien que ie le veux Sous l’vn & l'autre habit eſgalement i’admire, Tantoſt la belle Orante, & tantoſt Cleomire, Mon cœur n’eſt pai vn bien que ie donne à demy, Ie l’aime comme fille & l’aimois comme amy.	Ce brave Cavalier sçait Mon que n' est bien Que demi, et l'autre habit également j'admire, Tantôt la belle Orante, et tantôt Comire, Mon cœur n'est paimer bien que tu donne à demi, Je l'aime comme fille et l'aime comme ami.
ORANTE.	ORANTE.
Et ie vous ſeruiray pour tous les deux enſemble.	Et ici vous servirai pour tous les deux ensemble.
POLIANTE.	POLIANTE.
On ne peut ſeparer ce que le Cul aſſemble, Il a certains reſſorts qu’on ne peut deſcouurir, C’eſt vn liure ferme qu'on ne ſçaurois ouurir, Et la fin des deſſeins non plus que des années, Ne ſe voit que des Dieux qui foet nos deſtinées, C’eſt à nous d'ob ïr aux Maiſtres des humains.	On ne peut séparer ce que le Cul assemble, Il a certains ressorts qu'on ne peut découvrir, C'est un livre ferme qu'on ne saurais ouvrir, Et la fin des desseins non plus que des années, Ne se voit que des Dieux qui foet nos destinées, C'est à nous d'ob ïr aux Maîtres des humains.
Aηßι ie tends vers eux l’œi lεραην, & les mains, Bu denmue pounvoua vno ſrame choiſie, Vne amour ſans froideur comme ſans ialouſie, Et pour comble di iuys& de proſperité, Das ur ſans außi bour que Vous l’aurez eſté.	Aηssι ie tends vers eux lεραην, et les mains, Beau beau tends v srame choisie, eux l' froideur l' Un ialousie, Et pour le iuyset de mains, B ur sans mue pounoua Un sraurez choisie,
