I ARGVMENT.	I JRGUMENT.
& Ronte aimoit Calirie dés le be ceau, eſgalement aimé d’elle, d rant la force, de leur affectic Alidor ſon nepueu reuient d’A gleterre, où il auoit eſté long temps, & d bord qu’il voit Calirie en deuient amo reux, ſans ſe ſouuenir, ny de l’amitié que ſe oncle luy portoit, ny des obligations qu luy auoit, ſa paſſion vint à tel poinct, que i l’oſant deſcouurir, de peur d’offenſer ſo oncle, ſon mal caché ſe rendant plus vie lent, il tombe malade, Oronte qui aimoit nepueu, comme ſi c’euſt eſté ſon fils, en ploye toute la medecine pour ſa guariſoi & voyant que c’eſtoit inutilement, il en pa le à vn Medecin de ſes amis, auec de ſi grai s marques de ſon deſplaiſir, que l’autre blige à deſcouurir le ſujet du mal d’Alior à cét effet, il ſe tient deux ou trois iours iprés du malade, & faiſant des obſeruaons particulieres de l’extraordinaire mouement du pouls, & des changemens dũ vige d’Alidor, lors que Calirie entroit dans chambre, ibcreut que l’amour de Calirie rendoit malade, cette croyance l’oblige e dire à Oronte, que s’il vouloit conſeruer on nepueu, il luy falloit donner Calirie, ce iſcours eſtonne Oronte, & toutesfois l’aaitié qu’il auoit pour ſon nepueu le fait paſr pardeſſus toutes les conſiderations de l’anour de Calirie, & ſe reſout de luy ſauuer a vie, en ſe priuant de ce qu’il auoit de plus her, & pour n’y perdre point de temps, il oit Calirie, la prie de viſiter ſouuent ſon iepueu, & de le careſſer,& cependant il va thez Larinthe, luy propoſe les aduantages lu mariage deſon nepueu & de ſa fille, & paſſe iuſqu’à la concluſion, il porte ces nouuelles à Alidor, qui viſité ſouuent de Calirie.	et Ronte aimoit Calirie dés le ceau, également aimé elle, rant la force, de leur affectic Alidor son nepueu reuient A gleterre, il auoit esté long temps, et bord il voit Calirie en dévient reux, sans se souuenir, ni de amitié que se oncle lui portoit, ni des obligations lui auoit, sa passion vint tel poinct, que y osant descouurir, de peur offenser oncle, son mal caché se rendant plus vie lent, il tombe malade, Oronte qui aimoit nepueu, comme si eût esté son fils, en ploye toute la médecine pour sa guarisoi et voyant que estoit inutilement, il en le Medecin de ses amis, auec de si gray marques de son déplaisir, que autre blige descouurir le sujet du mal Alior cét effet, il se tient deux ou et iours iprés a malade, et que le obseruaons particulières à son bodu pouls, et des changemens t aimé d'Elle, d' elle Ra entroit la force, de que leur de Calirie rendoit malade, cette son noblige dire ouOronte, que d'A vouloit err on nepueu, il où il a Vay, ce iscours été Longtemps, et dès çaaitié qu'il voit pourson nepueu le fait pasr ie en de vien de amour de Calirie, et se ans se lui sauuer a nir, en se ni de ce l' amit de que se, et pour nyclé était de temps, il oit Ait, la ni des visiter souuent qu' y, avait , sa caresseron vint il à tel Put, que j' os aduantages lu mariage deson nepueu et de sa fille, de peur d'ossen la conclusion, et de l' nouuelles Alidor, qui il tombe de Malade,
commençoit à ſe remettre, ce qui le remit tout à fait ſur pied:	commençait à se remettre, ce qui le remit tout à fait sur pied:
durant que cela ſe paſſe, Cintille qui aimoit Alidor, & qui en auoit eſté aimée en Angleterre, preſſee de ſa paſſion, & aydee de la reſſemblance qu’elle auoit à ſon frere Alcandre, auoit pris des habits d’homme, & eſtoit venuë en France, où ne pouuant voir Alidor, à cauſe de ſon mal, elle fit cognoiſſance auec vn ieune Gentilhomme François nommé Florintor, amoureux de Meliſſee, & qui pour diuertir, le feint Alcandre l’auoit ſouuent conduit chez ſa Maiſtreſſe Meliſſee, qui n’ayant peu reſiſter à la force des yeux de cette fille deſguiſee en deuient amoureuſe, la croyant Alcandre, & pour l’obliger, parce qu’elle l’en auoit priée, fait bonne mine à Florintor, non pas ſans donner des teſmoignages à Cintille de ſa paſſion, mais cette fille qui n’auoit que l’aH 10 AROVMEICT.	durant que cela se passe, Cintille qui aimait Alidor, et qui en avait été aimée en Angleterre, pressée de sa passion, et aidée de la ressemblance qu'elle avait à son frère Alcandre, avait pris des habits d'homme, et était venue en France, où ne pouvant voir Alidor, à cause de son mal, elle fit connaissance avec un jeune Gentilhomme François nommé Florintor, amoureux de Melisse, et qui pour divertir, le feint Alcandre l'avait souuent conduit chez sa Maîtresse Melisse, qui n'ayant peu résister à la force des yeux de cette fille desguisee en dévient amoureuse, la croyant Alcandre, et pour obliger, parce elle en auoit priée, fait bonne mine Florintor, non pas sans donner des témoignages Cintille de sa passion, mais cette fille qui auoit que aH 10 AROVMEICT.
mour d’Alidor dans l’eſprit ſe feint, attendant l’occaſion de voir ſon Amant, elle le voit en fin, mais en eſt receuë, comme ſi veritablement elle euſt eſté ſon frere Alcandre, ſans que parmy leurs diſcours Alidor nommaſt iamais Cintille, ce qui la picqua ſi fort, qu’elle le quitte tout en cholere, & prend reſolution de retourner dans vne ſollitude où elle auoit eſté quelque temps:	mour d'Alidor dans l'esprit se feint, attendant l'occasion de voir son Amant, elle le voit en fin, mais en est reçue, comme si véritablement elle eût été son frère Alcandre, sans que parmi leurs discours Alidor mât jamais Cintille, ce qui la piqua si fort, qu'elle le quitte tout en cholere, et prend résolution de retourner dans une sollitude où elle avait été quelque temps:
Auparauant que de partir elle donne chargea Orcan vieux Gentil-homme qu’elle auoſt emmene, de ſçauoir ce qui pouuoit obliger Alidor à la traicter de la ſorte, Orcan prend ce ſoin auec affection, & faict ſi bien qu’il apprend que Calirie eſtoit l’object des paſſions d’Alidor, que ſon oncle auoit traicté leur mariage auec la mere de la fille, & que toutesfois Oronte ayant veu que ſon nepueu ſans mourir auoit ſouffert le refus de Calirie, faiſoit ſon poſſible pour ſe remettre bien auec elle, & que lors qu’il eſtoit ſur le --- poinct d’obtenir le pardon de ſa faute, Alidor eſtoit ſuruenu, qui ſe voyant mal traicté de ſa Maiſtreſſe, & trompé par ſon oncle, fit quelques reproches à tous les deux, & fait effort de ſe tuer, Calirie l’en empeſche, & promet à l’vn & à l’autre de les contenter le lendemain, ce qu’Orcan ayant rapporté à Cintille, elle ſe reſout de quitter ſa ſolitude, reuient à la Cour, croit Meliſſee, qui luy deſcouure ouuertement ſon amour, qu’elle rejette le plus honneſtement qu’elle peut, s'excuſant ſur l’affection qu’elle auoit pour Doris, & luy parle pour Florintor, Meliſſee faſchee la quitte, rencontre Florintor, & le traicte plus mal qu’elle n’auoit iamais faict, luy diſant qu’elle ne l’auoit ſoüffert que pour obliger Alcandre, & non luy, Florintor tout eſtonné ſe retire, & va faire ce diſcours à Cintille, qui luy confeſſe qu’il eſtoit vray que Meliſſee luy auoit teſmoigné de l’amour, mais que cela nele deuoit pas troubler, puis qu’il eſtoit impoſſible qu’elle la contentaſt, Florintor aucunement ſatisfait, laiſſe Cintille, qui le prie pourtant de la ſuiurę bien toſt chez Meliſſee où elle alloit, & que de là tous trois enſemble ſe rendroient chez Calirie, où ſe deuoit vuider ce iour-là la querelle de l’oncle & du nepueu, Calirie cependant qui n’auoit point repoſé, ſongeant aux moyens de contenter Oronte ſans faſcher Alidor, prend vne eſtrange reſolûtion, & d’vne poincte de diamant gaſte tous les beaux traits de ſon viſage, ſa mere arrſua ſur ce poinct, qui la voyant toute en ſang s’eſcrie, Cintille, Meliſſee, & Florintor ſuruiennent, qui eſtonnez d’vn accident ſi cruel s’informent du nom du barbare qui auoit oſéruiner tant de beautez, Calirie ſans s’eſmouuoir leur dit, que ç’auoit eſté Oronte & Alidor, Oronte arriue là deſſus, & faiſant la méme demande que les autres, apprend par la bouche de Calirie, quecenoie luy e ſon 13 nepueu qui l’auoit miſe en ſi mauuais eſtat, Alidor qui auoit eu la nouuelle de l’accidẽt de Calirie, vient tout en fureur, prot eſtant d’oſter la vie à celuy qui auoit oſé mettre la main ſur ſa Maiſtreſſe, mais il n’euſt pas plus toſt veu ce viſage tout en ſang, qu’il détourne ailleurs ſa veuë, ce que Calirie ayant apperceu, prend occaſion de luy dire qu’elle auoit touſiours creu qu’il n’auoit aimé que ſa beauté exterieure, que pour cette raiſon elle l’auoit voulu perdre, & que ſans doute Oronte l’en aimeroit dauantage, puis qu’elle ne l’auoit perduë que pour ſe conſeruer à luy ſeul, toute l’aſſiſtãce admire cette action genereuſe, & lors qu’Alidor ſe veut ietter à genoux pour leur demander pardon, il eſt interrõpu par Cintille, qu’il croit touſiours eſtre Alcandre, ce qui le fait reſſouuenir du tort qu’elle auoit fait à Cintille, c’eſt pourquoy il la prie de le vouloir remettre en grace auprés de ſaſœur, Cintille qui le voit repentant, luy fait perdre cet te croyance, & ſe fait cognoiſtre pour ce qu’elle eſtoit, ce nouuel accident donne autant d’eſtonnement à toute la compagnie, que l’action de Calirie leur auoit donné de l’admiration, & principalement à Meliſſee, qui hõteuſe d’auoir aimé vne fille, & preſſee par elle-meſme de recognoiſtre l’amour de Florintor, promet de l’aimer, Cintille pardonne à Alidor, Calirie eſt extrémement contente d’eſtre auſeul Dronte, & de voir Alidor ſatisfait, la mere qui craignoit que le mal de ſa fille ne s’enuenimaſt, les oblige de ſe retirer, & prie Cintille & Meliſſee de prendre ſa maiſon, en attendant que la gueriſon de ſa fille leur permit de receuoir les plaiſirs qu’elles attendoient de leur amour, par le mariage de toutes trois, auec les perſonnes ay	Auparauant que de partir elle donne chargea Orcan vieux Gentil-homme elle auost emmene, de sçauoir ce qui pouuoit obliger Alidor la traicter de la sorte, Orcan prend ce soin auec affection, et faict si bien il apprend que Calirie estoit object des passions Alidor, que son oncle auoit traicté leur mariage auec la mere de la fille, et que toutesfois Oronte ayant que son nepueu sans mourir auoit souffert le refus de Calirie, faisoit son possible pour se remettre bien auec elle, et que lors il estoit sur le -- poinct obtenir le pardon de sa faute, Alidor estoit survenu, qui se voyant mal traicté de sa Maistresse, et trompé par son oncle, fit quelques reproches tous les deux, et fait effort de se tuer, Calirie en empêche, et promet et autre de les contenter le lendemain, ce Orcan ayant rapporté Cintille, elle se résout de quitter sa solitude, reuient la Cour, croit Melissee, qui lui descouure ouuertement son amour, elle rejette le plus honnêtement elle peut, s'excusant sur affection elle auoit pour Doris, et lui parle pour Florintor, Melissee fâchée la quitte, rencontre Florintor, et le traicte plus mal elle auoit iamais faict, lui disant elle ne auoit soüffert que pour obliger Alcandre, et non lui, Florintor tout estonné se retire, et va faire ce discours Cintille, qui lui confesse il estoit vrai que Melissee lui auoit tesmoigné de amour, mais que cela nele deuoit pas troubler, puis il estoit impossible elle la contentât, Florintor aucunement satisfait, laisse Cintille, qui le prie pourtant de la suiurę bien tôt chez Melissee elle alloit, et que de tous trois ensemble se rendroient chez Calirie, se deuoit vider ce iour-là la querelle de oncle et du nepueu, Calirie cependant qui auoit point reposé, songeant aux moyens de contenter Oronte sans fâcher Alidor, prend étrange resolûtion, et poincte de diamant gâte tous les beaux traits de son visage, sa mere arrsua sur ce poinct, qui la voyant toute en sang écrie, Cintille, Melissee, et Florintor surviennent, qui étonnez accident si cruel informent du nom du barbare qui auoit oséruiner tant de beauté, Calirie sans esmouuoir leur dit, que auoit esté Oronte et Alidor, Oronte arriue dessus, et faisant la méme demande que les autres, apprend par la bouche de Calirie, quecenoie lui son 13 nepueu qui auoit mise en si mauuais estat, Alidor qui auoit eu la nouuelle de accidẽt de Calirie, vient tout en fureur, prot estant ôter la vie celui qui auoit osé mettre la main sur sa Maistresse, mais il eût pas plus tôt ce visage tout en sang, il détourne ailleurs sa veuë, ce que Calirie ayant apperceu, prend occasion de lui dire elle auoit tousiours creu il auoit aimé que sa beauté extérieure, que pour cette raison elle auoit voulu perdre, et que sans doute Oronte en aimeroit dauantage, puis elle ne auoit perduë que pour se conserver lui seul, toute assistãce admire cette action généreuse, et lors Alidor se veut ietter genoux pour leur demander pardon, il est interrõpu par Cintille, il croit tousiours être Alcandre, ce qui le fait ressouuenir du tort elle auoit fait Cintille, est pourquoi il la prie de le vouloir remettre en grace à sa vie, Et qui de voit sang lui a réscet te ion, et et que ces pour ce elle -moi, ce qu' elle ne la rétonnement toute la compagnie, de Saction de Calirie ce qui se de nait, et principalement A Le, qui hõteuse auoir aimé fille, à la par ellement de recognoistre la de Sorte, Or de a, Cintille pardonne Alidor, Ce est soin contente auêtre asse Dronte, et et voir Ait si, la mere qui en que ' il de sa fille ne menvenimât, les oblige de se étai, l' prie Cintille et Des de passions d' maison, que son onclé avait de ra fille leur mariage avec les a mellesdite de la jalousie, et que mariage de toutefois trois, ayant vu que son
I P R( ET 21 L0 TL TRAGI-COMEDIE.	I PUIS R( ET 21 0 TL TRAGI-COMÉDIE.
ACTE PREMIER SCENE I.	ACTE PREMIER SCÈNE I.
ORONTE ſeul.	ORONTE seul.
P Ieux, de qui tous les iours i’approche les Autels!	 Peux, de qui tous les jours j'approche les Autels!
ie ie ſuis malheureux entre tous les mortels;	ie Ne suis malheureux entre tous les mortels;
l'ay fait ce que i’ay peu, pour conſeruer ma vie	l'ai fait ce que j'ai peu, pour conserver ma vie
Exempte des ennuis qui nous cauſe l'enuie:	Exempte des ennuis qui nous cause l'envie:
Et l’on n'a point connu parmy tous les humains Vn ſeul qui peut reprendre, ou mes mœurs, ou mes mains:	Et l'on n'a point connu parmi tous les humains Un seul qui peut reprendre, ou mes mœurs, ou mes mains:
Le crime que l’on peut me reprocher au monde Eſt que ma paßion ſe trouue ſans ſeconde;	Le crime que l'on peut me reprocher au monde Est que ma passion se trouve sans seconde;
Que i’ayme Calirie, & que i'aymerois mieux Perdre l’obiect du iour que celuy de ſes yeux.	Que j'aime Calirie, et que j'aimerais mieux Perdre l'object du jour que celui de ses yeux.
Mais eſt-ce vn crime, ô Dieux!	Mais est-ce un crime, ô Dieux!
que d’aymer vos ouurages.	que d'aimer vos ouvrages.
Et d’adorer en eux vos diuins aduantages;	Et d'adorer en eux vos divins avantages;
Non, ie ſçay que le Ciel, & toutes ſes clartés Qui de nuict & de iour nous mõſtrẽt leurs beautés Sont œuures de vos mains, pour noſtre ſeul Jeruice, Et que de les aymer ne fuſt iamais vn vice, Et pour ceſte raiſon, i'ay creu que ie pouuois Soûmettre mon eſprit aux amoureuſes lois, Pue faus rous offencer, i'auois rendu les armes A l’ouurage diuin, dont i’adore les charmes.	Non, Seigneur sais que le Ciel, et toutes ses clartés Qui de nuit et de jour nous mõstrẽt leurs beautés Sont œuvres de vos mains, pour notre seul Jerce, Et que de les aimer ne fût jamais un vice, Et pour cette raison, j'ai cru que sans pouvais Soumettre mon esprit aux amoureuses lois, Pue faus rous offenser, j'avais rendu les armes A l'ouvrage divin, dont j'adore les charmes.
Cependant auiourd’huy ie ne ſuis malheureux Que pour eſtre preßé d’vn deſir amourenx.	Cependant aujourd'hui jour ne suis malheureux Que pour être pressé d'un des amourenx.
S’il faut que mon Amour vous ſoit de ſagréable, Puniſſez de la mort cét Amant miſerable:	S'il faut que mon Amour vous soit de sagréable, Punissez de la mort cet Amant misérable:
Car la vie außsi bien en l’eſtat où ie ſuis A fait mourir ma ioye, & nourrit mes ennuis.	Car la vie aussi bien en l'état où tu suis A fait mourir ma joie, et nourrit mes ennuis.
Ie me trauaille en vain, les Dieux ſont ſans oreilles, Et ne s’eſmeuuent point pour des choſes pareilles, Lors que leur prouidence a donné ſes decrets, Il nous eſt defendu d’en ſçauoir les ſecrets:	Je me travaille en vain, les Dieux sont sans oreilles, Et ne s'esmeuuent point pour des choses pareilles, Lors que leur providence a donné ses décrets, Il nous est défendu d'en savoir les secrets:
Ie n’ay pas toutesfois grand ſujet de me plaindre, Calirie aime Oronte, & ie ne dois rien craindre, Elle m’a teſmoigné que ſon bel œil vainqueur Ne me promettoit rien qu'elle n'euſt dans ſe cœur, Et depuis le long temps que i'adore ſa grace, I’ay trouué de l’ardeur, les autres de laglace.	Je n'ai pas toutefois grand sujet de me plaindre, Calirie aime Oronte, et atte lasse rien craindre, Elle m'a témoigné que son bel œil vainqueur Ne me promettait rien qu'elle n'eût dans se cœur, Et depuis le long temps que j'adore sa grâce, J'ai trouvé de l'ardeur, les autres de laglace.
Mais durant cét amour i’apprehende vn malheur, Alidor en mourant me cache ſa douleur.	Mais durant cet amour j'appréhende un malheur, Alidor en mourant me cache sa douleur.
Les ſoins des Medecins n'eſt que peine pérdué, Sa gueriſon n'eſt plus de leurs mains attendué, C’eſt en vain tous les iours qu’ils viennent pour le voir, La grandeur de ſon mal ſurpaſſe leur ſçauoir,	Les soins des Médecins n'est que peine pérdué, Sa guérison n'est plus de leurs mains attendué, C'est en vain tous les jours qu'ils viennent pour le voir, La grandeur de son mal surpasse leur savoir,
Ie me doute pourtant d’où vient ſa maladie, Et qu’il mourra bien toſt ſi ie n’y remedie, Ses ſouspirs ſi frequents, & ſes trãſports d’esprit, Alors que Calirie approche de ſon lit Me font iuger qu'il aime, & qu’il cache dãs l’ame, De peur de m'offenſer ſon amoureuſe flame.	Je me doute pourtant d'où vient sa maladie, Et qu'il mourra bien tôt si apprendre n'y remédie, Ses soupirs si fréquents, et ses transports d'esprit, Alors que Calirie approche de son lit Me font juger qu'il aime, et qu'il cache dans l'âme, De peur de m'offenser son amoureuse flamme.
Que feray-ie, Alidor mourra t’il ſans ſecours, Parce qu’il tient ſecret l’objet de ſes amours?	Que ferai-je, Alidor mourra -t-il sans secours, Parce qu'il tient secret l'objet de ses amours?
Que ſa diſcretion retient dans ſa penſee Le nom de ſa beauté dont ſen ame eſt bleſſee.	Que sa discrétion retient dans sa pensée Le nom de sa beauté dont sen âme est blessée.
Non, non, auparauant que de les voir mourir, Aux despens de ma flame il le faut ſecourir:	Non, non, auparavant que de les voir mourir, Aux dépens de ma flamme il le faut secourir:
Mais voicy noſtre amy de qui l’experience Des plus grands Medecins ſurpaſſe la ſcience:	Mais voici notre ami de qui l'expérience Des plus grands Médecins surpasse la science:
Qui depuis quelques iours ſe tient auprés de luy, Pour ſçauoir le ſujet de ſon cruelennuy.	Qui depuis quelques jours se tient auprès de lui, Pour sçauoir le sujet de son cruelennui.
Et bien, qu'auez-vous faict, auez-vous peu cognoiſtre, D'où ſa melancolie, & ſon mal peuuent naiſtre.	Et bien, qu'avez-vous fait, avez-vous peu connaître, D'où sa mélancolie, et son mal peuvent naître.
ACTE PREMIER.	ACTE PREMIER.
SCENE II.	SCÈNE II.
LE MEDECIN.	LE MÉDECIN.
ORONTE.	ORONTE.
LE MEDECIN.	LE MÉDECIN.
Vy ie l’ay recogneu, en le peut ſoulager, Courueu que Calirie en oſte le danger.	Vi ici l'ai reconnu, en le peut soulager, Couru que Calirie en ôte le danger.
JRONTE.	JRONTE.
Et comment Calirie a-t'elle ſon remede.	Et comment Calirie a-t'-elle son remède.
LE MEDECIN.	LE MÉDECIN.
Si on veut le ſauuer, il faut qu’il l’a poſſede, Son mal eſt dans l’eſprit, ceſte ieune beauté, Par ſes diuins appas altere ſa ſanté, Il l’aime, & ſon amour a quelque retenuë, L° 2- - -- A iij Qui difficilement me peut eſtre cogneuë:	Si on veut le sauver, il faut qu'il l'a possède, Son mal est dans l'esprit, cette jeune beauté, Par ses divins appas altère sa santé, Il l'aime, et son amour a quelque retenue, L 2-à --- A jij Qui difficilement me peut être connue:
Elle l’allegera de ſon ſeul entretien.	Elle l'allégera de son seul entretien.
Adien.	Adien.
ORONTE ſeul.	ORONTE seul.
T’ay-i employé pour m'arracher mon bien.	T'ai-y employé pour m'arracher mon bien.
Tu gueris Alidor, & contre ton enuie Tu m'annonces la mort en luy donnant la vie:	Tu guéris Alidor, et contre ton envie Tu m'annonces la mort en porte donnant la vie:
Tu m’oſtes Calirie, eſt-ce pas me tuer, Mon amitié pourtant le doit effectuer, Quelqu’amour que mon ame ayt encore pour elle, Il ne doit pas mourir pour aymer ceſte belle:	Tu m'ôtes Calirie, est-ce pas me tuer, Mon amitié pourtant le doit effectuer, Quelqu'amour que mon âme ait encore pour elle, Il ne doit pas mourir pour aimer cette belle:
Ie veux que mon amour cede à mon amitié, Qu'en ſa faueur ie ſois contre moy ſans pitié.	Je veux que mon amour cède à mon amitié, Qu'en sa faveur je sois contre moi sans pitié.
Sonpere;	Sonpère;
à qui le mien preßsé de la vieilleſſe, Mourant laiſſa le ſoin de regir maieuneſſe:	à qui le mien presssé de la vieillesse, Mourant laissa le soin de régir maieunesse:
Qui m'a ſeul eſleué, qui me dit à ſa mort Qu'il me laiſſoit ſon fils, que i’eſtois ſon ſupport, Me pourroit iuſtement faire vn iour ce reproche, Qu'as-tu fait de mon fils, & d’vn parent ſi proche Ay-ie voulu iamais trauerſer tes deſirs, Ou te laiſſer mourir pour des laſches plaiſirs, E 79 ae- 4 –	Qui m'a seul élevé, qui me dit à sa mort Qu'il me laissait son fils, que j'étais son support, Me pourrait justement faire un jour ce reproche, Qu'as-tu fait de mon fils, et d'un parent si proche Ai-je voulu jamais traverser tes désirs, Ou te laisser mourir pour des lâches plaisirs, É 79 ae- 4là
Non, il auoit vn ſoin ſi grand de me complaire, Que i'en receus touſiours des offices de pere, Et ie veux conteſter maintenant ſi ie dois Ceder ſur Calirie à ſon fils, tous mes droits, Ouy ie le dois ceder, & ma raiſon plus forte Doit faire quitter priſe à l’ardeur qui m’emporte, Ie veux perdre auiourd’huy tous mes contentemẽs, Que ie ſois mis au rang des mal-heureux Amans:	Non, il avait un soin si grand de me complaire, Que j'en reçus toujours des offices de père, Et de veux contester maintenant si personne dois Céder sur Calie à son fils, tous mes droits, Ou ie le dois céder, et ma raison plus forte Doit faire quitter prise à l'ardeur qui m'emporte, Je veux perdre aujourd'hui tous mes contentements, Que ie sois mis au rang des malheureux Amants:
Ie te cede Alidor, la belle Calirie, Reprens ton embon-poinct, laiſſe ta reſuerie, Il faut que tous les ſoins que pour elle i'ay pris, Seruent à ſoulager tes amoureux eſprits, Et que ce ſoit pour toy ce que i'ay fait pour elle:	Je te cède Alidor, la belle Calirie, Reprends ton embon-point, laisse ta rêverie, Il faut que tous les soins que pour elle j'ai pris, Servent à soulager tes amoureux esprits, Et que ce soit pour toi ce que j'ai fait pour elle:
Mais ie voy ce me ſemble approcher ceſte belle, Que ſon objet m'eſmeut, ie ne ſçay plus comment Luy tenir vn diſcours que ma flame deſment.	Mais ie cy ce me semble approcher cette belle, Que son objet m'émut, toujours ne sais plus comment Lui tenir un discours que ma flamme dément.
–- 4 ---	§- 4 --elle
ACTE PREMIER.	ACTE PREMIER.
SCENE III.	SCÈNE III.
CALIRIBONONIE.	CALIRIBONONIE.
CALIRIE.	CALIRIE.
IEs yeux großis de pleurs, & ton viſage bleſme, Oronte, ſont teſmoins d’vne douleur extreſme, Tu ne dois pas pourtant eſtre triste ſans moy, Nvons auons trop long temps veſcu ſous ceſte loy, Pour maintenant la rompre, & me cacher tõ ame, Ie ne la puis ſouffrir ſans reproche, ou ſans blaſme.	IEs yeux gross de pleurs, et ton visage blême, Oronte, sont témoins d'une douleur extrême, Tu ne dois pas pourtant être triste sans moi, Névons auons trop long temps vécu sous cette loi, Pour maintenant la rompre, et me cacher tendre âme, Je ne la puis souffrir sans reproche, ou sans blâme.
ORONTE.	ORONTE.
Ie ne puis Calirie eſtre iamais content, --- - ---- .	Je ne puis Calirie être jamais content, -- - -- .
	
Que l’on croit ſans raiſon, qui pour eux ne ſouſpire.	Que l'on croit sans raison, qui pour eux ne soupire.
Ie l’ay bien approuué, moy dont l’aage plus meur Deuroit auoir changé les penſers & l’humeur:	Je l'ai bien approuvé, moi dont l'âge plus meur Deurait avoir changé les pensers et l'humeur:
Mais puis qu'vn meſme amour violente ton ame, Que ton cœur eſt touché d’vne pareille flame, Ie te veux teſmoigner que pour ta gueriſon, Si i’ay beaucoup d’amour, i’ay bien plus de raiſon, Ie ne ſçaurois iamais auoir l’ame contente, Si dans le deſespoir la tienne eſtoit conſtante:	Mais puis qu'un même amour violente ton âme, Que ton cœur est touché d'une pareille flamme, Je te veux témoigner que pour ta guérison, Si j'ai beaucoup d'amour, j'ai bien plus de raison, Je ne saurais jamais avoir l'âme contente, Si dans le désespoir la tienne était constante:
Change doncques d’humeur, espere tout d’amour, Et tu ſeras bien toſt eſclairé d’vn beauiour.	Change donc d'humeur, espère tout d'amour, Et tu seras bien tôt éclairé d'un beaujour.
I’aime cher Alidor, trop cherement ta vie, Pour ſouffrir qu'à ma faute elle te ſoit rauie, Ie ſuis tant obligé de te la conſeruer, Que ie me voudrois perdre, afin de te ſauuer, Ie viendray bien à bout de ce que ie medite, uu ſçay que Calirie eſtime ton merite, Ie viens de l’engager à te voir plus ſouüent, Et tu la cognoiſtras autre qu'auparauant, Remets-toy ſeulement.	J'aime cher Alidor, trop chèrement ta vie, Pour souffrir qu'à ma faute elle te soit ravie, Je suis tant obligé de te la conserver, Que ie tu voudrais perdre, afin de te sauver, Je viendrai bien à bout de ce que je médite, sçay que Calirie estime ton merite, Ie viens de engager te voir plus souüent, Et tu la cognoistras autre qu'auparauant, Remets-toi seulement.
ALIDOR.	ÀLIDOR.
O Dieux!	Ô Dieux!
quelle iniuſtice, Me voulez-vous ſauuer pour vous mettre au ſupplice, Moy, dis-ie, dont l’amour vous offenſe ſi fort:	quelle injustice, Me voulez-vous sauver pour vous mettre au supplice, Moi, dis-je, dont l'amour vous offense si fort:
Non, non, O ronte, non, i’aime bien mieux la mort, Au moins ie n’auray plus l’horreur de vous deſplaire, Laiſſez-moy dõcmourir, ie n'ay qu'vn pas à faire.	Non, non, Ô ronte, non, j'aime bien mieux la mort, Au moins ie n'aurai plus l'horreur de vous déplaire, Laissez-moi dõcmourir, une n'ai qu'un pas à faire.
Mon esprit abbaitu des maux que ie reſſens Eſt preſt d’abandonner ces membres languiſſans:	Mon esprit abaitu des maux que ici ressens Est prêt d'abandonner ces membres languissants:
Poſſedez Calirie, ô bien-heureux Oronte, Et ſouffrez que la mort vienne couurir ma honte	Possédez Calirie, ô bienheureux Oronte, Et souffrez que la mort vienne couvrir ma honte
ORONTE.	ORONTE.
Alidor ſi tu veux aduancer mon trespas, Tu n'as qu'à perſiſter à ne m’obeyr pas:	Alidor si tu veux avancer mon trépas, Tu n'as qu'à persister à ne m'obéir pas:
Mais s’il te reſſouuient auec quelle tendreſſe, I’ay long temps pris le ſoin d’eſleuer ta ieuneſſe, Que ie t'ay plus aimé, que tout ce que les Dieux Ont peu iuſqu’à preſent faire voir à mes yeux, Tu prendras le ſoucy de ſauuer ce que i’aime, 1 Vu C Puis que de ta ſanté despend ma ſanté meſme, Promets-le moy mon fils.	Mais s'il te ressouvient avec quelle tendresse, J'ai long temps pris le soin d'élever ta jeunesse, Que tu t'ai plus aimé, que tout ce que les Dieux Ont peu jusqu'à présent faire voir à mes yeux, Tu prendras le souci de sauver ce que j'aime, 1 Vu Ç Puis que de ta santé dépend ma santé même, Promets-le moi mon fils.
ALIDOR.	ÀLIDOR.
Vous puis-ie refuſer,	Vous puis-je refuser,
ORONTE.	ORONTE.
Me voila ſatisfait taſche de repoſer.	Me voilà satisfait tâche de reposer.
ALIDOR ſeul.	ÀLIDOR seul.
Que ie ſuis combattu de diuerſes penſees, Dont les vnes eſtant des autres effacees, Forment en mon eſprit tant de confuſion, Que tout ce qu’il m'a dit me ſemble illuſion.	Que ie suis combattu de diverses pensées, Dont les unes étant des autres effacées, Forment en mon esprit tant de confusion, Que tout ce qu'il m'a dit me semble illusion.
Quelle apparence außi qu'apres tant de ſeruices, Tant de ſoins, tãt d’amour, & tant de bõs offices, Qu'il n'à pas employez, que pour la poſſeder, Lors qu'il en eſt au poinct il la vueille ceder, Non, non, c’eſt vn effect de noſtre reſuerie, Calirie aime Oronte, Oronte Calirie, Et l’on pourra pluſtoſt allumer des glaçons, Et rendre les rochers fertiles en moiſſons, Que de pouuoir iamais eſteindre ceſte flame, Qu'vn amour mutuel entretient dans leur ame:	Quelle apparence aussi qu' apres Tant de soins, Tant de soins, tãt d'amour, et tant de bons offices, Qu'il n'à pas employez, que pour la posséder, Lors qu'il en est au point il la veuille céder, Non, non, c'est un effet de notre rêverie, Calirie aime Oronte, Oronte Calirie, Et l'on pourra plutôt allumer des glaçons, Et rendre les rochers fertiles en moissons, Que de pouvoir jamais éteindre cette flamme, Qu'un amour mutuel entre dans le âme:
Mourons doncques, mourons, & ceſſons d’eſperer Ce que ie ne dois pas ſeulement deſirer:	Mourons donc, mourons, et cessons d'espérer Ce que je ne dois pas seulement désirer:
Toutes fois l’amitié qu’Oronte me teſmoigne Semble m'offrir le port, lors que ie m'en eſloigne, Ie voy qu'il eſt touché ſi fort de mon ennuy, Que ie ne parois pas ſi malade que luy, Et ie ſerois ingrat à ceſte amitié forte, Si ie ne receuois le bon-heur qu’il m'apporte.	Toutes fois l'amitié qu'Oronte me témoigne Semble m'offrir le port, lors que sans m'en éloigne, Je vois qu'il est touché si fort de mon ennui, Que me ne parais pas si malade que lui, Et ainsi serais ingrat à cette amitié forte, Si ie ne receuois le bonheur qu'il m'apporte.
Mais voicy cét objet, autheur de mes douleurs, Voicy ces yeux vainqueurs cauſe de mes malheurs:	Mais voici cet objet, auteur de mes douleurs, Voici ces yeux vainqueurs cause de mes malheurs:
Adorons-la pourtant, c’eſt ſans idolatrie, La Maieſté des Dieux ſe trouue en Calirie, Oronte ie vois bien que c'eſt ſans fiction Que tu me veux ayder en mon affection.	Adorons-la pourtant, c'est sans idolâtrie, La Majesté des Dieux se trouve en Calirie, Oronte femme vois bien que c'est sans fiction Que tu me veux aider en mon affection.
ACTE PREMIER.	ACTE PREMIER.
SCENE VI.	SCÈNE VI.
CALIRIE ALIDOL.	CALIRIE ALIDOL.
CALIRIE.	CALIRIE.
Lidor voulés-vous eſtre touſiours malade, Durãt ceſte ſaiſon propre à la promenade, Que tout ſe reſiouyt, que les champs ſont ſi beaux, Que les arbres ont pris de viſages nouueaux, Vous à qui la ieuneſſe, & la beauté promett ent Tous les plus doux plaiſirs que les Dieux nous permettent, Qui vertueux, courtois, prudent en vos diſcours Aux meilleurs entretiens deuez paſſer vos iours,  iij	Lidor voulez-vous être toujours malade, Durant cette saison propre à la promenade, Que tout se resiouyt, que les champs sont si beaux, Que les arbres ont pris de visages nouveaux, Vous à qui la jeunesse, et la beauté promett ent Tous les plus doux plaisirs que les Dieux nous permettent, Qui vertueux, courtois, prudent en vos discours Aux meilleurs entretiens devez passer vos jours, iij
Mn muiaui mai Md a jdM mmav	Mn muiaui mai d a jusdu mémav
81 Voulez-vous donc laiſſer voſtre ame enſeuelie Dans les noires vapeurs de la melancholie, Et pour quelque chagrin conceu legerement, Ruiner voſtre eſtime, & voſtre iugement, Chaqu'vn eſt eſtonné de vostre maladie, Voyant qu'elle s'accroit lors qu'on y remedie, Voſtre oncie qui n'eſt plus qu'vn corps demy viuât, Ne ſe peut conſeruer, ſinon en vous ſauuant, On dit puhliquement, que ce n'est que triſteſſe, Que quelque desplaiſir dedans l’ame vous preſſe, Faut-il qu'vn deſpleiſir ſoit en vous ſi puiſſant Qu'il vous porte au deſir de vous voir languiſſant;	81 Voulez-vous donc laisser votre âme enseuelie Dans les noires vapeurs de la mélancolie, Et pour quelque chagrin conçu légèrement, Ruiner votre estime, et votre jugement, Chaqu'un est estonné de votre maladie, Voyant qu'elle s'accroît lors qu'on y remédie, Votre oncie qui n'est plus qu'à corps demi viuât, Ne se peut conserver, sinon en vous sauvant, On dit puhliquement, que ce n'est que tristesse, Que quelque déplaisir dedans l'âme vous presse, Faut-il qu'un dess soit en vous si puissant Qu'il vous porte au désir de vous voir languissant;
Non, non, braue Alidor, forcez ceſte manie, Chaſſez les mouuemens d’vn ſi triſte genie, Et recouurant bien toſt la force & la ſanté, Reprenez voſtre humeur, & voſtre gayeté, Que ſi vous perſiſtez en voſtre humeur farouche, On vous laiſſera ſeul languir dans voſtre couche, Perſonne ne voudra vous voir, ny vous ouyr, Ne parlez doncques plus que de vous reſiouyr.	Non, non, brave Alidor, forcez cette manie, Chassez les mouvements d'un si triste génie, Et recouvrant bien tôt la force et la santé, Reprenez votre humeur, et ainsi gaieté, Que si vous persistez en votre humeur farouche, On vous laissera seul languir dans votre couche, Personne ne voudra vous voir, ni vous ouïr, Ne parlez donc plus que de vous réjouir.
P mquuiu	 mquuiu
ALIDOR.	ÀLIDOR.
Parfaite Calirie, adorable merueille, Dõt le prudẽt diſcours, tout d’vn coup me reſueille, Et tire mes esprits d’vn aſſoupiſſement, Qui n'euſt iamais finy que dans le monument, Quelque iuſte triſteſſe où mon ame ſe plonge, Et de quelque ſoucy dont mon esprit ſe ronge, Que ie me trouue heureux parmy tous mes ennuis, Puis que vous me plaignez en l’eſtat out ie ſuis, Et que voſtre pitié pour moy trop fauorable, Prend part aux desplaiſirs d’vn hõme miſerable, Si vous ſçauiez pourtant quelle iuſte raiſon Me fait chercher ma mort, & non ma gueriſon, Vous diriez qu'Alidor eſt digne du tonnerre, Qu'il ne merile puruiomurenei ſui la terre, Et qu'il deuoit mourir dés le premier moment Nraeja;	Parfaite Calirie, adorable merveille, Domme le prudẽt discours, tout d'un coup me réveille, Et tire mes esprits d' assoupissement, Qui n'eût jamais fini que dans le monument, Quelque iuste tristesse où mon âme se plonge, Et de quelque souci dont mon esprit se ronge, Que je me trouve heureux parmi tous mes ennuis, Puis que vous me plaignez en l'état ou ie suis, Et que vôtre pitié pour moi trop fauorable, Prend part aux y hõme misérable, Si vous y pourtant quelle iuste raison Me fait chercher ma mort, et non ma guérison, Vous diriez qu'Alidor Et digne du tonnerre, Qu'il ne merile puruiomurenei zvi la terre, Et qu'il deuoit mourir dés le premier moment Nraeja;
CALIRIE.	CALIRIE.
Pourſuiuez, ne craignez nullement.	Poursuivez, ne craignez nullement.
ALIDOR.	ÀLIDOR.
Alidor que fais-tu, penſe à ton infortune Elle eſt particuliere, & tu la rends commune:	Alidor que fais-tu, pense à ton infortune Elle est particulière, et tu la rends commune:
Beauté qui pouuez tout, accordez-moy ce point, Que siteſtcommente, ie ne t'atnene point.	Beauté qui pouvez tout, accordez-moi ce point, Que sitestcommente, toujours ne t'atnène point.
CALIRIE.	CALIRIE.
Vous voila retombé dans vostre reſuerie, Il vous faut diuertir,	Vous voilà retombé dans votre rêverie, Il vous faut divertir,
ALIDOR.	ÀLIDOR.
Aimable Calirie, L’honneur de vous parler, de vous voir ſeulement, Surpaſſe le plaiſir du diuertiſſement, Vn regard de vos yeux, vn mot de voſtre bouche Me peuuent releuer de ceste triſte couche, Vous ſeule pouuez plus que tous les Medecins, Qui nous voulans guerir deuiennent aſſaßins.	Aimable Calirie, L'honneur de vous parler, de vous voir seulement, Surpasse le plaisir du divertissement, Un regard de vos yeux, un mot de votre bouche Me peuvent relever de cette triste couche, Vous seule pouvez plus que tous les Médecins, Qui nous voulant guérir deviennent assassins.
CALIRIE.	CALIRIE.
Si par mon entretien, & ſi par mes viſites Vous pouuez Alidor, guerir comme vous dites, I'eſpere en peu de temps de vous voir en ſanté:	Si par mon entretien, et si par mes visites Vous pouvez Alidor, guérir comme vous dites, J'espère en peu de temps de vous voir en santé:
Repoſez là deſſus.	Reposez là -dessus.
ALIDOR lors qu’on cache le lict.	ÀLIDOR lors qu'on cache le lit.
O Cienque ut vonte.	Ô Cienque ut vonte.
Oronte, Oronte, quel moyen de pouuoir recognoiſtre Eere eserremnte amtete que tu pie jais paroijtre.	Oronte, Oronte, quel moyen de pouuoir reconnaître Éère éerremnte amie que tu pie jais paraître.
CALIRIE ſeule.	CALIRIE seule.
Ou ie me trompe fort, ou i’ay bien recognu La nature du mal dont il eſt detenu, Tous ces begayemens, ces tranſports, ces œillades Ne ſont pas accidẽs communs aux corps malades, Mais quoy qu’il en puiſſe eſtre, il faut continuër Iuſqu'à ce que ſon mal vienne à diminuër, Alors ayant parfait ce que demande Oronte, Ie luy teſmoigneray qu'il a mal fait ſon conté, Et que ſans l’amitié que ſon oncle a pour luy, I'aurois ſans me faſcher ſupporté ſon ennuy:	Ou personne me trompe fort, ou j'ai bien reconnu La nature du mal dont il est détenu, Tous ces begayemens, ces transports, ces œillades Ne sont pas accids communs aux corps malades, Mais quoi qu’il en puisse être, il faut continuer Jusqu'à ce que son mal vienne à diminuer, Alors ayant parfait ce que demande Oronte, Je lui témoignerai qu'il a mal fait son conté, Et que sans l'amitié que son oncle à pour lui, J'aurais sans me fâcher supporté son ennui:
Mais que ne peut Oronte, à qui dés mon enfance I'ay ſur mes volontez donné toute puiſſance.	Mais que ne peut Oronte, à qui dès mon enfance J'ai sur mes volontés donné toute puissance.
.	.
.	.
2 - 2	2 - 2
ACTE SECOND.	ACTE SECOND.
SCENE I.	SCÈNE I.
CINTILLE ſous le nom d’Alcandre.	CINTILE sous le nom d'Alcandre.
ORCAN vieux Gentil-homme qui l’accompagne.	ORCAN vieux Gentilhomme qui l'accompagne.
CINTILLE.	CINTILE.
Ay bien changé de lieu, mais le meſme ſoucy Qui me troubloit chez moy, m'afflige encore icy.	Ai bien changé de lieu, mais le même souci Qui me troublait chez moi, m'afflige encore ici.
I’ay bien changé d’habit, mais non pas de fortune, Puis que la meſme ardeur encore m'importune,	J'ai bien changé d'habit, mais non pas de fortune, Puis que la même ardeur encore m'importune,
aa la dll a la las Que i'ay dedans le ſein, cét ennemy cruel Out me rend en tous lieux le mal continuel.	à la dll a la las Que j'ai dedans le sein, cet ennemi cruel Ut me rend en tous lieux le mal continuel.
2 Dieu dont la prouidence entretient toutés choſes, Qui des biens & des maux à ton plaiſir diſpoſes, As-tu fait noſtre ſexe ainſi foible & craintif.	2 Dieu dont la providence entretient toutés choses, Qui des biens et des maux à ton plaisir disposes, As-tu fait notre sexe ainsi faible et craintif.
Pour le tenir touſiours iniuſtement captif, L’as-tu fait ſans defenſe, afin qu'il ſoit la proye De ces monſtres cruels qui nous priuent de ioye De ces hommes ingrats, dont l’affront violent S’eſt acquis deſſus nous vn empire inſolent, Et bien ſi tu l’as fait, auecquelle tuſtice Es-tu noſtre ennemy, pour leur eſtre propice, Et pourquoy ſouffres-tu que nos yeux, & nos cœurs Seliguent contre nous pour ſuiure ces vainqueurs Nous trouuons de douceurs en ces tyrans infames Et nommons nos ambles pourreaux de nos ames Nous les aimons alors qu’ils nous peuuent hayr, Et nous fions en ceux qui nous veulent trahyr.	Pour le tenir toujours injustement captif, L'as-tu fait sans défense, afin qu'il soit la proie De ces monstres cruels qui nous privent de joie De ces hommes ingrats, dont l'affront violent S'est acquis dessus nous un empire insolent, Et bien si tu l'as fait, avecquelle tustice Es-tu notre ennemi, pour leur être propice, Et pourquoi souffres-tu que nos yeux, et nos cœurs Seliguent contre nous pour suivre ces vainqueurs Nous trouvons de douceurs en ces tyrans infâmes Et nommons nos ambles pourreaux de nos âmes Nous les aimons alors qu'ils nous peuuent haïr, Et lors fions en qu' ils nous veulent trahir.
ORCAN.	ORCAN.
Madame, où penſez-vous, finiſſez vos ſaillies, Da Les Dieux n'ont point de part en toutes vos folies, Leur prouidence eſt grande agiſſant deſſus nous, L'our va nomme trompeur ne iey otaſmez pas tous.	Madame, où pensez-vous, finissez vos saillies, Da Les Dieux n'ont point de part en toutes vos folies, Leur providence est grande agissant dessus nous, L'our va nomme trompeur ne Ami otismez pas tous.
CINTILLE.	CINTILE.
Orcan, que puis-ie faire, Alidor m'a ſeduite, I’ay quitté mon pays pour arreſter ſa fuite, I’ay laißé mes parens, oublie mon deuoir, Pour auoir le bon heur encoré de le voir:	Orcan, que puis-je faire, Alidor m'a séduite, J'ai quitté mon pays pour arrêter sa fuite, J'ai laissé mes parents, oublie mon devoir, Pour avoir le bon heur encoré de le voir:
ismon s eſt eycoutu acpuinojtre ay vince, Et ie me vois pourtant de ce bon heur priuée.	Xmon s' est eycoutu acpuinaître ai vince, Et personne me vois pourtant de ce bon heur privée.
JRCAN.	JRCAN.
Vne melancholie, à ce que l’on m'adit, Le tient depuis long temps malade dans vn lit, Sans qu'on puiſſe donner vne cauſe certaine Du cruel defplaiſir, dont s’entretient ſa peine, Peur eapre le remura qut jun amt reeh D’auoir quitté vos yeux le rend ſi languiſſant, Et l'on le peut iuger auec queique apparence.	Une mélancolie, à ce que l'on m'adit, Le tient depuis long temps malade dans un lit, Sans qu'on puisse donner une cause certaine Du cruel déplaisir, dont s'entretient sa peine, Peur eapre le remura qu' un amt reeh D'avoir quitté vos yeux le rend si languissant, Et l'on le peut juger avec queique apparence.
CINTILLE.	CINTILE.
Ah!	Ah!
ne me flatte point d’vne telle esperance.	ne me flatte point d'une telle rance.
ORCAN.	ORCAN.
Il faut voir Florintor, qui m’a deſia promis.	Il faut voir Florintor, qui m'a déjà promis.
Qii vous te feron vour ſi ioſt qu'il ſoit remis.	Ai vous te feron vour si tôt qu'il soit remis.
LINTILLE.	LINTILE.
Mais il est amoureux ſi fort de Meliſſee, Qu'il porte rarement autre part ſa penſee.	Mais il est amoureux si fort de Mélisse, Qu'il porte rarement autre part sa pensée.
Le voicy, ORCAN.	Le voici, ORCAN.
CINLILLE.	CINLILE.
Florintor.	Florintor.
FLORINTOR.	FLORINTOR.
Ie vous allois chercher, Alidor auiourd’huy commence de marcher, Ie le viens de quitter fort ſatisfat uupprendre, Qu’il eſtoit cher encor au ſouuenir d’Alcandre, Et ne tiendra qu'a vous que vous ne le voyez.	Je vous allais chercher, Alidor aujourd'hui commence de marcher, Je le viens de quitter fort satisfat upprendre, Qu'il était cher encor au souvenir d'Alcandre, Et ne tiendra qu'a vous que vous ne le voyez.
DINTILLE.	DINTILLE.
I'estime maintenant vos ſoins bien employez.	J'estime maintenant vos soins bien employés.
Allons-y,	Allons-y,
LORINTOR.	LORINTOR.
vous voyez auparauant la belle, e v l7.	vous voyez auparavant la belle, e v l7.
* D iii Qui depuis ſi long temps ſe monstre ſi cruelle, Et nous viſiterons Alidor ſur le ſoir, Aaujatuienne peutxona ceſte Deure le voir.	* D Di Qui depuis si long temps se montre si cruelle, Et nous visiterons Alidor sur le soir, Aaujatuienne peutxona cette Deure le voir.
TILLE.	TILLE.
Allons ſi vous croyez que ie vous ſois vtile.	Allons si vous croyez que ici vous sois utile.
FLORINTOR.	FLORINTOR.
Ie croy que vos diſcours me la rendront facile.	Je crois que vos discours me la rendront facile.
ACTE SECOND.	ACTE SECOND.
SCENE II.	SCÈNE II.
MELTSSEE ſeule.	MELTSE seule.
Y Ne ſecrette ardeur ſe gliſſe dans mes os, Qui me gaſte l’esprit, & m'oſte le repos.	Y Ne secrète ardeur se glisse dans mes os, Qui me gâte l'esprit, et m'ôte le repos.
Que fais-tu, ma raiſon, ſerois-tu bien laſſeé De regler les transports qui troublent Meliſſee.	Que fais-tu, ma raison, serais-tu bien lasseé De régler les transports qui troublent Mélisse.
Non, nõ, viens empeſcher que ce laſche vainqueur Te chaſſant de chez moy ne me gaigne le cœur, Que dis-ie qu'il ne gaigne, il le tient, il l’emporte, Et pour luy reſiſter tu n’es pas aſſez forte, Ceſte ieune beaute, ceſte aimable douceur, Que fait voir à mes yeux ce nouueau rauiſſeur, Ce teint pareil aux fleurs que l’õ n'a point touchees,	Non, non, viens empêcher que ce lâche vainqueur Te chassant de chez moi ne me gagne le cœur, Que dis-je qu'il ne gagne, il le tient, il l'emporte, Et pour lui résister tu n'es pas assez forte, Cette jeune beau, cette aimable douceur, Que fait voir à mes yeux ce nouveau ravisseur, Ce teint pareil aux fleurs que l'on n'a point touchées,
Et mille autres beautez en ſon esprit cachees, Me rauiſſent les ſens, & forcent ma raiſon D’adorer ſon vainqueur, & d’aimer ma priſon, Reprens, reprens tes ſens, force ceste manie, Reiette les conſeils d’vn ſi mauuais genie, Mets-toy deuant les yeux l’humeur des ieunes gens, Qui ſe voyans aimez font plus de ſobligeants, Ce n'eſt qu'vn eſtranger de qui la vaine gloire Mespriſera peut-eſtre vne telle victoire, Et s’il eſt engagé, ſon inſolent meſpris Luy fera negliger le cœur qu’il aura pris, Inutiles penſers, images effacées Par celles que l’amour a dans mon cœur tracées, Foibles reſſentimens ne me reſiſtez plus, Voſtre deſir eſt vain, vos efforts ſuperflus.	Et mille autres beautés en son esprit caches, Me ravissent les sens, et forcent ma raison D'adorer son vainqueur, et d'aimer ma prison, Reprends, reprens tes sens, force cette manie, Rejet les conseils d'un si mauvais génie, Mets-toi devant les yeux l'humeur des jeunes gens, Qui se voyant aimez font plus de sobligeants, Ce n'est qu'un étranger de qui la vaine gloire Mesprisera peut-être une telle victoire, Et s'il est engagé, son insolent mépris fera négliger le cœur il a pris, Né pensersgimages effacées Par celles que amour a dans le cœur tracées, Foibles ressentimens ne me résistez plus, Et forest vain, l' efforts ur.
L’adorable ſuiet de mon inquietudé A de perſections, qui ſont tout mon eſtude, Qui ſont tout mõ bonheur, ma raiſon & mes ſoins, Inſenſibles objets, vous en eſtes teſmoins, Ie ne l’ay dit qu'à vous, car mon ardeur ſecrette	L'adorable sujet de mon inquiétudé À de perséctions, qui sont tout mon étude, Qui sont tout mon bonheur, ma raison et mes soins, Insensibles objets, vous en êtes témoins, Je ne l'ai dit qu'à vous, car mon ardeur secrète
N'a	N'a
N’a point les mouuemens de ma flame indiſcrette.	N'a point les mouvements de ma flamme indiscrète.
O Dieux!	Ô Dieux!
ie ſuis ſurpriſe, aſſeurons nos ecprits, Et les forçons à feindre encore qu’ils ſoient pris, I'oy venir quelques-vns, l’agreable viſite, Si cét autre importun n'eſtoit pas de ſa ſuite, N’importe ie feindray d’auoir pitié de luy, Et d’eſtre reſoluë à finir ſon ennuy:	Que suis surprise, assurons nos ecprits, Et les forçons à feindre encore qu'ils soient pris, J'ois venir quelques-uns, l'agréable visite, Si cet autre importun n'était pas de sa suite, N'importe autre feindrai d'avoir pitié de lui, Et d'être résolue à finir son ennui:
Mais de façon pourtant que le diuin Alcandre, S’il ne manque d’esprit, me pourra bien entendre.	Mais de façon pourtant que le divin Alcandre, S'il ne manque d'esprit, me pourra bien entendre.
ACTE SECOND.	ACTE SECOND.
SCENE III.	SCÈNE III.
TLORINTOR.	TLORINTOR.
CINTILLE.	CINTILE.
NIELISSEES	NIELISESES
FLORINTOR.	FLORINTOR.
Adame, pardonnez ceſte inciuilité, Puis qu'elle ne nous vient que de voſtre beauté.	Adame, pardonnez cette incivilité, Puis qu'elle ne nous vient que de votre beauté.
Nous auons diuerty l’aimable reſuerie, Qui vous entretenoit dans ceſte galerie:	Nous avons diverti l'aimable rêverie, Qui vous entretenait dans cette galerie:
3 Mais l’amour dans mon ſein est pour vous ſi puiſſant, Que loin de vos beaux yeux ie meurs en languiſſant, Et pour ceſte raiſon, ie me croirois coupable Des crimes dont iamais vn homme fuſt capable, Si ie laiſſois paſſer la moindre occaſion De monſtrer quelque effect de mon affection;	3 Mais l'amour dans mon sein est pour vous si puissant, Que loin de vos beaux yeux mis meurs en languissant, Et pour cette raison, je me croirais coupable Des crimes dont jamais un homme fut capable, Si tu laissois passer la moindre occasion De montrer quelque effet de mon affection;
Quoy que depuis deux ans que ma paßion dure, 35 Vous ayez ry touſiours des tourmẽs que i’endure, Que voſtre cruauté ne m'ayt point fait de iour Pour donner quelque eſpoir à mon fidelle amour.	Quo que depuis deux ans que ma passion dure, 35 Vous ayez ry toujours des tourments que j'endure, Que votre cruauté ne m'ait point fait de jour Pour donner quelque espoir à mon fidèle amour.
MELISSEE.	MELISEE.
Les bommes, Florintor, ont certaine ſcience A feindre leurs tranſports, & leur impatience Que nos foibles eſprits peuuent malaisément Aſſeoir ſur leurs diſcours vn foible iugement, C’eſt pourquoy, Florintor, de peur d’eſtre ſurpriſe Ie ry de vos diſcours, & de voſtre entrepriſe, Et ſi vous me voulez obliger deſormais, Lors que vous me verrez ne m'en parlez iamais, C'eſt trop m’importuner de vos chimeres vaines, Trop me rompre l’eſprit de vos maux, de vos chaiſ	Les bommes, Florintor, ont certaine science À feindre leurs transports, et leur impatience Que nos faibles esprits peuvent malaisément Asseoir sur leurs discours un faible jugement, C'est pourquoi, Florintor, de peur d'être surprise Je ri de vos discours, et de votre entreprise, Et si vous me voulez obliger désormais, Lors que vous me verrez ne m'en parlez jamais, C'est trop m'importuner de vos chimères vaines, Trop me de vos esprit de vos chais, de vos chais
CINTILLE.	CINTILE.
nes.	nés.
Meliſſee, ah!	Mélissee, ah!
c'eſt trop, retractez, retractez,	c'est trop, rétractez, rétractez,
E u En faueur d’vn Amant ces grandes cruautez Ne de ſesperez point vn homme dont la flâme Eſt toute de respect, toute exempte de blâme, Qui vous aime ſi fort, que deux ans de mespris N’ont encore changé ſes amoureux eſprits, Il a de qualitez ſi belles, & ſi rares, Qu'il ſe feroit aimer des ames plus barbares, meje te decenbauun pan ſiuumomme volis, Ie vous diſputerois vn entretien ſi doux.	 Eu En faveur d'HanNant ces grandes cruautés Ne de sespérez point un homme dont la flamme Est toute de respect, toute exempte de blâme, Qui vous aime si fort, que deux ans de mépris N'ont encore changé ses amoureux esprits, Il a de qualités si belles, et si rares, Qu'il se ferait aimer des âmes plus barbares, me te decenbauun pan siuumomme volis, Je vous disputerais un entretien si doux.
MELISSEE.	MELISEE.
Vous ne le faites voir auecques tant de charmes, Qu’enfin vous me pourriez faire rendre les armes, Et bien, bien Florintor, eſperez en vos feux, Puis qu’vn ſecõdl ſi fort ſe viẽt ioindre à vos vœux.	Vous ne le faites voir auecques tant de charmes, Qu'enfin vous me pourriez faire rendre les armes, Et bien, bien Florintor, espérez en vos feux, Puis qu'un secondl si fort se vie ioindre à vos vœux.
PMORINPOR.	PMORINPOR.
O bien-heureux Amant, pourueu que Meliſſee, Auec ce peu de mots explique ſa penſee.	Ô bienheureux Amant, pourvu que Mélissee, Avec ce peu de mots explique sa pensée.
MELISSEE.	MELISEE.
Mais vous, dõt les diſcours monſtrẽt à deſcouuert, Que d’vn trait amoureux voſtre cœur eſt ouuert, Ie croy que la beauté, qui de vous eſt ſeruie, Paſſe en vos entretiens vne fort douce vie, Et que d’vn meſme coup tous vos deux cœurs bleſE bhreciproque amon ſe jont retompenjez.	Mais vous, dont les discours montrent à découvert, Que d'un trait amoureux votre cœur est uert, Je crois que la beauté, qui de vous est servie, Passe en vos entretiens fort douce vie, Et que d'un même coup tous vos deux cœurs blesE bhreciproque amon se jont retompensés.
CINTILLE.	CINTILE.
Que vous renouuelez vne playe indicible, La cruelle, au contraire, eſt du tout inſenſible, Elle me fait ainſi qu'vn cruel ennemy, Et ne m'a point encor eſcoûté qu'à demy, C’eſt elle qui m’a fait errer ſans eſperance, Et dont les cruautez m'ont fait venir en Prance, Mais, Madame, laiſſons cét entretien faſcheux.	Que vous renouverez une plaie indicible, La cruelle, au contraire, est du tout insensible, Elle me fait ainsi qu'un cruel ennemi, Et ne m'a point encor écouté qu'à demi, C'est elle qui m'a fait errer sans espérance, Et dont les cruautés m'ont fait venir en Prance, Ma, Dame, laissons cet entretien fâcheux.
MELISSEE.	MELISEE.
Les hommes plus aimez ſe feignent malheureux, Et quoy que vous diſiez vous auez quelque grace Capable d’eſchaufer les marbres & la glace, Et c’eſt trop affecter ceſte ſeuerité, Que de vouloir parler contre la verité, Et n'imaginez pas que ie vous tienne quitte, Lors que vous m’aurez dit ſon nõ, & ſon merite, Si vous eſtes courtois, vous nous direz encor Quel eſt l’heureux pays qui gartuinreſor.	Les hommes plus aimés se feignent malheureux, Et quoi que vous disiez -vous avez quelque grâce Capable d'échauffer les marbres et la glace, Et c'est trop affecter cette sévérité, Que de vouloir parler contre la vérité, Et n'imaginez pas que je vous tienne quitte, Lors que vous m'aurez dit son nom, et son mérite, Si vous êtes courtois, vous nous direz encor Quel est l'heureux pays qui gartuinres.
CINTILLE.	CINTILE.
xrradame,tacujea’moy, ſrie vons le reſnſe.	Uxradame,tacujea’-moi, srie vons le rênse.
FLORINTOR.	FLORINTOR.
Non, non, Alcandre, non, ne cherchez point d’excuſe, Accordez, s’il vous plaiſt, à nos iuſtes deſirs Le recit de vos maux, & de vos deſplaiſirs, y enx errerer pea a vnt ounenererue, Qu'vn refus deuiendroit vne offenſe mortelle.	Non, non, Alcandre, non, ne cherchez point d'excuse, Accordez, s'il vous plaît, à nos justes désirs Le récit de vos maux, et de vos déplaisirs, y enx errer pérer a vnt ounenererue, Qu'à -fus deviendrait une offense mortelle.
CINTILLE.	CINTILE.
Et bien quand ie deurois ſouffrir mille tourmens Au recit malheureux de mes feux vehemens, Ie vous feray ſçauoir que lle fuſt leur naiſſance, Et qui ſont les beaux yeux dont ie ſens la puiſſance.	Et bien quand ici devrais souffrir mille tourments Au récit malheureux de mes feux vehemens, Je vous fera y que fût leur naissance, Et qui sont les beaux yeux dont toutes sens la puissance.
NALLTOGEC.	NALTOGEC.
Nous ſerons dans ma chambre auec plus de repos, Perſonne n'y viendra rompre noſtre propos.	Nous serons dans ma chambre était plus de repos, Personne n'y viendra rompre notre propos.
CINTILLE tout bas.	CINTILE tout bas.
Il ſera bien aisé d’inuenter quelque ſonge, Et de couurir mes feux de l’ombre du menſonge.	Il sera bien aisé d'inventer quelque songe, Et de couvrir mes feux de l'ombre du mensonge.
F2 – 1 --e ſc	F2 4 1 aise sc
ACTE SECOND.	ACTE SECOND.
SCENE IV.	SCÈNE IV.
ORONTE.	ORONTE.
ALIDOR.	ÀLIDOR.
ORONTE ſeul.	ORONTE seul.
Nn’a iamais parlé de ſemblable malheur, Ie trauaille moy-meſme à nourrir ma douleur, Ie ſuis ingenieux à chercher mon dommage, Et fais des coups de fou pour me mõſtrer trop ſage, N'eſt-ce pas eſtre fou de faire des efforts De conſeruer autruy pour ſouffrir mille morts.	Nn’a jamais parlé de semblable malheur, Je travaille moi-même à nourrir ma douleur, Je suis ingénieux à chercher mon dommage, Et fais des coups de foulé pour me montrer trop sage, N'est-ce pas être fou de faire des efforts De conserver autrui pour souffrir mille morts.
Car de quelque façon que mon ſoin reußiſſe, Ie voy touſiours ouuert pour moy le precipice, Si Calirie l’aime & finit ſon tourment, Ie ne ſouffriray pas vne mort ſeulement, Que ſi ceſte amitié qu'elle m'a tant iurée, Au malheur d’Alidor la rendoit coniurée, Que deuiendrois-ie, ô Dieux!	Car de quelque façon que mon soin reussisse, Je vois toujours ouvert pour moi le précipice, Si Calirie l'aime et finit son tourment, Je ne souffrirai pas une mort seulement, Que si cette amitié qu'elle m'a tant jurée, Au malheur d'Alidor la rendait conjurée, Que deviendrais-je, ô Dieux!
ſi ie voyois perir Celuy que de mon ſang ie voudrois ſecourir, Que de confuſionmet l’amour dans mon ame, Ie voudrois conſeruer Alidor, & ma flame, Et ie me voy contraint de perdre l’vn des deux, Ie puis ſauuer pourtant en moy-meſme mes feux, Encore qu'Alidor espouſe Calirie, Le voicy tout plongé dedans ſa reuerie.	si ici voyais périr Celui que de mon sang ie voudrais secourir, Que de confusionmet l'amour dans mon âme, Je voudrais conserver Alidor, et ma flamme, Et ainsi me vois contraint de perdre l'un des deux, Je puis sauver pourtant en moi-même mes feux, Encore qu'Alidor épouse Calirie, Le voici tout plongé dedans sa rêverie.
ALIOOR.	ÀLIOR.
Mon pere ie voy bien que vos ſoins ſuperflus, Selon voſtre defir ne me ſecourent plus, Depuis que Calirie a veu que la triſteſſe Abandonnoit mon ame, & mon corps ſa foibleſſe Ses viſites ſoudain rares, ou ſans effet, M’ont fait eſperer peu de tout ce qu'elle a fait, L’amour qu'elle a pour vous occupe ſa penſee, Et la rend à mes feux entierement glacee, que efe uannuo uejfamnue finir voſtre peine.	Mon père femme vois bien que vos soins superflus, Selon votre désir ne me secourent plus, Depuis que Calirie a vu que la tristesse Abandonnait mon âme, et mon corps sa faiblesse Ses visites soudes rares, ou sans effet, M'ont fait espérer peu de tout ce qu'elle a fait, L'amour qu'elle a pour vous occupe sa pensée, Et la rend à mes feux entièrement glacée, que vos soins uejfamnue finir votre peine.
MELISSEE.	MELISEE.
Penſez à mettre fin à vos maux ſeulement, Sans vous trauailler plus de ſon contentement:	Pensez à mettre fin à vos maux seulement, Sans vous travailler plus de son contentement:
Adieu, ma flâme, helas!	Adieu, ma flamme, hélas!
eſt-ce à ce poinct venuë, Qu'elle ne ſçauroit plus auoir de retenue, I'espere tout, & crains encore tout außi Que ce nouuel amour me donne de ſoucy.	est-ce à ce point venue, Qu'elle ne saurait plus avoir de retenue, J'espère tout, et crains encore tout aussi Que ce nouvel amour me donne de souci.
ACTE TROISIESME.	ACTE -TROISIÈME.
SCENE I.	SCÈNE I.
CALIRIE.	CALIRIE.
ORONTE.	ORONTE.
CALIRIE ſeule.	CALIRIE seule.
L 6 Ay mandé cét ingrat, ce traiſtre abominable:	 6 Ai mandé cet ingrat, ce traître abominable:
8 [Mais il ne viendra pas puis qu'il ſe cruil coupavie, Le voicy toutesfois qui fait bien l’afſligé, On diroit à le voir qu'il en ſoit tout changé.	8 [Mais il ne viendra pas puis qu'il se cruil coupavie, Le voici toutefois qui fait bien l'afsgligé, On dirait à le voir qu'il en soit tout changé.
ONTE.	ONTE.
Qus veut ma belle fille à ſon fidelle Oronte.	Quus veut ma belle fille à son fidèle Oronte.
CALIRIE.	CALIRIE.
Voir ſi ſa trahiſon luy donne quelque honte, Mais ie voy bien que non, il eſt trop aſſeuré, Encores que le crime en ſoit tout aueré, Tu n’eſtois pas content de m'auoir abuſee, Lors qu'vn gage innocent me rendoit moins ruſeo, Tu m'as voulu monſtrer, que me fiant à toy, Tu prendrois bien le temps de te mocquer de moy, Tu l’as fait, ame ingrate, ame noire, & pariure:	Voit si sa trahison lui donne quelque honte, Mais ie vois bien que non, il est trop assuré, Encores que le crime en soit tout averé, Tu n'étais pas content de m'avoir abusée, Lors qu'un gage innocent me rendait moins ruse, Tu m'as voulu montrer, que me fiant à toi, Tu prendrois bien le temps de te moquer de moi, Tu l'as fait, âme ingrate, âme noire, et parjure:
Mais tu ne m'as pas fait vne petité iniure, Au moins ſi tu pouuois me dire vne raiſon Qui peut faire excuſer ta lâche trahiſon, Si i’eſtois criminelle en ton endroit, infame, Si i'auois mesprisé ton merite, ou ta flâme, Si ie t'auois hay, ſi i’auois fait effort, En faignant de t’aimer, & te donner la mort, Ie dirois en moy-meſme, Oronte ſe retire Auecques des raiſons que ie n'oſerois dire;	Mais tu ne m'as pas fait une petité injure, Au moins si tu pouuois me dire une raison Qui peut faire excuser ta lâche trahison, Si j'étais criminelle en ton endroit, infâme, Si j'avais méprisé ton mérite, ou ta flamme, Si trouver t'avais ha, si j'avais fait effort, En faites de t'aimer, et te donner la mort, Je dirais en moi-même, Oronte se retire Avecques des raisons que je n'oserais dire;
Mais ſi ma paßion a ſuiuytes deſirs, Sii ay participé dans tous tes desplaiſtrs, Si ie n'ay rien aimé que toy dans la nature, d le -	Mais si ma passion a suiuytes désirs, Sii ai participé dans tous tes desplaistrs, Si Dieux n'ai rien aimé que toi dans la nature, dès le -
Si i’ay creu ton amour, ma plus grande aduanture, N'es-tu pas bien meſchant de me vouloir offrir En victime à celuy que ie ne puis ſouffrir, Tu ſçais depuis long temps que ſon entretien meſme Me donnoit tous les iours vn desplaiſir extreſme, Et qu'estant auec luy, quelque grace qu’il euſt, Ie n'y trouuay iamais action qui me pleusf;	Si j'ai cru ton amour, ma plus grande aventure, N'es-tu pas bien méchant de me vouloir offrir En victime à celui que je ne puis souffrir, Tu sais depuis long temps que son entretien même Me donnait tous les jours un déplaisir extrême, Et qu'étant auecjours, quelque grâce qu'il eût, Je n'y trouvai jamais action qui me pleusf;
Toutes fois ennemy du repos de mon ame, Tu fais ce que tu peux pour me rendre ſa femme.	Toutes fois ennemi du repos de mon âme, Tu fais ce que tu peux pour me rendre sa femme.
Non, non, que tous les Dieux ſecõdent ton deſſein, Alidor n'entrera iamais dedans mon ſein, Et toy dont les diſcours ont trahy ma franchiſe, Dont la fauſſe amitié m'a laſchement ſur priſe, Sçache que tu m'as plus obligée auiourd’huy Que tu n'as creu me nuire en me donnant à luy, Monesprit détrompé ne ſera plus capable Ce crotre rien en moy qui me peut rendre aimable, Ainſi me defiant des hommes deſormais, Ie viur ay touſiours libre & n'aimeray iamais.	Non, non, que tous les Dieux secondent ton dessein, Alidor n'entrera jamais dedans mon sein, Et toi dont les discours ont trahi ma franchise, Dont la fausse amitié m'a lâchement sur prise, Sçache que tu m'as plus obligée aujourd'huire Que tu n'as cru me nuire en me donnant à La, Monesprit détrompé ne sera plus capable Ce crois rien en moi qui me peut rendre aimable, Ainsi me défiant des hommes désormais, Je vivr ait toujours libre et n'aimerai jamais.
ORONTE demeure ſeul.	ORONTE demeure seul.
Tu t’en vat, Calirie, apres vn tel reproche, Et laiſſes ton Oronte außi froid qu'vne roche, Va, fuy, fuy cét ingrat, tu le fuis iuſtement, I'ay trahy ton amour, & mon contentement, Fuy, fuy ce malheureux qui ne te peut respondre, Mon ſeul reſſentiment ſuffit à me confondre, Ie ſuis plus criminel que tu ne me fay pas, Et pour me bien punir, c’eſt peu que le treſpas, Il me faut inuenter des tortures nouuelles, Qui me faiſant ſouffrir ne me ſoient pas mortelles, Afin que languiſſant, & touſiours malheureux, Ie ſois vn triſte exemple aux laſches amoureux.	Tu t'en vat, Calirie, après un tel reproche, Et laisses ton Oronte aussi froids qu'une roche, Va, fui, fuis cet ingrat, tu le fuis jus,QU'ai trahi ton amour, et mon contentement, Fuy, fuite ce malheureux qui ne te peut répondre, Mon seul ressentiment suffit à me confondre, Je suis plus criminel que tu ne me fais pas, Et pour me bien punir, c'est peu que le trépas, Il me faut inventer des tortures nouvelles, Qui me faisant souffrir ne me soient pas mortelles, Afin que languissant, et toujours malheureux, Il sois triste exemple aux lâches amoureux.
ACTE TROISIESME.	ACTE -TROISIÈME.
SCENE II.	SCÈNE II.
CINTILLE ſous le nom d’Alcandre.	CINTILE sous le nom d'Alcandre.
ORCAN ſon conſident, Page de MELISSEE.	ORCAN son consident, Page de MELISE.
CINTILLE.	CINTILE.
Oy qui ſçais les ſecrets de toute ma diſgrace, Qui cognois mon amour, qui ſçais ce qui ſe paſſe, Que dois-ie deuenir, i’ay veu l’objet aimé:	Oi qui sais les secrets de toute ma disgrâce, Qui connais mon amour, qui sais ce qui se passe, Que dois-je devenir, j'ai vu l'objet aimé:
Mais plus froid mille fois qu'vn corps deſ-animé, Il a quitté le lict, & ſa melancholie --- O- --- Le porte bien ſouuent à de traits de folie, Il m'a fait vn accueil aſſez extrauagant, Bien qu’il ne m’ayt rien dit qui ſentit l’arrogant, Non pas que me croyant touſiours eſtre mon frere, Il n'ayt de complimens voulu me ſatisfaire, Quoy qu’il fuſt bien ſouuent ſurpris d’eſtonnemẽt, Et reſtaſt quelque fois ſans voix, ny mouuement, Qu'apres ſeuamununt u fet porr ſa penſee Eſtre diuerſement deſſus moy balancee.	Mais plus froid mille fois qu'un corps des-animé, Il a quitté le litt, et sa mélancolie -à- Ô- a- Le porte bien souvent à de traits de folie, Il m'a fait un accueil assez extravagant, Bien qu'il ne m'ait rien dit qui sentit l'arrogant, Non pas que me croyant toujours été mon frère, Il n'ait de compliments voulu me satisfaire, Quoi qu'il fût bien souvent surpris d'estonnemẽt, Et restât quelque fois sans voix, ni mouuement, Qu'après seuamununt set porr sa pensée Estre sam dessus moi balancée.
RCAN.	RACN.
lt vonos a reconnue, & ſe trouuant ſurpris, Voſtre veuë a ſans doute eſtonné ſes esprits.	lt vonos a reconnue, et se trouvant surpris, Votre vue à sans doute étonné ses esprits.
LINTILLE.	LINTILE.
Nullement cét habit contraire amon olſage, La taille de mon frere, & les traits du viſage L’ont aisément trompé parmy l’obſcurité.	Nullement cet habit contraire amon olsage, La taille de mon frère, et les traits du visage L'ont aisément trompé parmi l'obscurité.
ONCAN.	ONCAN.
Vous auez, toutesfois, vn eſclat de beauté, Qui deuoit außi tost vous faire recognoiſtre.	Vous avez, toutefois, un éclat de beauté, Qui devait aussi tôt vous faire reconnaître.
CINTILLE.	CINTILE.
Ouy, s’il n’auoit pas eu l’ame, & les yeux d’vn traiſtre.	Oui, s'il n'avait pas eu l'âme, et les yeux d'un traître.
S’il n’auoit point perdu la memoire, & l’amour Dés l’heure qu’il laiſſa nos ports, & noſtre Cour;	S'il n'avait point perdu la mémoire, et l'amour Dès l'heure qu'il laissa nos ports, et notre Cour;
Car ſçache que parmy les paroles courtoiſes, Qui ne manquent iamais dans les bouches Françoiſes, Et parmy l’amitié qu’il teſmoignoit d’auoir Pour mõ cher frere abſent, & qu’il croyoit deuoir, C.	Car sçache que parmi les paroles courtoises, Qui ne manquent jamais dans les bouches Françaises, Et parmi l'amitié qu'il témoignait d'avoir Pour mon cher frère absent, et qu'il croyait devoir, Ç.
iti iaiiuuie nom de Cintille à la bouche, Bien qu’à ſes complimens ie paruſſe vne ſouche.	iti iaiiuuie nom de Cintille à la bouche, Bien qu'à ses compliments ie parusse une souche.
ORCAN.	ORCAN.
Il eſt donc attaché de quelque autre lien.	Il est donc attaché de quelque autre lien.
CINTILLE.	CINTILE.
Helas!	Hélas!
mon cher Orcan, c’eſt ce que ie voy bien.	mon cher Orcan, c'est ce que je vois bien.
ORCAN.	ORCAN.
Il faut doncoublier l’ingrat qui vous oublie, El le laiſſer perir dans ja metanenolte, 2 L’amour est vn Dieu iuſte, encores qu’il ſoit lent, Et vengera bien toſt ſon meſpris inſolent.	Il faut doncoublier l'ingrat qui vous oublie, El le laisser périr dans ja metanenolte, 2 L'amour est un Dieu juste, encore qu'il soit lent, Et vengera bien tôt son mépris insolent.
CINTILLE.	CINTILE.
Ma reſolution eſt preſque ta penſee, Ie le veux oublier, puis qu’il m'a delaiſſee, Ie veux ſçauoir deuant ce qu’il a ſur le cœur, Et cognoiſtre l’objet qu’il tient pour ſon vainqueur, Tu me peux ſoulager dans ceſte inquietude, Cependant que i'iray reuoir ma ſolitude.	Ma résolution est presque ta pensée, Je le veux oublier, puis qu'il m'a délaissée, Je veux savoir devant ce qu'il a sur le cœur, Et connaître l'objet qu'il tient pour son vainqueur, Tu me peux soulager dans cette inquiétude, Cependant que j'irai revoir ma solitude.
ORCAN.	ORCAN.
Ie ſuis trop honoré de ce commandement, Pour n'aller pas veiller à voſtre allegement.	Je suis trop honoré de ce commandement, Pour n'aller pas veiller à votre allégement.
Mais que veut ceſtuy-cy.	Mais que veut celui-cy.
PAGE.	PAGE.
Axonfieur, c'eſt MIeliſſee Qui voudroit vous parler pour affaire preſſee.	Axonfieur, c'est MIélissee Qui voudrait vous parler pour affaire pressée.
CINTILLE.	CINTILE.
Ie m'en vay la trouuer tout à l’heure apres vous, Que l’amour en ce poinct ſe mocque bien de nous, Ceſte Dame en amour eſt ſi fort malheureuſe, Que me croyant Alcandre, elle en eſt amoureuſe, Et qu'eue tronut en moy de grates, et d'appas, Que tu vois qu'Alidor l’ingrat n’y trouue pas.	Je m'en vais la trouver tout à l'heure après vous, Que l'amour en ce point se moque bien de nous, Cette Dame en amour est si fort malheureuse, Que me croyant Alcandre, elle en est amoureuse, Et qu'eue tronut en moi de grates, et d'appas, Que tu vois qu'Alidor l'ingrat n'y trouve pas.
Iuge ſi ſon malheur n'eſgale pas le noſtre.	Juge si son malheur n'égale pas le nôtre.
ORCAN.	ORCAN.
Son infortune encore eſt pire que la voſtre.	Son infortune encore est pire que la vôtre.
H	H
ACTE TROISIESME.	ACTE -TROISIÈME.
SCENE III.	SCÈNE III.
MELISSEE.	MELISEE.
PAGE.	PAGE.
MELISSEE.	MELISEE.
Nutile pudeur, foible apprehenſion, 2 Qui me rendez muette en mon affection, Qui voulez retenir vn feu dans la contrainte, Sçachez que mõ amour eſt deſormais ſans crainte, Que ces reſpects qui l’ont ſi long temps enfermé, muin ceuurnue aiſtoriir b one puna pevumaitin y Alcandre preuenu de ſa premiere flâme, Ne voit point dans mes yeux le feu que i'ay dans Il l'en faut aſſeurer par des termes preſſans, Qui luy prennent le cœur, par le moyen des ſens.	Nutile pudeur, faible appréhension, 2 Qui me rendez muette en mon affection, Qui voulez retenir un feu dans la contrainte, Sachez que mon amour est désormais sans crainte, Que ces respects qui l'ont si long temps enfermé, muin ceunue aitoriir b one puna pevumaitin y Alcandre prévenu de sa première flamme, Ne voit point dans mes yeux le feu que j'ai dans Il l'en faut assurer par des termes pressants, Qui lui prennent le cœur, par le moyen des sens.
O Dieux!	Ô Dieux!
que de plaiſir, quoy que ie le preutenne, S’il vouloit égaler ſonardeur à la mienne, I a-Eil dit qu'il ſeroit en peu de temps 2y.	que de plaisir, quoi que je le préutenne, S'il voulait égaler sonardeur à la mienne, I aÉil dit qu'il serait en peu de temps 2i.
IGE.	IGE.
Ptés qu'außi toſt que moy, Madame, le voicy.	Ptés qu'avez tôt que moi, Madame, le voici.
ACTE TROISIESME.	ACTE -TROISIÈME.
SCENE IV.	SCÈNE IV.
CINTILLE.	CINTILE.
MELISSEE.	MELISEE.
CINTILLE.	CINTILE.
Nquoy puis-ie ſeruir l’aimable Meliſſee.	Noiquoi puis-je servir l'aimable Mélisse.
MELISSEE tout bas.	MELISEE tout bas.
Ha!	Ha!
que ne ſuis-ie telle au fonds de ta penſee.	que ne suis-je telle au fond de ta pensée.
CINTILLE.	CINTILE.
Ie n'en excepte rien pourueu que mon pouuoir Seconde heureuſement mes ſoins, & mon deuoir.	Je n'en excepte rien pourvu que mon pouvoir Seconde heureusement mes soins, et mon devoir.
MELISSEE.	MELISEE.
Alcandre cognoiſſant mon defaut de merité, D'abord à me ſeruir a mis vne limite, Il ne me veut ſeruir qu'autant qu’il le pourra, C’eſt à dire en vn mot autant qu’il luy plairra:	Alcandre connaissant mon défaut de mérité, D'abord à me servir a mis quelque limite, Il ne me veut servir qu'autant qu'il le pourra, C'est à dire en un mot autant qu'il avait plaira:
Mais ſi i’eſtois Cloris tout luy ſeroit poßsible, Il pourroit animer vne roche inſenſible, Il pourroit r'appeler tous les morts des enfers, Et rompre des Titans les priſons, & les fers:	Mais si j'étais Cloris tout lui serait possible, Il pourrait animer une roche insensible, Il pourrait rappeler tous les morts des enfers, Et rompre des Titans les prisons, et les fers:
Ha!	Ha!
ce n'eſt pas ainſi qu’il faut ſeruir Alcandre, Celle qui de ſon ſang voudroit bien vous defendre, Vous aimez vne ingrate, vne ame ſans pitié, Qui rit de voſtre ardeur, & de voſtre amitié, Qui maintenat, sâs doute, à quelqu'autre engagée, Se mocque auecques luy de voſtre ame affligée, Qui lors que vous pleurez contente ſes deſirs, Et relaſche ſon ame au milieu des plaiſirs.	ce n'est pas ainsi qu'il faut servir Alcandre, Celle qui de son sang voudrait bien vous défendre, Vous aimez une ingrate, une âme sans pitié, Qui rit de votre ardeur, et de votre amitié, Qui maintenat, sâts doute, à quelque autre engagée, Se moque auecques lui de votre âme affligée, Qui lors que vous pleurez contente ses désirs, Et relâche son âme au milieu des plaisirs.
CINTILLE.	CINTILE.
Voyez iuſqu'à quel poinct Alcãdre eſt mi ſerable, Puis que dans ſes meſpris ie la trouue adorable, Et que ie me croirois trop heureux ſeulement, Si mon mal luy donnoit quelque contentement, Elle ne ſonge à moy qu'auec indifference, S’il eſt encores vray que ceſte ingrate y penſe:	Voyez jusqu'à quel point Alcãdre est mi serable, Puis que dans ses mépris que la trouve adorable, Et que sans me croirais trop heureux seulement, Si mon mal lui donnait quelque contentement, Elle ne songe à moi qu'avec indifférence, S'il est encor vrai que cette ingrate y pense:
Mais ie ſçay bien que non, & ſon meſpris eſt tel, Que Mnornone ſeutement tay ſemoie vn nom mortel.	Mais ici sais bien que non, et son mépris est tel, Que Mannornone seutement tai semoie un nom mortel.
MELISSEE.	MELISEE.
Pourquoy donc l’auez-vous touſiours dans la meCINTILLE.	Pourquoi donc l'avez-vous toujours dans la meCINTILLE.
moire.	moire.
Parce qu'à l’adorer ie mets toute ma gloire.	Parce qu'à l'adorer Seigneur mets toute ma gloire.
MELISSEE.	MELISEE.
Quelque beauté qu'elle ayt, quelques charmes puiſſans, Qui ſoient ab ſolument maiſtres de tous vos ſens, Elle s’en rend indigne, & vous eſtes blaſmable, Si vous traittant ſi mal vous l’a trouuez aimable, Faites comme elle fait, vous trouuerez icy D’außi grandes beautez auec moins de ſoucy.	Quelque beauté qu'elle ait, quelques charmes puissants, Qui soient ab olument maîtres de tous vos sens, Elle s'en rend indigne, et vous êtes blâmable, Si vous traitant si mal vous l'a trouvez aimable, Faites comme elle fait, vous trouverez ici D'avez grandes beautés avec moins de souci.
CINTILLE.	CINTILE.
C’eſt me donner la mort de parler de la ſorte, L’amour que i'ay pour elle en mon ame eſt trop forte, Si vous n’auez deſſein de me deſobliger Par de pareils diſcours ceſſez de m'affliger, Et me dites enquoy vous me trouuez capablę ſ -- -------- 3 Du vous pouuoir ſeruir,	C'est me donner la mort de parler de la sorte, L'amour que j'ai pour elle en mon âme est trop forte, Si vous n'avez dessein de me désobliger Par de pareils discours cessez de m'affliger, Et me dites enquoy vous me trouvez capablę forte -à- -- 3 Du vous pouvoir servir,
MELISSEE.	MELISEE.
que vous eſtes coupable, Et que voux meritez pos enmib inſtement.	que vous êtes coupable, Et que voux mérités pô enmib instement.
CINTILLE.	CINTILE.
Puiſque Cloris le veut, c’eſt mon contentement:	Puisque Cloris le veut, c'est mon contentement:
Mais laiſſant ce diſcours, dites-moy quel affaire M'appelle auprés de vous, & ce que ie puis faire,	Mais laissant ce discours, dites-moi quel affaire M'appelle auprès de vous, et ce que donne puis faire,
MELISSEE.	MELISEE.
Quoy?	Quoi?
vous ne l’auez point cõpris en mes diſcours, Faut-il plus clairement deſcouurir mes amours, Alcandre ie vous aime, & ceſte aimable grace, Pour qui Cloris n’a rien que meſpris, & que glace, Allume dans mon ſein, malgré voſtre froideur, Vn feu qui me conſomme auecque ſon ardeur.	vous ne l'avez point confpris en mes discours, Faut-il plus clairement découvrir mes amours, Alcandre où vous aime, et cette aimable grâce, Pour qui Cloris n'a rien que mépris, et que glace, Allume dans mon sein, malgré votre froideur, Un feu qui me consomme auecque son ardeur.
CINTILLE.	CINTILE.
Si vous ſçauiez au vray l’eſtat de ma fortune, Ma preſence deſia vous ſeroit importune, Et pendant cét amour que vous me teſmoignez, Vous plaindriez mon malheur lors que vous vous plaignez, Songez à Florintor, recognoiſſez ſa flâme.	Si vous savez au vrai l'état de ma fortune, Ma présence déjà vous serait importune, Et pendant cet amour que vous me témoignez, Vous plaindriez mon malheur lors que vous vous plaignez, Songez à Florintor, reconnaissez sa flamme.
MELISSEE.	MELISEE.
Mais toy, ſonge impoſteur, à ton mespris infame, Penſe-tu donc, ingrat, de m’abuſer ainſi, Ta feinte à mon endroit n'a pas bien reüßi, Sçache que Florintor eſt bien loin de ſon conte, Ie veux vanger ſur luy tes mespris, & ma honte, DJE pINpen3 Il faut que mon despit vous enuelope tous.	Mais toi, songe imposteur, à ton mépris infâme, Pensé-tu donc, ingrat, de m'abuser ainsi, Ta feinte à mon endroit n'a pas bien réussi, Sache que Florintor est bien loin de son conte, Je veux venger sur lui té mépris, et ma honte, DE pINpen3 Il faut que mon dépit vous enuelope vous.
CINTILLE ſeule.	CINTILE seule.
Qu'elle me fait pitié!	Qu'elle me fait pitié!
mais que peut-elle attandre, Ie ne ſuis que de nom, & d’habit ſon Alcandre, Ie te plains, Florintor, & ſuis bien affligé De voir qu’en te ſeruant ie t’ay deſobligé, Voila comme l’amour rit de noſtre prudence, Ce n'eſt point la raiſon qui regit ſon enfance, Ie cauſe les meſpris qu’elle monſtre pour toy, Et tu croyois d’auoir quelque ſupport de moy.	mais que peut-elle attandre, Je ne suis que de nom, et d'habit son Aligandre, Je te plains, Florintor, et suis bien affligé De voir qu'en te servant quelque t'ai desobligé, Voilà comme l'amour rit de notre prudence, Ce n'est point la raison qui régit son enfance, Je cause les mépris qu'elle montre pour toi, Et tu croyais d'avoir quelque support de moi.
Mais penſons à nous-meſmes, & laiſſons là les autres, Leurs plus grandes douleurs n’allegent point les noſtres.	Mais pensons à nous-mêmes, et laissons là les autres, Leurs plus grandes douleurs n'allègent point les nôtres.
Retirons ------	Retirons -on-
Retirons-nous d’icy, ie ſçay qu'en peu de iours Les maux que ie leur cauſe auront vn autre cours, Außi toſt que l’ingrat, dont ie me crois haye, Fera voir que ma flâme eſt tout à fait trahie, Ie leueray le maſque, & vangeant cét affront, Ie luy peindray la honte, ou la mort ſur le front, Ou bien ſi ſa valeur qui donne de l’enuie A tous les plus vaillans qui cognoiſſent ſa vie, Me porte dans le ſein la pointe de ſon fer, Et le fait doublement de mon cœur triompher, La mort me ſera douce, & beniray les armes Qui m'auront fait verſer le ſang au lieu de larmes -	Retirons-nous d'ici, ie rai qu'en peu de jours Les maux que sans leur cause auront un autre cours, Aussi tôt que l'ingrat, dont Madame me crois haie, Fera voir que ma flamme est tout à fait trahie, Je lèverai le masque, et vengeant cet affront, Je lui peindray la honte, ou la mort sur le front, Si bien si sa valeur qui donne de l'envie À tous les plus vaillants qui connaissent sa vie, Me porte dans le sein la pointe de son fer, Et le fait doublement de mon cœur triompher, La mort me sera douce, et beniray les armes Qui m'ont fait verser et sang au lieu le sa-
ACTE TROISIESME.	ACTE -TROISIÈME.
SCENE J EARINTHE.	SCÈNE J ARINTHÉE.
AEIDORCRLINIE.	AEIDORCRLINIE.
LARINTHE.	LARINTHÉ.
Lle, & moy receuons auec contentement Le bon-heur qu'Alidor nous procure en l'aimant, Ne vous eſtonnez pas de la voir ſi penſiue, Vne fole en ce poinct fait touſiours la rétiue, Ces petites façons paroiſtroient de meſpris, Auec des igrorans, ou des ieunes esprits, Quãd ſon pere Arimãd me recherchoit de mefme, Qu'il me diſoit cent fois, Larinthe, que ie t'aime, -- -- Ie faiſois la faſchée, & pourtant mes deſirs Attachoient ma penſee à ces derniers plaiſirs, Elle en fait tout de meſme, & ie perdray la vie, Que tout ce qu'elle fait eſt contre ſonenuie, Et ſi ie vous laiſſois entretenir tous deux, Elle prendroit plaiſir aux diſcours de vos feux, Mon aage eſt außi bien importun aux tendreſſes, Que trouuent les Amans auprés de leurs Maistreſſes, C eſi pourquoy te vom taiſſe en pnitore entretien, Remettant à demain voſtre ſouuerain bien.	Loin, et moi recevons ainsi contentement Le bonheur qu'Alidor nous procure en l'aimant, Ne vous étonnez pas de la voir si pensive, Une sole en ce point fait toujours la rétive, Ces petites façons paraîtraient de mépris, Avec des igrorants, ou des jeunes esprits, Quãd son père Ariment me recherchait de me, Qu'il me disoit cent fois, Âme, que ie 'aime, -- -- Ie faisois la faschée, et pourtant me dis Ait ma pensée ce derniers plaisirs, Elle en fait fo de même, et ie perdrai La ri, Que tout ce qu'elle fait est contre sonenuie, Et si ue vous laissois entretenir tous deux, Elle prendroit ' a discours de vos feux, m aage est aussi bien importun aux tendresses, Que trouuent j' Amans auprés de leurs Maistresses, Ç esi pourquoi te taisse en pnitore entretien, Remettant demain vôtre souuerain bien.
ALIDOR.	ÀLIDOR.
Eſtonné du bon-heur que le deſtin m'enuoye, Par où commenceray-ie à teſmoigner ma ioye, C’est en m’humiliant à l’aimable beauté, Dont les charmes puiſſans m’oſtent la liberté, Pardonnez, Calirie, à l’ardeur qui m'enflame, Sii oſe vous nommer le repos de mon ame, Sans vous ceſte clarté, que nous donnent les Cieux, Seroit abſolument inut le à mes yeux, Vous m'auez retiré du bord du precipice, Et par voſtre bonté ie trouue tout propice, Ie ſçay bien que i’ay tort, que ie ſuis criminel, Que ma faute merite vn ſupplice eternel, Et ſi ie n'esperois de n’obtenir la grace, Vous verriez ce corps mort tomber plus froid que glàce,	Étonné du bonheur que le destin m'envoie, Par où commencerai-je à témoigner ma joie, C'est en m'humiliant à l'aimable beauté, Dont les charmes puissants m'ils la liberté, Pardonnez, Calirie, Çalardeur qui m'enflamme, Si ose vous nommer le repos de mon âme, Sans vous cette clarté, que nous donnèrent les Cieux, Serait absolument inut le mes yeux, Vous m'avez retiré du bord du précipice, Et par votre bo ie trouue du précipice, Que sçay bien que j'ai tort, que j' ai tort, Que ma faute mérite supplice éternel, Et si ie n'esperois de obtenir la grace, Vous verriez ce corps mort tomber plus froid que glàce,
CALIRIE.	CALIRIE.
Meurs, ou ſois tout de glace, il m’eſt indifferent, Tout ce que i'en ay fait eſtoit pour ton parent Que i’aimois, il eſt vray, mais dans ſa perfidie I'ay trouué le defaut qui m'en a refroidie, Ne croy pas toutesfois, que pour ne l’aimer pat Ie conſerue pour toy le peu que i'ay d’appas, I’aimerois mieux mourir que d’auoir la penſee De te conſiderer, parce qu’il m'a laiſſee, Au contraire ie veux teſmoigner auiourd’huy Que ié te fais autant qu’il me donne d’ennuy, Et ſi tu ne veux pas encores me deſplaire, Va-t'en loin de mes yeux, ne preſſe plus ma mere, Ou tu m’obligeras à cercher dans ma mort, Contre vn ſi grand orage vn fauorable port.	Meurs, ou sois tout de glace, il m'est indifférent, Tout ce que j'en ai fait était pour ton parent Que j'aimais, il est vrai, mais dans sa perfidie J'ai trouvé le défaut qui m'en a refroidie, Ne crois pas toutefois, que pour ne l'aimer pat En conserve pour toi le peu que j'ai d'appas, J'aimerais mieux mourir que d'avoir la pensée De te considérer, parce qu'il m'a laisse, Au contraire ainsi veux témoigner aujourd'hui Que j' fais autant qu'il me donne d'ennui, Et si tu ne veux pas encor me déplaire, Va-t'en loin de mes yeux, ne presse j' en loin, Ou tu obligeras cercher dans ma mort, Contre si grand orage fauorable port.
ALIDOR ſeul.	ÀLIDOR seul.
O Dieux!	Ô Dieux!
qu'ay-ie entendu, ces paroles cruelles Me font dedans le ſein de bleſſeures nouuelles, Bien, puis que tu le veux, il me faut eſloigner, Ie te veux en cela mon amour teſmoigner, I'oſteray cét objet ſi funeste à ta veuë:	qu'ai-je entendu, ces paroles cruelles Me font dedans le sein de blessures nouvelles, Bien, puis que tu le veux, il me faut éloigner, Je te veux en cela mon amour témoigner, J'ôterai cet objet si funeste à ta vue:
Mais d’vne autre façon que tu n'as pas preueué̈:	Mais d'une autre façon que tu n'as pas preueué̈:
Quel demon ennemy depuis deux mois me nuit, De qui me dois-ie plaindre au malheur qui me ſuit, Oronte, Calirie, Amour, eſt de vous-meſme, Vous estes les autheurs de ma douleur extreſme, Oronte, pour m'auoir à mon retour permis De voir ces deux beaux yeux qui me ſont ennemis, Et vous rare beauté, de qui l’iniuſte gloire, Apres m'auoir vaincu mespriſe ſa victoire, Vous auez augmenté les douleurs que ie ſens, En trompant auiourd’huy mes deſirs innocens, Apres m'auoir nourry de vaines eſperances, Et trompé mon amour de fauſſes apparences, Et toy cruel demon, dont le pouuoir fatal, En me faiſant aimer fut autheur de mon mal, 18 * C-	Quel demon ennemi depuis deux mois me nuit, De qui me dois-je plaindre au malheur qui me suit, Oronte, Calirie, Amour, est de vous-même, Vous êtes les auteurs de ma douleur extrême, Oronte, pour m'avoir à mon retour permis à voir ces deux beaux yeux qui me sont ennemis, Et vous rare beauté, de qui l'injuste gloire, Après m'auoir vaincu méprise sa victoire, Vous avez augmenté les douleurs que je sens, En trompant aujourd'hui mes désirs innocents, Après m'avoir nourri de vaines espérances, Et trompté mon amour de fa pas, Et toi us ave, a le pouuoir a,En me faisant ave fut ave de mon mal, 18 * Ç-
Tu m’as mis en l’eſtat où ſe trouue mon ame, En iettant dans mon ſein ta mal-heureuſe flame:	Tu m'as mis en l'état où se trouve mon âme, En jetant dans mon sein ta malheureuse flamme:
Ha!	Ha!
que le Ciel eſt iuſte, il eſtoit bien raiſon, Que la peine ſuiuy ma laſche trahiſon, Apres auoir trahy l’ame plus vertueuſe, Qui iamais ayt bruſlé d’vne flâme amoureuſe, Vien, Cintille, vien voir le iuſte chaſtiment Que l’amour fait ſouffrir à ton perfide Amant, Vien, vien, & tu verras mon ame de ſolée, Et la punition de ma foy violée, Et toy dont l’amitié m'a tiré du cercueil, Qui pour me conſoler as augmenté ton dueil, Oncle trop complaiſant à ma flame inciuile, Vien voir à mon endroit ton ſecours inutile, Vien voir ton Alidor, que la foudre a frapé, Alors que tu croyois l’orage dißipe, Laſches raiſonnemens, qui m'oſtez le courage.	que le Ciel est juste, il était bien raison, Que la peine suivi ma lâche trahison, Après avoir trahi l'âme plus vertueuse, Qui jamais ait brûlé d'une flamme amoureuse, Viens, Cintille, viens voir le juste châtiment Que l'amour fait souffrir à ton perfide Amant, Viens, vien, et tu verras mon âme de solée, Et la punition de ma foi violée, Et toi dont l'amitié m'a tiré du cercueil, Qui pour me consoler as augmenté ton dueil, Oncle trop complaisant à ma flamme inciuile, Vien voir et endroit ton secours inutile, Vien voir ton Alidor, que la foudre a ce, Alors quetu croyois orage y, Le raisonnemens, qui m'ôtez le courage.
Abandonnez mon ame au pouuoir de la rage, N’ay-ie plus de vertu contre tant de malheurs.	Abandonnez mon âme au pouvoir de la rage, N'ai-je plus de vertu contre tant de malheurs.
Ce bras ne peut-il pas ſurmonter mes douleurs, Ce bras, & ceſte espée en finiſſant ma peine Contenteront bien toſt ta rigueur inhumaine, Tu ne me verras plus, ſi tu ne me vois mort.	Ce bras ne peut-il pas surmonter mes douleurs, Ce bras, et cette épée en finissant ma peine Contenteront bien tôt ta rigueur inhumaine, Tu ne me verras plus, si tu ne me vois mort.
ACTE TROISIESME.	ACTE -TROISIÈME.
SCENE VI.	SCÈNE VI.
ORONTE.	ORONTE.
ALIDOR.	ÀLIDOR.
ORONTE luy arreſtant le bras.	ORONTE était arrêtant le bras.
V'eſt-ce cy, mon nepueu, d’où vous vient ce transport.	V'est-ce cy, mon nepueu, d'où vous vient ce transport.
ta	ta
ALIDOR.	ÀLIDOR.
Ha!	Ha!
ne m'empeſches plus de finir vne vie De mille ennuis mortels à toute heure ſuiuie, I'ay trop long temps veſcupour mon contentement, Tous m’auez vne fois tiré du monument, – –--t- 1 Oronte, c’eſt aſſez, laiſſez-moy donc pourſuiure Le deſſein que i’ay fait de ne vouloir plus viure, Calirie elle-meſme en a donné l’arreſt, Et puis qu'elle le veut ie mourray ſans regret.	ne m'empêches plus de finir une vie De mille ennuis mortels à toute heure suivie, J'ai trop long temps vécupour mon contentement, Tous m'avez un fois tiré du monument, - 1 Oronte, est assez, laissez-moi donc poursuiure Le dessein que ay fait de ne vouloir plus viure, Calirie elle-même en a donné arrest, Et puis qu'elle le veut ie mourrai sans regret.
ORONTE.	ORONTE.
Pouſſe doncques pluſtoſt dans mon ſein ton eſpée, Qu'elle ſoit dãs mon ſang, & non du tien trempée, Quel accident nouueau vient troubler tes plaiſirs, Que iqu'vn a-tit ponta tranc jentes deſtrs, Si Larinthe le veut, Alidor, qui te faſche.	Pousse donc plutôt dans mon sein ton épée, Qu'elle soit dans mon sang, et non du tien trempée, Quel accident nouveau vient troubler tes plaisirs, Que j'un a-tit ponta tranc jentes détrs, Si Larinthe le veut, Alidor, qui te fâche.
ALIDOR.	ÀLIDOR.
Moy-meſme d’auoir fait vne action ſi laſche, Car ie deuois mourir dés le premier moment, Que mon amour troubla voſtre contentement.	Moi-même d'avoir fait une action si lâche, Car tu devais mourir dès le premier moment, Que mon amour troubla votre contentement.
ORONTE.	ORONTE.
Cher nepueu, ne mets plus mon intereſt en conte, Di iu peux opliger te mainchren Oronte, Et me dy ſeulement d’où vient ton de ſespoir  epint on neure ou deux que tu m’es venu voir.	Cher nepueu, ne mets plus mon intérêt en conte, Di yu veux opliger te mainchren Oronte, Et me dis seulement d'où vient ton de sespoir épint on neure ou deux que tu m'es venu voir.
ALIDOR.	ÀLIDOR.
Du ſeul commandement que m'a fait ceste belle * --- –2 E–- De ne De ne monſtreriamais Alidor deuant elle.	Du seul commandement que m'a fait cette belle * --elle 2 ESPRIT- De ne De ne montreriamais Alidor devant elle.
RONTE.	RONTE.
Si ce n'est que cela ne t'en eſtonne pas, On l’appaiſera bien a moins que du treſpas, Ces mouuemens de fille aisément ſe deſtruiſent Alors que les flambeaux de mariage luiſent, Repoſe-t'en fur moy, ie ſuis bien aſſeuré Que fa mere tiendra ce qu'elle m'a iuré, Calirie en vn mot n’oſeroit la deſdire, Et demain au plus tard finira ton martyre, Que ſi cela n'eſt pas, ie te permets apres, Selon que tu voudras de finir tes regrets, Iuſques à ce temps-la donne-toy patience, Ie t'en parle, Alidor, de certaine ſcience.	Si ce n'est que cela ne t'en étonne pas, On l'apaisera bien à moins que du trépas, Ces mouvements de fille aisément se détruisent Alors que les flambeaux de mariage luisent, Repose-t'-en fur moi, elle suis bien assuré Que fa mère tiendra ce qu'elle m'a juré, Caleurie en un mot n'oserait la dédire, Et demain au plus tard finira ton martyre, Que si cela n'est pas, ie je voudras après, Selon que tu voudras de finir tes regrets, Jusques à ce temps-la donne-la donne, -la t'in parle, Alidor, de certaine A.
ALIDOR.	ÀLIDOR.
C’eſt pour vous contenter, mais ie ſuis bien certain Que tout vostre trauail ne peut eſtre que vain.	C'est pour vous contenter, mais ainsi suis bien certain Que tout votre travail ne peut être que vain.
ACTE ATRIESME.	ACTE ATRIESME.
SCENE I.	SCÈNE I.
MELISSEE.	MELISEE.
FLORINTOR.	FLORINTOR.
Q M MELISSEE ſeule.	Q M MELISSEE seule.
Voy qu'vn iuſte despit de me voir refuſce, De voir par vn ingrat ma flame refuſee, Deuſt chaſſer de mõ ſein l’amour que i’ay pour luy, I’adore toutes fois l’autheur de mon ennuy.	Vois qu'un juste dépit de me voir refusée, De voir par un ingrat ma flamme refuse, Deut chasser de m sein 'amour sein l'ai pour lui, J'adore toutes fois l'auteur de mon ennui.
I’adore cét ingrat qui m'a de ſobligée, Et ne le puis hayr, bien qu'il m'ayt negligee,	J'adore cet ingrat qui m'a de sobligée, Et ne le puis haïr, bien qu'il m'ait néglige,
Alcandre, que le Ciel re donne iniuſtement, Auec tant de beautez, vn cœur qui les deſment, Deuoit-il animer ce miracle viſible, Et cét object d’amour, que d’vne ame ſenſible, Que ne te donnoit-il le cœur que tu n'as pas, Ou ne te faiſoit naiſtre auecques moins d’appas;	Alcandre, que le Ciel re donne injustement, Avec tant de beautés, un cœur qui les dément, Deuait-il animer ce miracle visible, Et cet objet d'amour, que d'une âme sensible, Que ne te donnait-il le cœur que tu n'as pas, Ou ne te faisait naître avec moins d'appas;
Mais deuois-ie esperer qu'en vn pays barbare Peut naiſtre ſans de faut vne beauté ſi rare, Qui n'eut du naturel des flots, & des rochers, Qui le long de ſon Iſle effraye les nochers, Ie l’aime toutesfois, quoy que ie m'en defende, Et contre mon deſir il faut que ie me rende, Ie trouue en ſes mespris quelques charmes puiſſans Qui le font malgré moy maiſtre de tous mes ſens, Imprudent que tu es, qui pour me vouloir plaire, As amené chez moy ce cruel aduerſaire, Tu croyois qu’il me peuſt obliger à t’aimer:	Mais devais-je espérer qu'en un pays barbare Peut naître sans de faut quelque beauté si rare, Qui n'eut du naturel des flots, et des rochers, Qui le long de son Île effraie les nochers, Je l'aime toutefois, quoi que tu m'en défende, Et contre mon désir il faut que sans me rende, Je trouve en ses mépris quelques charmes puissants Qui le font malgré moi maître de tous mes sens, Imprudent que tu es, qui pour me vouloir plaire, As amené chez moi ce cruel adversaire, Tu oyais qu'il me pût obliger à t'aimer:
Mais nous auõs tous deux rai ſon de nous blaſmer, Toy pour t'eſtre ſeruy d’vn agent dont la grace Des hommes plus parfaits les merites efface, Et moy pour auoir veu d’vn gil trop amoureux Marẽ LE-AT.	Mais nous avons tous deux rai son de nous blâmer, Toi pour t'être servi d'un agent dont la grâce Des hommes plus parfaits les mérites efface, Et moi pour avoir vu d'être gil trop amoureux Marence LE-T.
Vn homme que i’adore, & ſe croit mal-heureux, Si ie me ſuis mocque autrefois de ta flame, Vien voir qu'vn autre rit des ardeurs de mõ ame, Alcandre t'a vengé par le cruel meſpris Qu’il fait de la beauté de celle qui t'a pris.	Un homme que j'adore, et se croit malheureux, Si tu me suis moque autrefois de ta flamme, Viens voir qu'un autre rit des ardeurs de mon âme, Alcandre t'a vengé par le cruel mépris Qu'il fait de la beauté de celle qui t'a pris.
Il tient dans la priſon celle qui te captiue, Et lors que ie te fuy, il faut que ie le ſuiue, Ie ne puis Florintor, ſouffrir ton entretien, Encor que par mon mal ie cognoiſſe le tien, Voicy le malheureux, qui ſelon ſa couſtume Me vient importuner du feu qui le conſume, Ha!	Il tient dans la prison celle qui te captive, Et lors que ie te fuis, il faut que ie le suive, Je ne puis Florintor, souffrir ton entretien, Encor que par mon mal Seigneur connaisse le tien, Voici le malheureux, qui selon sa coutume Me vient importuner du feu qui le consume, Ha!
que tu trouueras de changement en moy, Puis qu'Alcandre auiourd’huy ne vient pas auec 1 9.	que tu trouveras de changement en moi, Puis qu'Alcandre aujourd'hui ne vient pas avec 1 9.
ACTE VATRIESME.	ACTE VATRIESME.
SCENE II.	SCÈNE II.
TLORINTOR.	TLORINTOR.
MELISSEE.	MELISEE.
FLORINTOR.	FLORINTOR.
Quoy ſe diuertit la belle Meliſſee, Suis-ie aſſez bien venu pour ſçauoir ſa penſee, de ne teſperepas, te fais trop malnearene.	Quoi se divertit la belle Mélisse, Suis-je assez bien venu pour savoir sa pensée, de ne tespérepas, te fais trop malnearene.
MELISSEE.	MELISEE.
Ie ne penſois qu'a vous,	Je ne pensais qu'a vous,
FLORINTOR.	FLORINTOR.
O rencontre amoureux, Fortuné Florintor, s’il faut que ie le croye.	Ô rencontre amoureux, Fortuné Florintor, s'il faut que que le croie.
*6 -- ----- - -------s---U- s--- { ii	*6 --est -est- -est -ce-ce-U- s- { ji
MELISSEE.	MELISEE.
Il n'eſt pas temps encor de monſtrer vostre ioye, Ie ne pẽſois qu'à vous, mais pour vous teſmoigner Qu'il faut pour m'obliger deſormais m'eſloigner, Que ie ne ſçaurois plus vous voir, ny vous entẽdre, Que c'eſt folie à vous deſormais d’y pretendre, Que voſtre paßion me desplaiſt tellement, Que ie ne vous puis voit ſans meſcontentement:	Il n'est pas temps encor de montrer Seigneur joie, Je ne pẽsois qu'à vous, mais pour vous témoigner Qu'il faut pour m'obliger désormais m'éloigner, Que me ne saurais plus vous voir, ni ainsi entendre, Que c'est folie à vous désormais d'y prétendre, Que votre passion me déplaît tellement, Que je ne vous puis voit sans mécontentement:
Non, non, ie ne veux plus vous donner esperance, Et nourrir voſtre amour d’vne fauſſe apparance, Tout ce que i'en ay fait eſtoit pour obliger, Pluſtoſt que Florintor, voſtre ingrat eſtranger, Et ſi vous ne voulez vous attirer mahaine, Ne me voyez iamais.	Non, non, Madame ne veux plus vous donner espérance, Et nourrir votre amour d'une fausse apparance, Tout ce que j'en ai fait était pour obliger, Plutôt que Florintor, votre ingrat étranger, Et si vous ne voulez vous attirer mahaine, Ne me voyez jamais.
FLORINTOR.	FLORINTOR.
Arreſtez, inhumaine, Dues-moy ta raiſon a vnſiprompr changemente	Arrêtez, inhumaine, Dues-moi ta raison a unsiprompr changemente
MELISSEE.	MELISEE.
Adieu, ie vous l’ay dit encor trop clairement.	Adieu, Seigneur vous l'ai dit encor trop clairement.
FLORINTOR.	FLORINTOR.
Cruelle tu t'en vas, & deux ans de ſeruice tni e ue c--- *---4- 1-  101	Cruelle tu t'en vas, et deux ans de service tenni ce ue viens- *-4-là 1- 101
.	.
JVci	JUci
Ne peuuent t'empe ſcher d’vn ſi mauuais office, Ie voy bien ce que c'eſt, cét aimable eſtranger Eſt l’objet auiourd’huy qui t’oblige à changer, Sa beauté t’a ſurpriſe, & par mon imprudence 75 I’ay moy-meſme introduit l’innocẽt qui m’offence, O Dieux!	Ne peuvent t'empe sécher d'un si mauvais office, Je vois bien ce que c'est, cet aimable étranger Est l'objet aujourd'hui qui t'oblige à changer, Sa beauté t'a surprise, et par mon imprudence 75 J'ai moi-même introduit l'innocence qui m'es, QUI Dieux,
vn eſtranger depuis deux iours venu, Qu'elle n’a pas encor deux fois entretenu, Qui pour vn autre objet à toute heure ſouſpire, Eſt cét heureux Amant, que ſeul elle deſire, Et moy qui l’ay ſeruy, & n'ay iamais aimé Qu'elle ſeule depuis que ie ſuis animé, Nay d’vn me ſme pays, de longue cognoiſſance, Ie ſuis le malheureux, dont elle veut l’abſence, Sexe ingrat, & leger, qui change plus ſouuent Que les roſeaux pliez par la force du vent, Qui n'as rien de l’humain que les traits du viſage, Et qui ne mit iamais la raiſon en vſage, Que nous ſerions heureux, ſi noſtre volonté Ne ſe laiſſoit pas vaincre aux traits de ta beauté;	un étranger depuis deux jours venu, Qu'elle n'a pas encor deux fois entretenu, Qui pour un autre objet à toute heure soupire, Est cet heureux Amant, que seul elle désire, Et moi qui l'ai servi, et n'ai jamais aimé Qu'elle seule depuis que sans suis animé, Nay d'un me sme pays, de longue connaissance, Je suis le malheureux, dont elle veut l'absence, Sexe ingrat, et léger, qui change plus souvent Que les roseaux pleure par la force du vent, Qui n'as rien de l'humain que les traits du visage, Et qui ne mit jamais la raison en vsage, Si nous serions heureux, si nôtre volonté Ne se laissoit pas vaincre aux traits de ta beauté;
Mais le Ciel qui t’a fait auecques tant de charmes Pour te bien reſiſter nous refuſe des armes, 24	Mais le Ciel qui t'a fait auecques tant de charmes Pour te bien résister nous refuse des armes, 24
C’eſt pourquoy malgré nous il nous faut obeyr Aimant nos ennemis, au lieu de les hayr.	C'est pourquoi malgré nous il nous faut obéir Aimant nos ennemis, au lieu de les haïr.
Ie te veux donc aimer, cruelle Meliſſee.	Je te veux donc aimer, cruelle Mélissee.
Attendant que le temps ayt changé ta penſee, Ie ſuis bien aſſeuré qu'Alcandre a dans le ſein Des feux qui le rendront contraire à ton deſſein:	Attendant que le temps ait changé ta pensée, Je suis bien assuré qu'Alcandre a dans le sein Es feux qui le rendront contraire à ton dessein:
Allons le voir chez luy, pour luy faire cognoiſtre S’il ne le ſçait encor, l’amour qu'il a fait naiſtre.	Allons le voir chez lui, pour lui faire connaître S'il ne le sait encor, l'amour qu'il a fait naître.
ACT	ACT
ACTE QVATRIESME.	ACTE QUATRIÈME.
SCENE III.	SCÈNE III.
URONTE, CALIRIE.	OURONTE, CALIRIE.
ORONTE.	ORONTE.
Rreſtez Calirie, eſcoutez ma raiſon.	Rrestez Calirie, écoutez ma raison.
CALIRIE.	CALIRIE.
N’as tu point inuenté quelqu'autre trabiſon, Ton esprit n'eſt-il pas tontent ue ta prémiere, Si tu n'es ſatisfait, ôſte-moy la lumiere, Arrache-moy le cœur que le tien a trahy.	N'as tu point inventé quelque autre trabison, Ton esprit n'est-il pas tontent ue ta prémiere, Si tu n'es satisfait, ôte-moi la lumière, Arrache-moi le cœur que le tien a trahi.
ORONTE.	ORONTE.
Eſt-il poßsible, ô Dieux!	Est-il passible, ô Dieux!
qu’Oronte ſoit hay.	qu'Oronte soit haï.
CALIRIE.	CALIRIE.
Mu piaer cenlla enatarozetie.	Mu piaer cenlla enatarozetie.
ORONTE.	ORONTE.
Quoy, ma ſluecroird que ſon Amant ſoit traiſtre,	Quoi, ma sluecroird que son Amant soit traître,
CALIRIE.	CALIRIE.
Comment nommeras-tu ta derniere action.	Comment nommeras-tu ta dernière action.
N'as-tu pas eſté traiſtre à mon affection, Tu me veux obliger de trouuer agreable Vn homme qui pour moy n'euſt iamais rien d’aimable, Que ie hay de nature, & que ie ne puis voir Dans le deſſein qu’il a qu'auec le deſeſpoir, Toyde qui ie croyois l’ardeur pour m'yy puiſſante, A buſant auiourd huy de ma flame inpocente, Tu preſſes mes parens de m'engager ailleurs, Et ie pourrois auoir de ſentimens meilleurs:	N'as-tu pas été traître à mon affection, Tu me veux obliger de trouver agréable Vén homme qui pour moi n'eût jamais rien d'aimable, Que ie haï de nature, et que je ne puis voir Dans le dessein qu'il a qu'avec le désespoir, Toide qui tu croyais l'ardeur pour m'y puissante, À busant aujourd' hui de ma flamme inpocente, Tu presses mes parents de m'engager ailleurs, Et que pourrais avoir de sentiments meilleurs:
Non, non, ie te crois traiſtre, & quoy que tu me dies, Apres de trahiſons ſi la ſchement ourdies, Si ie te croyois plus, i’aurois bien merité Le mal que m'a causé ton infidelité.	Non, non, Seigneur te crois traître, et quoi que tu me dies, Après de trahisons si la schement ourdies, Si tu te croyais plus, j'aurais bien mérité Le mal que m'a causé ton infidélité.
ORONTE.	ORONTE.
Il eſt vray que ma faute eſt au nombre des crimes Qui ſe doiuent punir dans les profonds abyſmes:	Il est vrai que ma faute est au nombre des crimes Qui se doivent punir dans les profonds abîmes:
Mais ſi vous me voulez eſcouter vn moment, Vous ſçaurez que ie ſuis touſiours fidelle Amant, Vous verrez que ma flame eſt touſiours toute entiere, Que ie n’ay rien perdu de mon ardeur premiere, Que vuime caurle, & queec quet ay jair N'eſt que de mon malheur vn miſerable effet.	Mais si vous me voulez écouter un moment, Vous saurez que tu suis toujours fidèle Amant, Vous verrez que ma flamme est toujours toute entière, Que Que n'ai rien perdu de mon ardeur première, Que vuime caurle, et queect que ai jair N'est que de mon malheur un misérable effet.
CALIRIE.	CALIRIE.
Dy ce que tu voudras, & toutesfois t'aſſeure Que mon cœur eſt deſia guery de ſa bleſſeure.	Dis ce que tu voudras, et toutefois t'assure Que mon cœur est déjà guéri de sa blessure.
ORONTE.	ORONTE.
S’il eſt vray, ma chere ame, il me faut donc mourir, Et rien que le treſpas ne me peut ſecourir, Perdant voſtre amitié, ie n'ay rien qui me reſte, Qui ne ſoit deſormais à mes plaiſirs funeſte, Dés que i’auray perdu voſtre doux entretien, Ie tiens indifferent, & le mal, & le bien.	S'il est vrai, ma chère âme, il me faut donc mourir, Et rien que le trépas ne me peut secourir, Perdant votre amitié, on n'ai rien qui me reste, Qui ne soit désormais à mes plaisirs funeste, Des que j'aurai perdu votre doux entretien, Je tiens indifférent, et le mal, et le bien.
E ſh	E sh
ALIRIE.	ÀLIRIE.
S’il eſt vray que ie ſois à ton ame ſi chere, Pourquoy me preſſe-tu d’obeyr à ma mere, Et pourquoy pour accroiſtre auiourd’huy mon ennuy, M'as-tu voulu ſouſmettre aux volontez d’autruy.	S'il est vrai que ainsi sois à ton âme si chère, Pourquoi me presse-tu d'obéir à ma mère, Et pourquoi pour accroître aujourd'hui mon ennui, M'as-tu voulu sousmettre aux volontés d'autrui.
Parle.	Parle.
ACTE TATRIESME.	ACTE TATRIESME.
ALIDOR tout bas.	ÀLIDOR tout bas.
E trouue ſeuls Oronte & Calirie, Voicy l’occaſion de voir leur trõperie, Ie les veux eſcouter.	E trouve seuls Oronte et Calirie, Voici l'occasion de voir leur troupérie, Je les veux écouter.
SCENE IV.	SCÈNE IV.
ALIDOR.	ÀLIDOR.
CALIRIE.	CALIRIE.
ORONTE.	ORONTE.
CAEIRIE.	CAEIRIE.
La honte t'interdit, Tu ne ſçaurois respondre à ce que ie t’ay dit.	La honte t'interdit, Tu ne saurais répondre à ce que Il t'ai dit.
ORONTE.	ORONTE.
Il est vray que ie ſens vne douleur ſi forte De m'eſtre auecques vous gouuerné de la ſorte,  2 ---- 8 -----8 14 Que ie ne ſçay que dire, & que ie ſuis honteux De vous auoir rendu mon amour ſi douteux, D’auoir à ſon ſujet trahy ma propre flâme, Et d’auoir pour ſa vie entrepris ſur mon ame:	Il est vrai que ie Se vne douleur si forte De m'être apprendre vous gouverné de la sorte, 2 -- 8 --8 14 Que tu ne sais que dire, et que je suis honteux De vous avoir rendu mon amour si douteux, D'avoir à son sujet trahi ma propre flamme, Et d'avoir pour sa vie entrepris sur mon âme:
Mais vous ſçauez qu'il eſt l’appuy de ma maiſon, Que ce que i’en ay fait, ie l’ay fait par raiſon, Que ſon pere en mourant le remit à ma garde, Que ie le dois ſeruir en ce qui le regarde, Ou ie ſerois ingrat à ceſte affeſtion,  Que ſon pere a fait voir en ſemblable action, La ſanté toutesfois à mon nepueu renduë, Et qu’il conſerue encor, quoy qu’il vous ayt perduë, Deuroit m’auoir rendu ce que i’auois donné, Et m'aſſeurer deſia que ie ſuis pardome.	Mais vous savez qu'il est l'appui de ma maison, Que ce que j'en ai fait, votre l'ai fait par raison, Que son père en mourant le remit à ma garde, Que ie le dois servir en ce qui le regarde, Oufin serais ingrat à cette affestion, Que son père a fait voir en semblable action, La santé toutefois à mon neve renduë, Et qu'il conserve encor, quoi qu’il vous ait perdue, Deurait m'avoir rendue ce que j'avais donné, Et m'assurer déjà que ie suis pardome.
Accordez, Calirie, vne faueur ſi grande Au mal-heureux Oronte, & ſignez ſa demande.	Accordez, Calirie, une faveur si grande Au malheureux Oronte, et signez sa demande.
ALIDOX Ie delcouurant.	ÀLIDOX Je délcouvrant.
Ie viens pour la ſigner, mais c'est auec le ſang Que ce fer à vos yeux tirera de ce flanc.	Je viens pour la signer, mais c'est avec le sang Que ce fer à vos yeux tirera de ce flanc.
CALIRIE l’arreſtant.	CALIRIE l'arrêtant.
Alidor, arreſtez, c'eſt moy qui vous coniure De ne me faire point ceſte ſeconde iniure, Suſpendez quelque temps ce transport inhumain Et vom ſerez contenisi vn & vanre demdin,	Alidor, arrêtez, c'est moi qui vous conjure De ne me faire point cette seconde injure, Suspendez quelque temps ce transport inhumain Et vom serez contenisi un et vanre demin,
ALIDOR.	ÀLIDOR.
Non, ne retardez point la mort que ie deſire, C’eſt d’elle que i’attens la fin de mon martyre, Apres auoir cognu qu’Oronte m'a trahy, Que i’aime ſans espoir, & que ie ſuis hay:	Non, ne retardez point la mort que je désire, C'est d'elle que j'attends la fin de mon martyre, Apres avoir connu qu'Oronte m'a trahi, Que j'aime sans espoir, et que je suis haï:
Arle conferner ta pit, eſt augmemerma peine, Laiſſez-moy dõc mourir, vous me ſerez humaine.	Arle conferner ta pit, est augmemerma peine, Laissez-moi dont mourir, vous me rez humaine.
CALIRIE.	CALIRIE.
Vous m’aimez Alidor, O ronte m’aime außi, Et ie dois vous tirer tous deux de ce ſoucy, Iurez moy ſeulement de ne rien entreprendre Iuſqu'à ceſue ueinamie touste faſſe entendre, S'il eſt vray que l’on m’aime, onme doit obeyr, La de ſobeyſſance oblige de hayr.	Vous m'aimez Alidor, Ô ronte m'aime aussi, Et ie dois vous tirer tous deux de ce souci, Jurez moi seulement de ne rien entreprendre Jusqu'à cette éveinamie cette fasse entendre, S'il est vrai que l'on m'aime, onme doit obéir, La de sobéissance oblige de haïr.
ORONTE.	ORONTE.
P'our moy ie vous promets que mes ardeurs plus fermes Se maintiendront touſiours dedans leurs premiers termes.	P'our moi je vous promets que mes ardeurs plus fermes Se maintiendront toujours dedans leurs premiers termes.
ALIDOR.	ÀLIDOR.
Et moy quoy que ie ſois tout à fait malheureux, Pour vous deſobeyr ie ſuis trop amoureux, Voſtre commandement m'est vne loy ſeuere Que ie reçoypourtant de peur de vous deſplaire.	Et moi quoi que je sois tout à fait malheureux, Pour vous désobéir tu suis trop amoureux, Votre commandement m'est une loi sévère Que je reçoypourtant de peur de vous déplaire.
CALIRIE.	CALIRIE.
Ie vous quitte, & croyez que dans le meſme temps Que ie vous ay promis, ie vous rendray contens.	Je vous quitte, et croyez que dans le même temps Que je vous ai promis, je vous rendrai contents.
RORIE.	RORIE.
Ie croiray tout de vous, mais ie crains le contraire.	Je croirai tout de vous, mais ie ainsi le contraire.
ALIDOR ſeul.	ÀLIDOR seul.
Oronte qui touſiours m’as ſeruy comme pere, Et qui m'as retiré du milieu des ennuis, Tu feints de me ſauuer, & c’eſt toy qui me nuis, emonoig neuutoueueux, i'ay touſiours mon remede, La mort quand ie voudray ſera preſte à mon ayde.	Oronte qui toujours m'as servi comme père, Et qui m'as retiré du milieu des ennuis, Tu feints de me sauver, et c'est toujours qui me nuis, émonoig neuutoueueux, j'ai toujours mon remède, La mort quand ie voudrai sera prête à mon aide.
ACTE QVATRIESME.	ACTE QUATRIÈME.
SCENE V.	SCÈNE V.
CINTILLE daſis Ia loſicude.	CINTILE dasis Ja losicude.
I Riſtes reſſentimẽs du bien que i’ay perdu, Sortez de ma penſee, C’eſt vn bien qui iamais ne me ſer a rendu, Alidor m'a laiſſee, Iingrat ne ſonge plus à ſa premiere ardeur, Et ie cognois dans ſa froideur Que de ſon ſouuenir Cintille eſt effacee.	I Ristes ressentiments du bien que j'ai perdu, Sortez de ma pensée, C'est un bien qui jamais ne me ser a rendu, Alidor m'a laisse, Jingrat ne songe plus à sa première ardeur, Et ie cognais dans sa froideur Que de son souvenir Cintille est effacée.
Miſerable Cintille, à qui te reſous-tu Dans ce cruel orage, Il te faut conſeiller à ta propre vertu, * ---	Misérable Cintille, à qui te résous-tu Dans ce cruel orage, Il te faut conseiller à ta propre vertu, * --
M 4 Et monstrer ton courage:	M 4 Et montrer ton courage:
Ceſſe de t’affliger, prens vn meilleur deſſein, TL.	Cesse de t'affliger, prends un meilleur dessein, TL.
De jene.	De jène.
Les conſeils violens que te donne la rage.	Les conseils violents que te donne la rage.
Meurs, meurs, & n’attends plus le ſecours des humains, Ton attente eſt trop vaine, Ce fer dans vn moment, par l’ayde de tes mains, Mettra finã ta peine:	Meurs, meurs, et n'attends plus le secours des humains, Ton attente est trop vaine, Ce fer dans un moment, par l'aide de tes mains, Mettra finã Ma peine:
Pouſſe-le hardiment, & dans ton propre cœur Va cercher cét ingrat vainqueur, Et venge deſſus luy ta douleur inhumaine.	Pousse-le hardiment, et dans ton propre cœur Va ce cét ingrat vainqueur, Et venge dessus Seigneur ta douleur inhumaine.
Le traiſtre y regne encor auec tous ſes meſpris, Mais auec tant de charmes, Que malgré la fureur qui trouble mes eſprits, Il m'arrache les armes, Et pour s’y maintenir me contraint doucement De viure parmy mon tourment, Et de continuër mes ſouspirs, & mes larmes.	Le traître y règne encor auec tous ses mépris, Mais avec tant de charmes, Que malgré la fureur qui trouble mes esprits, Il m'arrache les armes, Et pour s'y maintenir me contraint doucement De vivre parmi mon tourment, Et de continuer mes soupirs, et mes larmes.
Pleurons doncques, pleurons, puis qu’il le veut ainſi, La matiere en eſt ample, Et faiſons en ces lieux de ces gaſons icy Vn dep lorable temple, Où mes longues douleurs, & ma fidelité Daujjent à la poſterité De conſtance &t d’amour vn memorable exemple.	Pleurons donc, pleurons, puis qu'il le veut ainsi, La matière en est ample, Et faisons en ces lieux de ces gazons ici Un dép letorable temple, Où mes longues douleurs, et ma fidélité Daujent à la postérité De constance ett d'amour un mémorable exemple.
ACTE ATRIESME.	ACTE ATRIESME.
SCENE WI.	SCÈNE II.
ORCAN.	ORCAN.
CINTILLE,	CINTILE,
E me tromperois fort en mon opinion, Si vous ne reuiez pas à vostre paßion:	ELLE me tromperais fort en mon opinion, Si vous ne rêviez pas à votre passion:
Ces yeux noyez de pleurs, & ceſte couleur ble ſme dincieſmoignent aſſez voſtre douteur extreſme, Ne me le cachez point, il ſe faut retirer De ceſte folle ardeur qui vous fait ſouspirer.	Ces yeux noyez de pleurs, et cette couleur blé sme dinciémoignent assez vôtre douteur extrême, Ne me le cachez point, il se faut retirer De cette folle ardeur qui vous fait soupirer.
INTILLE.	INTILE.
Orcan, il est certain que i’auois ma penſee Portée à cét ingrat qui m'a l’ame bleſſee, Et que ie ne ſçaurois ſouffrir qu'auec douleur Sa la ſche ingratitude, & mon cruel malheur:	Orcan, il est certain que j'avais ma pensée Portée à cet ingrat qui m'a l'âme blessée, Et que sans ne saurais souffrir qu'avec douleur Sa la che ingratitude, et mon cruel malheur:
Mais que m'apporte-tu, dois-ie mourir, ou viure, Dy-le moy franchement,	Mais que m'apporte-tu, dois-je mourir, ou vivre, Dis-le moi franchement,
ORCAN.	ORCAN.
Son crime vous deliure,	Son crime vous délivre,
CINTILLE.	CINTILE.
Son crime!	Son crime!
qu'a-t’il fait,	qu'a-t-il fait,
ORCAN.	ORCAN.
Rien, ſinon vous trahir, Pour vne qui ne peut iamais que le haïr, Voyez ſi ſon forfait ne vous a pas vengée, Et s’il n'eſt pas puny de vous auoir changée, Il aime vne beauté, qui ne le peut ſouffrir, Et que tit de ſes pœux quancetetes etent oſſrir.	Rien, sinon vous trahir, Pour une qui ne peut jamais que le haïr, Voyez si son forfait ne vous a pas vengée, Et s'il n'est pas puni de vous avoir changée, Il aime une beauté, qui ne le peut souffrir, Et que tit de ses pœux quancetes et ossrir.
Son nom CINTILLE.	Son nom CINTILLE.
ORCAN.	ORCAN.
Eſt Calirie, & ſon riual Oronte, Voila comme l’amour a vangé voſtre honte.	Est Calirie, et son rival Oronte, Voilà comme l'amour a vengé votre honte.
diA lij	diA lijà
CINTILLE.	CINTILE.
Tu me parles Orcan, trop generalement, C y-moyce qui ſe paſſe, & ne men nauement,	Tu me parles Oran, trop généralement, Ç y-moice qui se passe, et ne men navement,
ORCAN.	ORCAN.
Alidor amoureux de ceſte belle Dame, A fait l’extrauagant pour teſmoigner ſa flâme, Il eſt tombé malade, & ſe laiſſoit mourir Lors que ceste beauté l’eſt venu ſecourir.	Alidor amoureux de cette belle Dame, A fait l'extravagant pour témoigner sa flamme, Il est tombé malade, et se laissait mourir Lors que cette beauté l'est venu secourir.
Comment, CANTILLE.	Comment, CANTILLE.
ORCAN.	ORCAN.
Oronte à qui ſa flame eſtoit cognuë, Encores qu’il vſaſt de quelque retenuë, Adoroit Calirie, elle l’aimoit außi, C’eſtoit le meſme cœur, & le meſme ſoucy:	Oronte à qui sa flamme était connue, Encores qu'il vsast de quelque retenue, Adorait Calirie, elle l'aimait aussi, C'était le même cœur, et le même souci:
Mais voyant qu'Alidor ne viuroit point ſans elle, Il fit vne action à luy-meſme cruelle, Il fut voir ſon nepueu, luy dit ſa paßion, Et qu’il le veut ſeruir dans ſon affection, De fait il le ſeruit auecques tant d’addreſſe, Que pour l’amour de luy ſa Dame le careſſe, - -a-----v-- E.	Mais voyant qu'Alidor ne vivrait point sans elle, Il fit été action à peine-même cruelle, Il fut voir son nepueu, avait dit sa passion, Et qu'il le veut servir dans son affection, De fait il le servit avec tant d'adresse, Que pour l'amour de trouver sa Dame le caresse, - -a- .
t .	t .
M Me:	M Me:
Le viſite ſouuent:	Le visite souvent:
ſi bien que ſa beauté Luy redonnaſt bien toſt ſa premiere ſanté:	si bien que sa beauté Lui redonnât bien tôt sa première santé:
Mais lors qu’il fut guery, la belle refroidie Luy parloit autrement que dans ſa maladie, Oronte qui craignoit que ce grand changement Ne iettaſt ſon nepueu dedans le monument, Auoit auec la mere ar reſté l’hymenée.	Mais lors qu'il fut guéri, la belle refroidie Lui parlait autrement que dans sa maladie, Oronte qui craignait que ce grand changement Ne jetât son nepueu dedans le monument, Avait sous la mère ar resté l'hyménée.
Calirie d’abord ſe void bien eſtonnée:	Calirie d'abord se voit bien étonnée:
Mais ſe voyant preſſee, elle demande vn iour, Pour ſe pouuoir reſoudre à ce nouuel amour, Cependant elle pleure, elle ſe plaint d’O ronté, Luy reproche ſon crime, & le couure de honte, Elle fuyt Alidor plus qu'elle n'auoit fait, Luy dit que ſon amour la faſche, & luy desplait, Qu'elle ne le peut voir qu'auec vnœil de haine, Qu'elle mourra pluſtoſt que d’alleger ſa peine.	Mais se voyant pressée, elle demande un jour, Pour se pouvoir résoudre à ce nouvel amour, Cependant elle pleure, elle se plaint d'Ô ronté, Lui reproche son crime, et le couvre de honte, Elle fût Alidor plus qu'elle n'avait fait, Lui dit que son amour la fâche, et et déplaît, Qu'elle ne le peut voir qu'avec ainsi de haine, Qu'elle mourra plutôt que d'alléger sa peine.
CINTILLE.	CINTILE.
Amour iuſte vengeur de mes feux innocens, En fin tu l’as puny des maux que ie reſſens.	Amour juste vengeur de mes feux innocents, En fin tu l'as puni des maux que ie ressens.
ORCAN.	ORCAN.
Oronte dont l’amour eſtoit touſiours puiſſante, --- T	Oronte dont l'amour était toujours puissante, -- 
Eſtoit ſi ſatis fait de la voir ſi conſtante, Que voyant ſon nepueu ſupporter ſans mourir, Ce qu’il ne eroyoit pas, qu’il peut iamais fouffrit Retourne à Calirie, & par des raiſons fortes Taſche de r’allumer les ardeurs qu’il croit mortes.	Était si satî fait de la voir si constante, Que voyant son neveu supporter sans mourir, Ce qu'il ne eroyait pas, qu'il peut jamais fouffrit Retourne à Calirie, et par des raisons fortes Tâche de rallumer les ardeurs qu'il croit mortes.
Alidor qui l’auoit par hazard entendu, L’interrompit pluſtoſt qu’il n’auoit attendu, Se plaint de tous les deux, leur fait pluſieurs reproches, Et les rend außi froids, que s’ils eſtoient des roches:	Alidor qui l'avait par hasard entendu, L'interrompit plutôt qu'il n'avait attendu, Se plaint de tous les deux, leur fait plusieurs reproches, Et les rend ajà froids, que s'ils étaient des roches:
Il ſe voulut tuër, mais il fut arreſté Par le commandement que fit ceſte beauté, Si vous m’aimez, dit-elle, aimez donc voſtre vie, Et perdez tout à fait ceſte brut ale enuie, Demain ſans y faillir, ie vous rendray contens, Pout tous dimter tonsuenx, te prens et tauc temps, Voila le vray ſujet de ſa melancholie, Et ce qui s'eſt paßé dans toute ſa folie.	Il se voulut tuer, mais il fut arrêté Par le commandement que fit cette beauté, Si vous m'aimez, dit-elle, aimez donc votre vie, Et perdez tout à fait cette brut ale envie, Demain sans y faillir, je vous rendra contens, Pout tous dimter tonsuenx, te prends et tauc temps, Voilà le vrai sujet de sa mélancolie, Et ce qui s'est passé dans toute sa folie.
CINTILLE.	CINTILE.
Ce n'eſt pas tout, Orcan, ie veux voir quel ſuccés Nous pourront apporter ces amoureux exces,	Ce n'est pas tout, Orcan, on veux voir quel succès Nous pourront apporter ces amoureux excès,
La reſolution de perdre cét infame, S’il perſiste à l’aimer est priſe dans mon ame, Auprés de Calirie, ou des mains, ou du fer, Entre tous ſes amis, ie le veux eſtoufer.	La résolution de perdre cet infâme, S'il persiste à l'aimer est prise dans mon âme, Auprès de Calirie, ou des mains, ou du fer, Entre tous ses amis, Seigneur le veux étouffer.
ACTE CIN VIESME.	ACTE CIN VIESME.
SCENE I.	SCÈNE I.
FLORINTOR.	FLORINTOR.
CINTILLE.	CINTILE.
D AN Eraus Our le dire en vn mot, elle m’a fait entendre Qu'il me faloit ceder aux merites d’Alcandre, Que vous auiez plus fait ſans l’aimer dans vn iour, Que moy depuis deux ans que dure mon amour, Que vous eſtes le ſeul qui pouuiez tout ſur elle, Que vous eſtes l’objet de ſa flâme nouuelle, de que tout jouuon neu eſeoceutre vos mains.	 AN Eraus Our le dire en un mot, elle m'a fait entendre Qu'il me fallait céder aux mérites d'Alcandre, Que vous aviez plus fait sans l'aimer dans un jour, Que moi depuis deux ans que dure mon amour, Que vous êtes le seul qui pouviez tout sur elle, Que vous êtes l'objet de sa flamme nouvelle, de que tout jouvon neu eseoceutre vos mains.
CINTILLE.	CINTILE.
Que l’amour eſt contraire au repos des humains, Il eſt vray, Florintor, que voſtre Meliſſee 8 M’a fait voir qu'elle eſtoit de mon amour bleſſee, Qu'elle m'a teſmoigné beaucoup de paßion;	Que l'amour est contraire au repos des humains, Il est vrai, Florintor, que votre Mélissee 8 M'a fait voir qu'elle était de mon amour blessée, Qu'elle m'a témoigné beaucoup de passion;
Mais ie ſuis impuiſſant pour ſon affection, Outre vostre intereſt, dont mon ame eſt touchée, Vne raiſon plus forte eſt dans mon ſein cachée, Qui m'oblige de voir Meliſſee autrement Que comme ma Maiſtreſſe, ou comme ſon Amãt, I'eſtime ſa beauté, ſon merite, ſagrace, Mais ie ne puis pour elle auoir qu’vn cœur de glace.	Mais ie suis impuissant pour son affection, Outre votre intérêt, dont mon âme est touchée, Âme raison plus forte est dans mon sein cachée, Qui m'oblige de voir Melissee autrement Que comme ma Maîtresse, ou comme son Amant, J'estime sa beauté, son mérite, sagrâce, Mais ils ne puis pour elle avoir qu'un cœur de glace.
FLORINTOR.	FLORINTOR.
Il est vray que i’ay creu que la belle Cloris, Qui depuis ſi long temps maiſtriſe vos eſprits, Auec tous ſes deſdains, eſt ſi bien dans vostre ame, Qu'elle n’y laiſſe point de place à d’autre flâme, Et que malaisément ce climat eſtranger Vous peut monſtrer d’ob et qui vous puiſſe chãger:	Il est vrai que j'ai cru que la belle Cloris, Qui depuis si long temps maîtrise vos esprits, Avec tous ses dédains, est si bien dans votre âme, Qu'elle n'y laisse point de place à d'autre flamme, Et que malaisément ce climat étranger Vous peut montrer d'ob et qui vous puisse changger:
N Toutesfois le plaiſir d’eſtre aimé d’vne belle Qui vous parle d’amour, lors que l’autre eſt cruelle, A beaucoup de pouuoir pour ſe rendre vainqueur De ceste forte ardeur qui vous bruſle le cœur, L’amour qu'elle a pour vous, ſes ſouspirs, & ſes larmes, A ſes autres beautez adiouſtent bien de charmes, Efaupafa,e.	 Noutefois le plaisir d'être aimé d'une belle Qui vous parle d'amour, lors que l'autre est cruelle, A beaucoup de pouvoir pour se rendre vainqueur De cette forte ardeur qui vous brûle le cœur, L'amour qu'elle a pour vous, ses soupirs, et ses larmes, A ses autres beautés ajoutent bien de charmes, Efaupafa,.
D’aimer tant de beautez à qui l’on eſt ſi cher.	D'aimer tant de beautés à qui l'on est si cher.
CINTILLE.	CINTILE.
Vous croirez, s’il vous plaist, ce que la ialouſie Peut deſſus ce ſujet vous mettre en fantaſie:	Vous croirez, s'il vous plaît, ce que la jalousie Peut dessus ce sujet vous mettre en fantaisie:
Mais ſoyez aſſeuré que iamais autre ardeur Que de mon feu premier ne bruſlera mon cœur, Deuant la fin du iour, dont la lumiere eſclaire, Vous cognoiſtrez que i'aime, & que ie me ſȩay (taire.	Mais soyez assuré que jamais autre ardeur Que de mon feu premier ne brûlera mon cœur, Deuant la fin du jour, dont la lumière éclaire, Vous connaîtrez que j'aime, et que je me sais (taire.
FLORINTOR.	FLORINTOR.
Que dant ce peu de mots vous me dites beaucoup, Amy vous m'obligez doublement à ce coup, Vous me ſauuez la vie, & ſi l’amour luy-meſme N'eſt pas mon ennemy, vous ſauuez ce que i'aime.	Que dant ce peu de mots vous me dites beaucoup, Ami vous m'obligez doublement à ce coup, Vous me sauvez la vie, et si l'amour lui-même N'est pas mon ennemi, vous sauvez ce que j'aime.
CINTILLE.	CINTILE.
Ie vous prie e nuoyons mon homme pour ſçauoir Si ſans l’importuner, ie pourray l’aller voir, Vous me ſuiurez apres, & puis tous trois ensẽble Irons chez Calirie:	Je vous prie est nuoyons mon homme pour savoir Si sans l'importuner, Seigneur pourrai l'aller voir, Vous me suivrez après, et puis tous trois ensemble Irons chez Calirie:
Parce que ie voudrois qu’elle, & nous deux enſemble Pupromeneic cuurteyomte ſçay qu'on s'aſſemble:	Parce que ici voudrais qu'elle, et nous deux ensemble Pupromèneic cuvrteyomte sais qu'on s'assemble:
Là voila ſur ſa porte, Adieu, venez apres.	Là voilà sur sa porte, Adieu, venez après.
FLORINTOR s’en allant.	FLORINTOR s'en allant.
Ie crains que ton ſecours n’augmente mes regrets, Toutes fois ſes diſcours teſmoignent ſa franchiſe.	Je crains que ton secours n'augmente mes regrets, Toutes fois ses discours témoignent sa franchise.
ACTE CIN I TIESME.	ACTE CIN I TIESME.
Adame, ie voy bien que ie vous ày ſurpriſe.	Adame, je vois bien que votre vous à surprise.
SCENE II.	SCÈNE II.
CINTILLE.	CINTILE.
MELISSEE.	MELISEE.
CINTILLE abordant Meliſſee.	CINTILLE abordant Mélisse.
MELISSEE.	MELISEE.
Ouy, vous m'auez ſurpriſe, ingrat meſcognoißsãt, Qui vous mocquez des feux que mon ame reſſent:	Oui, vous m'avez surprise, ingrat méconnaissez, Qui vous moquez des feux que mon âme ressent:
Mais le Ciel s’il eſt iuste en vangera le crime, Quoy, vous offenſez-vous de ce qu'on vous eſtime, Si vous ne pouuez pas ſupporter mon ardeur Qu'auecque du mespris, ou beaucoup de froideur,	Mais le Ciel s'il est juste en vengera le crime, Quoi, vous offensez-vous de ce qu'on vous estime, Si vous ne pouvez pas supporter mon ardeur Qu'avec du mépris, ou beaucoup de froideur,
Pourquoy m’abordez-vous, venez-vous recognoiſtre Si cét amour eſt mort, que vous auez fait naistre:	Pourquoi m'abordez-vous, venez-vous reconnaître Si cet amour est mort, que vous avez fait naître:
Non, non, tous vos meſpris ne font que l’augmẽter, Et l’horreur du trespas ne me peut rebuter, Encor que vous puißiez beaucoup deſſus mon ame, Vous ne luy pouuez pas donner vne autre flâme, Ne me venez-vous voir que pour ſolliciter, Pour l’importun Amant qui vient de vous quiter, Vous vous trõpez, Alcandre, il vous eſt impoſsible De me rendre iamais à ſon amour ſenſible:	Non, non, tous vos mépris ne font que l'augmẽter, Et l'horreur du trépas ne me peut rebuter, Encor que vous puissions beaucoup dessus mon âme, Vous ne lui devez pas donner une autre flamme, Ne me venez-vous voir que pour solliciter, Pour l'importun Amant qui vient de vous quitter, Vous vous trompez, Alcandre, il vous est impossible De me rendre jamais à son amour sensible:
Ie veux vous preuenir, de peur que vos diſcours Ne me viennent preſſer de luy donner ſecours, Ie ne le puis ſouffrir quelque choſe qu'il face, I'ay trop de feu pour vous, & pour luy trop de gla	Je veux vous prévenir, de peur que vos discours Ne me viennent presser de reste donner secours, Je ne le puis souffrir quelque chose qu'il face, J'ai trop de feu pour vous, et pour lui trop de gla
CINTILLE.	CINTILE.
Ie le viens de quitter, il eſt vray, mais ſçachez Que vous ne tenez plus ſes eſprits attachez, (ce.	Je le viens de quitter, il est vrai, mais sachez Que vous ne tenez plus ses esprits attachez, (ce.
Que ne pouuant ſouffrir voſtre rigueur extreſme, Si vous ne l’aymez point, il en faict tout de meſme.	Que ne pouvant souffrir votre rigueur extrême, Si vous ne l'aimez point, il en fait tout de même.
MELISSEE.	MELISEE.
S’il eſt vray, Florintor m’oblige grandement, Mvie deliurani dinſ a vn iiportun Amant.	S'il est vrai, Florintor m'oblige grandement, Muie délivrani dins a un jiportun Amant.
CINTILLE.	CINTILE.
L’orgueil, & la beauté ſont d’ordinaire enſemble, Vous le deuriez pourtant regretter, ſi me ſemble, Lit iot touſiours tenu dans les loix du deuoir, Et d’autres ſe croiront heureuſes de l’auoir.	L'orgueil, et la beauté sont d'ordinaire ensemble, Vous le devriez pourtant regretter, si me semble, Lit iot toujours tenu dans les lois du devoir, Et d'autres se croiront heureuses de l'avoir.
MELISSEE.	MELISEE.
Qu'vn autre le poſſede, ou qu’il en aime mille, De ſupporter ce mal, il me ſera facile:	Qu'un autre le possède, ou qu'il en aime mille, De supporter ce mal, il me sera facile:
Mais encoré ſçachons le nom de la beauté Qui dans ces nouueaux nœuds retient ſa liberté.	Mais encoré sachons le nom de la beauté Qui dans ces nouveaux nœuds retient sa liberté.
CINTILLE.	CINTILE.
La belle Calirie eſt l’objet de ſa flâme, C’eſt elle qui poſſede à ceſte heure ſon ame.	La belle Calirie est l'objet de sa flamme, C'est elle qui possède à cette heure son âme.
MELISSEE.	MELISEE.
Il n'a pas mal choiſi, mais il a des riuaux Qui le trauerſeront en ſes deſirs nouueaux, L’hiſtoire des amours d’Alidor, & d’Oronte, Pour la meſme beauté le couurira de honte:	Il n'a pas mal choisi, mais il a des rivaux Qui le traverseront en ses désirs nouveaux, L'histoire des amours d'Alidor, et d'Orontte, Pour la rendre beauté le couvrira de honte:
Il ne l’ignore pas,	Il ne l'ignore pas,
LINTILLE.	LINTILE.
C’eſt pour cette raiſon Quiicnoiſit auiourd huy cette belle priſon	C'est pour cette raison Quiicnaisit aujourd' hui cette belle prison
MELISSEE.	MELISEE.
En tout voſtre diſcours ie ne puis rien entendre, Außi ne veux-ie pas dauantage en apprendre, Laiſſonntunuormnoisue purtons que ac evous, Et nous oſtons d’icy, nous ſerons mieux chez nous.	En tout votre discours ie ne puis rien entendre, Aussi ne veux-je pas davantage en apprendre, Laissonntunuormnoisue purtons que ac evous, Et nous ôtons d'ici, nous serons mieux chez nous.
INTILLE tout bas.	INTILE tout bas.
Que ie plains ton malheur, ô pauure Meliſſee, Tu te verras tantoſt bien loin de ta penſee.	Que ainsi plains ton malheur, ô pauvre Mélissee, Tu te verras tantôt bien loin de ta pensée.
ACTE CINQVIESME.	ACTE CINQUIÈME.
SCENE III.	SCÈNE III.
CALIRIE ſeule dans ſa chambre, tenant vn miroir.	CALIRIE seule dans sa chambre, tenant un miroir.
Emon dont la vertu maintient cêt vniuers, Qui te fais recognoiſtre en tes actes diuers, Qui ſçais tout, qui vois tout, Amour Dieu des merueilles, Si ma iuſte priere a touché tes oreilles, 40 Fais reußir de grace vn genereux deſſein, Que ta puiſſante ardeur inspire dans mon ſein, Ah!	Emon dont la vertu maintient cet univers, Qui te fais reconnaître en tes actes divers, Qui sais tout, qui vois tout, Amour Dieu des merveilles, Si ma juste prière a touché tes oreilles, 40 Fais reussir de grâce un généreux dessein, Que ta puissante ardeur inspire dans mon sein, Ah!
miroir autrefois conſulté pour l’vſage Des embelliſſemens qu'on met ſur vn viſage, Dont la glace monſtroit autrefois à mes yeux	miroir autrefois consulté pour l'usage Des embellissements qu'on met sur un visage, Dont la glace montrait autrefois à mes yeux
Vn threſor que chaqu'vn eſtime precieux, Que ie ſuis bien changée, & que ce qui m’oblige A te venir reuoir cruellement m'afflige, Ie viens pour conſulter auec toy les moyens De perdre le plus cher, & plus grand de mes biẽs, Ie ſçay, ſans me flatter, qu'on me peut dire belle, Qu'auiourd’huy ie viens faire vne action nouuelle:	Un thresor que chaqu'un estime précieux, Que tu suis bien changée, et que ce qui m'oblige À te venir revoir cruellement m'afflige, Je viens pour consulter avec toi les moyens De perdre le plus cher, et plus grand de mes bea, Ie bières, sans me flatter, qu'on me peut dire belle, Qu'aujourd'hui toujours viens faire une action nouvelle:
Mais que ne peut l’amour, à qui les immortels, Et toute la nature erige des autels, Oronte ſeul objet de toutes mes penſees Ne croy pas tes ardeurs dans mon ſein effacees, Ie t’ay touſiours aimé, ie t'eſtime touſiours, Et ſans toy ie croirois malheureux tous mes iours, Ie ne ſçay toutesfois ſi me voyant changée, Alors que ton erreur ſera ſur moy vangée, Et voyant mon viſage auecque moins d’appas, Tu ne deuiendras autre que tu n'es pas.	Mais que ne peut l'amour, à qui les immortels, Et toute la nature erige des autels, Oronte seul objet de toutes mes pensées Ne crois pas tes ardeurs dans mon sein effacées, Je t'ai toujours aimé, je t'estime toujours, Et sans toi ainsi croirais malheureux tous mes jours, Je ne sais toutefois si me voyant changée, Alors que ton erreur sera sur moi vengée, Et voyant mon visage avec moins d'appas, Tu ne deviendras autre que tu n'es pas.
Helas!	Hélas!
que ce ſoupçon eſt loin de l’apparence, Tu m'as de ton amour donne trop d’aſſeurance, Siie perds mes appas, au moins ie ne les pers Que pour me retirer de ces iniustes fers, 4 e	que ce soupçon est loin de l'apparence, Tu m'as de ton amour donne trop d'assurance, Siie perds mes appas, au moins On ne les pers Que pour me retirer de ces injustes fers, 4 e
MllClseld.	MllClseld.
Où ta folle amitié pour vn nepueu peu ſage, Sans aucune raiſon à ceſte heure m'engage, Tu trouueras en moy d’autres perfections, Que l’on voit eſclater dedans mes actions, Tu diras que ces traits ſont mon moindre merite, Que ma vertu n'a rien icy qui la limite, Ie ne croy pas außi que tu te ſois peiné, Pour vn peu de beauté par le temps condamné, Qui dans fort peu de iours tombe comme les roſes, Que nous voyons mourir, dés qu’elles ſont eſcloſes, Ton eſprit eſt trop fort pour t'aller engager A l’eſclat que l’on voit ſortir d’vn feu leger, Tu ſçais bienque le temps oſte auec peu de pene La beauté de nos corps, comme vn nom de l’arene, Alidor de qui ſeul prouient mon desplaiſir, Ie la veux immoler à ton cruel deſir, Ce teint qui te plaiſoit va changer de nature, Ie veux guerir ta flâme auecque ma bleſſure, Ce viſage où tu vis tant de charmes puiſſans, Apres ceſte action eſtonnera tes ſens, He ſtons noſtre deſſein, que ma main l’execute;	Où ta folle amitié pour un nepueu peu sage, Sans aucune raison à cette heure m'engage, Tu trouveras en moi d'autres perfections, Que l'on voit éclater dedans mes actions, Tu diras que ces traits sont mon moindre mérite, Que ma vertu n'a rien ici qui la limite, Je ne crois pas aussi que tu te sois peiné, Pour un peu de beauté par le temps condamné, Qui dans fort peu de jours tombe comme les roses, Que nous voyons mourir, dés qu'elles sont écloses, Ton esprit est trop fort pour t'aller engager A éclat que l'on voit sortir feu léger, Tu sçais bienque le temps ôte auec peu de pene La beauté de nos corps, comme nom de arène, Alidor de qui seul prouient mon déplaisir, Ie la veux immoler ton cruel désir, Ce teint qui te plaisoit va changer de nature, Ie veux guérir ta flâme auecque ma blessure, Ce visage tu vis tant de charmes puissans, Apres ceste action étonnera tes sens, stons nôtre dessein, que ma main execute;
109 Mais mõ viſage en pleurs ſemble qu’il me rebute.	109 Mais mo mme en pleurs semble qu'il me rebute.
Non, non, mes tristes yeux, il ne faut point pleurer.	Non, non, mes tristes yeux, il ne faut point pleurer.
Ce qui ne ſçauroit plus auecque vous durer, Ne vous affligez pas, ie vous conſerue encore, Auec mon cœur ardent pour l’objet que i'adore, Et vous tous mes attraits, dont le pouuoir charmãt Me donnoit autrefois tant de contentement, Ne me diriez-vous pas que c'eſt vne manie De me vouloir priuer de voſtre compagnie, Li Que de vouloir vous perdre, & d’eſtre ſans raiſon, Et coupable enuers moy de quelque trahiſon, Il ſemble qu’il ſoit vray, mais quand ie conſidere Le crime iniurieux que vous venez de faire, Que l’oncle, & le nepueu depuis qu'ils ſont amis Sont à voſtre ſujet deuenus ennemis, C’eſt auecque raiſon, que de vous ie me priue, Puiſque c’eſt de vous ſeuls que ce malheur m'arriue, Douleurs fortes douleurs, dont l’apprehenſion Veut rompre le deſſein qu'a fait ma paßion Contre vos ſentimens ie ſuiuray mon enuie, Et ma beauté croiſtra quand ie l’auray rauie.	Ce qui ne saurait plus auecque vous durer, Ne vous affligez pas, tu vous conserve encore, Avec mon cœur ardent pour l'objet que j'adore, Et vous tous mes attraits, dont le pouvoir charma Me donnait autrefois tant de contentement, Ne me diriez-vous pas que c'est une manie De me vouloir priver de votre compagnie, Li Que de vouloir vous perdre, et d'être sans raison, Et coupable envers moi de quelque trahison, Il semble qu'il soit vrai, mais quand je considère Le crime injurieux que vous venez de faire, Que l'oncle, et le nevez depuis qu'ils sont amis Sont à votre sujet deuenus ennemis, est auecque raison, que de vous ie me priue, Puisque est de vous seuls que ce malheur m'arriue, Douleurs fortes douleurs, dont appréhension Veut rompre le dessein qu'a fait ma passion Contre vos sentimens ie suiuray mon envie, Et ma beauté croîtra quand ie auray rauie.
Elle ſe gaſte leviſage auec vn diamant.	Elle se gâte levisage était un diamant.
ACTE CINQVIESME.	ACTE CINQUIÈME.
SCENE IV.	SCÈNE IV.
LARINIAE.	LARINIAE.
CALIRIE.	CALIRIE.
LARINTHE.	LARINTHÉ.
Heure approche de voir finir les differens Que ma fille a fait naiſtre entre les deux parens, Pourtant ie ne voy point luire aucune apparence, Qu'elle en contente deux ſuiuant ſon esperance, Oronte la deſire, Alidor l’aime außi, Tout cela cependant me met engrand ſouçy, Ie l’ay ſur ce ſujet diuerſement preſſee, Mais elle m'a caché iu ſqu’icy ſa penſee, ---- .	Heure approche de voir finir les différents Que ma fille a fait naître entre les deux parents, Pourtant quelque ne vois point luire aucune apparence, Qu'elle en contente deux suivant son espérance, Oronte la désire, Alidor l'aime aussi, Tout cela cependant me met engrand souçi, Je l'ai sur ce sujet diversement pressée, Mais elle m'a caché ju scune sa pensée, -- .
Il la faut là deſſus encor ſolliciter, Toutesfois s’il ſe peut ſans rien precipiter, Elle eſt ſeule à ſa chambre, CALIRIE apres s’eſtre gaſtée le viſage.	Il la faut là dessus encor solliciter, Toutefois s'il se peut sans rien précipiter, Elle est seule à sa chambre, CALIRIE après s'être gâtée le visage.
Alidor, mon viſage, Sans doute eſtant changé changera ton courage, Vien, vien voir Calirie, & dans l’eſtat qu'elle eſt Ie me tromperay bien ſi ſa beaûté te plaiſt.	Alidor, mon visage, Sans doute étant changé changera ton courage, Viens, viens voir Calirie, et dans l'état qu'elle est Je me tromperai bien si sa beaûté te plaît.
LARINTHE voyant ſa fille.	LARINTHÉ voyant sa fille.
Ah!	Ah!
qu'eſt-ce que ie voy, quelle ame ſi barbare A gaſté les beaux traits d’vne beauté ſi rare, Ma fille, mon ſupport, apprens-moy quelle main A commis contre toy ce forfait inhumain, Perdre tant de beautez par de telles bleſſures, Tu l’as veu Dieu du Ciel, & pourtãt tu l’endures.	qu'est-ce que ce la, quelle âme si barbare A gâté les beaux traits d'une beauté si rare, Ma fille, mon support, apprends-moi quelle main A commis contre toi ce forfait inhumain, Perdre tant de beautés par de telles blessures, Tu l'as vu Dieu du Ciel, et pourtant tu l'endures.
CALIRIE.	CALIRIE.
avlaiere ſiniſjez ces lhilles plehrs, N’augmẽtés point ma peine auecque vos douleurs, Ceux qui m'ont fait le mal ſe feront biẽ cognoiſtre.	avlaière sinisjez ces lhilles plehrs, N'augments point ma peine avec vos douleurs, Ceux qui m'ont fait le mal se feront biẽ cognoistre.
6	6
LARINTHE.	LARINTHÉ.
Ne deſoblige point celle qui t'a fait naiſtre, Dis-moy viſte leur nom, tu retardes eneor.	Ne désoblige point celle qui t'a fait naître, Dis-moi vite leur nom, tu retardes eneor.
CALIRIE.	CALIRIE.
Ues deuxi vnesi Oronte, & taulle Mlidor.	Ues deuxi vnesi Oronte, et taulle Mlidor.
LARINTHE.	LARINTHÉ.
Eſtrange cruauté, quoy?	Étrange cruauté, quoi?
ces Amans, dont l’ame Monſtroit à ton ſujet estre toute de flâme, Ont eu le cœur ſi dur de te traiter ſi mal?	ces Amants, dont l'âme Monstrait à ton sujet être toute de flamme, Ont eu le cœur si dur de te traiter si mal?
Helas!	Hélas!
que leur amour, ma fille, t'eſt fatal.	que leur amour, ma fille, t'est fatal.
ACTE	ACTE
ACTE CINQVIESME.	ACTE CINQUIÈME.
SCENE, V.	SCÈNE, V.
FLORINTOR.	FLORINTOR.
LARINTHE.	LARINTHÉ.
CINTILLE.	CINTILE.
MELISSEE.	MELISEE.
CALIRIE.	CALIRIE.
FLORINTOR en entrant.	FLORINTOR en entrant.
E ne ſçay que ſonger pour vn iour d’aſſemblée, Il me ſemble de voir Larinthe bien troublée.	E ne sais que songer pour un jour d'assemblée, Il me semble de voir Larinthe bien troublée.
LARINTHE.	LARINTHÉ.
Venez eſtre teſmoins du plus loſche forfait, Que dans tout l’vniuers ayt encor eſté fait.	Venez der témoins du plus losche forfait, Que dans tout l'univers ait encor été fait.
CINTILLE.	CINTILE.
S’eſt-il trouué quelqu'vn de ce crime capable.	S'est-il trouvé quelqu'un de ce crime capable.
MELISSEE.	MELISEE.
quon aueiſje el earcencure le coupaele.	quon aueisje é parcencure le coupale.
ALIRIE.	ÀLIRIE.
Les coupables bien toſt viendront icy nous voir, Vn moment, eux preſens, vous fera tout ſçauoir:	Les coupables bien tôt viendront ici nous voir, Un moment, eux presens, vous fera tout sçauoir:
Voicy l’vn,	Voici l'autre,
LORINTOR.	LORINTOR.
C'eſt Oronté,	C'est Oronté,
CALIRIE.	CALIRIE.
On verra bien toſt l’autre.	On verra bien tôt l'autre.
ACTE CINQVIESME.	ACTE CINQUIÈME.
SCENE VI.	SCÈNE VI.
ORONTE.	ORONTE.
CALIRIE.	CALIRIE.
ALIDOR.	ÀLIDOR.
MELISSEE.	MELISEE.
CINTILLE.	CINTILE.
FLORINTOR.	FLORINTOR.
LARINTHE.	LARINTHÉ.
ORONTE.	ORONTE.
H!	H!
quelle cruauté, quel mal-heur eſt le noſtre, Quel tygre vous a miſe en ce cruel eſtat, A vommez-ie moy, quit mente apres ecl attentdis	quelle cruauté, quel malheur est le nôtre, Quel tigré vous a mise en ce cruel état, A vommez-je moi, quit mente après ecl attentidis
CALIRIE.	CALIRIE.
Le tygre, cher Oronte, eſt vn autre vous-meſme.	Le tigré, cher Oronte, est un autre vous-même.
Le te ac-t- P	Le te act- P
ORONTE.	ORONTE.
Helas!	Hélas!
n’adiouſtezrien à ma douleur extreſme.	n'adioustezrien à ma douleur extrême.
CINTILLE voyant Alidor.	CINTILE voyant Alidor.
Ah!	Ah!
voicy mon ingrat, dont l’eſprit trans porté Rejnrense damten pareirtent ayic.	voici mon ingrat, dont l'esprit trans porté Rejnrense damten paretirtent ayic.
ALIOOR.	ÀLIOR.
Par celuy qui m'a faict, deuant les Dieux ie iure.	Par celui qui m'a fait, devant les Dieux ie jure.
4 Que la mort du coupable en vangera l’iniure.	4 Que la mort du coupable en vengera l'injure.
CINTILLE.	CINTILE.
Cachons nos mouuemens pour voir la fin de tous.	Cachons nos mouvements pour voir la fin de tous.
CRLIRIE.	CRLIRIE.
Vous vous en deſdirez, puiſque ce n’eſt que vous.	Vous vous en dédirez, puisque ce n'est que vous.
Alidor, ORONTE,	Alidor, ORONTE,
CALIRIE.	CALIRIE.
C’eſt luy-meſme,	C'est autre-même,
ara dn aa eu da Ie ne ſçay plus que dire, Enfin toute eſtonnée,  2 M	ara dn a eu da Je ne sais plus que dire, Enfin toute étonnée, 2 M
CINTILLE.	CINTILE.
Acheuons la iournée, Vous verrez des ſujets de plus d’eſtonnement.	Achevons la journée, Vous verrez des sujets de plus d'étonnement.
FLORINTOR.	FLORINTOR.
En volla blenpourtrrnit que t'en voir aurentente	En volla blenpourtrent que t'en voir aurentente
CALIRIE.	CALIRIE.
Alidor qu'eſt-cecy, vous destournez la veuë, Ne ſuis-ie plus d’attraits à vos yeux ſi pourueuë, N’ay-ie plus ces beautez que vous cherißiez tât, Comment, ce peu de ſang vous rend-il inconſtant, Et toy, mon cher Amant, en feras-tu de meſme, Auiourd’huy que tu vois que perſonne ne m'aime, Voy, voy que ce viſage eſt ſeulement changé, Pour monſtrer mon amour, & te rendre venge, Perſonne deſormais ne s’oppoſe à ta flâme, Ie ſçay que ton amour eſtoit toute pour l’ame, Qu'elle ſe maintenoit par de plus forts appas Que ceux qu’on voit le ſoir, & demainne ſont par;	Alidor qu'est-ceci, vous détournez la vue, Ne suis-je plus d'attraits à vos yeux si pourvue, N'ai-je plus ces beautés que vous cherissiez tât, Comment, ce peu de sang vous rend-il inconstant, Et toi, mon cher Amant, en feras-tu de même, Auiourd’hui que tu vois que personne ne m'aime, Vois, vois que ce visage est seulement changé, Pour montrer mon amour, et te rendre venge, Personne désormais ne s'oppose à ta flamme, Je sais que ton amour toute pour pour Qu'âme, Qu'elle se maintenait par de plus forts appas Que ceux qu'on voit le soir, et demainne et par'
Mais parce que chacun attend que ie luy die Le veritable autheur de cette tragedie, Sçachez que c'eſt Oronte, auec ſon Alidor, Qui me priuent auiourd’huy de ce riche threſor, Oronte pour m’auoir trop librement cedée A qui ie ne pouuois iamais eſtre accordée, Et vous ſon cher nepueu, pour auoir trop aime Cét eſclat de beauté qui vous auoit charme:	Mais parce que chacun attend que ainsi ainsi die Le véritable auteur de cette tragédie, Sachez que c'est Oronte, avec son Alidor, Qui me privent aujourd'hui de ce riche thresor, Oronte pour m'avoir trop librement cédée À qui ie ne pouvais jamais être accordée, Et vous son cher nepueu, pour avoir trop aime Cet éclat de beauté qui vous avait charme:
Mais ie rends grace aux Dieux, que mon ame contente Apres ce peu de mal receura ſon attente, Oronte qui deuoit de tout droit eſtre mien, Apres ce que i’ay fait me voudra plus de bien, Et vous braue Alidor, cognoiſſant voſtre faute, Vous m'eſtimerez plus d’vne action ſi haute, dousen ſyaucz ta cauſe, en volta tintrument, Que ma main a conduit à l'accompliſſement.	Mais mille rends grâce aux Dieux, que mon âme contente Après ce peu de mal recevra son attente, Oronte qui devait de tout droit même mien, Après ce que j'ai fait me voudra plus de bien, Et vous brave Alidor, connaissant votre faute, Vous m'estimez plus d'une action si haute, dousen syaucz ta cause, en volta tintrument, Que ma main a conduit à l'accomplissement.
DRONTE.	DRONTE.
Apres cette action, quelle vertu pareille Nous a iamais produit vne telle merueille, Que ie cheris ce ſang qu'on a versé pour moy, Nnectomnenautle levaſe, te voy.	Après cette action, quelle vertu pareille Nous a jamais produit une telle merveille, Que ie chéris ce sang qu'on a versé pour moi, Nunectomnenautle levase, te vois.
Ma belle fille excuſe Qronte, ie te prie, I'obtiens entierement auiourd'huy Calirie.	Ma belle fille excuse Qronte, on te prie, J'obtiens entièrement aujourd'hui Calirie.
BARINTHE.	BARINTHÉ.
Mai parmy ces transports ſon mal s'enuenimat.	Ma parmi ces transports son mal s'envenimât.
Vous pourroit bien rauir tout ce contentement.	Vous pourrait bien ravir tout ce contentement.
ALIDOR Confus de tout cecy, ma pauure ame abbatuë Deteur pouuoir parter vainement s eſuertue.	ÀLIDOR Confus de tout ceci, ma pauvre âme abattue Deteur pouvoir parter vainement s' évertue.
CINTILLE.	CINTILE.
Ce n’eſt pas tout, ingrat, la cholere des Dieux Vient expoſer ton crime auttntmutes yeux, Ne me cognois-tu point?	Ce n'est pas tout, ingrat, la colère des Dieux Vient exposer ton crime auttntmutes yeux, Ne me connais-tu point?
ALIDOR.	ÀLIDOR.
Ah!	Ah!
valeureux Alcandre, Ie n’ay point de raiſon qui me puiſſe defendré, Il est vray, ie l’aduouë, & le Ciel eſt trop doux De m’auoir eſpargné dans ſon iuste courroux:	valeureux Alcandre, Je n'ai point de raison qui me puisse défendré, Il est vrai, toujours l'avoue, et le Ciel est trop doux De m'avoir épargné dans son juste courroux:
I’ay trahy voſtre ſœur, & mon ame infidelle Merite de ſouffrir vne peine eternelle:	J'ai trahi votre sœur, et mon âme infidèle Mérite de souffrir une peine éternelle:
Ah!	Ah!
Cintille, Cintille, apres cett action, Ie ne merite plus ta chaſte affection, Ie t’ay trop offenſee, & mon ame pariure Ne ſe pourraiamais lauer de cett'iniure, Toutesfois, cher amy, ſi le vray repentir, Qui fait comme tu voy tous mes ſouſpirs ſortir, Te porte à la pitié, pardonne monoffenſe – -7-16 - - 1  Entreprens vers ta ſœur, toy-meſme ma defenſe, Ramene cẽt eſclaue à ſa captiuité, Et ne le traite pas comme il a merité, Que ſita ſœur encor conſerue dans ſon ame, Pour vn coupable Amant quelque reſte de flâme, Bten-heu reux Alidor, mais ie ne le croy pas, I’ay trop indignement mesprisé ſes appas.	Cintille, Cintille, après cet action, Je ne mérite plus ta chaste affection, Je t'ai trop offense, et mon âme parjure Ne se pourraiamais lauer de cett' injure, Toutefois, cher ami, si le vrai repentir, Qui fait comme tu vois tous mes soupirs sortir, Te porte à la pitié, pardonne mon - - 1 Entreprens vers ta sœur, toi-même ma défense, Ramene cẽt esclaue â sa captiuité, Et ne le traite pas me il a me, Que sita sœur encor conserve dans son âme, Pour coupable Amant quelque reste de flâme, Bten-heu reux Alidor, mais ie ne le croy pas, ay trop indignement mesprisé ses appas.
CINTILLE.	CINTILE.
Leuez-vous Alidor, l’offenſe eſt pardonnée, Et gardez mieux la foy quand vous tanttz donee.	Levez-vous Alidor, l'offense est pardonnée, Et gardez mieux la foi quand vous tanttz done.
Regardez qui vous parle,	Regardez qui vous parle,
ALIDOR.	ÀLIDOR.
O bon heur nompareil, Mes yeux ſont esbloüys à ce nouueau ſoleil, Cintiie, ceſt pous mefine ye beauté fans exemple, A qui les cœurs des Dieux doiuẽt ſeruir de temple Helas!	Ô bon heur nompareil, Mes yeux sont éblouis à ce nouveau soleil, Cintière, cest pous mène y beauté sans exemple, À qui les cœurs des Dieux doiuẽt servir de temple Hélas!
quel bon demon vous à conauitity.	quel bon démon vous à conauitity.
CINTILLE.	CINTILE.
Ton crime, & mon amour:	Ton crime, et mon amour:
MELISSEE tout bas.	MELISEE tout bas.
Quel changement voicy;	Quel changement voici;
Alcandre Alcandre est vne fille, ô folle Meliſſee, De quel trait amoureux est ton ame bleſſee L’objet de tes deſirs ne te peut ſecourir, Et qui t’a fait le mal ne te ſçauroit guerir, Amour, c'est donc ainſi cruel que tu m'abuſes.	Alcandre Alcandre est une fille, ô folle Melisse, De quel trait amoureux est ton âme blessée L'objet de tes désirs ne te peut secourir, Et qui t'a fait le mal ne te saurait guérir, Amour, c'est donc ainsi cruel que tu m'abuses.
CINTILLE.	CINTILE.
C’eſt aſſez, Alidor, on reçoit vos excuſes, A la charge pourtant de ne puit renenir A la faute qu'amour eſtoit preſt de punir.	C'est assez, Alidor, on reçoit vos excuses, À la charge pourtant de ne puit renenir A la faute qu'amour était prêt de punir.
ALIDOR.	ÀLIDOR.
Si iamais autre amour que le voſtre me preſſe, Si quelque autre beauté que la voſtre me bleſſe, Que le Dieu qui punit le crime des Amans Inuente à mon ſujet mille nouueaux tourmens.	Si jamais autre amour que le vôtre me presse, Si quelque autre beauté que la vôtre me blesse, Que le Dieu qui punit le crime des Amants Inuente à mon sujet mille nouveaux tourments.
CALIRIE.	CALIRIE.
Que i'ay peu de regret à ma derniere perte, Et que t'ay da plaiſir de ma douleur ſoufferte, Puis qu’en vn ſeul moment ruinant mes attraits, Oronte, & ſon nepueu ſe trouuent ſatisfaits.	Que j'ai peu de regret à ma dernière perte, Et que t'ai da plaisir de ma douleur soufferte, Puis qu'en un seul moment ruinant mes attraits, Oronte, et son nepueu se trouvent satisfaits.
CINTILLE.	CINTILE.
Approchez Meliſſee, embraſſez vostre Alcãdre, Tout autre toutesfois qu'on ne deuoit attendre, Et ne rougiſſez point que ſous ces habits faux Ie vous aye apporté de veritables maux, Florintor dont l’amour vous eſt aſſez cognuë, Qui parmy vos meſpris euſt tant de retenuë, Qui perſiſte touſiours en ſa premiere ardeur Doit faire ſucceder l’amour à la froideur.	Approchez Mélissee, embrassez esprit Alcondre, Tout autre toutefois qu'on ne devait attendre, Et ne rougissez point que sous ces habits faux Je vous aie apporté de véritables maux, Florintor dont l'amour vous est assez connue, Qui parmi vos mépris eût tant de retenue, Qui persiste toujours en sa première ardeur Ait faire succéder l'amour à la froideur.
MELISSEE.	MELISEE.
Ouy, Cintille, il eſt vray que mon ame enflamee Vous a dans ces habits trop ardemmant aimee:	Oui, Cintille, il est vrai que mon âme enflamène Vous a dans ces habits trop ardemmant aimée:
Mais qui n'adoreroit des appas ſi puiſſans, Et n'aſſub jettiroit à vos yeux tous les ſens, Et pour vous teſmoigner que ie vous aime encore, Qa quel ſexe qui ſoit vos merites i'autre, Pour vous plaire ie veux receuoir Florintor, Auec la meſme ardeur que vous voſtrę Alidor.	Mais qui n'adorerait des appas si puissants, Et n'assub jetait à vos yeux tous les sens, Et pour vous témoigner que je vous aime encore, Qa quel sexe qui soit vos mérites j'autre, Pour vous plaire tu veux recevoir Florintor, Avec la vôtre ardeur que vous vostr Ilidor.
FLORINTOR.	FLORINTOR.
Surpris d’eſtonnement, & de plaiſir enſemble, Que l’amour en ce lieu tant d’accidens aſſemble, Ie croy que quelque ſonge a doucement ſurpris, Au milieu du ſommeil mes amoureux esprits, Meliſſee a mis fin à ſa rigueur cruelle, Et veut que Florintor bruſle touſiours pour elle, Enfin elle a pitié de ſes cruels ennuis, d'altes-moy plus certain de l'eſtat ou ie ſuis,	Surpris d'étonnement, et de plaisir ensemble, Que l'amour en ce lieu tant d'accidents assemble, Je crois que quelque songe a doucement surpris, Au milieu du sommeil mes amoureux esprits, Mélissee a mis fin à sa rigueur cruelle, Et veut que Florintor brûle toujours pour elle, Enfin elle a pitié de ses cruels ennuis, d'ales-moi plus certain de l'état ou je suis,
MELISSEE.	MELISEE.
Vous auez tout ſujet d’auoir l’ame contente Si mon affection eſt toute voſtre attente.	Vous avez tout sujet d'avoir l'âme contente Si mon affection est toute votre attente.
FLORINTOR.	FLORINTOR.
P.	P.
ur ces invis aniour a nuy vous me reſſaſcuezs Et ie benis les maux ſi long temps ſupportez.	ur ces invis aniour a nui vous me ressascuezs Et ici bénis les maux si long temps supportez.
LARINTHE.	LARINTHÉ.
Le malde Calirie à tous momens s’augmente, Et quoy qu'elle ſe feigne, il faut qu’il la tourmente, C’eſt pourquoy puis qu'amour agit ſeul en cecy, Meliſſee, & Cintille arreſteront icy, Et cependant que l’art remettra ſon viſage, Les propos amoureux reprendront leur vſage, Iuſqu'à ce qu'vn hymen confirmant vos amours, Vous vniſſe tous ſix le reſte de vos iours.	Le malde Calirie à tous moments s'augmente, Et quoi qu'elle se feigne, il faut qu'il la tourmente, C'est pourquoi puis qu'amour agit seul en ceci, Mélissee, et Cintille arrêteront ici, Et cependant que l'art remettra son visage, Les propos amoureux reprendront leur usage, Jusqu'à ce qu' Hymen confirmant vos amours, Vous unisse tous six le reste de vos jours.
