ADVERTISSEMENT L A V TE V R ECTEVR.	ADVERTISSEMENT L À V TE V R CTEUR.
Si quelques heures perduës m’ont permis de faire cette Piece, ce n’a pas eſté mon intention de la donner au Public:	Si quelques heures perdues m'ont permis de faire cette Pièce, ce n'a pas été mon intention de la donner au Public:
Mais depuis;	Mais depuis;
ie luy ay voulu faire voir le monde, & l’ay tirée de la ſolitude de mon Cabinet où elle ã ij a eſté produitte ſans beaucoup de peine & de trauail, puis qu’elle m’a ſeruy de diuertiſſement, & a occupé mon eſprit par vne pure fantaiſie, quoy que le ſujet en ſoit tiré de l’Exil de Polexandre:	Les autres ai voulu faire voir le monde, et l'ai tirée de la solitude de mon Cabinet où elle a a été produite sans beaucoup de peine et de travail, puis qu'elle m'a servi de divertissement, et a occupé mon esprit par une pure fantaisie, quoi que le sujet en soit tiré de l'Exil de Polexandre:
Ce ſont des perſonnages que i’ay fait Poëtes apres auoir eſté Orateurs;	Ce sont des personnages que j'ai fait Poètes après avoir été Orateurs;
Si vous prenez plaiſir à entendre leurs fortunes, & qu’elles vous plaiſent en ce déguiſement, ie ne croiray pas auoir perdu mon temps.	Si vous prenez plaisir à entendre leurs fortunes, et qu'elles vous plaisent en ce déguisement, sans ne croirai pas avoir perdu mon temps.
Mais ſi ils vous dégouſtent, ie ne m’en attriſteray point.	Mais si ils vous dégoûtent, Seigneur ne m'en attristerai point.
C’eſt pourquoy dans cette indifference d’approbation ou de cenſure ie l’ay fruſtrée d’vn Protecteur, qui ſeroit obligé de ſouſtenir les deffauts que voſtre patience trouueroit en liſant.	C'est pourquoi dans cette indifférence d'approbation ou de censure ie aay frustrée d'un Protecteur, qui serait obligé de soutenir les défauts que votre patience trouverait en lisant.
Excuſez donc, LECTEVR, il vous n’y trouuez aucun agréement qui vous plaiſe, puiſque ce n’auoit pas eſté mon deſſein de vous la donner.	Excusez donc, LECTEUR, il vous n'y trouvez aucun agrément qui vous plaise, puisque ce n'avait pas été mon dessein de vous la donner.
C’eſt la ſeule raiſon qui me fait meſpriſer vos Cenſures, puis qu’elle n’a eſté faite que pour ma ſatisfaction.	C'est la seule raison qui me fait mépriser vos Censures, puis qu'elle n'a été faite que pour ma satisfaction.
Adieu.	Adieu.
LES ACTEVRS CINTILLE, Reine de Suede.	LES ACTEURS CINTILLE, Reine de Suède.
ATIILEA, Gentil-homme Suedois.	ATIILEA, Gentilhomme Suedois.
ZERBINE, Suiuante de Cintille.	ZERBINE, Suivante de Cintille.
ISATIDE, Princeſſe Arabe.	ISATIDE, Princesse Arabe.
ALCIOMEDE, Confident d’Attilla.	ÀLCIOMEDE, Confident d'Atilla.
OITIDDEDRAHuI, lInice d’Auſtraſie.	OITIDDEDRAHuI, lInice d'Autrasie.
TANABONTE, Tante de Cintille.	TANABONTE, Tante de Cintille.
PANDOR, Confident de Childebrand.	PANDOR, Confident de Childebrand.
Les ſoldats dela ſuitte de Childebrand.	Les soldats déla suitte de Childebrand.
DE ANNGEANCE.	DE ANGEANCE.
ACTE PREMIER.	ACTE PREMIER.
SCENE PREMIERE.	SCÈNE PREMIÈRE.
ATTILLA, CINTILLE, ISATIDE, ZERBINE.	ATTILA, CINTILLE, ISATIDE, ZERBINE.
E vous efforcez plus à me faire mourir, Puiſque vostre beauté refuſe à me guerir, Voſtre cœur endurcy ſe rit de ma constanMon amour fait ma peine, & mon feu fait mon mal, Pour tout fruit de ma foy ie ſuis vn deſloyal.	E vous efforcez plus à me faire mourir, Puisque votre beauté refuse à me guérir, Votre cœur endurci se rit de ma constanMon amour fait ma peine, et mon feu fait mon mal, Pour tout fruit de ma foi je suis un déloyal.
En fin, Belle Cintille, est-ce la mon ſalaire, PayeZ vous mon amour de haine & de colere?	En fin, Belle Cintille, est-ce la mon salaire, PayeZ -vous mon amour de haine et de colère?
nons nuuez qne poui moy uo uinnunmite, Non, non, ce n'eſt pas là ce que i'ay merité.	nons nuez qne pouy moi uo innunite, Non, non, ce n'est pas là ce que j'ai mérité.
CINTILLE.	CINTILE.
Vacruel, va barbare, ennemy de ma vie;	Vacruel, va barbare, ennemi de ma vie;
Quoy!	Quoi!
ta rage n'est pas tout à fait aſſouuie?	ta rage n'est pas tout à fait assouuie?
Homme le plus meſchant qui ſoit deſſous les Cieux;	Homme le plus méchant qui soit dessous les Cieux;
Ie connois ton deſſein, ie le lis dans tes yeux.	Je connais ton dessein, Seigneur le lis dans tes yeux.
Tu veux ioindre ma mort à celle de mon pere, Si c’eſt ta volonté tu n'as donc qu’a le faire;	Tu veux joindre ma mort à celle de mon père, Si c'est ta volonté tu n'as donc qu'a le faire;
Tu me tiens en tes mains, & ma condition Agraue ton forfait par ta laſche action;	Tu me tiens en tes mains, et ma condition Agrave ton forfait par ta lâche action;
Tu ne me connois plus, & ce tiltre de Reine Dont ie ſuis honorée est l’obiect de ta haine.	Tu ne me connais plus, et ce titre de Reine Dont tu suis honorée est l'objet de ta haine.
ATTILLA.	ATTILA.
Les crimes que i’ay faits, Amour les a commis;	Les crimes que j'ai faits, Amour les a commis;
C’est vn Enfant aueugle à qui tout eſt permis;	C'est un Enfant aveugle à qui tout est permis;
Qu'vn Riual à mes yeux inſolemment me braue, Et pour m’auoir vaincu qu’il me traitte en eſclaue.	Qu'un Rival à mes yeux insolemment me brave, Et pour m'avoir vaincu qu'il me traite en esclave.
Vn autre qu'Attilla peut-estre l’eust ſouffert, Pour estre trop cruel bien ſouuent l’on ſe pert;	Un autre qu'Atilla peut-être l'eût souffert, Pour être trop cruel bien souvent l'on se pert;
I'aſſeure mon amour contre la jalouſie,	J'assure mon amour contre la jalousie,
CINTILLE.	CINTILE.
Pourſuy, pourſuy perfide, autheur de mes mal-heurs, Donne moy le treſpas, mets fin à mes douleurs;	Poursui, poursui perfide, auteur de mes malheurs, Donne moi le trépas, mets fin à mes douleurs;
Exerce deſſus moy ton humeur ſanguinaire, Donne moy le repos, oſte moy de miſere.	Exerce dessus moi ton humeur sanguinaire, Donne moi le repos, ôte moi de misère.
Mais que tu monstres bien ton mauuais naturel, En toutes les façons ton eſprit eſt cruel;	Mais que tu monstres bien ton mauvais naturel, En toutes les façons ton esprit est cruel;
Tu dénies la vie à qui te la demande, Et tu donnes la mort à qui plus l’apprehende.	Tu dénies la vie à qui te la demande, Et tu donnes la mort à qui plus l'appréhende.
ATTILLA.	ATTILA.
Que ie fiſſe mourir la Reine de mon cœur.	Que quelque fisse mourir la Reine de mon cœur.
CINTILLE.	CINTILE.
St i'en eſtois la Reine, infame ſuborneur, Auec plus de reſpect ie me verrois traittée, Tu ne me tiendrois pas de la ſorte arrestée, En fin, ſi ie l’eſtois i'aurois quelque pouuoir.	St j'en étais la Reine, infâme suborneur, Avec plus de respect ion me verrais traitée, Tu ne me tiendrais pas de la sorte arrêtée, En fin, si tu l'étais j'aurais quelque pouvoir.
ATTILLA.	ATTILA.
Lequel demandez vous,	Lequel demandez -vous,
CINTILLE.	CINTILE.
De iamais ne me voir, Et de ne te trouuer iamais en ma preſence.	De jamais ne me voir, Et de ne te trouver jamais en ma présence.
ATTILLA.	ATTILA.
Adian dast tnat tarlac aaic as diſaaume m’aſtanca Attuis fort.	Adian dât tint tarlac ajà as disame m'astanca Atis fort.
DEVXIESME.	DEUXIÈME.
CINTILLE, ISATIDE, ZERBINE,	CINTILE, ISATIDE, ZERBINE,
M CINTILLE.	M MDINTILLE.
Ous voyeZ, chere ſœur, où le ſort me reduit;	Ous voyeZ, chère sœur, où le sort me réduit;
Lors qu’icy ce Tyran luy meſme me conduit, Depuis tantost deux ans ce brutal me tourmente;	Lors qu'ici ce Tyran lui était me conduit, Depuis tantôt deux ans ce brutal me tourmente;
Que ie force mon cœur, que ie ſois ſon Amante.	Que personne force mon cœur, que ici sois son Amante.
Iſatide, où ie ſuis l’on ne voit que mal-heurs, Pour mon ſoulagement il me reſte des pleurs.	Isatide, où on suis l'on ne voit que malheurs, Pour mon soulagement il me reste des pleurs.
Voulez vous eſcouter auec quelle induſtrie Ce traiſtre m’enleua de ma chere Patrie;	Voulez -vous écouter avec quelle industrie Ce traître m'enleva de ma chère Patrie;
Si vous preſteZ l’oreille à ce triſte diſcours, Vous ſçaurez tout au long les mal-heurs de mes iours	Si vous prêtez l'oreille à ce triste discours, Vous saurez tout au long les malheurs de mes jours
ISATIDE.	ISATIDE.
n 111.	n 111.
1.	1.
Oceſtou mon enuie De ſçauoir voſtre histoire, & celle de ſa vie.	Océtou mon envie Dé sçauoir votre histoire, et celle de sa vie.
CINTILLE.	CINTILE.
Vous ſçaurez, chere ſœur, que tous mes plus beaux ans Ont esté trauerſez par diuers accidens, Et le Ciel ennuyeux du repos de mon pere, Nous monſtra tout d’vncoup la fortune contraire:	Vous saurez, chère sœur, que tous mes plus beaux ans Ont été traversez par divers accidents, Et le Ciel ennuyeux du repos de mon père, Nous montra tout d'uncoup la fortune contraire:
Car ce traiſtre ſubiect, & cét esprit ruſé Tinſt enſemble Alaric, & le peuple abuſé.	Car ce traître sujet, et cet esprit rusé Tinst ensemble Alaric, et le peuple abusé.
Il changea tout l’Eſtat, & par ſon artifice Tout ſe laiſſa conduire à ſon propre caprice;	Il changea tout l'État, et par son artifice Tout se laissa conduire à son propre caprice;
Il bannit de la Cour tous les vrais ſeruiteurs, A la place des bons on y vit des flatteurs;	Il bannit de la Cour tous les vrais serviteurs, À la place des bons on y vit des flatteurs;
Tout y fut peruerty par ſes deſſeins tragiques, Et ſes meſchancetez, paſſoient pour Politiques;	Tout y fut perverti par ses desseins tragiques, Et ses méchancetés, passaient pour Politiques;
Ses cruauteZ eſtoient des maximes d’Eſtat, Vne action pieuſe estoit vn attentat.	Ses cruauté étaient des maximes d'État, Une action pieuse était un attentat.
Pendant tous ces mal-heurs (où toute la Suëde Ne trouuoit à ſon mal Medecin ny remede;	Pendant tous ces malheurs (où toute la Suëde Ne trouvait à son mal Médecin ny remède;
Mon pere deceda me laiſſant dans les mains Du plus meſchant qui fuſt entre tous les humains.	Mon père décéda me laissant dans les mains Du plus méchant qui fût entre tous les humains.
Außi toſt il braſſa mille guerres ciuilles, Il taſcha par preſens de corrompre les villes;	Aussi tôt il brassa mille guerres civilles, Il tâcha par prés de corrompre les villes;
Alors s’apperceuant de ſon ambition, 'eſclat d’vne Couronnne occupa ſa penſée e deſir le toucha, ſon ame en fut bleßée;	Alors s'apercevant de son ambition, ' éclat d'une Couronnne occupa sa pensée e désir le toucha, son âme en fut blessée;
ſais en fin ſon deſſein ne pouuant reußir, on arrogante humeur venoit à s’adoucir, ?	sais en fin son dessein ne pouvant revir, on arrogante humeur venait à s'adoucir, ?
reçeus de ſa main le Sceptre & la Couronne;	reçus de sa main le Sceptre et la Couronne;
ſe fit mon Tuteur pour garder ma perſonne;	se fit mon Tuteur pour garder ma personne;
leconnoiſſeZ vn peu ſon tragique deſſein, ’eſtoit afin d’auoir le pouuoir à la main.	leconnoisseZ un peu son tragique dessein, étaît afin d'avoir le pouvoir à la main.
llors tout le païs ſentit ſa tyrannie, Le vice s’eſtablit, la vertu fut bannie.	lors tout le pays sentit sa tyrannie, Le vice s'établit, la vertu fut bannie.
Quand tous les Suedois furent ſous ſon pouuoir, Pendant cinq ans entiers ie fus bien ſans le voir;	Quand tous les Suédais furent sous son pouvoir, Pendant cinq ans entiers toujours fus bien sans le voir;
l fut chez nos voiſins comme vn foudre de guerre, porter la terreur, & par Mer & par Terre;	l fut chez nos voisins comme un foudre de guerre, porter la terreur, et par Mer et par Terre;
Cout ce qu’il rencontroit reſiſter à ſon bras, j'ans espargner perſonne il mettoit tout à bas.	Cout ce qu'il rencontroit résister à son bras, j'ans épargner personne il metait tout à bâter.
Cout le Septentrion eſprouua ſon courage, Mais pluſtoſt des effects d’vn homme plein de rage;	Cout le Septentrion éprouva son courage, Mais plutôt des effets d'un homme plein de rage;
L’on reuit à la Cour cét eſprit violent Beaucoup plus furieux, & bien plus inſolent;	L'on revit à la Cour cet esprit violent Beaucoup plus furieux, et bien plus insolent;
Tout d’vn coup cét eſprit par vn prodige eſtrange Deuint doux, mais l’Amour fit luy ſeul cét eſchange.	Tout d'un coup cet esprit par un prodige étrange Deuint doux, mais l'Amour fit quelque seul cet échange.
L’Amour dedans ſes fers l’ayant trop bienlié, Cét orgueilleux eſprit deuint humilié;	L'Amour dedans ses fers l'ayant trop bienlié, Cet orgueilleux esprit devint humilié;
Car eſtant à ſon cœur vn obiect plein de charmes, Il fut bien toſt reduit à l’vſage des larmes.	Car étant à son cœur un objet plein de charmes, Il fut bien tôt réduit à l'usage des larmes.
Il n'a iamais manqué de ruſes ny d’adreſſes Pour gagner mon eſprit par de fauſſes promeſſes;	Il n'a jamais manqué de ruses mains d'adresses Pour gagner mon esprit par de fausses promesses;
Il me portoit beaucoup de reſpect & d’honneur, Il diſoit que de moy dépendoit ſon bon-heur;	Il me portait beaucoup de respect et d'honneur, Il disait que de moi dépendait son bonheur;
Il venoit tous les iours pour m’offrir ſes ſeruices Il me promit vn Temple auec des Sacrifices;	Il venait tous les jours pour m'offrir ses services Il me promit un Temple avec des Sacrifices;
Eſtonit Zles eſſecis de ſa vrutalité, Car ſon Amour paſſa iuſqu'à l’impieté.	Étonit Zles essecis de sa vrutalité, Car son Amour passa jusqu'à l'impiété.
ISATIDE.	ISATIDE.
A quoy ſe reſolut ce Monſtre de Nature.	À quoi se résolut ce Monstre de Nature.
CINTILLE.	CINTILE.
Zerbine peut conter toute cette aduanture.	Zerbine peut conter toute cette aventure.
Ie ne veux pas laiſſer mon diſcours imparfait, Ie veux rendre en cela voſtre eſprit ſatisfait.	Je ne veux pas laisser mon discours imparfait, Je veux rendre en cela votre esprit satisfait.
ATIDE.	ATIDE.
Vous m’obligez beaucoup,	Vous m'obligez beaucoup,
CINTILLE.	CINTILE.
Aſui par nes Troumnces Se dire l’ennemy des Seigneurs & des Princes, Qui deſſus ſes Autels ne voudroient conſacrer A la Diuinité qu’il faiſoit adorer.	Asui par nés Troumnces Se dire l'ennemi des Seigneurs et des Princes, Qui dessus ses Autels ne voudraient consacrer À la Divinité qu'il faisait adorer.
La grande ambition de ſon humeur altiere Eit trataſou tau ta-a -----l.	La grande ambition de son humeur altière Eit tratasou tau ta-a --l.
Ses deſſeins inoüis paſſerent plus auant, Il enuoya chercher des marbres au Leuant Pour me faire baſtir le plus ſuperbe Temple Qui fust ſans ſon pareil, & qui n'euſt point d’exemple;	Ses desseins infinis passèrent plus avant, Il envoya chercher des marbres au Lévant Pour me faire bâtir le plus superbe Temple Qui fût sans son pareil, et qui n'eût point d'exemple;
Il fut bien commencé, mais cét eſprit mal fait Fit laiſſer à la fin cét ouurage imparfait:	Il fut bien commencé, mais cet esprit mal fait Fit laisser à la fin cet ouvrage imparfait:
Cependant noſtre Cour deuint ſi magnifique, Que ce n'eſtoit par tout que balets & muſique.	Cependant notre Cour devint si magnifique, Que ce n'était par tout que ballets et musique.
Les peuples eſtrangers reçeurent les cartels, Qui firent contre nous tant d’ennemis mortels, Son mal-heureux Tournoy fit à ſon ouuerture Par ſes éuenemens vne triste aduanture.	Les peuples étrangers recevrent les cartels, Qui firent contre nous tant d'ennemis mortels, Son malheureux Tournoi fit à son ouverture Par ses événements une triste aventure.
Là pluſieurs Cheualiers pouſſeZ d’ambition, De ſouſtenir le rang de leur condition;	Là plusieurs Chevaliers poussés d'ambition, De soutenir le rang de leur condition;
Captiuez des appas de leurs cheres Maiſtreſſes, Monstrerent en ce Tournoy leurs plus grandes adreſſes.	Captivez des appas de leurs chères Maîtresses, Monstrerent en ce Tournoi leurs plus grandes adresses.
La Fortune trabit leurs genereux deſſeins, Attilla les vainquit, leurs efforts furent vains;	La Fortune trabit leurs généreux desseins, Atilla les vainquit, leurs efforts furent vains;
Cét orgueilleux eſprit du fruit de ſa victoire, Se vit bien toſt décheu de ſa nouuelle gloire, Lors que deſſus les rangs parut vn Cheualier, Dont l’eſclat merueilleux nous fit tout oublier.	Cet orgueilleux esprit du fruit de sa victoire, Se vit bien tôt décheu de sa nouvelle gloire, Lors que dessus les rangs parut un Chalier, Dont l'éclat merveilleux nous fit tout oublier.
A voir ce Cheualier ſi remply d’apparence, L’on en conçeut deſlors vne bonne esperance;	À voir ce Chevalier si rempli d'apparence, L'on en conçut délors une bonne espérance;
Et m’ayant apperçeuë, il parla de la ſorte:	Et m'ayant aperçue, il parla de la sorte:
Zerbine, pourſuiueZ, car la douleur m’emporte;	Zerbine, poursuivez, car la douleur m'emporte;
Ie ne ſçaurois vous faire vn ſi triste diſcours, Dont le reſſouuenir eſt fatal à mes iours.	Je ne saurais vous faire un si triste discours, Dont le ressouvenir est fatal à mes jours.
SATIDE.	SATIDE.
Acheuez, s’il vous plaiſt.	Achevez, s'il vous plaît.
IN TILLE.	IN TILLE.
Eſtant laſſe de viure, Pour augmenter mon mal ie m’en vais le pourſuiure.	Étant lasse de vivre, Pour augmenter mon mal Dieux m'en vais le poursuivre.
Madame, me dit-il, ces Cheualiers deffaits, Ayans esté vaincus ſont aſſez ſatis faits;	Madame, me dit-il, ces Chevaliers défaits, Ayants été vaincus sont assez satî faits;
Puiſque voſtre beauté par l’eſclat de ſes charmes, Par le bras d’Attilla leur fit rendre les armes.	Puisque votre beauté par l'éclat de ses charmes, Par le bras d'Atilla leur fit rendre les armes.
Le Ciel a conſerué voſtre propre intereſt, Par le bras d’Attilla tout criminel qu’il eſt, Mais il vous déniroit à ce coup ſa iustice, S’il ne vouloit punir ce Monſtre plein de vicé.	Le Ciel a conservé votre propre intérêt, Par le bras d'Atilla tout criminel qu'il est, Mais il vous déniroit à ce coup sa justice, S'il ne voulait punir ce Monstre plein de vicé.
Ouy, Madame, le Ciel me conduit en ces lieux Pour punir deuant vous cét homme audacieux.	Oui, Madame, le Ciel me conduit en ces lieux Pour punir devant vous cet homme audacieux.
Madame, approuueZ donc que ie prenne vangeance Des torts qu’il vous a faits deuant voſtre preſence.	Madame, approuvez donc que sans prenne vengeance Des torts qu'il vous a faits devant quelque présence.
Voila ce qu’il me dit, mais en fin, chere ſœur, Ce fut a ces propos que ie perdis mon cœur.	Voilà ce qu'il me dit, mais en fin, chère sœur, Ce fut a ces propos que ie perdis mon cœur.
Prodigieux effects de la foibleſſe humaine, Qui trahit la Raiſon ſans trauail & ſans peine?	Prodigieux effets de la faiblesse humaine, Qui trahit la Raison sans travail et sans peine?
I’accorde la demande à ce nouuel Amant, Ie laiſſe ma vangeance à ſon reſſentiment.	J'accorde la demande à ce nouvel Amant, Je laisse ma vengeance à son ressentiment.
Ils entrerent au Camp, mais auec cette enuie De ſe vaincre l’vn l’autre, ou de perdre la vie.	Ils entrèrent au Camp, mais avec cette envie De se vaincre l'un l'autre, ou de perdre la vie.
La, ce beau Cheualier, fondit ſur ſon Riual, Qui perdit les arçons, & tomba de cheual;	La, ce beau Chevalier, fondit sur son Rival, Qui perdit les arçons, et tomba de cheval;
Attilla releué, l’autre mit pied à terre, Pour commencer entr’eux vne mortelle guerre;	Attilla relevé, l'autre mit pied à terre, Pour commencer entr'eux une mortelle guerre;
Chacun de ſon coſté fait d’eſtranges efforts A la fureur des coups ils expoſent leurs corps.	Chacun de son côté fait d'étranges efforts A la fureur des coups ils exposent leurs corps.
Pendant tout ce temps-là ma flame intereßée Eſtouffa ma raiſon, la rendit incenſée;	Pendant tout ce temps-là ma flamme interessée Étouffa ma raison, la rendit incensée;
Mon cœur fut combatu par tant d’euenemens Qu’il ſouffrit ſans mourir de rigoureux tourmens.	Mon cœur fut combattu par tant d'événements Qu'il souffrit sans mourir de rigoureux tourments.
Ma veue en ce temps-là fut touſiours occupée A voir comment chacun frappoit de ſon espée, A la fin, Attilla, cedant aux loix du ſort, Tombant, fut hors du Camp emporté comme mort;	Ma vue en ce temps-là fut toujours occupée A voir comment chacun frappait de son épée, A la fin, Atilla, cédant aux lois du sort, Tombant, fut hors du Camp emporté comme mort;
Mon vainqueur tout couuert, & de ſang & de gloire, Vint demander le prix de ſa belle victoire;	Mon vainqueur tout couvert, et de sang et de gloire, Vint demander le prix de sa belle victoire;
Le prix de ce combat eſtoit vn diamant, Dont ie recompenſay ce genereux Amant.	Le prix de ce combat était un diamant, Dont ie récompensai ce généreux Amant.
Mais pendant ce temps-là ie deuins toute eſmeuë, Sur ce beau Cheualier i’auois touſiours la veuë;	Mais pendant ce temps-là apprendre devins toute émue, Sur ce beau Chalier j'avais toujours la vue;
La perte de ſon ſang fit qu’il s’euanoüit;	La perte de son sang fit qu'il s'euanoüit;
Ie cheus, & ie fis voir par mon amour extréme, Que ie craignois pour luy bien plus que pour moy meſme:	Je cheus, et ici fis voir par mon amour extrême, Que ie craignais pour lui bien plus que pour moi -même:
On le fit emporter, & ie m'en retourné, Ie plaignois les mal-heurs de mon infortuné;	On le fit emporter, et ainsi m'en retourné, Je plaignais les malheurs de mon infortuné;
Ie fus aſſez long temps comme deſeſperée, D'entendre que ſa vie eſtoit mal aſſeurée;	Je fus assez long temps comme désespérée, D'entendre que sa vie était mal assurée;
Mon cœur fut fort long temps dans l’apprehenſion, En voyam fon umour uuno vu fuſpenſion;	Mon cœur fut fort long temps dans l'appréhension, En voyam son umour uno vu suspension;
De perdre tout d’vn coup vne ſi belle flame, Qui ſeruoit d’entretien iour & nuit à mon ame.	De perdre tout d'un coup une si belle flamme, Qui servait d'entretien jour et nuit à mon âme.
ISATIDE.	ISATIDE.
Ie vois bien que l’Amour cauſa ces accidens, Deſſous vn faux appas les maux ſont euidens.	Je vois bien que l'Amour causa ces accidents, Dessous un faux appas les maux sont évidents.
ZERBINE.	ZERBINE.
Tout cela ne fut rien au prix de ce qui reſte, Ce que vous entendrez eſt beaucoup plus funeſte.	Tout cela ne fut rien au prix de ce qui reste, Ce que vous entendrez est beaucoup plus funeste.
CINTILLE.	CINTILE.
Cependant Attilla ſçauoit par ſes valets Tout ce qu’en ſon abſence on faiſoit au Palais;	Cependant Atilla appendant par ses valets Tout ce qu'en son absence on faisait au Palais;
Ce fut la qu’il monſtra des effects de ſa rage, La force luy manquoit, mais non pas le courage.	Ce fut la qu'il montra des effets de sa rage, La force lui manquait, mais non pas le courage.
L’on dit qu’il arracha cent fois ſes appareils, Il ne put receuvir, bons ny mauuais conſeils.	L'on dit qu'il arracha cent fois ses appareils, Il ne put reçuvir, bons homme mauvais conseils.
Il maudiſſoit le iour, & par ces violances L’on voyoit ſa fureur dans ſes extrauagances Mais au bout de deux mois te vis que ce vainqueur Recouura ſa ſanté, ſa force & ſa vigueur, Que de contentemens mon ame fut ſaiſie;	Il maudissait le jour, et par ces violances L'on voyait sa fureur dans ses extravagances Mais au bout de deux mois te vis que ce vainqueur Recouvra sa santé, sa force et sa vigueur, Que de contentements mon âme fut saisie;
Que d’estranges penſers i’eus dans la fantaiſie?	Que d'étranges pensers j'eus dans la fantaisie?
Apres qu’il fut guery i'oſay tout eſperer;	Après qu'il fut guéri j'osai tout espérer;
Ie commençois à rire au lieu de ſouſpirer:	Je commençais à rire au lieu de soupirer:
Lors que contre mon feu, ce cruel, ce perſide Me fit ſentir l’effort de ſon bras homicide.	Lors que contre mon feu, ce cruel, ce perside Me fit sentir l'effort de son bras homicide.
Mon Amant diſparut, ma raiſon s’égara, Außi tost de mon cœur la frayeur s’empara, L’on fuyoit mon abord tant i’eſtois furieuſe, On connût par mon mal que i’eſtois amoureuſe, Car Attilla ſentit par ma viue douleur, Qu’il auoit ſuſçité noſtre commun mal-heur.	Mon Amant disparut, ma raison s'égara, Aussi tôt de mon cœur la frayeur s'empara, L'on fuyait mon abord tant j'étais furieuse, On connut par mon mal que j'étais amoureuse, Car Tilla sentit par ma vive douleur, Qu'il avait susçité notre commun malheur.
Chere ſœur, nuict & iour que i’ay pleuré ſa perte, Auec quels deſplaiſirs ma flame l’a ſoufferte.	Chère sœur, nuit et jour que j'ai pleuré sa perte, Avec quels déplaisirs ma flamme l'a soufferte.
Quels, pendant ceste abſence ont esté mes ennuis, Les nuicts me ſembloient iours, les iours me ſembloient nuicts;	Quels, pendant cette absence ont été mes ennuis, Les nuits me semblaient jours, les iours me semblaient nuits;
Tout me choquoit l’eſprit, & rien n’estoit capable De me diſſuader que i'eſtois miſerable.	Tout me choquait l'esprit, et rien n'était capable De me dissuader que j'étais misérable.
Ce ſubiect deſloyal me vint trouuer vn iour, Croyant me conſoler en me parlant d’amour, Ie repouſſay ce Monstre auec tant de colere, Que ſa femerité receus bien ſon ſalaire;	Ce sujet déloyal me vint trouver un jour, Croyant me consoler en me parlant d'amour, Je repoussai ce Monstre avec tant de colère, Que sa femérité reçus bien son salaire;
4 Mon diſcours deſpleut fort à cét audacieux, Qu'on voyoit le deſpit paroiſtre dans ſes yeux.	4 Mon discours déplut fort à cet audacieux, Qu'on voyait le dépit paraître dans ses yeux.
Cét effronté voyant ſa flame meſpriſée;	Cet effronté voyant sa flamme méprisée;
Et que ſa tyrannie eſtoit authoriſée;	Et que sa tyrannie était autorisée;
Pour vanger ſon amour, & pour me mal traiter, Dans le Palais en fin il me fit arrester.	Pour venger son amour, et pour me mal traiter, Dans le Palais en fin il me fit arrêter.
Là pendant plus d’vn mois ie fus ſa priſonniere, Mais de ſes cruautez en vorcy la derniere;	Là pendant plus d'être mois Seigneur fus sa prisonnière, Mais de ses cruautés en vorci la dernière;
Il m’enleua luy meſme, & deſſus ſes vaiſſeaux, Il commit ma fortune à la mercy des eaux;	Il m'enleva M mesme, et dessus ses vaisseaux, Il commit ma fortune à la merci des eaux;
Il nous mena luy meſme, & ſe fit le Pilote, Le vaiſſeau ſe rendit au reſte de ſa flote.	Il nous mena lui même, et se fit le Pilote, Le vaisseau se rendit au reste de sa flote.
Nous couruſmes les Mers des Pais eſtrangers Auec trop de bon-heur ſans perils ny dangers;	Nous courûmes les Mers des Pais étrangers Avec trop de bonheur sans périls ni dangers;
Le Nauire ayant eu touſiours le vent en poupe, Nous arriuaſme à bord auec toute ſa troupe.	Le Navire ayant eu toujours le vent en poupe, Nous arriuasme à bord avec toute sa troupe.
Ce fut dedans ces lieux par le Ciel deſtineZ Que par ce deſloyal nous fuſmes ameneZ.	Ce fut dedans ces lieux par le Ciel destinés Que par ce déloyal nous fûmes amenés.
Du depuis i’ay veſcu touſiours dans la triſteſſe, Ie n'ay iamais eſté ſans le mal qui me preſſe;	Du depuis j'ai vécu toujours dans la tristesse, Je n'ai jamais été sans le mal qui me presse;
Voila ma chere ſœur, ce qui m'eſt arriué, Par les méchanceteZ d’un homme dépraué, D'vn capable de tout, excepté de bien faire;	Voilà ma chère sœur, ce qui m'est arrivé, Par les méchancetés d'un homme dépravé, D'un capable de tout, excepté de bien faire;
En fin voila les maux que m'a fait ce Corſaire.	En fin voilà les maux que m'a fait ce Corsaire.
ATIDE.	ATIDE.
Vos malheurs ſont bien grands, mais außi bien que vous, La fortune a versé deſſus moy ſon courroux;	Vos malheurs sont bien grands, mais aussi bien que vous, La fortune a versé dessus moi son courroux;
I'ay ſenty les effects de ſon humeur volage.	J'ai senti les effets de son humeur volage.
ZERBINE.	ZERBINE.
Qui ſe peut dire exempt d’vne ſemblable orage.	Qui se peut dire exempt d'une semblable orage.
La Nature en naiſſant nous apprend à ſouffrir, Et ſi nous viuons tous ce n’est que pour mourir.	La Nature en naissant nous apprend à souffrir, Et si nous vivons tous ce n'est que pour mourir.
Il nous faut conſoler, & croire que ſes peines, De tant d’euenemens ſont les marques humaines.	Il nous faut consoler, et croire que ses peines, De tant d'événements sont les marques humaines.
Pin da premner netes	Pin da premner nètes
L I 8	L I 8
SCENE PREMIERE.	SCÈNE PREMIÈRE.
ATTILLA, ALCIOMEDE.	ATTILA, ALCIOMEDE.
8 ALCIOMEDE.	8 ALCIOMEDE.
OVS aueZ veû la Reine,	OUS avez vu la Reine,
ATTILLA.	ATTILA.
Ouy, cher Alciomede, Poun iu pounoit rejonure, n'n'eſt point de remede, Elle tient des diſcours qui ne font que faſcher, Cét eſprit eſt farcuone, omn peurv'approcher;	Oui, cher Alciomède, Poun ju pounait rejonure, n'n'est point de remède, Elle tient des discours qui ne font que fâcher, Cet esprit est farcuone, omn peurv'approcher;
Ie fais ce que ie puis, mais il est impoßible, Cette ingratte à mes pleurs deuient trop inſenſible.	Je fais ce que je puis, mais il est impossible, Cette ingrate à mes pleurs devient trop insensible.
ALCIOMEDE.	ÀLCIOMEDE.
Que penſez vous donc faire en cette extremité?	Que pensez vous donc faire en cette extrémité?
ATTILLA.	ATTILA.
Que d’eſtranges penſers mon cœur est agités	Que d'étranges pensers mon coeur est agités
ALCIOMEDE.	ÀLCIOMEDE.
Vous perdez, voſtre temps, il faut bien ſe reſoudre;	Vous perdez, votre temps, il faut bien se résoudre;
Tant de ſi beaux deſſeins s’en iront-ils en poudre.	Tant de si beaux desseins s'en iront-ils en poudre.
Que le pouuoir agiſſe au lieu de l’amitié, Comtmez vusire antont, n'ayes point de pitié;	Que le pouvoir agisse au lieu de l'amitié, Comtés vusire antont, n'ayes point de pitié;
Vous conſulteZ encore,	Vous consultez encore,
ATTILLA.	ATTILA.
Il eſt bien raiſonnable;	Il est bien raisonnable;
Cur ioutomois pas mon crime pardonnable.	Cur joutomais pas mon crime pardonnable.
ALCIOMEDE.	ÀLCIOMEDE.
SuiueZ tous mes conſeils.	Suivez tous mes conseils.
ATTILLA.	ATTILA.
Ie n’y puis conſentir, Deux puiſſantes raiſons m'en viennent diuertir.	Je n'y puis consentir, Deux puissantes raisons m'en viennent divertir.
La premiere est l’amour que i'ay pour cette ingratte;	La première est l'amour que j'ai pour cette ingrate;
La ſeconde raiſon, eſt l’espoir qui me flatte;	La seconde raison, est l'espoir qui me flatte;
Par mes ardans ſouſpirs i’eſchaufferay ſon cœur De vaincu que ie ſuis, ie ſeray ſon vainqueur.	Par mes ardans soupirs j'échaufferai son cœur De vaincu que je suis, toujours serai son vainqueur.
Non, non, ne croyeZ pas, mon cher Alciomede, Que ie me laiſſe vaincre au mal qui me poſſede.	Non, non, ne croisiez pas, mon cher Alciomède, Que tu me laisse vaincre au mal qui me possède.
ALCIOMEDE.	ÀLCIOMEDE.
La fortune a touſiours ſecondé vos deſſeins, Ce que vous deſiriez n'eſt-il pas en vos mains, La Reine est à preſent deſſous voſtrespuiſſance, Vous differez le bien de voſtre iouiſſance.	La fortune a toujours secondé vos desseins, Ce que vous désiriez n'est-il pas en vos mains, La Reine est à présent dessous vôtrespuissance, Vous différez le bien de votre jouissance.
Le temps n'eſt pas touſiours à noſtre volonté, Uous eſtes à preſent, & vous aueZ eſté.	Le temps n'est pas toujours à notre volonté, Uous êtes à présent, et vous avez été.
Conſiderez combien la fortune eſt changeante, Que quand nous differons elle pert noſtre attente;	Considérez combien la fortune est changeante, Que quand nous différons elle pert notre attente;
Nous deuenons ſouuent le rebut de ſes coups, Pour l’auoir meſpriſée, elle nous perdra tous.	Nous devenons souvent le rebut de ses coups, Pour l'avoir méprisée, elle nous perdra tous.
ATTILLA.	ATTILA.
Ie gouste vos raiſons, mais malgré la fortune, I’aime mieux conſulter à la perte commune, Que de traitter ainſi l’obiect de mon amour, Que ie tiens außi cher comme ie fais le iour.	Je goûte vos raisons, mais malgré la fortune, J'aime mieux consulter à la perte commune, Que de traiter ainsi l'objet de mon amour, Que ie tiens aussi cher comme on fais le jour.
Cintille eſt trop charmante.	Cintille est trop charmante.
ALCIOMEDE.	ÀLCIOMEDE.
Elle eſt außi cruelle, Et ſe rit de l’amour que vous aueZ pour elle;	Elle est aussi cruelle, Et se rit de l'amour que vous avez pour elle;
Connoiſſant cét humeur, & voyant ſes refus, Quand ie penſe à cela ie deuiens tout confus.	Connaissant cet humeur, et voyant ses refus, Quand tu pense à cela ie deviens tout confus.
Vous estes trop diſcret,	Vous êtes trop discret,
ATTILLA.	ATTILA.
Mettez vous en ma place, Et ce que vous feriez, dites-le moy de grace.	Mettez -vous en ma place, Et ce que vous feriez, dites-le moi de grâce.
ALCIOMEDE.	ÀLCIOMEDE.
Ie prendrois mieux que vous vn bien qui m'est offert, Ie ſerois ſatisfait, & i’aurois moins ſouffert.	Je prendrais mieux que vous un bien qui m'est offert, Je serais satisfait, et j'aurais moins souffert.
Mais c’eſt trop diſcourir, en vain ie m'evertuë De donner du ſecours à voſtre ame abatué.	Mais c'est trop discourir, en vain ie m'évertue De donner du secours à votre âme abattué.
Vous vous plaignez d’Amour, mais c’eſt iniuſtement, Puiſque vous refuſez voſtre contentement.	Vous vous plaignez d'Amour, mais c'est injustement, Puisque vous refusez votre contentement.
On ne peut vous guerir.	On ne peut vous guérir.
ATTILLA.	ATTILA.
Bien;	Bien;
quoy qu’il en aduienne, Amy, ſa volonté doit reſpondre à la mienne.	quoi qu’il en advienne, Ami, sa volonté doit répondre à la mienne.
I'y ſuis bien reſolu.	J'y suis bien résolu.
ALCIOMEDE.	ÀLCIOMEDE.
Faites-luy donc ſçauoir Ce que vous reſoluez, ou bien alleZ la voir, Dites-luy tout d’vn coup le deſſein qui vous meine, Que c'eſt perdre ſon temps de faire l’inhumaine;	Faites-lui donc sçauoir Ce que vous résolvez, ou bien allez la voir, Dites-lui tout d'un coup le dessein qui vous mène, Que c'est perdre son temps de faire l'inhumaine;
Que vous ne pouuez, plus en aucune façon Endurer ſes refus, voila voſtre leçon.	Que vous ne pouvez, plus en aucune façon Endurer ses refus, voila vôtre leçon.
ATTILLA.	ATTILA.
Faſſent les Dieux, amy, que cela reüßiſſe.	Fassent les Dieux, ami, que cela réussisse.
ALÇIOMEDE.	ALÇIOMEDE.
Que ſi cela n'aduient, faites que ie periſſe,	Que si cela n'advient, faites que je périsse,
ATTILLA.	ATTILA.
Ie m'en vais donc la votr.	Je m'en vais donc la voctr.
ALCIOMEDE.	ÀLCIOMEDE.
Sur tout n’oublieZ pas De dire qu'vn refus cauſera ſon treſpas.	Sur tout n'oubliés pas De dire qu'un refus causera son trépas.
S 2i N DEVXIESME.	 S2i N EUXIESME.
CINTILLE ſeule.	CINTILE seule.
E	E
Puis qu’il te faut ſouffrir, & que la violence Opprime l’innocence.	Puis qu'il te faut souffrir, et que la violence Opprime l'innocence.
mon crnoi aitiua cauſe iant de mal-heurs.	mon crnoi aitiva cause jant de malheurs.
Et qu’il faille auiourd’huy qu’vne telle aduanture, OApprenne u ia Nature, Qu'en effect noſtre vie est pleine de mal-heurs.	Et qu'il faille aujourd'hui qu'une telle aventure, APprenne u ja Nature, Qu'en effet quelque vie est pleine de malheurs.
28 Aquoy ſert de pleurer, à quoy ſert de ſe plaindre, Ie ne dois plus rien craindre.	28 Aquoi sert de pleurer, à quoi sert de se plaindre, Je ne dois plus rien craindre.
C’eſt vn mal naturel qui doit prendre ſon cours, Puiſque tous les humains qui viuent ſur la Terre, Me declarent la guerre, I'attendray que le Ciel me donne du ſecours,	C'est un mal naturel qui doit prendre son cours, Puisque tous les humains qui vivent sur la Terre, Me déclarent la guerre, J'attendrai que le Ciel me donne du secours,
8 Pourſuis tes cruauteZ, fais tomber ſur ma teſte Le coup de la tempeſte.	8 Poursuis tes cruautés, fais tomber sur ma tête Le coup de la tempête.
Iuſqu’à mon dernier iour monſtre toy mon fleau, Acheue en ma perſonne vn ſecond homicide, Attenuunt on Mitiue, Qui doit pour te punir te creuſer vn tombeau.	Jusqu'à mon dernier jour montre toi mon fléau, Achève en ma personne un second homicide, Attenuunt on Mitive, Qui doit pour te punir te creuser un tombeau.
N TROISIESME.	 TROISIÈME.
L CINTILLE, ATTILLA.	 LINTILLE, ATTILLA.
& C CINTILLE.	et ET CINTILLE.
Ais ie voy Attilla, dont le confus viſage Certain auant-coureur d’vn ſiniſtre pre Medite en ſon eſprit quelqu’autre cruauté, Four cruiſtre mesmat-peurs iuſqu'a l'extremite.	Ais ie vois Atilla, dont le confus visage Certain avant-coureur d'un sinistre pré Dite en son esprit quelqu'autre cruauté, Four cruistre mémat-peurs jusqu'a l'extrémité.
Approche donc, cruel, contente ton enuie, Ie n’apprehende point que tu m'oste la vie, Acheue deſſus moy ton iniuste deſſein, Par cét aſſaßinat enſanglante ta main.	Approche donc, cruel, contente ton envie, Je n'appréhende point que tu m'ôte la vie, Achève dessus moi ton injuste dessein, Par cet assassinat ensanglante ta main.
ATTILLA.	ATTILA.
Vous tenez le diſcours d’vne deſesperée, Ma Reine, auec moy, ſoyez plus aſſeuree.	Vous tenez le discours d'une désespérée, Ma Reine, avec moi, soyez plus assurée.
CroyeZ, belle Cintille, que ie voudrois perir, Pour prolonger vos iours, & pour vous ſecourir.	Croyez, belle Cintille, que je voudrais périr, Pour prolonger vos jours, et pour vous secourir.
Ce cœur tout embraſé d’vne flame ſi pure, N’eut iamais le deſſein de vous faire vne iniure;	Ce cœur tout embrasé d'une flamme si pure, N'eût jamais le dessein de vous faire une injure;
Ipiais an tomraut, nels:	Jiais an tomraut, nels:
vumom que t'ay pourvous Me fait deuant vos pieds ſouspirer à genoux.	vumom que t'ai pourvous Me fait devant vos pieds soupirer à genoux.
CINTILLE.	CINTILE.
Va, c’est perdre ton temps, infame temeraire, De croire que mon cœur te vueille ſatis faire;	Va, c'est perdre ton temps, infâme téméraire, De croire que mon cœur te veuille satî faire;
Tu t’abuſes toy meſme en croyant obtenir, Ce qu'au prix de mon ſang il me faut maintenir.	Tu t'abuses toi -même en croyant obtenir, Ce qu'au prix de mon sang il me faut maintenir.
Non, non, c'eſt eſperer qu'en vain ie t’abandonne, Vn bien qui m’est plus cher que n’estoit ma Couronne;	Non, non, c'est espérer qu'en vain ie t'abandonne, Un bien qui m'est plus cher que n'était ma Couronne;
Tu iouis de mes biens, & malgré les efforts, De cette laſcheté i'exempteray mon corps.	Tu jouis de mes biens, et malgré les efforts, De cette lâcheté j'exempterai mon corps.
Ne te ſuffit-il point apres m’auoir rauié, D'anoir mauvene foux testone uſferuie.	Ne te suffit-il point après m'avoir ravié, D'anoir mauvène foux têtone usfervie.
Ne deſires-tu pas que mon cœur ſoit le prix Des biens que i’ay perdus, außi que tu m'as pris.	Ne désires-tu pas que mon cœur soit le prix Des biens que j'ai perdus, aussi que tu m'as pris.
Tu perds ton temps, cruel, ſi c’est là ton attente, Ie periray pluſtost deuant que i’y conſente.	Tu perds ton temps, cruel, si c'est là ton attente, Je périrai plutôt devant que j'y consente.
ATTTEEI Cruelle, ces diſcours me pourront bien aigrir.	ATTTEI Cruelle, ces discours me pourront bien aigrir.
CINTILLE.	CINTILE.
Ie ne crains point cela, ie ſuis preste à mourir, Tu dois estre aſſeuré ſi tost que ie fus née, Quu in penle au iom le me quis aeſtinée,	Je ne crains point cela, votre suis prête à mourir, Tu dois être assuré si tôt que sans fus née, Quu in penle au jom le me quis aestinée,
ATTILLA.	ATTILA.
La mort aux mal-heureux eſt douce à ſupporter.	La mort aux malheureux est douce à supporter.
CINTILLE.	CINTILE.
Pourtant ma qualité ne m'en peut exempter.	Pourtant ma qualité ne m'en peut exempter.
ATIILLA.	ATIILA.
Vous ſçaueZ bien quelle eſt ma puiſſance abſolue.	Vous savez bien quelle est ma puissance absolue.
CINTILLE.	CINTILE.
Ie te l’ay deſia dit, i’y ſuis trop reſoluë.	Je te l'ai déjà dit, j'y suis trop résolue.
ATTILLA.	ATTILA.
Emtnie, eſpargneZ vous, vous estes dans mes mains.	Emtnie, épargnez -vous, vous êtes dans mes mains.
SIIADDE.	SIIADE.
Ayant le Ciel pour moy, ie me ris des humains.	Ayant le Ciel pour moi, ie me ris des humains.
ATTILLA.	ATTILA.
L'on s’abuſe ſouuent en ſemblable creance.	L'on s'abuse souvent en semblable créance.
CINTILLE.	CINTILE.
C’eſt aſſez qu'en luy ſeul i’ay mis mon eſperance.	C'est assez qu'en Un seul j'ai mis mon espérance.
ATTILLA.	ATTILA.
Ie feray jaiisſan denan vostre treſpas.	Je ferai jouissan denan votre trépas.
CINTILLE.	CINTILE.
Pour ſauuer mon honneur i'en haſteray le pas.	Pour sauver mon honneur j'en hâterai le pas.
ATTILLA.	ATTILA.
Ie ſçay bien le moyen d’empeſcher le contraire.	Je sais bien le moyen d'empêcher le contraire.
CINTILLE.	CINTILE.
L’on trouue trop dequoy pour finir ſa miſere.	L'on trouve trop dequoy pour finir sa misère.
ATTILLA.	ATTILA.
de mt peurrayſernu de mon auiuone.	de mont peurraysernu de mon aujuone.
CINTILLE.	CINTILE.
Le Ciel te punira l’ayant trop irrité.	Le Ciel te punira l'ayant trop irrité.
ATTILLA.	ATTILA.
En fin reſoluez vous, car c'eſt perdre ſa peine, Cintille il n'est plus temps de faire l’inhumaine.	En fin résolvez -vous, car c'est perdre sa peine, Cintille il n'est plus temps de faire l'inhumaine.
Ie ne puis plus ſouffrir qu'on ſe mocque de moy, Ie commande en ce lieu, puiſque i’en ſuis le Roy;	Je ne puis plus souffrir qu'on se moque de moi, Je commande en ce lieu, puisque j'en suis le Roi;
I’ayla force en la main, & quoy qu’il en aduienne Ce que ie veux de vous il faut que ie l’obtienne;	J'ayla force en la main, et quoi qu’il en advienne Ce que tu veux de vous il faut que ie obtienne.
Vous aueZ beau pleurer, les plaintes, les ſouſpirs, Ne destourneront pas le cours de mes plaiſirs.	Vous avez beau pleurer, les plaintes, les soupirs, Ne détourneront pas le cours de mes plaisirs.
Cintille, il eſt certain que i’auray iouiſſance Des cruelles BeauteZ qui ſont en ma preſence:	Cintille, il est certain que j'aurai jouissance Des cruelles Beautez qui sont en ma présence:
Ouy i’esteindray l’ardeur de mes chaudes amours, Sans meſme que les Dichæ vous aonneni du ſecours, ConſulteZ là deſſus, Il for	Oui j'éteindrai l'ardeur de mes chaudes amours, Sans même que les Dichæ vous aonneni du secours, Consultés là -dessus, Il for
CINTILLE.	CINTILE.
Helas!	Hélas!
pauure Princeſſe, Dans la neceßité l’on connoist ſa foibleſſe;	pauvre Princesse, Dans la necemité l'on connaît sa faiblesse;
Ce Tyran enragé violant le deuoir, Me veut faire ſentir l’effort de ſon pouuoir;	Ce Tyran enragé violant le devoir, Me veut faire sentir l'effort de son pouvoir;
Il n’en faut plus douter, ma perte est aſſeurée, Ie ne la ſçaurois fuir, ce traiſtre l’a iurée.	Il n'en faut plus douter, ma perte est assurée, Je ne la saurais fuir, ce traître l'a jurée.
Mais quand ſera-ce, helas!	Mais quand sera-ce, hélas!
celeſtes DeïteZ, Que vous me vangerez de tant de cruautez?	célestes DeïteZ, Que vous me vengerez de tant de cruautés?
A quoy ſert en vos mains le careau de la foudre, Si ce n'est pour punir, & pour reduire en poudre Ces traistres aſſaßins, ces hommes criminels, Qui répandent le ſang au pied de vos Autels?	À quoi sert en vos mains le careau de la foudre, Si ce n'est pour punir, et pour réduire en poudre Ces traîtres assassins, ces hommes criminels, Qui répandent le sang au pied de vos Autels?
Ly N ATRIERME.	Li N ATRIERME.
ALCTOMEDE, ZERBINE.	ÀLCTOMEDE, ZERBINE.
ALCIOMEDE.	ÀLCIOMEDE.
& Echez, ſechez vos pleurs, banniſſez la MIBIN triſteſſe, Ce lieu doit à preſent eſtre plein d’allereffe;	et Échez, séchez vos pleurs, bannissez la MIBIN tristesse, Ce lieu doit à présent être plein d'allèreffe;
Car ie crois qu'Attilla doit estre noſtre Roy Cintille s’est renduë en receuant ſa foy;	Car ie crois qu'Atilla doit être notre Roi Cintille s'est rendue en recevant sa foi;
Le Ciel les va lier ſous le joug d’Hymenée,	Le Ciel les va lier sous le joug d'Hyménée,
ZERBINE.	ZERBINE.
Ie ne crois point cela, la Reine est trop bien née Pour faire cette iniure, & ce tort à ſon rang De prendre vne perſonne indigne de ſon Sang.	Je ne crois point cela, la Reine est trop bien née Pour faire cette injure, et ce tort à son rang De prendre un personne indigne de son Sang.
Vous vouleZ m’abuſer en me forçant de croire, Qu'Attilla ſur ſon cœur ait gagné la victoire;	Vous voulez m'abuser en me forçant de croire, Qu'Atilla sur son cœur ait gagné la victoire;
C’eſt en vain que ce traistre a fait tout ſon pouuoir De taſcher par ſes pleurs la ciaincrs dœ l'ómauuniMonſieur, tous ces diſcours ont fort peu d’apparence, Pons fonder deſſus enx cette vaine creance.	C'est en vain que ce traître a fait tout son pouvoir De tâcher par ses pleurs la ciaincrs dœ l'ómauuniMonsieur, tous ces discours ont fort peu d'apparence, Pons fonder dessus enx cette vaine créance.
ALC IOMEDE.	ÀLC JOMEDE.
Vous parlez hardiment.	Vous parlez hardiment.
ZERBINE.	ZERBINE.
Ie dis la verité.	Je dis la vérité.
Et qui plus eſt, Monſieur, i'ay cette authorité;	Et qui plus est, Monsieur, j'ai cette autorité;
La Reine offenceroit la cendre de ſon pere, Que de mettre en ſon lict vnhomme ſanguinaire.	La Reine offenserait la cendre de son père, Que de mettre en son lit homme sanguinaire.
ALCIOMEDE.	ÀLCIOMEDE.
Tous ces piquans propos ne ſont pas de ſaiſon, Quand vous parlez ainſi, vous parleZ ſans raiſon.	Tous ces piquants propos ne sont pas de saison, Quand vous parlez ainsi, vous parlez sans raison.
AE RDIN L.	ÀE RDIN L.
Ie parle comme il faut & l’honneur me conuie De prendre le party de qui ie dois la vie.	Je parle comme il faut et l'honneur me convie De prendre le parti de qui était dois la vie.
L y ſuis trop obligée, & ie fais mon deuoir.	L y suis trop obligée, et ainsi fais mon devoir.
ALCIOMEDE.	ÀLCIOMEDE.
Le bon ſens vous delaiſſe, & parleZ ſans ſçauoir.	Le bon sens vous délaisse, et parlez sans savoir.
Vous offencez vn Prince,	Vous offensez un Prince,
ZERBINE.	ZERBINE.
Ou bien plustoſt vn traiſtre, Ses laſches actions le font aſſeZ paroiſtre.	Ou bien tôt un traître, Ses lâches actions le font assez paraître.
Vous eſtes partiſan de ſes maudits conſeils Iueſe oruy qu'onemnenn on chercher ſes pareils.	Vous êtes partisan de ses maudits conseils Jues orui qu'onemnenn on chercher ses pareils.
Zerbine, ADOTOMEDE.	Zerbine, ADOTOMEDE.
ZERBINE.	ZERBINE.
Alciomede,	Alciomède,
ALCIOMEDE.	ÀLCIOMEDE.
9.	9.
it ne puis me taire;	it ne puis me taire;
La fureur me ſurmonte, & ie ſuis en colere.	La fureur me surmonte, et ainsi suis en colère.
Vous vous repentirez,	Vous vous repentirez,
ZERBINE.	ZERBINE.
Ctſt a jaire à cela, Contez toute l’hiſtoire à ce traiſtre Attilla;	Ctst à jaire à cela, Comptez toute l'histoire à ce traître Atilla;
Ie ne crains point du tout de meriter ſa haine;	Je ne crains point du tout de mériter sa haine;
Ie ne ſuis pas à luy, puiſque ie ſers la Reine.	Je ne suis pas à vertu, puisque ici sers la Reine.
Zerbine ſort.	Zerbine sort.
CIN I N L VIEHL.	CIN I N L VIEHL.
ALCIOMEDE, ATTILLA.	ÀLCIOMEDE, ATTILLA.
Bj 2l 8 ATTILLA.	Bj 2l 8 ATTILLA.
IEVX!	JEUX!
que fort à propos ie vous rencontre icy;	que fort à propos Dieux vous rencontre ici;
Amy, voſtre conſeil a fort bien reüßi, topppwe lecroy que deuans peu i'obtiendray de ma Belle, Pour le prix de ma foy ce qui dépendra d’elle;	Ami, votre conseil a fort bien réussi, toppe lecroi que devant peu j'obtiendrai de ma Belle, Pour le prix de ma foi ce qui dépendra d'elle;
Dedans mon entretien, le diſcours que i’ay fait, L’a bien fort eſtonnée, & ſurpriſe en effect.	Dedans mon entretien, le discours que j'ai fait, L'a bien fort étonnée, et surprise en effet.
ALCIOMEDE.	ÀLCIOMEDE.
Ie ſuis fort ſatisfait, de ce que mon ſeruice, Dedans cette action vous ait eſté propice;	Je suis fort satisfait, de ce que mon service, Dedans cette action vous ait été propice;
MAAI.	MAI.
ATTILLA.	ATTILA.
Excuſez, cher amy Si ie ne vous puis pas reconnoiſtre à demy;	Excusez, cher ami Si On ne vous puis pas reconnaître à demi;
Tenc & cous aſſeust, te feraymon poßible, Eſtant voſtre obligé, ie ſerois inſenſible.	Tens et cous asseut, te feraimon pouvible, Estant votre obligé, toujours serais insensible.
ALCIOMEDE.	ÀLCIOMEDE.
Laiſſez là ces diſcours, Seigneur, eſpargnez moy.	Laissez là ces discours, Seigneur, épargnez -moi.
Ce que i’ay fait pour vous eſt le fruit de ma foy.	Ce que j'ai fait pour vous est le fruit de ma foi.
ATTILLA.	ATTILA.
Mais quand ie ſuis entré, Zerbine ce me ſemble Eſtoit auecque vous, & vous parlieZ enſemble, Quels eſtoient vos propos?	Mais quand tu suis entré, Zerbine ce me semble Était avec vous, et vous parliez ensemble, Quels étaient vos propos?
ALCIOMEDE.	ÀLCIOMEDE.
Seigneur, tous nos diſcours Ont eſté de parler de vos belles Amours.	Seigneur, tous nos discours Ont été de parler de vos belles Amours.
I’ay voulu faire croire à cette Confidante, Que la Reine auouoit qu'elle eſtoit voſtre Amante;	J'ai voulu faire croire à cette Confidante, Que la Reine avouait qu'elle était toujours Amante;
Qu'Hymen vous alloit iome, Cuube uii cœurs;	Qu'Hymen vous allait jome, Cube ui cœurs;
Que vous auiez vaincu ſes plus grandes rigueurs;	Que vous aviez vaincu ses plus grandes rigueurs;
Que tout ſe ſoumettoit deſſous vostre puiſſance;	Que tout se soumettait dessous votre puissance;
Qu'vn chacun vous rendoit vne humble obeïſſance;	Qu' vous chacun vous rendait une humble obéissance;
Que la Reine elle meſme eſtoit ſous voſtre loy;	Que la Reine elle -même était sous votre loi;
TILLA.	TILLA.
Ionoien, quu et tue uu, entendant cette feinte?	Jonoyen, quu et tue u, entendant cette feinte?
ALCIOMEDE.	ÀLCIOMEDE.
Außi toſt ſur ſon front la rougeur s’est dépeinte;	Aussi tôt sur son front la rougeur s'est dépeinte;
I’ay connu que ſon cœur eſtoit preſque interdit, Et n'a pour tout rien crenut toin et que l'ay dit.	J'ai connu que son cœur était presque interdit, Et n'a pour tout rien crenut toin et que l'ai dit.
Mais ſes plus beaux diſcours ont esté des iniures;	Mais ses plus beaux discours ont été des injures;
Elle vſe de ces noms, de traistres & pariures.	Elle use de ces noms, de traîtres et parjures.
TTILLA.	TTILA.
Cét eſprit est à craindre, & i'apprehende fort, Que ſes inuentions ne me faſſent du tort;	Cet esprit est à craindre, et j'appréhende fort, Que ses inventions ne me fassent du tort;
Tout cela, cher Amy, trouble ma fantaiſie.	Tout cela, cher Ami, trouble ma fantaisie.
ALCIOMEDE.	ÀLCIOMEDE.
e ſon ſort ſoit égal, & ſuiue Philezie;	 Je sort soit égal, et suive Philezie;
MetteZ vous en repos de tout ce costé-là, Et monstrez qu'en ce lieu vous eſtes Attilla.	Mettez -vous en repos de tout ce côté-là, Et montrez qu'en ce lieu vous êtes Atilla.
E N SIXIESME.	E N SIXIÈME.
Ri CHILDEBRAND, TANABOVSE, PANDOR, & les ſoldats de ſa ſuitte.	Ri CHILDEBRAND, TANABOUSE, PANDOR, et les soldats de sa suitte.
Q L CHILDEBRAND.	 Q CHILDEBRAND.
Enereux Compagnons, qui depuis tant d’années y Auez touſiours ſuiuy toutes mes deſtiA nées;	Énereux Compagnons, qui depuis tant d'années y Avez toujours suivi toutes mes destiA nées;
La fortune en ce lieu nous prepare vn Tombeau, N’en cherchons point ailleurs vn qui nous ſoit plus beau;	La fortune en ce lieu nous prépare un Tombeau, N'en cherchons point ailleurs un qui nous soit plus beau;
Vangeons noſtre intereſt auecque l’innocence, Monſtrons nostre courage en ſa iuſte deffence;	Vengeons notre intérêt avec l'innocence, Monstrons notre courage en sa juste défense;
Puniſſons vn Tyran qui tient dedans ſes mains Vn miracle d'Amour qui charme les humains;	Punissons un Tyran qui tient dedans ses mains Un miracle d'Amour qui charme les humains;
Voſtre ſang genereux, qui bout dedans vos veines, Vient deſia coniurer leurs ruines certaines;	Votre sang généreux, qui bout dedans vos veines, Vient déjà conjurer leurs ruines certaines;
Tous vos bras animeZ ſans craindre les haZards, Auront plus de vertu que tous ceux des Ceſars Madame que voila beaucoup intereſſée, Tomnmo uepas vanger ſe ſent trôpeſfouise, Elle toint ſa priere a celle que te fais, Deliurons des Captifs, & les mettons en paix.	Tous vos bras animés sans craindre les hasards, Auront plus de vertu que tous ceux des Césars Madame que voilà beaucoup intéressée, Tomnmo ô vanger se sent trôpesfouise, Elle toint sa prière à celle que te fais, Délivrons des Captifs, et les mettons en paix.
TANABOVSE.	TANABOUSE.
Grand Prince, ie ſeray touſiours voſtre obligée, De vouloir ſecourir vne Reine affligée;	Grand Prince, a seray toujours votre obligée, De vouloir secourir notre Reine affligée;
Uoſtre grande vertu par tout où vous allez, Et vos fameux exploicts ſe ſont trop ſignalez;	Uotre grande vertu par tout où vous allez, Et vos fameux exploits se sont trop signalez;
Chacun craint vostre bras, lors qu’on voit voſtre eſpée;	Chacun craint votre bras, lors qu'on voit votre épée;
Car elle est en vos mains iustement occupée;	Car elle est en vos mains justement occupée;
I'eſpere de reuoir encore cette fois Le modelle viuant de tant de ſigrands Rois.	J'espère de revoir encore cette fois Le modèle vivant de tant de sigrands Rois.
CHILDE BRAND.	CHILDE BRAND.
Aſſeurez vous, Madame, ayant les Dieux propices, Et que nous combattons ſous de ſi bons auſpices;	Assurez -vous, Madame, ayant les Dieux propices, Et que nous combattons sous de si bons auspices;
Que tout doit reußir comme vous l’eſperez, Iemettray dans vos mains ce que vous deſirez.	Que tout doit reussir comme vous l'espérez, Jémettrai dans vos mains ce que vous désirez.
ANDOR.	ANDOR.
Nos cœurs ſuiuant le voſtre au chemin de la gloire, Se propoſent deſia d’emporter la victoire;	Nos cœurs suivant le vôtre au chemin de la gloire, Se proposent déjà d'emporter la victoire;
Eſtant conduits par vous ſans craindre le treſpas, Iuſques dans les Enfers nous irons ſur vos pas,	Étant conduits par vous sans craindre le trépas, Jusques dans les Enfers nous irons sur vos pas,
CHILDEBRAND.	CHILDEBRAND.
Ie n’ay iamais douté de tous tant que vous estes;	Je n'ai jamais douté de tous tant que vous êtes;
Rramis untons, mesumis, pour eſtouſſer ces pestes;	Rramis untons, mesumis, pour étousser ces pestes;
Acquerons de l’honneur en vn ſi beau combat, Nous gagnerons le prix d’vn ſi iuſte debat.	Acquérons de l'honneur en un si beau combat, Nous gagnerons le prix d'un si juste débat.
TANABOVSE.	TANABOUSE.
e quuutines foiumtsj O vous granus Capitaines, Comment recompenſer vos trauaux & vos peines?	 quuutines foiumtsi Ô vous granus Capitaines, Comment récompenser vos travaux et vos peines?
Ma puiſſance eſt petite, & s’il faut de mon ſang Ie vous en tireray de celuy de mon flanc.	Ma puissance est petite, et s'il faut de mon sang Ie vous en tirerai de celui de mon flanc.
CHILDEBRAND.	CHILDEBRAND.
Ils ne demandent point aucune recompence De vaincre vn Tyran oppreſſeur d’innocence;	Ils ne demandent point aucune récompense De vaincre un Tyran oppresseur d'innocence;
La vertu les oblige à faire leur deuoir, Ils ſont tous vos ſubiects eſtant ſous mon pouuoir.	La vertu les oblige à faire leur devoir, Ils sont tous vos sujets étant sous mon pouvoir.
Mais il faut donner ordre au reste de l’armée, Elle eſt dans nos vaiſſeaux aſſez bien animée.	Mais il faut donner ordre au reste de l'armée, Elle est dans nos vaisseaux assez bien animée.
Il faut ſans eſtre veus gagner ce grand rocher, Afin que librement on ſe puiſſe approcher;	Il faut sans être vus gagner ce grand rocher, Afin que librement on se puisse approcher;
Les ſoldats couleront à la faueur de l’ombre, Cét endroit eſt commode à cauſe qu’il eſt ſombre;	Les soldats couleront à la faveur de l'ombre, Cet endroit est commode à cause qu'il est sombre;
La ruſe est neceſſaire,	La ruse est nécessaire,
PANDOR.	PANDOR.
Et ſelon mon aduis Ils ſeront eſtonnez ſe voyant pourſuiuis;	Et selon mon avis Ils seront étonnés se voyant poursuivis;
Sur tout il faut garder dextrement l’auenuë, d'il ne ſe trouue point quelque route inconnue, Par où les ennemis ſans peril ny danger Nous pourroient tous deffaire, & nous endommager.	Sur tout il faut garder dextrement l'avenue, d'il ne se trouve point quelque route inconnue, Par où les ennemis sans péril ni danger Nous pourraient tous défaire, et nous endommager.
CHILDEBRAND.	CHILDEBRAND.
Allons dans nos vaiſſeaux, car il eſt neceſſaire De mettre noſtre armée en eſtat de bien faire.	Allons dans nos vaisseaux, car il est nécessaire De mettre notre armée en état de bien faire.
Fin du deuxieſme Acte.	Fin du deuxième Acte.
EE AYE	CE AYE
SCENE PREMIERE.	SCÈNE PREMIÈRE.
OXANTE, ATTTLLA, ALCIOMEDE.	OXANTE, ATTTLA, ALCIOMEDE.
A M OXANTE.	À M OXANTE.
Eigneur, quelques vaiſſeaux ont paru ſur ces bords;	Eigneur, quelques vaisseaux ont paru sur ces bords;
Ils ont tous inueſty l’auenuë & les ports;	Ils ont tous inuesty l'avenue et les ports;
Quantite de ſoldats ont deſia gagne ferre,	Quantite de soldats ont déjà gagne ferre,
ATTILLA.	ATTILA.
Qui ſont ces ennemis qui nous liurent la guerre;	Qui sont ces ennemis qui nous livrent la guerre;
La fortune commence à me perſecuter.	La fortune commence à me persécuter.
ALCIOMEDE.	ÀLCIOMEDE.
Mon Seigneur, c’eſt vn mal qu'on ne peut euiter Sunefepauuuue au fort, jongeons u nous deffendre.	Mon Seigneur, c'est un mal qu'on ne peut éviter Sunefepauuuue au fort, jongeons u nous défendre.
ATTILLA.	ATTILA.
En ſin mon peure vient, il eſt temps de me rendre.	En sin mon peure vient, il est temps de me rendre.
ALCIOMEDE.	ÀLCIOMEDE.
Ce ſera fort bien fait, dans la neceßite, Deffendons nous pourtant iuſqu'à l’extremité.	Ce sera fort bien fait, dans la nécessite, Défendons nous pourtant jusqu'à l'extrémité.
OXANTE.	OXANTE.
Seigneur;	Seigneur;
conſiderez qu’au beſoin qui nous preſſe, Uoſtre courage meurt, voſtre bras nous delaiſſe;	considérez qu'au besoin qui nous presse, Uotre courage meurt, votre bras nous délaisse;
Ce ſont des ennemis par la mer haraſſeZ.	Ce sont des ennemis par la mer harasseZ.
Par le moindre combat ils ſeront terraſſe?	Par le moindre combat ils seront terrasse?
Vendons leur cherement le prix de noſtre vie;	Vendons leur chèrement le prix de notre vie;
Empeſchons, s’il ſe peut, qu'elle nous ſoit rauie.	Empêchons, s'il se peut, qu'elle nous soit ravie.
ATTILLA.	ATTILA.
AlleZ par tout cette Iſle, & voyez ſi nos gens Sont preſts à ſe deffendre, à s’armer diligens;	Allez par tout cette Isle, et voyez si nos gens Sont prêts à se défendre, à s'armer diligents;
Que tout ſuiue voſtre ordre, & pour Alciomede Il ſera prés de moy pour venir à mon aide.	Que tout suive votre ordre, et pour Alciomède Il sera près de moi pour venir à mon aide.
En fin, mon cher Amy, ie ſuis ſi fort ſurpris, .	En fin, mon cher Ami, je suis si fort surpris, .
Que ie ſuis immobile, & ie perds les eſprits.	Que ie suis immobile, et ainsi perds les esprits.
Le Ciel vange ſur moy l’intereſt de la Reine, Mes laſches actions ont merité ſa haine;	Le Ciel venge sur moi l'intérêt de la Reine, Mes lâches actions ont mérité sa haine;
Tout conſpire à me perdre, & ſa captiuité Attire deſſus moy ce que i'ay merité;	Tout conspire à me perdre, et sa captivité Attire dessus moi ce que j'ai mérité;
Ie ne puis reſiſter aux coups de la Fortune, Elle a ſigné l’Arreſt de la perte commune.	Je ne puis résister aux coups de la Fortune, Elle a signé l'Arrêt de la perte commune.
nomo migiuuve, ncejo compe, muie ouc naut que perir;	nomo migive, ncejo compe, muie ouc naut que périr;
Il faut bien auec moy ſe reſoudre à mourir.	Il faut bien avec moi se résoudre à mourir.
ALCIOMEDE.	ÀLCIOMEDE.
Seigneur, eſcoutez moy, la fureur le tranſporte La raiſont'avumonne, & ta razt temporfe;	Seigneur, écoutez -moi, la fureur le transporte La raisont'avumonne, et ta razt temporpe;
Il ne ſe connoist plus, car tous ces momiemens Accompagnent touſiours les mal-heureux Amans.	Il ne se connaît plus, car tous ces moments Accompagnent toujours les malheureux Amants.
ATTILLA.	ATTILA.
Iniuſte Ciel, pourquoy ſouffreZ vous que ma teſte, Attende des mortels le coup de la tempeſte;	Injuste Ciel, pourquoi souffrez -vous que ma tête, Attende des mortels le coup de la tempête;
Il n’appartient qu’à vous de vanger deſſus moy, Les crimes que i’ay faits d’attenter ſur vn Roy.	Il n'appartient qu'à vous de venger dessus moi, Les crimes que j'ai faits d'attenter sur un Roi.
MHelas!	MHélas!
vous ſousteneZ l’innocence opprimée, Sa beauté iustement eſt digne d’eſtre aimée.	vous soutenez l'innocence opprimée, Sa beauté justement est digne d'être aimée.
Reine trop dédaigneuſe.	Reine trop dédaigneuse.
ALCIOMEDE.	ÀLCIOMEDE.
En fin tous ces diſcours Ne peuuent ſoulager ny donner du ſecours.	En fin tous ces discours Ne peuvent soulager ni donner du secours.
Songez donc, s’il vous plaist, que pour noſtre deffence Les ſoldats ont beſoin d’auoir voſtre preſence.	Songez donc, s'il vous plaît, que pour notre défense Les soldats ont besoin d'avoir votre présence.
Vn Chef dans ſon armée a beaucoup de pouuoir, Dentemen à fa vene on je mei en denoir.	Un Chef dans son armée a beaucoup de pouvoir, Dentement à fa vene on je mei en denoir.
ATTILLA.	ATTILA.
De plus en plus, Amy, ma frayeur ſe redouble, Quna te ſonge à tela ioul ma taiſon ſe trouble, Ie croy que c'eſt vn charme ou pluſtoſt viſion.	De plus en plus, Ami, ma frayeur se redouble, Quna te songe à tela joul ma taison se trouble, Je crois que c'est un charme ou plutôt vision.
ALCIOMEDE.	ÀLCIOMEDE.
Tout ce que vous voyeZ eſt donc illuſion;	Tout ce que vous voyeZ est donc illusion;
Croyez, croyeZ, Seigneur, ce n'eſt pas moquerie, Vous vous faites du tort par cette réverie;	Croyez, croyez, Seigneur, ce n'est pas moquerie, Vous vous faites du tort par cette rêverie;
Recueillez vos eſprits, rendez les animeZ Afin de ſecourir celle que vous aymeZ;	Recueillez vos esprits, rendez les animés Afin de secourir celle que vous aimez;
2 Vous aueZ oublié cét obiet plein de charmes.	2 Vous avez oublié cet objet plein de charmes.
ATTILLA.	ATTILA.
Viſte, viſte, quelqu’vn, apporteZ moy mes armes, Mon amour, & l’honneur ſont bleſſez en ce point;	Vite, vite, quelqu'une, apportez -moi mes armes, Mon amour, et l'honneur sont blessez en ce point;
Que ie me ferois tort en ne combattant point.	Que ie me ferais tort en ne combattant point.
Ie ſens que mon amour m'accuſe de pareſſe;	Je sens que mon amour m'accuse de paresse;
De laiſſer en danger cette belle Princeſſe, Et marchons de ce pas contre nos ennemis, Leur monstrer que nos cœurs ne ſont plus endormis.	De laisser en danger cette belle Princesse, Et marchons de ce pas contre nos ennemis, Leur montrer que nos cœurs ne sont plus endormis.
L DEVXIESME.	 LEUXIESME.
DHADHD, IOATIDE, ZERBINE.	DHADHD, JOATIDE, ZERBINE.
M CINTILLE.	M MDINTILLE.
E Ciel veut mettre fin à l’estat déplorable, Où nous estions reduits par cét inexorable;	E Ciel veut mettre fin à l'état déplorable, Où nous étions réduits par cet inexorable;
Il nous vient ſecourir, & nous oſter des fers Ayant pitié des maux que nous auons ſoufferts;	Il nous vient secourir, et nous ôter des fers Ayant pitié des maux que nous avons soufferts;
Cet te puiſſante flotte en cette Iſle arriuée, S’en vient pour chastier ſa vie déprauée;	Cet te puissante flotte en cette Île arrivée, S'en vient pour châtier sa vie dépravée;
Les Dieux iustes vangeurs des crimes des humains, 1 Pour punir les meſchans ont le foudre en leurs mains;	Les Dieux justes vengeurs des crimes des humains, 1 Pour punir les méchants ont le foudre en leurs mains;
L’on ne peut eſchaper le bras de ſa Iuſtice, L'on le ſent tost ou tard ou contraire ou propice.	L'on ne peut échapper le bras de sa Justice, L'on le sent tôt ou tard ou contraire ou propice.
E	E
ATIDE.	ATIDE.
Madame, il est certain qu’apres tant de mal-heurs Nous ſentons ſucceder les plaiſirs aux douleurs.	Madame, il est certain qu'après tant de malheurs Nous sentons succéder les plaisirs aux douleurs.
De mon costé, pour moy, ie n'ay point d’eſperance, Que l’on puiſſe à mes maux donner de l’allegeance, Zelmatide eſtant mort, ainſi que ie le croy, Madame, il n'y a point d’eſperance pour moy, Quoy qu’il puiſſe arriuer, helas!	De mon côté, pour moi, je n'ai point d'espérance, Que l'on puisse à mes maux donner de l'allégeance, Zelmatide étant mort, ainsi que sans le crois, Madame, il n'y a point d'espérance pour moi, Quoi qu'il puisse arriver, hélas!
tout m'est funeſte:	tout m'est funeste:
L’enuie de le ſuiure est celle qui me reste.	L'envie de le suivre est celle qui me reste.
Lors que ie ſuis au lit, ie voy toutes les nuits Son ombre qui me dit, ie ſuis mort & tu vis.	Lors que ici suis au lit, je vois toutes les nuits Son ombre qui me dit, ie suis et et tu vis.
Tu ne tiens pas ta foy, trop ingrate Iſatide, Tu ne penſes donc plus au pauure Zelmatide;	Tu ne tiens pas ta foi, trop ingrate Isatide, Tu ne penses donc plus au pauvre Zelmatide;
C iſt pur ue teis diſcours qu'il me vient aſfliger;	Ç pur pur te teis discours qu'il me vient asfliger;
Uoulant viure apres luy, c'est le deſobliger;	Où vivre après avoir, c'est le désobliger;
C’eſt pourquoy dans mon mal quelque bonne fortune Qui me puiſſe arriuer, me nuit & m’importune.	C'est pourquoi dans mon mal quelque bonne fortune Qui me puisse arriver, me nuit et m'importune.
ZERBINE.	ZERBINE.
Sur vn ſimple rapport vous croyez de leger, Zelmatide peut viure ayant fuy le danger;	Sur un simple rapport vous croyez de léger, Zélatide peut vivre ayant fui le danger;
Les Dieux l’ont conſerué pour nous faire paroiſtre Que c'eſt par leur bonté qu’ils nous ont donné l’Eſtre;	Les Dieux l'ont conservé pour nous faire paraître Que c'est par leur bonté qu'ils nous ont donné l'Être;
Eſtans nos Souuerains, ils ſont bien tous puiſſans.	Étant nos Souverains, ils sont bien tous puissants.
ISATIDE.	ISATIDE.
Helas!	Hélas!
par tels diſcours n’abuſez pas mes ſens;	par tels discours n'abusez pas mes sens;
Sa mort aſſurément eſt trop bien conſeruée.	Sa mort assurément est trop bien conservée.
Apres les gens deffaits de toute ſon armée, Tous ſes vaiſſeaux bruſlez, ſont vn ſigne euident Qu’il n’a pû s’eſchaper d’vn ſi triſte accident, Auroit-il euité la flame & le naufrage!	Après les gens défaits de toute son armée, Tous ses vaisseaux brûlés, sont un signe évident Qu'il n'a pu s'échapper d'un si triste accident, Aurait-il euité la flamme et le naufrage!
Tous ces euenemens m’affligent dauantage;	Tous ces événements m'affligent davantage;
Vous m’obligerez, plus à ne m'en point parler, Uous pretendeZ en vain me pouuoir conſoler.	Vous m'obligerez, plus à ne m'en point parler, Uous prétendez en vain me pouvoir consoler.
CINTILLE.	CINTILE.
Chere ſœur, ie vous pleins,	Chère sœur, Seigneur vous pleins,
ISATIDE.	ISATIDE.
Ie ne ſuis pas à plaindre.	Je ne suis pas à plaindre.
Dans l’eſtat où ie ſuis ie ne dois plus rien craindre.	Dans l'état où tu suis ici ne dois plus rien craindre.
CINTILLE.	CINTILE.
En effect ie prens part dans voſtre affliction, Le Deſtin traitte mal vostre condition:	En effet grande prends part dans votre affliction, Le Destin traite mal votre condition:
Voſtre mal-heur me touche,	Votre malheur me touche,
ZERBINE.	ZERBINE.
Où manque le remede, Il faut faire venir la raiſon à noſtre ayde.	Où manque le remède, Il faut faire venir la raison à notre aide.
SATIDE.	SATIDE.
Croyez que la raiſon ne me ſçauroit guerir, Mon plus certain remede est celuy de mourir.	Croyez que la raison ne me saurait guérir, Mon plus certain remède est celui de mourir.
Ie m’exempterois bien de tout ce que i’endure, Par vn coup de ma main ie ferois cette cure;	Je m'exempterais bien de tout ce que j'endure, Par un coup de ma main après ferais cette cure;
Ie pourrois auancer l’heure de mon treſpas:	Je pourrais avancer l'heure de mon trépas:
Mais mon cœur y reſiſte, & me retient le bras.	Mais mon cœur y résiste, et me retient le bras.
Tantoſt il me contraint à finir ma miſere, Et tantoſt il m'oblige à faire le contraire;	Tantôt il me contraint à finir ma misère, Et tantôt il m'oblige à faire le contraire;
Qnpue foiu me umnconme mon fentiment, Qu’il me faut conſeruer pour mon fidel Amant;	Qnpue faut conserver pour mon sentiment, Qu'il me faut conserver pour mon fidel Amant;
Puis ſemble repugne eruriprmre trejaute, Que ie vis ence lieu ſans aucune eſperance.	Puis semble répugne eruriprmre trejaute, Que tu vis ence lieu sans aucune espérance.
Attilla & Alciomede armez, entrent.	Attilla et Alciomède armés, entrent.
L TV TROISIESME.	 LU TROISIÈME.
E ATTILLA, CINTILLE.	 ATTILLA, CINTILLE.
Q ATTILLA.	Q ATTILLA.
N fin, cruelle en fin, vos imprecations Ont remply tout ce lieu de maledictions;	N fin, cruelle en fin, vos imprécations Ont rempli tout ce lieu de malédictions;
Vous aueZ ſuſcité ce furieux orage, MeorT& Ne croyeZ pas pourtant euiter le naufrage.	Vous avez suscité ce furieux orage, MeorTE Ne crois pas pourtant éviter le naufrage.
Uoſtre beau Cheualier auec tout ſon effort, Ne vous peut exempter du peril de la mort.	Votre beau Chevalier avec tout son effort, Ne vous peut exempter du péril de la mort.
Quoy qu’il ſoit en ce lieu la choſe eſt aſſeurée, Voſtre perte eſt certaine, & ſon heure iurée.	Quo qu’il soit en ce lieu la chose est assurée, Votre perte est certaine, et son heure jurée.
Il croit que voſtre corps doit eſtre ſon butin, Mais il doit esperer vn plus triſte deſtin;	Il croit que votre corps doit être son butin, Mais il doit espérer un plus triste destin;
Car perſonne apres moy n’aura pas cette gloire, Que de pouuoir iouir d’vne pleine victoire.	Car personne après moi n'aura pas cette gloire, Que de pouvoir jouir d'une pleine victoire.
Ouy, c’est bien mon deſſein, & mon intention Qu d'empeſtper quit ai vostre poſſeßion.	Oui, c'est bien mon dessein, et mon intention Qu 'empestper quit ai votre possesiion.
CINTILLE.	CINTILE.
Zerbine ie me meurs,	Zerbine personne me meurs,
ATTILLA.	ATTILA.
Regardez cette infame Le nom de ſon Amant fait deſcouurir ſa flame,	Regardez cette infâme Le nom de son Amant fait découvrir sa flamme,
INTILLE.	INTILE.
Qui t'empeſche Tyran d’acheuer deſſus moy Vn crime commencé ſur la teſte d’vn Roy.	Qui t'empêche Tyran d'achever dessus moi Un crime commencé sur la tête d'un Roi.
Meſchant, le pere mort il reſte encor la fille, Esteint en ma perſonne vne illustre famille?	Mêchant, le père mort il reste encor la fille, Éteint en ma personne une illustre famille?
A quoy ſert ton eſpée, & qui retient ton bras, Qu'au milieu de ce ſein tu ne la plonge pas;	À quoi sert ton épée, et qui retient ton bras, Qu'au milieu de ce sein tu ne la plonge pas;
Tes crimes ſont permis pour gagner la Couronne, Y ouſſes dont, ne crains rien, apres ie te la donne, Mais croy qu’apres ma mort le Ciel me vangera;	Tes crimes sont permis pour gagner la Couronne, Y ousses dont, ne crains rien, après ie te la donne, Mais crois qu'après ma mort le Ciel me vengera;
La Iuſtice diuine en fin te punira;	La Justice divine en fin te punira;
Les Dieux ſe laſſeront de voir ta tyrannie, Par quelque eſtrange mort ils finiront ta vie.	Les Dieux se lasseront de voir ta tyrannie, Par quelque étrange mort ils finiront ta vie.
ATTILLA.	ATTILA.
Impudique, c’est trop, en l’estat où ie ſuis, Ie te veux vne fois monſtrer ce que ie puis;	Impudique, c'est trop, en l'état où tu suis, Je te veux une fois montrer ce que ie puis;
Ie vay tout de ce pas ſur cette belle armée Esprouuer cette main par la rage animée.	Je vais tout de ce pas sur cette belle armée Esprouver cette main par la rage animée.
Il ſort.	Il sort.
CINTILLE.	CINTILE.
O mal-heur ſans égal!	Ô malheur sans égal!
ô cruauté du ſort!	ô cruauté du sort!
De deux coſtez helas!	De deux côtés hélas!
ie dois craindre la mort.	Ne dois craindre la mort.
I’apprehende pour moy;	J'appréhende pour moi;
ie crains plus pour vn autre, Beau Cheualier, ma vie eſt iointe auec la voſtre.	Je crains plus pour un autre, Beau Chevalier, ma vie est jointe avec la vôtre.
Que dois-ie deuenir dans cette extremité!	Que dois-je devenir dans cette extrémité!
A quoy ſe reſoudra mon eſprit agité!	À quoi se résoudra mon esprit agité!
Si tu meurs, cher Amant, ie iure de te ſuiure, Apres t’auoir perdu, non ie ne dois plus viure.	Si tu meurs, cher Amant, Seigneur jure de te suivre, Après t'avoir perdu, non ie ne dois plus vivre.
Mais ſi tu vis, helas!	Mais si tu vis, hélas!
qu'Attilla ſoit vaincu, Pour viure vne heure apres, i’auray trop ſurueſcu.	qu'Attilla soit vaincu, Pour vivre une heure après, j'aurai trop survécu.
Ourmomes von I pranou ton nonneur t'engage;	Ôurmomes von I pranou ton nonneur t'engage;
Amour, il ne faut plus conſulter dauantage;	Amour, il ne faut plus consulter davantage;
Il vaut mieux que ie meure, & que th ſois vainqueur, La loy de ton honneur force à cette rigueur.	Il vaut mieux que de meure, et que th sois vainqueur, La loi de ton honneur force à cette rigueur.
ZERBINE.	ZERBINE.
Dans l’eſtat déplorable où vous eſtes reduitte, Inuentons, s’il ſe peut, quelque bonne conduitte;	Dans l'état déplorable où vous êtes réduite, Inventons, s'il se peut, quelque bonne conduite;
Euitons vn mal-heur, puiſque prest à tomber, Oi la neceßité nous feroit ſuccomber;	Éviterons un malheur, puisque prêt à tomber, Oi la necemité nous ferait succomber;
Où le mal est preſſant, la prompte medecine Ne ſe doit negliger pour couper la racine;	Où le mal est pressant, la prompte médecine Ne se doit négliger pour couper la racine;
Cherchons quelque moyen qui puiſſe diuertir, Ontoup qmi je prepare à je ſaire ſehtir.	Cherchons quelque moyen qui puisse divertir, Ontoup qmi je prépare à je zaïre sehtir.
CINTILLE.	CINTILE.
Vous pretendez en vain au mal qui me poſſede, D’y donner du ſecours, d’apporter du remede;	Vous prétendez en vain au mal qui me possède, D'y donner du secours, d'apporter du remède;
meſe peraut vofere temps, le nenſcaurors guerir, Il n’y faut plus ſonger, ie ſuis preſte à mourir.	meze péraut vofère temps, le nenscaurors guérir, Il n'y faut plus songer, sans suis prête à mourir.
La AV 2 VATRIESME.	La AU 2 VATRIESME.
CHILDEBRAND, PANDOR, & ſa ſuitte, armez.	CHILDEBRAND, PANDOR, et sa suitte, armés.
CHILDEBRAND.	CHILDEBRAND.
E voy que vous ſçauez le deſſein qui me mene, Que c’est pour deliurer vne innocente Reine, A Pour laquelle mon cœur tout embrasé d’amour Ne fait rien que ſe plaindre, & pleurer nuit & iour.	E vois que vous savez le dessein qui me mène, Que c'est pour délivrer une innocente Reine, A Pour laquelle mon cœur tout embrasé d'amour Ne fait rien que se plaindre, et pleurer nuit et jour.
Donnons donc, s’il ſe peut, à mon mal allegeance, Puniſſons vn ſubiect tout remply d’arrogance;	Donnons donc, s'il se peut, à mon mal allégeance, Punissons un sujet tout rempli d'arrogance;
Et croyez mes amis que c’est ce petit Dieu, Lequel de ſon flambeau nous conduit en ce lieu.	Et croyez mes amis que c'est ce petit Dieu, Lequel de son flambeau nous conduit en ce lieu.
Courage, compagnons, ſi l’amour m'authoriſe, Croyez aſſeurément que Mars nous fauoriſe;	Courage, compagnons, si l'amour m'autorise, Croyez assurément que Mars nous favorise;
Il faut executer vn ſi iuste deſſein, Puiſque nous auons tous les armes à la main;	Il faut exécuter un si juste dessein, Puisque nous avons tous les armes à la main;
Meſnageons comme il faut nostre bonne fortune, L’imprudence peut nuire, & nous estre importune.	Mesnageons comme il faut notre bonne fortune, L'imprudence peut nuire, et nous chang importune.
Deſia nos ennemis nous croyans les plus forts, Se ſont decourageZ, & ſont à demy morts;	Déjà nos ennemis nous croyant les plus forts, Se sont décourage, et sont à demi morts;
A la moindre rencontre, aux petites alarmes, Ils ſe rendront à nous, & mettront bas les armes.	À la moindre rencontre, aux petites alarmes, Ils se rendront à nous, et mettront bas les armes.
Le ſeul reſſouuenir des crimes qu’ils ont faits, Gu on ions abbatus, & preſque tous deffaits, Nous ſommestroptemiains au fruut de la viétnire, Nous en remporterons, & l’honneur & la gloire;	Le seul ressouvenir des crimes qu'ils ont faits, Gu on jons abattus, et presque tous défaits, Nous sommestroptemiains au fru de la viétnire, Nous en remporterons, et l'honneur et la gloire;
Ils viendront à nos pieds ſe ietter à genoux, Implorer le pardon qu’ils eſperent de nous.	Ils viendront à nos pieds se jetèter à genoux, Implorer le pardon qu'ils espèrent de nous.
PANDOR.	PANDOR.
Allons, allons, Seigneur, deſſus tous ces perfides, Faire ſentir l’effort de nos bras homicides;	Allons, allons, Seigneur, dessus tous ces perfides, Faire sentir l'effort de nos bras homicides;
Monſtrons à ce Tyran que ſa temerité Se doit recompenſer comme elle a merité.	Monstrons à ce Tyran que sa témérité Se doit récompenser comme elle a mérité.
Auce Auec trop de raiſon voſtre amour nous appelle, A prendre l’intereſt de ſa propre querelle;	Auce Vec trop de raison votre amour nous appelle, À prendre l'intérêt de sa propre querelle;
Il ne faut plus tarder cette execution, Que l’on doit terminer par la punition.	Il ne faut plus tarder cette exécution, Que l'on doit terminer par la punition.
Cette Reine oprimée auec impatience, Attend de vostre bras le coup de ſa deffence;	Cette Reine oprimée avec impatience, Attend de votre bras le coup de sa défense;
Buns uoute eue ſe plaint voyant voſtre longueur, D'estre ſi prés de nous ſi long temps en langueur.	Buns ouvte eue se plaint voyant votre longueur, D'être si près de nous si long temps en langueur.
CHILDE BRAND.	CHILDE BRAND.
Puiſque voſtre vertu ſe rend intereſſée A vouloir ſecourir l’innocente oppreſſée;	Puisque votre vertu se rend intéressée À vouloir secourir l'innocente oppressée;
Ie ſeray redeuable à vostre affection, Demvraſſer jon party pour ja protection.	Je serai redevable à votre affection, Demuvrasser jon parti pour ja protection.
Soldats, mes compagnons, dont la valeur extréme Se doit recompenſer par quelque Diadéme.	Soldats, mes compagnons, dont la valeur extrême Se doit récompenser par quelque Diadème.
Que feray-ie pour vous,	Que ferai-je pour vous,
ANDOR Nos ſeruices paſſeZ Et tous ceux d’apreſent ſont trop recompenſeZ	ANDOR Nos services passés Et tous ceux d'aprésent sont trop recompenseZ
Fin du troiſieſme Acte.	Fin du troisième Acte.
LX	LX
SCENE PREMIERE.	SCÈNE PREMIÈRE.
ATTILLA, & CHILDE BRAND, armez.	ATTILA, et CHILDE BRAND, armés.
2 ATTILLA.	2 ATILLA.
Heualier, faiſons tréue, & fais moy cetL te grace, Que de vouloir m'attendre en cette meſme place;	Hevalier, faisons trêve, et fais moi cetL te grâce, Que de vouloir m'attendre en cette seule place;
Ie m’en vais reuenir, puis apres on verra A qui ſera l’honneur, & qui l’emportera.	Je m'en vais revenir, puis après on verra À qui sera l'honneur, et qui l'emportera.
CHILDEBRAND.	CHILDEBRAND.
Allez, ie vous attens, c’est auec cette enuie, De gagner la victoire ou de perdre la vie.	Allez, Seigneur vous attends, c'est avec cette envie, De gagner la victoire ou de perdre la vie.
Le temps est arriué, miracle de beauté!	Le temps est arrivé, miracle de beauté!
Que ie veux vous tirer de la captiuité.	Que tu veux vous tirer de la captivité.
Le Ciel me ſecondant, il faut que cette eſpée Soit dans ſon traiſtre ſang iuſqu’aux gardes trempée.	Le Ciel me secondant, il faut que cette épée Soit dans son traître sang jusqu'aux gardes trempée.
Il a voulu permettre en voyant mon amour, Que ie vinſſe en ce lieu pour le priuer du iour;	Il a voulu permettre en voyant mon amour, Que Rome vinsse en ce lieu pour le priver du jour;
Auec contentement ie feray cét office, Mon bras est deſtiné pour rendre la iuſtice;	Avec contentement ici ferai cet office, Mon bras est destiné pour rendre la justice;
Mon bras voudroit ſeruir auec trop de raiſon, Pour briſer tous vos fers, rompre voſtre priſon.	Mon bras voudrait servir Seigneur trop de raison, Pour briser tous vos fers, rompre votre prison.
I'immoleray ſon cœur à ma iuſte colere;	J'immolerai son cœur à ma juste colère;
Ie ſeray ſatisfait vous pouuant ſatisfaire.	Je serai satisfait vous pouvant satisfaire.
Viens donc, viens donc, Tyran, c’eſt en fin trop tarder, Dedans vn dernior coup il faut tout haZarder.	Viens donc, viens donc, Tyran, c'est en fin trop tarder, Dedans un dernior coup il faut tout hasarder.
Ne crois pas prolonger ce qui te reſte à viure, Pour haſter ton treſpas ce bras te va pourſuiure;	Ne crois pas prolonger ce qui te reste à vivre, Pour hâter ton trépas ce bras te va poursuivre;
Fais qu’eſtant mort l’on die;	Fais qu'étant mort l'on die;
s’il ne fut pas vainqueur, Au moins il s’eſt battu comme vn homme de cœur.	s'il ne fut pas vainqueur, Au moins il s'est battu comme un homme de cœur.
CHILDEBRAND.	CHILDEBRAND.
Darbare, qu'aselu jait.	Darbare, qu'aselu jait.
ATTILLA.	ATTILA.
I’ay fait ce que i’ay deû, Ne pouuant poſſeder vn bien prey jue perdu.	J'ai fait ce que j'ai déçu, Ne pouvant posséder un bien pré jue perdu.
Mon amour me forçant à cette violence, I'ay mis la Reine à mort.	Mon amour me forçant à cette violence, J'ai mis la Reine à mort.
CHILDEBRAND.	CHILDEBRAND.
Ah!	Ah!
Dieu, quelle inſolance.	Dieu, quelle insolance.
Tu me fruſtres du prix pour lequel ie combats.	Tu me frustres du prix pour lequel ici combats.
ATTILLA.	ATTILA.
Ouy, i’ay mis de ma main ce beau chef d’œuure à bas.	Oui, j'ai mis de ma main ce beau chef d'œuvre à bas.
CHILDEBRAND en ſe battant.	CHILDEBRAND en se battant.
Tu ne ſuruiuras pas cette Reine innocente, Cruelle à te punir ſon ombre eſt conſentante;	Tu ne survivras pas cette Reine innocente, Cruelle à te punir son ombre est consentante;
Elle veut auiourd’huy que ie ſois ſon bourreau, Ie feray, s'il ſe peut, vn office ſi beau.	Elle veut aujourd'hui que je sois son bourreau, Je ferai, s'il se peut, un office si beau.
ATTILLA en mourant.	ATTILA en mourant.
Ie meurs trop ſatisfait puiſque ie perds la vie, Pour contenter la Reine à quiie l’ay rauie.	Je meurs trop satisfait puisque je perds la vie, Pour contenter la Reine à quiie l'ai ravie.
Que le Deſtin eſt rigoureux:	Que le Destin est rigoureux:
Ah!	Ah!
que la Fortune eſt ſeuere A rendre mes iours mal-heureux Son inconſtance perſeuere.	que la Fortune est sévère A rendre mes jours malheureux Son inconstance persévère.
Pourquoy, volage Deité, Deſſous vn viſage emprunté Caches-tu le poiſon que ta main nous prepare.	Pourquoi, volage Déité, Dessous un visage empruné Caches-tu le poison que ta main nous prépare.
Tu m'as conduit dedans ce lieu, Puis tout d’vn coupon me ſepare D'vn obiect qui pourroit aſſubiettir vn Dieu.	Tu m'as conduit dedans ce lieu, Puis tout d'un coupon me sépare D'un objet qui pourrait assubiettir un Dieu.
Mais c’eſt me plaindre vainement;	Mais c'est me plaindre vainement;
Ce ſont des effets de ta rage, Deſſus vn mal-heureux Amant Tu verſes touſiours quelque orage.	Ce sont des effets de ta rage, Dessus un malheureux Amant Tu verses toujours quelque orage.
Ton ordinaire cruauté Voyant vne telle Beauté, Pour monſtrer aux humains ta fatale puiſſance, Tu ſignas l’Arreſt de ſa mort Sans conſiderer ſa naiſſance;	Ton ordinaire cruauté Voyant une telle Beauté, Pour montrer aux humains ta fatale puissance, Tu signas l'Arrest de sa mort Sans considérer sa naissance;
Fais donc qu'en l’imitant i’aye vn ſemblable ſort.	Fais donc qu'en l'imitant j'aie un semblable sort.
Cruelle, inſenſible à mes pleurs, Tu te moques de ma priere, Afin d’augmenter mes douleurs Tu me conſerues la lumiere.	Cruelle, insensible à mes pleurs, Tu te moques de ma prière, Afin d'augmenter mes douleurs Tu me conserves la lumière.
Fortune en vain c’est t’implorer, Amour ne faut rien eſperer, Tout s’oppoſe au deſſein que ie fais de te ſuiure.	Fortune en vain c'est t'implorer, Amour ne faut rien espérer, Tout s'oppose au dessein que je fais de te suivre.
Ah!	Ah!
quel eſt mon reſſentiment, Belle ombre, on m’ordonne de viure Pour courir apres toy v'on met empeſchement.	quel est mon ressentiment, Belle ombre, on m'ordonne de vivre Pour courir après toi v'on met empêchement.
En prenant la teſte.	En prenant la tête.
Mais tout eſt mort pour moy, ie n’ay plus d’eſperance, Tout ce qui reſte icy m'est dans l’indifference.	Mais tout est mort pour moi, je n'ai plus d'espérance, Tout ce qui reste ici m'est dans l'indifférence.
Il eſt vray, cher obiect, croyant te poſſeder, Pour en venir à bout, i’oſay tout hazarder, Et ce traiſtre aſſaßin par ſa main meurtriere A mis fin à ma ioye en t’ostant la lumiere.	Il est vrai, cher objet, croyant te posséder, Pour en venir à bout, j'osai tout hasarder, Et ce traître assassin par sa main meurtrière A mis fin à ma joie en tôtant la lumière.
En ſeretourIe coniure le Ciel afin de te punir, Que tu ſois en horreur aux ſiecles à venir.	En secrétourIe conjure le Ciel afin de te punir, Que tu sois en horreur aux siècles à venir.
nant vers Attilla, Au Royaume des morts, ie prie que ton ombre, Des furies d’Enfer en augmente le nombre;	nant vers Atilla, Au Royaume des morts, je prie que ton ombre, Des furies d'Enfer en augmente le nombre;
Qu'elle ſoit condamnée à ſouffrir mille maux;	Qu'elle soit condamnée à souffrir mille maux;
Que l’on prepare exprés des ſupplices nouueaux;	Que l'on prépare exprès des supplices nouveaux;
Que tes meſchanceteZ rongent ta conſcience;	Que tes meschanceteZ rongent ta conscience;
Qu'en te faiſant ſouffrir tu ſois ſans patience;	Qu'en te faisant souffrir tu sois sans patience;
Que tu bruſles touſiours ſur quelque ardant buſcher;	Que tu brûles toujours sur quelque ardant bûcher;
Qu’au tourment d’Ixion onte puiſſe attacher;	Qu'au tourment d'Ixion onte puisse attacher;
Que ton corps ſans tombeau demeure ſur la Terre;	Que ton corps sans tombeau demeure sur la Terre;
Que tes os ſoyent briſeZ d’vn eſclat de Tonnerre;	Que tes os soient brisés d'un éclat de Tonnerre;
Qu'aux oyſeaux acharnez tu ſerues de repas;	Qu'aux oiseaux acharnés tu serves de repas;
Qu’ils te traiſnent pluſtoſt, & ne te mangent pas;	Qu'ils te traînent plutôt, et ne te mangent pas;
Que tu faſſes frayeur à toute la Nature;	Que tu fasses frayeur à toute la Nature;
Que tu puiſſe reſter ainſi ſans ſepulture;	Que tu puisse rester ainsi sans sépulture;
Que ce funeſte lieu quand i'en ſeray ſorty De ton mal-heureux corps demeure empuanty, Que cette Iſle deuienne infertille & deſerte:	Que ce funeste lieu quand j'en serai sorti De ton malheureux corps demeure empuanti, Que cette Île devienne infertille et déserte:
Bref, que tous les maudits inſtrumens de ma perte Soient touſiours pourſuiuis des plus cruels mal-heurs, Comme mon cœur reſſent de ſemblables douleurs, Encore pour te vanger, s’il eſtoit neceſſaire De ſemer dans ces lieux l’horreur & la miſere, Mon cœur plus furieux mille fois qu'vn Lyon, Feroit de cét endroit vn ſecond Ilion.	Bref, que tous les maudits instruments de ma perte Soient toujours poursuivis des plus cruels malheurs, Comme mon cœur ressent de semblables douleurs, Encore pour te venger, s'il était nécessaire De semer dans ces lieux l'horreur et la misère, Mon cœur plus furieux mille fois qu'un Lyon, Ferait de cet endroit un second Ilion.
Si ces diſcours pouuoient te redonner vne ame;	Si ces discours pouvaient te redonner une âme;
Si ton corps ſe pouuoit r’animer par ma flame, Tu ſçaurois belle teſte apprenant par ma voix, 4 Que mon deſir eſtoit de viure ſous tes loix.	Si ton corps se pouvait ranimer par ma flamme, Tu saurais belle tête apprenant par ma voix, 4 Que mon désir était de vivre sous tes lois.
Mon ſang preſque perdu, ma douleur exceßiue, M'affoibliſſant beaucoup, veulent que ie te ſuiue;	Mon sang presque perdu, ma douleur excessiue, M'affaiblissant beaucoup, veulent que Seigneur te suive;
Ie ne reſiſte plus, ie conſens à mourir, Ah!	Je ne résiste plus, ie encens à mourir, Ah!
belle ombre, attens moy, ie vais te ſecourir.	belle ombre, attends moi, On vais te secourir.
Li N DEVXIESME.	Li N EUXIESME.
Ll TANABOVSE, PANDOR, CHILDEBRAND.	Ll TANABOUSE, PANDOR, CHILDEBRAND.
E M TANABOVSE.	E M ANABOUSE.
Vel ſpectacle eſt-ce icy, dedans noſtre arriuée, Du ſang de ces deux corps la terre eſt abreuée.	Vel spectacle est-ce ici, dedans notre arriuée, Du sang de ces deux corps la terre est abreuée.
Approchons, voyons les.	Approchons, voyons -les.
CHILDEBRAND couché.	CHILDEBRAND couché.
Ah!	Ah!
Madame, arreſtez, La Fortune en effect nous a bien mal traittez.	Madame, arrêtez, La Fortune en effet nous a bien mal traités.
PANDOR.	PANDOR.
PANDOR.	PANDOR.
Uous voila, mon Seigneur, en fort triste equipagé Si vous n’estes la Mort, vous eſtes ſon image;	Uous voilà, mon Seigneur, en fort triste équipagé Si vous n'êtes la Mort, vous êtes son image;
eure pute cemtein, & cos jeux tangmijſans En ſont de vrais teſmoins,	eure pute camtein, et cos jeux tangmijans En sont de vrais témoins,
CHILDEBRAND ſe releuant.	CHILDEBRAND se relevant.
La douleur que ie ſens Uient d’vn autre costé que de celuy des armes.	La douleur que je sens Uient d'un autre côté que de celui des armes.
Quand i'y viens a penſer, il faut verſer des larmes, Croyant eſtre vainqueur me voila le vaincu, Tamdoraprecun pelle, enfnvi nep ced.	Quand j'y viens a penser, il faut verser des larmes, Croyant être vainqueur me voilà le vaincu, Tamdoraprecun pelle, enfnuvi ne céd.
TANABOVSE.	TANABOUSE.
Quel eſt voſtre accident:	Quel est votre accident:
CHILDEBRAND.	CHILDEBRAND.
Helas!	Hélas!
lors que i’y penſe, Ie dois auec raiſon regretter l’innocence.	lors que j'y pense, Je dois avec raison regretter l'innocence.
Regardez cetté vope, O mgei frmes preurs A tort ſont reſpandus apres tant de mal-heurs.	Regardez cetté vope, Ô méi frêmes près A tort sont répandus après tant de malheurs.
La Reine ne vit plus, en voila ce qui reſte, Ce traiſtre de ſa main a fait ce coup funeſte, Auant que de mourir voila ce qu’il a fait, Apres cette action il eſt mort ſatisfait.	La Reine ne vit plus, en voilà ce qui reste, Ce traître de sa main a fait ce coup funeste, Avant que de mourir voilà ce qu'il a fait, Après cette action il est mort satisfait.
Childebrand & Pandor s’en vont.	Childebrand et Pandor s'en vont.
TANABOVSE tenant la teſte.	TANABOUSE tenant la tête.
Qu'as-tu fait au Deſtin, innocente Princeſſe, A pres t’auoir cherchée auec tant de tendreſſe;	Qu'as-tu fait au Destin, innocente Princesse, A pres t'avoir cherchée auec tant de tendresse;
Ie perds mon eſperance en ne te voyant plus, Ie voy en moins de rien tous mes ſoins ſuperflus.	Je perds mon espérance en ne te voyant plus, Je vois en moins de rien tous mes soins superflus.
Qu'a ſeruy de courir tant de Mers estrangeres, Sinon que d’auancer l’heure de tes miſeres?	Qu'a servi de courir tant de Mers étrangères, Sinon que d'avancer l'heure de tes misères?
A quoy donc ont ſeruy tant de ſi grands trauaux, Qu'à croistre mes mal-heurs en augmentant tes maux?	À quoi donc ont servi tant de si grands travaux, Qu'à croître mes malheurs en augments té maux?
Ie veux viure à preſent comme deſeſperée, Regardant de ton corps la teſte ſeparée;	Je veux vivre à présent comme désespérée, Regardant de ton corps la tête séparée;
La Terre me deſplaist, i’ay le Ciel en horreur, Toutes ſortes d’obiects me font de la terreur.	La Terre me déplaît, j'ai le Ciel en horreur, Toutes sortes d'objets me font de la terreur.
Que dy-ie, chere Niece, en l’estat déplorable Où ie ſuis à preſent mon crime est pardonnable.	Que dis-je, chère Nièce, en l'état déplorable Où tu suis à présent mon crime est pardonnable.
Non, non, ie te veux ſuiure en quel lieu que tu ſois, Ie vaincray par mes pleurs les plus fatales Loix, I’amoliray le cœur des dures destinées, Pour abreger le cours de mes triſtes années;	Non, non, Seigneur te veux suivre en quel lieu que tu sois, Je vaincrai par mes pleurs les plus fatales Lois, J'amolirai le cœur des dures destinées, Pour abréger le cours de mes tristes années;
Voyant mon deſplaiſir, m'enuoiront le treſpas Pour te ſuiure, belle Ombre, & marcher ſur tes pas.	Voyant mon déplaisir, m'envoiront le trépas Pour te suivre, belle Ombre, et marcher sur tes pas.
Mais s’eſt-il iamais veû ſemblable barbarie;	Mais s'est-il jamais vu semblable barbarie;
S’eſt-il vu cruauté, plutoſt, dy-ie furie.	S'est-il vu cruauté, plutôt, dis-je furie.
Ouy, ouy, faut eſtre tygre, encor plus furieux	Oui, oui, faut être tigré, encor plus furieux
VANGEANCE.	VANGEANCE.
Que doy-ie deuenir apres vn tel outrage?	Que dois-je devenir après un tel outrage?
Helas!	Hélas!
maudits effets d’vn tyran plein de rage, Belle teſte autrefois, ſiege de la raiſon, Le Ciel t’abien vangé de cette trahiſon.	maudits effets d'un tyran plein de rage, Belle tête autrefois, siège de la raison, Le Ciel t'abien vengé de cette trahison.
Mais, helas!	Mais, hélas!
apres tout dans ce mal qui me preſſe Ie ne ſçaurois pleurer au fort de ma tristeſſe;	après tout dans ce mal qui me presse Je ne saurais pleurer au fort de ma tristesse;
La Nature m’empeſche vn ſi foible deuoir, Dans l’eſtat où ie ſuis ie reſte ſans pouuoir.	La Nature m'empêche un si faible devoir, Dans l'état où je suis été reste sans pouvoir.
Si ie ne puis pleurer, il faut que ie te baiſe;	Si ici ne puis pleurer, il faut que je te baise;
Que mes lévres ſur toy ſe collent à mon aiſe.	Que mes lèvres sur toi se collent à mon aise.
Allons, allons chercher au milieu des rochers, Les roſtes de ton corps qui me furent ſi chers.	Allons, allons chercher au milieu des rochers, Les rosîtes de ton corps qui me furent si chers.
Plus ie te conſidere, & plus ie me tourmente;	Plus Seigneur te considère, et plus grands me tourmente;
Plus ie voy ton beau Chef, plus ma douleur s’augmente;	Plus ici vois ton beau Chef, plus ma douleur s'augmente;
Le temps en cét endroit deuient mon aſſaßin, Il me tue plutost qu’il n'eſt mon Medecin;	Le temps en cet endroit dévient mon assassin, Il me tue plutôt qu'il n'est mon Médecin;
Il ſigure à mes yeux la grandeur de ma perte;	Il sigure à mes yeux la grandeur de ma perte;
Il me monstre les maux que ta vie a ſoufferte.	Il me montre les maux que ta vie a soufferte.
Iniuſtes Dieux, pourquoy, vous dreſſer des Au tels;	Iniustes Dieux, pourquoi, vous dresser des Au tels;
A quoy ſeruent les vœux que vous font les mortels?	À quoi servent les vœux que vous font les mortels?
A quoy doiuent ſeruir tant de beaux Sacrifices, Si ce n'est pour nous estre à tant de maux propices?	À quoi doivent servir tant de beaux Sacrifices, Si ce n'est pour nous être à tant de maux propices?
Dites donc pourquoy ſert la tempeſte en vos mains, Si ce n'eſt pour punir les crimes des humains.	Dites donc pourquoi sert la tempête en vos mains, Si ce n'est pour punir les crimes des humains.
Quoy!	Quoi!
vous auez ſouffert qu’vne Reine innocente, Ait reçeu le treſpas d’vne main violente;	Vous avez souffert qu'une Reine innocente, Ait reçu le trépas d'une main violente;
LA IVSIE Uous aueZ enduré ſans eſtre à ſon ſecours Qu'vn traiſtre ait racourcy la trame de ſes iours;	LA IVSIE Uous avez enduré sans être à son secours Qu'un traître ait racourci la trame de ses jours;
Qu'vn cruel ſans ſujet ait mis fin à ſa vie, Et vous aueZ permis qu'elle luy fuſt rauie.	Qu'un cruel sans sujet ait mis fin à sa vie, Et vous avez permis qu'elle te fût ravie.
C’est en vain vous prier, vous estes impuiſſans;	C'est en vain vous prier, vous êtes impuissants;
En vain tous les mortels vous ſont obeïſſans, Puiſque vous delaiſſez ſans prendre leur deffence Ceux qui craignoient touſiours de vous faire vne offence.	En vain tous les mortels vous sont obéissants, Puisque vous délaissez sans prendre leur défense Ceux qui craignaient toujours de vous faire une offense.
Mais, helas!	Mais, hélas!
ils ſont ſourds à mon reſſentiment Puis qu’ils ſont les autheurs de cét euenement.	ils sont sourds à mon ressentiment Puis qu'ils sont les auteurs de cet événement.
En vain Diuinitez, les hommes vous adorent;	En vain Divinités, les hommes vous adorent;
Ils s’abuſent beaucoup en vain ils vous honorent.	Ils s'abusent beaucoup en vain ils vous honorent.
Ah!	Ah!
c’eſt parler en l’air, ces diſcours ſont perdus, Ils ſont de ces rochers bien plutost entendus;	c'est parler en l'air, ces discours sont perdus, Ils sont de ces rochers bien plutôt entendus;
Dans ma iuste douleur le deſeſpoir m'emporte, De tant de paßions la rage est la plus forte;	Dans ma juste douleur le désespoir m'emporte, De tant de passions la rage est la plus forte;
Mon iugement ſe pert, ma raiſon s’affoiblit;	Mon jugement se pert, ma raison s'affaiblit;
Dans ce cœur affligé la frayeur s'eſtablit, Beau Reste inanimé d’vne amitié ſi tendre, L’on n’a pû te ſauuer en te voulant deffendre.	Dans ce cœur affligé la frayeur s'établit, Beau Reste inanimé d'une amitié si tendre, L'on n'a pu te sauver en te voulant défendre.
Apres auoir vaincu ton cruel ennemy, Nous n'auons emporté la gluire qu’à demy;	Après avoir vaincu ton cruel ennemi, Nous n'avons emporté la gluire qu'à demi;
Il triomphe de nous nonobſtant ſa deffaite, Puis qu'il nous a laißé la victoire imparfaite.	Il triomphe de nous nonobstant sa défaite, Puis qu'il nous a laisse la victoire imparfaite.
C’eſt traiter l’innocence auec trop de rigueur, Pour ſouffrir ces douleurs i'ay trop peu de vigueur:	C'est traiter l'innocence avec trop de rigueur, Pour souffrir ces douleurs j'ai trop peu de vigueur:
Il me faut ſuccomber, la force m'abandonne, Cintille, ie te ſuis, le Destin me l’ordonne.	Il me faut succomber, la force m'abandonne, Cintille, tu te suis, le Destin me l'ordonne.
Il eſt temps, c’en eſt fait, ie ne puis reſiſter.	Il est temps, c'en est fait, tu ne puis résister.
Mon deſeſpoirunoit, Ouijene umemporter.	Mon désespoirunait, Ouijène umemporter.
T IV TROISTESME.	 IV TROISTESME.
P CINTILLE, TANABOVSE.	 PINTILLE, TANABOUSE.
A CINTILLE.	À CINTILLE.
Hel grands Dieux, ſauueZ moy	Hél grands Dieux, sauvez moi
TANABOVSE.	TANABOUSE.
I'entens quelqu'vn ſe piuindre.	J'entends quelqu'un se pivindre.
Voyons où c’eſt en fin, car ie ne dois rien craindre;	Voyons où c'est en fin, car tu ne dois rien craindre;
Sans doute cette voix vient du creux d’vn rocher, C’eſt de ce costé-là, ie vay m'en approcher.	Sans doute cette voix vient du creux d'un rocher, C'est de ce côté-là, vou sais m'en approcher.
H.	H.
iij Mais ie nemens pius rien,	ij Mais Seigneur nements pius rien,
CINTILLE.	CINTILE.
Helas!	Hélas!
TANABOVSE.	TANABOUSE.
On recommence.	On recommence.
Pour apprendre qui c’est, c’est en vain que i’auance, Il n’en faut plus douter estant morte en ce lieu, Son ame par ces mots vient de me dire Adieu:	Pour apprendre qui c'est, c'est en vain que j'avance, Il n'en faut plus douter étant morte en ce lieu, Son âme par ces mots vient de me dire Adieu:
Attens encore vn peu puis que ie t'en coniure Ie vay rendre à preſent le tribut à Nature.	Attends encore un peu puis que sans t'en conjure Je vais rendre à présent le tribut à Nature.
Ie venx Pactompaguer un Ro juume ues Morts, Ie n’ay plus qu'a quitter mon miſerable corps.	Je venx Pactompaguer un Ro jume ues Morts, Je n'ai plus qu'a quitter mon misérable corps.
Cintille ſort d’vn rocher par vne pierre qu’elle fait tomber.	Cintille sort d'un rocher par une pierre qu'elle fait tomber.
CINTILLE.	CINTILE.
Qui vous conduit, ma Tante, en ce lieu detestable, Vous vous rendeZ encore vne fois miſerable,	Qui vous conduit, ma Tante, en ce lieu détestable, Vous vous rendez encore une fois misérable,
RATBOVSE.	RATBOUSE.
En fin ie voy ſon ombre, & ie la connois bien, Elle me vient querir.	En fin grande vois son ombre, et ainsi la connais bien, Elle me vient quérir.
CINTILLE.	CINTILE.
Non, non, ne craigneZ riens Ie ne ſuis pas vne Ombre, & ie ſuis cette Reine, Le rebut du Deſtin, & l’obiect de ſa haine.	Non, non, ne craignez riens Je ne suis pas une Ombre, et je suis cette Reine, Le rebut du Destin, et l'objet de sa haine.
Je vis ma chere Tante, & reſpuetc iour, Puiſque dedans ce lieu vous eſtes de retour.	Je vis ma chère Tante, et respuetc jour, Puisque dedans ce lieu vous êtes de retour.
TANABOVSE.	TANABOUSE.
Helas!	Hélas!
eſt-il poßible;	est-il passible;
& comment peut-il eſtre Que vous ſoyez viuante, en vous faiſant paroistre Ce teſmoin aſſeuré, ce chef encor ſanglant, Dont vous aueZ ſouffert vn trespas violant.	et comment peut-il être Que vous soyez vivante, en vous faisant paraître Ce témoin assuré, ce chef encor sanglant, Dont vous avez souffert un trépas violant.
CINTILLE.	CINTILE.
R'aſſurez vos eſprits, & croyez moy, ma Tante;	R'assurez vos esprits, et croyez moi, ma Tante;
Cela vous peut auoir donné de l’espouuante.	Cela vous peut avoir donné de l'épouvante.
Certainement ie vis.	Certainement Seigneur vis.
TANABOVSE.	TANABOUSE.
Ab!	Ab!
quel eſt mon bon-heur, La ioye tout d’vn coup ſuccede à ma douleur.	quel est mon bonheur, La joie tout d'un coup succède à ma douleur.
Que de contentemens.	Que de contentements.
Dieux!	Dieux!
que ie ſuis rauie, La fortune a voulu vous conſeruer la vie.	que ici suis ravie, La fortune a voulu vous conserver la vie.
Faites moy ce recit.	Faites -moi ce récit.
CINTILLE.	CINTILE.
Apres que i’auray ſçeû Ce que ce Cheualier a fait à mon deſceu, Le ſuccés du combat, la mort de ce perfide, Le iuſte châtiment de ſon cœur homicide.	Après que j'aurai su Ce que ce Chevalier a fait à mon desceu, Le succès du combat, la mort de ce perfide, Le juste châtiment de son cœur homicide.
Vous ſçaurez, cette hiſtoire.	Vous saurez, cette histoire.
ANABOVSE.	ANABOUSE.
Ouy pour voûs contenter Ie vay en peu de mots le tout vous raconter.	Oui pour us contenter Je vais en peu de mots le tout vous raconter.
Apprenez, chere Niepce, apres que noſtre armée Bien conduitte en bon ordre & fort bien animée;	Apprenez, chère Nypce, après que notre armée Bien conduite en bon ordre et fort bien animée;
Atiilla fut ſurpris, & ſon eſtonnement Luy cauſa tout d’vn coup vn grand ſaiſifſement.	Atiilla fut surpris, et son étonnement Lui causa tout d'un coup un grand saisifsement.
Lors qu’il fut dans le champ, reſolu de ſe battre, Il ietta cette teſte auant que de combattre.	Lors qu'il fut dans le champ, résolu de se battre, Il jeta cette tête avant que de combattre.
Nous cruſmes außi tost, que par vn deſeſpoir Il auoit faït ce coup ne vous pouuant auoir, Puis qu'il penſoit mourir ayant perdu courage, Il auoit deſſus vous ietté toute ſa rage.	Nous crûmes aussi tôt, que par un désespoir Il avait faït ce coup ne vous pouvant avoir, Puis qu'il pensait mourir ayant perdu courage, Il avait dessus vous jeté toute sa rage.
Vostre beau Cheualier, pour vanger voſtre mort A fait à ce cruel courir vn meſme ſort.	Votre beau Chevalier, pour venger votre mort A fait à ce cruel courir un même sort.
INTILLE.	INTILE.
Mais eſtant a ſon bras de la ſorte obligée, S’il eſtoit en danger i'en ſerois affligée.	Mais étant à son bras de la sorte obligée, S'il était en danger j'en serais affligée.
Dites que ce cruel ne l’a point offencé, Si deffendant ſa vie il ne l’a point bleßé;	Dites que ce cruel ne l'a point offensé, Si défendant sa vie il ne l'a point blé:
Pourquoy me vouleZ vous celer ce qui me touche.	Pourquoi me voulez -vous celer ce qui me touche.
Ah!	Ah!
vos yeux font aſſez l’office de la bouche;	vos yeux sont assez l'office de la bouche;
Il n'en faut plus douter, voſtre paſle couleur Fait voir la verité, prédiſant mon mal-heur.	Il n'en faut plus douter, votre pâle couleur Fait voir la vérité, prédisant mon malheur.
ER	ER
SCENE PREMIERE.	SCÈNE PREMIÈRE.
CHILDEBRAND, TANABONTE, CINTILLE.	CHILDEBRAND, TANABONTE, CINTILLLE.
CHILDEBRAND le bras en eſcharpe.	CHILDEBRAND le bras en écharpe.
Q Q E Ciel me fauoriſe, & ſa bonté ſupréme Nous monſtre en cét endroit qu’elle eſt iuſDo qu'à l’extréme.	 Q E Ciel me favorise, et sa bonté suprême Nous montre en cet endroit qu'elle est jusDo qu'à l'extrême.
Ie croyois qu’Attilla d’vn ſeul coup de ſa main Euſt mis fin à vos iours par cét acte inhumain.	Je croyais qu'Atilla d'un seul coup de sa main Eut mis fin à vos jours par cet acte inhumain.
Ie me tiens trop heureux de voir mon eſperance Reuiure en vn moment contre toute apparence, Quand ie ſonge par moy ce qui m'eſt arriué Ie croy iuſqu'à preſent auoir touſiours reſvé.	Je me tiens trop heureux de voir mon espérance Reuiure en un moment contre toute apparence, Quand ie songe par moi ce qui m'est arrivé Je crois jusqu'à présent avoir toujours rêvé.
Mais, Madame, à cette heure, il eſt bien du contraire, Vous me fermez la bouche, & forcez de me taire;	Mais, Madame, à cette heure, il est bien du contraire, Vous me fermez la bouche, et forcez de me taire;
Car tout ce qui s’eſt fait eſt pure verité, Ce n’eſt pas viſion, mais bien realité.	Car tout ce qui s'est fait est pure vérité, Ce n'est pas vision, mais bien realité.
It eſt vray, te croyois quece faſt vonre leſte Sur laquelle eſt tombée vne horrible tempeſte.	It est vrai, te croyais quece fât vonre leste Sur laquelle est tombée une horrible tempête.
CINTILLE.	CINTILE.
Cher François, cette teſte eſt vn funeſte obiet, Si ie me plains du ſort i’en ay bien du ſujet;	Cher Français, cette tête est un funeste objet, Si tu me plains du sort j'en ai bien du sujet;
La fidelle Zerbine en cela me ſurmonte, Ouy, ſa noble action me vient couurir de honte;	La fidèle Zerbine en cela me surmonte, Oui, sa noble action me vient couvrir de honte;
Elle s’eſt elle meſme expoſée pour moy A la fureur d’vn traiſtre, & d’vn homme ſans foy.	Elle s'est elle -même exposée pour moi A la fureur d'un traître, et d'un homme sans foi.
Sa grande affection, ſon genereux courage, Pour deſtourner de moy le coup de cét orage, Sans craindre le treſpas, ſurprenant mon bourroau, S’est paſtie à ma place vn glorienx tombeau;	Sa grande affection, son généreux courage, Pour détourner de moi le coup de cet orage, Sans craindre le trépas, surprenant mon bourro, S'est pâtie à ma place un glorienx tombeau;
Certes cette action me condamne moy meſme.	Certes cette action me condamne moi -même.
CHILDEBRAND.	CHILDEBRAND.
Sa generoſité, ma Princeſſe, eſt extréme.	Sa générosité, ma Princesse, est extrême.
CINTILLE.	CINTILE.
Son viſage & le mien auoient tant de rapport, Que cette reſſemblance a ſuſcité ſa mort.	Son visage et le mien avaient tant de rapport, Que cette ressemblance aux suscité sa mort.
TANABONTE.	TANABONTE.
Il faut loüer le Ciel, plutoſt que de ſe plaindre, Cette noble action nous y doit bien contraindre.	Il faut louer le Ciel, plutôt que de se plaindre, Cette noble action nous y doit bien contraindre.
Il a viſiblement enuers vous operé, En vous oſtant des mains de ce deſeſperé;	Il a visiblement envers vous opéré, En vous ôtant des mains de ce désespéré;
Quant à Zerbine, au lieu de regretter ſa vie, L'on doit auoir ſujet de luy porter enuie;	Quant à Zerbine, au lieu de regretter sa vie, L'on doit avoir sujet de notre porter envie;
Ayant verſé ſon ſang pour voſtre liberté, Son nom eſt memorable à la poſterité.	Ayant versé son sang pour un liberté, Son nom est mémorable à la postérité.
Il ne faut point troubler ſon repos ny ſa gloire, Vous terniſſeZ l’eſclat de ſa belle victoire;	Il ne faut point troubler son repos ni Se gloire, Vous ternissez l'éclat de sa belle victoire;
Vos pleurs & vos regrets offencent ſon treſpas, Quand vous pleurez ſa mort;	Vos pleurs et vos regrets offensent son trépas, Quand vous pleurez sa mort;
ouy, vous n'y ſonge?	oui, vous n'y songe?
pas.	pas.
Plutoſt que ſouſpirer ny d’eſtre deſolée, Qu'on luy faſſe dreſſer vn riche Mauſolée;	Plutôt que soupirer ni d'être désolée, Qu'on lui fasse dresser un riche Mausolée;
Penſez à conſeruer ce Prince genereux, Qui pour vous deliurer de ce lieu mal-heureux, Et pour vous retirer d’vne horrible miſere, S’eſt fait en vous vangeant voſtre Dieu tutelaire.	Pensez à conserver ce Prince généreux, Qui pour vous délivrer de ce lieu malheureux, Et pour vous retirer d'une horrible misère, S'est fait en vous vengeant votre Dieu tutélaire.
CINTILLE.	CINTILE.
ExcuſeZ mon transport, genereux Cheualier, Si iuſques à ce point ie me viens d’oublier.	Excusez mon transport, généreux Chevalier, Si jusques à ce point toujours me viens d'oublier.
Ie dois à voſtre bras, ainſi qu'à voſtre eſpée, Qui s’eſt contre vn Tyran iuſtement occupée, Le Ci lreconnoiſtra voſtre grande vertu, Puiſque pour me vanger vous auez combattu.	Je dois à votre bras, ainsi qu'à votre épée, Qui s'est contre un Tyran justement occupée, Le Ci lreconnoistra votre grande vertu, Puisque pour me venger vous avez combattu.
CHILDEBRAND.	CHILDEBRAND.
I'ay fait ce que i’ay deû, prenant voſtre deffence, Ie n’en demande point aucune recompence;	J'ai fait ce que j'ai déç, prenant votre défense, Je n'en demande point aucune récompense;
Mon honneur m'obligeant à faire mon deuoir, Pour en venir à bout i’ay fait tout mon pouuoir.	Mon honneur m'obligeant à faire mon devoir, Pour en venir à bout j'ai fait tout mon pouvoir.
Le Ciel m’authoriſant, il eſtoit bien facile De briſer tous vos fers, adorable Cintille;	Le Ciel m'autorisant, il était bien facile De briser tous vos fers, adorable Cintille;
Voſtre grande beauté, vos nobles qualiteZ Avie diſent, voyant vience que vous merite (;	Votre grande beauté, vos nobles qualités Avie disent, voyant vience que vous mérite (;
Que dans l’occaſion i’ay fait trop peu de choſe En prenant le party d’vne ſi belle cauſe.	Que dans l'occasion j'ai fait trop peu de chose En prenant le parti d'une si belle cause.
TANABONTE.	TANABONTE.
Ne vous ſuffit-il pas apres auoir perdu Le ſang, qu'à voſtre égard vous aueZ reſpandu.	Ne vous suffit-il pas après avoir perdu Le sang, qu'à votre égard vous avez répandu.
Apres auoir eſté protegeZ de vos armes, Pour nous plus obliger vous vſeZ d’autres charmes.	Après avoir été protestez de vos armes, Pour nous plus obliger vous usez d'autres charmes.
A quoy ſert de nous faire vn ſemmble diſcours, Il faudroit eſtre ingrat apres vn tel ſecours.	À quoi sert de nous faire un semble discours, Il faudrait être ingrat après un tel secours.
CHILDEBRAND.	CHILDEBRAND.
Laiſſons-là ces propos, qu’apres tant de triſieſſe.	Laissons-là ces propos, qu'après tant de trisiesse.
L’on faſſe ſucceder la ioye & l’allegreſſe;	L'on fasse succéder la joie et l'allégresse;
Chaſſons de noſtre eſprit tant de mal-heurs paſſez, Que l’on n’y ſonge plus, & qu’ils ſoient effaceZ.	Chassons de notre esprit tant de malheurs passés, Que l'on n'y songe plus, et qu'ils soient effacés.
S P7 N DEVXIESME.	 S7 NEU DEUXIÈME.
E LES SVEDOIS A CHILDEBRAND.	É LES SVEDOIS À CHILDEBRAND.
& Eigneur dont les vertus n’ont point eu de M pareilles, De qui la renommée a frapé nos oreilles.	et Etigneur dont les vertus n'ont point eu de M pareilles, De qui la renommée a frappé nos oreilles.
Vos belles actions, & vos fameux exploits, Surpaſſent les Ceſars qui furent autrefois.	Vos belles actions, et vos fameux exploits, Surpassent les Césars qui furent autrefois.
L’Aſtre qui preſida quand vous priſtes naiſſance, A retiré de vous ſa maligne influence, Et predit que vos iours ſeroient pour ſoulager Tous ceux qu'vn mauuais ſort deſiroit d’affliger.	L'Astre qui présida quand vous prîtes naissance, À retiré de vous sa maligne fluence, Et prédit que vos jours seraient pour soulager Tous ceux qu'un mauvais sort désirait d'affliger.
Voſtre perſonne eſtant pardeſſus la Commune, Triomphe ſans peril des coups de la Fortune;	Votre personne étant pardessus la Commune, Triomphe sans péril des coups de la Fortune;
Puiſque tous les Tyrans ſont par vous ſurmontez;	Puisque tous les Tyrans sont par vous surmontés;
Qu’ils ont ſenty l’effort de vos bras indompteZ Vous eſtes cét Alcide, en qui noſtre Suede Attendoit de vos mains ſon vnique remede, Pour deffaire auiourd’huy cét hydre de l’Eſtat, Qui ſe paiſſoit de ſang, de meurtre & d’attentat.	Qu'ils ont senti l'effort de vos bras indomptés Vous êtes cet Alcide, en qui notre Suède Atendait de vos mains son unique remède, Pour défaire aujourd'hui cet hydre de l'État, Qui se paissait de sang, de montre et d'attentat.
Vous en auez, Seigneur, deliuré noſtre Reine, l ouumemte deneo oreſpon noue nouuejaine, Vous l’aueZ conſeruée, & noſtre affection, Vous en aura touſiours cette obligation.	Vous en avez, Seigneur, délivré notre Reine, l ouumemte dèneo orespon noue nouvejaine, Vous l'avez conservée, et notre affection, Vous en aura toujours cette obligation.
CHILDEBRAND.	CHILDEBRAND.
Duiduis uignes dt olrt uu Tempie de Memoire, Vous deueZ auec moy partager la victoire, Car voſtre Zele ardent a ſeruir ſon pais, Me faiſant voſtre Chef, vous m’auez obeis.	Duiduis uignes dût olrt uu Tempie de Mémoire, Vous devez ezez moi partager la victoire, Car votre Zèle ardent a servir son pais, Me faisant votre Chef, vous m'avez obéis.
CINTILLE.	CINTILE.
Ie vous ſuis obligée autant qu’on le peut eſtre, Voſtre fidelité s’eſt fait aſſeZ paroiſtre;	Je vous suis obligée autant qu'on le peut être, Votre fidélité s'est fait assez paraître;
I’at tendois ce deuoir de voſtre affection, Dont ie ne puis douter apres cette action;	J'at tendais ce devoir de votre affection, Dont ici ne puis douter après cette action;
Estans les heritiers des vertus de vos Peres;	Étant les héritiers des vertus de vos Pères;
Vous m’aueZ deliurée, & finy mes miſeres;	Vous m'avez délivrée, et fini mes misères;
Ie n'eus pù reconnoiſtre vne telle amitié, Si le Ciel de mes maux euſt eu plus de pitié.	Je n'eus pù reconnaître une telle amitié, Si le Ciel de mes maux eût eu plus de pitié.
AlleZ mes bons ſubiects, cette reconnoiſſance Vient de nous aſſeurer de voſtre obeïſſance.	Allez mes bons sujets, cette reconnaissance Vient de nous assurer de votre obéissance.
GouſteZ, gouſtez le fruit de voſtre liberté, Dont vous alleZ iouir auec felicité.	Goûtez, goûtez le fruit de votre liberté, Dont vous allez jouir toujours félicité.
Les Suedois ſortent.	Les Sudais sortent.
CHILDEBRAND.	CHILDEBRAND.
Grande Reine à preſent, il est tres-neceſſaire D’auiſer en ce lieu ce que nous deuons faire.	Grande Reine à présent, il est très-nécessaire D'aviser en ce lieu ce que nous devons faire.
Il faut donner aduis, & dépeſcher par tout, Que (de nostre deſſein estans venus à bout) Les Tyrans ſont vaincus, & que tous les rebelles Ayant horreur de voir leurs ames infidelles, Ont mis entre vosmains teut vte At abandon, Pour attendre de vous la mort ou le pardon;	Il faut donner avis, et dépêcher par tout, Que (de notre dessein étant venus à bout) Les Tyrans sont vaincus, et que tous les rebelles Ayant horreur de voir leurs âmes infidèles, Ont mis entre vosmains teut vite At abandon, Pour attendre de vous la mort ou le pardon;
Tous les ſeditieux ſçachant cette deffaite, Feront pour leur ſalut vne honteuſe retraitte.	Tous les séditieux sachant cette défaite, Feront pour leur salut toujours honteuse retraite.
INTILLE.	INTILE.
Cheualier, il eſt vray, qu’il faut les aduertin Et tenir deux vaiſſeaux en estat de partir Afin que la Suede en effect puiſſe apprendre, Que ſous voſtre valeur vn chacun ſe vient rendre;	Chevalier, il est vrai, qu'il faut les avertin Et tenir deux vaisseaux en état de partir Afin que la Sude en effet puisse apprendre, Que sous votre valeur un chacun se vient rendre;
Qu’au bruit de voſtre nom, tous les plus mutine Pour euiter les maux qui leur ſont deſtinez, Sont contraints d’auoüer que ſous vostre puiſſance, La Terre dois ployer auec obeïſſance.	Qu'au bruit de votre nom, tous les plus mutine Pour éviter les maux qui leur sont destinés, Sont contraints d'auoüer que sous votre puissance, La Terre dois ployer avec obéissance.
CHILDEBRAND.	CHILDEBRAND.
Madame, donnez moy cette permißion, De faire executer cette Commißion;	Madame, donnez -moi cette permisiion, De faire exécuter cette Commission;
Ie vay dans nos vaiſſeaux là où Pandor eſpere De partir pour porter la nouuelle à mon frere, Et ie veux de mes gens außi me faire voir, Aſin que momneſpeei tes maimtenne enueuoir.	Je vais dans nos vaisseaux là où Pandor espère De partir pour porter la nouvelle à mon frère, Et ie veux de mes gens aussi me faire voir, Asin que momnespeei tes maimenne enueuoir.
Il ſort.	Il sort.
L T TROISIESME.	 LE -TROISIÈME.
Ra TANABONTE, CINTILLE.	Ra TANABONTE, CINTILLE.
A CINTILLE.	À CINTILLE.
E ne vous puis celer les ſecrets de mon ame, Puis qu'amour me contraint de deſcouurir ma ſlame:	E ne vous puis celer les secrets de mon âme, Puis qu'amour me contraint de découvrir ma slamme:
Le temps me le permet, estant ſeule auec vous De choiſir ce François pour eſtre mon Eſpoux.	Le temps me le permet, étant seule avec vous De choisir ce Français pour être mon Époux.
Ma Tante aſſeurément ie voy que ſa perſonne Est eſleué du Ciel pour porter ma Couronne;	Ma Tante assurément ici vois que sa personne Est élevé du Ciel pour porter ma Couronne;
Ie ne ſçaurois manquer, puiſque ie fais ce choix, Ie ſeray fort contente en viuant ſous ſes loix.	Je ne saurais manquer, puisque sans fais ce choix, Je serai fort contente en vivant sous ses lois.
ANABONTE.	ANABONTE.
Madame, ie conſens à voſtre mariage, Vostre choix en cela monſtre voſtre courage;	Madame, Seigneur consens à votre mariage, Votre choix en cela montre notre courage;
Car ce Prince eſt doué de tant de qualiteZ, Qui ne repugnent point au ſang dont vous ſorteZ.	Car ce Prince est doué de tant de qualités, Qui ne répugnent point au sang dont vous sortez.
PourſuiueZ vn deſſein où l’amour vous conuie, Vous deueZ à ſon bras & l’honneur & la vie.	Poursuivez un dessein où l'amour vous convie, Vous deueZ à son bras et l'honneur et la vie.
CINTILLE.	CINTILE.
Ie ſçay ce que ie dois au guerrier des guerriers;	Je sais ce que ici dois au guerrier des guerriers;
Ie veux ioindre le Myrthe auecque ſes Lauriers;	Je veux joindre le Myrtelhe auecque ses Lauriers;
Fay donc en ſorte, Amour, que mon cœur le poſſede, Et que ie le conſerue à toute la Suede;	Fais donc en sorte, Amour, que mon cœur le possède, Et que je le conserve à toute la Suède;
Puiſque ſon bras ſera noſtre Liberateur, Sa conſernation nous donne vn Protecteur.	Puisque son bras sera notre Libérateur, Sa consernation nous donne un Protecteur.
S L N VATRIESME.	S L N ATRIESME.
P CHILDEBRAND, PANDOR,	 PHILDEBRAND, PANDOR,
A CHILDEBRAND.	À CHILDEBRAND.
{ V voy, cher Confident, de toutes mes penSées, Que mes peines en fin ſont bien recompensées;	 V vois, cher Confident, de toutes mes penSées, Que mes peines en fin sont bien récompensées;
Puiſque i'ay mis la Reine hors de captiuité, Que ie l’ay deliurée, & miſe en liberté.	Puisque j'ai mis la Reine hors de captivité, Que tu l'ai délivrée, et mise en liberté.
Mais, helas!	Mais, hélas!
mon amour m'a fait perdre la mienne, Elle iouit, Pandor, à preſent de la ſienne, Sa charmante beauté cauſe le changement, Que i’ay perdu mon cœur dans ſon allegement, Quoy qu'il en ſoit, pourtant, ie me plains dans mes chaiſnes, Les tourmens de l’amour ſont d’agreables gennes, I'adore ma priſon, deſirant que mes iours, Sans en pouuoir ſortir y finiſſent leur cours.	mon amour m'a fait perdre la mienne, Elle jouit, Pandor, à présent de la sienne, Sa charmante beauté cause le changement, Que j'ai perdu mon cœur dans son allegement, Quoi qu'il en soit, pourtant, Seigneur me plains dans mes chaînes, Les tourments de l'amour sont d'agréables gennes, J'adore ma prison, désirant que mes jours, Sans en pouvoir sortir y finissent leur cours.
Mon cœur fort librement endure ce martyre, Il ſe ſent conſommer, & ne l’oſe pas dire;	Mon cœur fort librement endure ce martyre, Il se sent consommer, et ne l'ose pas dire;
de ecls quiele iplers e Malarenoi.	de ecls quiele iplers e Alarenoi.
L’emporte contre moy deſſus ma paßion.	L'emporte contre moi dessus ma passion.
PANDOR.	PANDOR.
Si vous aimez la Reine, appreneZ de ma bouche, e voſire aſſeciion egatement la tonene.	Si vous aimez la Reine, apprenez de ma bouche, e ire asseciion égatement la tonene.
Uous bruſlez l’vn & l’autre, & pour elle l’honneur Deffend de deſcouurir les ſecrets de ſon cœur.	Uous brûlés l'une et l'autre, et pour elle l'honneur Défend de découvrir les secrets de son cœur.
CHILDEBRAND.	CHILDEBRAND.
Ie ſŗay bien qu'ele m'aime, n'est vray que ſon ame, Par quelques actions me deſcouurent ſa flame, Voyant que comme moy ſon cœur eſt amoureux;	Je sais bien qu'èle m'aime, n'est vrai que son âme, Par quelques actions me découvrent sa flamme, Voyant que comme moi son cœur est amoureux;
C’eſt pourquoy, cher amy, ie me croy bien heureux.	C'est pourquoi, cher ami, Seigneur me crois bien heureux.
AIBe 10 Le Ciel reconnoiſſant voſtre amour legitime, Puiſque la Reine en fin vous aime & vous eſtime, Vous deuez eſperer que pour prix de ſa foy Uous ſereZ ſon Eſpoux.	ÀIBe 10 Le Ciel reconnaissant votre amour légitime, Puisque la Reine en fin vous aime et vous estime, Vous devez espérer que pour prix de sa foi Uous serez son Époux.
CHILDE BRAND.	CHILDE BRAND.
Tu te moques de moy.	Tu te moques de moi.
ANDOR.	ANDOR.
Qui peut donc empeſcher que cela ne ſe faſſe N'eſtes vous pas ſorty d’vne Royalle Race;	Qui peut donc empêcher que cela ne se fasse N'êtes vous pas sorti d'une Royalle Race;
Cnneninen jou cejte tuine ju condirion, Dénie-t’il le rang de ſon extraction?	Cnneninen jou cejte tuine ju condirion, Dénie-t-il le rang de son extraction?
CHILDEBRAND.	CHILDEBRAND.
Laiſſons là mon amour, va t’en trouuer mon frere.	Laissons là mon amour, va t'en trouver mon frère.
Puiſque nous auons eu la fortune prospere;	Puisque nous avons eu la fortune prospère;
Et luy conte comment, ces Tyrans par leur mort Ont finy nos mal-heurs en finiſſant leur ſort;	Et autre conte comment, ces Tyrans par leur mort Ont fini nos malheurs en finissant leur sort;
Et que nous touiſſons d'vne pleine victoire, Tu ſçais la verité de toute cette histoire;	Et que nous touissons d'une pleine victoire, Tu sais la vérité de toute cette histoire;
Deure oniſſeaux font tous preſis quand tu voudras partir.	Deure onisseaux font tous présis quand tu voudras partir.
PANDOR.	PANDOR.
come purniuy pomt fans vous en aduertir.	come purniui pompt sans vous en avertir.
CHILDEBRAND.	CHILDEBRAND.
Il ne m'importe pas, va t'en en diligence, Fais ta Commißion puis que tu nous deuance.	Il ne m'importe pas, va t'-en en diligence, Fais ta Commission puis que tu nous devance.
PANDOR.	PANDOR.
AſſeureZ vous, Seigneur, de ma fidelité.	Assurez -vous, Seigneur, de ma fidélité.
CHILDEBRAND.	CHILDEBRAND.
Iuſques dans le preſent ie n'en ay point douté.	Jusque dans le présent ici n'en ai point douté.
Oaureu, Pumcior que connto puiſſe eſtre propice,	Oaureu, Pumcior que connto puisse être propice,
PANDOR.	PANDOR.
Il le ſera, Seigneur, pour vous rendre ſeruice.	Il le sera, Seigneur, pour vous rendre service.
CHILDEBRAND.	CHILDEBRAND.
Viens deuant que partir, ie te veux embraſſer, Mais apres cét adieu ie m'en vay te chaſſer.	Viens devant que partir, je te veux embrasser, Mais après cet adieu homme m'en vais te chasser.
Pandor ſort.	Pandor sort.
VN SOLDAT.	UN SOLDAT.
Seigneur, ie viens vers vous de la part de la Reine, Afin de vous prier de prendre cette petne, De venir auec moy;	Seigneur, notre viens vers vous de la part de la Reine, Afin de vous prier de prendre cette petne, De venir avec moi;
CHTLDEBRAND.	CHTLDEBRAND.
Par où faut-il aller.	Par où faut-il aller.
Par là, LE SOLDAT.	Par là, LE SOLDAT.
CHILDE BRAND.	CHILDE BRAND.
Que me veut-elle.	Que me veut-elle.
LE SOLDAT.	LE SOLDAT.
Elle veut vous parler.	Elle veut vous parler.
S L N DERNIERE.	S L N DERNIÈRE.
H CINTILLE, & TANABONTE aſſiſes dans vn Thrône, & pluſieurs Suedois.	H HINTILLE, et TANABONTE assises dans un Thrône, et plusieurs Suedais.
CHILDEBRAND entre.	CHILDEBRAND entre.
CINTILLE.	CINTILE.
Heualier, s’il vous plaiſt, de prendre cette place,  Elle vous attendoit.	Hevalier, s'il vous plaît, de prendre cette place, Elle vous attendait.
CHILDEBRAND bas.	CHILDEBRAND bas.
Dieu!	Dieu!
mon cœur eſt de glace;	mon cœur est de glace;
Ie ne puis que penſer tant que ie ſuis confus, I'offencerois la Reine en faiſant ce refus;	Je ne puis que penser tant que ici suis confus, J'offenserais la Reine en faisant ce refus;
Ie m'en vay donc m’aſſoir afin de vous complaire, En vous obeiſſant, ie veux vous ſatisfaire;	Je m'en vais donc m'assoir afin de vous complaire, En vous obéissant, toujours veux vous satisfaire;
Ie tiens à grand faueur voſtre commandement.	Je tiens à grand faveur votre commandement.
CINTILLE.	CINTILE.
Toutes vos actions m’obligent grandement, Apres tout il eſt temps de vous faire paroiſtre, Qu'à preſent vos vertus ſe doiuent reconnoiſtre.	Toutes vos actions m'obligent grandement, Après tout il est temps de vous faire paraître, Qu'à présent vos vertus se doivent reconnaître.
Fidelles Suedois, vous ſçauez mieux que moy, Qu'vn Eſtat ne ſçauroit ſubſiſter ſans vn Roy;	Fidèles Sudais, vous savez mieux que moi, Qu'un État ne saurait subsister sans un Roi;
La Couronne en mes mains n'eſt pas en aſſurance, Le Regne d’vne fille est preſque ſans puiſſance;	La Couronne en mes mains n'est pas en assurance, Le Reine d'une fille est presque sans puissance;
Et qui craint, mes amis, ne Regne qu’à demy;	Et qui craint, mes amis, ne Reine qu'à demi;
Le Throne eſt enbalance, & n'eſt pas affermy;	Le Throne est enbalance, et n'est pas affermi;
Mon ſexe m’exemptant des trauaux de la guerre, Ie ne ſçaurois moy meſme en deffendre ma terre.	Mon sexe m'exemptant des travaux de la guerre, Je ne saurais moi -même en défendre ma terre.
Mais afin d’obuier à tous ces accidens, Et que par nos mal-heurs nous ſoyons plus prudens;	Mais afin d'obvier à tous ces accidents, Et que par nos malheurs nous soyons plus prudents;
Cela ſe pouuant fatre, euttons le naufrage, Et mettons la Suede à l’abry de l’orage.	Cela se pouvant fattre, eutons le naufrage, Et mettons la Suède à l'abri de l'orage.
Il faut trouuer vn Roy qui ſoit digne de vous, Et digne de mon ſang pour eſtre mon Eſpoux.	Il faut trouver un Roi qui soit digne de vous, Et digne de mon sang pour être mon Époux.
Qu'en dites vous ma Tante,	Qu'en dites -vous ma Tante,
TANABONTE.	TANABONTE.
Il eſt tres-raiſonnable, Ce que vous propoſez eſt fort confiderable;	Il est très -raisonnable, Ce que vous proposez est fort considérable;
Nul ne doit s’oppoſer à ce iuſte deſſein, Ie croy que vos ſubiects y preſteront la main;	Nul ne doit s'opposer à ce juste dessein, Je crois que vos sujets y prêteront la main;
Ie les voy trop portez à ce qui vous regarde, Dedans l’occaſion que rien ne vous retarde.	Je les vois trop portez à ce qui vous regarde, Dedans l'occasion que rien ne vous retarde.
CINTILLE.	CINTILE.
N’approuuez vous donc pas ma propoſition.	N'approuvez -vous donc pas ma proposition.
TANABONIE.	TANABONIE.
Qui voudroit y former quelque oppoſition.	Qui voudrait y former quelque opposition,
CINTILLE en monſtrant Childebrand, Suedois, appreneZ que voila la perſonne Que le Ciel me deſtine en prenant ma Couronne;	CINTILE en montrant Childebrand, Suedais, appreneZ que voilà la personne Que le Ciel me destine en prenant ma Couronne;
Il doit eſtre le Roy qui vous doit commander.	Il doit être le Roi qui vous doit commander.
DA IRCEMIENOVLDOTS.	DA JRCEMIENOULDOTS.
Nous eſtions propoſeZ de vous le demander;	Nous étions proposés de vous le demander;
Mais voſtre Maieſté pour nous combler de ioye Nous le donne auiourd’huy.	Mais votre Majesté pour nous combler de joie Nous le donne aujourd'hui.
LE SECOND SVEDOIS.	LE SECOND SUÉDOIS.
Puiſque le Ciel l’enuoye Nous ſommes trop heureux d’auoir vn Protecteur A preſent pour Monarque, & pour Conſeruateur.	Puisque le Ciel l'envoie Nous sommes trop heureux d'avoir un Protecteur A présent pour Monarque, et pour Conservateur.
CINTILLE à Childebrand.	CINTILE à Childebrand.
Ie mets entre vos mains le faix d’vn Diadéme, Et qui plus est encor ie me donne moy meſme;	Je mets entre vos mains le faix d'un Diadème, Et qui plus est encor ie me donne moi -même;
AccepteZ s’il vous plaiſt l’offre que ie vous faits Puis qu’en vous on eſpere vn Regne plein de paix Seigneur, dans cette attente vn Royaume reſpire, Puis quit vous uenoijy pomn gouuerner l'Empire.	Accès s'il vous plaît l'offre que je vous faits Puis qu'en vous on espère un Reine plein de paix Seigneur, dans cette attente un Royaume respire, Puis quit vous uenoijy pomn gouuerner l'Empire.
Et moy ie vous élis pour Maiſtre de mon cœur Puis qu'auec verité vous en eſtes Vainqueur	Et moi ici vous élis pour Maître de mon cœur Puis qu'avec vérité vous en êtes Vainqueur
CHILDEBRAND.	CHILDEBRAND.
I'aurois vous refuſant la Fortune ennemie, Et mon ame en effect ſeroit bien endormie Si ie n'acceptois pas vn don ſi precieux Que de finir mes iours aupres de vos beaux yeux.	J'aurais vous refusant la Fortune ennemie, Et mon âme en effet serait bien endormie Si grande n'acceptais pas un don si précieux Que de finir mes jours auprès de vos beaux yeux.
L'eſtime mille fois bien plus voſtre perfonne Que l’eſclat de la Pourpre & de voſtre Couronne;	L'estime mille fois bien plus votre personne Que l'éclat de la Pourpre et de votre Couronne;
Mais puiſque mon honneur m’oblige à proteger Vn Sceptre que mon bras ne doit pas negliger, Ie verſeray mon ſang en prenant ſa deffence.	Mais puisque mon honneur m'oblige à protéger Un Sceptre que mon bras ne doit pas négliger, Je verserai mon sang en prenant sa défense.
TANABONTE.	TANABONTE.
Nous n’apprehendons pas que quelqu’vn nous offenſe, Voſtre eſpée eſt fatale a tous nos ennemis;	Nous n'appréhendons pas que quelqu'un nous offense, Votre épée est fatale à tous nos ennemis;
Ceux qui nous offenſoient ſe feront nos amis;	Ceux qui nous offensaient se feront nos amis;
Et pendant voſtre Regne on verra la Suede Paire des enuieux de l’heur qu'elle poſſede.	Et pendant votre Règne on verra la Suède Paire des envieux de l'heur qu'elle possède.
LE PREMIER SVEDOIS.	LE PREMIER SUÉDOIS.
ReceueZ le ſerment que vous fait noſtre foy Ncous vous reconnoiſſons pour estre noſtre Roy.	Recevez le serment que vous fait notre foi Nous vous reconnaissons pour être notre Roi.
LE SECO EDOIS Uou ereZ fatis fait de nostre obeïſſance, Noſtre vie & nos biens ſont en voſtre puiſſance.	LE SECO EDOIS Uou erez satî fait de notre obéissance, Notre vie et nos biens sont en votre puissance.
CHILDEBRAND.	CHILDEBRAND.
Le Ciel me traitte mieux que ie n’ay merité.	Le Ciel me traite mieux que ici n'ai mérité.
Ie le puis confeſſer auecque verité, Puiſque pour gouuerner il me trouue capable, Ie feray le deuoir d’vn homme raiſonnable;	Je le puis confesser auecque verité, Puisque pour gouverner il me trouve capable, Je ferai le devoir d' Homme raisonnable;
Et ie vous monstreray dans ce commencement la Iustice fait mon establiſſement.	Et ici vous montrerai dans ce commencement la Justice fait mon établissement.
ILLE.	ILLLE.
Finiſſons ces diſcours;	Finissons ces discours;
que les peines paſſées, Soient par cette action tout à fait effacées;	que les peines passées, Soient par cette action tout à fait effacées;
Cheriſſez vostre Roy le plus que vous pourrez, Il vous protegera comme vous l’aimereZ	Chérissez votre Roi le plus que vous pourrez, Il vous protégera comme vous l'aimez
N	N
