JESUS, MARIA.	JESUS, MARIA.
SAINT HERMENEGILDE ANMOEDIE.	SAINT HÉRMENEGILDE ANMOEDIE.
ACTE PREMIER.	ACTE PREMIER.
SCENE FREMIERE.	SCÈNE FREMIÈRE.
HERMENEGILDE, ERASISTRATE.	HÉRMENEGILDE, ERASISTRATE.
Hermenegilde.	Hermènegilde.
Deplorable ſort!	Déplorable sort!
ô funeſte avanture!	ô funeste aventure!
Tout eſt affreux pour nous dans cette conjoncture, Tu vois dans quel état mon pere me ſurprend;	Tout est affreux pour nous dans cette conjoncture, Tu vois dans quel état mon père me surprend;
Je peux lui reſiſter, mais Dieu me le défend :	Je peux lui résister, mais Dieu me le défend :
rous mes ſens ſont troubles, les paſſions m’agitent;	rous mes sens sont troubles, les passions m'agitent;
Tu ſçais mes ennemis les deſſeins qu’ils meditent, Ils portent leur fureur juſqu’au dernier excez:	Tu sais mes ennemis les desseins qu'ils méditent, Ils portent leur fureur jusqu'au dernier excès:
Il faut vaincre ou perir, douteux eſt le ſuccez;	Il faut vaincre ou périr, douteux est le succès;
i’ai pour les terraſſer des forces ſuffiſantes, Et déja je crois voir mes troupes triomphantes.	j'ai pour les terrasser des forces suffisantes, Et déjà je crois voir mes troupes triomphantes.
Mais enfin il vaut mieux, pour ſoûtenir mon rang, Mourir dans le devoir, que de verſer du ſang :	Mais enfin il vaut mieux, pour soutenir mon rang, Mourir dans le devoir, que de verser du sang :
Le Roy peut s’avaucer, s’il veut m’ôter la vie, que ſa rage en ce jour contente ſon envie:	Le Roi peut s'aucer, s'il veut m'ôter la vie, que sa rage en ce jour contente son envie:
C’eſt à mon innocence un avantageux ſort, Que de gagner le Ciel par une heureuſe mort?	C'est à mon innocence un avantageux sort, Que de gagner le Ciel par une heureuse mort?
Dans le ſecours divin je mets toute ma gloire.	Dans le secours divin je mets toute ma gloire.
A ij Je veux prendre ſur moi cette ſainte victoire;	À ij à veux prendre sur moi cette sainte victoire;
Mais ſi pour decouvrir ſes injuſtes projets, qui vont de tant de maux accabler mes Sujets, Je tentois le moyen d’aller trouver mon pere, Et de lon ceul aigil d'apuierla coicre;	Mais si pour découvrir ses injustes projets, qui vont de tant de maux accabler mes Sujets, Je tentais le moyen d'aller trouver mon père, Et de lon ceul aigil d'appuierla coicre;
Dis-moi ſur ce deſſein quel eſt ton ſentiment?	Dis-moi sur ce dessein quel est ton sentiment?
Eraſiſtrate.	Erasistrate.
Ah!	Ah!
Prince, vos malheurs me touchent vivement;	Prince, vos malheurs me touchent vivement;
Et dans le ſeul recit que vous venez de faire, Mon cœur ſaiſi d’effroy ne peut vous ſatisſaire;	Et dans le seul récit que vous venez de faire, Mon cœur saisi d'effroi ne peut vous satissaire;
Il ne me permet pas d’en parler avec vous;	Il ne me permet pas d'en parler avec vous;
Mais de pleurer les maux qui vont tomber ſur mous:	Mais de pleurer les maux qui vont tomber sur mous:
Je le dois cependant, ſçachant vôtre innocence, Victime de l’envie & de la médiſance;	Je le dois cependant, sachant votre innocence, Victime de l'envie et de la médisance;
Elle eſt par la fureur expoſé à leurs traits, On vous dépeint au Roy ſous de malins portraits, Que pourroit taporter ces noires calomnies?	Elle est par la fureur exposé à leurs traits, On vous dépeint au Roi sous de malins portraits, Que pourrait taporter ces noires calomnies?
Et pouvez-vous les voir demeurer impunies?	Et pouvez-vous les voir demeurer impunies?
Ah:	Ah:
grand Prince, il’raudroit prevemir les farfieurs Qui vous feroient ſentir de plus vives douleurs.	grand Prince, il'raudrait prévémir les farfieurs Qui vous feraient sentir de plus vives douleurs.
He rme negilde.	He rame négilde.
Ton conſeil eſt ſenſé;	Ton conseil est sensé;
mais puis-je bien le ſuivre?	mais puis-je bien le suivre?
Eraſiſtrate.	Erasistrate.
Ah!	Ah!
grand Disu, quel deſtin où vôtre foy vous livre?	grand Disu, quel destin où votre foi vous livre?
Vous voulez donc, Seigneur, deſarmer vos Soldats, Vous rendre auprés du Roy, vous mettre entre ſes bras, Sans nul autre ſecours que de votre innocence, Lui marquer vos reſpects & vôtre confiance?	Vous voulez donc, Seigneur, désarmer vos Soldats, Vous rendre auprès du Roi, vous mettre entre ses bras, Sans nul autre secours que de votre innocence, Lui marquer vos respects et votre confiance?
Vôtre innocence a droit de mépriſer les coups;	Votre innocence a droit de mépriser les coups;
Et de ne craindre rien des Ennemis jaloux:	Et de ne craindre rien des Ennemis jaloux:
Mais, hélas!	Mais, hélas!
je prévois.	je prévois.
Hermenegilde.	Hermènegilde.
Hé quoi!	Hé quoi!
que veux-tu dire?	que veux-tu dire?
Eraſiſtrate.	Erasistrate.
qu’il ne vous en arrive autre choſe de pire, C'eſt vous aller jetter dans le piege tendu, Et donner plus au Roy qu’il n’avoit pretendu.	qu'il ne vous en arrive autre chose de pire, C'est vous aller jeter dans le piège tendu, Et donner plus au Roi qu'il n'avait prétendu.
Plût à Dieu qu’il vous fut comme à nous favorable Il le devroit hélas!	Plût à Dieu qu'il vous fut comme à nous favorable Il le devrait hélas!
il ſeroit équitable;	il serait équitable;
Mais ne l’eſperez pas d’un Prince ambitieux.	Mais ne l'espérez pas d'un Prince ambitieux.
Tragedie.	Tragédie.
D’un Vainqueur inſolent, cruel, audacieux:	D'un Vainqueur insolent, cruel, audacieux:
quand en faveur du ſang qui coule dans vos veines, S’adouciſſant pour vous, il finiroit vos peines;	quand en faveur du sang qui coule dans vos veines, S'adoucissant pour vous, il finirait vos peines;
Et qu’agréant enfin vôtre ſoûmiſſion, Il vous confirmeroit dans la poſſeſſion Du droit que vous avez d’hériter ſa Couronne, Il entend contre vous les avis qu’on lui donné.	Et qu'agréant enfin votre soumission, Il vous confirmerait dans la possession Du droit que vous avez d'hériter sa Couronne, Il entend contre vous les avis qu'on lui donné.
Qui toûjours à tel point allument ſon courroux, Qu’il ne peut moderer ſa fureur contre vous;	Qui toujours à tel point allument son courroux, Qu'il ne peut modérer sa fureur contre vous;
Les faux raports ſur tout de vôtre belle-mere Etouffent dant ioncuur les tendreſſes d’un pere.	Les faux rapports sur tout de votre belle-mère Étouffent dant ioncuur les tendresses d'un père.
He rmenegilde.	He rmènegilde.
Hé!	Hé!
que dit-elle enfin?	que dit-elle enfin?
Eraſiſtrate.	Erasistrate.
Vos ennemis, Seigneur, Vous font paiſer au Roy pour un Empoiſonneur, Violateur des Loix, un Lraitre, un Homicide, Et que vous meditez de faire un patricide:	Vos ennemis, Seigneur, Vous font paiser au Roi pour un Empoisonneur, Violateur des Lois, un Lraitre, un Homicide, Et que vous méditez de faire un patricide:
Il les croit, il a dit ſans ambiguité, que les Soldats levés par vôtre autorité, Pour mettre en ſûreté vôtre propre perſonne, C’étoit pour lui ravir ſoi sceptie & ia Couronne.	Il les croit, il a dit sans ambiguité, que les Soldats levés par votre autorité, Pour mettre en sûreté votre propre personne, C'était pour lui ravir soi sceptie et ja Couronne.
La paſſion le jette en ſi grande fureur, que pour perure ion ſang il paroit ſans horreur, Et que ſans differer il ſouhaite lui même Executer ſur vous cette rigueur extreme.	La passion le jette en si grande fureur, que pour pure ion sang il parait sans horreur, Et que sans différer il souhaite lui même Exécuter sur vous cette rigueur extrême.
Hermenegilde.	Hermènegilde.
Mais ſon courroux peut-être à preſent a ceſſé.	Mais son courroux peut-être à présent a cessé.
Eraſiſtrate.	Erasistrate.
Aprés la vie, ô Ciel!	Après la vie, ô Ciel!
que vous a-t'il laiſſé?	que vous a-t'-il laissé?
il vous a retile ron aiour, les tendreſſes, Il vous a depoüillé de toutes vos richeſſes, Des ornemens Royaux:	il vous a retile ron aiour, les tendresses, Il vous a depoüillé de toutes vos richesses, Des ornements Royaux:
chaſſé de ſa maiſon Partout il vous pourſuit ſans fujet;	chassé de sa maison Partout il vous poursuit sans sujet;
ianis farfon;	janis farfon;
Pouvez-vous eſperer qu’il ait une autre envie, que de vous attraper, pour vous ôter la vie?	Pouvez-vous espérer qu'il ait une autre envie, que de vous attraper, pour vous ôter la vie?
Hermenegi lde.	Hermènegi lède.
Il eſt vrai;	Il est vrai;
mais peut-être en me rendant chez luj jans ſuite, ſans ſecours, ſans armes, ſans apui, la confiar ui marquant de mon cœur Lui faiſant remarquer en tout mon innocence, qu’il pourra s'adoucir, & calant ſon courroux, Beprimer les excés des ennemis jaloux.	mais peut-être en me rendant chez lujouchant suite, sans secours, sans armes, sans appui, la confiar marquant de mon cœur Lui faisant remarquer en tout mon innocence, qu'il pourra s'adoucir, et calant son courroux, Beprimer les excès des ennemis jaloux.
Fraſiſtrate.	Frastrate.
Vous vous flatez, grand Prince, une telle penſée.	Vous vous flattez, grand Prince, une telle pensée.
Au goût des connoiſſeurs ne parolt pas ſenſée:	Au goût des connaisseurs ne paraît pas sensée:
Vôtre innocence a droit d’eſperer le changer;	Votre innocence a droit d'espérer le changer;
Mais c’eſt vous expoſer dans un trop grand danger, Vôtre bon naturel vous rend par trop credule, Ce Monarque irrité n’auroit pas de ſcrupule D’abuſer de l’hommage, & de la bonne foi Que vous lui marqueriez, vous mettant ſous ſa loi:	Mais c'est vous exposer dans un trop grand danger, Votre bon naturel vous rend par trop crédule, Ce Monarque irrité n'aurait pas de scrupule D'abuser de l'hommage, et de la bonne foi Que vous lui marqueriez, vous mettant sous sa lois:
Vous voyez la fureur contre vous qui l’emporte, Peut-elle devenir plus terrible & plus forte?	Vous voyez la fureur contre vous qui l'emporte, Peut-elle devenir plus terrible et plus forte?
Hermenegilde.	Hermènegilde.
quoi donc, faut-il combattre?	quoi donc, faut-il combattre?
Eraſiſtrate.	Erasistrate.
oüy ſans doute, il le faut, L’orguëil des ennemis ne peut monter plus haut, Ils ne vous ont laiſſé que le ſort de vos armes:	oui sans doute, il le faut, L'orgueil des ennemis ne peut monter plus haut, Ils ne vous ont laissé que le sort de vos armes:
Allez par la valeur leur donner des allarmes, Vôtre Armée eſt trés-belle, & vaillans vos Soldats, Je les vois animés à donner des combats.	Allez par la valeur leur donner des alarmes, Votre Armée est très-belle, et vaillants vos Soldats, Je les vois animés à donner des combats.
Il faut que par quelqu’un vôtre ſort ſe decide, Je ne vous porte pas a faire un homicide, Et je ne ſuis pas homme à vous le conſeillet;	Il faut que par quelqu'un votre sort se décide, Je ne vous porte pas a faire un homicide, Et je ne suis pas homme à vous le conseillet;
Mais pour vous conſerver ou ne peut trop veiller, Vos ennemis cruels excités par la Reine, Du Roy contre vos jours entretiennent la haine, Et pour vous perdre enfin redoublent leurs efforts:	Mais pour vous conserver ou ne peut trop veiller, Vos ennemis cruels excités par la Reine, Du Roi contre vos jours entretiennent la haine, Et pour vous perdre enfin redoublent leurs efforts:
N’attendez pas, Seigneur, qu’ils deviennent plus forts Prevenez leurs deſſeins, combattez ſans vangeance, Vôtre Armée eſt nombreuſe, el le eſt dans l’abondance?	N'attendez pas, Seigneur, qu'ils deviennent plus forts Prévenez leurs desseins, combattez sans vengeance, Votre Armée est nombreuse, elle le est dans l'abondance?
Eſperez que le Ciel, en ſeco ndant vos vœux, Vous iera remporter la victoire ſur eux.	Espérez que le Ciel, en seco nédant vos vœux, Vous jera remporter la victoire sur eux.
SCENE SECONDE.	SCÈNE SECONDE.
HERMENFGILDE, ERASISTRATE.	HÉRMENFGILDE, ERASISTRATE.
Durias.	Durias.
E viens vous annoncer que vôtre illuſtre frere, JEnvoyé de la part de vôtre auguſte pere, Demtande avec inſtance à vous entretenir.	E viens vous annoncer que votre illustre frère, JEnvoyé de la part de votre auguste père, Demtande avec instance à vous entretenir.
Hermenegilde.	Hermènegilde.
o l’heureuſe nouvelle!	ô l'heureuse nouvelle!
ah!	ah!
faites-le venir.	faites-le venir.
Le voilà,	Le voilà,
SCENE TROISIE’ME.	SCÈNE -TROISIE'ME.
1 HERMENEGHDE, RECAREDE, FRASIS TRATE	1 HÉRMENEGHDE, RECAREDE, FRASIS TRATE
Recarede.	Récarède.
20 Mon cher frere, avant que je m’explique Sur ma commiſſion ſans fard, ſans politique, je viens vous aſſûrer de la bonté du Roy:	20 Mon cher frère, avant que je m'explique Sur ma commission sans fard, sans politique, je viens vous assûrer de la bonté du Roi:
Liles vuus ieiein de mon peica de moy	Liles vus ieiein de mon péica de moi
Hermenegilde.	Hermènegilde.
Recarede, je ſuis & ſerai vôtre frere, Et non vôtre ennemi, ni celui de mon pere;	Recarede, je suis et serai votre frère, Et non votre ennemi, ni celui de mon père;
Embraſſez-moi, mon frere, en cette qualité.	Embrassez-moi, mon frère, en cette qualité.
Re tarede.	Re tarède.
que vous dirai-je, hélas!	que vous dirai-je, hélas!
dans ma perplexité?	dans ma perplexité?
Je vois mon pere armé contre mon propre frere, je vois mon frere armé contre le Roy ſon pere:	Je vois mon père armé contre mon propre frère, je vois mon frère armé contre le Roi son père:
Leur camp dans la triſteſſe & les gemiſſemens, Les rigoureux effets de leurs reſſentimens, Ce camp qui fut rempli des fruits de nos conquêtes, Qui rempor ta toûjours des victoires completes, Va donc être arroſé de nôtre propre ſang;	Leur camp dans la tristesse et les gémissements, Les rigoureux effets de leurs ressentiments, Ce camp qui fut rempli des fruits de nos conquêtes, Qui rempor ta toujours des victoires complètes, Va donc être arrosé de notre propre sang;
Mais ſi le mien, Seigneur, peut être aſſez puiſſant,	Mais si le mien, Seigneur, peut être assez puissant,
A iv Pour calmer le courroux & de l’un & de l’autre.	À j' On calmer le courroux et de l'un et de l'autre.
Je veux faire ceſſer & le ſien & le vôtre, ne je m'enmierar r'homde le plus heureux, Si je puis arrêter la colere des deux.	Je veux faire cesser et le sien et le vôtre, ne je m'enmierar rhomde le plus heureux, Si je puis arrêter la colère des deux.
Hermenegilde Je loûe avec ſujet vôtre invincibie zeie, Je ſçai que vous m’avez toûjours été fidele.	Hermènegilde Je loue avec sujet votre invincibie zeie, Je sais que vous m'avez toujours été fidèle.
Recarede.	Récarède.
Pourquoi trop écouter les conſeils imprudens, que vous ont inſpiré vos plus chers Confidens?	Pourquoi trop écouter les conseils imprudents, que vous ont inspiré vos plus chers Confidents?
Quoi!	Quoi!
faut-il meſurer mon épée à la vôtre?	faut-il mesurer mon épée à la vôtre?
Qu’on nous voye à regret être l’un contre l’autre?	Qu'on nous voit à regret être l'un contre l'autre?
Faut-il par un combat tout preſt à ſe donner, Vous vanter des affronts qu’il faudroit pardonner?	Faut-il par un combat tout prêt à se donner, Vous vanter des affronts qu'il faudrait pardonner?
Jour trop infortuné d’une ſaiſon ſi belle, Qui couvriroit de ſang l’amitié fraternelle!	Jour trop infortuné d'une saison si belle, Qui couvrirait de sang l'amitié fraternelle!
Fraſiſtrate.	Frastrate.
O le fin Orateur!	Ô le fin Orateur!
quel dilcours cioquences L'aparence en eſt belle & n’a rien de choquent, Vous l’écoutés, je croy, comme un fart grand Orachi Craignés qu’à nos deſſeins ce ne ſoit un obſtacle.	quel dilcours cioquences L'apparence en est belle et n'a rien de choquent, Vous l'écoutés, je crois, comme un fart grand Orachi Craignès qu'à nos desseins ce ne soit un obstacle.
Recarede.	Récarède.
Par ces reflexions vous nous intereſſée, Et mon cœur aujourd’huy ne peut s’en plaindre aſſez quoy!	Par ces réflexions -vous nous intéressée, Et mon cœur aujourd'hui ne peut s'en plaindre assez quoi!
nous faiſons au Ciel des vœux pour vôtre vie Nous gemiſſons des maux dont on la voit ſuivie, On voit dans la douleur & dans l’accablement, Tout le peuple afflligé de vôtre éloignement, Il vous prie inſtamment de ſoulager ſes peines, Ne l’expoſés donc pas à de plus rudes gehenes, voulés vous ruiner & perure vos bujetaoſtés de vôtre eſprit ces injuſtes projets;	nous faisons au Ciel des vœux pour votre vie Nous gémissons des maux dont on la voit suivie, On voit dans la douleur et dans l'accablement, Tout le peuple afflligé de votre éloignement, Il vous prie instamment de soulager ses peines, Ne l'exposés donc pas à de plus rudes gehenes, voulez vous ruiner et perure et bujetaostés de votre esprit ces injustes projets;
Ne les diviſés pas, vous deves les deffendre, Hé quoy!	Ne les divisez pas, vous devez les défendre, Hé quoi!
ſouffrirez vous qu’on les reduiſe en cendre, Et qu’un reſte de vie en qui vous avés part, Leur ſoit encore ôtée aprés vôtre départ?	souffrirez -vous qu'on les réduise en cendre, Et qu'un reste de vie en qui vous avez part, Leur soit encore ôtée après votre départ?
Hermenegilde.	Hermènegilde.
Je ſuis bien éloigné de commettre un tel crime	Je suis bien éloigné de commettre un tel crime
Atlarent.	Attlarent.
Ce ſera démentir vôtre cœur magnanime, Si vous executês vos deſſeins dangereux;	Ce sera démentir votre cœur magnanime, Si vous executês vos desseins dangereux;
Peuvent-ils à vos yeux paroitre plus affreux!	Peuvent-ils à vos yeux paraître plus affreux!
quel honneur de vous voir enflammé de colere, Les armes à la main combattre vôtre pere!	quel honneur de vous voir enflammé de colère, Les armes à la main combattre votre père!
Dequoy vous ſerviront vos glorieux travaux, Ceux de vos Officiers & de vos Generaux, D’être ſçavant, heureux aux exploits militaites, Sage, prudent, diſcret, verſé dans les affaires!	Dequoy vous serviront vos glorieux travaux, Ceux de vos Officiers et de vos Généraux, D'être sçavant, heureux aux exploits militaites, Sage, prudent, prudent, versé dans les affaires!
quels fruits vous preduiront toutes ces qualités, qu’à vous enfler le cœur de vos proſperités?	quels fruits vous préduiront toutes ces qualités, qu'à vous enfler le cœur de vos prospérités?
Voulés-vous vous placer au Trone de mon pere, Et l’en faire deſcendre à cauſe de ma mere?	Voulez-vous vous placer au Trone de mon père, Et l'en faire descendre à cause de ma mère?
Le mal qu’elle vous fait ſeroit-il un ſujet, D’executer ſur lui cet injuſte projet?	Le mal qu'elle vous fait serait-il un sujet, D'exécuter sur lui cet injuste projet?
Il eſt, vous le ſçavez, ſur la fin de ſa vie, Que vôtre ambition ſur luy n’ait point d’envie, Son Trône à ſon deceds vous eſt juſtement dû, De le pretendre avant, les loix l’ont deffendu, Vous avés des endroits pour briller & pour plaire.	Il est, vous le savez, sur la fin de sa vie, Que votre ambition sur cela n'ait point d'envie, Son Trône à son décéds vous est justement dû, De le prétendre avant, les lois l'ont défendu, Vous avez des endroits pour briller et pour plaire.
Chacun de vos Sujets cherche à vous ſatisfaire, N’allés donc pas remplir les annales d’un fait qui rendroit le Lecteur de vous mal ſatisfait, Et terniſſant l’éclat des actions paſſées, Lui feroit ſouhaiter de les voir effacées;	Chacun de vos Sujets cherche à vous satisfaire, N'allés donc pas remplir les annales d'un fait qui rendrait le Lecteur de vous mal satisfait, Et ternissant l'éclat des actions passées, Lui ferait souhaiter de les voir effacées;
Je vous conjure donc par le Dieu tout puiſſant, De ne le prendre plus ſur un ton menaçant,	Je vous conjure donc par le Dieu tout puissant, De ne le prendre plus sur un ton menaçant,
Hermenegilde.	Hermènegilde.
Vous vous moqués, je croy, levés vous mon cher frere,	Vous vous moquez, je crois, levez -vous mon cher frère,
Recarede.	Récarède.
Flechiſſés vôtre eſprit, domptés vôtre colere, Surmontés vous vous-même, & ne vous jettés pas Dans l’affreux precipice où conduiſent vos pas, Revenés avec moy, revenés mon cher frere, Je ſuis ici venu de la part de mon pere, Vous dire qu’il eſt prêt à vous bien recevoir, Tâchés de vous tenir auſſi dans le devoir, Vous ſerés le premier d’une Cour ſi charmante, Vous la rendrés toûjours plus belle & plus brillante;	Flechissés -vous esprit, domptez votre colère, Surmontez -vous vous-même, et ne vous jetez pas Dans l'affreux précipice où conduisent vos pas, Revene avec moi, revenés mon cher frère, Je suis ici venu de la part de mon père, Vous dire qu'il est prêt à vous bien recevoir, Tâchez de vous tenir aussi dans le devoir, Vous serez le premier d'une Cour si charmante, Vous la rendriez toujours plus belle et plus brillante;
Vos plus fiers ennemis ſe declarent pour vous, Et tous avec ardeur vous ſouhaitent pour nous, Revenés au plûtôt embraſſer mon cher pere, Mais ſi vous perſiſtés à paroitre en colere, La tuurnant lar mey ſeur delivrés par ma mort, Tout le peuple des maux qu’il ſouffriroit à tort.	Vos plus fiers ennemis se déclarent pour vous, Et tous avec ardeur vous souhait à nous, Revenezez au plûtôt embrasser mon cher père, Mais si vous persistez à paraître en colère, La tuurnant lar me sûr ès par ma mort, Tout le peuple des maux qu'il souffrirait à tort.
He rmenegilde.	He rmènegilde.
Ne vous échauffés pas à preſſer vôtre ouvrage, Je vous accorde tout, en faut-il d’avantage?	Ne vous échauffez pas à presser votre ouvrage, Je vous accorde tout, en faut-il d'avantage?
Pourquoy me regar der comme vôtre Ennemy?	Pourquoi me régar der comme votre Ennemi?
De mon pere & de vous je fus toûjours amy, C’eſt une verité, j’en atteſte Dieu même, Je reſſentis pour vous une tendreſſe extrême, Je ne vous vis jamais d’un œil plein de courroux, De vos plus grands honneurs je ne fus point jaloux;	De mon père et de vous je fus toujours ami, C'est une vérité, j'en atteste Dieu même, Je ressentis pour vous une tendresse extrême, Je ne vous vis jamais d'un œil plein de courroux, De vos plus grands honneurs je ne fus point jaloux;
Ne pouvant de mon Roy digerer la diſgrace, J’ay levé des Soldats, pour réprimer l’audace, De ceux dont les Conſeils l’ont aigry contre moy, Sans craindre de bleſſer mes devoirs, ni ma Loy, Mais s’il n’a plus pour moy qu’amour & que tendreſſe, Si j’en puis eſperer quelque aimable carene, Je vais ſur vôtre foy me preſenter à luy, Et ma ſeule innocence y ſera mon apuy, Allés le prévenir, & me ſervés de guide.	Ne pouvant de mon Roi digérer la disgrâce, J'ai levé des Soldats, pour réprimer l'audace, De ceux dont les Conseils l'ont aigri contre moi, Sans craindre de blesser mes devoirs, ni ma Loi, Mais s'il n'a plus pour moi qu'amour et que tendresse, Si j'en puis espérer quelque aimable carene, Je vais sur votre foi me présenter à lu, Sera mon seule innocence y sera mon appui, Allz le prévenir, et me servésde guide.
Fraſiſtrate.	Frastrate.
Ah Ciel!	Ah Ciel!
que faites-vous, Prince trop intrepide?	que faites-vous, Prince trop intrépide?
voulez-vous ſans raiſon vous livrer à la mort?	voulez-vous sans raison vous livrer à la mort?
Vous allez à coup ſûr faire naufrage au port :	Vous allez à coup sûr faire naufrage au port :
Ces beaux dehors me ſont de fort mauvais augure, De me taire en ce point je vous ferois injure;	Ces beaux dehors me sont de fort mauvais augure, De me taire en ce point je vous ferais injure;
Je crains, & ma frayeur n’eſt pas ſans fondement, Et ſi vous m’en croyez, vous n’irez nullement:	Je crains, et ma frayeur n'est pas sans fondement, Et si vous m'en croyez, vous n'irez nullement:
Cette belle amitié n’eſt qu’une amitié feinte, Tout paroit en ce cas fortifier ma crainte.	Cette belle amitié n'est qu'une amitié feinte, Tout parait en ce cas fortifier ma crainte.
Hermenegiiat.	Hermènegiat.
Mon cher Eraſiſtrate, en cette occaſion Je blâme vôtre zele & vôtre affection:	Mon cher Erasistrate, en cette occasion Je blâme votre zèle et votre affection:
Vous avez vù mon frere avec quelle ouverture Il m’a fait de ſon cœur la charmante peinture;	Vous avez vù mon frère avec quelle ouverture Il m'a fait de son cœur la charmante peinture;
Ne ſoupçonnez donc rien de ſiniſtre pour moi.	Ne soupçonnez donc rien de sinistre pour moi.
EraſiſtrateAh?	ErastrateAh?
Seigneur, allez donc ſur vôtre bonne foi.	Seigneur, allez donc sur votre bonne foi.
je vous ſuivrai par tout;	je vous suivrai par tout;
& j’aime mieux qu’on penſe, Que j’ai voulu vous ſuivre avec quelque prudence, que r'on faſſe un reproche à la fidelité, Que je vous ai promiſe avec ſincerité.	et j'aime mieux qu'on pense, Que j'ai voulu vous suivre avec quelque prudence, que ron fasse un reproche à la fidélité, Que je vous ai promise avec sincérité.
Durias.	Durias.
Grand Prince, je crains tout ;	Grand Prince, je crains tout ;
ainſi je vous conjure De peſer toutes choſes en cette conjoncture:	ainsi je vous conjure De peser toutes choses en cette conjoncture:
Prenez vos ſûretés, comptez ſur vos Soldats que je vois diſpoſés à donner des combats;	Prenez vos sûretés, comptez sur vos Soldats que je vois disposés à donner des combats;
Ne vous expoſez pas à vous perdre vous-même.	Ne vous exposez pas à vous perdre vous-même.
D’y penſer ſeulement ma frayeur eſt extrême:	D'y penser seulement ma frayeur est extrême:
Ne vous livrez pas trop à vos fiers ennemis;	Ne vous livrez pas trop à vos fiers ennemis;
s’ils font un beau ſemblant d’être de vos amis, C’eſt pour vous attirer par de belles promeſſes, Et vous faire ſentir leurs fureurs vangereſſes.	s'ils font un beau semblant d'être de vos amis, C'est pour vous attirer par de belles promesses, Et vous faire sentir leurs fureurs vengeresses.
Hermenegil de.	Hermènegil de.
Je vous ſuis obligé;	Je vous suis obligé;
mais je l’ay reſolu, Je croirai que le Ciel ainſi l’aura voulu, Et j’aime mieux mourir pour le crime des autres, que d’ajuſter ici ma conſcience aux vôtres:	mais je l'ai résolu, Je croirai que le Ciel ainsi l'aura voulu, Et j'aime mieux mourir pour le crime des autres, que d'ajuster ici ma conscience aux vôtres:
Allons où le deſſin doit conduire nos pas;	Allons où le dessin doit conduire nos pas;
s’il nous mene à la mort, nous ne la fuirons pas.	s'il nous mène à la mort, nous ne la fuirons pas.
Fin du premier Acte.	Fin du premier Acte.
ACTE SECOND.	ACTE SECOND.
SCENE TREMTERE.	SCÈNE TREMTERE.
DARIACES.	DARICES.
H!	H!
qu’eſt-ce que j’entends du Prince Recarede?	qu'est-ce que j'entends du Prince Recarede?
Au gré de ſes deſirs faut-il que tout ſuccede?	Au gré de ses désirs faut-il que tout succède?
YYJe tremble, je pâlis d’un fait ſi ſurprenant, Mon cœur par la douleur ſe pâme en l’apprenant:	YYJe tremble, je pâlis d'un fait si surprenant, Mon cœur par la douleur se pâme en l'apprenant:
on dit qu’il a gagné ſur l'eſprit de ſon frere, Qu’il conclura la paix avec le Roy ſon pere, que des chagrins paſſés dans le ſein de l’oubly, Le triſte ſouvenir doit être enſevely, Et retournant tous deux avecque plus de gloire, Que s’ils avoient gagné quelque inſigne victoire.	on dit qu'il a gagné sur l'esprit de son frère, Qu'il conclura la paix avec le Roi son père, que des chagrins passés dans le sein de l'oubli, Le triste souvenir doit être enseveli, Et retournant tous deux avec plus de gloire, Que s'ils avaient gagné quelque insigne victoire.
O rage!	Ô rage!
ô deſeſpoir!	ô désespoir!
par mille cruautés Je ſçaurai traverſer leurs deſſeins concertés, Oüy je reparerai ma lâcheté paſſée, Et je veux qu’en ce jour elle ſoit effacée:	par mille cruautés Je saurai traverser leurs desseins concertés, Oui je réparerai ma lâcheté passée, Et je veux qu'en ce jour elle soit effacée:
Il faut donc prévenir ſa domination;	Il faut donc prévenir sa domination;
Car ſi tout répondoit à fon ambition, Il me feroit ſentir une juſte vangeance, Et voudroit me ſoûmettre à ſon obéiſſance;	Car si tout répondait à son ambition, Il me ferait sentir une juste vengeance, Et voudrait me soumettre à son obéissance;
Je ne peux le ſouffrir, & j’eſpere dans peu, Qu’on lui fera par moi joüer un autre jeu.	Je ne peux le souffrir, et j'espère dans peu, Qu'on lui fera par moi jouer un autre jeu.
Il faut dés ce moment que je leve le maſque, Et que ma paſſion excite la bouraſque;	Il faut dès ce moment que je lève le masque, Et que ma passion excite la bourasque;
J’ai honte de paroître autre que je ne ſuis, Si je ne fais du mal, c’eſt que je ne le puis:	J'ai honte de paraître autre que je ne suis, Si je ne fais du mal, c'est que je ne le puis:
Ce n’eſt juſqu’à preſent que dans des minuties, que j’ai fait contre lui naitre des jalouſies, Je vais donc l’attaquer par des endroits plus iorts, Pour le faire perir je ferai mes efforts, ’employerai pour cela le dernier artifice, Et pretends lui creuſer un affreux precipice:	Ce n'est jusqu'à présent que dans des minuties, que j'ai fait contre lui naître des jalousies, Je vais donc l'attaquer par des endroits plus jorts, Pour le faire périr je ferai mes efforts, employerai pour cela le dernier artifice, Et prétends lui creuser un affreux précipice:
Il faut ſans balancer nous défaire de lui, ’en connois le moyen, ſans aucun autre apui :	Il faut sans balancer nous défaire de lui, 'en connais le moyen, sans aucun autre appui :
Veici fort à propos mon Receleur fidel	Veici fort à propos mon Receleur fidel
SCENE SECONDE.	SCÈNE SECONDE.
DARTACES, HERMENEFRIDE.	DARTACES, HÉRMENEFRIDE.
Dariaces.	Dariaces.
E ciel nous eſt propice, il nous la donne belle, L Nous ne manquerons pas en cette occaſion De mettre Hermenegilde en execration, c’eſt l’empêcher par là de monter ſur le trône:	E ciel nous est propice, il nous la donne belle, L Nous ne manquerons pas en cette occasion De mettre Hermenegilde en exécration, c'est l'empêcher par là de monter sur le trône:
Dites-moi vôtre avis ſur celui que je donne.	Dites-moi votre avis sur celui que je donne.
Hermene fride.	Hermène fride.
Il eſt conforme au vôtre, & je ſuis ſi chagrin De voir tous nos projets prendre un ſi mauvais train, Que malgré ma conſtance unie avec la vôtre, La crainte regne en moy plus que dans aucun autre, La douleur que je ſens me penetre le cœur, Par un revers fatal le verrons-nous Vainqueur?	Il est conforme au vôtre, et je suis si chagrin De voir tous nos projets prendre un si mauvais train, Que malgré ma constance unie avec la vôtre, La crainte règne en moi plus que dans aucun autre, La douleur que je sens me penre le cœur, Par un revers fatal le verrons-nous Vainqueur?
s’il revient triomphant auprés du Roy ſon pere, Nous al lons éprouver un châtiment ſevere;	s'il revient triomphant auprès du Roi son père, Nous al lons éprouver un châtiment sévère;
Il deviendra pour nous cruel en ſe vangeant, Il en aura pour lors un motif engageant :	Il deviendra pour nous cruel en se vengeant, Il en aura pour lors un motif engageant :
Nous avons vû ce Prince à deux doigts de ſa perte, Pour la voir achever la porte étoit ouverte;	Nous avons vu ce Prince à deux doigts de sa perte, Pour la voir achever la porte était ouverte;
L’Enfer de ſoi iecours hous avoit oblige, Il nous reprochera de l’avoir negligé.	L'Enfer de soi ici hous avait oblige, Il nous reprochera de l'avoir négligé.
Dariaces.	Dariaces.
nte vous amiger pas, nous en obtiendrons d’autres, Je ſuis de ſes amis comme je ſuis des vôtres.	nte vous amiger pas, nous en obtiendrons d'autres, Je suis de ses amis comme je suis des vôtres.
Hermenefride.	Hermènefride.
Ah!	Ah!
cher Dariaces, nos efforts ſeront vains.	cher Dariaces, nos efforts seront vains.
La proye eſt échapée à preſent de nos mains.	La proie est échappée à présent de nos mains.
Dariaces.	Dariaces.
Ne deſeſperez pas, je ſçai ce qu’il faut faire, Je pourrai la ravoir, & j’en fais mon affaire:	Ne désespérez pas, je sais ce qu'il faut faire, Je pourrai la ravoir, et j'en fais mon affaire:
Si la fortune donne à quelqu’un du pouvoir, L’envie en peu de tems ſçait l’en faire déchoir;	Si la fortune donne à quelqu'un du pouvoir, L'envie en peu de temps sait l'en faire déchoir;
Quand il auroit conquis le thrône d’Alexandre, Je ſçais un moyen ſûr, pour l’en faire deſcendre.	Quand il aurait conquis le trône d'Alexandre, Je sais un moyen sûr, pour l'en faire descendre.
Hermenefride.	Hermènefride.
Ah!	Ah!
ne l'eſperez pas;	ne l'espérez pas;
changeons de ſentiment, Nous ſerons à couvert de ſon reſſentiment.	changeons de sentiment, Nous serons à couvert de son ressentiment.
Dariaces.	Dariaces.
Mais ypemieirvous oiammno laene que vous êtes!	Mais ypérieirvous oiamno laène que vous êtes!
Nous ſommes prêts d’avoir le prix de nos conquêtes.	Nous sommes prêts d'avoir le prix de nos conquêtes.
Hermenejniat.	Hermenejniat.
Le Prince Hermenegilde eſt ſans doute innocent.	Le Prince Hermènegilde est sans doute innocent.
Dariaces.	Dariaces.
Et moy je ſuis coupable, un chacun s’en reſſent.	Et moi je suis coupable, un chacun s'en ressent.
Hermenefride.	Hermènefride.
En vain depuis long tems nous tentons de l’abattre.	En vain depuis long tems nous tentons de l'abattre.
Darrate).	Darrate).
Par de ſi bons endroits je ſçaurai le combattre, Qu’un ſeul coup de ma main pourra le renverſer.	Par de si bons endroits je saurai le combattre, Qu'un seul coup de ma main pourra le renverser.
Hermenefride.	Hermènefride.
Eſt-ce que la pudeur ne vous peut empêcher?	Est-ce que la pudeur ne vous peut empêcher?
Dariaces.	Dariaces.
A moi de la pudeur!	À moi de la pudeur!
vous me faites bien rire:	vous me faites bien rire:
Voici le Roy qui vient, voyons ce qu’il va dire;	Voici le Roi qui vient, voyons ce qu'il va dire;
Ne l’interrompons pas.	Ne l'interrompons pas.
SCENE TROTSIEME.	SCÈNE -TROTSIEME.
LEVIGILDE, SOPHRON, CARDACES, DARIACES, HERMENEFRIDE.	LEUIGILDE, SOPHRON, CARDACES, DARIACES, HERMENEFRIDE.
Levigilde.	Levigilde.
L’affaire eſt donc au point, que mon fils qui devoit avec moy s’être joint, Me force dans ce jour à punir ſon audace, D'aſpirer à mon thrône, & ſe mettre à ma place.	L'affaire est donc au point, que mon fils qui devait avec moi s'être joint, Me force dans ce jour à punir son audace, D'aspirer à mon trône, et se mettre à ma place.
Neceſſité fatale où je ſuis à preſent !	Nécessité fatale où je suis à présent !
Il faut donc malgré moy, pour punir l’inſolent, Que je trempe mes mains dans le ſang de ſes veines.	Il faut donc malgré moi, pour punir l'insolent, Que je trempe mes mains dans le sang de ses veines.
que mon ame eſt livree à de cruelles peines!	que mon âme est livrée à de cruelles peines!
o Dieu, donc la puiſſance égale la grandeur, De qui je tiens le Sceptre & toute ma valeur, Daignez dans le combat que je vais entreprendre Me donner du ſecours, & vouion me défendre:	ô Dieu, donc la puissance égale la grandeur, De qui je tiens le Sceptre et toute ma valeur, Daignez dans le combat que je vais entreprendre Me donner du secours, et vouion me défendre:
Puniſſez dans mon fils mes rebelles Sujets, Que je faſſe en ce jour avorter leurs projets, Que mon habileté dans les guerres civiles Eclate à ramener mes Sujets indociles, Comme à vaincre au dehors mes plus fiers ennemis Qui par force à mes loix ſe ſont trouvés ſoûmis, Si le Ciel n’eut pris ſoin de conſerver ma vie, La rage de mon fils ſe ſeroit aſſouvie Mais mon fils Recarede eſt long-tems à venir, Je crains que ce cruel ne le faſſe mourir, Et qu’il ne vienne aprés d’une main ſanguinaire Enfoncer le poignard dans le ſein de ſon pere :	Punissez dans mon fils mes rebelles Sujets, Que je fasse en ce jour avorter leurs projets, Que mon habileté dans les guerres civiles Éclate à ramener mes Sujets indociles, Comme à vaincre au dehors mes plus fiers ennemis Qui par force à mes lois se sont trouvés soûmis, Si le Ciel n'eut pris soin de conserver ma vie, La rage de mon fils se serait assouvie Mais mon fils Recarede est longtemps à venir, Je crains que ce cruel ne le fasse mourir, Et qu’ sang ne vienne après d'une main sanguinaire Enfoncer le poignard dans le sein de sein pere :
Je dois tout redouter de ce cœur inhumain, Allons le prévenir les armes à la main.	Je dois tout redouter de ce cœur inhumain, Allons le prévenir les armes à la main.
Allez donc Generaux, Officiers, Capitaines, Aſſembler au plûtôt les Soldats dans ces plaines, Et marchons promptement droit à nos ennemis, Le delai dans ce cas ne nous eſt point permis.	Allez donc Généraux, Officiers, Capitaines, Assembler au plûtôt les Soldats dans ces plaines, Et marchons promptement droit à nos ennemis, Le délai dans ce cas ne nous est point permis.
Hermenef ride.	Hermènef ride.
rtous alions tous, grand Roy, dans peu vous) ſatisfaire;	rous alions tous, grand Roi, dans peu vous) satisfaire;
Il faut par un combat terminer cette affaire:	Il faut par un combat terminer cette affaire:
Recarede, dit-on, n’a fait aucun traité, Et l’ennemi s’avance avec grande fierté.	Recarede, dit-on, n'a fait aucun traité, Et l'ennemi s'avance avec grande fierté.
Dariaces.	Dariaces.
Sire, il vous faut du ſang, & non pas des paroles, Pour punir leur orguëil elles ſont trop frivoles.	Sire, il vous faut du sang, et non pas des paroles, Pour punir leur orgueil elles sont trop frivoles.
dophron.	dophron.
Grand Roy, vôtre ordre eſt juſte, & ſans retardement Nous executerons vôtre commandement, Pourroit-on reculer dans cette conjoncture?	Grand Roi, votre ordre est juste, et sans retardement Nous exécuterons votre commandement, Pourrait-on reculer dans cette conjoncture?
Il faut les prévenir, & vanger cette injure.	Il faut les prévenir, et venger cette injure.
Cardaces.	Cardaces.
oüy c’eſt à vous, grand Prince, à nous donner des loix;	oüy c'est à vous, grand Prince, à nous donner des lois;
Mais qu’il me ſoit permis de vous dire une fois, Qu’il ne faut pas preſſer vôtre juſte vangeance, L’affaire en queſtion eſt trop de conſequence:	Mais qu'il me soit permis de vous dire une fois, Qu'il ne faut pas presser votre juste vengeance, L'affaire en question est trop de conséquence:
Sophron ne peut ſouffrir aucun retardement, On feroit mal, dit-il, d’y penſer ſeulement:	Sophron ne peut souffrir aucun retardement, On ferait mal, dit-il, d'y penser seulement:
Cependant c’eſt par là que tous les hommes ſages Ont detoûrné ſouvent de terribles orages;	Cependant c'est par là que tous les hommes sages Ont détouré souvent de terribles orages;
Ceux qui s’abandounant à leurs reſſentimens, Ecoutent la fureur des premiers mouvemens, Pour vanger une injure & s’en faire juſtice, Tombent ſouvent par là dans un grand précipice:	Ceux qui s'abandounant à leurs ressentiments, Ecoutent la fureur des premiers mouvements, Pour venger une injure et s'en faire justice, Tombent souvent par là dans un grand précipice:
Retarde encore un peu ſon execution, Attendez Recarede envoyé vers ſon frere;	Retarde encore un peu son exécution, Attendez Recarede envoyé vers son frère;
que ſi d’une heure ou deux ſon retour ſe differe,.	que si d'une heure ou deux son retour se diffère,.
Eſt-ce un ſujet ſi grand, pour vous mettre en courroux?	Est-ce un sujet si grand, pour vous mettre en courroux?
Je preſſens que ce Prince a réuſſi pour vous, Qu’il a par ſon eſprit & par ſon induſtrie Fait rendre Hermenegilde au bien de ſa Patrie:	Je pressens que ce Prince a réussi pour vous, Qu'il a par son esprit et par son industrie Fait rendre Herménégilde au bien de sa Patrie:
Mais ſi vous ordonnez qu’on marche aux ennemis, Il ne lui tiendra pas ce qu’il aura promis, Vous pourriéz voir alors un terrible carnage, Et les Soldats vainqueurs s’enrichir du pillage.	Mais si vous ordonnez qu'on marche aux ennemis, Il ne lui tiendra pas ce qu'il aura promis, Vous pourriez voir alors un terrible carnage, Et les Soldats vainqueurs s'enrichir du pillage.
Mais j’aperçois quelqu’un qui s’avance à grands pas, Je juge par ſon air qui ne me déplait pas, qu’il vient nous aporter quelque heureuſe nouvelle.	Mais j'aperçois quelqu'un qui s'avance à grands pas, Je juge par son air qui ne me déplait pas, qu'il vient nous apporter quelque heureuse nouvelle.
SCENE QUATRIEME.	SCÈNE QUATRIÈME.
LEVIGILDE, SOPHRON, CARDACES, DURIAS, HERMENEFRIDE, IGERDES.	LEUIGILDE, SOPHRON, CARDACES, DURIAS, HÉRMENEFRIDE, IGERDES.
Levigilde.	Levigilde.
Ia u bien, dites-nous donc au plûtôt quelle eſt-elle?	Ia a bien, dites-nous donc au plutôt quelle est-elle?
lgerdes.	lgerdes.
Le Prince Recarede eſt en chemin, grand Roy, Hermenegilde ſuit ſoûmis à vôtre loy.	Le Prince Récole est en chemin, grand Roi, Hermènegilde suit soumis à votre loi.
Levigilde, quelle heureuſe nouvelle!	Levigilde, quelle heureuse nouvelle!
Atrnele Et je l’ai vû moi-même, Eſcorté d’officiers dans une joye extreme.	Atrnele Et je l'ai vu moi-même, Escorté d'officiers dans une joie extrême.
Le vigilde.	Le vigilde.
Eh!	Eh!
que veulent donc dire iei ces médiſans, que déja l’ennemi s’avançoit vers nos eamps?	que veulent donc dire iei ces médisants, que déjà l'ennemi s'avançait vers nos éamps?
Igerdes.	Igerdes.
j'igners ce qu’on dit & te qu on fur ſepieen.	j'igners ce qu'on dit et te qu on fur sépieen.
.	.
je dis ce que j’ay vû, le voicy qui s’aproche;	je dis ce que j'ai vu, le voici qui s'approche;
Il vous informera de tout ce qu’il a fait, Et je croy que de tout vous ſerez ſatisfait.	Il vous informera de tout ce qu'il a fait, Et je crois que de tout vous serez satisfait.
Cardaces.	Cardaces.
Ah!	Ah!
grand Dieu, qu’il eſt bon dans ce que l'on médite, D'y penſer meurement, & n’aller point ſi vîte, c’eſt donc par mon conſeil que les Gots vont joüir De la charmante Paix qui va nous réjoüir.	grand Dieu, qu'il est bon dans ce que l'on médite, D'y penser meurement, et n'aller point si vite, c'est donc par mon conseil que les Gots vont joüir De la charmante Paix qui va nous réjouir.
Levigi lae.	Levigi lae.
Qu’il entre promptement,	Qu'il entre promptement,
SCENE CINQUIEME.	SCÈNE CINQUIÈME.
LEVIGILDE, RECAREDE, SOPHRON CARDACES, DARIA CES, HERMEV EFRIDE, IGERDES,	LEUIGILDE, RECAREDE, SOPHRON CARDACES, DARIA CES, HÉRMEU EFRIDE, IGERDES,
AH!	AH!
mon rils Recarede?	mon rils Recarede?
Venez-vous ſoulager le mal qui nous poſſede?	Venez-vous soulager le mal qui nous possède?
Recarede.	Récarède.
Conſolez-vous Seigneur, mon voyage eſt heureux, Le ſuccez vous le prouve & doit flater vos vœux, Hermenegilde ſuit, avec moy je l’améne, Sa preſence bientôt vous tirera de peine, Loin de voir en ce Frere un mortel ennemy.	Consolez-vous Seigneur, mon voyage est heureux, Le succès vous le prouve et doit flatter vos vœux, Hermenegilde suit, avec moi je l'amne, Sa présence bientôt vous tirera de peine, Loin de voir en ce Frère un mortel ennemi.
En luy j’ay rencontré le plus fidel amy, Il m’a cent fois juré que jamais de ſa vie Il n’avoit eu ſur vous de deſſein ny d’envie, Et pour vous en convaincre, il vient vous embraſſer;	En Elle j'ai rencontré le plus fidel ami, Il m'a cent fois juré que jamais de sa vie Il n'avait eu sur vous de dessein cy d'envie, Et pour vous en convaincre, il vient vous embrasser;
Pour le bien recevoir daignez le careſſer.	Pour le bien recevoir daignez le caresser.
Levigilde.	Levigilde.
Mais peut-être, mon Fils, que l’amour pour un Frert Vous dérobe le mal qu’il veut faire à ſon Pere, Ou que par trop credule à ce qu’il dit de ſoy vous penſez que ſans fard il parle comme moy;	Mais peut-être, mon Fils, que l'amour pour un Frérer Vous dérobe le mal qu'il veut faire à son Père, Ou que par trop crédule à ce qu'il dit de soi vous pensez que sans fard il parle comme moi;
Au nom de l’Eternel, mon Fils, je vous conjure Faites-moy de ſon cœur la naive peinture, Venez me raconter comme il vous a reçû,	Au nom de l'Éternel, mon Fils, je vous conjure Faites-moi de son cœur la naïve peinture, Venez me raconter comme il vous a reçu,
Recarede.	Récarède.
Ah!	Ah!
Seigneur, non jamais vous ne l’aurier Ce Prince tout malade accablé de miſere, Chagrin d’avoir perdu l’amitié de ſon Pere, Frapé des faux raports de ſes perſecuteurs, Se trouvoit affligé par d’étranges malheurs, Cependant il les porte avec tant de conſtance, Qu’on ne peut admirer aſſez ſa patience, Bien loin d’avoir formé quelque mauvais deſſein, Il vous aime, Seigneur, & vous porte en ſon ſein Il ſouffriroit plûtôt les fureurs de Bellonne, Que de commettre rien contre vôtre perſonne;	Seigneur, non jamais vous ne l'aurier Ce Prince tout malade accablé de misère, Chagrin d'avoir perdu l'amitié de son Père, Frappé des faux rapports de ses persécuteurs, Se trouvait affligé par d'étranges malheurs, Cependant il les porte avec tant de constance, Qu'on ne peut admirer sa sa patience, Bien loin d'avoir formé quelque mauvais dessein, Il vous aime, Seigneur, et vous porte en son sein Il finirait plutôt les fureurs de Bellonne, Que de commettre rien contre votre personne;
Auſſi-tôt qu’avec luy j’a y parlé de la paix, Je l’ay vû ſans delay répondre à mes ſouhaits, on l’a vû m’embraſſer devant toute l’Armée qui reſte avec plaiſir du ſpectacle charmée, Et que ſe dépoüillant de toute ſa fureur, s’eſt ſoumiſe à ce Prince, & repris ſa douceur.	Aussitôt qu'avec beau j'a y parlé de la paix, Je l'ai vu sans délai répondre à mes souhaits, on l'a vu m'embrasser devant toute l'Armée qui reste avec plaisir du spectacle charmée, Et que se dépoüillant de toute sa fureur, s'est soumise à ce Prince, et repris sa douceur.
Sa pieté ſur tout le rend ſemblable aux Anges, Chaque action qu’il fait merite des loüanges, Pour nous convaincre encor de ſa ſincerité, Et que ce que je dis n’eſt que la verité, Il vient ſe rendre icy, ſans arme,, ſans eſcorte, Son innocence ſeule en eſt une aſſez forte;	Sa pieté sur surtout le rend semblable aux Anges, Chaque action qu'il fait mérite des louanges, Pour nous convaincre encor de sa sincérité, Et que ce que je dis n'est que la vérité, Il vient se rendre ici, sans arme, sans escorte, Son innocence seule en est une assez forte;
Voulez-vous maintenant que je le faſſe entrer?	Voulez-vous maintenant que je le fasse entrer?
Levigilde.	Levigilde.
Je commence à ſentir mon cœur ſe penetrer, Mon ſang dans ce cher Fils me paroit agreable, Sa douceur me ravit & me le rend aimable, Un tendre ſentiment cede à la dureté, Et ce Fils genereux deſarme ma fierté, qu’il entre, je le veux, & je vous le commandeLe voila qu’il paroit, écoutons ſa demande,	Je commence à sentir mon cœur se pénétrer, Mon sang dans ce cher Fils me parait agréable, Sa douceur me ravit et me le rend aimable, Un tendre sentiment cède à la dureté, Et ce Fils généreux désarme ma fierté, qu'il entre, je le veux, et je vous le commandeLe voilà qu'il parait, écoutons sa demande,
SCENE SIXIE'ME.	SCÈNE SIXIE'ME.
LEVIGILDE, HERMENGGILDE, RECAREDESOPHIRON, CARDACES, DARIAOEO JERASISTRATE, HERMENEFRIDE, IGERDES.	LEUIGILDE, HÉRMENGILDE, RECAREDESOPHIRON, CARDACES, DARIAONE RASISTRATE, HERMENEFRIDE, IGÈRDES.
Miaitate Eigneur voilà mon Frere,	Miaitate Eigneur voilà mon Frère,
Herm enegilde.	Herm enegilde.
A vos ordres foûmis:	À vos ordres soumis:
Seigneur, quoiqu’il arrive avec mes ennemis.	Seigneur, quoiqu'il arrive avec mes ennemis.
je me qualifieray du nom d’Hermenegilde, Et d’être Fils Aîné du grand Roy Levigilde Chaſſé de ſa maiſon je vis comme exilé, J’ay ſuivi mon deſtin, je n’ay pas reculé;	je me qualifierai du nom d'Hermènegilde, Et d'être Fils Aîné du grand Roi Levigilde Chassé de sa maison je vis comme exilé, J'ai suivi mon destin, je n'ai pas reculé;
Mes calomniateurs, en ſéduiſant mon Pere Ont fait tomber ſur moy le poid de ſa colere, S’ils ne ſont pas encor pleinement ſatisfaits, Ils peuvent contenter leurs injuſtes ſouhaits, Je viens vous apporter ma tête pour victime, Proteſtant à vos pieds que je mouray ſans crime.	Mes catis, en séduisant mon Père Ont fait tomber sur moi le poid de sa colère, S'ils ne sont pas encor pleinement satisfaits, Ils peuvent contenter leurs injustes souhaits, Je viens vous apporter ma tête pour victime, Protestant à vos pieds que je mourai sans crime.
Et vos pauvres Sujets accablez de travaux, Par là pourront joüir d’un paiſible repos.	Et vos pauvres Sujets accablez de travaux, Par là pourront jouir d'un paisible repos.
Ce me ſera, Seigneur, une mort conſolante.	Ce me sera, Seigneur, une mort consolante.
qu’ene ainve au plutot, ſi cela vous contente.	qu'ene ainve au plutôt, si cela vous contente.
C’eſt en verſant mon ſang que je prouveray mieux, qu’elle eſt mon innocence à la face des Cieux.	C'est en versant mon sang que je prouverai mieux, qu'elle est mon innocence à la face des Cieux.
Si jt la deffendois par la force des armes, Je cauſerois partout de funeſtes allarmes.	Si jt la défendais par la force des armes, Je causerais partout de funestes alarmes.
Levigilde.	Levigilde.
Levez-vous, embraſſez vôtre Pere en ce jour, je me réjoüis fort de vôtre heureux retour.	Levez-vous, embrassez votre Père en ce jour, je me réjouis fort de votre heureux retour.
je reconnois, mon Fils, qu’elle eſt vôtre innocence, Et que ce qu’on m’a dit n’étoit que médiſance, je voy trop éclater vôtre fidelité, Et mon eſprit n’eſt plus dans la perplexité, La confiance en moy que vous faites paroître, Ne me laiſſe sucun doute en quoy que ce puiſſe être;	je reconnais, mon Fils, qu'elle est votre innocence, Et que ce qu'on m'a dit n'était que médisance, je vois trop éclater votre fidélité, Et mon esprit n'est plus dans la perplexité, La confiance en moi que vous faites paraître, Ne me laisse sucun doute en quoi que ce puisse être;
Mais j’étois prévenu des raports impoſteurs, Que m’avoient fait de vous vos Calomniateurs, De leurs conſeils maudits je cedois à la force, Pour augmenter vos maux ils m’ont ſervy d’amorce, Et parlà ſans raiſon irrité contre vous, J’ay cauſé les malheurs que nous reſſentons tousJ’aprouve Eraſiſtrate, & loüe vôtre zele.	Mais j'étais prévenu des rapports imposteurs, Que m'avaient fait de vous vos Calomniateurs, De leurs conseils maudits je cédais à la force, Pour augmenter vos maux ils m'ont servi d'amorce, Et parlà sans raison irrité contre vous, J'ai causé les malheurs que nous ressentons tousJ’approuve Erastrate, et loue votre zèle.
Vous avez pour mon Fils toûjours été fidéle, Si vous l’avez marqué dans ſon adverſité.	Vous avez pour mon Fils toujours été fidèle, Si vous l'avez marqué dans son adversité.
Qui pourroit en douter dans ſa proſperité?	Qui pourrait en douter dans sa prospérité?
Eraſiſtrate.	Erasistrate.
Parmy les cruautez d’une aveugle fortune, Accablé des chagrins d’une crainte importune, Je jure icy, grand Prince, à vôtre Majeſté, qu’il ne manquoit pour vous d’amour ny de bonté, Ce qui faiſoit en luy la cauſe de ſa peine, C’eſt que ſes ennemis enflàmez par la haine, Pour comble de malheurs, aprés ſon triſte ſort, De trahir vôtre ſang l’accuſeroient à tort, Si de vôtre Palais, ſi de vôtre preſence, Ce Fils s’eſt éloigné par un trait de prudence, Il a crû de l’envie éviter la fureur, Et ménager ſa gloire aux dépens de ſon cœur, Il revient à vos pieds, dez que ſon innocence, Eſt aſſez reconnuë & miſe en évidence, Auſſi-tôt qu’il a vû que vôtre Majeſté, Etoit en ia faveur lennole à la bonte, Er vouloit luy permettre un abord plus facile, Aux traits de ſon amour il s’eſt rendu docile, Vous le voyez, grand Roy, ſans armes, ſans Soldats, Et ſa ſeule innocence accompagne ſes pas,	Parmi les cruautés d'une aveugle fortune, Accablé des chagrins d'une crainte importune, Je jure ici, grand Prince, à votre Majesté, qu'il ne manquait pour vous d'amour ni de bonté, Ce qui faisait en Un la cause de sa peine, C'est que ses ennemis enflés par la haine, Pour comble de malheurs, après son triste sort, De trahir votre sang l'accuseraient à tort, Si de votre Palais, si de votre présence, Ce Fils s'est éloigné par un trait un traité, Il a crû de l'envie viter la fureur, Et ménager sa gloire aux dépens de son cœur, Il revient ô pieds, dé que son innocence, Est a reconnuë et mise en évidence, Aussi-tôt il à que vôtre Majesté, Etoit en faveur lennole la bonté, vouloit lui permettre un abord plus facile, Aux traits de son amour il est rendu docile, Vous le voyez, grand Roy, sans armes, sans Soldats, Et sa seule innocence accompagne ses pas,
Et cixelaes Je reconnois, mon Fils, qu’elle eſt vôtre innocence, Le Ciel m’en a donné toute la connoiſſance, J’en benis aujourd’huy le Seigneur tout-puiſſant, oublions tout, mon Fils, en nous réüniſſant, Reprenez pour toûjours vôtre premiere joye,	Et cixelaes -Je reconnais, mon Fils, qu'elle est votre innocence, Le Ciel m'en a donné toute la connaissance, J'en bénis J'hui le Seigneur tout-puissant, oublions tout, mon Fils, en nous réunissant, Reprenez pour toujours votre première joie,
Hermenegilde.	Hermènegilde.
C’eſt un plaiſir bien doux que mon rere foetroye, Mais puiſque vous avez pour moy tant de bonté.	C'est un plaisir bien doux que mon recré foîtroie, Mais puisque vous avez pour moi tant de bonté.
je réponds aux deſſeins de vôtre Majeſté, ’oſe la ſuplier pour ceux qui dans ma fuite, ont ſoûtenu mon ſort mieux que je ne merite.	je réponds aux desseins de votre Majesté, ôse la supplier pour ceux qui dans ma fuite, ont soutenu mon sort mieux que je ne mérite.
Levigilde.	Levigilde.
Je loüë avec ſujet ceux qui dans vos malheurs, ont pris part à vos maux, reſſenti vos douleurs, Et qui vous ont ſuivy, non pas vôtre fortune, Gardes, empêchez donc qu’on ne nous importune, Allons, mon Fils, allons gouter les doux plaiſirs De la Paix que le Ciel accorde â nos deſirs, Il comble de faveurs & d’amour le plus tendre, Le Royaume des cets que nous devons dencnure, Venez prendre, mon Fils un repas avec moy, Il ſort.	Je lue avec sujet ceux qui dans vos malheurs, ont pris part à vos maux, ressenti vos douleurs, Et qui vous ont suivi, non pas votre fortune, Gardes, empêchez donc qu'on ne nous importune, Allons, mon Fils, allons goûter les doux plaisirs De la Paix que le Ciel accorde ât nos désirs, Il comble de faveurs et d'amour le plus tendre, Le Royaume des cets que nous devons dencencure, Venez prendre, mon Fils un repas avec moi, Il sort.
Hermenegilde.	Hermènegilde.
Fidéle Eraſiſtrate, apreſent je te croy, Tout raſſûre nos cœurs, la crainte en eſt bannie, Et nul n’oſera plus par une calomnie, En impoſer au Roy, qui par ſon équité Pourroit de l’impoſteur punir la lâcheté Apreſent qu’il connoit quelle eſt mon innocence, Je vois que tout le mondet eſt en réjoüiſſance, Les Bourgeois en danſant au bruit de leurs baſſons, Viennent nous accuëillir avec mille chanſons,	Fidèle Erasistrate, aprèsent je te crois, Tout rassurère nos cœurs, la crainte en est bannie, Et nul n'osera plus par une calomnie, En imposer au Roi, qui par son équité Pourrait de l'imposteur punir la lâcheté Aprésent qu'il connaît quelle est mon innocence, Je vois que tout le en est en réjouissance, Les Bourgeois en avant au bruit de leurs bassons, Viennent nous accueillir avec mille chansons,
Eraſiſtrate.	Erasistrate.
Quoiqu’il en foit, mon cœur eſt toûjours dans la crainte Et ces dehors ſi beaux ne peuvent être que feinte.	Quoiqu'il en soit, mon cœur est toujours dans la crainte Et ces dehors si beaux ne peuvent être que feinte.
La ſluteuſe Marâtre auprés du Roy ſurtout, Fera tous ſes efforts pour vous pouſſer about.	La sleuse Marâtre auprès du Roi surtout, Fera tous ses efforts pour vous pousser about.
Fin du ſecond Acte.	Fin du second Acte.
ACTE TROISIE’ME.	ACTE -THROISIE'ME.
SCENE PREMIERE.	SCÈNE PREMIÈRE.
DURIAS.	DURIAS.
Rand Dieu, que tes ſecrets nous ſont impenetrables, O que tes juſtes deſſeins ſont toûjours adorables!	Rand Dieu, que tes secrets nous sont impénétrables, Ô que tes justes desseins sont toujours adorables!
Que craindre ou qu’eſperer de la charmante Paix, Qui répond en ce jour à nos tendres ſouhaits?	Que craindre ou qu'espérer de la charmante Paix, Qui répond en ce jour à nos tendres souhaits?
On voit avec plaiſir nôtre Roy Levigilde, Embraſſer par amour le Prince Hermenegilde, Luy marquer ſa douleur des injuſtes ſoupçons, Qu’il avoit eu de luy par de fauſſes raiſons, De ſon plus tendre amour la marque eſt autentiquIl va le regaler d’un feſtin magnifique, L’abondance des mets & des plus excellens, Doit répondre en bel ordre à ces vins petillans Il renait dans les yeux de ce Fils qu’il admire, Il en eſt ſi charmé qu’il ne ſçauroit rien dire.	On voit avec plaisir notre Roi Levigilde, Embrasser par amour le Prince Hermenegilde, Lui marquer sa douleur des injustes soupçons, Qu'il avait eu de quelques par de fausses raisons, De son plus tendre amour la marque est autentiquIl va le régaler d'un festin magnifique, L'abondance des mets et des plus excellents, Doit répondre en bel ordre à ces vins pétillants Il renaît dans les yeux de ce Fils qu'il admire, Il en est si charmé qu'il ne saurait rien dire.
Il ſemble negliger les mets les plus exquis, Et n’a plus d’autre ſoin que d’admirer ſon Fils Mais de ſes ennemis la ſecrette aſſemblée, Fait craindre que bientôt la paix ne ſoit troubléc Je ſçay qu’Hermenefride, avec Dariaces Enragent d’avoir vû d’avantageux ſuccés, Qu’ils cherchent les moyens de les pouvoir détruire Les voicy, ce me ſemble, ils vont nous en inſtruire	Il semble négliger les mets les plus exquis, Et n'a plus d'autre soin que d'admirer son Fils Mais de ses ennemis la secrète assemblée, Fait craindre que bientôt la paix ne soit troublécé Je sais qu'Hermenefride, avec Dariaces Enragent d'avoir vu d'avantageux succès, Qu'ils cherchent les moyens de les pouvoir détruire Les voici, ce me semble, ils vont nous en instruire
SCENE SECONDE.	SCÈNE SECONDE.
DARIACES, HERMENEFRIDE.	DARICES, HÉRMENEFRIDE.
Hermenefride.	Hermènefride.
H!	H!
cher Dariaces, mes ſens ſont éperdus, AA Tous nos efforts ſont vains, nous voilà confondu.	cher Dariaces, mes sens sont éperdus, AA Tous nos efforts sont vains, nous voilà confondu.
Nôtre pauvre navire eſt battu des ten, Le mal que nous faiſons retombe ſur nos tetes.	Notre pauvre navire est battu des ten, Le mal que nous faisons retombe sur nos têtes.
Voilà de nos travaux le fruit que nous tirons.	Voilà de nos travaux le fruit que nous tirons.
De nos affreux deſſeins nous nous repentirons, Nous avons entrepris pour plaire à nôtre Reyne, De faire à l’innocence éprouver nôtre haine, De perdre Hermenegilde au comble des honneurs, Pour attirer ſur nous de plus grandes faveurs, Il a ſçu ſe tirer de toutes nos embuches, Je me vois confondu, toy-même tu trébuches, Le Roy d’un grand feſtin honore ſon retour, Sa paix eſt affermie, il brille dans ſa Cour, Il triomphe de nous & de nos calomnies, Par un ſuplice affreux nous les verrons punies, Pour comble de malheurs qui vont tomber ſur nous, Il nous fera ſentir juſtement ſon courroux;	De nos affreux desseins nous nous repentirons, Nous avons entrepris pour plaire à notre Reine, De faire à l'innocence éprouver notre haine, De perdre Hermenegilde au comble des honneurs, Pour attirer sur nous de plus grandes faveurs, Il a suiv se tirer de toutes nos embûches, Je me vois confondu, toi-même tu trébuches, Le Roi d'un grand festin honore son retour, Sa paix est affermie, il brille dans sa Cour, Il triomphe de nous et de nos calomnies, Par un supplice affreux nous les verrons punies, Pour comble de pu qui vont tomber Il nous, Il nous fera sentira sentira sentira sen;
si nous ne trouvons pas d’expedient contraire nous ſommes ſûrement trés-mal dans nos affaires:	si nous ne trouvons pas d'expédient contraire nous sommes sûrement très-mal dans nos affaires:
Dariaces.	Dariaces.
Sur ce point, cher amy, je vay te conſoler, Raſſûre ton eſprit, écoute-moy parler, L’affaire en queſtion eſt de grande importance, Il faut certainement beaucoup de vigilance Pour en venir about je ſçay de bons moyens, Sans demander l’apuy d’aucuns des Citoyens, Et pour peu que le Ciel ſe montre favorable, Ou plûtôt que l’Enfer daigne être ſecourable, Nous en verrons bientôt l’avantageux ſuccez, Le Roy fera du Prince inſtruire le procez:	Sur ce point, cher ami, je vais te consoler, Rassurre ton esprit, écoute-moi parler, L'affaire en question est de grande importance, Il faut certainement beaucoup de vigilance Pour en venir about je sais de bons moyens, Sans demander l'apuy d'aucuns des Citoyens, Et pour peu que le Ciel se montre favorable, Ou plutôt que l'Enfer daigne être secourable, Nous en verrons bientôt l'avantageux succès, Le Roi fera du Prince instruire le procès:
Tu ſçais qu’il eſt Chrêtien, c’eſt ce qu’il faut luy quIl ne changera point pour gouverner l’Empire Il eſt trop affermy dans ſa Religion Pour en quitter l’amour & la profeſſion, Cette adreſſe en ce point ne ſera point ſuſpecte, Le Roy, comme tu ſçais;	Tu sais qu'il est Chrétien, c'est ce qu'il faut rien quIl ne changera point pour gouverner l'Empire Il est trop affermi dans sa Religion Pour en quitter l'amour et la profession, Cette adresse en ce point ne sera point suspecte, Le Roi, comme tu sais;
deteſte cette Secte, En voilà bien aſſez pour aigrir ſon eſprit, Il s’agit de prouver ce crime par écrit.	deteste cette Secte, En voilà bien assez pour aigrir son esprit, Il s'agit de prouver ce crime par écrit.
I’en ay déja dreſſé la lettre contrefaite, Je feins que les Chrêtiens méditent ſa defaite, Que le Prince par eux en eſt follicité;	J'en ai déjà dressé la lettre contrefaite, Je feins que les Chrétiens méditent sa défaite, Que le Prince par eux en est sollicité;
Allons le déferer avec ſubtilité :	Allons le déférer avec subtilité :
Mais le voilà qui vient, entendons-nous enſemble,	Mais le voilà qui vient, entendons-nous ensemble,
SCENE TROISIE'ME LEVIGILDE, HERMENEFRIDE, DARIACES.	SCÈNE -TROISIE'ME LEVIGILDE, HÉRMENEFRIDE, DARIACES.
Levigilde.	Levigilde.
Ue faites.	Que faites.
vous icy!	vous ici!
quel ſujet vous aſſemble?	quel sujet vous assemble?
Pourquoy ne pas venir me lane un compliment, Sur le retour heureux d’un Prince ſi charmant, Dont la preſence a mis toute la Cour en joye;	Pourquoi ne pas venir me lane un compliment, Sur le retour heureux d'un Prince si charmant, Dont la présence a mis toute la Cour en joie;
Dariaces.	Dariaces.
Ah!	Ah!
Sire, nôtre cœur dans la douleur ſe noye, D’un cruel attentat nous preſſentons les coups, Vos fideles Sujets s’affligent comme nous, Nous laiſſons à l’écart ceux qui vous congratulent, Ils cherchent vôtre mort, quoiqu’ils le diſſimulent Fortement attachez à l’inclination De vous ſervir toûjours avec affection, A la veille de voir éclore un ſi grand crime, "eur Jeys ute jeul duiolt ilegleines	Sire, notre cœur dans la douleur se noie, D'un cruel attentat nous pressentons les coups, Vos fidèles Sujets s'affligent comme nous, Nous laissons à l'écart ceux qui vous congratulent, Ils cherchent votre mort, quoiqu'ils le dissimulent Fortement attachés à l'inclination De vous servir toujours avec affection, À la veille de voir éclore un si grand crime, "eur à ute jeute duiolt ilegleines
Levigi lde.	Levigi de.
je me flatois d’avoir mille contentemens, Et vous ne me parlez que de gemiſſemens.	je me flattais d'avoir mille contentements, Et vous ne me parlez que de gémissements.
Forme-t’on contre moy quelque nouvelle intrigue,	Forme-t-on contre moi quelque nouvelle intrigue,
Hermene fride.	Hermène fride.
sire, ſi vous voulez, nous vous dirons la brigue;	sire, si vous voulez, nous vous dirons la brigue;
Levigilde, la diigde a ens depuis quand:	Levigilde, la diigde a ens depuis quand:
Dariaces.	Dariaces.
Ah vous êtes, grand Roy;	Ah vous êtes, grand Roi;
Sur le point d’éprouver qu’on vous manque de foy, si des heureux deſtins contre eux ne vous délivrent, Au plus tragique ſort vos ennemis vous livrent.	Sur le point d'éprouver qu'on vous manque de foi, si des heureux destins contre eux ne vous délivrent, Au plus tragique sort vos ennemis vous livrent.
Levigilde.	Levigilde.
Vous faites aujourd’huy de fort mauvais loupçons, Le retour de mon Fils renverſe vos raiſons, La paix regne entre nous, la tempête eſt calmée,	Vous faites aujourd'hui de fort mauvais loupçons, Le retour de mon Fils renverse vos raisons, La paix règne entre nous, la tempête est calmée,
Hermene fride.	Hermène fride.
Ah plût à Dieu qu’il fût encor à ſon Armée !	Ah plût à Dieu qu'il fût encor à son Armée !
quurid on pouridie le craimre nmeroit decouvert, Quelles précautions contre un Fils ſi couvert?	quurid on pourridié le craimre nmerait découvert, Quelles précautions contre un Fils si couvert?
Levigilde.	Levigilde.
Eh!	Eh!
qu’elle eſt donc encor cette brigue maudit, Et qu’avez-vous appris des deſſeins qu’on médite?	qu'elle est donc encor cette brigue maudit, Et qu'avez-vous appris des desseins qu'on médite?
D’en ſoupçonner le Prince, il ne m’eſt pas permis, re voilà de retour à mes ordres ſoûmis.	D'en soupçonner le Prince, il ne m'est pas permis, re voilà de retour à mes ordres soumis.
Dariaces.	Dariaces.
Que je ſuis malheureux!	Que je suis malheureux!
faut-il que je le diſe, Et que je faſſe voir celuy qui ſe déguiſe ?	faut-il que je le dise, Et que je fasse voir celui qui se déguise ?
vôtre bonheur, grand Roy, vous met en ſûreté, Mais pour mieux vous marquer nôtre fidelité, C’eſt à nous de veiller à conſerver la vie, aacelay dent depena cene de la laulz	votre bonheur, grand Roi, vous met en sûreté, Mais pour mieux vous marquer notre fidélité, C'est à nous de veiller à conserver la vie, aacelai dent dépena cène de la ulz
Levigilde.	Levigilde.
Quoy ſe trouveroit-il encore contre moy, Quelques ſecrets complots à donner de l’effroy!	Quoi se trouverait-il encore contre moi, Quelques secrets complots à donner de l'effroi!
Dariaces, Ah!	Dariaces, Ah!
Sire, vôtre Fils, faut-il que je le nomme?	Sire, votre Fils, faut-il que je le nomme?
b nentier preromptif de vôtre grand Royaume,, Hermenegilde enfin, que vous croyez ſoûmis, S’eſt ligué par ſerment avec vos ennemis;	b nentier promptif de votre grand Royaume, Hermenégilde enfin, que vous croyez soumis, S'est ligué par serment avec vos ennemis;
Levigilde.	Levigilde.
s’eſt ligué, dites-vous ?	s'est ligué, dites-vous ?
Dariacer.	Dariacer.
.	.
Je dois encor vous dire.	Je dois encor vous dire.
Qu’il eſt Chrêtien Romain, & combat vôtre Empire	Qu'il est Chrétien Romain, et combat votre Empire
Comment, il eſt Lat-n!	Comment, il est Lat-n!
Le vigilde.	Le vigilde.
Dariaces.	Dariaces.
Ouy, Sire, il eſt Latin, Je ne puis ſur cela vous cacher mon chagrin, Quand il aura reçû le Sceptre du Royaume, Il fera triompher le Pontife de Rome;	Oui, Sire, il est Latin, Je ne puis sur cela vous cacher mon chagrin, Quand il aura reçu le Sceptre du Royaume, Il fera triompher le Pontife de Rome;
Levigilde.	Levigilde.
Ce diſcours me ſurprend,	Ce discours me surprend,
Dariaces.	Dariaces.
Cela me fait norreur, ’ay peine à vous le dire, & j’en tremble de peur, Sire, vos ennemis méditont vôtre perte, La voye à ce deſſein ne s’étoit point ouverte, Ils n’ont pû réũſſir en vous donnant combat, Leur fureur à preſent ſans ceſſe ſe débat, Et c’eſt par vôtre Fils qu’agit leur artifice, Par de mauvais conſeils il ſoûtient leur malice, Il eſt même, dit-on engagé par ſerment, Qu’il feindroit avec vous un tendre engagement, Qu’il viendroit à la Cour ménager vos careſſes, Tachant de vous gagner par de belles promeſſes, Et qu’il ne manqueroit à leur convention, Sitôt qu’il en auroit trouvé l’occaſion, Et ſi vous en doutez, cette lettre ſurpriſe.	Cela me fait norreur, aay peine à vous le dire, et j'en tremble de peur, Sire, vos ennemis médit votre perte, La voie à ce dessein ne s'était point ouverte, Ils n'ont pu réũssir en vous donnant combat, Leur fureur à présent sans cesse se débat, Et c'est par votre Fils qu'agit leur artifice, Par de mauvais conseils il soutient leur malice, Il est même, dit-on engagé par serment, Qu'il feindrait avec vous un tendre engagement, Qu'il viendrait à la Cour ménager vos caresses, Tachant de vous gagner par de belles promesses, Et il ne manqueroit leur convention, Sitôt il en auroit trouvé occasion, Et si vous en doutez, cette lettre surprise.
Pourra vous decouvrir leur damnable entrepriſe.	Pourra vous découvrir leur damnable entreprise.
Le Roi piend la letu	Le Roi piend la lu
SCLNEQEAIRIEME LEVIGILDE, HERMENEFRIDE DARIACE SOPHRON.	SCLNEQEAIRIEME LEUIGILDE, HERMENEFRIDE DARIACE SOPHRON.
Sophron.	Sophron.
Et écrit le condamne, il n’eſt rien de plus fo C Si ce n’eſt point menſonge, Hermenegilde a to Qui pourroit s’empêcher d’admirer l’artifice, Dont on ſe ſert ſouvent pour publier le vice, on affecte un déhors agreable & benin, Quand on cache en ſon cœur le plus ſubtil venin;	Et écrit le condamne, il n'est rien de plus fo Ç Si on n'est point mensonge, Hermenegilde a to Qui pourrait s'empêcher d'admirer l'artifice, Dont on se sert souvent pour publier le vice, on affecte un déhors agréable et bénin, Quand on cache en son cœur le plus subtil venin;
Mais comme cette affaire eſt de grande importance Il ne faut pas ſitôt juger ſur l’apparence.	Mais comme cette affaire est de grande importance Il ne faut pas sitôt juger sur l'apparence.
on doit prouver le fait dont on eſt accuſé, Car ſouvent un témoin peut être recuſé, Je croy donc qu’il faudroit envoyer au plus vîte Cnercher Hermenegilde, & ſur ce qu'on debite L’interroger à fond avec dexterité, que s’il s’eſt fait Chrêtien de lon tutnome, S’il s’eſt joint aux ligueurs pour une tente arrane, vous ſçavez là-deſſus ce que vous devez faire.	on doit prouver le fait dont on est accusé, Car souvent un témoin peut être recusé, Je crois donc qu'il faudrait envoyer au plus vite Conte Hermenegilde, et sur ce qu'on débite L'interroger à fond avec dexterité, que s'il s'est fait Chrétien de lon tutome, S'il s'est joint aux ligueurs pour une tente arrane, vous savez là-dessus ce que vous devez faire.
Levigilde.	Levigilde.
parlaivlay votre avias qu'on le mane venir, S’il ſe trouve coupable, il faudra le punir.	parlaivlai votre avias qu'on le mane venir, S'il se trouve coupable, il faudra le punir.
Dariaces.	Dariaces.
Sire permettez-moy d’éviter ſa preſence, Il cionore que par nous vous iȩaven lon offence	Sire permettez-moi d'éviter sa présence, Il cionore que par nous vous jet lon offense
CCENEGINQOIEME.	CCENEGINQOIEME.
LEVIGILDE HERME NEGILDE.	LEUIGILDE HERME NEGILDE.
tevigilde.	tevigilde.
Monſtre abominable!	Montre abominable!
ô Fils denaturé!	ô Fils denaturé!
O oſes-tu devant moy d’un viſage aſſûré, Te montrer tout noirci du plus horrible crime?	Ô oses-tu devant moi d'un visage assuré, Te montrer tout noirci du plus horrible crime?
Et quand je te fais voir plus d’amour & d’eſtime, A quel prix, malheureux, as-tu vendu mon ſang?	Et quand je te fais voir plus d'amour et d'estime, À quel prix, malheureux, as-tu vendu mon sang?
T’ay-je donc élevé dans un illuſtre rang, Pour me fouler aux pieds & m’arrâcher la vie?	T'ai-je donc élevé dans un illustre rang, Pour me fouler aux pieds et m'arrâcher la vie?
Cet attentat, dit-on a flâté ton envie, Quoy donc lorſque pour toy du ſoir juſqu’au meci.	Cet attentat, dit-on a flamté ton envie, Quoi donc lorsque pour toi du soir jusqu'au meci.
Je regale ma Cour d’un ſomptueux feſtin, Méditant contre moy la plus noire entrepriſe, Tu peux l’executer ſans aucune remiſe?	Je règale ma Cour d'un somptueux festin, Méditant contre moi la plus noire entreprise, Tu peux l'exécuter sans aucune remise?
Quoy!	Quoi!
dans le tems, perfide, où je faiſois des vœux, Pour conſerver ta vie & l’obtenir des Cieux, Tu penſois aux moyens de détruire la mienne?	dans le temps, perfide, où je faisais des vœux, Pour conserver ta vie et l'obtenir des Cieux, Tu pensais aux moyens de détruire la mienne?
Tu merites a bon droit qu'on retranche la tienne?	Tu mérites a bon droit qu'on retranche la tienne?
Ton crime fait horreur à tout le genre humain, Et tu peux affecter un viſage ſerein.	Ton crime fait horreur à tout le genre humain, Et tu peux affecter un visage serein.
Hermenegilde.	Hermènegilde.
Qu’ay-je fait, & quel eſt le crime qu’on ſupoſe?	Qu'ai-je fait, et quel est le crime qu'on supose?
Je ſçauray me laver du faux que l’on m’impoſe.	Je saurai me laver du faux que l'on m'impose.
LevigildePrince le plus ingrat, indigne de ton rang, Tu veux tremper tes mains dans mon illuſtre ſang Prétends-tu te couvrir d’une fauſſe innocence	LevigildePrince le plus ingrat, indigne de ton rang, Tu veux tremper tes mains dans mon illustre sang Prétends-tu te couvrir d'une fausse innocence
Hermeneg lde.	Hermèneg lède.
on ne pourra jamais prouver ce qu’on avance, Ecoutez-vous encor des calomniateurs, Dont il faut redouter les diſcours ſeducteurs?	on ne pourra jamais prouver ce qu'on avance, Écoutez-vous encor des calomniateurs, Dont il faut redouter les discours séducteurs?
Plus je ſonde mon cœur, & plus je m’examine, Moins je connois le mal, & moins je le devine;	Plus je sonde mon cœur, et plus je m'examine, Moins je connais le mal, et moins je le devine;
Parler, & marquez-moy quel eſt mon attentat, Et voyons ſi mon crime eſt un crime d’Etat.	Parler, et marquez-moi quel est mon attentat, Et voyons si mon crime est un crime d'État.
Levigilde.	Levigilde.
Admirez de ce port la maniere engageante, cette taille ſi belle & ſa bouche riante, Ces dents blanches, ce front, & cet air ſi charmant, Ces beaux dehors pour moy ſont un raviſſement, Ah!	Admirez de ce port la manière engageante, cette taille si belle et sa bouche riante, Ces dents blanches, ce front, et cet air si charmant, Ces beaux dehors pour moi sont un ravissement, Ah!
Prince infortuné, que je ſuis miſerable ?	Prince infortuné, que je suis misérable ?
C’eſt par ces qualités qu’il paroiſſoit aimable, Mais ſon perfide cœur me fut toûjours caché, Le pruo jele confomo muomomm puolt touché;	C'est par ces qualités qu'il paraissait aimable, Mais son perfide cœur me fut toujours caché, Le pruo jele confomo muomommom puolt touché;
Hermenegilde.	Hermènegilde.
A vos plaintes, grand Roy, mon cœur eſt trop ſenſible Mais il eſt innocent, la preuve en eſt viſible.	À vos plaintes, grand Roi, mon cœur est trop sensible Mais il est innocent, la preuve en est visible.
Levigilde.	Levigilde.
Deffends-toy, parricide, & prouve ſi tu peux, Qu’on te ſupoſe un crime énorme, je le veux;	Défends-toi, parricide, et prouve si tu peux, Qu'on te supose un crime énorme, je le veux;
Mais vois-tu cet écrit, connois-tu cette lettre !	Mais vois-tu cet écrit, connais-tu cette lettre !
Hermenegilde.	Hermènegilde.
Je ne la connois point, Levigilde.	Je ne la connais point, Levigilde.
Tu feins la méconnoitre;	Tu feins la méconnaître;
Ah!	Ah!
quelle effronterie!	quelle effronterie!
il ne la connoit poizt, Une audace peut-elle arriver à ce point?	il ne la connaît poilés, Une audace peut-elle arriver à ce point?
Quoy!	Quoi!
tu n’en connois pas la main ny l’écriture?	tu n'en connais pas la main ni l'écriture?
Qui ſont tes Conſeiſlers dans cette conjoncture?	Qui sont tes Conseîlers dans cette conjoncture?
Les exhortations des Grecs & des Latins Pour te faire avec eux ſoulever les mutins, Et te faire attenter à ma propre perſonne;	Les exhortations des Grecs et des Latins Pour te faire avec eux soulever les mutins, Et te faire attenter à ma propre personne;
Ce ſont les bons conſeils qu’un chacun d’eux te donne.	Ce sont les bons conseils qu'un chacun d'eux te donne.
Hermenegilde, Les Grecs & les Latins que je crois ſans pareils Ne m’ont jamais donné que de ſages conſeils, Par eux je ſuis inſtruit de reſpecter mon Pere, De l’aimer Arrien de même que la merci D’obeïr à ſes loix autant que je pourray, Jamais de ces devoirs je ne m’eloigneray.	Hermènegilde, Les Grecs et les Latins que je crois sans pareils Ne m'ont jamais donné que de sages conseils, Par eux je suis instruit de respecter mon Père, De l'aimer Arrien de même que la merci D'obéir à ses lois autant que je pourrai, Jamais de ces devoirs je ne m'éloignerai.
Levigilde.	Levigilde.
Il eſt vray que ta fuite & tes grandes armées, Pour agir contre moy par la rage animées, Teuyent tropmuidrerde con anecuon, Et marquent les effets de ta ſoûmiſſion.	Il est vrai que ta fuite et tes grandes armées, Pour agir contre moi par la rage animées, Teuyent tropmuidrerde con anécuon, Et marquent les effets de ta soumission.
Hermenegilde.	Hermènegilde.
Ah!	Ah!
ſi de tout cela vous me parlez encore, Nous ne ſortirons pas d’un cahos que j’abhorre.	si de tout cela vous me parlez encore, Nous ne sortirons pas d'un cahos que j'abhorre.
Levigilde.	Levigilde.
pour te confondre, ingrat, je connois le moyen Répons-moy n’eſt-tu pas & Romain & Chrêtien?	pour te confondre, ingrat, je connais le moyen Réponds-moi n'est-tu pas et Romain et Chrétien?
Hermenegilde, Deſirant le ſçavoir, une liberté ſainte, Doit me faire aujourd’huy le découvrir ſans crainte, Juſque a icy cependant, pour ne vous point fâcher, La crainte & la pudeur m’ont fait vous le cacher:	Hermènegilde, Désirant le savoir, une liberté sainte, Doit me faire aujourd'hui le découvrir sans crainte, Jusque a ici cependant, pour ne vous point fâcher, La crainte et la pudeur m'ont fait vous le cacher:
oui?	oui?
, mon Pere, Je ſuis Chrêtien, bon Catholique, Et pour tout dire enfin, Romain Apoſtolique, Non, rien ne me fera quitter un nom ſi beau, Et je le porteray juſques dans le tombeau.	, mon Père, Je suis Chrétien, bon Catholique, Et pour tout dire enfin, Romain Apostolique, Non, rien ne me fera quitter un nom si beau, Et je le porterai jusque dans le tombeau.
Levigilde.	Levigilde.
O ſacrilege impie!	Ô sacrilège impie!
ô monſtre deteſtable, De ſe glorifier de ce nom execrable, Et ſous ce voile affreux cacher ſa trahiſon !	ô montre détestable, De se glorifier de ce nom exécrable, Et sous ce voile affreux cacher sa trahison !
Perfide, as-tu perdu le ſens & la raiſon ?	Perfide, as-tu perdu le sens et la raison ?
Hermenegilde.	Hermènegilde.
oüi, Seigneur, ce beau nom fait ma plus grande gloire, Et je l’auray toûjours gravé dans la mémoire, En eſt-il ſous le ciel qui ſoit plus éclatant?	oui, Seigneur, ce beau nom fait ma plus grande gloire, Et je l'aurai toujours gravé dans la mémoire, En est-il sous le ciel qui soit plus éclatant?
Vôtre titre de Roy ne ſçauroit l’être tant;	Votre titre de Roi ne saurait l'être tant;
Que dis-je?	Que dis-je?
il n’en eſt pas qui luy ſoit comparable, Ah plût à Dieu, grand Roy, que ce nom venerable, Se trouva joint au vôtre, à vôtre dignité!	il n'en est pas qui lui soit comparable, Ah plut à Dieu, grand Roi, que ce nom vénérable, Se trouva joint au vôtre, à votre dignité!
Il vous feroit briller par plus de Majeſté.	Il vous ferait briller par plus de Majesté.
Levigilde.	Levigilde.
O Dieu!	Ô Dieu!
quel inſenſé, quel étrange genie, De ſouhaiter que j’ayeune telle manie!	quel insensé, quel étrange génie, De souhaiter que j'ai telle manie!
Loin de moy, de ma race.	Loin de moi, de ma race.
un pareil deshonneur, Je me croirois tombé dans le plus grand malheur, ll te faut renoncer à cette ſecte infame, Deteſter ton erreur, éclairer mieux ton ame, Et ſi tu n’obéis à mes commandemens, je te feray ſentir de rudes châtimens.	un pareil déshonneur, Je me croirais tombé dans le plus grand malheur, ll te faut renoncer à cette secte infâme, Detester ton erreur, éclairer mieux ton âme, Et si tu n'obéis à mes commandements, je te ferai sentir de rudes châtiments.
Hermenegilde.	Hermènegilde.
Quoy!	Quoi!
renoncer le Dieu de qui je tiens la vie;	renoncer le Dieu de qui je tiens la vie;
En vain vôtre fureur aujourd’huy m’y convie, Pour loũer ce grand Dieu pendant l’éternité, Je pretends le ſervir avec fidelité, Je deffendray ma foy, c’eſt ce que je proteſte,, Vôtre culte eſt impie, & mon cœur le deteſte.	En vain votre fureur aujourd'hui m'y convie, Pour loumer ce grand Dieu pendant l'éternité, Je prétends le servir avec fidélité, Je défendrai ma foi, c'est ce que je proteste, Votre culte est impie, et mon cœur le déteste.
Levigilde.	Levigilde.
Quelle honte à ma race!	Quelle honte à ma race!
& qui l’auroit penſé Qon enane loi a ley cet apiit imleme, Au lieu de ſes habits que d’un ſac on le couvre, qu’il ne paroiſſe plus deſormais dans le louvre.	et qui l'aurait pensé Qon enane lois a lei cet apiit imle, Au lieu de ses habits que d'un sac on le couvre, qu'il ne paraisse plus désormais dans le louvre.
Hermenegilde.	Hermènegilde.
Je quitte avec plaiſir ce pompeux appareil, Les amans de la Croix n’en ont point de pareil, joinamtoye du ueigneur la graec qur m’arrive, Que je peux appeller une grace tardive, O vetemens Royaux, delicats, éclatans, Que vous couvrez, helas!	Je quitte avec plaisir ce pompeux appareil, Les amants de la Croix n'en ont point de pareil, joinamoie du ouveigneur la graec qur ive, Que je peux appeler une grâce tardive, Ô vetemens Rois, délicats, éclatants, Que vous couvrez, hélas!
de chagrins en tout temps:	de chagrins en tout temps:
Levigilde.	Levigilde.
Allez ſans differer le mettre dans les chaines,	Allez sans différer le mettre dans les chaines,
Hermenegilde.	Hermènegilde.
Je les embraſſeray, j’en ſouffriray les peines, Déja je les préfere aux cordons de nos Roys Et par elles je veux m’attacher à la Croix.	Je les embrasserai, j'en souffrirai les peines, Déjà je les préfère aux cordons de nos Rois Et par elles je veux m'attacher à la Croix.
Levigilde.	Levigilde.
Il faut que ma fureur à preſent ſe déploye, qu’on le tienne en priſon juſqu’à ce que je voye De quel genre de mort je le feray perir Un ſuplice ordinaire eſt peu pour le punir, D’un bon Pere outragé trop juſte eſt la vengeance, Qui d’un barbare Fils deteſte l’inſolence,	Il faut que ma fureur à présent se déploie, qu'on le tienne en prison jusqu'à ce que je voie De quel genre de mort je le ferai périr Un suplice ordinaire est peu pour le punir, D'un bon Père outragé trop juste est la vengeance, Qui d'un barbare Fils déteste l'insolence,
Cardaces.	Cardaces.
O que la joye eſt courte!	Ô que la joie est courte!
O ciel l qui l’auroit crû, Qu’à cette extrêmité le mal ce fut accrù?	Ô ciel l qui 'aurait cru, Qu'à cette extrémité le mal ce fut accrù?
O Prince malheureux!	Ô Prince malheureux!
en vous perdant vous-même, Je me perds avec vous dans ce malheur extrême.	en vous perdant vous-même, Je me perds avec vous dans ce malheur extrême.
SODMDSIAIEME.	SODMDSIAIEME.
IGERDES.	IGERDES.
Déteſtable crime!	Détestable crime!
un Prince eſt dans les fers, O Des barbares cruels ont cauſé ce revers, Helas que de malheurs ſuivent de prés la joye!	un Prince est dans les fers, Ô Des barbares cruels ont causé ce revers, Hélas que de malheurs suivent de près la joie!
Mon cœur dans la triſteſſe & la douleur ſe noyeje vois un jeune Prince aimable & raviſſant, En priſon pour des faits dont il eſt innocent, La vengeance d’un Pere en ce jour ſe declare, Contre ſon propre fils elle n’eſt point avare, Qui l’auroit pû penſer qu’à cette extremité, Son couroux paternel ſe put voir irrité?	Mon cœur dans la tristesse et la douleur se noieje vois un jeune Prince aimable et ravissant, En prison pour des faits dont il est innocent, La vengeance d'un Père en ce jour se déclare, Contre son propre fils elle n'est point avare, Qui l'aurait pu penser qu'à cette extrémité, Son courroux paternel se put voir irrité?
Ah!	Ah!
pauvre Eraſiſtrate, en cette conjoncture, Je prévois de ton cœur la triſteſſe future, Aprenant ces malheurs tu ſeras conſterné, quel ſera ton chagrin de le voir enchainé, Moi-méme à ce moment du ſeul récit je tremble Mais qui s’avance icy?	pauvre Erasistrate, en cette conjoncture, Je prévois de ton cœur la tristesse future, Aprenant ces malheurs tu seras consterné, quel sera ton chagrin de le voir enchaîné, Moi-même à ce moment du seul récit je tremble Mais qui s'avance ici?
le voilà ce me ſemble,	le voilà ce me semble,
SCENE SEPTIEME.	SCÈNE SEPTIÈME.
IGERDES ERASISTRATE,	IGERDES ERASISTRATE,
lgtratf.	légtratf.
On cher Eraſiſtrate éloignez vous d’icy, M ruyez, épargnez vous le plus mortel ſoucv,	On cher Erasistrate éloignez -vous d'ici, M ruiez, épargnez -vous le plus mortel soucu,
Es tu fou?	Es tu fou?
Frafiſtrate	Frafistrate
Igerdes.	Igerdes.
helas!	hélas!
non le malheur qu’on publie, Doit s’appeller fureur plûtôt qu’une folie,	non le malheur qu'on publie, Doit s'appeler fureur plutôt qu'une folie,
Eraſiſtrate.	Erasistrate.
D’où vient, que veux-tu dire?	D'où vient, que veux-tu dire?
Igerdes.	Igerdes.
o deſtin malheureux!	ô destin malheureux!
Tout eſt deſagreable & du dernier affreux,	Tout est désagréable et du dernier affreux,
Eraſiſtrate.	Erasistrate.
Dis-moy donc ce que c’eſt, pourquoy me fai re attencit, Et laſſer mon eſprit en voulant le ſurprendre?	Dis-moi donc ce que c'est, pourquoi me fait re attencit, Et lasser mon esprit en voulant le surprendre?
Igerdes.	Igerdes.
Ouy je le ſurprendray, car vous n’attendez pas, D’apprendre Hermenegilde à deux doigts du trépas, Empriſonné, lié, charge de groſſes chaînes, N’eſt ce pas un ſujet de partager ſes peines?	Oui je le surprendrai, car vous n'attendez pas, D'apprendre Hermenegilde à deux doigts du trépas, Emprisonné, lié, charge de grosses chaînes, N'est ce pas un sujet de partager ses peines?
Eraſiſtrate.	Erasistrate.
O Dieu!	Ô Dieu!
quel changement !	quel changement !
Igerder.	Igerder.
Je dis ce que j’ay vu,	Je dis ce que j'ai vu,
Eraſiſtrate.	Erasistrate.
O foudres!	Ô foudres!
cependant je les avois prévû, Une femme en fureur renverſe des Royaumes, perd un aimable Prince, & tous tant que nous ſommes, A ſes vrais interêts juſtement attachez Ton injuſte fureur, tes horribles pechez, O cruelle Marâtre, ô monſtre abominable, Ne font voir à nos yeux qu’un objet deteſtable, Grand Dieu, laiſſerez-vous ces crimes impunis ?	cependant je les avais prévu, Une femme en fureur renverse des Royaumes, perd un aimable Prince, et tous tant que nous sommes, À ses vrais intérêts jusqu' attachez Ton injuste fureur, tes horribles péchez, Ô cruelle Marâtre, monstre abominable, Ne font voir nos yeux un objet détestable, Grand Dieu, laisserez-vous ces crimes impunis ?
Les foudres, les carreaux, dont vos bras ſont munis.	Les foudres, les carreaux, dont vos bras sont munis.
Ne tomberont-ils pas ſur ſa coupable téte.	Ne tomberont-ils pas sur sa coupable tête.
Que ne l’accablez vous d’une horrible tempête, Le jour à ſon egard devroit s’aneantir, La terre s’entr’ouvrant la devroit engloutir, O megere execrable!	Que ne l'accablez -vous d'une horrible tempête, Le jour à son égard devrait s'anéantir, La terre s'entra la devroit engloutir, Ô mégère exécrable!
& qui n’eſt que pour nuire, En faveur des humains nous devons te detruire, Mon épée en ce jour en dépit de ton rang, Ouy j’iray t’attaquer & d’une ardeur extrême, Je te feray mourir, ou je mouray moy-mẽme.	et qui n'est que pour nuire, En faveur des humains nous devons te détruire, Mon épée en ce jour en dépit de ton rang, Oui j'irai t'attaquer et d'une ardeur extrême, Je te ferai mourir, ou je mourai moi-même.
Igerdes.	Igerdes.
Suſpendez pour un tems votre juſte courroux Quoy ne ſçavez-vous pas que tout au tour de nous, Se trouvent des ſoldats qui peuvent nous entendre, Auprés d’Hermenegilde allez vlte vous rendre, offrez-luy ſans delay des ſervices d’amour, Vous pouvez empêcher qu’il ne perde le jour, Allons, Eraſiſtrate, a ceux que l’on abuſe, Des calomniateurs déveloper la ruſe, Il le faut au plûtôt, ſans attendre à demain;	Suspendez pour un temps votre juste courroux Quoi ne savez-vous pas que tout au tour de nous, Se trouvent des soldats qui peuvent nous entendre, Auprès d'Hermenegilde allez vlte vous rendre, offrez-lui sans délai des services d'amour, Vous pouvez empêcher qu'il ne perde le jour, Allons, Erasistrate, a ceux que l'on abuse, Des calomniateurs développer la ruse, Il le faut au plu, sans tendre à demain;
Eraſiſtrate.	Erasistrate.
O Marâtre crauno a tout le geme humain?	Ô Marâtre crauno à tout le gème humain?
Fin du troiſiéme Acte.	Fin du troisième Acte.
ACTE QUATRIEME.	ACTE QUATRIÈME.
SCENE PREMIERE.	SCÈNE PREMIÈRE.
ERTTORIDE REGIRAIE	ERTORIDE RÉGIRAIE
Levigilde.	Levigilde.
Ue me demandez-vous?	Que me demandez-vous?
Recarede.	Récarède.
La priſon & les chaines?	La prison et les chaines?
Les plus affreux tourmens, les plus cruelles peines, La mort qui venge enfin Hermenegilde & moy, Du crime que j’ay fait de lui manquer de foy, Voilà ce qui m’afflige, & ce qui me conſole, C’eſt de n’avoir fait rien que ſur vôtre parole, Vous m’avez envoyé negocier la paix;	Les plus affreux tourments, les plus cruelles peines, La mort qui venge enfin Hermenegilde et moi, Du crime que j'ai fait de lui manquer de fo, Voilà ce qui m'afflige, et ce qui me console, C'est de n'avoir fait rien que sur votre parole, Vous m'avez envoyé négocier la paix;
C’étoit tous ſes deſirs, c’étoit tous mes ſouhaits, Il a reçû par moy cette heureuſe nouvelle, Je n’en pouvois, dit-il, recevoir de plus belle;	C'était tous ses désirs, c'était tous mes souhaits, Il a reçu par moi cette heureuse nouvelle, Je n'en pouvais, dit-il, recevoir de plus belle;
J’aime toûjours le Roy, je ne l’ay point hay, C’eſt donc par moy, seigneur, que vous l’avez trahy?	J'aime toujours le Roi, je ne l'ai point haï, C'est donc par moi, seigneur, que vous l'avez trahi?
Que vous l’avez conduit à cette boucherie, Par l’animoſité de la Reyne en furie, De vôtre Ambaſſadeur je deviens ſon bourreau?	Que vous l'avez conduit à cette boucherie, Par l'animosité de la Reine en furie, De votre Ambassadeur je deviens son bourreau?
L’olivier ſera teint du ſang de cet agneau, Ah!	L'olivier sera teint du sang de cet agneau, Ah!
Seigneur, appaiſez vôtre injuſte colere, Ne la dechargez pas ſur mon aimable frere, Mais ſi vous ne pouvez adoucir ce courroux, Faites tomber ſur moy la rigueur de vos coups;	Seigneur, apaisez votre injuste colère, Ne la déchargez pas sur mon aimable frère, Mais si vous ne pouvez adoucir ce courroux, Faites tomber sur moi la rigueur de vos coups;
Je me livre à la mort pour conſerver ſa vie, C'eſt à tort que l’on a contre luy de l’envie, je içay ion mocente, « je ra denendray Au peril de mes jours, où je ne le pourray.	Je me livre à la mort pour conserver sa vie, C'est à tort que l'on a contre lui de l'envie, je içay ion movente, " je ra denendrai Au péril de mes jours, où je ne le pourrai.
Levigilde.	Levigilde.
Quoy je conſerverois un traître, un parricide, Et comment oſez-vous deffendre un fraticide?	Quoi je conserverais un traître, un parricide, Et comment osez-vous défendre un fraticide?
c’eſt être aſſûrément contre vous furieux, Cteb de voue ciplle ce uenein ligouleua, Peut-il jamais venir dans l’eſprit d’aucun homme?	c'est être assurément contre vous furieux, Cteb de voue ciplle ce uenein ligouleua, Peut-il jamais venir dans l'esprit d'aucun homme?
Souffrez qu’on vous aſſûre aprés moy le Royaume.	Souffrez qu'on vous assoure après moi le Royaume.
Recarede.	Récarède.
Ah!	Ah!
Seigneur, bien plûtôt à vos pieds je mourray, Et de mon propre ſang je les arroſeray, n partume jaumn vos genoun que jembraſſe, Que je n’aye obtenu de mon frere la grace, si vous ne l’accordez, préparez aujourd’huy Un tombeau ſuffiſant pour me mettre avec luy.	Seigneur, bien tôt à vos pieds je mourrai, Et de mon propre sang je les arroserai, n ume jaumn vos genn que jembrasse, Que je n'aie obtenu de mon frère la grâce, si vous ne l'accordez, préparés aujourd'hui Un tombeau suffisant pour me mettre avec lui.
Levigilde.	Levigilde.
Retirez.	Retirez.
vous d’icy furieux que vous êtes,	vous d'ici furieux que vous êtes,
Recarede.	Récarède.
J’ay déja trop vêcu pour voir tant de tempêtes,	J'ai déjà trop vécu pour voir tant de tempêtes,
Levigilde.	Levigilde.
Qu’on le faſſe ſortir, il n’a point de raiſon, s’il ſçavoit comme moy la noire trahiſon.	Qu'on le fasse sortir, il n'a point de raison, s'il avait comme moi la noire trahison.
Recarede.	Récarède.
o ciel!	ô ciel!
ô foudre!	ô foudre!
ô Dieu, qui voyez la victime !	ô Dieu, qui voyez la victime !
Pouvez-veus bien ſouffrir qu’on commette un tel crime?	Pouvez-vus bien souffrir qu'on commette un tel crime?
SCENE SECONDE.	SCÈNE SECONDE.
LEVIGILDE, HERMENEFRIDE, SOPHRON, CARDACES.	LEUIGILDE, HÉRMENEFRIDE, SOPHRON, CARDACES.
Levigilde.	Levigilde.
Erfide, ingrat, cruel, deffends-toy ſi tu peux, T Ie doute que le Ciel ſoit propice à tes vœux.	Erfide, ingrat, cruel, défends-toi si tu peux, T Ie doute que le Ciel soit propice à tes vœux.
Hermenegilde.	Hermènegilde.
prouver mon innocence, eſt choſe aſſez facile;	prouver mon innocence, est chose assez facile;
Mais de la voir deffendre, il eſt plus difficile:	Mais de la voir défendre, il est plus difficile:
Preſque tous juſqu’icy dans mes plus grands malheurs N’ont point auprés de vous employé leurs faveurs;	Presque tous jusqu'ici dans mes plus grands malheurs N'ont point auprès de vous employé leurs faveurs;
Ils ſçavent cependant qu’elle eſt mon innocence, que ce qu’on dit de moy n’eſt qu’une médiſance;	Ils savent cependant qu'elle est mon innocence, que ce qu'on dit de moi n'est qu'une médisance;
Mes calomniateurs, de crimes infectez, Malicieuſement me les ont imputez, Contr’eux juſqu’à preſent vous etiés mon refuge;	Mes calomniateurs, de crimes infectez, Malicieusement me les ont imputez, Contr'eux jusqu'à présent vous étiez mon refuge;
Mais vous ne m’êtes plus qu’un implacable Juge.	Mais vous ne m'est plus qu'un implacable Juge.
Le ſenſible chagrin qui me perce le cœur, Et qui cauſe aujourd’huy ma plus vive douleur;	Le sensible chagrin qui me perce le cœur, Et qui cause aujourd'hui ma plus vive douleur;
C’eſt de voir la fureur devenir la plus forte:	C'est de voir la fureur devenir la plus forte:
Contre vôtre devoir on l’a voit qui l’emporte, Admis à vôtre table & dans vôtre Palais, où je me ſuis rendu pour y faire la paix, Vous m’en faites ſortir chargé de calomnies?	Contre votre devoir on l'a voit qui l'emporte, Admis à votre table et dans votre Palais, où je me suis rendu pour y faire la paix, Vous m'en faites sortir chargé de calomnies?
Accompagné partout de mille ignominies, Avec indignité l’on m’ôte mes habits, Je me vois ſans honneur au nombre des proſcrits;	Accompagné partout de mille ignominies, Avec indignité l'on m'ôte mes habits, Je me vois sans honneur au nombre des proscrits;
Mis dans une priſon auſſi ſombre qu’étroite, Jetté dedans les fers, aſſis ſur la ſellette, Si je me plains au Ciel d’un ſi dur traitement;	Mis dans une prison aussi sombre qu'étroite, Jeté dedans les fers, assis sur la sellette, Si je me plains au Ciel d'un si dur traitement;
ai pen veux appener a votre jugement, je ne puis eſperer qu’un Jugement contraire, De me plaindre de vous, je ne le veux pas faire?	ai pen veux appener à votre jugement, je ne puis espérer qu'un Jugement contraire, De me plaindre de vous, je ne le veux pas faire?
J’aimerois mieux ſubir les plus facheuſes loix, que de manquer jamais à ce que je vous dois.	J'aimerais mieux subir les plus fâcheuses lois, que de manquer jamais à ce que je vous dois.
Levigilde.	Levigilde.
De ce charmant diſcours admirés la fineſſe.	De ce charmant discours admirez la finesse.
Hermenegilde.	Hermènegilde.
Je parle ſans détour, j’explique ma tendreſſe;	Je parle sans détour, j'explique ma tendresse;
Et ſi vous ſouhaités que je ne diſe rien;	Et si vous souhaitez que je ne dise rien;
Mon ſilence pour moy s’expliquera fort bien.	Mon silence pour moi s'expliquera fort bien.
Levigilde.	Levigilde.
Je ſuis, pour t’écouter, Juge trop équitable;	Je suis, pour t'écouter, Juge trop équitable;
Prouve par tes raiſons que tu n’es pas coupable?	Prouve par tes raisons que tu n'es pas coupable?
Puis-je te condamner ſans t’être deffendu?	Puis-je te condamner sans t'être défendu?
Tout coupable à ſes droits & veut être entendu	Tout coupable à ses droits et veut être entendu
Hermenegilde, Puiſque vous le voulés, je parleray mon Pere;	Hermènegilde, Puisque vous le voulez, je parlerai mon Père;
Non qu’en me deffendant il ſoit rien que j’eſpere;	Non qu'en me défendant il soit rien que j'espère;
Mais le Ciel m’eſt témoin que mon plus grand déſir, Eſt de rendre à vos pieds juſqu’au dernier ſoupir:	Mais le Ciel m'est témoin que mon plus grand désir, Est de rendre à vos pieds jusqu'au dernier soupir:
Ah!	Ah!
s’il ne s’agiſſoit que de perdre la vie, Et que mes ennemis n’euſſent point d’autre envie, Avec bien du plaiſir je répandrois mon ſang;	s'il ne s'agissait que de perdre la vie, Et que mes ennemis n'eussent point d'autre envie, Avec bien du plaisir je répandrais mon sang;
Mais il ne ſeroit pas encore ſuffiſant;	Mais il ne serait pas encore suffisant;
Ils font tous leurs efforts pour obſcurcir ma gloire, D'une tache à rener toujours dans ia memone, Daignés donc m’écoûter & ſans prévention, Donnés à votre fils un peu d’attention,	Ils font tous leurs efforts pour obscurcir ma gloire, D'une tache à rener toujours dans ja mémone, Daignés donc m'écouter et sans prévention, Donnés à votre fils un peu d'attention,
Levigilde.	Levigilde.
Au fait, que diras-tu pour excuſer ton crime?	Au fait, que diras-tu pour excuser ton crime?
Hermenegilde.	Hermènegilde.
De Conſtance un Chrêtien contre un Juge s’anime;	De Constance un Chrétien contre un Juge s'anime;
Seigneur, je ne ſçay point par un crime nouveau;	Seigneur, je ne sais point par un crime nouveau;
Avoir de ſon merite effacé le tableau;	Avoir de son mérite effacé le tableau;
Gointhe depuis long-tems vôtre nouvelle épouſe, De nos proſperités ſe montre trop jalouſe;	Gointhe depuis longtemps votre nouvelle épouse, De nos prospérités se montre trop jalouse;
Elle eſt à nôtre égard plus dure que l’aymant, Son attrait eſt pour vous agréable & charmant, C’eſt nôtre belle-mere, il eſt vray je l’avouë, Et vôtre affection pour elle ſe dévouë, La nôtre luy devroit de même appartenir, Si la ſienne pour nous pouvoit s’entretenir:	Elle est à notre égard plus dure que l'aimant, Son attrait est pour vous agréable et charmant, C'est notre belle-mère, il est vrai je l'avoue, Et votre affection pour elle se dévoue, La nôtre lui devrait de même appartenir, Si la sienne pour nous pouvait s'entretenir:
Mais, helas!	Mais, hélas!
nous ſentons les effets de ſa haine.	nous sentons les effets de sa haine.
Et c’eſt ce qui nous cauſe une plus rude péine;	Et c'est ce qui nous cause une plus rude pêne;
C’eſt elle en abuſant de vôtre affection, Qui nous met avec vous dans la diviſion :	C'est elle en abusant de votre affection, Qui nous met avec vous dans la division :
Elle employe avec ſoin & l’adreſſe & la ruſe, Pour nous charger des faits dont elle nous accuſe;	Elle emploie avec soin et l'adresse et la ruse, Pour nous charger des faits dont elle nous accuse;
Ah!	Ah!
s’il étoit permis manes des bienheureux, De vous ſolliciter à deſcendre des Cieux, Je conduirois ma mere au trône de mon pere, Elle me deffendroit contre ma belle-mere:	s'il était permis mânes des bienheureux, De vous solliciter à descendre des Cieux, Je conduirais ma mère au trône de mon père, Elle me défendrait contre ma belle-mère:
Ah!	Ah!
Prince infortuné, quelle perte ay-je fait, Dans cette aimable mere où j’étois ſatisfait?	Prince infortuné, quelle perte ai-je fait, Dans cette aimable mère où j'étais satisfait?
Mon jeune âge pour lors m’empéchoit de connoître;	Mon jeune âge pour lors m'empêchait de connaître;
Le bonheur que j’avois, je le vois diſparoître;	Le bonheur que j'avais, je le vois disparaître;
Je n’éprouve à preſent que d’extrêmes rigueurs, A la place des ris je vois naître des yleurs;	Je n'éprouve à présent que d'extrêmes rigueurs, A la place des ris je vois naître des yleurs;
je ne peux plus chanter ies douceufs, les careſſes.	je ne peux plus chanter jes douceufs, les caresses.
D’un pere & d’une mere, & toutes leurs tendreſſes;	D'un père et d'une mère, et toutes leurs tendresses;
C’étoit à vous alors qu’étoit tout mon recours, Et vous m’aviés flatté de vôtre prompt ſecours, Vous étiés le premier pour eſſuyer mes larmes, Et pour me réjoûir, un objet plein de charmes.	C'était à vous alors qu'était tout mon recours, Et vous m'aviez flatté de votre prompt secours, Vous étiez le premier pour essuyer mes larmes, Et pour me réjouir, un objet plein de charmes.
Levigilde.	Levigilde.
Cela n’a nul rapport au crime en queſtion.	Cela n'a nul rapport au crime en question.
Hermenegilde.	Hermènegilde.
J’en parleray, Seigneur, un peu d’attention, Si-tôt que j’eût atteint la fleur de ma jeuneſſe, j’avois de vôtre cœur l’amour & la tendreſſe, I’en reſſentois toûjours d’avantageux effets, l’entrois dans vos deſſeins, je les tenois ſecrets, j’avois commandement ſur toutes vos armées;	J'en parlerai, Seigneur, un peu d'attention, Sitôt que j'eût atteint la fleur de ma jeunesse, j'avais de votre cœur l'amour et la tendresse, J'en ressentais toujours d'avantageux effets, l'entrais dans vos desseins, je les tenais secrets, j'avais commandement sur toutes vos armées;
j’ay veu des ennemis les troupes allarmées, Je des ay veu plier dans differens combats, J’en ay mis pluſieurs!	j'ai vu des ennemis les troupes alarmées, Je des ai vu plier dans différents combats, J'en ai mis plusieurs!
fois plus de dix mille à bas, J’ay toûjours eu ſur eux une entiere victoire, Vous en avés reçû par moy toute la gloire;	fois plus de dix mille à bas, J'ai toujours eu sur eux une entière victoire, Vous en avez reçu par moi toute la gloire;
vous em ctes couverende pamnes, de lauriers, Tout le Royaume eſt plein des effet des guerriers, Vous m’aimiés, je faiſois vos plus cheres delices.	vous em ôtes couverende pamnes, de lauriers, Tout le Royaume est plein des effet des guerriers, Vous m'aimiez, je faisais vos plus chères délices.
Levigilde.	Levigilde.
Il eſt vray, mais alors vous n’aviés point de vices.	Il est vrai, mais alors vous n'avez point de vices.
Hermenegilde.	Hermènegilde.
En ce tems, quoyque jeune, il vous plût m’allier A la fille d’un Roy, Princeſſe à marier, Son merite étoit rare, & plus recommandable, Par les hautes vertus qui la rendoient aimable, Que par les qualités qu’elle aſſemble à la fois, De fille, niéce, ſœur de Princes & de Roys, Avec elle étant joint par un ſaint mariage, Je rempli les devoirs où ce lien m’engage;	En ce temps, quoique jeune, il vous plût m'allier A la fille d'un Roi, Princesse à marier, Son mérite était rare, et plus recommandable, Par les hautes vertus qui la rendaient aimable, Que par les qualités qu'elle assemble à la fois, De fille, nièce, sœur de Princes et de Rois, Avec elle étant joint par un saint mariage, Je rempliage les devoirs où ce lien m'engage;
Je pouvois me flater d’un ſort le plus heureux, Et de ſa pieté je devins amoureux, Du flambeau de la foy m’éclairant la premiere, mans la pius ſombre nuit j’ay ſuivi ſa lumiere.	Je pouvais me flatter d'un sort le plus heureux, Et de sa piété je devins amoureux, Du flambeau de la foi m'éclairant la première, mans la pius sombre nuit j'ai suivi sa lumière.
Levigilde.	Levigilde.
Defſus un mechant arbre on cuëille un mauvais fruit:	Défsus un méchant arbre on cueille un mauvais fruit:
Hermenegilde.	Hermènegilde.
Pendant ce tems, Seigneur, où le Ciel m’a conduit, Par un ſecond hymen qui fait ma deſtinée, Vous avés épouſé Gointhe femme effrenée, D’un naturel hautain, farouche, imperieux, D’un eſprit ſombre, noir, cruel, malicieux, Auſſi-tôt qu’étant joint à la Dame Arrienne:	Pendant ce temps, Seigneur, où le Ciel m'a conduit, Par un second hymen qui fait ma destinée, Vous avez épousé Gointhe femme effrenée, D'un naturel hautain, farouche, impérieux, D'un esprit sombre, noir, cruel, malicieux, Aussitôt qu'étant joint à la Dame Arrienne:
Vous n’eûtes plus pour nous cette tendreſſe ancienne, De nouveaux feux pour elle enflâmant vôtre cœur, Cnueun de vos emais cut anes de maieur, Qu’aprés avoir été vos plus cheres délices, ils ne ſervirent plus que d’objets de ſupplices.	Vous n'eûtes plus pour nous cette tendresse ancienne, De nouveaux feux pour elle enflammant votre cœur, Cnueun de vos emais cut ânes de maïeur, Qu'après avoir été vos plus chères délices, ils ne servirent plus que d'objets de supplices.
Levigilde.	Levigilde.
Quoy!	Quoi!
ta bouche, inſolent, oſe ainſi me blâmer, D’une alliance heureuſe & qui doit me charmer?	ta bouche, insolent, ose ainsi me blâmer, D'une alliance heureuse et qui doit me charmer?
Hermenegilde.	Hermènegilde.
Je dis la verité qu’une femme en furie, Empẽche le repos, ſoûtient la calomnie, De ſes traits venimeux, nous ſommes attaqués, Et nos cœurs de ſon fiel ſe trouvent ſuffoques, Par tout où nous allons, nous rencontrons par elle Quelque nouveau tourment d’invention cruelle, Mon épouſe en reſſent vivement la douleur, Elle en eſt penetrée au profond de ſon cœur, La voulant obliger de ſe faire Arrienne, Et d’abjurer la foy de la ſecte Chrêtienne;	Je dis la vérité qu'une femme en furie, Emponche le repos, soutient la calomnie, De ses traits venimeux, nous sommes attaqués, Et nos cœurs de son fiel se trouvent suffoques, Par tout où nous allons, nous rencontrons par elle Quelque nouveau tourment d'invention cruelle, Mon épouse en ressent vivement la douleur, Elle en est pénétrée au profond de son cœur, La voulant obliger de se faire Arrienne, Et d'abjurer la foi de la secte Chrêtienne;
Voyant que ſon adreſſe étoit ſans aucun fruit, Que ſa rigueur non plus n’avoit de rien produit, N’ayant pû tirer d’elle aucune autre parole, Que celle qui toûjours dans ſes maux la conſole, ( je ſuis graces à Dieu, Chrétienne, & veut ſouffrir, que par mille tourmens on me faſſe mourir, Plutót que de jamais commettre un ſi grand crime, Que d’abjurer ma foy pour avoir vôtre eſtime,) La cruelle à ces mots, furieuſe en courroux, La battit rudement, la frappa de cent coups, la foulant à ſes pieds, & pat tEte vengcance, Fit ſortir de ſon corps le ſang en abondance, La menaçant encor de plus rudes tourmens.	Voyant que son adresse était sans aucun fruit, Que sa rigueur non plus n'avait de rien produit, N'ayant pu tirer d'elle aucune autre parole, Que celle qui toujours dans ses maux la console, ( je suis grâces à Dieu, Chrétienne, et veut souffrir, que par mille tourments on me fasse mourir, Plut que de jamais commettre un si grand crime, Que d'abjurer ma foi pour avoir votre estime,) La cruelle à ces mots, furieuse en courroux, La battit rudement, La frappa de cent coups, la foulant à ses pieds, et pat rAte vengance, Fit sortir de son corps le sang en abondance, La menaçant encor de plus rudes tourmens.
Si ſa ſoûmiſſion n’alloit à des ſermens.	Si sa soumission n'allait à des serments.
Levigilde.	Levigilde.
quel emane a ion perea parlé de la ſorte?	quel emane a ion pèrea parlé de la sorte?
Voyés donc, je vous prie où ſon ardeur l’emporte.	Voyez donc, je vous prie où son ardeur l'emporte.
Hermenegilde.	Hermènegilde.
Vous fermés bien, Seigneur, vôtre oreille au récit.	Vous fermez bien, Seigneur, votre oreille au récit.
De ces faits inhumains que ma langue déduit, Ils ſont ſi ſurprenans qu’un chacun les abhorre;	De ces faits inhumains que ma langue déduit, Ils sont si surprenants qu'un chacun les abhorre;
En voicy de plus grands que je vais dire encore, Non contente des maux que je viens de citer, Il en eſt de honteux que je vais raconter;	En voici de plus grands que je vais dire encore, Non contente des maux que je viens de citer, Il en est de honteux que je vais raconter;
Pour mieux venir about de ſa belle entrepriſe.	Pour mieux venir about de sa belle entreprise.
Et l’obliger enfin d’abandonner l’Egliſe, Au milieu de l’hyver on l’a fait dépoüiller, Et pour de plus en plus ſes douleurs reveiller;	Et l'obliger enfin d'abandonner l'Église, Au milieu de l'hiver on l'a fait dépouiller, Et pour de plus en plus ses douleurs réveiller;
On l’a plongé dans l’eau d’un étang plein de glace Par les mains des Bourreaux devant la populace, On la menace alors de ne l’en point tirer, qu’elle n’ait fait ſerment & promis d’abjurer;	On l'a plongé dans l'eau d'un étang plein de glace Par les mains des Bourreaux devant la populace, On la menace alors de ne l'en point tirer, qu'elle n'ait fait serment et promis d'abjurer;
Sans ceſſe on l’a preſſoit de ſe faire Arrienne, Sa réponſe toûjours étoit, je ſuis Chrêtienne, En ſouffrant tous ces maux & cet horrible affront, par ceux dont la fureur paroiſſoit ſur le front;	Sans cesse on l'a pressait de se faire Arrienne, Sa réponse toujours était, je suis Chrétienne, En souffrant tous ces maux et cet horrible affront, par ceux dont la fureur paraissait sur le front;
Sa patience étoit d’un chacun admirée, Jamais ne ſe plaignant d’être deshonorée, Son plus cruel ſupplice en cette extrémité Etoit le déplaiſir qu’on vît ſa nudité:	Sa patience était d'un chacun admirée, Jamais ne se plaignant d'être déshonorée, Son plus cruel supplice en cette extrémité Etoit le déplaisir qu'on vît sa nuité:
Le Soleil a-t’il vû pareille barbarie?	Le Soleil a-t-il vu pareille barbarie?
C’eſt le cruel effet d’une femme en furie, J’aurois pû me vanger, les armes à la main.	C'est le cruel effet d'une femme en furie, J'aurais pu me venger, les armes à la main.
De cette cruauté, de ce coup inhumain;	De cette cruauté, de ce coup inhumain;
Cependant de concert avec ma chere épouſe, Pour n’avoir plus preſente une femme jalouſe;	Cependant de concert avec ma chère épouse, Pour n'avoir plus présente une femme jalouse;
Nous fûmes dans Seville alors nous retirer, Beniſſant le deſtin qui nous fit admirer, La Maratre pour lors ſe croyant malheureuſe.	Nous fûmes dans Seville alors nous retirer, Bénissant le destin qui nous fit admirer, La Maratre pour lors se croyant malheureuse.
Ayant manqué ſon coup devint plus furieuſe, Sa malice entreprit pour noircir mon honneur?	Ayant manqué son coup devint plus furieuse, Sa malice entreprit pour noircir mon honneur?
De me faire paſſer pour un empoiſonneur, Un parricide, un traître à touté Patrie, Et l’ennemi juré de ſon idolatrie:	De me faire passer pour un empoisonneur, Un parricide, un traître à touté Patrie, Et l'ennemi juré de son idolâtrie:
Plût à Dieu, qu’écoûtant ſes rapports impoſteurs;	Plût à Dieu, qu'écoutant ses rapports imposteurs;
Vous ne les euſſiés crû que comme ſeducteurs!	Vous ne les eussiez cru que comme séducteurs!
Vous n’auriés pas levé contre moy des armées, On ne les verroit pas de fureur animées;	Vous n'auriez pas levé contre moi des armées, On ne les verrait pas de fureur animées;
C’eſt pour nous preſerver de cette oppreſſion, Que j’ay pour nous deffendre en cette occaſion, Pris les armes en main, non pas pour vous combattres Mais contre les efforts que fait nôtre Muratre, J’aurois mis armes bas, vous diſant mon deſſein, Des due la idiete Me preteroit la iaiile	C'est pour nous préserver de cette oppression, Que j'ai pour nous défendre en cette occasion, Pris les armes en main, non pas pour vous combattrez Maîtres contre les efforts que fait notre Muratre, J'aurais mis armes bas, vous disant mon dessein, Des due la idiète Me prêterait la jaiile
Levigilde.	Levigilde.
Vous mentés, dangereux impoſteur que vous êtes.	Vous mentez, dangereux imposteur que vous êtes.
Hermenegilde.	Hermènegilde.
Pendant ce grand orage & ces rudes tempêtes, Vous m’avés pourſuivi pour abreger mes jours, Les Temples du Seigneur ont été mon recours, Je les prends à témoins, ils m’ont ſervi d’azile;	Pendant ce grand orage et ces rudes tempêtes, Vous m'avez poursuivi pour abréger mes jours, Les Temples du Seigneur ont été mon recours, Je les prends à témoins, ils m'ont servi d'asile;
Quoyque de me ſauver, il m’eût été facile, L’intrepide valeur de cent mille ſoldats, Auroit pû m’empêcher de tomber dans vos bras, Mais je pris le parti que vous ne pouviés croire, Dont la poſterité cherira la memoire, De venir à vos pieds vous dire avec reſpect, Que vous ne deviés pas me tenir pour ſuſpect;	Quoique de me sauver, il m'eût été facile, L'intrépide valeur de cent mille soldats, Aurait pu m'empêcher de tomber dans vos bras, Mais je pris le parti que vous ne pouviez croire, Dont la postérité chérira la mémoire, De venir à vos pieds vous dire avec respect, Que vous ne deviez pas me tenir pour suspect;
Quel eſt donc le ſujet de l’affaire nouvelle, Qui ternit tout l’éclat d’une action ſi belle?	Quel est donc le sujet de l'affaire nouvelle, Qui ternit tout l'éclat d'une action si belle?
Mes plus fiers ennemis, dont le plus grand effort, N’a pû jamais par force accelerer ma mort, ont tâche de le faire avec leurs calomnies, Ils en ont prés de vous abondamment fournies, j’ay commis ce ſeul crime il me met dans les fers, Que tant de ſaints Martyrs avec joye ont ſoufferts.	Mes plus fiers ennemis, dont le plus grand effort, N'a pu jamais par force accélérer ma mort, ont tâche de le faire avec leurs calomnies, Ils en ont près de vous abondamment fournies, j'ai commis ce seul crime il me met dans les fers, Que tant de saints Martyrs avec joie ont soufferts.
Je ſuis Chrêtien Romain, c’eſt une verité, C’eſt un crime innocent dont je fais vanité, Le Ciel s’en réjoüit, l’Enfer s’en épouvente, Le Juge l’apprehende & ſa fureur augmente, De m’en voir accuſé, cela me fait honneur, Et de mourir pour luy, ce ſeroit mon bonheur, Bour conſerver ce nom je perdrois mille vies, Et je n’auray jamais de plus grandes envies, Ma ferveur, dirés-vous, eſt un effort humain;	Je suis Chrétien Romain, c'est une vérité, C'est un crime innocent dont je fais vanité, Le Ciel s'en réjoüit, l'Enfer s'en épouvente, Le Juge l'appréhende et sa fureur augmente, De m'en voir accusé, cela me fait honneur, Et de mourir pour rendre, ce serait mon bonheur, Bour conserver ce nom je perdrais mille vies, Et je n'aurai jamais de plus grandes envies, Ma ferveur, irez-vous, est un effort humain;
Mais, non, cette vertu, grand Dieu, vient de ta main, Et comme les effets la ſource en eſt divine, C’eſt du Ciel que me vient cette noble vigueur, Qui m’a fait des tourmens mépriſer la rigueur, Qui me fait défier les puiſſances humaines, Et qui fait que mon ſang ſe déplait dans mes veines;	Mais, non, cette vertu, grand Dieu, vient de ta main, Et comme les effets la source en est divine, C'est du Ciel que me vient cette noble vigueur, Qui m'a fait des tourments mépriser la rigueur, Qui me fait défier les puissances humaines, Et qui fait que mon sang se déplait dans mes veines;
Oüy, ces chaines, Seigneur, ces fardeaux glorieux, Sont aux bras d’un Chrétien des bijoux précieux, Avant nous le Sauveur en eût les mains chargées, Au feu de ſon amour, il nous les a forgées, Loin de nous accabler, leur faix eſt nôtre appuy, Et c’eſt par ces chaînons que nous allons à luy, Déployés vos rigueurs ſur ma propre perſonne, Faites-moy par ma mort meriter la couronne.	Oui, ces chaines, Seigneur, ces fardeaux glorieux, Sont aux bras d'un Chrétien des bijoux précieux, Avant nous le Sauveur en eût les mains chargées, Au feu de son amour, il nous les a forgées, Loin de nous accabler, leur fait est notre appui, Et c'est par ces chaînons que nous allons à M, Déployés vos rigueurs sur ma propre personne, Faites-moi par ma mort mériter la couronne.
Levigilde.	Levigilde.
ll faut un delcipon pour me plier la mort.	Il faut un délcipon pour me plier la mort.
Hermenegilde.	Hermènegilde.
Quand j’étois Arrien, je l’apprehendois fort, Je ne pouvois alors fonder nufle eſperance.	Quand j'étais Arrien, je l'appréhendais fort, Je ne pouvais alors fonder nuffle espérance.
D’avoir de mes travaux la digne recompenſe.	D'avoir de mes travaux la digne récompense.
Levigilde.	Levigilde.
Quel eſpoir, ame baſſe, avés-vous à preſent?	Quel espoir, âme basse, avés-vous à présent?
Et comment vivés-vous?	Et comment vivez-vous?
comme un extravagant.	comme un extravagant.
Hermenegilde.	Hermènegilde.
Le cilice à preſent, du pain, de l’eau pour boire, Les chaines, la priſon, c’eſt là toute ma gloire.	Le cilice à présent, du pain, de l'eau pour boire, Les chaines, la prison, c'est là toute ma gloire.
Levigilde.	Levigilde.
Eh!	Eh!
ne mettés-vous pas auſſi vôtre bonheur, Dans ce qui vous devroit faire le plus d’horreur, M’outrager, me haïr, de même que la Reine, Que l’on doit reſpecter comme une Souveraine?	ne mettez-vous pas aussi votre bonheur, Dans ce qui vous devrait faire le plus d'horreur, M'outrager, me haïr, de même que la Reine, Que l'on doit respecter comme une Souveraine?
Hermenegilde.	Hermènegilde.
Non, Seigneur, i’ay pour vous le reſpect que je dois;	Non, Seigneur, j'ai pour vous le respect que je dois;
Et je vous ay toûjours honoré comme Roy, Quoyque vous me ſoyés de plus en plus ſevere, Je vous ay reveré comme un enfant ſon Pere, Comme mon maître auſſi toûjours je vous ay craint, Si je vous ay quitté, je m’y ſuis vû contraint;	Et je vous ai toujours honoré comme Roy, Quoique vous me soyez de plus en plus sévère, Je vous ai révéré comme un enfant son Père, Comme mon maître aussi toujours je vous ai craint, Si je vous ai quitté, je m'y suis vu contraint;
J’ay toûjours ſouhaité pour vôtre chere épouſe, Qu’elle eût un bon eſprit & ne fut point jalouſe.	J'ai toujours souhaité pour votre chère épouse, Qu'elle eût un bon esprit et ne fut point jalouse.
Levigilde.	Levigilde.
Elle eſt d’un grand eſprit pour reprimer l’effort, que vous faites contre elle, en luy donnant le tort,	Elle est d'un grand esprit pour réprimer l'effort, que vous faites contre elle, en lui donnant le tort,
Hermenegilae.	Hermènegilae.
oüy, pour un tel ſujet elle en eſt toute pleine, C’eſt ce qui va cauſer la mort où l’on me menne.	oui, pour un tel sujet elle en est toute pleine, C'est ce qui va causer la mort où l'on me menne.
Levigilde.	Levigilde.
Allés, retirés-vous, nous en allons parler.	Allez, retirez-vous, nous en allons parler.
SCENE TROISIE'ME LEPTGILDE, SOPHRON, CARDACES.	SCÈNE -TROISIE'ME LEPTGILDE, SOPHRON, CARDACCES.
Levigilde.	Levigilde.
Dites-moy vôtre avis, ſans rien diſſimuler;	Dites-moi votre avis, sans rien dissimuler;
Cardaces.	Cardaces.
Grand Roy, ce fait n’eſt pas dans le cours ordinaire, Le droit ne m’apprend pas ce qu’il convient de faire;	Grand Roi, ce fait n'est pas dans le cours ordinaire, Le droit ne m'apprend pas ce qu'il convient de faire;
on doit traiter la choſe avec précaution, Ne rien précipiter avecque paſſion;	on doit traiter la chose avec précaution, Ne rien précipiter avec passion;
Il faudroit, pour juger une entiere aſſeurance;	Il faudrait, pour juger une entière assurance;
Le fait eſt incertain, je flotte & je balance, Si pour juger quelqu’un, même du dernier rang;	Le fait est incertain, je flotte et je balance, Si pour juger quelqu'un, même du dernier rang;
Quand il s’agit ſur tout de répandre ſon ſang;	Quand il s'agit sur tout de répandre son sang;
on ne peut contre luy porter nulle Sentence, Qu’on ne ſoit ſârement inſtruit de ſon offenſe:	on ne peut contre deux porter nulle Sentence, Qu'on ne soit sâtrement instruit de son offense:
Quelles précautions devons-nous donc avoir, Pour vôtre Fils qu’on veut qu’il manque à ſon devoir?	Quelles précautions devons-nous donc avoir, Pour votre Fils qu'on veut qu'il manque à son devoir?
Ce Fils qui paroiſſoit faire vos complaiſances;	Ce Fils qui paraissait faire vos complaisances;
En qui les Goths mettoient toutes leurs eſperances;	En qui les Goths mettaient toutes leurs espérances;
on l’accuſe d’avoir été peu circonſpect, D’avoir manqué, Seigneur, envers vous de reſpect, Et par de faux zelés s’être laiſſé ſéduire, Aux ſuperſtitions dont il s’eſt fait inſtruire:	on l'accuse d'avoir été peu circonspect, D'avoir manqué, Seigneur, envers vous de respect, Et par de faux zelés s'être laissé séduire, Aux superstitions dont il s'est fait instruire:
Quant au premier des Chefs, il en a rejet té La faute ſur la Reine, il a même atteſté Qu’il croit qu’elle a deſſein d’attenter à ſa vie, que ce deſſein eſt ſûr, & flatte ſon envie, il vient de le prouver, & pluſieurs vous l’ont dit, Je trouve que ce fait par d’autres eſt prédit;	Quant au premier des Chefs, il en a rejet té La faute sur la Reine, il a même attesté Qu'il croit qu'elle a dessein d'attenter à sa vie, que ce dessein est sûr, et flatte son envie, il vient de le prouver, et plusieurs vous l'ont dit, Je trouve que ce fait par d'autres est prédit;
Si j’ay des anciens tems aſſés bonne mémoi re, Des Marâtres partout je découvre l’hiſtoire, Leur malice a cauſé la perte des Etats, Revolté les Sujets, broüillé les Potentats;	Si j'ai des anciens temps assez bonne mémoi re, Des Marâtres partout je découvre l'histoire, Leur malice a causé la perte des États, Révolté les Sujets, brouillé les Potentats;
Leur eſprit eſt ſouvent picqué de jalouſie, Tout dépend du caprice & de leur fantaiſie, De-là dans les eſprits, trouble, diviſion, Et contre les enfans, mépris, averſion, C’eſt donc à vous, grand Roy, de voir ſi c’eſt la haine, que la Reine a pour luy, qui lui cauſe ſa peine;	Leur esprit est souvent piqué de jalousie, Tout dépend du caprice et de leur fantaisie, De-là dans les esprits, trouble, division, Et contre les enfants, mépris, aversion, C'est donc à vous, grand Roy, de voir si c'est la haine, que la Reine a pour lu, qui lui cause sa peine;
Ce n’eſt que pour vanger ſes terribles affronts, Ses grandes cruautés;	Ce n'est que pour venger ses terribles affronts, Ses grandes cruautés;
ſes noires trahiſons, Qu’il s’eſt porté contre elle à prendre en main les armes;	ses noires trahisons, Qu'il s'est porté contre elle à prendre en main les armes;
Il en eſt ſi touché qu’il en verſe des larmes, Son retour prés de vous fait ſi confidamment, Montre que contre vous il n’agit nullement, qu’il n’a jamais penſé de ravir ſa couronne, Encor moins d’offenſer la Royale perſonne;	Il en est si touché qu'il en verse des larmes, Son retour près de vous fait si confidamment, Montre que contre vous il n'agit nullement, qu'il n'a jamais pensé de ravir sa couronne, Encor moins d'offenser la Royale personne;
Examinons le cas de la Religion.	Examinons le cas de la Religion.
Dont il a déclaré faire profeſſion;	Dont il a déclaré faire profession;
Il n’eſt pas ſurprenant qu’ayant femme Chrétienne, A ſa Religion il conforme la ſienne;	Il n'est pas surprenant qu'ayant femme Chrétienne, À sa Religion il conforme la sienne;
Il s’y voit engagé par le plus tendre amour, Il ne peut refuſer d’y répondre à ſon tour.	Il s'y voit engagé par le plus tendre amour, Il ne peut refuser d'y répondre à son tour.
Son crime eſt en cela beaucoup plus excuſable.	Son crime est en cela beaucoup plus excusable.
s’il n’eſt abſolument eſtimé pardonnable;	s'il n'est absolument estimé pardonnable;
D’ailleurs peut-on luy faire un crime de cela?	D'ailleurs peut-on venir faire un crime de cela?
Quoy!	Quoi!
faut-il des Bourteaux pour le tirer de la2 N'a-t’on pas plus beſoin dans une telle affaire, De deux Docteurs zelés pour mieux vous ſatisfaire?	faut-il des Bourteaux pour le tirer de la2 N'a-t-on pas plus besoin dans une telle affaire, De deux Docteurs zelés pour mieux vous satisfaire?
Levigilde.	Levigilde.
Sophron, qu’en penſés-vous?	Sophron, qu'en pensez-vous?
Sopbron.	Sopbron.
Ren de bon nullement, Son audace eſt coupable, & c’eſt mon ſentiment, Vôtre Majeſté voit de quel air il s’exprime, Il oſe devant vous ſe vanter de ce crime, Encor s’il l’eût couvert de quelque beau dehors, Je luy conſeillerois de differer pour lors, De bien examiner cette importante affaire, Et de voir à loiſir ce qu’il luy faudroit faire;	Ren de bon nullement, Son audace est coupable, et c'est mon sentiment, Votre Majesté voit de quel air il s'exprime, Il ose devant vous se vanter de ce crime, Encor s'il l'eût couvert de quelque beau dehors, Je sens conseillerais de différer pour lors, De bien examiner cette importante affaire, Et de voir à loisir ce qu'il lui faudrait faire;
Mais il n’a pas de honte à vous le declarer, Il a même fait gloire à vous en aſſeurer.	Mais il n'a pas de honte à vous le déclarer, Il a même fait gloire à vous en assurer.
Il n’a pas craint non plus de vous faire un outrage, Je croy ſans differer un moment davantage, Qu’il faut trancher ſa vie en vous la conſervant, C’eſt ſon cruel deſſin, prenés donc le devant, Un crime ſi criant jamais ne ſe pardonne, S’il n’avoit entrepris que d’ôter ſa couronne, Par un moyen plus doux on pourroit le punir;	Il n'a pas craint non plus de vous faire un outrage, Je crois sans différer un moment davantage, Qu'il faut trancher sa vie en vous la conservant, C'est son cruel dessin, prenezez donc le devant, Un crime si criant jamais ne se pardonne, S'il n'avait entrepris que d'ôter sa couronne, Par un moyen plus doux on pourrait le punir;
La juſtice & la paix pourroient ſe réunir;	La justice et la paix pourraient se réunir;
Mais ayant eu deſſein de vous ôter la vie, Aprés avoir trahy Dieu même & ſa Patrie, Violé tous les droits des preceptes divins, Et ſans ceſſe rebelle à la Loy des humains, Reſiſté contre vous autant qu’il a pû faire;	Mais ayant eu dessein de vous ôter la vie, Après avoir trahi Dieu même et sa Patrie, Violé tous les droits des préceptes divins, Et sans cesse rebelle à la Loi des humains, Résisté contre vous autant qu'il a pu faire;
Les armes à la main voulant ſe ſatisfaire, Ne ſe rendant à vous qu’avec mille regrets, Jamais du fond du cœur ſoûmis à vos Arrêts, Mépriſant les Conſeils du Royaume & d’un Pere, Rejettant tous ſes faits ſur une belle-mere, Blamant ſon alliance & ſon illuſtre ſang;	Les armes à la main voulant se satisfaire, Ne se rendant à vous qu'avec mille regrets, Jamais du fond du cœur soumis à vos Arrêts, Méprisant les Conseils du Royaume et d'un Père, Rejettant tous ses faits sur une belle-mère, Blamant son alliance et son illustre sang;
S’il oſe maintenant qu’il n’eſt pas dans ſon rang, Qu’il eſt dans la priſon chargé de groſſes chaînes, Revêtu d’un cilice & ſouffre tant de peines, D’un air audacieux vous parler comme il fait;	S'il ose maintenant qu'il n'est pas dans son rang, Qu'il est dans la prison chargé de grosses chaînes, Revêtu d'un cilice et souffre tant de peines, D'un air audacieux vous parler comme il fait;
Eh!	Eh!
que ſeroit-ce donc, ſi ſelon ſon projet;	que serait-ce donc, si selon son projet;
Il ſe voyoit enfin ſur ſon glorieux trône;	Il se voyait enfin sur son glorieux trône;
s’il tenoit dans ſes mains le ſceptre & la couronne?	s'il tenait dans ses mains le sceptre et la couronne?
Ne ſoyés pas, grand Roy, touché de ſes malheurs, Et ne vous rendés pas à ſes indignes pleurs, Tant de faits criminels, dont on ſçait l’inſolence, Ne vous permettent pas d’adoucir ſa ſentence, s’il ne quitte au plûtôt ſes ſuperſtitions, s’il ne ſe rend à vous par ſes ſoumiſſions, s’il ne vous marque pas un repentir ſincere, l Faites-luy reſſentir vôtre juſte colere;	Ne soyez pas, grand Roi, touché de ses malheurs, Et ne vous rendez pas à ses indignes pleurs, Tant de faits criminels, dont on sait l'insolence, Ne vous permettent pas d'adoucir sa sentence, s'il ne quitte au plûtôt ses superstitions, s'il ne se rend à vous par ses soumissions, s'il ne vous marque pas un repentir sincère, l' Faites-lui ressentir votre juste colère;
Ordonnés qu’on luy faſſe éprouver la rigueur Du ſupplice qui peut luy donner plus d’horreur.	Ordonnez qu'on peut fasse éprouver la rigueur Du supplice qui peut lui donner plus d'horreur.
Caranevi.	Caranevi.
sophron, pourquoy vouloir qu’on force la nature?	sophron, pourquoi vouloir qu'on force la nature?
Laiſſés agir un Pere en cette conjoncture.	Laisez agir un Père en cette conjoncture.
Sophron.	Sophron.
Cardaces, l’on a vû ſeverement punir Des enfans qu’au devoir on n’a pû contenir;	Cardaces, l'on a vu sévèrement punir Des enfants qu'au devoir on n'a pu contenir;
Rappellés-vous Corſate, on ſçait de ſon hiſtoire, Que fier, audacieux d’une prande victoire, Qu’enflé de ſa grandeur, pour ſes pauvres parens, Et ſon cœur & ſes yeux étoient indifferens, Ce monſtre de nature informé que ſon pere Etoit enfin preſſé d’une extrême miſere, De ce revers fatal honteuſement ſurpris, Ne le regardoit plus qu’avec mille mepris.	Rappelés-vous Corsate, on sait de son histoire, Que fier, audacieux d'une prande victoire, Qu'enflé de sa grandeur, pour ses pauvres parents, Et son cœur et ses yeux étaient indifférents, Ce montre de nature informé que son père Etoit enfin pressé d'une extrême misère, De ce revers fatal honteusement surpris, Ne le regardait plus qu'avec mille mépris.
Entré dedans ſon camp ſous des marques pompeuſes;	Entré dedans son camp sous des marques pompeuses;
Il ſouffrit une mort toute des plus honteuſes:	Il souffrit une mort toute des plus honteuses:
Torquatus pour avoir la bataille donné, Contre ce que ſon pere en avoit ordonné.	Torquatus pour avoir la bataille donné, Contre ce que son père en avait ordonné.
Fut par ſon ordre exprés mis à mort pour ce crime, Comptant cette action n’être pas legitime;	Fut par son ordre exprès mis à mort pour ce crime, Comptant cette action n'être pas légitime;
Car dans l’art militaire on manque à ſes emplois, Quand on ne regle pas ſes devoirs ſur les loix;	Car dans l'art militaire on manque à ses emplois, Quand on ne règle pas ses devoirs sur les lois;
Nous qui ſommes inſtruits par de ſi grands exemples, Souffrirons encor qu’on mepriſe nos Temples, Et que ce Prince, enfin ce Fils dénaturé, S’en faſle un point d’honneur & le plus aſſûré?	Nous qui sommes instruits par de si grands exemples, Souffrirons encor qu'on méprise nos Temples, Et que ce Prince, enfin ce Fils dénaturé, S'en fâle un point d'honneur et le plus assuré?
Levigilde eſt le pere & l’appuy du Royaume, Et non d’un Criminel comme eſt ce fier jeune homme.	Levigilde est le père et l'appui du Royaume, Et non d'un Criminel comme est ce fier jeune homme.
Levigilde.	Levigilde.
Je jure par mon ſceptre, & par mon bras puiſſant, c ii mouna ceue dant on de enange a l’inttant, Appellés Leonide.	Je jure par mon sceptre, et par mon bras puissant, ç y mouna cève dant on de enange à l'inttant, Appellés Léonide.
SCENE QUATRIEME.	SCÈNE QUATRIÈME.
LEVIGIIDE, SOPHRON, CARDACES, Aue a llEs Levigilde.	LEUIGIIDE, SOPHRON, CARDACES, Aue a lEs Levigilde.
Aujourd'huy Leonide;	Aujourd'hui Léonide;
Il faut par la valeur d’un courage intrepide, que je connoiſſe en vous vôtre fidelité, Et dalls une aetion vede deateine, C’eſt un coup qu’il faut faire, il eſt de conſequence.	Il faut par la valeur d'un courage intrépide, que je connaisse en vous votre fidélité, Et dalls une aétion vède deateine, C'est un coup qu'il faut faire, il est de conséquence.
Levigilde.	Levigilde.
Il faut que vous mettiés ma vie en ſûreté:	Il faut que vous mettez ma vie en sûreté:
Mais je crains cependant que vôtre lâcheté.	Mais je crains cependant que votre lâcheté.
Etobtoc.	Etobtoc.
Ah!	Ah!
sire, pour cela je donneray la mienne;	sire, pour cela je donnerai la mienne;
Trouveriés-vous quelqu’un qui ne donnât la ſienne?	Trouveriez-vous quelqu'un qui ne donnât la sienne?
Faut-il pour ce ſujet me tenir en ſuſpends, Je ſuis prêt d’obéir à l’ordre que j’attends.	Faut-il pour ce sujet me tenir en suspends, Je suis prêt d'obéir à l'ordre que j'attends.
Levigilde.	Levigilde.
Il vous eſt ordonné par le Roy Levigilde, D’aller trancher la tête au Prince Hermenegilde.	Il vous est ordonné par le Roi Levigilde, D'aller trancher la tête au Prince Hermenegilde.
Leonide.	Léonide.
o Ciel!	ô Ciel!
ô sire !	ô sire !
helas!	hélas!
que me commandés-vous?	que me commandez-vous?
Seigneur, penſés y bien, calmés vôtre courroux;	Seigneur, pensez y bien, calmez votre courroux;
Ah le cruel Arrêt!	Ah le cruel Arrêt!
je me pâme à l’entendre, Dans l’abîme infernal j’aimerois mieux deſcendre;	je me pâme à l'entendre, Dans l'abîme infernal j'aimerais mieux descendre;
qui pourroit ſe reſoudre à verſer vôtre ſang?	qui pourrait se résoudre à verser votre sang?
Levigilde.	Levigilde.
Il le faut, je le veux, ſoyés obeiſſant;	Il le faut, je le veux, soyez obéissant;
Leonide.	Léonide.
Un juſte repentir vous coutera des larmes.	Un juste repentir vous coûtera des larmes.
Levigilde.	Levigilde.
Non, il m’a trop donné de funeſtes allarmes, L’affaire eſt reſoluë, allés inceſſamment;	Non, il m'a trop donné de funestes alarmes, L'affaire est résolue, assez incessamment;
Vous vous rendres coupable à tarder d’un moment.	Vous vous rendrez coupable à tarder d'un moment.
SCENE CINQUIEME.	SCÈNE CINQUIÈME.
HERMENEFRIDE, DARIACES.	HÉRMENEFRIDE, DARIACES.
Dariaces.	Dariaces.
Llons Hermenefride au Temple de la gloire, A Rendre graces aux Dieux d’une illuſtre victoire;	Llons Hermènefride au Temple de la gloire, A Rendre grâces aux Dieux d'une illustre victoire;
Ils nous ont aujourd’huy comblé de leurs bienfaits, ils ont daigné répondre à nos juſtes ſouhaits;	Ils nous ont aujourd'hui comblé de leurs bienfaits, ils ont daigné répondre à nos justes souhaits;
Nous voilà triomphans du Prince Hermenegilde, Nous verrons vivre en paix nôtre Roy Levigilde, De Mars ny d’Appollon ne ſoyons plus jaloux, Ny des honneurs divins que l’on rend parmy nous, A Jupiter armé des foudres du tonnerre, Nous ſommes maintenant ſes rivaux ſur la terre.	Nous voilà triomphants du Prince Hermènegilde, Nous verrons vivre en paix notre Roi Lévigilde, De Marsîle d'Apollon ne soyons plus jaloux, Ni des honneurs divins que l'on rend parmi nous, A Jupiter armé des foudres du tonnerre, Nous sommes maintenant ses rivaux sur la terre.
SCENE SIXIE'ME.	SCÈNE SIXIE'ME.
HERMENEFRIDE, DARIACES, DURIAS.	HÉRMENEFRIDE, DARIACES, DURIAS.
Durias.	Durias.
Arbares affamés de carnage & de iangs D Vantés-vous d’avoir fait mourir un innocent, Un Prince ſi charmant qui faiſoit nos délices, A ſouffert par vos mains les plus cruels ſupplices;	Arbares affamés de carnage et de yangs D Vantés-vous d'avoir fait mourir un innocent, Un Prince si charmant qui faisait nos délices, A souffert par vos mains les plus cruels supplices;
Mais le grand Dieu vangeur de vos iniquités, Punira tôt ou tard de telles cruautés.	Mais le grand Dieu vengeur de vos iniquités, Punira tôt ou tard de telles cruautés.
Hermenefride.	Hermènefride.
Pauvre Enfant, vous croyés faire bien des merveilles, De venir en colere étourdir nos oreilles.	Pauvre Enfant, vous croyez faire bien des merveilles, De venir en colère étourdir nos oreilles.
Durias.	Durias.
Comment, vous oſés donc m’appeller un enfant, Tout enfant que je ſuis, je vous dis maintenant, que pour vous appeller un traître, un homicide, Je n’en deviendray pas devant vous plus timide;	Comment, vous osez donc m'appeler un enfant, Tout enfant que je suis, je vous dis maintenant, que pour vous appeler un traître, un homicide, Je n'en deviendrai pas devant vous plus timide;
Partout je publieray, tenés-le pour certain, Et vous feray paſſer pour un monſtre inhumain,	Partout je publierai, tenez-le pour certain, Et vous ferai passer pour un monstre inhumain,
Hermene fride.	Hermène fride.
Durias, vous feriés beaucoup mieux de vous taire, Profités de l’avis, il vous eſt ſalutaire:	Durias, vous feriez beaucoup mieux de vous taire, Profités de l'avis, il vous est salutaire:
Durias.	Durias.
Moy me taire!	Moi me taire!
non, non, par tout je publieray, vôtre fureur barbare à ceux que je verray :	non, non, par tout je publierai, votre fureur barbare à ceux que je verrai :
Si les hommes perdus ne veulent pas l’entendre, Les bêtes, les rochers la pourront bien comprendre;	Si les hommes perdus ne veulent pas l'entendre, Les bêtes, les rochers la pourront bien comprendre;
Et le Ciel irrité par leurs gemiſſemens, Marquera ſon horreur & ſes reſſentimens.	Et le Ciel irrité par leurs gémissements, Marquera son horreur et ses ressentiments.
Dariaces.	Dariaces.
Je vois bien, Durias, par toutes vos manieres, Que vous voulés bien-tôt avoir les étrivieres.	Je vois bien, Durias, par toutes vos manières, Que vous voulez bientôt avoir les étrivières.
Durias.	Durias.
De verges vous oſés, lâche, me menacer !	De verges vous osez, lâche, me menacer !
Ma patience enfin commence à ſe laſſer;	Ma patience enfin commence à se lasser;
Si vous avés du cœur, tirés donc vôtre épée;	Si vous avez du cœur, tirerez donc votre épée;
Ie vois par ce défy vôtre attente trompée, Ce ſeroit ſûrement pour la premiere fois, Qu’on l’auroit vû tirée au Service des Rois.	Je vois par ce défi votre attente trompée, Ce serait sûrement pour la première fois, Qu'on l'aurait vu tirée au Service des Rois.
Dariaces.	Dariaces.
Hermenefride, enfin permectés, je vous prie, Qu’en ce jour par ma main il ne ſoit plus en vie;	Hermènefride, enfin permectés, je vous prie, Qu'en ce jour par ma main il ne soit plus en vie;
Son audace eſt extrême, & j’en ſuis irrité, Il en ſera puni comme il a merité :	Son audace est extrême, et j'en suis irrité, Il en sera puni comme il a mérité :
Je veux à ce moment que ſa tendre nature, Aux mouches, aux fourmis ſerve de nourriture.	Je veux à ce moment que sa tendre nature, Aux mouches, aux fourmis serve de nourriture.
Hermeneſride.	Hermèneride.
inſenſé, temeraire, à quoy donc penſés-vous?	insensé, téméraire, à quoi donc pensez-vous?
Vous venés ſûrement chercher icy des coups;	Vous venez sûrement chercher ici des coups;
Croyés-moy taiſés-vous, un parltur trop ſevere, At tire ſur ſon dos une mauvaiſe affaire;	Croyez-moi taisez-vous, un parltur trop sévère, At tire sur son dos une mauvaise affaire;
Vôtre ſort en ce jour ne dépend que de luy!	Votre sort en ce jour ne dépend que de Seigneur!
Ne l’irrités donc pas, mais cherchés ſon appuy, Retirés-vous d’ici malheureux que vous étes, Son courroux vous deſtine à ces petites bêtes.	Ne l'irritez donc pas, mais cherchez son appui, Retirez-vous d'ici malheureux que vous êtes, Son courroux vous destine à ces petites bêtes.
Dutias.	Dutias.
gii die minunter d'un courage mne peur, Je luy feray ſentir juſqu’où va ma valeur.	gy die minunter d'un courage mune peur, Je lui ferai sentir jusqu'où va ma valeur.
DArtatel.	DArtatel.
Il mourra, c’en eſt fait, il mourra je le jure.	Il mourra, c'en est fait, il mourra je le jure.
Durias.	Durias.
O Chien!	Ô Chien!
prends cette épée, & fais une ouverture?	prends cette épée, et fais une ouverture?
Acheve de tirer & de boire mon ſang, La mort d’Hermenegilde à moitié le répand.	Acheve de tirer et de boire mon sang, La mort d'Hermègegilde à moitié le répand.
Hermenefride.	Hermènefride.
Laiſſés-le, laiſſés-le, la fureur qui l’emporte, Le fait ſans y penſer, parler de cette ſorte, Il ſeroit beau d’ailleurs d’avoir un differend, Et vouloir diſputer avec un jeune enfant;	Laissez-le, laissez-le, la fureur qui l'emporte, Le fait sans y penser, parler de cette sorte, Il serait beau d'ailleurs d'avoir un différend, Et vouloir disputer avec un jeune enfant;
Allons ſans plus tarder, ſonger à nôtre affaire;	Allons sans plus tarder, songer à notre affaire;
cent la ce qui nous plene, e le plus necenaie;	cent la ce qui nous plène, eût le plus necenaie;
Voyons ſi l’on n’y met aucun empêchement.	Voyons si l'on n'y met aucun empêchement.
Dariaces en s’en allant.	Dariaces en s'en allant.
Si je te prends,	Si je te prends,
Durias.	Durias.
Allés, partés diligemmenc?	Allz, partez diligemmenc?
Le Roy ſera bientôt inſtruit de vôtre intrigue.	Le Roi sera bientôt instruit de votre intrigue.
Et nous pourrons peut-être anéantir la brigue;	Et nous pourrons peut-être anéantir la brigue;
Mais comment aprés tout, malheureux que je ſuis!	Mais comment après tout, malheureux que je suis!
Pourray-je l’aborder?	Pourrai-je l'aborder?
c’eſt ce que je ne puis, La noire calomnie a fermé les entrées, De cet indigne effort nos ames ſont outrées.	c'est ce que je ne puis, La noire calomnie a fermé les entrées, De cet indigne effort nos âmes sont outrées.
Nous ſommes tous trahis, n’importe, il faut aller, Nous trouverons moyen de pouvoir luy parler.	Nous sommes tous trahis, n'importe, il faut aller, Nous trouverons moyen de pouvoir lui parler.
Fin du Quatriéme Acte.	Fin du Quatrième Acte.
ACTE CINQUIE’ME.	ACTE CINQUIE'ME.
SCENE PREMTERE.	SCÈNE PREMTERE.
LEONIDE.	LEONIDE.
*Rand Dieu!	*Rand Dieu!
c’eſt donc par moy que le Roy Levigilde UVeut qu’on tranche la tête au Prince Hermenegilde;	c'est donc par moi que le Roi Levigilde UVeut qu'on tranche la tête au Prince Hermenegilde;
Faut-il que mon deſtin ſoit aſſés malheureux, Pour faire executer cet ordre rigoureux?	Faut-il que mon destin soit assez malheureux, Pour faire exécuter cet ordre rigoureux?
Ah!	Ah!
s’il ſe contentoit de l’injuſte menace, que ſi je n’obéis la mienne eſt à ſa place, Je me ferois ſans doute un bonheur de l’offrir, Mais helas!	s'il se contentait de l'injuste menace, que si je n'obéis la mienne est à sa place, Je me ferais sans doute un bonheur de l'offrir, Mais hélas!
ſon courroux ne le voudroit ſouffrir, qui vît jamais un Pere avant ſes funerailles, Se faire en ſon Enfant arracher les entrailles?	son courroux ne le voudrait souffrir, qui vît jamais un Père avant ses funérailles, Se faire en son Enfant arracher les entrailles?
Les ours & les lions, les plus fiers animaux;	Les ours et les lions, les plus fiers animaux;
Jamais à leurs petits n’ont fait les moindres maux:	Jamais à leurs petits n'ont fait les moindres maux:
on les voit au contraire en tous lieux les deffendre, La nature eſt en eux plus humaine & plus tendre:	on les voit au contraire en tous lieux les défendre, La nature est en eux plus humaine et plus tendre:
Comment puis-je annoncer à ce Prince innocent, Qu’il faut que cette nuit je répande ſon ſang?	Comment puis-je annoncer à ce Prince innocent, Qu'il faut que cette nuit je répande son sang?
je tremble, je pâlis, & ma voix preſque éteinte, Montre de mon eſprit la terrible contrainte;	je tremble, je pâlis, et ma voix presque éteinte, Montre de mon esprit la terrible contrainte;
Vvalfride, retirés le Prince de Priſon:	Valfride, retirez le Prince de Prison:
Helas!	Hélas!
il n’en ſçaura que trop tôt la raiſon.	il n'en saura que trop tôt la raison.
SCENE SECONDE.	SCÈNE SECONDE.
HERMENEGILDE, LEONIDE.	HÉRMENEGILDE, LEONIDE.
Hermenegilde.	Hermènegilde.
Quel ſujet, Leonide, en ce lieu vous amenne?	Quel sujet, Léonide, en ce lieu vous amenne?
Leonide.	Léonide.
Prince de vous l’apprendre, épargnés moi la peine;	Prince de vous l'apprendre, épargnés moi la peine;
Plût à Dieu que le Roy furieux contre vous, Déchargeât ſur moy ſeul la rigueur de ſes coups, Qu’au moins je n’euſſe pas une langue en la bouche, pour vous parler, Seigneur, du ſujet qui vous touche.	Plût à Dieu que le Roi furieux contre vous, Déchargeât sur moi seul la rigueur de ses coups, Qu'au moins je n'eusse pas une langue en la bouche, pour vous parler, Seigneur, du sujet qui vous touche.
Hermenegilde, Faites vôtre devoir, & dites hardiment, Lordre que vous avés, ſans nul déguiſement.	Hermènegilde, Faites votre devoir, et dites hardiment, Lordre que vous avez, sans nul déguisement.
Leonide.	Léonide.
mon riince, en!	mon riince, en!
faut-n'uonc que ma bouche prophaneVous annonce la mort où le Roy vous condamne?	faut-n'uonc que ma bouche prophaneUous annonce la mort où le Roi vous condamne?
Hermenegilde.	Hermènegilde.
Par mon Pere, ô mon Dieu !	Par mon Père, ô mon Dieu !
j’ay reçû de vos mains a La lumiere & le jour comme tous les humains, Par luy vous permettés qu’il force la nature, Et qu’il m’ôte la vie en cette conjoncture;	j'ai reçu de vos mains à La lumière et le jour comme tous les humains, Par ty vous permettés qu'il force la nature, Et qu'il m'ôte la vie en cette conjoncture;
Mais vous m’en donnerés au Royaume des Cieux, Une plus glorieuſe avec̈ les Bien-heureux, Grace à vôtre bonté de la faveur inſigne, Qu’il vous plaît m’accorder, & de m’en rendre digne Aprés avoir paſſé tant de malheureux jours, qu’il vous plaiſe, Seigneur, en arrêter le cours, De quel genre de mort veut-il donc que je meure.	Mais vous m'en donnerez au Royaume des Cieux, Une plus glorieuse avec les Bienheureux, Grâce à votre bonté de la faveur insigne, Qu'il vous plaît m'accorder, et de m'en rendre digne Près avoir passé tant de malheureux jours, qu'il vous plaise, Seigneur, en arrêter le cours, De quel genre de mort veut-il donc que je meure.
Leonide.	Léonide.
Il veut que cette nuit vers la quatriéme heure;	Il veut que cette nuit vers la quatrième heure;
Le puis-je prononcer?	Le puis-je prononcer?
cela me fait horreur, Qui parmy les mortels auroit aſſés de cœur, Pour ſeparer du corps la tête de ſon Prince?	cela me fait horreur, Qui parmi les mortels aurait assez de cœur, Pour séparer du corps la tête de son Prince?
S’en peut-il rencontrer dans aucune Province?	S'en peut-il rencontrer dans aucune Province?
Herm enegilde.	Herm enegilde.
je vous entends aſſés, ce ſupplice eſt trop doux?	je vous entends assez, ce supplice est trop doux?
Je voudrois éprouver le plus cruel de tous, Qui fit deffus mon Corps cent & cent ouvertures, Pour voir couler mon ſang par toutes ſes bleſſures, en ioumane pourmon bieu ccotourmens rigoureux, Je pourrois luy prouver les ardeurs de mes feux.	Je voudrais éprouver le plus cruel de tous, Qui fit dessus mon Corps cent et cent ouvertures, Pour voir couler mon sang par toutes ses blessures, en joumane pourmon bieu ccotourments rigoureux, Je pourrais quelques prouver les ardeurs de mes feux.
Leonide.	Léonide.
O conſtance admirable!	Ô constance admirable!
Herme negilde.	Herme négilde.
où veut-il que je meure?	où veut-il que je meure?
Etonide.	Étonide.
bedans vôtre priſon, cette affreuſe demeure, Pendant que l’on ſera dans un profond ſommeil, Et ſans attendre enfin le retour du ſoleil.	bedans votre prison, cette affreuse demeure, Pendant que l'on sera dans un profond sommeil, Et sans attendre enfin le retour du soleil.
D ij	D ij
Quelle heure eſt-il?	Quelle heure est-il?
Hermenegilde.	Hermènegilde.
Leonide.	Léonide.
On eſt à la ſeconde veille, où de vôtre conſtance unchacun s’émerveille.	On est à la seconde veille, où de votre constance unchacun s'émerveille.
Hetmenegilde.	Hetmenegilde.
Regardés fixement les étoilles aux Cieux;	Regardez fixement les étoilles aux Cieux;
Combien vous en voyez qui brillent à vos yeux.	Combien vous en voyez qui brillent à vos yeux.
oüy, je les vois, Leonide.	oui, je les vois, Léonide.
Hermenegilde.	Hermènegilde.
Autant d’Anges par leur preſence, Seront de bons témoins de ma pure innocence, Et je ne mourray point dedans l’obſcurité, Comme le Roy ſouhaite avec indignité, Dedans cette priſon, appellés Leonide;	Autant d'Anges par leur présence, Seront de bons témoins de ma pure innocence, Et je ne mourrai point dedans l'obscurité, Comme le Roi souhaite avec indignité, Dans cette prison, appelés Léonide;
Un Prêtre Catholique, & ſervés-luy de guide, Avant que de mourir, je voudrois luy parler.	Un Prêtre Catholique, et servez-lui de guide, Avant que de mourir, je voudrais toujours parler.
Leonide.	Léonide.
Mon Prince, je voudrois le pouvoir appeller;	Mon Prince, je voudrais le pouvoir appeler;
Mais je dois refuſer vôtre juſte demande, J’en ay l’ordre précis, & le Roy le commande;	Mais je dois refuser votre juste demande, J'en ai l'ordre précis, et le Roi le commande;
Mais ſi vous voulés voir quelque Prêtre Arrien.	Mais si vous voulez voir quelque Prêtre Arrien.
Il vous ſera permis d’avoir ſon entretien.	Il vous sera permis d'avoir son entretien.
Herm enegilde.	Herm enegilde.
Non, de vos Arriens les erreurs je deteſte, Je ſuis Chrêtien Romain, c’eſt ce que je proteſte, Et je mourray plûtôt ſans la confeſſion, Le Martyre ſupplée en cette occaſion:	Non, de vos Arriens les erreurs je déteste, Je suis Chrétien Romain, c'est ce que je proteste, Et je mourrai plutôt sans la confession, Le Martyre supplée en cette occasion:
Quoy!	Quoi!
mon Pere a bien pû me refufer un Prêtre:	mon Père a bien pu me refuser un Prêtre:
que ſon cœur eſt cruel!	que son cœur est cruel!
il le fait trop paroitre, ye lua Made da Mels en Mion diiauon 3 qu’il ne m’ôtera pas la conſolation De voir & de parler à mon aimable épouſe, De mon heureux deſtin, elle ſera jalouſe.	il le fait trop paraître, ie lua Made da Mels en Mion diiavon 3 qu'il ne m'ôtera pas la consolation De voir et de parler à mon aimable épouse, De mon heureux destin, elle sera jalouse.
Leonide.	Léonide.
vôtre attente eſt trompée, il me l’a deffendu.	votre attente est trompée, il me l'a défendu.
Hermenegilde.	Hermènegilde.
Ah quelle cruauté!	Ah quelle cruauté!
j’en ſuis tout éperdu, O ma chere Indegonde!	j'en suis tout éperdu, Ô ma chère Inde!
attendiés-vous d’un pere, Cette inhumanité,, ce jugement ſevere, Digne épouſe de Dieu beaucoup plus que de moy, Perſeverés toûjours conſtamment dans la foy, Demeurés attachée à la vertu ſolide;	attendiez-vous d'un père, Cette inhumanité, ce jugement sévère, Digne épouse de Dieu beaucoup plus que de moi, Persevrez toujours constamment dans la foi, Demeurez attachée à la vertu solide;
Et regardés la mort d’un viſage intrepide, Avec les Bienheureux pour honorer l’Agneau, Nous chanterons au Ciel un Cantique nouveau, Vous n’avés pas porté de pourpre aſſés brillante, La couleur de mon ſang ſera plus éclatante, Epouſe trop cherie en tout tems, en tout lieu, souvenes-vous de moy, je vous embraſſe, adieu.	Et regardez la mort d'un visage intrépide, Avec les Bienheureux pour honorer l'Agneau, Nous chanterons au Ciel un Cantique nouveau, Vous n'avez pas porté de pourpre assez brillante, La couleur de mon sang sera plus éclatante, Épouse trop chérie en tout temps, en tout lieu, souvenez-vous de moi, je vous embrasse, adieu.
SCENE TROTSIE'ME HERAHENEGILDE, ERASISTRATE, LEONIDE.	SCÈNE -TROTSIE'ME HERAHENEGILDE, ERASISTRATE, LENIDE.
Eraſiſtrate.	Erasistrate.
2 1 nquenidevend?	2 1 néquenidevend?
du moms que je Tembraſſe, Apendant qu’il vit encor, je veux ſuivre ſa trace:	du moments que je Tembrasse, Apendant qu'il vit encor, je veux suivre sa trace:
Eh!	Eh!
quel eſt le barbare, & l’homme aſſés cruel, qui pourra me ravir l’innocent criminel.	quel est le barbare, et l'homme assez cruel, qui pourra me ravir l'innocent criminel.
Leonide.	Léonide.
Ah!	Ah!
pauvre Eraſiſtrate, où courés-vous ſi vîte?	pauvre Erasistrate, où courez-vous si vite?
Reflêchiſſés ſur vous, le ſujet le merite;	Reflêchissés sur vous, le sujet le mérite;
Pouvés-vous iguorer que vous choqués le Roy;	Pouvez-vous iguorer que vous choquez le Roi;
s’il commande, il faudra quoyque bien malgré moy.	s'il commande, il faudra quoique bien malgré moi.
Eraſiſtrate.	Erasistrate.
Mon Prince Hermenegilde & le meilleur des Princes, Vous êtes regretté dans toutes les Provinces, Dans quel état, helas!	Mon Prince Hermènegilde et le meilleur des Princes, Vous êtes regreté dans toutes les Provinces, Dans quel état, hélas!
paroiſſés-vous réduit?	paraissez-vous réduit?
C’eſt là que vos malheurs vous ont enfin conduit, Par trop de bonne foy, ſur la ſimple apparence, Vqus vous êtes rendu ſans nulle reſiſtance, Sans vouloir déferer à tout ce que j’ay dit;	C'est là que vos malheurs vous ont enfin conduit, Par trop de bonne foi, sur la simple apparence, Vé vous êtes rendu sans nulle résistance, Sans vouloir déférer à tout ce que j'ai dit;
Vous allés éprouver ce que j’avois prédit;	Vous allés éprouver ce que j'avais prédit;
– Je m’eu vais donc vous perdre, ô mon aimable maître, Pour la derniere fois qu’il vous plaiſe permettre;	 Je m'eu vais donc vous perdre, ô mon aimable maître, Pour la dernière fois qu'il vous plaise permettre;
Que j’aye encor, l’honneur d’embraſſer vos genoux, Et de vous aſſeurer que je ſuis tout à vous, Mon courage eſt ardent, il n’eſt rien qu’il n’eſpere, 54 juſqu’au dernier moment je veux qu'il perſevere.	Que j'aie encore, l'honneur d'embrasser vos genoux, Et de vous assurer que je suis tout à vous, Mon courage est ardent, il n'est rien qu'il n'espérer, 54 jusqu'au dernier moment je veux qu'il persévère.
Rtous ivons une épée, & pour vous délivrer, Nous voulons bien pour vous à la mort nous livrer.	Rtous ivons une épée, et pour vous délivrer, Nous voulons bien pour vous à la mort nous livrer.
Mtimemegrine.	Mtimegrine.
De quoy vous plaignés-vous?	De quoi vous plaignez-vous?
Eraſiſtrate.	Erasistrate.
De cet énorme crime, Qu’on commet contre vous, c’eſt là ce qui m’anime, C’eſt ce qui va nous mettre en execration, Pour avoir eu l’honneur de vôtre affection;	De cet énorme crime, Qu'on commet contre vous, c'est là ce qui m'anime, C'est ce qui va nous mettre en exécration, Pour avoir eu l'honneur de votre affection;
Qu’allons-nous devenir?	Qu'allons-nous devenir?
allons, prenons les armes, Mettons par la valeur tout le monde en allarmes, Tirons de la priſon l’innocent Criminel.	allons, prenons les armes, Mettons par la valeur tout le monde en alarmes, Tirons de la prison l'innocent Criminel.
Faiſſons en ſa faveur' déclarer l’Eternel.	Faissons en sa faveur' déclarer l'Éternel.
O Ciel!	Ô Ciel!
ô Dieu vangeur de telles calomnies;	ô Dieu vengeur de telles calomnies;
Pouvés-vous plus long-tems les laiſſer impunies?	Pouvez-vous plus long-tems les laisser impunies?
Hermenegilde, on appene cera parier en furieus s.	Hermènegilde, on appène cera parier en furieus s.
Conſultés la raiſon d’un air plus ſerieux;	Consultés la raison d'un air plus sérieux;
Eſtes-vous donc fâché de m’avoir oüy dire, Que je meure en Chrêtien, & par un doux Martyre?	Êtes-vous donc fâché de m'avoir ouï dire, Que je meure en Chrétien, et par un doux Martyre?
Eraſiſtra te.	Erasistra te.
Non, mais, puis-je ſouffrir que vos fiers ennemis Faſſent auprés du Roy les Serviteurs ſoûmis, Qui ſous ces beaux dehors cachant des cœurs rebelles Conſpirent vôtre perte & vous ſoient infidelles?	Non, mais, puis-je souffrir que vos fiers ennemis Fassent auprès du Roi les Serviteurs soumis, Qui sous ces beaux dehors cachant des cœurs rebelles Conspirent votre perte et vous soient infidèles?
Qu’ils oſent vous charger de ces crimes affreux, Dont ils ſont infectés en ce tems malheureux?	Qu'ils osent vous charger de ces crimes affreux, Dont ils sont infectés en ce temps malheureux?
Puis-je voir à ce point l’innocence opprimée, Dans la fleur de vos ans, dont mon ame eſt charmée De neiienes tarens que pon comnoit en vous, Une humeur enjoüée, un cœur humble & ſi doux, Ont fait depuis long-tems mes plus cheres délices, Et vous voir accablé par de cruels ſupplices, Dont vôtre cœur conſtant ne paroit pas touché, voila ce qui m’afflige, & dont je ſuis faché.	Puis-je voir à ce point l'innocence opprimée, Dans la fleur de vos ans, dont mon âme est charmée De neiienes tarents que pelon comnait en vous, Une humeur enjoüée, un cœur humble et si doux, Ont fait depuis long-tems mes plus chères délices, Et vous voir accablé par de cruels supplices, Dont votre cœur constant ne parait pas touché, voilà ce qui m'afflige, et dont je suis fâché.
Hermenegilde.	Hermènegilde.
Mon cher Eraſiſtrate, avec joye & ſans peine, Je quitte les plaiſirs d’une vie incertaine, l’en gouteray bientôt de plus delicieux, pour en joûir toûjours au Royaume des Cieux.	Mon cher Érasistrate, avec joie et sans peine, Je quitte les plaisirs d'une vie incertaine, l'en goûterai bientôt de plus délicieux, pour en jouir toujours au Royaume des Cieux.
Eraſiſtrate.	Erasistrate.
Que feray-je ſans vous en ce lieu de miſere, Aprés avoir perdu.	Que ferai-je sans vous en ce lieu de misère, Après avoir perdu.
mais voilà vôtre frere.	mais voilà votre frère.
SCENE QUATRIEME.	SCÈNE QUATRIÈME.
HERMENEGILDE, RECAREDE.	HÉRMENEGILDE, RECAREDE.
Retarede.	Retarede.
H!	H!
mon frere, c’eſt moy qui vous ay donc trahy, AI Et mon cœur cependant ne vous a point hay;	mon frère, c'est moi qui vous ai donc trahi, AI Et mon cœur cependant ne vous a point haï;
Je vous ay donc conduit à cette boucherie, Mis aux fers, en priſon, par ma ſupercherie;	Je vous ai donc conduit à cette boucherie, Mis aux fers, en prison, par ma supercherie;
C’eſt moy qui vous preſſay par ma commiſſion, De venir vers mon Pere avec ſoûmiſſion, Proteſtant que pour lors il vous feroit careſſe, Et qu’il n’avoit pour vous qu’amour & que tendreſſe, Qu’il vouloit avec vous faire une bonne paix, Et par vôtre retour couronner ſes ſouhaits, Fondé ſur ſa parole & comptant ſur la nôtre, Deſarmant vos Soldats & me donnant la vôtre, vous êtes retourné de concert avec moy;	C'est moi qui vous pressai par ma commission, De venir vers mon Père avec soumission, Protestant que pour lors il vous ferait caresse, Et qu'il n'avait pour vous qu'amour et que tendresse, Qu'il voulait avec vous faire une bonne paix, Et par votre retour couronner ses souhaits, Fondé sur sa parole et comptant sur la nôtre, Désarmant vos Soldats et me donnant la vôtre, vous êtes retourné de concert avec moi;
Mais vous éprouvés bien qu’on a manqué de foy:	Mais vous éprouvez bien qu'on a manqué de foi:
O Perfide, execrable & cruel Ambaſſade, our la laune uouceur d’une agreable œillade!	Ô Perfide, exécrable et cruel Ambassade, our la laune uouceur une agréable œillade!
Vengés-vous, mon cher frere, & que ce ſoit ſur moy, Vos malheurs, vôtre mort me ſaiſiſſent d’effroy, Ah!	Vengez-vous, mon cher frère, et que ce soit sur moi, Votre malheurs, votre mort me saisissent d'effroi, Ah!
ne differés plus, prenés donc mon épée, Mon ame à demy morte en eſt déja frappée,	ne différez plus, prenezez donc mon épée, Mon âme à demi morte en est déjà frappée,
Hermenegilde.	Hermènegilde.
Pourquoy me parlés-vous d’un ton de furieux?	Pourquoi me parlez-vous d'un ton de furieux?
Reprenés, s’il vous plait, vôtre air ſi gracieux, Mettés-vous en repos, je ſçay vôtre innocence;	Reprenezez, s'il vous plaît, votre air si grâce, Metez-vous en repos, je sais votre innocence;
Recarede.	Récarède.
Je ne merite pas cet air de complaiſance, Il eſt vray mes deſſeins étoient juſtes & bons, Mais leurs mauvais effets leur donnent d’autres noms.	Je ne mérite pas cet air de complaisance, Il est vrai mes desseins étaient justes et bons, Mais leurs mauvais effets leur donnent d'autres noms.
Hermenegilde.	Hermènegilde.
En quoy ſont-ils mauvais?	En quoi sont-ils mauvais?
Recare de.	Récare de.
O le triſte ſpectacle, Je crois que c’eſt un rêve, & non pas un oracle, Ah!	Ô le triste spectacle, Je crois que c'est un rêve, et non pas un oracle, Ah!
mon frere, quittés, ſans attendre à demain, Ce nom que vous prenés de Chrêtien, de Romain, Et par là vous pourrés vous conſerver la vie;	mon frère, quittez, sans attendre à demain, Ce nom que vous prenezez de Chrétien, de Romain, Et par là vous pourrez vous conserver la vie;
Mon Pere n’aura plus ſur elle aucune envie;	Mon Père n'aura plus sur elle aucune envie;
Ou ſi vous aimés tant cette Religion, Diſſimulés au moins, uſés de fiction.	Ou si vous aimez tant cette Religion, Dissimulezez au moins, usez de fiction.
Hermenegilde.	Hermènegilde.
Nôtre foy n’admet point cet acte de foibleſſe, Je dois la publier, puiſque je la profeſſe;	Notre foi n'admet point cet acte de faiblesse, Je dois la publier, puisque je la professe;
Peut-on deſavoüer le Maître que l’on ſert;	Peut-on désavouer le Maître que l'on sert;
Nos bouches & nos cœurs ſont à luy de concert, Les plus rudes tourmens n’ont point de violence, Qui puiſſent m’obliger à ce honteux ſilence, Si pour la pieté vous voulés m’exhorter;	Nos bouches et nos cœurs sont à lui de concert, Les plus rudes tourments n'ont point de violence, Qui puissent m'obliger à ce honteux silence, Si pour la piété vous voulez m'exhorter;
Vous aurés le plaiſir de me voir écouter, Mais ſi vous n’avés pas d’autres choſes à me dire, que ce qui ne tendroit qu’à la pouvoir détruire, Je dois fermer l’oreille à vos mauvais Conſeils, Et ma loy me deffend d’en ſuivre de pareils;	Vous aurez le plaisir de me voir écouter, Mais si vous n'avez pas d'autres choses à me dire, que ce qui ne tendrait qu'à la pouvoir détruire, Je dois fermer l'oreille à vos mauvais Conseils, Et ma loi me défend d'en suivre de pareils;
En vain vous me preſſés, vous n’aurés pas la gloire De remporter ſur moy cette injuſte victoire, Je perds avec plaiſir & la vie & les biens, Pour la gloire de Dieu de qui ſeul je les tiens, Mais en quittant pour duy le Sceptre & la Couronne, Aux Martyrs genereux j’auray celle qu’il donne, Couronne qui n’eſt pas pour un tems limité, Mais qu’on doit poſſeder pendant l’éternité;	En vain vous me pressez, vous n'aurez pas la gloire De remporter sur moi cette injuste victoire, Je perds avec plaisir et la vie et les biens, Pour la gloire de Dieu de qui seul je les temps, Mais en quittant pour dui le Sceptre et la Couronne, Aux Martyrs généreux j'aurai celle qu'il donne, Couronne qui n'est pas pour un temps limité, Mais qu'on doit posséder pendant l'éternité;
Je quitte donc le Sceptre & je vous l’abandonne, Il eſt tems de vous voir monter deſſus le thrône, Je ne rejette pas mes pretendus malheurs, Sur vous ny ſur le Roy ny ſur mes impoſteurs, Prenés ſoin de mon Pere;	Je quitte donc le Sceptre et je vous l'abandonne, Il est temps de vous voir monter dessus le trône, Je ne rejet pas mes prétendus malheurs, Sur vous Seigneur sur le Roy y sur mes imposteurs, Prensez soin de mon Père;
au fort de ſa vieilleſſe, Employés tous vos ſoins & toute vôtre adreſſe, Pour remplir des devoirs qui ne ſont dûs qu’à luy, Vous devés l’honorer & luy ſervir d’appuy, A la Reine aujourd’huy volontiers je pardonne, Je n’examine point ſi ſa fin étoit bonne;	au fort de sa vieillesse, Employez tous vos soins et toute votre adresse, Pour remplir des devoirs qui ne sont dus qu'à autre, Vous devez l'honorer et ainsi servir d'appui, A la Reine aujourd'hui volontiers je pardonne, Je n'examine point si sa fin était bonne;
c’eſt à Dieu d’en juger, il en ſçait le ſecret, Que ſon cœur ſoit percé d’un ſenſible regret, Loin de m’en reſſentir, j’en ſuis comble de joye, pour me conduire au Ciel, elle a marqué la voye, Et je l’en remercie affectueuſement, Ne gardés point contr’elle aucun reſſentiment:	c'est à Dieu d'en juger, il en sait le secret, Que son cœur soit percé d'un sensible regret, Loin de m'en ressentir, j'en suis comble de joie, pour me conduire au Ciel, elle a marqué la voie, Et je l'en remercie affectueusement, Ne gardez point contr'elle aucun ressentiment:
Non, ne penſés jamais à me vanger ſur elle;	Non, ne pensez jamais à me venger sur elle;
Songés à travailler pour la vie éternelle, Lorſque je joüiray du celeſte bonheur;	Songez à travailler pour la vie éternelle, Lorsque je jouirai du céleste bonheur;
Comptés-moy prés de Dieu pour vôtre Interceſſeur;	Comptez-moi près de Dieu pour votre Intercesseur;
je feray mille vœux pour obtenir les graces, De vous faire Chrétien & marcher ſur mes traces, De quitter pour jamais les ſuperſtitions, Et rendre à nôtre foy d’humbles ſoûmiſſions, Dieu m’inſpire à preſent, je vous le prophetiſe, que vous ſerés un jour au giron de l’E gliſe;	je ferai mille vœux pour obtenir les grâces, De vous faire Chrétien et marcher sur mes traces, De quitter pour jamais les superstitions, Et rendre à notre foi d'humbles soumissons, Dieu m'inspire à présent, je vous le prophétise, que vous avez un jour au giron de l'E glise;
Vous ſerés Catholique, & ſurvivant au Roy;	Vous serez Catholique, et survivant au Roi;
Par tout dans ce Pays vous fonderés la foy, Genereux deffenſeur de l’Egliſe Romaine, vous icres de vos biens accrortre lon domame, Accordés-moy, mon Dieu, cette grace en mourant, C’eſt le ſecond déſir de mon cœur expirant.	Par tout dans ce Pays vous fonderez la foi, Généreux défendeur de l'Église Romaine, vous icres de vos biens accrortre lon domame, Accordez-moi, mon Dieu, cette grâce en mourant, C'est le second dès de mon cœur expirant.
SCENE CINCOIEME.	SCÈNE CINCOIEME.
HER MENEGILDE, RECAREDE, HERMENEFRIDE, LEONIDE, ERASISTRATE.	HÉR MENEGILDE, RECAREDE, HÉRMENEFRIDE, LEONIDE, ERASISTRATE.
Hermenefride.	Hermènefride.
E'!	E'!
comment Leonide, Hermenegilde en vie?	comment Léonide, Hermènegilde en vie?
FI Deſobéir au Roy!	FI Désobéir au Roi!
pourquoy cette manie, Ne vous louvienten prus de ion comandement ?	pourquoi cette manie, Ne vous louvienten prus de ion comandement ?
Craignés tout pour vos jours par ce retardement, Je jure par le Ciel & toutes les puiſſances, Qui répandent ſur nous leurs douces influences;	Craignez tout pour vos jours par ce retardement, Je jure par le Ciel et toutes les puissances, Qui répandent sur nous leurs douces influences;
Si ſa tête n’eſt u bas au lever du ſoleil, Je vous feray punir d’un ſupplice pareil.	Si sa tête n'est u bas au ver du soleil, Je vous ferai punir d'un supplice pareil.
Hermenegilde.	Hermènegilde.
Je vais vous contenter, mon cher Hermenefride, Et répandre mon ſang dont vous étes avide;	Je vais vous contenter, mon cher Hermènefride, Et répandre mon sang dont vous êtes avide;
Donnés, Eraſiſtrate, a mon épouſe encor, Pour un ſigne d’amour cette belle Croix d’or, Dites-luy que je meurs en la Foy la plus pure, Dont elle m’a donné la premiere teinture, Son cœur éprouvera plus de joye à ma mort, Que le deüil naturel ne luy fera de tort :	Donnez, Érasistrate, à mon épouse encor, Pour un signe d'amour cette belle Croix d'or, Dites-lui que je meurs en la Foi la plus pure, Dont elle m'a donné la première teinture, Son cœur éprouvera plus de joie à ma mort, Que le deuil naturel ne lui fera de tort :
Adieu, mes chers amis, conſervés ma memoire;	Adieu, mes chers amis, conservez ma mémoire;
Mais pourquoy pleurés-vous?	Mais pourquoi pleurez-vous?
je m’en vais dans la gloire;	je m'en vais dans la gloire;
Je ſuis prêt de mourir, appellés le Bourreau, J’abandonne ma tête au trenchant du couteau.	Je suis prêt de mourir, appelés le Bourreau, J'abandonne ma tête au trenchant du couteau.
Recarede.	Récarède.
o cier:	ô cier:
cen donc ain que la mont nous ienleve ?	cen donc ain que la mont nous ienlève ?
Contre un deſtin ſi dur tout mon cœur ſe ſouleve, Non, je ne peux ſurvivre à de ſi grands malheurs.	Contre un destin si dur tout mon cœur se soulève, Non, je ne peux survivre à de si grands malheurs.
Eraſiſtrate.	Erasistrate.
Soutenés-vous, grand Prince, & calmés vos douleurs, Vous êtes innocent d’une mort ſi tragique, C’eſt l’ouvrage cruel d'une Reine heretique, Ah !	Soutenez-vous, grand Prince, et calmez vos douleurs, Vous êtes innocent d'une mort si tragique, C'est l'ouvrage cruel d'une Reine hérétique, Ah !
Princeſſe Indegonde, en approchant de vous;	Princesse Indegonde, en approchant de vous;
Comment vous annoncer la mort de vôtre époux!	Comment vous annoncer la mort de votre époux!
Comment recevrès-vous cette triſte nouvelle, Vous allés imiter la chaſte tourterelle.	Comment recevrez-vous cette triste nouvelle, Vous allés imiter la chaste tourterelle.
SCENE SIXIE'ME.	SCÈNE SIXIE'ME.
RECAREDE, LEONIDE, ERASISTRATE, IGERDES.	RECAREDE, LEONIDE, ERASISTRATE, IGERDES.
Igerdes.	Igerdes.
Rand Dieu!	Rand Dieu!
quel changement!	quel changement!
courons à la priſon ¶ Le Roy vient de ſçavoir toute la trahiſon, Des Caiomnateuis ir connoît l’artifice, Il les auroit puni par le dernier ſupplice;	courons à la prison Le Roi vient de savoir toute la trahison, Des Caiomnateuis ir connaît l'artifice, Il les aurait puni par le dernier supplice;
s’ils n’avoient par la fuite évité ſa fureur, Conſervés, dit le Roy, mon fils & mon bonheur, Volés à la priſon porter cette nouvelle;	s'ils n'avaient par la fuite évité sa fureur, Conservez, dit le Roi, mon fils et mon bonheur, Volez à la prison porter cette nouvelle;
Ce Prince eſt innocent, & fut toûjours fidelle.	Ce Prince est innocent, et fut toujours fidèle.
Leonide, arrêtés, Eraſiſtrate.	Léonide, arrêtez, Érasistrate.
.	.
i.	y.
Leonide.	Léonide.
C’en eſt fait, il eſt mort, Eraſiſtrate.	C'en est fait, il est mort, Érasistrate.
Il eſt mort, ah!	Il est mort, ah!
qu’entends-je?	qu'entends-je?
oh que vous avés tort?	oh que vous avez tort?
Igerdes.	Igerdes.
O Ciel!	Ô Ciel!
ah quel deſtin pour un Prince ſi ſage!	ah quel destin pour un Prince si sage!
Quoy!	Quoi!
la mort nous l’enleve à la fleur de!	la mort nous l'enlève à la fleur de!
ſon âge!	son âge!
L’avoir mis dans les fers, n’étoit-ce point aſſés?	L'avoir mis dans les fers, n'était-ce point assez?
Pourquoy trancher le fil des jours ſi traverſés?	Pourquoi trancher le fil des jours si traversés?
mait reux que je ſuis, en apportant ſa grace!	mait reux que je suis, en apportant sa grâce!
Ah!	Ah!
du moins permettés qu’à preſent je l’embraſſe, Et recuëille ſon ſang qu’un Pere a répandu.	du moins permettés qu'à présent je l'embrasse, Et recueille son sang qu'un Père a répandu.
Eraſiſtrat e.	Erasistrat e.
Mon Prince Hermenegilde, en-vous j’ay tout perdu, Parmy tous ſes malheurs c’eſt de quoy je me vante, Je l’ay toûjours ſuivy d’une ferveur conſtante;	Mon Prince Hermènegilde, en-vous j'ai tout perdu, Parmi tous ses malheurs c'est de quoi je me vante, Je l'ai toujours suivi d'une ferveur constante;
Faut-il que ſon honneur ſe voye ainſi terny?	Faut-il que son honneur se voie ainsi terni?
Grand Dieu!	Grand Dieu!
laiſſerés-vous ce grand crime impuni!	laisserez-vous ce grand crime impuni!
Les foudres de vos mains par d’horribles tempêtes;	Les foudres de vos mains par d'horribles tempêtes;
Ne tomberont-ils pas ſur les coupables têtes:	Ne tomberont-ils pas sur les coupables têtes:
Eſt-ce un Pere?	Est-ce un Père?
eſt-ce un tigre?	est-ce un tigre?
un lyon rugiſſant, Qui nous a tous prive de ce Prince innocent?	un lyon rugissant, Qui nous a tous prive de ce Prince innocent?
Eh!	Eh!
qu’eſt donc devenu l’ordre de la Juſtice?	qu'est donc devenu l'ordre de la Justice?
Depuis quand ttaîne-t’on l’innocence au ſupplice?	Depuis quand ttaîne-t-on l'innocence au supplice?
Il faloit écouter la forme & la raiſon, pon eut pa decoutm iinfame trahiſon.	Il fallait écouter la forme et la raison, pon eut pa découtm infâme trahison.
CETHE SEPTIEME.	CETHÉ SEPTIÈME.
LEVIGILDE, CARDACES.	LEUIGILDE, CARDACES.
Levigilde.	Levigilde.
Nfin, la verité commence à ſe connoitre, E Dariaces eſt donc.	Nfin, la vérité commence à se connaître, E Dariaces est donc.
Cardaces.	Cardaces.
Ah!	Ah!
Sire, c’eſt un traître, Il eſt par les remords de ce crime agité, Il ſçait le chatiment qu’il a bien merité, Il n’oſe icy paroître, il fuit vôtre preſence, Il craint d’être puny pour une telle offenſe;	Sire, c'est un traître, Il est par les remords de ce crime agité, Il sait le châtiment qu'il a bien mérité, Il n'ose ici paraître, il fuit votre présence, Il craint d'être puni pour une telle offense;
Il a donc pris la fuite afin de l’éviter.	Il a donc pris la fuite afin de l'éviter.
Levigilde.	Levigilde.
Vite, vîte, au plûtôt qu’on le faſſe arrêter;	Vite, vite, au plûtôt qu'on le fasse arrêter;
Cardaces.	Cardaces.
ii cet orait précis, grand Roy, je vais me rendre, Mais voicy Durias, daignerés.	ji cet orait précis, grand Roi, je vais me rendre, Mais voici Durias, daignerés.
vous l’entendre?	vous l'entendre?
SCENE HUITIE’ME.	SCÈNE HUITIE'ME.
LEVIGILDE, DURIAS, ERASISTRATE.	LEUIGILDE, DURIAS, ERASISTRATE.
Durias.	Durias.
E ſera-t’il permis d’embraſfer vos genoux?	E sera-t-il permis d'embrasser vos genoux?
M C’eſt un azile ſur dont pluſieurs ſont jaloux, Auprés de vous, grand Roy, je cherche ce Refuge;	M M'est un asile sur dont plusieurs sont jaloux, Auprès de vous, grand Roi, je cherche ce Refuge;
Daignés me rêcevoir en Pere & non en Juge;	Daignès me rêcevoir en Père et non en Juge;
Je viens vous demander pour un Prince innocent, Le dédommagement que l’on doit à ſon ſang, L’excés de vôtre haine & de vôtre colere, L’oblige de ſouffrir un chatiment ſevere, Vous avés écoûté les rapports impoſteurs, qu’ont déchargé ſur luy ſes calomniateurs:	Je viens vous demander pour un Prince innocent, Le dédommagement que l'on doit à son sang, L'excès de votre haine et de votre colère, L'oblige de souffrir un châtiment sévère, Vous avez écoûté les rapports imposteurs, qu'ont déchargé sur lu ses Calomniateurs:
Ah!	Ah!
Sire, penſés-vous que celuy qu’on outrage, De vos rares vertus eſt la brillante image?	Sire, pensez-vous que celui qu'on outrage, De vos rares vertus est la brillante image?
Que vous trempés vos mains dans vôtre propre ſang, qurſeimenegnde eumi ent au riince innocent?	Que vous trempez vos mains dans votre propre sang, qurseimènegnède eumi ent au riince innocent?
Vous le faites gemir en priſon dans les chaînes;	Vous le faites gémir en prison dans les chaînes;
Il ſouffre la rigueur des plus cruelles peines, Luy qui jamais pour vous n’a manqué de reſpect;	Il souffre la rigueur des plus cruelles peines, Lui qui jamais pour vous n'a manqué de respect;
Pourquoy d’un crime affreux le croyés-vous ſuſpect?	Pourquoi d'un crime affreux le croyez-vous suspect?
Levigilde.	Levigilde.
La voix de la nature eſt toûjours la-plus forte, Sur tous mes préjugés ſa puiſſance l’emporte, Elle a calmé mon cœur, defarmé mon courroux, Et m’inſpire aujourd’huy, des ſentimens plus doux, Que mon fils vive donc, qu’Hermenegilde vive, Qu’un deſtin plus tranquille & plus heureux le ſuive, Je reconnois trop tard que les rapports flateurs, Partoient du cœur malin des calomniateurs, Je conſens,,Durias, à ta juſte demande, Court donc' prõmptement, c’eſt moy qui le commande, Du Prince Hermenegilde entre dans la priſon, oſte-luy tous ſes fers, je luy feray raiſon.	La voix de la nature est toujours la-plus forte, Sur tous mes préjugés sa puissance l'emporte, Elle a calmé mon cœur, désarmé mon courroux, Et m'inspire aujourd'hui, des sentiments plus doux, Que mon fils vive donc, qu'Hermènegilde vive, Qu'un destin plus tranquille et plus heureux le suive, Je reconnais trop tard que les rapports flatteurs, Partaient du cœur malin des calomniateurs, Je consens,Durias, à ta juste demande, Court donc prõmptement, est moi qui le commande, Du Prince Hermenegilde entre dans la prison, ôte-lui tous ses fers, je lui ferai raison.
Durias à Eraſiſtrate.	Durias à Erasistrate.
Eh!	Eh!
pourquoy pleurés-vous?	pourquoi pleurez-vous?
n2 Jyrnles Mortelle eſt ma ma triſteſſe,	n2 Jyrnles Mortelle est ma ma tristesse,
Levigilde.	Levigilde.
Ne vous donne-je pas tout ſujet d’allegreſſe, Laiſſant vivre mon Fils qui fait vôtre ſupport?	Ne vous donne-je pas tout sujet d'allégresse, Laissant vivre mon Fils qui fait votre support?
Erafiſtrate.	Erafistrate.
Ah!	Ah!
Sire, il eſt trop tard,	Sire, il est trop tard,
Levigilde.	Levigilde.
Touiduoy donc ?	Touiduoi donc ?
Eraſiſtra te.	Erasistra te.
Il eſt mort.	Il est mort.
Le vigilde.	Le vigilde.
C’eſt ma faute;	C'est ma faute;
il eſt vray, j’ay commandé qu’il meure;	il est vrai, j'ai commandé qu'il meure;
Mais il faut de ſa mort qu’on ait devancé l’heure,	Mais il faut de sa mort qu'on ait devancé l'heure,
Durias.	Durias.
Quene ameule nouvenc apportes-vous icy ?	Quène ameule nouvenc apportes-vous ici ?
Je tremble, je fremis, j’en ay le cœur tranſy:	Je tremble, je frémis, j'en ai le cœur transi:
Ah!	Ah!
que ne puis-je encor embraſſer mon cher maître!	que ne puis-je encor embrasser mon cher maître!
Pour la derniere fois je veux le reconnoitre.	Pour la dernière fois je veux le reconnaître.
Eraſiſtrate.	Erasistrate.
Il eſt mort, il eſt mort par la main d’un Bourreau;	Il est mort, il est mort par la main d'un Bourreau;
C’eſt pour tous vos sujets un ſpectacle nouveau :	C'est pour tous vos sujets un spectacle nouveau :
Que ne perdés-vous pas, sire, dans ce grand homme!	Que ne perdez-vous pas, sire, dans ce grand homme!
netoit le ſoutien de tout vôtre Royaume;	netait le soutien de tout votre Royaume;
Vous l’avés fait mourir, & mourir innocent, Sa' mort eſt contre vous un reproche puiſſant;	Vous l'avez fait mourir, et mourir innocent, Sa' mort est contre vous un reproche puissant;
j’ay recuëlli ſon ſang, en voilà des reliques!	j'ai recuelli son sang, en voilà des reliques!
Dignes de recevoir des honneurs magnifiques.	Dignes de recevoir des honneurs magnifiques.
Levigilde.	Levigilde.
ouy, je le vois ce fang dont vous êtes taché, Ma douleur eſt extrême, & j’en ſuis trés- faché, Ciel!	oui, je le vois ce sang dont vous êtes taché, Ma douleur est extrême, et j'en suis très- fâché, Ciel!
pourquoy me donner une ſi longue vie, Si ma gloire à la fin devoit être ternie?	pourquoi me donner une si longue vie, Si ma gloire à la fin devait être ternie?
Mon fits, vous êtes mort, je vous ay donc perdu;	Mon fitz, vous êtes mort, je vous ai donc perdu;
Mais ce qui me confond, c’eſt que je l’ay voulu.	Mais ce qui me confond, c'est que je l'ai voulu.
Cardaces.	Cardaces.
O Pere malheureux!	Ô Père malheureux!
ô Prince Hermenegilde?	ô Prince Hermènegilde?
Levigilde.	Levigilde.
Quelle honte à jamais pour le Roy Levigilde!	Quelle honte à jamais pour le Roi Levigilde!
Inſenſé, furieux, execrable vieillard, Devois-tu pour ta femme avoir eu tant d’égard?	Insensé, furieux, exécrable vieillard, Devais-tu pour ta femme avoir eu tant d'égard?
Par ta credulité tu commets ce grand crime, Qui de tous tes Sujets te fait perdre l’eſtime, qui doit ternir l’éclat de tes fameux exploits, Et te rendre l’horreur des Princes & des Rois!	Par ta crédulité tu commets ce grand crime, Qui de tous tes Sujets te fait perdre l'estime, qui doit ternir l'éclat de tes fameux exploits, Et te rendre l'horreur des Princes et des Rois!
O Marâtre de mere!	Ô Marâtre de mère!
ouy, c’eſt par ton envie, que ion riis a peruu le jour avec la vie, Ce Fils plein de vertu, digne du plus haut rang, Qui devoit ſoutenir la gloire de mon ſang!	oui, c'est par ton envie, que ion riis a perv le jour avec la vie, Ce Fils plein de vertu, digne du plus haut rang, Qui devait soutenir la gloire de mon sang!
Sophron.	Sophron.
Sire, à quoy ſerviront à preſent tant de larmes, Tant de gemiſſemens, de chagrins & d’allarmes?	Sire, à quoi serviront à présent tant de larmes, Tant de gémissements, de chagrins et d'alarmes?
Des portes de la mort qui peut le rappeller?	Des portes de la mort qui peut le rappeler?
Le mal eſt ſans remede, il n’en faut plus parler,	Le mal est sans remède, il n'en faut plus parler,
Levigilde.	Levigilde.
Helas!	Hélas!
que dites-vous?	que dites-vous?
n’ay-je pas tout à craindre?	n'ai-je pas tout à craindre?
Me conſoler ſi-tôt, ce ſeroit me contraindre, De l’amour paternel j’éprouve les douleurs;	Me consoler sitôt, ce serait me contraindre, De l'amour paternel j'éprouve les douleurs;
Rien ne doit arréter le torrent de mes pleurs;	Rien ne doit arrêter le torrent de mes pleurs;
j’ay fait mourir mon Fils, tout ce que je peux faire, A ce que je ſuy dois pourlu-t’il ſatisfaire?	j'ai fait mourir mon Fils, tout ce que je peux faire, À ce que je suis dois pourlu-t-il satisfaire?
Un deſeſpoir ſecret que je ne puis calmer, Me percera toûjours d’un repentir amer, Eh bien !	Un désespoir secret que je ne puis calmer, Me percera toujours d'un repentir amer, Eh bien !
Eraſiſtrate à cette heure derniere, Enviſageant la mort, quelle étoit ſa mauiere?	Erasistrate à cette heure dernière, Envisageant la mort, quelle était sa mavière?
Eraſiſtrate.	Erasistrate.
ni reguidoit la mort comme un victorieux, Et c’étoit un triomphe agréable à ſes yeux;	ni réguidait la mort comme un victorieux, Et c'était un triomphe agréable à ses yeux;
Non, je ne vis jamais une mort ſi paiſible, Ce Prince paroiſſoit un rocher inſenſible.	Non, je ne vis jamais une mort si paisible, Ce Prince paraissait un rocher insensible.
Levigilde.	Levigilde.
N’a-t'il pas contre moy fait d’imprécations!	N'a-t'-il pas contre moi fait d'imprécations!
Fraſiſtrate.	Frastrate.
A ſon frere il a fait des ſupplications, D’employer tous ſes ſoins & toute ſa tendreſſe, Pour ſoulager en tout votre grande vienleſſe, De ne manquer jamais au reſpect à l’amour, Qu’il doit au Souverain qui luy donna le jour, Le refus qu’on luy, fit de parler à ſa femme, Fut un coup bien ſenſible à ſa genereuſe ame;	À son frère il a fait des supplications, D'employer tous ses soins et toute sa tendresse, Pour soulager en tout votre grande vienlesse, De ne manquer jamais au respect à l'amour, Qu'il doit au Souverain qui lui donna le jour, Le refus qu'on tu, fit de parler à sa femme, Fut un coup bien sensible à sa généreuse âme;
Un Prêtre Catholique à ſes vœux refuſé, Ne deſola pas moins cet illuſtre accuſe, Apres avon prie pour le bien du Royaume, Il offrit au Bourreau ſa tête, 2	Un Prêtre Catholique à ses vœux refusé, Ne désola pas moins cet illustre accuse, Apres avon prie pour le bien du Royaume, Il offrit au Bourreau sa tête, 2
Levigilde.	Levigilde.
O le grand homme !	Ô le grand homme !
Faut-il que tu ſois mort par la main d’un Bourreau?	Faut-il que tu sois mort par la main d'un Bourreau?
O pretieuſe tête!	Ô prieuse tête!
ô barbare couteau !	ô barbare couteau !
Pourquoy trancher le fil d’une ſi belle vie, qui des plus grands, honneurs devoit être ſuivie?	Pourquoi trancher le fil d'une si belle vie, qui des plus grands, honneurs devait être suivie?
O martyr genereux, dont je pleure la mort, Je dois me réjouir du bonheur de ton ſort, Tu regnes dans la gloire, & deſormais j’eſpere, Qus tu n’oublieras point ton miſerable Pere.	Ô martyr généreux, dont je pleure la mort, Je dois me réjouir du bonheur de ton sort, Tu règnes dans la gloire, et désormais j'espère, Qus tu n'oublieras point ton misérable Père.
SCENE NEUVIE'ME.	SCÈNE NEUIE'ME.
LEVIGILDE IGERDES.	LEUIGILDE IGÈRDES.
Igerdes.	Igerdes.
Ire, calmés vos ſens, & ceſſés de pleurer, O Nous avons le ſaint Corps, il le faut reverer, Le Ciel vient d’honorer ſon glorieux martyre, De prodiges divers que l’on ne ſçauroit dire, Remet tant ſon eſprit entre les mains de Dieu;	Ire, calmez vos sens, et cessés de pleurer, Ô Nous avons le saint Corps, il le faut révérer, Le Ciel vient d'honorer son glorieux martyre, De prodiges divers que l'on ne saurait dire, Remet tant son esprit entre les mains de Dieu;
Dans le même moment j’entendis en ce lieu, D’un beau concert de voix la charmante harmonie, Par ves globes de feux l’obſcurité bannie, Attirbit d’un chacun les curieux regards, Oy les voyoit rouler brillans de toutes parts, Var ces globes de feux & ces divins Cantiques, Le Ciel de ce martyr honore les Reliques.	Dans le même moment j'entendis en ce lieu, D'un beau concert de voix la charmante harmonie, Par vez globes de feux l'obscurité bannie, Atirbit d'un chacun les curieux regards, Oi les voyait rouler brillants de toutes parts, Var ces globes de feux et ces divins Cantiques, Le Ciel de ce martyr honore les Reliques.
Levigilde.	Levigilde.
O Dieu!	Ô Dieu!
par un prodige admirable & puiſſant, Tu ſoûtiens l’innocence honorant l’innocent, Tu fus perſecuté;	par un prodige admirable et puissant, Tu soutiens l'innocence honorant l'innocent, Tu fus persécuté;
mais ta magnificence Luy donne dans la gloire une ample recompenſe;	mais ta magnificence Lui donne dans la gloire une ample récompense;
Tu viens de condamner l’excés de ma fureur.	Tu viens de condamner l'excès de ma fureur.
Par un fait ſurprenant qui me touche le cœur, Il ne m’en reſte pas dans l’eſprit aucun doute:	Par un fait surprenant qui me touche le cœur, Il ne m'en reste pas dans l'esprit aucun doute:
Mais helas!	Mais hélas!
que feray-je écarté de ma route?	que ferai-je écarté de ma route?
Mon Fils Hermenegilde, ah!	Mon Fils Hermènegilde, ah!
du plus haut des Cieux, où tu te vois reçû triomphant glorieux, Daigne jetter ſur moy tes regards favorables, Obtiens-moy par tes vœux des ſecours charitables;	du plus haut des Cieux, où tu te vois reçu triomphant glorieux, Daigne jeter sur moi tes regards favorables, Obtiens-moi par tes vœux des secours charitables;
Je reconnois mon crime, & viens d’un triſte ton Chercher miſericorde, & demander pardon, Appaiſe en ma faveur la divine Juſtice, Suſpends le bras vangeur, rends mon Juge propice, D’une ſainte lumiere éclaire mon eſprit, Au livre des Elûs fait que je lois cerit, Et que par les vertus ſoutenant ma conduite, De regner avec toy j’obtienne le merite.	Je reconnais mon crime, et viens d'un triste ton Chercher miséricorde, et demander pardon, Apaise en ma faveur la divine Justice, Suspends le bras vengeur, rends mon Juge propice, D'une sainte lumière éclaire mon esprit, Au livre des Elus fait que je lois cérit, Et que par les vertus soutenant ma conduite, De régner avec toi j'obtienne le mérite.
Fraſiſtrate.	Frastrate.
Prince le plus charmant!	Prince le plus charmant!
digne des ſaints autels, Qui peut avoir ſur vous porté ces coups mortels?	digne des saints autels, Qui peut avoir sur vous porté ces coups mortels?
On m’a donné le ſoin de vôtre ſepulture;	On m'a donné le soin de votre sépulture;
Mais que feray-je helas!	Mais que ferai-je hélas!
dans cette conjoneture?	dans cette conjoneture?
où trouveray-je un lieu qui ſoit digne de vous?	où trouverai-je un lieu qui soit digne de vous?
D’un ſuperbe tombeau vous n’êtes point jaloux, Je vais prendre conſeil ſur ce que je dois faire.	D'un superbe tombeau vous n'êtes point jaloux, Je vais prendre conseil sur ce que je dois faire.
Durias.	Durias.
Qui pourra deſormais ſoulager ma miſere, Helas!	Qui pourra désormais soulager ma misère, Hélas!
j’ay ſtout perdu;	j'ai stout perdu;
mon Prince en vous perdant, Parlés-moy donc encor, mais en me commandant;	mon Prince en vous perdant, Parlez-moi donc encor, mais en me commandant;
Dites ſi je vous peux rendre quelque ſervice, Je l’ay fait autrefois, & c’étoit mon office, J’avois un rang d’honneur parmy vos favoris, J’entrois dans vos ſecrets, j’étois des plus cheris, En attendant le bien de vous voir dans la gloire, Je vous auray toûjours gravé dans ma memoire, Si la mort à mes yeux vous ravit en ce jour, Vous vivrés dans mon cœur par le plus tendre amour,	Dites si je vous peux rendre quelque service, Je l'ai fait autrefois, et c'était mon office, J'avais un rang d'honneur parmi vos favoris, J'entrais dans vos secrets, j'étais des plus chéris, En attendant le bien de vous voir dans la gloire, Je vous aurai toujours gravé dans ma mémoire, Si la mort à mes yeux vous ravit en ce jour, Vous vivriez dans mon cœur par le plus tendre amour,
L Levigilde.	 Levigilde.
Aux chapts harmonieux d’une douce muſique, Qu’on porte le ſaint Corps au Temple magnifique, La nous dluy rendrons tous les plus dignes honneurs:	Aux chapts harmonieux d'une douce musique, Qu'on porte le saint Corps au Temple magnifique, La nous dlui rendrons tous les plus dignes honneurs:
Pour obtenir par luy les divines faveurs.	Pour obtenir par lui les divines faveurs.
Bn du cinquiéme & dernier Acte.	Bn du cinquième et dernier Acte.
Par un fait ſurprenant qui me touche le cœur, Il ne m’en reſte pas dans l’eſprit aucun doute:	Par un fait surprenant qui me touche le cœur, Il ne m'en reste pas dans l'esprit aucun doute:
Mais helas!	Mais hélas!
que feray-je écarté de ma route?	que ferai-je écarté de ma route?
Mon Fils Hermenegilde, ah!	Mon Fils Hermènegilde, ah!
du plus haut des Cieux, où tu te vois reçû triomphant glorieux, Daigne jetter ſur moy tes regards favorables, Obtiens-moy par tes vœux des ſecours charitables;	du plus haut des Cieux, où tu te vois reçu triomphant glorieux, Daigne jeter sur moi tes regards favorables, Obtiens-moi par tes vœux des secours charitables;
Je reconnois mon crime, & viens d’un triſte ton Chercher miſericorde, & demander pardon, Appaiſe en ma faveur la divine Juſtice, Suſpends le bras vangeur, rends mon Juge propice, D’une ſainte lumiere éclaire mon eſprit, Au livre des Elûs fait que je lois cerit, Et que par les vertus ſoutenant ma conduite, De regner avec toy j’obtienne le merite.	Je reconnais mon crime, et viens d'un triste ton Chercher miséricorde, et demander pardon, Apaise en ma faveur la divine Justice, Suspends le bras vengeur, rends mon Juge propice, D'une sainte lumière éclaire mon esprit, Au livre des Elus fait que je lois cérit, Et que par les vertus soutenant ma conduite, De régner avec toi j'obtienne le mérite.
Fraſiſtrate.	Frastrate.
Prince le plus charmant!	Prince le plus charmant!
digne des ſaints autels, Qui peut avoir ſur vous porté ces coups mortels?	digne des saints autels, Qui peut avoir sur vous porté ces coups mortels?
On m’a donné le ſoin de vôtre ſepulture;	On m'a donné le soin de votre sépulture;
Mais que feray-je helas!	Mais que ferai-je hélas!
dans cette conjoneture?	dans cette conjoneture?
où trouveray-je un lieu qui ſoit digne de vous?	où trouverai-je un lieu qui soit digne de vous?
D’un ſuperbe tombeau vous n’êtes point jaloux, Je vais prendre conſeil ſur ce que je dois faire.	D'un superbe tombeau vous n'êtes point jaloux, Je vais prendre conseil sur ce que je dois faire.
Durias.	Durias.
Qui pourra deſormais ſoulager ma miſere, Helas!	Qui pourra désormais soulager ma misère, Hélas!
j’ay ſtout perdu;	j'ai stout perdu;
mon Prince en vous perdant, Parlés-moy donc encor, mais en me commandant;	mon Prince en vous perdant, Parlez-moi donc encor, mais en me commandant;
Dites ſi je vous peux rendre quelque ſervice, Je l’ay fait autrefois, & c’étoit mon office, J’avois un rang d’honneur parmy vos favoris, J’entrois dans vos ſecrets, j’étois des plus cheris, En attendant le bien de vous voir dans la gloire, Je vous auray toûjours gravé dans ma memoire, Si la mort à mes yeux vous ravit en ce jour, Vous vivrés dans mon cœur par le plus tendre amour,	Dites si je vous peux rendre quelque service, Je l'ai fait autrefois, et c'était mon office, J'avais un rang d'honneur parmi vos favoris, J'entrais dans vos secrets, j'étais des plus chéris, En attendant le bien de vous voir dans la gloire, Je vous aurai toujours gravé dans ma mémoire, Si la mort à mes yeux vous ravit en ce jour, Vous vivriez dans mon cœur par le plus tendre amour,
L Levigilde.	 Levigilde.
Aux chapts harmonieux d’une douce muſique, Qu’on porte le ſaint Corps au Temple magnifique, La nous dluy rendrons tous les plus dignes honneurs:	Aux chapts harmonieux d'une douce musique, Qu'on porte le saint Corps au Temple magnifique, La nous dlui rendrons tous les plus dignes honneurs:
Pour obtenir par luy les divines faveurs.	Pour obtenir par lui les divines faveurs.
Bn du cinquiéme & dernier Acte.	Bn du cinquième et dernier Acte.
