A MADAME DE LA CHASTAIGNERAYE.	À MADAME DE LA CHÂTAIGNERAYE.
ADAME, Ie ne ſçay ſi vous approuuerez le deſſein que i'ay pris de vous offrir ce Poëme:	ADAME, Je ne sais si vous approuverez le dessein que j'ai pris de vous offrir ce Poème:
Mais i'oſe eſperer que vous ne blaſmerez point mon zele quand vous ſçaurez que ie vous dedie cette piece plus par vn hommage respectueux que je vous doique pour vous faire vn preſent.	Mais j'ose espérer que vous ne blâmerez point mon zèle quand vous saurez que ie vous dedie cette pièce plus par un hommage respectueux que je vous doique pour vous faire un présent.
I ay tant d’obligations à Monſieur de la Chaſtaigneraye voſtre digne mary, & je ſçay ſi peu par où les reconnoiſtre, qu'encores que ie vous donne cet ouurage, ie preuois 5 que ie luy ſeray redeuable toute ma vie:	I ai tant d'obligations à Monsieur de la Châtaigneraie votre digne mari, et je sais si peu par où les reconnaître, qu'encores que je vous donne cet ouvrage, Seigneur prévois 5 que ie ans serai redevable toute ma vie:
De ſorte.	De sorte.
Madame que i ay cru que comme il a fait choix de voſtre charmante perſonne pour vous donner ſes vœux les plus tendres, ie deuois auſſi vous choiſir pour vous donner ce que j'aurois pu luy preſenter, ſçachant que vous eſtes ce qu'il aime le plus au mon de.	Madame que j' ai cru que comme il a fait choix de votre charmante personne pour vous donner ses vœux les plus tendres, ie deuois aussi vous choisir pour vous donner ce que j'aurais pu lui présenter, sachant que vous êtes ce qu'il aime le plus au mon de.
Si cette piece peut paſſer pour quelque remerciment, a qui puis-ie mieux m'adreſſer qu'à la plus chere partie de luy-meſme pour la luy offrir?	Si cette pièce peut passer pour quelque remerciment, à qui puis-je mieux m'adresser qu'à la plus chère partie de Roy-même pour la lui offrir?
Ie ſçay bien que ce n’eſt pas icy vn ouurage digne de vous eſtre preſenté;	Je sais bien que ce n'est pas ici un ouvrage digne de vous être présenté;
Mais ce qui me conſole, c'eſt qu'il n’en eſt point dont le merite ne ſoit fort au deſſous du voſtre:	Mais ce qui me console, c'est qu'il n'en est point dont le mérite ne soit fort au dessous du vôtre:
Comme il n'eſt point d’Objets qui puiſſent vous eſtre comparables, auſſi n'eſt-il point d’Autheurs qui vous puiſſent rien donner d’eſgal à vous.	Comme il n'est point d'Objets qui puissent vous être comparables, aussi n'est-il point d'Auteurs qui vous puissent rien donner d'égal à vous.
Cependant MADAME, comme i’ay veu cette Comedie ſuiuie de quantité d’honneſtes gens, qui n’en ſont iamais ſortis que fort ſatisfaits i'ay moins de repugnance à vous la preſenter.	Cependant MADAME, comme j'ai vu cette Comédie suivie de quantité d'honnêtes gens, qui n'en sont jamais sortis que fort satisfaits j'ai moins de répugnance à vous la présenter.
Il eſt vray, que ſi elle a eu quelques applaudiſſemens, elle vous en doit toute la glotre, puis que la premiere fois qu'elle parut & qu'elle eut l’honneur de vous attirer, vous en diſtes ſi obligeamment & ſi hautement du bien, que toute l’aſſemblée vous l'entendant loüer de ſi bonne grace, elle ne put s’empeſcher d’en faire de meſme à voſtre exemple:	Il est vrai, que si elle a eu quelques applaudissements, elle vous en doit toute la glotre, puis que la première fois qu'elle parut et qu'elle eut l'honneur de vous attirer, vous en dîtes si obligeamment et si hautement du bien, que toute l'assemblée vous l'entendant louer de si bonne grâce, elle ne put s'empêcher d'en faire de même votre exemple:
je m'imagine enco, 1u voir tout ce peuple vous applautii yenl dit en joi tsnve y	je m'imagine enco, 1u voir tout ce peuple vous applauti yenl dit en joi tsnve y
Ciel!	Ciel!
quel objet adorable, y Vient nous rauir tous en ces lieux!	quel objet adorable, y Vient nous ravir tous en ces lieux!
C’eſt, ie croy, le plus grãd des Dieux, Oüy, c’eſt l’Amour ou ſon ſemblable.	C'est, Seigneur crois, le plus grands des Oui, Oui, c'est l'Amour ou son semblable.
Mais las!	Mais las!
que dis-je miſerable?	que dis-je misérable?
Ié ſçay que l’amour n’a point d’yeux Et j’en apperçois icy deux, Dont le charme eſt jncomparable.	Jé sais que l'amour n'a point d'yeux Et j'en aperçois ici deux, Dont le charme est jncomparable.
Pourtant cette rare Beauté Sceut paſſer pour Diuinité Sans rencontrer aucun obſtacle;	Pourtant cette rare Beauté Sut passer pour Divinité Sans rencontrer aucun obstacle;
Des que ion viſage eut brillé.	Des que ion visage eut brillé.
Tout le monde cria miracle, Et reſta tout émerueille.	Tout le monde cria miracle, Et resta tout émerveille.
Iugez, Madame, fi apres vn tel rauiſſement tout ce monde n’auroit pas voulu trouuer vne occaſion auſſi fauorable que celle que i'ay, pour ſe dire.	Jugez, Madame, fi après un tel ravissement tout ce monde n'aurait pas voulu trouver une occasion aussi favorable que celle que j'ai, pour se dire.
cemme j’oſe me dire, auec vne ſoûmiſtion reſpectueuſe,	cème j'ose me dire, avec une soûmistion respectueuse,
MADAME, Voſtre tres humble, & tres-obeyſſant ſerui teur;	MADAME, Votre très humble, et très-obéissant servi teur;
CREVACILI	CREUCILI
ADVIS DV LIBRAIRE 6 un Mausmis.	ADVIS DU LIBRAIRE 6 un Mausmis.
Intrigue des Caroſſes à cinq ſous que je te donne, & que, j'expoſe à toute ta Lcenſure a paru ſur le Theatre du Marais ſi auantageuſement & a acquis tant de gloire à ſon Autheur par les applaudiſſemens que peut-eſtre toy-meſme tu luy as donnez, que de peur de te faire tort dans l’inégalité de tes jugemens je veux croire que tu luy rendras la meſme iuſtice, ou que tu auras la meſme bonté que tu fis paroiſtre quand tes ſuffrages contribuerent à ſa reuſſite.	Intrigue des Carosses à cinq sous que je te donne, et que, j'expose à toute ta Lcensure a paru sur le Théâtre du Marais si avantageusement et a acquis tant de gloire à son Auteur par les applaudissements que peut-être toi-même tu lui as donnez, que de peur de te faire tort dans l'inégalité de tes jugements je veux croire que tu lui rendras la même justice, ou que tu auras la même bonté que tu fis paraître quand tes suffrages contribuèrent à sa réussite.
Tu as ſans doute l’eſprit trop bon pour t’eſtre laiſſé ſurprendre à la delicateſſe de la repreſentation, & à la beauté des habits, & comme il y a des perſonnes qui ſont ſi mal traittées de la nature, que le fard eſt employé pour reparer les deffauts que le Ciel a repandu fur elles, il y en a d’autres de qui les charmes ont le pouuoir d’embellir le lard.	Tu as sans doute l'esprit trop bon pour t'être laissé surprendre à la délicatesse de la représentation, et à la beauté des habits, et comme il y a des personnes qui sont si mal traitées de la nature, que le fard est employé pour réparer les défauts que le Ciel a répandu fur elles, il y en a d'autres de qui les charmes ont le pouvoir d'embellir le lard.
3i l'hlatheur qui ſe ſert de mon miniſtere pour fauoriſer le public de cette piece, auoit moins de modeſtie, je dirois que quelque empreſſement qu’il y ait eu à en voir les frequentes repreſentations qui en ont eſté données, elle eſt encore plus attenduë pour la beaute& de ſon inuention qu’elle ne le fut autresfois pour la nouueauté de ſon titre.	Ojà l'hlateur qui se sert de mon ministère pour favoriser le public de cette pièce, avait moins de modestie, je dirais que quelque empressement qu'il y ait eu à en voir les fréquentes représentations qui en ont été données, elle est encore plus attendue pour la beauté de son invention qu'elle ne le fut autrefois pour la nouveauté de son titre.
Ceux qui Pont veuë, aſpirent à lla voir encore pour gouter la meſme ſatis faction qu’ils ont déja receuë, peut-eſtre plus d’vne fois, & ceux qui ont eſté aſſer, ral-heureux pour n’auoir pû jouïr juſqu’à preſe tvn diuertiſſement ſi ſouhaitable, n’ont pris l’ennie de deſirer vne occaſion fauorable de s’y rencontrerque ſur la foy du rapport auantageux qu’on leur en a fait.	Ceux qui Pont vue, aspirent à lla voir encore pour goûter la même satî faction qu'ils ont déjà reçue, peut-être plus d'une fois, et ceux qui ont été asser, ralheureux pour n'avoir pu jouir jusqu'à prese tête divertissement si souhaitable, n'ont pris l'ennie de désirer toujours occasion favorable de s'y rencontrer sur la foi du rapport avantageux qu'on leur en a fait.
Quoy que j’en ſois maintenant poſſeſſeur, je ne me fuſſe point haſté de mettre cette Comedie ſous la preſſe ſans la juſte impatience que témolgne ce qu’il y a d’honneſtes gens dans Paris, de digerer à loiſir toutes les beautez qu’ils y ont remarquée en peu de temps, pour y rencontrer tout le plaiſir qu’ils y trouueront quand ils y appliqueront des reflections neceſſaires.	Quoi que j'en sois maintenant possesseur, je ne me fusse point hâté de mettre cette Comédie sous la presse sans la juste impatience que témolgne ce qu'il y a d'honnêtes gens dans Paris, de digérer à loisir toutes les beautés qu'ils y ont remarquée en peu de temps, pour y rencontrer tout le plaisir qu'ils y trouveront quand ils y appliqueront des reflections nécessaires.
S’il m’eſt dû de la reconnoiſſance pour le zele que je fais paroiſtre pour ton contentement, tu peux l’employer à precipiter le debit de tous les exemplaires que je te reſerue, & de ma part ie te proteſte que ſi par mal-heur il y a quelque choſe qui te choque la veuë, & qu’il ſe ſoit gliſſé quelque fautes dans l’impreſſion, je ſeray plus ſoigneux de les corriger dans la ſeconde Edition qui en ſera faite.	S'il m'est dû de la reconnaissance pour le zèle que je fais paraître pour ton contentement, tu peux l'employer à précipiter le débit de tous les exemplaires que je te réserve, et de ma part ie te proteste que si par malheur il y a quelque chose qui te choque la vue, et qu'il se soit glissé quelque fautes dans l'impression, je serai plus soigneux de les corriger dans la seconde Édition qui en sera faite.
EXTRAIT DV PRIVILEGE au Reje	EXTRAIT DU PRIVILÈGE au Reje
AR Grace & Priuilege du Roy, donné à Paris le 7.	AR Grâce et Privilège du Roi, donné à Paris le 7.
Decembre 1662.	Décembre 1662.
Signé Par le Roy en ſon Conſeil NOBLET;	Signé Par le Roi en son Conseil NOBLET;
II eſt permis à PIERRE BAVDOVYN Marchand Libraire à Paris, d’imprimer ou de faire imprimer en tel volume & caractere, & autant de fois que bon luy ſemblera, vne Comedie intitulée L’iNTRIGVE DES CAROSSES A CINQ SOVS, repreſentée ſur le Theatre Royal du Matais, composée par le ſieur Cheualier Comedien, ordinaire de ſa Maieſté par tel Imprimeur qu’il voudra, pendant le temps de cinq années:	II est permis à PIERRE BAUDOUIN Marchand Libraire à Paris, d'imprimer ou de faire imprimer en tel volume et caractère, et autant de fois que bon lui semblera, une Comédie intitulée L'iNTRIGUE DES CAROSS A CINQ SOUS, représentée sur le Théâtre Royal du Matais, composée par le sieur Chalier Comédien, ordinaire de sa Majesté par tel Imprimeur qu'il voudra, pendant le temps de cinq années:
& deffenſes ſont faites à tous autres de l’imprimer ou en vendre d’autre Edition que de celle de l’Expoſant, ou de ceux qui auront droict de luy;	et défenses sont faites à tous autres de l'imprimer ou en vendre d'autre Édition que de celle de l'Exposant, ou de ceux qui auront droit de Seigneur;
à peine de mille liures d’amende, de confiſcation des exemplaires & de tous deſpens, dommages, & intereſts, comme il eſt porté plus amplement par les Lettres dudit Priuilege.	à peine de mille livres d'amende, de confiscation des exemplaires et de tous dépens, dommages, et intérêts, comme il est porté plus amplement par les Lettres dudit Privilège.
Regiſtré dans le liure de la Communaute des Libraires & Imprimeurs de cette Ville de Paris le 29.	Registré dans le livre de la Communaute des Libraires et Imprimeurs de cette Ville de Paris le 29.
Decembre 1662.	Décembre 1662.
ſuiu ant l’Arreſt de la Ceur de Parlement du 8.	suiu de la Arrest de la Ceur de Parlement du 8.
Auril 1653.	Avril 1653.
Signé DVBRAY, Syndic.	Signé DUBRAY, Syndic.
Acheué d’imprimer le 2.	Achevé d'imprimer le 2.
Ianuier 1665.	Janvier 1665.
Les Exemplaires ont eſté fournis	Les Exemplaires ont été fournis
LECUGEANIRUEU	LECUGEANIRUEU
CLIDAMANT, Mary de Clarice.	CLIDAMANT, Mari de Clarice.
SBINDON,Mary de Ehcienc.	SBINDON,Mari de Ehcienc.
CLARICE.	CLARICE.
LVCRESSE, Traueſtie en homme.	LVCRESSE, Travestie en homme.
ILLOT, Valet de Clidamant.	ILLOT, Valet de Clidamant.
AGO IN, Valet de Clindor.	AGO IN, Valet de Clindor.
E A RIX, Suiuante de Clarice.	 A RIX, Suivante de Clarice.
LISETTE, Suiuunte de Lucreſſe.	LISETTE, Suivunte de Lucresse.
La Soene eſt aant la place Roy al, proche le Bureau des Caroſſes,	La Soène est aant la place Roi al, proche le Bureau des Carosses,
EIIVTNIOVE DES CAROSSES A CINQ SOVS.	EIIVTNIOUE DES CAROSSES A CINQ SOUS.
COMEDIE.	COMÉDIE.
ACTE PREMIER.	ACTE PREMIER.
SCEEEE.	SCEEE.
LVCRESSE traueiſtie en homme.	LVCRESSE traveistie en homme.
LISETTE.	LISETTE.
LISETTE.	LISETTE.
Ais, Madame, à quoy bon vn tel déguiſement?	Ais, Madame, à quoi bon un tel déguisement?
TV TEt que pretendés vous par cét habillement ?	TU TEt que prétendez -vous par cet habillement ?
Dites moy s’il vous plaiſt ce que vous voulez faire.	Dites -moi s'il vous plaît ce que vous voulez faire.
LYCRESSE.	LYCRESSE.
Tu ſçais bien que iamais ie ne t’ay pû rien talre, Et comme ie connois con eſpne lore uncrer Ie n’ay point de ſecret qui ſoit pour toy ſecrer.	Tu sais bien que jamais rien ne t'ai pu rien talre, Et comme tu connais con espne lore uncrer Je n'ai point de secret qui soit pour toi secrer.
Sçaches donc que mon mal eſt tellement extrême Qu’il ſeroit malaiſé d’en trouuer vn de meſme Puis qu’il n’eſt que trop vray qu’vn mary ſans raiſon, A depuis peu de temps ruïné ma maiſon, Et pour t’en dire icy la veritable cauſe, C’eſt qu’il iouë à toute heure & qu’il perd toute choſe.	Saches donc que mon mal est tellement extrême Qu'il serait malaisé d'en trouver un de même Puis qu'il n'est que trop vrai qu'un mari sans raison, A depuis peu de temps ruiné ma maison, Et pour t'en dire ici la véritable cause, C'est qu'il joue à toute heure et qu'il perd toute chose.
Ie n’auois plus chez nous, ô mal-heurs jnoüis!	Je n'avais plus chez nous, ô malheurs jnoüis!
Pour tout bien, tout eſpoir, que deux mille Louis Qu’il vient de m’emporter & quelques pierreries.	Pour tout bien, tout espoir, que deux mille Louis Qu'il vient de m'emporter et quelques pierreries.
Qu’il va iouer & perdre à ces Academies:	Qu'il va jouer et perdre à ces Academies:
Dy moy, que dois-ie dire ou faire la deſſus.	Dis -moi, que dois-je dire ou faire la dessus.
LISETTE.	LISETTE.
Pour moy mon aduis eſt que ne les ayant plus Il faut pour les rauoir vſer de toute choſe.	Pour moi mon avis est que ne les ayant plus Il faut pour les ravoir user de toute chose.
LVCRESSE.	LVCRESSE.
C’eſt donc potrquoy i’ay fait cette metamorphoſe, Clindor ne portera que peu d’argent ſur luy, Eſtant fort malheureux, il faut donc auiourd’huy, Comme ordinairement Ragot porte ſa bourſe, Aupres de ce valet chercher quelque reſource;	C'est donc potrquoy j'ai fait cette métamorphose, Clindor ne portera que peu d'argent sur Ah, Étant fort malheureux, il faut donc aujourd'hui, Comme ordinairement Ragot porte sa bourse, Auprès de ce valet chercher quelque ressource;
Auſſi bien que ſon maiſtre il aime fort le jeu, Et quand il eſt apres, il n’en prend pas pour peu;	Aussi bien que son maître il aime fort le jeu, Et quand il est après, il n'en prend pas pour peu;
Voyla ce qui me fait en ce moment pretendre, Que ie pourray t’auoir ce que l’on m’a ſçeu prendre,	Voilà ce qui me fait en ce moment prétendre, Que ie pourrai t'avoir ce que l'on m'a su prendre,
ISETTE.	ISETTE.
Si bien que pour r’auoir voſtre or & vos bijoux, Voul alce luicein-de laire vnesme demiou y	Si bien que pour rappoir ainsi or et vos bijoux, Voul alce luiceinde laire unesme demiou y
LVCRESSE.	LVCRESSE.
Oüy, c’eſt la mon deſſein:	Oui, c'est la mon dessein:
dy-moy ſi tu l’approuue,	dis-moi si tu l'approuve,
LISETTE.	LISETTE.
Ne dit on pas qu’on prend ſon bien où l’on le trouue ?	Ne dit on pas qu'on prend son bien où l'on le trouve ?
Mais ne craignez vous point que Chndor voſtre eſpoux, Ne voye par vos traits, Madame, que c’eſt vous?	Mais ne craignez -vous point que Chndor votre époux, Ne voie par vos traits, Madame, que c'est vous?
LVCRESSE Le ieu, chere Liſette, occupe trop ſon ame, Pour, malgré cét habit, neconnoiſtre ſa femme.	LVCRESSE Le jeu, chère Lisette, occupe trop son âme, Pour, malgré cet habit, neconnoistre sa femme.
LISETTE.	LISETTE.
Ie croyois vous voyant dedans ce bel atour, Que vous vous eſtiez miſe en teſte quelque amour!	Je croyais vous voyant dedans ce bel atour, Que vous vous étiez mise en tête quelque amour!
Et vous maſculinant d’vne telle maniere, Que vous alliez donner à vos eſprits carriere:	Et vous masculinant d'une telle manière, Que vous alliez donner à vos esprits carrière:
Mais ſçachant à preſent quel eſt voſtre deſſein, Madame, ie n’ay plus ce penſer dans le ſein, A Dieu ne plaiſe helas, que voſtre humeur fut telle.	Mais sachant à présent quel est votre dessein, Madame, je n'ai plus ce penser dans le sein, À Dieu ne plaise hélas, que votre humeur fut telle.
Qu’amour vint ſottement vous broüiller la cetuelle:	Qu'amour vint sottement vous brouiller la cetuelle:
Car enfin que ſçait on?	Car enfin que sait on?
ſi ie voyois pecher;	si ici voyais pécher;
Ie ne pourrois peut-eſtre auſſi m’en empeſcher;	Je ne pourrais peut-être aussi m'en empêcher;
Comme le naturel au mal à de la pente, Ce mal qui fait du bien, facilement nous tente, A-ce qu’au moins iadis ma mere m’en apprit, Ie ne le ſçaurois pas ſi l’on ne me l’euſt dit;	Comme le naturel au mal à de la pente, Ce mal qui fait du bien, facilement nous tente, A-ce qu'au moins jadis ma mère m'en apprit, Je ne le saurais pas si l'on ne me l'eût dit;
Et ie ne ſuis pas fille à faire vn tel paſſage!	Et ici ne suis pas fille à faire un tel passage!
Sans y faire deuant paſſer le mariage.	Sans y faire devant passer le mariage.
Si j’auois eu deſſein de mordre à l’hameçon.	Si j'avais eu dessein de mordre à l'hameçon.
Ragot m’en conte encor de la bonne façon.	Ragot m'en compte encor de la bonne façon.
Il me dit tous les iours;	Il me dit tous les jours;
Mon aimable Liſette, Si tu veux nous ferons enſemble l’amourette, Va ie t’épouſeray s’il en vient vn poupon.	Mon aimable Lisette, Si tu veux nous ferons ensemble l'amourette, Va toujours t'épouserai s'il en vient un poupon.
Ie luy dis la deſſus bruſquement, je t’en pon, C’eſt pour ton nés, il faut ma foy que l’on t’en donne.	Je lui dis la dessus brusquement, je t'en pon, C'est pour ton nés, il faut ma foi que l'on t'en donne.
Sçais tu ſi ce ſeroit vn poupon ou pouponne Et croy tu que ie ſois vne fille à cela?	Sais tu si ce serait un poupon ou pouponne Et crois tu que je sois une fille à cela?
va luy dis-ie d’abort, va t’en au plautle:	va deux dis-je d'abort, va t'en au plautle:
va, Fais ie pas bien, Madame?	va, Fais Seigneur pas bien, Madame?
LYCRESSE.	LYCRESSE.
Oüy, cela me contente;	Oui, cela me contente;
Mais cherchons vn remede au mal qui me tourmente.	Mais cherchons un remède au mal qui me tourmente.
Tu peux t’imaginer apres ce que i’ay dit Si ie ſouffre à preſent du corps & de l’eſprit:	Tu peux t'imaginer après ce que j'ai dit Si tu souffre à présent du corps et de l'esprit:
Sortons donc promptement d’vn ſi cruel ſupplice,	Sortons donc promptement d'ins si cruel supplice,
LISETTE.	LISETTE.
Vous ne ſouffrez pas ſeule, & l’aimable Clarice Reſſent ainſi que vous, vn extreme tourment;	Vous ne souffrez pas seule, et l'aimable Clarice Ressent ainsi que vous, un extrême tourment;
Clidamant ſon mary ne fait inceſſamment, Que courir tout le iour de Caroſſe en Caroſſe, Pour auec tous objets faire nouueau negoce, Aux deſpens de ſa femme il leur fait les yeux doux.	Clidamant son mari ne fait incessamment, Que courir tout le jour de Carosse en Carosse, Pour auec tous objets faire nouveau négoce, Aux dépens de sa femme il leur fait les yeux doux.
LVCRESSE.	LVCRESSE.
Ii ebbrritror fortune en Caroſſe à cinq ſous!	Ji ebbrritror fortune en Carosse à cinq sous!
lliroit pouſſer la quelques galanteries!	lirait pousser la quelques galanteries!
LISETTE.	LISETTE.
d.	d.
ii en poune, Madame, ir en fait des roties, Clarice voſtre amie en eſt au deſeſpoir.	ji en poune, Madame, ir en fait des rôties, Clarice votre amie en est au désespoir.
EVCNSSOM.	EUCNSOM.
Que ſçais-tu?	Que sais-tu?
LISETTE.	LISETTE.
Beatrix m’apprit tout hier au ſoir, Et me dit qu’elle eſtoit de voir vn tel volage, Dans vn emportement, qui va iuſqu’à la rage, Que Clarice viendroit vous trouuer auiourd’huy cour vouy faire igadoir l’excés de ſon ennuy.	Beatrix m'apprit tout hier au soir, Et me dit qu'elle était de voir un tel volage, Dans emportement, qui va jusqu'à la rage, Que Clarice viendrait vous trouver aujourd'hui cour voui faire igadoir l'excès de son ennui.
Sans doute on la verra bien-toit courir les ruës, Ayant dedans l’eſprit ces viſions cornues, Ne vous l’ay ie pas dit?	Sans doute on la verra bien-toit courir les rues, Ayant dedans l'esprit ces visions cornues, Ne vous l'a ie pas dit?
elle vous vient chercher.	elle vous vient chercher.
LVCRESSE.	LVCRESSE.
Va t'en pour vn moment prés d’icy té cacher, La ſurpriſe en ſera peut eſtre auſſi jolie, Que iamais incident le fut en Comedie, Lors qu’elle me verra dans cét habillement.	Va t'en pour un moment prés d'ici té cacher, La surprise en sera peut être aussi jolie, Que jamais incident le fut en Comédie, Lors qu'elle me verra dans cet habillement.
A nij	A Aj
SCLESE II.	SCLESE II.
ATCRESJE,CEARICESDEATRIX.	ATCRESJE,CEARICESDEATRIX.
LVCRESSE a Clarice.	LVCRESSE a Clarice.
ſerois ie obiet rare & charmant, Denfander en quereu voitre denein vous A meine?	serais ie objet rare et charmant, Denfander en quereu voitre dènein vous A mène?
Vous puis ie accompagner?	Vous puis ici accompagner?
CLARICE N’en prenez pas la peineComme ie ne m’en vay qu’à quatre pas dicy, Ie me puis aiſement paſſer de vous ainſi?	CLARICE N'en prenez pas la peineComme Dieux ne m'en vais qu'à quatre pas dicy, Je me puis aisément passer de vous ainsi?
Ie ſuis trop obligée à voſtre courtoiſie, Ne vous çonnoilſant point.	Je suis trop obligée à votre courtoisie, Ne vous çonnoilsant point.
2	2
LVCRESSE.	LVCRESSE.
Treue de raillerie, Ce n’eſt pas d’auiourd’huy que i’ay de vos faueurs, Et lious nous ſommes veus en autre part qu’ailIeurs.	Treve de raillerie, Ce n'est pas d'aujourd'hui que j'ai de vos faveurs, Et lious nous sommes vus en autre part qu'ailIeurs.
CLARICE.	CLARICE.
Moy ie vous aurois veu?	Moi , Vous aurais vu?
Dieux qu’elle menterie!	Dieux qu'elle menterie!
Ceſſés voſtre arrogance & voſtre effronterie, Ie ne vous vis iamais autre part qu’en ce lieu, Treue donc d’entretien, & là deſſus adieu.	Cessez votre arrogance et votre effronterie, Je ne vous vis jamais autre part qu'en ce lieu, Trouve donc d'entretien, et là dessus adieu.
LVCRESSE.	LVCRESSE.
Comment?	Comment?
vous, qui m’aimés auec ardeur extreme Vſer auec que moy d’vn ſi grand ſtratageſme Et ſi ie vous diſois que vous m’allés chercher;	vous, qui m'aimez après ardeur extrême User avec que moi d'un si grand stratagème Et si ie vous disais que vous m'allez chercher;
CLARICE.	CLARICE.
Ie vous chercherois, moy?	Je vous chercherais, moi?
Dieu m’en veille inlepciener, Moncher petit Monſieur, ie vous iure mon ame, Bien loin de vous chercher, que ie cherche vne femme.	Dieu m'en veille inlepciener, Moncher petit Monsieur, tu vous jure mon âme, Bien loin de vous chercher, que ie cherche une femme.
LVCRESSE.	LVCRESSE.
Vous cherchez vne femme?	Vous cherchez une femme?
ouy, femme comme moy.	oui, femme comme moi.
vous contenteray comme elle ſur ma foy,	vous contenterai comme elle sur ma foi,
CLARICE.	CLARICE.
Laiſſons-le, Beatrix, faiſons noſtre viſite.	Laissons-le, Beatrix, faisons notre visite.
BEATRIX.	BEATRIX.
Peut-entre ce Monſeur eſt vne Hermatroydite.	Peut-entre ce Monsieur est une Hermatroidite.
CLARICE.	CLARICE.
Laiſſons-le encor' vn coup, allons ſortons d’icy;	Laissons-le encor' un coup, allons sortons d'ici;
Mais Lilette parbi s crre lotto de louoyi Où peut eſtre Lucreſſe?	Mais Lilette parbi s crèvre lotto de loui Où peut être Lucresse?
LISETTE.	LISETTE.
Elle eſt icy tout proche	Elle est ici tout proche
CEMITOs Où?	CEMITOs Où?
ie ne la voy point.	On ne la vois point.
LISETTE.	LISETTE.
o la dure caboche Elle eſt deuant vos yeux, ne la voyez vous point	ô la dure caboche Elle est devant vos yeux, ne la voyez vous point
BEATRIX.	BEATRIX.
Il faut donc qu’elle y ſoit en chauſſes & pourpoint, Car plus j’employe icy les efforts de ma veuë Ie ne vois rien qu’vn homme, ou bien i’ay la berluë.	Il faut donc qu'elle y soit en chausses et pourpoint, Car plus j'emploie ici les efforts de ma vue Je ne vois rien qu'un homme, ou bien j'ai la berlue.
LISETTE.	LISETTE.
Comme on duppe aiſement & les yeux & l’eſprit, Lucrene anuremene gne denous cet habic.	Comme on dupe aisément et les yeux et l'esprit, Lucrène anuremene denous cet habic.
BEATRIX.	BEATRIX.
Les femmes à preſent portent le haut de chauſſe!	Les femmes à présent portent le haut de chausse!
Ie n’aurois iamais cru voſtre apparence fauſſe.	Je n'aurais jamais cru votre apparence fausse.
LVCRESSE.	LVCRESSE.
Quoy vous ierconnoiſſez qui vous counoiſt ſi bien, Et qui vous aime tant?	Quoi vous jerconnaissez qui vous counait si bien, Et qui vous aime tant?
CLARICE.	CLARICE.
Ie n’y comprenois rien, Et l’on ne vit iamais dans noltre cour charmante!	Je n'y comprenais rien, Et l'on ne vit jamais dans noltre cour mante!
Vn homme d’vne mine & d’humeur plus galant:	Un homme d'une mine et d'humeur plus galant:
l'our moy, i’en ſuis ſurpriſe & ne le puis nier.	l'our moi, j'en suis surprise et ne le puis nier.
BEATRIX.	BEATRIX.
Vous n’entendés pas mal à vous hommifier.	Vous n'entendez pas mal à vous hommifier.
CLARICE.	CLARICE.
Pourquoy vous eſtes vous miſe en cette poſture?	Pourquoi vous êtes -vous mise en cette posture?
LVCRESSE.	LVCRESSE.
Pour tacher de finir les tourmens que i'endure:	Pour tacher de finir les tourments que j'endure:
CLARICE.	CLARICE.
Il ne ſont pas plus grands, ie croy, que mon ſoucy Lors que vous les ſçaurez;	Il ne sont pas plus grands, ie crois, que mon souci Lors que vous les saurez;
mais quelqu’vn vient Cherchons où nous conter le mal qui nous tourMente	mais quelqu'amour vient Cherchons où nous conter le mal qui nous tourMente
SUNNE III.	SUNNE III.
CLINDOR, RAGOTIN.	CLINDOR, RAGOTIN.
RAGOTIN.	RAGOTIN.
Oſtre façon d’agir, Monſieur, eſt bien méchante.	Ostre façon d'agir, Monsieur, est bien méchante.
CLINDOR.	CLINDOR.
Nous auons de l’argent Ragot, nous voyla bien,	Nous avons de l'argent Ragot, nous voilà bien,
RAGOTIN.	RAGOTIN.
Monſieur encor vn coup, ce tour-là ne vaut rien, Il faut que vous ayez vne ame bien tigreſſe, D’aller voler ainſi voſtre femme Lucreſſe, Comment?	Monsieur encor un coup, ce tour-là ne vaut rien, Il faut que vous ayez une âme bien tigresse, D'aller voler ainsi votre femme Lucresse, Comment?
tout emporter & tout prendre chez vous, Pour aller le porter à la gueulle aux filoux?	tout emporter et tout prendre chez vous, Pour aller le porter à la gueulle aux filoux?
Car il n’eſt rien plus vray qu’en ces Academies, Il ſe commet ſouuent force friponneries, Teſmoin certain manteau doublé du meſme drap, Dont à mon grand regret il me fut fait vn rapt:	Car il n'est rien plus vrai qu'en ces Academies, Il se commet souvent force friponneries, Témoin certain manteau doublé du même drap, Dont à mon grand regret il me fut fait un rapt:
Dans ce maudit endroit;	Dans ce maudit endroit;
où tout chacun abonde, On y voit des futés s’il en eſt daus le monde;	où tout chacun abonde, On y voit des futés s'il en est daus le monde;
Le fils duppe le pere & le pere le fils, Ils ſe pendroient plutoſt qu’ils n’euſſent vos loüis Là dans ce maudit lieu plein de libertinage;	Le fils dupe le père et le père le fils, Ils se pendraient plutôt qu'ils n'eussent vos louis Là dans ce maudit lieu plein de libertinage;
Et vous & vos Loüis ſont d’abort au pillage, Et ſi toſt qu’ils ont mis mon maiſtre au rang des gueux, Il ſort, & ces matois partagent tout entr’eux.	Et vous et vos Louis sont d'abort au pillage, Et si tôt qu'ils ont mis mon maître au rang des gueux, Il sort, et ces matais partagent tout entr'eux.
Si bien qu’apres cela vous allés vous ébatre, A faire comme on dit, chez vous raſfle de quatre, Et tout ce qui ſe peut rencontrer ſous vos mains, Vous l’allés iuſtement porter à des gredins, Qui n’ont le plus ſouuent pour toute leur richeſſe Qu’vne paire de mains pour les tours de ſoupleſſe, Pour attraper la bourſe aux pauures innocens, Ainſi qu’ils vous ont fait malgré toutes vos dens.	Si bien qu'après cela vous allez vous ébattre, À faire comme on dit, chez vous râle de quatre, Et tout ce qui se peut rencontrer sous vos mains, Vous l'allez justement porter à des gredins, Qui n'ont le plus souvent pour toute leur richesse Qu'une paire de mains pour les tours de souplesse, Pour attraper la bourse aux pauvres innocents, Ainsi qu'ils vous ont fait malgré toutes vos dens.
Les tours de ces adroits vallẽt mieux que les yôtres Puis qu’ils ſçauent fort bien viure aux deſpent des autres, Mais vous qui ne ſçauez viure qu’à vos deſpens Vous ne ſerés iamais rien qu’au rang des rampans Et vous ſerez contraint de faire quelqu’affaire Qui tres certainement nous ſera fort contraire.	Les tours de ces adroits vallẽt mieux que les yôtres Puis qu'ils savent fort bien vivre aux dépent des autres, Mais vous qui ne savez vivre qu'à vos dépens Vous ne serez jamais rien qu'au rang des rampants Et vous serez contraint de faire quelque défaire Aux très certainement nous sera fort contraire.
CLINDOR.	CLINDOR.
Que tu raiſonnes mal, ò le plus grand des fous!	Que tu raisonnes mal, le plus grand des fous!
RAGOTIN.	RAGOTIN.
Lors que vous ne pourrez plus rien prendre chez vous, Vous irez autre part à la petite guerre, Et comme ie vous ſuis, Monſieur, par toute terre Si l’on vous met apres la main ſur le colet, On la mettra d’abord deſſus voſtre valet;	Lors que vous ne pourrez plus rien prendre chez vous, Vous irez autre part à la petite guerre, Et comme ie vous suis, Monsieur, par toute terre Si l'on vous met après la main sur le colet, On la mettra d'abord dessus votre valet;
Quoy que mon innocence aille iuſeu à l’extreme Si vous ne valés rien, on me croira dé meſme, Et l’on nous menera tout deux droit en priſon;	Quoi que mon innocence aille juseu à l'extrême Si vous ne valezez rien, on me croira dé même, Et l'on nous mènera tout deux droit en prison;
Apres ſi nous ſçauons quelque belle oraîſon, Nous n’aurons s’il nous plaiſt dans ce lieu qu’à la dire;	Après si nous sçauons quelque belle oraison, Nous n'aurons s'il nous plaît dans ce lieu qu'à la dire;
Iugés ſi nous aurons fort grand ſuiet de rire, Quand dedans peu de temps deuant force teſmoins, On vous accourcira de voſtre teſte au moins, Et moy qui n’ay rien fait pour aucun mal pretendre, On ne laiſſera pas ioliment de me pendre.	Jugez si nous aurons fort grand sujet de rire, Quand dedans peu de temps devant force témoins, On vous accourcira de votre tête au moins, Et moi qui n'ai rien fait pour aucun mal prétendre, On ne laissera pas joliment de me pendre.
Monſieur Monſieur ſur le plancher ie ſçais danſer fort bien, Mais ie ne ſçay point l’art de danſer deſſus rien.	Monsieur Monsieur sur le plancher ici sais danser fort bien, Mais tu ne sais point l'art de danser dessus rien.
CLINDOR.	CLINDOR.
Pour moy ie croy, Ragot, ta folie acheuée.	Pour moi ie cy, Ragot, ta folie achevée.
RAGOTIN.	RAGOTIN.
Monſieur c’eſt vn plaiſir d’aller teſte leuée, Ma mere-grand vn jour me diſoit ſur cela, Mon fils, qui bien fera touſiours bien trouuera;	Monsieur c'est un plaisir d'aller tête levée, Ma mère-grand un jour me disait sur cela, Mon fils, qui bien fera toujours bien trouvera;
Belles parolles, peuple !	Belles paroles, peuple !
ô les belles Sentences!	ô les belles Sentences!
Qui les ſuiura n’ira iamais en décadences.	Qui les suivra n'ira jamais en décadences.
CLINDOR.	CLINDOR.
Tout cela va fort bien, mais ſans plus diſcourir, Donne moy quelque argent, pour m’aller diuertir.	Tout cela va fort bien, mais sans plus discourir, Donne moi quelque argent, pour m'aller divertir.
RAGOTIN.	RAGOTIN.
Oüy dà:	Oui dà:
cela, Monſieur, eſt plus que raiſonnable, Sans pecune on n’eſt pas en compagnie aimable.	cela, Monsieur, est plus que raisonnable, Sans pecune on n'est pas en compagnie aimable.
Mais vous la ménagez de mauuaiſe façon;	Mais vous la ménagez de mauvaise façon;
Tachez à l’auenir d’eſtre joly garçon.	Tachez à l'avenir d'être joli garçon.
Ie ſçay qu’il ne faut pas paſſer pour vn infame, Qu’vn homme ſans argent eſt vn vray corps ſans ame, Et que dans cét eſtat les hommes ſont mocqués;	Je sais qu'il ne faut pas passer pour un infâme, Qu'un homme sans argent est un vrai corps sans âme, Et que dans cet état les hommes sont moquez;
Allés vous réjoüir, voila deux ſous marqués, Que ie n’aye de vous jamais aucun réproche.	Allez -vous réjouir, voilà deux sous marquez, Que tu n'aie de vous jamais aucun réproche.
CLINDOR.	CLINDOR.
Ie pourrois bien icy vous caſſer la caboche, Lors que vous me traittez de cette façon la.	Je pourrais bien ici vous casser la caboche, Lors que vous me traitez de cette façon la.
RAGOTIN luy donne ſa beurſe Monſieur prenez pluſtoſt tout ce qu’il vous plaira.	RAGOTIN lui donne sa beurse Monsieur prenez plutôt tout ce qu'il vous plaira.
La femme à ce qu’on dit, eſt fort bonne ſans teſte, Mais pour moy ſans mon chef, ie vaux moins qu’vne beſte, Ainſi laiſſez-le moy.	La femme à ce qu'on dit, est fort bonne sans tête, Mais pour moi sans mon chef, toujours vaux moins qu'une bête, Ainsi laissez-le moi.
CLINDOR.	CLINDOR.
Ie prens trenté Loüis;	Je prends trenté Louis;
Ie m'en vais.	Je m'en vais.
RAGOTIN.	RAGOTIN.
Ils ſeront bien-toſt éuanoüis Diable quel meſnager!	Ils seront bientôt éuanoüis Diable quel ménager!
on voit ſur ſon viſage Quirrenura tout dans peu pour viure de ménage:	on voit sur son visage Quirrenura tout dans peu pour vivre de ménage:
Mais tandis qu’il s’en va pouſſer le paroly, Ie m’en vay me donner d’vn doigt de roſſoly;	Mais tandis qu'il s'en va pousser le parole, Je m'en vais me donner d’ va doigt de rossoli;
Auſſi bien quelqu’vn vient.	Aussi bien quelqu'un vient.
SCENDTV.	SCENDTU.
CLARICE, LVCRESSE, BEATRIX, LISETTE.	CLARICE, LUCRESE, BEATRIX, LISETTE.
LYCRESSE.	LYCRESSE.
Enfin ma chere amie, Mon galant vient d’entrer dedans l’academie:	Enfin ma chère amie, Mon galant vient d'entrer dedans l'académie:
Et comme ſon valet s’en va boire beaucoup, Ce ſera le moyen de mieux faire mon coup.	Et comme son valet s'en va boire beaucoup, Ce sera le moyen de mieux faire mon coup.
Vous auez ſçeu de moy le ſujet de ma peine, Et vous m’auez appris auſſi ce qui vous geſne.	Vous avez su de moi le sujet de ma peine, Et vous m'avez appris aussi ce qui vous gêne.
Il ne reſte donc plus qu’à chercher les moyens, D’alleger vos tourmens en allegeant les miens?	Il ne reste donc plus qu'à chercher les moyens, D'alléger vos tourments en allégeant les miens?
Auecque Beatrix prenez encor Liſette, Ie n’ay pas beſoin d’elle en ce que ie projette.	Avec Beatrix prenez encor Lisette, Je n'ai pas besoin d'elle en ce que ie projette.
Cependant que ie vais entrer dedans ce lieu, Employés tous vos ſoins à joüer voſtre jeu, chdaiane ne fģauroſt aller chercher négoce?	Cependant que je vais entrer dedans ce lieu, Employez tous vos soins à jouer votre jeu, chdaieane ne faurost aller chercher négoce?
Sans paſſer paricy pour entrer en Caroſſe:	Sans passer parici pour entrer en Carrosse:
Ie vous quitte vn moment, adieu iuſqu’au reuoir, Ce que vous aurez fait, faites le moy ſçauoil, Enuoyés moy Liſette.	Je vous quitte un moment, adieu jusqu'au revoir, Ce que vous aurez fait, faites le moi sçauoil, Enuoyés moi Lisette.
A PIITARTJVE DESCAROSSES	À PIITARTE DESCAROSSES
CLARICE.	CLARICE.
Adieu, voſtre ſeruante.	Adieu, votre servante.
O Ciel fais reüſſir le deſſein que ie tente, Nous auons toutes trois chacune noſtre Loup Tâchons de n’eſtre pas ſurpriſes tout d’vn coup.	Ô Ciel fais réussir le dessein que je tente, Nous avons toutes trois chacune notre Loup Tâchons de n'être pas surprises tout d'un coup.
Mais le voicy déja;	Mais le voici déjà;
voyons ce qu’il veut faire Et deſſus ſon projet nous ferons noſtre affaire.	voyons ce qu'il veut faire Et dessus son projet nous ferons notre affaire.
Elles ſe cachent.	Elles se cachent.
d qm anumam v e CLIDAMANT, GVILLOT.	dq anm anumam v e ELIDAMANT, GUILOT.
CLIDAMANT.	CLIDAMANT.
Ais Guillot à quoy bon me vouloir arreſter?	Ais Guillot à quoi bon me vouloir arrêter?
Ne feras tu iamais que me perſecuter?	Ne feras tu jamais que me persécuter?
GVILLOT.	GUILOT.
Monſieur excuſez moy, ſi ie vous perſecute, C’eſt pour vous deſtourner de chercher chapecheute.	Monsieur excusez moi, si ici vous persécute, C'est pour vous détourner de chercher chapecheute.
Et qu’eſt il de beſoin de courir en lutin, Vous pour faire l’amour, moy pour mourir de faim ?	Et qu'est il de besoin de courir en lutin, Vous pour faire l'amour, moi pour mourir de faim ?
Dans le temps que ie ſouffre & mille& mille peines Vous faites le Rodrigue aupres de vos Climenes, On vous voit tout le iour en Fiacres a cinq ſous, A faire l’entendu, le beau fils, les yeux doux, A nommer vos objets de merueilleux che f-d’œuures, Cependant que Guillot aualle des couleuures.	Dans le temps que Seigneur souffre et milleet mille peines Vous faites le Rodrigue auprès de vos Climenes, On vous voit tout le jour en Fiacres a cinq sous, À faire l'entendu, le beau fils, les yeux doux, A nommer vos objets de merveilleux che f-d'œuvres, Cependant que Guillot aualle des couleuvres.
Ah, Monſieur i’aymerois tout autant me voir :	Ah, Monsieur j'aimerais tout autant me voir :
mort, Que d’eſtre à tout moment à courir le bon bord, A la Place Royalle, & puis aux Tuilleries, Luxembourg, l’Arcenal, ce ſont nos galeries, Si vous voulés Monſieur que nous viuions ſans bruit, Ne nous embarquons point ſur la mer ſans biſquit.	mort, Que d'être à tout moment à courir le bon bord, À la Place Royalle, et puis aux Tuilleries, Luxembourg, l'Arcénal, ce sont nos galeries, Si vous voulez Monsieur que nous vivions sans bruit, Ne nous embarquons point sur la mer sans bisquit.
Ie ſçay de bonne part que l’amour vous fait viure cauis fals repaitre vil poujiene vous ſçaurois Iuidre, Auant qu’aller plus loin prenons le bon part Et faſons s’il vous plaiſt beati garniti.	Je sais de bonne part que l'amour vous fait vivre cavis fals repaître vil poujiene vous saurais Juidre, Avant qu'aller plus loin prenons le bon part Et fasons s'il vous plaît béat garniti.
2	2
CLIDAMANT.	CLIDAMANT.
Ce Coquin n’a iamais ſon ame ſatisfaite.	Ce Coquin n'a jamais son âme satisfaite.
GVILLOT.	GUILOT.
Vous vous allés iouer à pouſſer la fleurette, 2 iij Et ſi ie vous vay voir exprimer voſtre amour, Peut eſtre deuiendray ie amoureux à mon tour, Puis ſi la Beatrix, de Madame ſuiuante, Vient à s’apperceuoir qu’vn autre objet me tente, Et que ie ne ſois plus d’elle paſſionné, Le Diable ſera lors ſur mon corps deſchaîné, Et pour me mal-traitter de mon humeur legere.	Vous vous avez jouer à pousser la fleurette, 2 iij Et si sens vous vais voir exprimer votre amour, Peut te deviendra ie amoureux à mon tour, Puis si la Beatrix, de Madame suivante, Vient à s'apercevoir qu'à autre objet me tente, Et que ieans sois plus d'elle passionné, Le Diable sera lors sur mon corps déchaîné, Et pour me maltraiter de mon humeur légère.
Elle viendra ſur moy fondre toute en colere, Me diſant furieuſe, en ouurant les nazeaux.	Elle viendra sur moi fondre toute en colère, Me disant furieuse, en ouvrant les nazeaux.
Ie ne ſeray iamais viande pour tes oyſeaux, Beau chercheur de midy, Monſieur l’homme de chambre, Et me pourra peut-eſtre aualler quelque membre.	Je ne serai jamais viande pour tes oiseaux, Beau chercheur de midi, Monsieur l'homme de chambre, Et me pourra peut-être avaller quelque membre.
l’aime mieux n’eſtre poit en cette extremité.	l'aime mieux n'être poit en cette extrémité.
Que de me voir iamais aucun membre gaſté.	Que de me voir jamais aucun membre gâté.
CLIDAMANT.	CLIDAMANT.
Lors que ie ſuis ſenſible, il faut que tu ſois ſouche	Lors que ici suis sensible, il faut que tu sois souche
GVILLOT.	GUILOT.
Vn exemple amoureux terriblement me touche, Et ſi-toſt que i’entens parler ſur ce ſujet, 1.	Un exemple amoureux terriblement me touche, Et sitôt que j'entends parler sur ce sujet, 1.
Je me trouue d’abord ie ne ſçay comment fait:	Je me trouve d'abord rien ne sais comment fait:
Des qu’vn objet fripon vient àmes yeux paroiſtre, L’eau me vient à la bouche & ne ſuis plus mon maiſtre, Vn feu s’eſpand en moy du bas iuſques en hant, le ianc comme on dit, des que i’ay le pied chaut.	Des qu'un objet fripon vient àmes yeux paraître, L'eau me vient à la bouche et ne suis plus mon maître, Un feu s'épand en moi du bas iusques en hant, le janc comme on dit, des que j'ai le pied chaut.
C	Ç
CLIDAMANT.	CLIDAMANT.
Quand d’vn nouuel amour tu te laiſſerois prendre, Dis moy, ta Beatrix pourroit elle l’apprendre?	Quand d'un nouvel amour tu te laisserais prendre, Dis moi, ta Beatrix pourrait -elle l'apprendre?
Elle n’en ſçaura rien, repoſe t’en ſur moy, mais duenda vnvient Iey.	Elle n'en saura rien, repose t'en sur moi, mais duenda vnvient Jei.
GVI LLOT.	GUI LLOT.
Sont-ce femmes?	Sont-ce femmes?
OOLETDVI.	ÔOLETDVI.
CLARICE,LISETTE, BEATRIX.	CLARICE,LISETTE, BEATRIX.
CLIDAMANT.	CLIDAMANT.
Tay-toy.	Tais-toi.
Mes Dames, puis ie bien ſans auoir voſtre haine, M’informer du ſuiet qui dans ce lieu vous meine?	Mes Dames, puisque bien sans avoir vôtre maine, M'informer du sujet qui dans ce lieu vous mène?
Vous y puis-ie ſeruir?	Vous y puis-je servir?
Le traiſtre?	Le traître?
CLARICE.	CLARICE.
Qu’il eſt humilié!	Qu'il est humilié!
GVILLOT.	GUILOT.
Trouuez vous chauſſure à voſtre pié?	Trouvez -vous chaussure à votre pie?
CLIDAMANT.	CLIDAMANT.
Mlaj le t citralgieray feunete rȩaſs taire.	Mlajà le t itralgierai feunette rȩass taire.
CLARICE.	CLARICE.
Nous allons au Palais pour vne grande affaire, Et le Caroſſe eſtant vne commodité.	Nous allons au Palais pour une grande affaire, Et le Carosse étant une commodité.
CLIDAMANT Ie viens chercher auſſi cette neceſſité, Mais ie ne vis iamais de ſi belles plaideuſes.	CLIDAMANT Je viens chercher aussi cette nécessité, Mais je ne vis jamais de si belles plaideuses.
o viu dove Pouſſez Monſieur, ce ſont de nos ſolliciteuſes.	ô vi doue Poussez Monsieur, ce sont de nos solliciteuses.
Laiſſe-moy.	Laisse-moi.
CEIDAMANT.	CEIDAMANT.
CLARICE bas.	CLARICE bas.
Le perfide!	Le perfide!
ah l’homme deſſoyal.	ah l'homme dessoyal.
GVILLOT.	GUILOT.
Que ie parle vn moment.	Que tu parle un moment.
CLIDAMANT.	CLIDAMANT.
Et bien parle, animal.	Et bien parle, animal.
GVILLOT abordant Beatrix.	GUILOT abordant Beatrix.
Dites moy, s’il vous plaiſt, puis qu’icy ie vous trouue, Si ſous ce maſque Loup vous ne ſeriés point louue, oue pous me paromez lans vous nitter beaucoup, La plus vilaine beſte enfin d’apres le loup.	Dites -moi, s'il vous plaît, puis qu'ici apprendre vous trouve, Si sous ce masque Loup vous ne seriez point louve, oue pous me paromez lans vous nitter beaucoup, La plus vilaine bête enfin d'après le loup.
CLIDAMANT.	CLIDAMANT.
Quoy?	Quoi?
ie ne pourray pas empeſcher tes ſottiſes?	Ne ne pourrai pas empêcher tes sottises?
BEAIRIX.	BEAIRIX.
Cela n’eſt rien Monſieur ce ſont des gaillardiſes,	Cela n'est rien Monsieur ce sont des gaillardises,
CLIDAMANT.	CLIDAMANT.
Coquin, va viſte voir ſi le caroſſe eſt preſt.	Coquin, va vite voir si le carosse est prêt.
GVILLOT.	GUILOT.
I’y vais, le malin corps!	J'y vais, le malin corps!
CLIDAMANT.	CLIDAMANT.
Mes Dames, s’il vous plaiſt, Accepter mon ſeruice, il n’eſt rien qui m’arreſte	Mes Dames, s'il vous plaît, Accepter mon service, il n'est rien qui m'arrête
GVILLOT reuenant.	GUILOT revenant.
Approchez viſtement, voſtre monture eſt preſte, Autremeut on pourra vous ſouffier les deux fonds.	Approchez vite, votre monture est prête, Autremut on pourra vous souffier les deux fonds.
CLIDAMANT.	CLIDAMANT.
De peur de ce malheur, mes Dames auançons, Et ne demeurons pas dans ce lieu dauantage.	De peur de ce malheur, mes Dames avançons, Et ne demeurons pas dans ce lieu davantage.
GVILLOT.	GUILOT.
En nous voyant partir, criés tous, bon voyage, Allons bon train cocher;	En nous voyant partir, criez tous, bon voyage, Allons bon train cocher;
touche tes bouriquets, Sans verſer s’il ſe peut meine nous au Palais.	touche tes bouriquets, Sans verser s'il se peut mène nous au Palais.
DOENEVII.	DONENEVI.
VN HOMME Arreſte vn peu, mon cher, as tu là quelque place?	UN HOMME Arrête un peu, mon cher, as tu là quelque place?
GVILLOT.	GUILOT.
Oüy ſi nous nous voulons eſcrazer la carcaſſe, O le loij deſſein pour nous faire eſtouffer!	Oui si nous nous voulons escrazer la carcasse, Ô le lois dessein pour nous faire étouffer!
L’HOMME Que veut dire ce ſot?	L'HOMME Que veut dire ce sot?
GVILLOT.	GUILOT.
Gardez de m'eſchauffer Vous auriez de ma part des bleſſures mortelles.	Gardez de m'échauffer Vous auriez de ma part des blessures mortelles.
L’HOMME.	L'HOMME.
Ce Coquin.	Ce Coquin.
GVILLOT Deſtallons maudites haridelles.	GUILOT Destallons maudites haridelles.
Fin du premier Acte.	Fin du premier Acte.
ACTE SECOND.	ACTE SECOND.
ACLETET.	ACLETET.
LY CRESSE.	LI CRESSE.
Seule, ſortant de l’academie.	Seule, sortant de l'académie.
Our tâcher de r’auoir toutes mes pierreries, JIe m’eſtois préparée à beaucoup d’induſtries.	Our tâcher de r'avoir toutes mes pierreries, JIe m'étais préparée à beaucoup d'industries.
Mais Clindor n’ayant veu perſonne dans ce lieu, Il n’a pû s’embarquer par ce moyen au jeu.	Mais Clindor n'ayant vu personne dans ce lieu, Il n'a pu s'embarquer par ce moyen au jeu.
Si bien qu’en attendant que compagnie arriue, Il vient prendre vn Caroſſe:	Si bien qu'en attendant que compagnie arrive, Il vient prendre un Carse:
il faut que ie l’y ſuiue.	il faut que ici l'y suive.
Si.	Si.
quelqu’vn fût venu jouer pour l’amuſer I'euſſe pû trouuer lieu de le deſniaiſer, Il paroiſt:	quelqu'un fût venu jouer pour l'amuser J'eusse pu trouver lieu de le déniaiser, Il paraît:
abordons-le & de façon galante.	abordons-le et de façon galante.
Sans doute vous cherchez noſtre maiſon roulante.	Sans doute vous cherchez notre maison roulante.
SCENE	SCÈNE
SCENE II.	SCÈNE II.
CLINDOE EVORESSE.	CLINDOE EVORÉSE.
CLINDOR.	CLINDOR.
2 y c’eſt pour ce ſujet que ie m’en viens icy	2 y c'est pour ce sujet que je m'en viens ici
LVCRESSE.	LVCRESSE.
C’eſt vn endroit fort propre à chacher le ſoucy, Et pour pluſieurs raiſons, il faut que l’on auoüe, Que qui ſceut l’inuenter, merite qu’on le loüe.	C'est un endroit fort propre à chacher le souci, Et pour plusieurs raisons, il faut que l'on auoüe, Que qui sut l'inventer, mérite qu'on le lette.
Dés qu’vn homme ſe voit entrer dans le chagrin, Qu’il entre en ce Caroſſe, il le bannit ſoudain.	Dès qu'un homme se voit entrer dans le chagrin, Qu'il entre en ce Carosse, il le bannit soudain.
Ou rencontre en ces lieux mille charmantes Dames, On pouſſe des torrens de ſoupirs & de ſſâmes:	Ou rencontre en ces lieux mille charmantes Dames, On pousse des torrents de soupirs et de ssâmes:
En fin on en voit là de toutes les façons;	En fin on en voit là de toutes les façons;
On y voit quelques fois des filles en garçons.	On y voit quelques fois des filles en garçons.
CLINDOR.	CLINDOR.
Il eſt vray que ce lieu ſe peut ſans flaterie, Nommer le beau ſejour de la galanterie, Cules plus grands plaiſirs.	Il est vrai que ce lieu se peut sans flatterie, Nommer le beau séjour de la galanterie, Cules plus grands plaisirs.
LVCRESSE.	LVCRESSE.
Moy qui vous parle, moy.	Moi qui vous parle, moi.
Sçauez vous que i’en ay rangé deſſous ma loy?	Savez -vous que j'en ai rangé dessous ma loi?
nt qui la plus aimable & la plus vertueuſe, Reliſte tarement à ina llaic ailouredle.	nt qui la plus aimable et la plus vertueuse, Reliste tarement à ina lailaic ailouredle.
CLINDOR.	CLINDOR.
Monſieur, certainement vn homme comme vous, Peut faire en ſe monſtrant quantité de jaloux:	Monsieur, certainement un homme comme vous, Peut faire en se montrant quantité de jaloux:
Le Ciel en vous faiſant, fit tout ce qu’il pût faire.	Le Ciel en vous faisant, fit tout ce qu'il pût faire.
LVCRESSE.	LVCRESSE.
Ie ne ſuis pas bien fait, mais i’ay le don de plaire, Et les plus fiers objets, ſçachant ce que ie puis, Auec moy paſſeroient & les iours & les nuits.	Je ne suis pas bien fait, mais j'ai le don de plaire, Et les plus fiers objets, sachant ce que je puis, Avec moi passeraient et les jours et les nuits.
CL'INDOR.	CL'INDOR.
En fin vous eſtes donc homme à bonnes fortunes?	En fin vous êtes donc homme à bonnes fortunes?
LYCRESSE.	LYCRESSE.
Il eſt vray que i'en ay, qui ne ſont pas communes:	Il est vrai que j'en ai, qui ne sont pas communes:
Et vous pouuez penſer ſi des gens comme nous, Peuuent manquer d’auoir d’abort le rendez-vous.	Et vous pouvez penser si des gens comme nous, Peuvent manquer d'avoir d'abort le rendez-vous.
CLINDOR.	CLINDOR.
I’auoüeray qu’en vous ſeul on voit toute la grace.	J'auoüeray qu'en vous seul on voit toute la grâce.
EVCRESSE.	EVCRESSE.
Et ſi ie vous diſois qu’en cette meſme place, Des Dames m’ont promis de me venir chercher.	Et si ici vous disais qu'en cette même place, Des Dames m'ont promis de me venir chercher.
Venez y, vous verrez combien ie leur ſuis cher.	Venez y, vous verrez combien ici leur suis cher.
Vous ſerez le teſmoin de toutes leurs careſſes, Vous verrez ſi ie ſuis heureux en mes maiſtreſſes, Et comme ie les rends ſenſibles à mes coups;	Vous serez le témoin de toutes leurs caresses, Vous verrez si tu suis heureux en mes maîtresses, Et comme ici les rends sensibles à mes coups;
Il s’en pourra trouuer quelques vnes pour vous, Et ie veux auiourd’huy vous faire voir deschoſes, Que l’on ne vit iamais dans les Metamorphoſes.	Il s'en pourra trouver quelques unes pour vous, Et ieprès aujourd'hui vous faire voir déchoses, Que l'on ne vit jamais dans les Métamorphoses.
Pour peu qu’à quelque objet ie daigne offrir mes vœux, Ie le fais condeſcendre à tout ce qui le reux;	Pour peu qu'à quelque objet ie daigne offrir mes vœux, Je le fais condescendre à tout ce qui le reux;
de lela vers le fon, vence y le vous pile, Vous verrez en amour ſi i’ay de l’induſtrie.	de lela vers le son, vence y le vous pile, Vous verrez en amour si j'ai de l'industrie.
CLINDOR.	CLINDOR.
Ie vous promets ma foy, que ie m’y trouueray.	Je vous promets ma foi, que ainsi m'y trouverai.
LVCRESSE.	LVCRESSE.
Par ce que ie feray, ie vous eſtonneray;	Par ce que ici ferai, Seigneur vous étonnerai;
Mais ie croy que i’entens venir noſtre voiture?	Mais ie cy que j'entends venir notre voiture?
Arreſte là Cocher, cherchons quelqu’auanture, A qui nos feux ardens puiſſent eſtre expliquez.	Arrête là Cocher, cherchons quelqu'aventure, À qui nos feux ardents puissent être expliquez.
CLINDOR.	CLINDOR.
Tiens petit enfant bleu, prens mes cinq ſous marquez.	Tiens petit enfant bleu, prends mes cinq sous marqués.
LVCRESSE.	LVCRESSE.
Miſerable mortel:	Misérable mortel:
prens les miens, ie te prie:	prends les miens, Seigneur te prie:
As-tu déja quelqu’vn?	As-tu déjà quelqu'amour?
aurons nous compagnie?	aurons nous compagnie?
Le petit LAQVAIS.	Le petit LAQUAIS.
Femmes, filles & Moines, enfin des trois mandiens, Il ne nous manque plus que des Comediens.	Femmes, filles et Moines, enfin des trois mandiens, Il ne nous manque plus que des Comédiens.
LVCRESSE.	LVCRESSE.
Allons, nous ferons là quelque plaiſante Hiſtoire.	Allons, nous ferons là quelque plaisante Histoire.
Le petit LAQVAIS.	Le petit LAQUAIS.
He, Monſieur, donnés-moy quelque choſe pour boire.	He, Monsieur, donnez-moi quelque chose pour boire.
CEIADeI Va, nous t’en donnerons, mets la portiere bas.	CEIADeI Va, nous t'en donnerons, mets la portière bas.
LVCRESSE.	LVCRESSE.
Quelqu’vn vient, plaçons nous, Cocher double le pas.	Quelqu'H vient, plaçons nous, Cocher double le pas.
DOLETE III.	DOLETE III.
CLARICE, DEMERTAJEIDETTE,	CLARICE, DEMERTAJEIDETTE,
CLARICE.	CLARICE.
T'on iamais parlé d’vne telle auanture?	T'on jamais parlé d'une telle aventure?
I'allois expreſſement dedans cette voiture, A deſſein de ſçauoir ce que fait mon mary, Quand il trouue vn objet digne d’eſtre chery, Et comme j’y voyois deux aſſés belles Dames, Pour s’attirer de luy des ſoûpirs tout de flâmes, le ir euiſe famais ereu qu vn bon-heur merueilleux, L’euſt rendu malgré luy de ſa femme amoureux.	J'allais expressément dedans cette voiture, A dessein de savoir ce que fait mon mari, Quand il trouve un objet digne d'être chéri, Et comme j'y voyais deux assez belles Dames, Pour s'attirer de même des soupirs tout de flammes, le irise eu jamais ereu qu 'heur merveilleux, L'eût rendu malgré tant de sa femme amoureux.
BEATRIX.	BEATRIX.
Madame vos façons ne ſont pas trop honneſtes, De chercher en Caroſſe à faire des conqueſtes, Car enfin toutes deux nous en ſommes teſmoins.	Madame vos façons ne sont pas trop honnêtes, De chercher en Carosse à faire des conquêtes, Car enfin toutes deux nous en sommes témoins.
CLARICE.	CLARICE.
Le lâche!	Le lâche!
à mon loup ſeul il rendoit tous ces ſoins	à mon loup seul il rendait tous ces soins
LISETTE.	LISETTE.
Mais vous voyez pourtant que ſon cœur eſt tout voſtre.	Mais vous voyez pourtant que son cœur est tout vôtre.
H1	H1
CLARICE.	CLARICE.
Oüy, parce qu’il m’a priſe en ce lieu pour vne autre, Si ie ne fuſſe entrée en Caroſſe auec luy, Comme les autres fois, i’en tenois auiourd’huy:	Oui, parce qu'il m'a prise en ce lieu pour une autre, Si ici ne fusse entrée en Carosse avec lui, Comme les autres fois, j'en tenais aujourd'hui:
S’il venoit comme on dit des cornes à la teſte, I'en aurois Dieu mercy d’vne longueur honneſte.	S'il venait comme on dit des cornes à la tête, J'en aurais Dieu merci d'une longueur honnête.
Mais il faut cependant que ie voye en ce iour, Iuſques où peut aller l’excez de ſon amour.	Mais il faut cependant que ainsi voie en ce jour, Iusques peut aller 'excès de son amour.
Tantoſt en m’en contant de la bonne maniere, Le plus que ie pouuois i’affectois d’eſtre fiere, Car il faut qu’vn objet à ſe rendre ſoit lent, Pour mieux faire valoir de l’amour le talent:	Tantôt en m'en contant de la bonne manière, Le plus que je pouuois j'affectais d'être fière, Car il faut qu'un objet à se rendre soit lent, Pour mieux faire valoir de l'amour le talent:
Pourtant i’apprehendois de paroiſtre trop lente, Et qu’ayant cõme il a l’hum eur fort inconſtante, Il n’allaſt preſenter &ſon cœur & ſa foy En ma preſence meſme à quelqu’autre qu’à moy;	Pourtant j'appréhendais de paraître trop lente, Et qu'ayant comme il a l'hum eur fort inconstante, Il n'allât présenter etson cœur et sa foi En ma présence avoir à quelque autre qu'à moi;
C’eſt pourquoy Beatrix ie me ſuis radoucie, Iuſques à me promettre à luy toute ma vie, Et ie luy pouuois bien promettre ce bon-heur, Sans comme tu le ſçais riſquer de mon honneur.	C'est pourquoi Beatrix Seigneur me suis radoucie, Jusqu' à me promettre à luitoute ma vie, Et a luy pouvais bien promettre ce bonheur, Sans comme tu le sais risquer de mon honneur.
Mais ie le veux railler.	Mais ie le veux railler.
BEATRIX.	BEATRIX.
C’eſt le moins qu’il merite, Il nous le faut berner tantoſt à ſa viſite, A lors qu’il vous viendra faire icy les yeux doux.	C'est le moins qu'il mérite, Il nous le faut berner tantôt à sa visite, À lors qu'il vous viendra faire ici les yeux doux.
LISETTE.	LISETTE.
Comme il vous à donne ce neu pour fendeo tous Et que d’amour il eſt, tout à fait ſuſceptible, Nouo le perrone biomtol, ta enore ort infaillible.	Comme il vous à donne ce neu pour fendeo tous Et que d'amour il est, tout à fait susceptible, No le perrone biomtol, ta en ort infaillible.
BEATRIX.	BEATRIX.
Si i’eſtois que de vous.	Si j'étais que de vous.
, mais ie le voy venir.	, mais Seigneur le vois venir.
CLARICE.	CLARICE.
Cac nons nous poul les voir vn peu s'entretenir.	Cac nons nous poul les voir un peu s'entretenir.
DEEECEEVO CLIDAMANT, GVILLOT.	DEEECEEVO CLIDAMANT, GUILOT.
CLIDAMANT.	CLIDAMANT.
Villot que ie me ſens eſpris de cette Dame!	Villot que personne me sens épris de cette Dame!
Et que ſans l’auoir veüe enfin elle m’enflâme.	Et que sans l'avoir vue enfin elle m'enflamme.
GVILLOT.	GUILOT.
Mais vous n’en auez veu que la taille & le port, Car ſon Loup.	Mais vous n'en avez vu que la taille et le port, Car son Loup.
CEIBAMANT.	CEIBAMANT.
Son eſprit m’a ſçeu prendre d’abort, Son merite eſt ſi grand, qu’on ne s’en peut deffendre.	Son esprit m'a su prendre d'abort, Son mérite est si grand, qu'on ne s'en peut défendre.
E	E
GVILLOT.	GUILOT.
Ie vous trouue Monſieur par trop facile à preudre, L’on ne vous verra point ſans vous railler beaucoup, De vous eſtre laiſſé prendre ainſi par le loup, Mais gardez s’il vous plaiſt, dans voſtre amour elttalise , De faire icy la beſte, & que le loup vous mange	Je vous trouve Monsieur par trop facile à preudre, L'on ne vous verra point sans vous railler beaucoup, De vous être laissé prendre ainsi par le loup, Mais gardez s'il vous plaît, dans votre amour éltalise , De faire ici la bête, et que le loup vous mange
CLIDAMANT.	CLIDAMANT.
Tout ce que tu me dis, ne m’en deſtourne point, Ie l’aime;	Tout ce que tu me dis, ne m'en détourne point, Je l'aime;
& ſon eſprit me charme au dernier point.	et son esprit me charme au dernier point.
Ah, Guillot quel plaiſir on a dans ces Caroſſes.	Ah, Guillot quel plaisir on a dans ces Carosses.
GVILLOT.	GUILOT.
Quel plaiſir de ſe voir charier par des roſſes, Par des harans ſorets des cheuaux ſi hydeux, Que i’aymerois autant eſtre en charette à bœufs, Quontole dedano le fond ou deuuns là porciere, On voit roſſes deuant, on voit roſſes derriere, On a beau regarder de l'vn à l’autre bout, On ne voit iamais rien que des roſſes par tout.	Quel plaisir de se voir charier par des rosses, Par des harants sorets des chevaux si hideux, Que j'aimerais autant être en charette à bœufs, Quontole dedano le fond ou devuns là porcière, On voit rosses devant, on voit rosses derrière, On a beau regarder de l'un à l'autre bout, On ne voit jamais rien que des rosses par tout.
CLIDAMANT.	CLIDAMANT.
HAI.	HAI.
Gardez pour trop roſſer, qu’icy ie ne vous roſſe.	Gardez pour trop rosser, qu'ic ie ne vous rosse.
GVI LLOT.	GUI LLOT.
Comme vn Chirurgien vous cherchez playe & boſſe, Mais ne m’en faites pas en cette occaſion, Car ie ſuis ennemy de la contuſion.	Comme un Chirurgien vous cherchez plaie et bosse, Mais ne m'en faites pas en cette occasion, Car ie suis ennemi de la contusion.
Monſieur ſi nous auons à demeurer enſemble, Ne nous battons iamais, ou qu’on nous deſaſſemble, Deuant que quelque coup ſoit ſur moy déchargé, Sans autre compiſent le vous donne congé	Monsieur si nous avons à demeurer ensemble, Ne nous battons jamais, ou qu'on nous désassemble, Dévant que quelque coup soit sur moi déchargé, Sans autre compisent le vous donne congé
CLIDAMANT.	CLIDAMANT.
A ton veu quelque-fois qu'vn vaſet chaſe vn Maiſtre?	À ton vu quelquefois qu'Han vaset chase un Maître?
GVILLOT.	GUILOT.
Si vous ne l’auez veu, vous le voyez paroiſtre, Auant que nous ayons quelque difficulté, Que chacun de nous deux aille de ſon coſté;	Si vous ne l'avez vu, vous le voyez paraître, Avant que nous ayons quelque difficulté, Que chacun de nous deux aille de son côté;
Il eſt tres aſſeuré que voüs eſtes mon Maiſtre Et moy voſtre valet, quoy qu’indigne de l’eſtre:	Il est très assuré que vœuxs êtes mon Maître Et moi votre valet, quoi qu'indigne de l'être:
Mais ſi vous me traittés autrement que fort bien, Dés ce meſme moment nous ne nous ſerons rien.	Mais si vous me traitez autrement que fort bien, Dès ce même moment nous ne nous serons rien.
CLIDAMANT.	CLIDAMANT.
D’où vient que contre moy ta colere s’enſſâme?	D'où vient que contre moi ta colère s'enssme?
Tu te fâches touſiours.	Tu te fâches toujours.
CpindoT.	CpindoT.
Vous auez vne femme, D'ont le Ciel par l'himen vous a fait vn preſent, Charmante & dont le bien eſt pour vous ſuffiſant.	Vous avez une femme, D'ont le Ciel par l'hymen vous a fait un présent, Charmante et dont le bien est pour vous suffisant.
Ce pendant vous allez courir la pretentaine Penſez-vous qu’vne femme aime telle fredaine, Et qu’en continuant à faire l’éuenté, Elle n’en faſſe pas autant de ſon coſté?	Ce pendant vous allez courir la prétentaine Pensez-vous qu'une femme aime telle fredaine, Et qu'en continuant à faire l'éventé, Elle n'en fasse pas autant de son côté?
Croyez vous que Madame enfin ſoit vne beſte, Pour ne ſe mettre pas la jalouſie en teſte?	Croyez -vous que Madame enfin soit une bête, Pour ne se mettre pas la jalousie en tête?
Et que ſi vous courez à tout moment aim voue ne la voyez pas blen-toit courir auſſi?	Et que si vous courez à tout moment aim voue ne la voyez pas blen-toit courir aussi?
CLIDAMANT.	CLIDAMANT.
Ie me riray touſiours de ce que tu ſçais dire.	Je me rirai toujours de ce que tu sais dire.
GVILLOT.	GUILOT.
Monſieur tout doucement il ne faut point tant rire Ie ſçais vn quolibet tout à fait familier, Qui dit que rira bien qui rira le dernier.	Monsieur tout doucement il ne faut point tant rire Je sais un quolibet tout à fait familier, Qui dit que rira bien qui rira le dernier.
2 Si comme vous, Madame alloit courir la Ville, Pour ſe faire conter la fleurette gentille, Qu'elle ſe fiſt trainer en caroſſe public, Et qu’au jeu de coureuſe elle vous fiſt repic, Qu’en cherchant cõme vous autre, part ſa fortune En Caroſſe commun elle deuinſt commune, Qu’à toute heure elle miſt voſtre honneur en peril, Dites moy s’il vous plaiſt, le ieu vous plairoit-il?	2 Si comme vous, Madame allait courir la Ville, Pour se faire conter la fleurette gentille, Qu'elle se fît trainer en carrosse public, Et qu'au jeu de coureuse elle vous fît repic, Qu'en cherchant cõme vous autre, part sa fortune En Carosse commun elle devinst commune, Qu'à toute heure elle mit votre honneur en péril, Dites moi s'il vous plaît, le jeu vous plaierait-il?
Non.	Non.
CLIDAMIIVE.	CLIDAMIIVE.
GVILLOT.	GUILOT.
Mais cette facon vous eſtant couſtumiere, Elle pourroit agir de la meſme maniere, Et comme vous mettez ſon honneur aux aboïs, Vous rendre bien ſouuent des feves pour des pois, Ioint qu’elle s’y feroit ſuiure de ſa ſuiuante Et ſi dans ces harnois quelque galant les tente, Et que toutes les deux y perdent leurs vertus Monſieur qui de nous deux ſera le plus ca mus?	Mais cette façon vous étant coutumière, Elle pourrait agir de la même manière, Et comme vous mettez son honneur aux aboss, Vous rendre bien souvent des feves pour des pois, Joint qu'elle s'y ferait suivre de sa suivante Et si dans ces harnais quelque galant les tente, Et que toutes les deux y perdent leurs vertus Monsieur qui de nous deux sera le plus ca us?
CLIDAMANT.	CLIDAMANT.
Ton cipiit n'elt reinpiy que de Miie fottnes, Et tu ne m’entretiens iamais que de beſtiſes,	Ton cipiit n'elt reinpi que de Miie fottnes, Et tu ne m'entretiens jamais que de bêtises,
GVILLOT.	GUILOT.
Ce qu’on doit craindre encor en caroſſe à cinq ſous, C’eſt qu’on liure ſon cœur â lageule des loups;	Ce qu'on doit craindre encor en carosse à cinq sous, C'est qu'on livre son cœur â geule des loups;
On ne rencontre là que chetiues donzelle, Qui.	On ne rencontre là que chétives donzelle, Qui.
vous m’entendez bien paſſent pour telle u’elles:	vous m'entendez bien passent pour telle eelles:
Et ſi ſatan alloit vn beau iour s’auiſer De ſe veſtir en Dame & pour vous courtiſer Deſſus ſon laid minois qu’il allaſt mettre vn maſque Et que Monſieur mon Maiſtre & ſon amour fantaſque, Allaſt conter fleurette à ce demon folet, Et qu’il ſe trouuaſt pris par ce diable au colet, Il ne ſeroit pas temps alors de s’en dedire;	Et si satan allait un beau jour s'aviser De se vêtir en Dame et pour vous courtiser Dessus son laid minois qu'il allât mettre un masque Et que Monsieur mon Maître et son amour fantasque, Allast conter fleurette à ce démon folet, Et qu'il se trouvât pris par ce diable au collet, Il ne serait pas temps alors de s'en dédire;
Bien loin de vous quitter, il n’en feroit que rire, Et quand il vous tiendroit vne fois dans ſon lieu, Dieu ſçait s’il vous feroit grande chere& beau feu.	Bien loin de vous quitter, il n'en ferait que rire, Et quand il vous tiendrait une fois dans son lieu, Dieu sçait 'il vous ferait grande chereet beau feu.
Tout cela ne vaut rien ſçachez que ſi Madame:	Tout cela ne vaut rien sachez que si Madame:
Vous voit iamais bruſler d’vne nouuelle flâme, Qu’elle vous voye vſer d’vn trafic ſi gaillart.	Vous voit jamais brûler d'une nouvelle flamme, Qu'elle vous voie user d'un trafic si gaillart.
Elle vous laiſſera faire l’amour à part;	Elle vous laissera faire l'amour à part;
Et voyant en amour que vous faites ripaille Elle ſe ſeruira du droit de reprezaille, Puis apres ’vous dira pour vous creuer d’ennuy Ainſi que cét oyſeau, comme il te fait fais luy.	Et voyant en amour que vous faites ripaille Elle se servira du droit de reprezaille, Puis après 'vous dira pour vous cruer d'ennui Ainsi que cet oiseau, comme il te fait fais lui.
CLIDAMANT.	CLIDAMANT.
Ah, qu’elle n’eſt pas femme à faire telle fante, Elle a ti op de lagene & lame par trop haute, Pour me tromper iamais.	Ah, qu'elle n'est pas femme à faire telle santé, Elle a ty op de lagène et lame par trop haute, Pour me tromper jamais.
GVILLOT.	GUILOT.
Et Monſieur que ſçait-on L’occaſion dit on, fait ſouuent le larron.	Et Monsieur que Sait-on L'occasion dit on, fait souvent le larron.
CLIDAMANT.	CLIDAMANT.
Mais ie la voy venir:	Mais ici la vois venir:
éuitons ſa rencontre.	éviterons sa rencontre.
DEBNE V .	DEBNE V .
CLIDAMANT, CLARICE, GVILLOT.	CLIDAMANT, CLARICE, GUILOT.
CLARICE ſans maſque.	CLARICE sans masque.
Vſtes Dieux!	Utes Dieux!
il me fuit d’abort que ie me mouP tre.	il me fuit d'abort que je me mouP tre.
GVILLOI.	GUILOI.
Monſieur approchez vous.	Monsieur approchez -vous.
CLIDAMANT.	CLIDAMANT.
Te tairas tu maraut?	Te tairas -tu maraud?
GVILEOT.	GUILEOT.
Faites luy mettre vn Loup vous l’aimerez bientoſt.	Faites -lui mettre un Loup vous l'aimerez bientôt.
CLARICE.	CLARICE.
2 61 Comment donc?	2 61 Comment donc?
vous fuiez alors qu’on vous appelle?	vous fuyez alors qu'on vous appelle?
GVILLOT.	GUILOT.
Il reſſemble le chien de feu Iean de Niuelle.	Il ressemble le chien de feu Jean de Nivelle.
CLARICE.	CLARICE.
Mais qui vous rend, Monſieur, de ſi mauuaiſe hu Mlu	Mais qui vous rend, Monsieur, de si mauvaise hu Mlu
CLIDAMANT.	CLIDAMANT.
I’ay perdu mon argent.	J'ai perdu mon argent.
CLARICE.	CLARICE.
Ou plûtoſt voſtre cœur	Ou plutôt votre cœur
CLIDAMANT.	CLIDAMANT.
Ah!	Ah!
Madame!	Madame!
ſçachez que le luis tounours voſtre, Et Guillot vous peut dire.	sachez que le luis tounours vôtre, Et Guillot vous peut dire.
Oüy c’eſt vn bon apoſtre.	Oui c'est un bon apôtre.
CLIDAMANT.	CLIDAMANT.
Que ie vous aime autant.	Que ici vous aime autant.
4 1 GVILLOT.	4 1 GVILLOT.
Madame par ma foy, Il vous aime en vn point.	Madame par ma foi, Il vous aime en un point.
enfin.	enfin.
que ſçay ie moy?	que sais ici moi?
Ie ne puis pas auoir l’eloquence aſſez forte, Pour vous bien l’exprimer, ou le Diable m’emporte.	Je ne puis pas avoir l'éloquence assez forte, Pour vous bien l'exprimer, ou le Diable m'emporte.
honmen	honmen
CLARICE.	CLARICE.
Ie vous laiſſe reſuer, adieu, ie vais chez nous.	Je vous laisse rêver, adieu, on vais chez nous.
CLIDAMANT.	CLIDAMANT.
Madame auriez vous pas voſtre monſtre ſur vous?	Madame auriez -vous pas votre montre sur vous?
La mienne eſt demeurée au logis ſur ma table.	La mienne est demeurée au logis sur ma table.
CLARICE.	CLARICE.
La voila, ie m’en vais.	La voilà, Seigneur m'en vais.
GVILLOT.	GUILOT.
Il la voudroit au diable, Pauure ſouffre-douleur que tu me rais pimie!	Il la voudrait au diable, Pauvre souffre-douleur que tu me rais ie!
Il faut que vous ſoyés, Monſieur, ſans amitié	Il faut que vous soyez, Monsieur, sans amitié
CLIDAMANT.	CLIDAMANT.
Ah!	Ah!
depuis que i’ay veu cette adorable Dame, Ie ne ſçaurois ſouffrir aucunement ma femme, Ne ſeray ie iamais au bien heureux moment, Que ie dois voir icy cét objet ſi charmant?	depuis que j'ai vu cette adorable Dame, Je ne saurais souffrir aucunement ma femme, Ne serai ie iamais au bien heureux moment, Que ils dois voir ici cet objet si charmant?
Mais las!	Mais las!
ie l’apperçois:	Ne l'aperçois:
ô dieux qu’elle a de grace?	ô dieux qu'elle a de grâce?
Madame vous daignez vous rendre en cette place;	Madame vous daignez -vous rendre en cette place;
Ah!	Ah!
que vous me comblés de faueurs en ce iour.	que vous me comblez de faveurs en ce jour.
CLARICE.	CLARICE.
On n’en ſçauroit moins faire ayant beaucoup d’amour.	On n'en saurait moins faire ayant beaucoup d'amour.
GVILLOT.	GUILOT.
Peſte qu'elle l'entend la matoiſe eſt rufée, Des la ſeçonde veuë elle eſt appriuoiſée.	Peste qu'elle l'entend la matoise est rusée, Des la seçonde vue elle est appriuoisée.
CLIDAMANT.	CLIDAMANT.
Madame, ie vous oit,et mon ceur & mon bien.	Madame, Seigneur vous oit, mon cœur et mon bien.
GVILLOT.	GUILOT.
Il n’en lortira pas lans y ſaiſſer du ſien.	Il n'en lortira pas lans y saisser du sien.
CLARICE.	CLARICE.
bas.	bas.
Voyez la trahiſon, la perfidie extreme, En tiendrois-ie à preſent ſi ie n’eſtois moy meſme?	Voyez la trahison, la perfidie extrême, En tiendrais-je à présent si On n'étais moi -même?
*87	*87
CLIDAMANT.	CLIDAMANT.
e Acceptez, s’il vous plaiſt, mon ſeruice & ma foy	 Acceptez, s'il vous plaît, mon service et ma foi
CLARICE.	CLARICE.
Ie ne refuſe point ce qui n’eſt deu qu’à moy, d dit dhie vamte, mais comme le vous aimte, Ce ſeroit me trahir ſi vous n’aimiez de meſme, Ainſi deux cœur vnis ne doiuent eſtre qu’vn.	Je ne refuse point ce qui n'est dev qu'à moi, d dit dhie vamte, mais comme le vous aimette, Ce serait me trahir si vous n'aimiez de rendre, Ainsi deux cœur Tris ne doivent être qu'un.
GVILLOT.	GUILOT.
Ils vont mettre bien-toſt tout leur bien en commun, Mai comme irfait l'amour a la chere poupine, Qu'à luy conter douceur le drolle ſe caline, Si pour moy vous vouliez auoir le cœur benin.	Ils vont mettre bientôt tout leur bien en commun, Mai comme irfait l'amour a la chère poupine, Qu'à lui conter douceur le drolle se caline, Si pour moi vous vouliez avoir le cœur bénin.
Nous pourrions bien auſſi nous donner du calin	Nous pourrions bien aussi nous donner du câlin
BEATRIX.	BEATRIX.
Quoy tu voudrois à deux donner tes amourettes?	Quoi tu voudrais à deux donner tes amourettes?
GVILLOT.	GUILOT.
Pourquoy non?	Pourquoi non?
vn bon cocq à bien douze pouIettes.	Un bon cocq à bien douze pouItes.
LISETTE.	LISETTE.
prayuiene e ent pour ton nés, on t’en donnera deux.	praiviene e ent pour ton nés, on t'en donnera deux.
GVILLOT.	GUILOT.
Sçauez vous que ie ſuis rudement amoureux, Et que c’eſt bien du moins que i’aye deux Chimenes.	Savez -vous que je suis rudement amoureux, Et que c'est bien du moins que j'aie deux Chimène.
Puis que mon Maiſtre en à trois ou quatre douzaines.	Puis que mon Maître en à trois ou quatre douzaines.
CLARICE.	CLARICE.
Monſieur, voſtre valet vous met en grand credit.	Monsieur, votre valet vous met en grand crédit.
GVILLOT.	GUILOT.
Nous auons en amour tous deux bon appetit.	Nous avons en amour tous deux bon appétit.
CLIDAMANT.	CLIDAMANT.
Tout ce qu’il dit n’eſt rien que pour nous fair e rire;	Tout ce qu'il dit n'est rien que pour nous fair e ire;
Madame autre que vous ne cauſe mon martire, Oüy de vous adorer ie fais tout mon bon-heur, I’en iure par vos yeux & deſſus mon honneur.	Madame autre que vous ne cause mon martyre, Oui de vous adorer tu fais tout mon bonheur, J'en jure par vos yeux et dessus mon honneur.
GVILLOT.	GUILOT.
Ah.	Ah.
ne le croyez pas, il iure par coutume, Il eſt chargé d’honneur cõme vn crapaut de plume.	ne le croyez pas, il jure par coutume, Il est chargé d'honneur comme un crapaut de plume.
CLIDAMANT.	CLIDAMANT.
Ah!	Ah!
c’eſt trop ii incerompee.	c'est trop ji incerompee.
GVILLOT.	GUILOT.
Et bien ie ne dis mot	Et bien ici ne dis mot
CLIDAMAMT.	CLIDAMAMT.
Vous vous ferez frotter ſi vous faites le ſot, Daignerez vous ſouffrir adorable perſonne, Queiatu noi de mon auiburte plerent le vous donne?	Vous vous ferez frotter si vous faites le sot, Daignerez -vous souffrir adorable personne, Quejatu noi de mon aviburte plèrent le vous donne?
CLARICE.	CLARICE.
Ce ſeroit vous fâcher ſi ie refuſois rien, Tous les biens ſont communs, alors qu’on s’aime bien, Lt come vo icauez à quel poit le vous ame.	Ce serait vous fâcher si ici refusais rien, Tous les biens sont communs, alors qu'on s'aime bien, Lt come vo icavez à quel poit le vous âme.
.	.
Il me fait vn preſent de ma montre à moy m'eſme L’ingrat, le deſloyal.	Il me fait vn présent de ma montre à moi m'esmé L'ingrat, le déloyal.
GVILLOT.	GUILOT.
Ah!	Ah!
tout beau, s’il vous plaiſt Si vous voulez aimer aimez, ſans intereſt;	tout beau, s'il vous plaît Si vous voulez aimer aimez, sans intérêt;
Comment Monſieur donner la montre à voſtre femme?	Comment Monsieur donner la montre à votre femme?
Dites, eſtes vous fou?	Dites, êtes -vous fou?
Clarice, Liſette, & Beatrix ſortent.	Clarice, Lisette, et Beatrix sortent.
CLIDAMANT.	CLIDAMANT.
Veux tu te taire infame?	Veux tu te taire infâme?
Quoy ie ne puis pas eſtre vn moment en repos Traiſtre, il faut qu’en ce lieu ie te briſe les os.	Quo ie ne puis pas être un moment en repos Traistre, il faut qu'en ce lieu ie te brise les os.
Pardon.	Pardon.
GVILLOT à genoux.	GUILOT à genoux.
C.	Ç.
LIDAMANT.	LIDAMANT.
Coquin.	Coquin.
Madame.	Madame.
GVILLOT.	GUILOT.
Ah!	Ah!
le plaiſant rencontre.	le plaisant rencontre.
CLIDAMANT.	CLIDAMANT.
Que veut dire cecy?	Que veut dire ceci?
GVILLOT.	GUILOT.
Regardez voſtre montre, Afin que nous puiſſiõs ſçauoir qu’elle heure il eſt;	Regardez votre montre, Afin que nous puissions savoir qu'elle heure il est;
Vous le meritez bien, Monſieur, puis qu’il vous plaiſt, Mais voſtre deſtinée eût eſté bien meilleure, or quand elle eſtoit là, la montre eût ſonné l’henEt qu’auant qu’elle pût d’icy démeſnager, vous I’eumez pu reauire à l'neure du berger.	Vous le méritez bien, Monsieur, puis qu'il vous plaît, Mais votre destinée eût été bien meilleure, or quand elle était là, la montre eût sonné l'henait qu'avant qu'elle pût d'ici démesnager, vous J'eumez pu reavire à l'neure du berger.
CLIDAMANT.	CLIDAMANT.
Non, ie ny cõprens rien, plus mon ame s’ocupe.	Non, Seigneur Seigneur cõprens rien, plus mon âme s'ocupe.
GVILLOT.	GUILOT.
Et moy ie comprens fort qu’on vous apris pour duppe, Il valoit beaucoup mieux faire l’amour chés vous Que d’en aller conter en Caroſſe à einq ſous.	Et moi assez comprends fort qu'on vous appris pour dupe, Il valait beaucoup mieux faire l'amour chez vous Que d'en aller conter en Carosse à éinq sous.
CLIDAMANT.	CLIDAMANT.
Adieux:	Adieux:
lais Cindor vient à la liace Noyalle.	lais Cindor vient à la liace Noyalle.
GVILLOT.	GUILOT.
Tout vient icy de vray, mais la montre deſtalle.	Tout vient ici de vrai, mais la montre destalle.
SOLEEVT.	SOLEUT.
CLAINDOR, CLIDAMANT, GVILLOT.	CLAINDOR, CLIDAMANT, GUILOT.
CLINDOR fortant du Caroſſe auëc Lucreſſe & vn autre.	CLINDOR sortant du Carosse auec Lucresse et un autre.
Dieu Meſſieurs ie ſuis voſtre humble ſerA uiteur.	Dieu Messieurs Seigneur suis votre humble serA uiteur.
LVCRESSE.	LVCRESSE.
Nous n’auons iamais eu rant de bien & d’honneur, Qu’on en a de ſe voir en voſtre compagnie,	Nous n'avons jamais eu rant de bien et d'honneur, Qu'on en a de se voir en votre compagnie,
Adicu, CLINDOR.	Adicu, CLINDOR.
GVILLOT.	GUILOT.
Que de ceremonie	Que de cérémonie
CLINDOR.	CLINDOR.
Qui vous croyoit iey ener amy endamant.	Qui vous croyait iey en ami endamant.
GVILLOT.	GUILOT.
an nes y void que trop pour ſon contentement:	an nés y voit que trop pour son contentement:
CLIDAMANT.	CLIDAMANT.
Ah!	Ah!
que i’ay de chagrin.	que j'ai de chagrin.
CLINDOR.	CLINDOR.
Qui le peur faire naiſtre?	Qui le peur faire naître?
VILLOT.	VILOT.
Demandez luy Monſieur qu’elle heure il peut bien eſtre.	Demandez Seigneur Monsieur qu'elle heure il peut bien être.
CLINDOR.	CLINDOR.
Tais-toy, mais qu’auez vous qui vous met en courroux?	Tais-toi, mais qu'avez -vous qui vous met en courroux?
CLADAMANI.	CLADAMANI.
Des Dames en Caroſſe auoient pris rendez-vous, Pour veml en tes ſieux, elles y lour venues .	Des Dames en Carosse avaient pris rendez-vous, Pour veml en tes sieux, elles y lour venues .
GVILLOT.	GUILOT.
Oüy, mais auec ſa montre elles ſont diſparües.	Oui, mais avec sa montre elles sont disparues.
CLINDOR.	CLINDOR.
He bien!	He bien!
pour vne montre eſt ce vn ſi grand mal heur?	pour une montre est ce un si grand mal heur?
CLIDAMANT.	CLIDAMANT.
VON, ſliais l'en adore vne & c’eſt ſà ma douleur,	VON, sliais l'en adore une et c'est sà ma douleur,
CLINDOR.	CLINDOR.
Il eſt vray qu’elle eſt grande.	Il est vrai qu'elle est grande.
GVILLOT.	GUILOT.
Ah!	Ah!
les maudits Caroſſes, u lon prene, ccarsargent, ou l'on tait cous ne goſſes.	les maudits Carosses, u lon prène, ccarsargent, ou l'on taît cous ne gosses.
Quinas e lea.	Quinas e lea.
I’en ſors & ne croy pas que l’on m’ait pris le mien	J'en sors et ne crois pas que l'on m'ait pris le mien
GVILLOT.	GUILOT.
Que ſçauez vo9 Monſieur, en iureriez vous bien,	Que savez vo Us, en jureriez -vous bien,
CLINDOR.	CLINDOR.
Ie le verray bien-toſt, il n’eſt rien plus facile.	Je le verrai bientôt, il n'est rien plus facile.
Il fouille en ſa poche.	Il fouille en sa poche.
O u dis, ie lle troude len.	Ô Ou dis, Seigneur lèle troude len.
GVILLOT.	GUILOT.
Adieu voſtre maz ille	Adieu votre maz ille
CLIDAMANT.	CLIDAMANT.
Quoy Clindor auriez vo9 trouué quelques filoux?	Quoi Clindor auriez vous trouvé quelques filoux?
CLINDOR.	CLINDOR.
I'auois porté ſur moy quantité de bijoux, Et l’on m’a tout volé, iuſtes dieux!	J'avais porté sur moi quantité de bijoux, Et l'on m'a tout volé, iustes dieux!
quel rencontre.	quel rencontre.
JVILLOT.	JVILOT.
Les bijoux ſont allez ſans doute auec la montre, Ie ne m’eſtonne plus ſi ces dignes Meſſieurs, Vous diſoient qu’ils eſtoient ſi fort vos ſeruiteurs Qu’ils n’auoient iamais eu tant de bien en leur Qu’il en auoient receu de voſtre compagnie.	Les bijoux sont allés sans doute avec la montre, Je ne m'étonne plus si ces dignes Messieurs, Vous disaient qu'ils étaient si fort vos serviteurs Qu'ils n'avaient jamais eu tant de bien en leur Qu'il en avaient reçu de votre compagnie.
CLINDOR.	CLINDOR.
Encore ſi j’auois en ce lieu mon valet.	Encore si j'avais en ce lieu mon valet.
GVILLOT.	GUILOT.
Monſieur chez chaque Orfeure enuoyez vn billet.	Monsieur chez chaque Orfeure envoyez un billet.
Pour moy, ſi ie les trouue auec que mon olinde.	Pour moi, si ici les trouve avec que mon olinde.
Et nous Monſieur allons chercher nos louues dinde.	Et nous Monsieur allons chercher nos louves dinde.
ACTE TROISIESME.	ACTE -TROISIÈME.
DSLNDI.	DSLNDI.
CLARICE, LVCRESSE, BEATRIX, LISETTES	CLARICE, LUCRESE, BEATRIX, LISETTES
CLARICE.	CLARICE.
Voüons toutes deux qu’en Caroſſe à cinq ſous, I A Nous auons fait des tours qui ſont dignes de nous.	Voüons toutes deux qu'en Carse à cinq sous, I A Nous avons fait des tours qui sont dignes de nous.
Puis que vous en auez tiré vos pierreries Et qu’vn mary m’a dit forces galanterles:	Puis que vous en avez tiré vos pierreries Et qu'un mari m'a dit forces galanterles:
Mais quoy s'n s'ent reuu dans ce ſieu mon amant Ie n’en dois le bonheur qu’à mon loup ſeulement;	Mais quoi s'n s'ent reuu dans ce sieu mon amant Je n'en dois le bonheur qu'à mon loup seulement;
Pour vous on ne peut trop admirer voſtre adreſſe.	Pour vous on ne peut trop admirer votre adresse.
LVCRESSE.	LVCRESSE.
Il eſt vray que i’ay fait le trait auec ſoupleſſe;	Il est vrai que j'ai fait le trait a plesse;
Ie vay pour mon argent jouer d’vn autre tour	Je vais pour mon argent jouer d'un autre tour
CLARICE.	CLARICE.
Moy jouer Clidamant juſqu’à la fin du iour.	Moi jouer Clidamant jusqu'à la fin du jour.
LVCRESSE	LVCRESSE
LVCRESSE.	LVCRESSE.
St, Ragotin paroiſt;	St, Ragotin paraît;
voicy quelque reſource;	voici quelque ressource;
Nous nous retrouuerõs dez que i’auray la bourſe.	Nous nous retrouuerõs dé que j'aurai la bourse.
Ne vous eſloignez pas s’il vous plaiſt de ces lieux.	Ne vous éloignez pas s'il vous plaît de ces lieux.
ACLIT RAGOTIN.	ACLIT RAGOTIN.
ſeul.	seul.
II	II
A peſte le bon vin, mais il eſt furieux;	À peste le bon vin, mais il est furieux;
I'en deuois par ma foy prendre moins d’vue Dragme, Car ie me ſens brûler iuſques au diafragme.	J'en devais par ma foi prendre moins d'une Dragme, Car tu me sens brûler jusques au diafragème.
l’auoüeray que cét homme eſtoit menteur alors, Qui diſoit qu’vn bon vin ſoûtenoit bien vn corps, Et qu’vn doit deſtournoit d’aller dedãs la tombe.	l'auoüeray que cet homme était menteur alors, Qui disait qu'un bon vin soutenait bien un corps, Et qu'un doit détournait d'aller dedans la tombe.
I'en ay beu comine vn diable, & ie ſens que ie tombe.	J'en ai bu comine un diable, et ton sens que Ne tombe.
Mon amy, mon garçon, mon fanfan, mon cher cœur, En cette occaſion monſtre de la vigueur.	Mon ami, mon garçon, mon sansan, mon cher cœur, En cette occasion montre de la vigueur.
DULNE III LVCRESSE.	DULNE III LUCRESSE.
RAGOIIIV.	RAGOIIV.
LVCRESSE.	LVCRESSE.
H, l'eſtrange malheur!	H, l'étrange malheur!
que ie ſuis miſerable!	que ici suis misérable!
Eſt il vn ſort au monde à mon ſort comparable ?	Est il un sort au monde à mon sort comparable ?
Dire que i’ay ioué, c’eſt dire i’ay perdu.	Dire que j'ai joué, c'est dire j'ai perdu.
RAGOTIN.	RAGOTIN.
Qu’auez vous donc Monſieur?	Qu'avez -vous donc Monsieur?
qui vous rend eſperdu?	qui vous rend éperdu?
LVCRESSE.	LVCRESSE.
Ce que i’ay?	Ce que j'ai?
i’ay perdu plus de mille piſtolles, Et ie puis bien au moins perdre quelques parolles	j'ai perdu plus de mille pistoles, Et je puis bien au moins perdre quelques paroles
RAGOTIN.	RAGOTIN.
Ah, Monſieur perdez en, ie n’y reſiſte pas, Comme vn deſeſperé criés au meurtre, helas, Peſtez & tempeſtez apres les deſtinées, Lutez ſi vous voulez contre les Pyrenées, Iurés comme vn Chartier dans voſtre paſſion;	Ah, Monsieur perdez en, votre n'y résiste pas, Comme un désespéré criez au meurtre, hélas, Pestez et tempêtez après les destinées, Lutez si vous voulez contre les Pyrénées, Jurez comme un Chartier dans votre passion;
Ie verray tout cela ſans nulle emotion.	Je verrai tout cela sans nulle émotion.
LVCRESSE.	LVCRESSE.
Ah, mort.	Ah, mort.
ToIL DICI.	ToIL DICY.
RAGOTIN.	RAGOTIN.
LVCRESSE.	LVCRESSE.
M'auoir quitté de la maniere Auec trente Loüis:	M'avoir quitté de la manière Avec trente Louis:
ie vay dans la riuiere Les ietter ſi ie n’ay quelqu'vn pour les iouer, Mais quoy, ſçay-ie aucun jeu?	Ce vais dans la rivière Les jeter si ici n'ai quelqu'un pour les jouer, Mais quoi, sais-je aucun jeu?
RAGOTIN.	RAGOTIN.
Ie veux l’amadoüer, Il vaut mieux les gagner que ſouffrir qu’il les iette Il ne ſçay pas le jeu, ie n’y ſuis pas mazette, Monſieur les voulez vous jouer dedans ce lieu?	Je veux l'amadouer, Il vaut mieux les gagner que souffrir qu'il les jette Il ne sais pas le jeu, je n'y suis pas mazette, Monsieur les voulez -vous jouer dedans ce lieu?
LVCRESSE.	LVCRESSE.
Ie le voudrois bien, mais ie ne ſçay pas le jeu.	Je le voudrais bien, mais ici ne sais pas le jeu.
RAGOTIN.	RAGOTIN.
Mlo!	Mlo!
nous vous le pourrons facilement apprendre, Pourueu que vous vouliez preſentement m’entendre, Quelle caltecree la.	nous vous le pourrons facilement apprendre, Pourvu que vous vouliez présentement m'entendre, Quelle caltecre la.
LVCRESSE.	LVCRESSE.
C’eſt le Roy de careau,	C'est le Roi de careau,
RAGOTIN.	RAGOTIN.
L’innocent!	L'innocent!
l’As de cœur, peſte du iouuençeau.	L'As de cœur, peste du iouuençeau.
Et ces deux autres la?	Et ces deux autres la?
LVCRESSE.	LVCRESSE.
Ce ſont ie croy deux treffles.	Ce sont ie cy deux treffles.
EJ	EJ
RAGOT IN.	RAGOT IN.
S’il s’en alloit au Temple il auroit bien des neffles.	S'il s'en allait au Temple il aurait bien des nesles.
A quel ieu iourons nous?	À quel jeu jourons -nous?
LVCRESSE.	LVCRESSE.
Au Lenſquenet.	Au Lensquenet.
A quelque ieu nouueau,	À quelque jeu nouveau,
RAGOTIN.	RAGOTIN.
Coupez.	Coupez.
LYCRDSGE.	LYCRDSGE.
Ie n’ay point de couteau.	Je n'ai point de couteau.
RAGOTIN.	RAGOTIN.
Au Diable ſoit la beſte & l’ignorance craſſe.	Au Diable soit la bête et l'ignorance crasse.
LVCRESSE.	LVCRESSE.
Eſtant de qualité i’aurois mauuaiſe grace, De iouer auec toy, puis as tu de l’argent?	Étant de qualité j'aurais mauvaise grâce, De jouer avec toi, puis as tu de l'argent?
RAGOTIN.	RAGOTIN.
Apprenés que ie ſuis moins que vous indigent.	Apprenez que ici suis moins que vous indigent.
Que ie ne ſuis iamais ſans quinze cent piſtolles, Ie vais vous les tirer pour prouuer mes parolles.	Que personne ne suis jamais sans quinze cent pistoles, Je vais vous les tirer pour prouver mes paroles.
LYCRESSE:	LYCRESSE:
Honneſte homme parbleu, puis qu’il a de l’argent.	Honnête homme parbleu, puis qu'il a de l'argent.
RAGOTIN, Ca Monſieur s’il vous plaiſt commençons maintenant.	RAGOTIN, Ca Monsieur s'il vous plaît commençons maintenant.
Coupez;	Coupez;
A vous la main.	À vous la main.
LVCRESSE.	LVCRESSE.
oui ies deux cartes voſtres, Que iouez vous l’amy?	oui jes deux quartes vôtres, Que jouez -vous l'ami?
les trente Loüis noſtres?	les trente Louis notre?
IIBCTIN.	IIBCTIN.
Oüy da, ie le veux bien.	Oui da, Seigneur le veux bien.
LVCRESSE.	LVCRESSE.
Celle-là c’eſt pour moy.	Celle-là c'est pour moi.
Mais beau ieu bon argent.	Mais beau jeu bon argent.
RAGOTIN.	RAGOTIN.
Tout eſt de bon alloy.	Tout est de bon alloi.
LVCRESSE ſe tournant vers le monde.	LVCRESSE se tournant vers le monde.
Pourquoy venir parler ſur le ieu de la ſorte, Sçauez vous que ie ſuis vn homme qui m’emporC’eſt trop, il faut au nés les cartes vous lancer.	Pourquoi venir parler sur le jeu de la sorte, Savez -vous que je suis un homme qui m'emporC'est trop, il faut au nez les cartes vous lancer.
RAGOTIN.	RAGOTIN.
Monſieur, attendez moy ie vay les ramaſſer.	Monsieur, attendez moi -je vais les ramasser.
C	Ç
EETTRIGVE DES CAROSSES	EETTRIGUE DES CAROSSES
LVCRESSE.	LVCRESSE.
Tandis que bonnement les cartes il ramaſſe, Plions luy ſa toilette & de fort bonne grace, Et ſongeons promptement à deſloger d'icy.	Tandis que bonnement les cartes il ramasse, Plions lui sa toilette et de fort bonne grâce, Et songeons promptement à déloger d'ici.
SCERREV RAGOTIN.	SCEREU RAGOTIN.
E vais à vous Monſieur;	E vais à vous Monsieur;
Ne parlez plus ainſi Et laiſſez nous iouer, Meſſieurs ſans nous rien dire;	Ne parlez plus ainsi Et laissez nous jouer, Messieurs sans nous rien dire;
Coupez, ou Diable eſt il, il s’eſt caché pour rire, Eſperant que la peur me ſaiſiroit les ſens, Mais peſte il ne tient rien, ie cõnois biẽ mes gens.	Coupez, ou Diable est -il, il s'est caché pour rire, Espérant que la peur me saisirait les sens, Mais peste il ne tient rien, ie cõnois bien mes gens.
Et puis ſon innocence allant iuſqu’à l’extreme, Pourroit il iamais faire vne action de meſme?	Et puis son innocence allant jusqu'à l'extrême, Pourrait il jamais faire une action de même?
Cherchons-le cepeudant, quoy qu’il ne ſoit pas fin, S’il s’en eſtoit allé, i’en aurois du chagrin:	Cherchons-le cepeudant, quoi qu'il ne soit pas fin, S'il s'en était allé, j'en aurais du chagrin:
Ah, c’eſt trop vous cacher Monſieur de l’ignorance, Hola!	Ah, c'est trop vous cacher Monsieur de l'ignorance, Holà!
ne ſuis ie point duppé par l’innocence.	ne suis ici point dupé par l'innocence.
Oüais, ie n’apperçois rien, il n’eſt plus en ce lieu, Ie ſuis volé ſans doute, Ine ſcait pas le ieu?	Ouais, Seigneur n'aperçois rien, il n'est plus en ce lieu, Je suis volé sans doute, Ine sait pas le jeu?
Monſieur?	Monsieur?
au Diablezot, il a plié bagage, C’eſt moy meſme qui ſuis l’innocence perſonnage, Si mon maiſtre ſuruient ie ſuis pendu tout net.	au Diablezot, il a plié bagage, C'est moi -même qui suis l'innocence personnage, Si mon maître survient ton suis pendu tout net.
Il vient.	Il vient.
JCLEEV.	JCLEU.
CLINDOR, RAGOTIN.	CLINDOR, RAGOTIN.
CLINDOR.	CLINDOR.
E voudrois bien rencontrer mon valet, Afin de pouuoir mieux mettre ordre à mon affaire, Le voila, Ragotin, parle, qui te fait taire,	E voudrais bien rencontrer mon valet, Afin de pouvoir mieux mettre ordre à mon affaire, Le voilà, Ragotin, parle, qui te fait taire,
e ldd llla Ah, i’ay la gueule morte en ma grande douleur.	 Je léda Ah, j'ai la gueule morte en ma grande douleur.
CLINDOR.	CLINDOR.
Comment t’a t’on appris iuſqu’ou va mõ malheu	Comment t'a -t-on appris jusqu'ou va mon malheu
RAGOTIN.	RAGOTIN.
Dans ce monde Monſieur tout chacun a ſa peine Vous ſçauez bien la voſtre & ie ſçay bien la mier ne.	Dans ce monde Monsieur tout chacun a sa peine Vous savez bien la vôtre et tu sais bien la mier ne.
CLINDOR.	CLINDOR.
Dis la moy, t’a t’on fait fait quelque choſe en ce lieu,	Dis la moi, t'a -t-on fait fait quelque chose en ce lieu,
RAGOTIN.	RAGOTIN.
Vn çertain innocent qui ſans ſçauoir le jeu!	Un çertain innocent qui sans savoir le jeu!
Iouoit auecque moy, i’ay tiré voſtre bourſe, Il à tout emporté, puis il a pris ſa courſe	Jouait auecque moi, j'ai tiré votre bourse, Il a tout emporté, puis il a pris sa course
CLINDOR.	CLINDOR.
Ah, traiſtre tu ſeras pendu dedans ce lieu.	Ah, traître tu seras pendu dedans ce lieu.
leiroo lIia Monſieur eſt ce ma faute?	leiro lIia Monsieur est ce ma faute?
il ne ſçait pas le jeu.	il ne sait pas le jeu.
CLINDOR.	CLINDOR.
He las ie ſuis perdu, ſi tu ne le fais prendre, Il n’eſt rien plus certain que ie te feray pendre, Dépeſche viſtement de courir apres luy:	He las grands suis perdu, si tu ne le fais prendre, Il n'est rien plus certain que ie te ferai pendre, Dépêche vite de courir après lui:
Apres tant de mal heurs il faut mourir d’ennuy;	Après tant de mal heurs il faut mourir d'ennui;
SCENE VI.	SCÈNE VI.
CLIDAMANT, GVILLOT.	CLIDAMANT, GUILOT.
GVILLOT.	GUILOT.
ais monſieur voulez vous auec vos amourettes Courir inceſſammẽt & louues & louuette:	ais monsieur voulez -vous avec vos amourettes Courir incessammẽt et louves et lette:
2-	2-
Et n’eſtes vous point las d’aller & nuit & iour, En ces chiens de harnois exprimer voſtre amour!	Et n'êtes vous point las d'aller et nuit et jour, En ces chiens de harnais exprimer votre amour!
On ne voit rien que vous à toute heure en dommage, En Caroſſe de Ville;	On ne voit rien que vous à toute heure en dommage, En Carosse de Ville;
en fiacres de louage;	en fiacres de louage;
N’eſtiez vous pas encor’hier à courir les champs, Ou vous pouſſâtes là mille ſoupirs touchahs, Au pres d’vne beauté ſenſible à voſtre peine:	N'étiez -vous pas encore hier à courir les champs, Ou vous poussâtes là mille soupirs touchahs, Au pres d'une beauté sensible à votre peine:
Auiour d’huy dans Charonne & demain dans Vincenne, A Boulogne, Paſſy, ſaint Cloù, chez la du Rier Cocher, vous fait?	Auiour Cloù dans Charonne et demain dans Vincenne, À Boulogne, Passy, saint Cloù, chez la du Rier Cocher, vous fait?
s là le repas familier, Vous vous diuertiſſez de la bonne maniere, Dans ce charmant logis où l’on fait chere entiere, Et quand vous auez pris vos aimables ébas, Vous t’entrez en Caroſſe, & puis au petit pas, Mon cher remeine nous par le Cours de la Reine, Là vous goguenardez auec voſtre Chimene, Puis vous eſtant donné comme on dit du menu, A lors que vous auez tout voſtre ſoul couru, Et toute la iournée & toute la nuitée, Vous allez repoſer voſtre teſte éuentée.	s là le repas familier, Vous vous divertissez de la bonne manière, Dans ce charmant logis où l'on fait chère entière, Et quand vous avez pris vos aimables ébas, Vous t'entrez en Carse, et puis au petit pas, Mon cher ramène nous par le Cours de la Reine, Là vous goguenardez auec jours Chimène, Puis vous étant donné comme on dit du menu, À lors que vous avez tout votre soul couru, Et toute la journée et toute la nuitée, Vous allez reposer votre tête éventée.
Monſieur ſi vo9 menez encor long-temps ce train C’eſt prendre de l’enfer iuſtement le chemin,	Monsieur si vous menez encor longtemps ce train C'est prendre de l'enfer justement le chemin,
CETDAMAN.	CETDAMAN.
Ah, loin de te railler au fort de mon martire, enereſtons pruitore nobjet pour qui mon cœux ſoûpire,	Ah, loin de te railler au fort de mon martyre, enerestons pruitore nobjet pour qui mon cœux soupire,
GVILLOT.	GUILOT.
Comme de nos harnois c’eſt icy le bureau, Ceſſez d’inquieter voſtre digne cerueau, Vous y verrez bien-toſt venir vos Demoiſelles, Se camper en ces lieux comme des ſentinelles, Pour voir les damoiſeaux afin d’eſpionner, Qui leur poura donner quelque choſe à gagner:	Comme de nos harnois c'est ici le bureau, Cessez d'inquiéter votre digne cerveau, Vous y verrez bientôt venir vos Demoiselles, Se camper en ces lieux comme des sentinelles, Pour voir les damoiseaux afin d'espionner, Qui pour leur donner quelque chose à gagner:
Dés qu’elles peuuent voir vn homme d’aparence Elles ſont à l’afuſt pour auoir ſa finance, S’il vient s’encaroſſer pour chaſſer ſon ennuy, Elles ne manquentpas de s’y mettre auec luy, Et ne peut s’eſchaper des mains de ces Coquettes Qu’il ne ſoit auſſi ſec qu’vn paquet d’alumettes.	Dès qu'elles peuvent voir un homme d'apparence Elles sont à l'afust pour avoir sa finance, S'il vient s'encariser pour chasser son ennui, Elles ne manquentpas de s'y mettre avec lui, Et ne peut s'échapper des mains de ces Coquettes Qu'il ne soit aussi sec qu'un paquet d'alumettes.
Comme elles ſont, Monſieur, adroites à cela, Vous imaginez vous qu’elles s’en tiennent là?	Comme elles sont, Monsieur, adroites à cela, Vous imaginez -vous qu'elles s'en tiennent là?
Celle que vous aimez de ce mertier le pique, Et vous eſtes ma foy ſa meilleure pratique, Ainſi vous la verrez bien toſt dedans ce lieu,	Celle que vous aimez de ce mertier le pique, Et vous êtes ma foi sa meilleure pratique, Ainsi vous la verrez bien tôt dedans ce lieu,
CLIDAMAN T.	CLIDAMAN T.
Que lorerdis neureua, ai.	Que lorerdis neureua, ai.
Gunlot pleuit à Dieu.	Gunlot pleuit à Dieu.
SCLED VIT.	SCLED VIT.
CLIDAMANT, GVILLOT, LISETTE.	CLIDAMANT, GUILLOT, LISETTE.
GVILLOT.	GUILOT.
Onſieur, i’en voy déja quelqu’vne qui ſe montre;	Onsieur, j'en vois déjà quelqu'une qui se montre;
Cherchez fortune ailleurs nous n’auons plus de montre,	Cherchez fortune ailleurs nous n'avons plus de montre,
CLIDAMANT.	CLIDAMANT.
Auacey	Auacei
LISETTE.	LISETTE.
Mon cher amy ceſſe de te fâcher Ma Maiſtreſſe m’a dit de vous venir chercher ſronleur y ce rous trouuant voſtre montre vous Tendre.	Mon cher ami cesse de te fâcher Ma Maîtresse m'a dit de vous venir chercher sronleur y ce rous trouvant votre montre vous Tendre.
GVILLOT.	GUILOT.
De peur qu’elle n’échape, il la faut viſte prendre.	De peur qu'elle n'échappe, il la faut vite prendre.
OLID MMANI.	OLID MMANI.
Si tu me parles plus, ie te vais eſtrangler.	Si tu me parles plus, Seigneur te vais étrangler.
GVILLOT.	GUILOT.
Ah, i'aime beaucoup mieux Monſieur ne point parſer, Ie m’en vais obſeruer vn ſi profond ſilence, Que vous enragerez.	Ah, j'aime beaucoup mieux Monsieur ne point parser, Je m'en vais observer un si profond silence, Que vous enragerez.
CLIDAMANT.	CLIDAMANT.
Dis-moy ce qui l’offence;	Dis-moi ce qui l'offense;
Et la peut obliger a rendre ce preient.	Et la peut obliger à rendre ce précient.
LISETTE.	LISETTE.
Elle en a, ce dit-elle, vn ſuiet ſuffiſant.	Elle en a, ce dit-elle, un sujet suffisant.
CLIDAMANT.	CLIDAMANT.
Mais encor, quel eſt-il?	Mais encor, quel est-il?
&qu’ay ie pû luy faire?	etqu'a ie pu venir faire?
LISETTE.	LISETTE.
Vous me faites pitié, ie ne puis vous le taire, Ma maiſtreſſe ſe plaint diſant qu’en ce moment Qu’elle a ſceu s’en aller, il falloit promptement Des qu’elle vous quittoit haſtiuement la ſuiure, Pour montrer qu’en amour vous ſçauiez fort bien viure;	Vous me faites pitié, je ne puis vous le taire, Ma maîtresse se plaint disant qu'en ce moment Qu'elle a su s'en aller, il fallait promptement Des qu'elle vous quittait hastiuement la suivre, Pour montrer qu'en amour vous sauriez fort bien vivre;
Elle a connu par là que voſtre amour eſt lent.	Elle a connu par là que votre amour est lent.
CLIDAMANT.	CLIDAMANT.
Ah!	Ah!
que dit elle?	que dit -elle?
eſt il rien de ſi violent?	est il rien de si violent?
Dites luy s’il vous plaiſt que ie brûle pour elle, Que l’on ne vit iamais vn amant ſi fidelle, Et que ſi ie n’ay l’heur de la voir en ces lieux, Ie ſuis dans vn eſtat tout à fait perilleux, Ie luy diray pourquoy ie ne l’ay pas ſuiuie.	Dites -moi s'il vous plaît que je ne vit elle, Un amon si vit Et que si grande fidèle, Et que si grande n'ai l'heur de la voir en ces lieux, Je suis dans un état tout à fait périlleux, Je lui dirai pourquoi ie ne l'ai pas suivie.
LISETTE.	LISETTE.
Comme-elle vous aimoit au de là de ſa vie.	Comme-elle vous aimait au de là de sa vie.
CLIDAMANT.	CLIDAMANT.
Reportez ce preſent à cet obiet charmant Luy donnant de ma part encor ce diamant, Et pour vous s’il vous plaiſ, prenez ce cy, ma fille.	Reportez ce présent à cet objet charmant Lui donnant de ma part encor ce diamant, Et pour vous s'il vous plais, prenez ce cy, ma fille.
LISETTE.	LISETTE.
He, Monſieur.	He, Monsieur.
CLIDAMANT, Ie le veux.	CLIDAMANT, Je le veux.
GVILLOT.	GUILOT.
Ah!	Ah!
comme elle le pille.	comme elle le pille.
CLIDAMANT.	CLIDAMANT.
Mais me promettez vous que le la pourray voitrr	Mais me promettez -vous que le la pourrai voitr
LISETTE.	LISETTE.
le vay tout de ce pas y faire mon pouuoir.	le vais tout de ce pas y faire mon pouvoir.
SCLNEVIIE.	SCLNEVIIE.
CLIDAMANT, GVILLOT, CLIDAMANT.	CLIDAMANT, GUILOT, CLIDAMANT.
Ve dis tu cher Guillot?	Ve dis tu cher Guillot?
GVILLOT.	GUILOT.
Ie n’oſerois rien dire	Je n'oserais rien dire
CLIDAMANT.	CLIDAMANT.
Ah, parle, ie le veux.	Ah, parle, Seigneur le veux.
GVILLOT.	GUILOT.
Monſieur, laiſſez moy rire.	Monsieur, laissez -moi rire.
Continuez mon fils.	Continuez mon fils.
Ah!	Ah!
le ioly garçon, Vous allez bien-toſt faire vne bonne naiſon;	le joli garçon, Vous allez bientôt faire un bonne naison;
Si vous menez encor quelque temps cette vie, Nous, vous verrons dans peû chef de la gueuzerie.	Si vous menez encor quelque temps cette vie, Nous, vous verrons dans pu chef de la guzerie.
Mais i’apperçois venir vos trois obiets filoux:	Mais j'aperçois venir vos trois objets filoux:
Voila noſtre bre bis a la gueuiedea Loups,	Voilà votre bre bis a la guiedea Loups,
CLIDAMANT.	CLIDAMANT.
Ah, que ie ſuis heureux de vous reuoir, Madame, Eſtre en vn lieu ſans vous, c’eſt eſtre ſans ſon ame	Ah, que ici suis heureux de vous revoir, Madame, Être en un lieu sans vous, c'est être sans son âme
CLARICE.	CLARICE.
Pour vn homme qui dit aimer ſi puiſſamment, vous deuien ceme fembit agn tout autfement Me ſuiure en m’en allant.	Pour un homme qui dit aimer si puissamment, vous devien ceme fembit agn tout autfement Me suivre en m'en allant.
CLIDAMANT.	CLIDAMANT.
Ah!	Ah!
dedans ce rencontre, Vous m’euſſiez accuſé d’auoir ſuiuy ma montre	dedans ce rencontre, Vous m'eussiez accusé d'avoir suivi ma montre
CLARICE.	CLARICE.
L’excuſe eſt fort adroite.	L'excuse est fort adroite.
CLIDAMANT.	CLIDAMANT.
Appaiſez ce couroux	Apaisez ce courroux
CLARICE.	CLARICE.
Aflez ie vous pardonne, & ie fuis toute à vous.	Aflez ie -vous pardonne, et Seigneur fuis toute à vous.
GVILLOT.	GUILOT.
Les voila bons amis, comme elle l’amadouës En luy prenant ſon bien, la drolleſſe le iouë.	Les voilà bons amis, comme elle l'amadoues En tu prenant son bien, la drollesse le joue.
CLIDAMANT.	CLIDAMANT.
Madame obligez moy, que ie vous puiſſe voir,	Madame obligez -moi, que ainsi vous puisse voir,
Montrez ce beau viſage où giſt tout ihon eſpoir,	Montrez ce beau visage où gît tout ihon espoir,
GVILLOT.	GUILOT.
Ouy c’eſt bien raiſonner, leuez voſtre viſiere, o ert peut eutre mromneul queique vieſſle Iorciere	Oui c'est bien raisonner, luez votre visière, ô ert peut eutre mromneul queique viessle Jorcière
CLARICE.	CLARICE.
Si ie me demaſquois, vous ſerier tien vonfus, Voyant mõ peu d’attraits, voꝰ ne m’aimeriez plus.	Si personne me démasquais, vous sérier tien vonfus, Voyant mon peu d'attraits, vo ne m'aimeriez plus.
CLIDAMANT.	CLIDAMANT.
Quand vous n’auriez en vous que voſtre ſeule grace, Ie vous.	Quand vous n'auriez en vous que votre seule grâce, Je vous.
CLARICE.	CLARICE.
Vous me verrez auant que le iour paſſe, Mais auant que me voir, voulez vous m’opliger?	Vous me verrez avant que le jour passe, Mais avant que me voir, voulez -vous m'opliger?
CLIDAMANT.	CLIDAMANT.
Ie brauerois pour voꝰ iuſqu’au plus grand danger.	Je braverais pour voù jusqu'au plus grand danger.
Madame, ce que i’ay de plus conſiderable, Daignez vous en ſeruir s’il vous eſt agreable, anaa pertonne, mon dien, letour coue dt aequs	Madame, ce que j'ai de plus considérable, Daignez -vous en servir s'il vous est agréable, ana pertonne, mon dien, letour coue dût aequs
CLARICE.	CLARICE.
furouurois ſeulement quatre ou cinq cens Loüis	furouurois seulement quatre ou cinq cents Loüis
GVILLOT.	GUILOT.
Seulement, ce n’eſt rien, non redoublez la doze Vous n’auez rien, Monſieur qu’à rayer cette clauís Qui ne paſſera point de mon conſentement.	Seulement, ce n'est rien, non redoublés la docoze Vous n'avez rien, Monsieur qu'à rayer cette claus Qui ne passera point de mon consentement.
N’auez vous pas ſon cœur, ſa montre, vn diamant Sans nous venir encor excroquer noſtre bourſe?	N'avez -vous pas son cœur, sa montre, un diamant Sans nous venir encor excroquer notre bourse?
Ou pourrions nous apres trouuer quelque reIource?	Ou pourrions nous après trouuer quelque revource?
CLIDAMANT.	CLIDAMANT.
Ah!	Ah!
ie m’en vais icy terminer ton deſtin.	Ne m'en vais ici terminer ton destin.
GVILLOT.	GUILOT.
Que m’importe?	Que m'importe?
auſſi bien ie vay mourir de faim?	aussi bien ici vais mourir de faim?
CLARICE.	CLARICE.
Pouuez vous me donner ce que ie vous demande?	Pouvez -vous me donner ce que ici vous demande?
Il eſt certain que c’eſt vne faueur bien grande, Mais ie verray par là iuſqu’où va voſtre ardeur, Si vous me l’accordez.	Il est certain que c'est une faveur bien grande, Mais tu verrai par là jusqu'où va votre ardeur, Si vous me l'accordez.
GVILLOT.	GUILOT.
Autant pour le brodeur	Autant pour le brodeur
CLIDAMANT.	CLIDAMANT.
Ie vous les vay donner preſentement Madams	Je vous les vais donner présentement Madams
GVILLOT.	GUILOT.
Moy ie vay de ce pas tout dire à voſtre femme.	Mo ie vais de ce pas tout dire à votre femme.
CLIDAMANT.	CLIDAMANT.
Tu vas à ma fureur eſtre ſacrifié, Ie te vais aſſommer,	Tu vas à ma fureur Ah sacrifié, Je te vais assommer,
CLARICE.	CLARICE.
Vous eſtes marié	Vous êtes marié
CLIDAMANT.	CLIDAMANT.
Moy marié Madame?	Moi marié Madame?
ah !	ah !
c’eſt vne impoſtur Que ce maraut vous dit:	c'est une impostur Que ce maraud vous dit:
tu periras ie iure.	tu périras Seigneur jure.
CLARICE.	CLARICE.
Vn homme marié qui feroit comme vous, Attircroit du Cierfar fay coue lecournoux, Ne pouuant trop punir ſa perfidie extrême:	Un homme marié qui ferait comme vous, Atircroit du Cierfar fais coue lecournoux, Ne pouvant trop punir sa perfidie extrême:
CLIDAMANT.	CLIDAMANT.
Madame aſſeurement croyez que ie vous aime, Que ie n’auray iamais d’autre femme que vous.	Madame assurément croyez que votre vous aime, Que je n'aurai jamais d'autre femme que vous.
GVILLOT.	GUILOT.
Madame, par ma foy s’il eſtoit voſtre eſpoux, Deux ſemmes ſeurement, s’il ne tiroit ſes chauſſes, Le feroient bien toſt pendre, ou les lois ſeroient fauſſes.	Madame, par ma foi s'il était vôtre époux, Deux semmes sûrement, s'il ne tirait ses chausses, Le feraient bien tôt pendre, ou les lois seraient fausses.
CLIDAMANT.	CLIDAMANT.
Il nous le faut laiſſer parler tant qu’il voudra, Madame cependant qu’il ſe tourmentera, Vous pouuez de ma part accepter cette romme:	Il nous le faut laisser parler tant qu'il voudra, Madame cependant qu'il se tourmentera, Vous pouvez de ma part accepter cette romme:
CLARICE.	CLARICE.
bas le premier mot.	bas le premier mot.
Le traiſtre!	Le traître!
ie l’accepte,	Il l'accepte,
LISETTE.	LISETTE.
Ah, mon Dieu l’honneſte homme!	Ah, mon Dieu l'honnête homme!
F iiij	 Fijà
GVILLOT.	GUILOT.
Vous n’auez plus qu’à faire encore vn meſme tour, Pour vous faire nommer Monſeigneur d’argentcourt, Vous en vſez mon Maiſtre auec tant de franchiſe, Qu’elles vous pilleront iuſqu’à voſtre chemiſe.	Vous n'avez plus qu'à faire encore un même tour, Pour vous faire nommer Monseigneur d'argentcourt, Vous en usez mon Maître auec tant de franchise, Qu'elles vous pilleront jusqu'à votre chemise.
MCLEVE II.	MCLEVE II.
CAIDAMANES CUMROE MUNESSE LISETTE, BEATRIX, GVILLOT.	CAIDAMANES CUMROE MUNESSE LISETTE, BEATRIX, GUILLOT.
LVCRESSE.	LVCRESSE.
Omment déja Madame eſtre renduë icy?	Omment déjà Madame été rendue ici?
GVILLOT a ſon maiſtre.	GUILOT a son maître.
Vous n’eſtes pas tout ſeul d’amoureux, Dieumercy.	Vous n'êtes pas tout seul d'amoureux, Dieumerci.
Nous allons voir beau jeau ſi dame jalouſie, Se vient mettre vne fois dedans ſa fantaiſie.	Nous allons voir beau jeau si dame jalousie, Se vient mettre imaires dedans sa fantaisie.
CLIDAMANT Seroit ce bien icy quelqu’autre rendez-vous?	CLIDAMANT Serait ce bien ici quelqu'autre rendez-vous?
LVCRESSE.	LVCRESSE.
Cela pourrort oien entre, en eſtes vous jaloux?	Cela pourrort oyen entre, en êtes vous jaloux?
CLIDAMANT.	CLIDAMANT.
Il ſemble qu’en ce lieu vous vouliez me déplaire.	Il semble qu'en ce lieu vous vouliez me déplaire.
LVCRESSE.	LVCRESSE.
Peut eſtre?	Peut être?
que ſçait-on?	que sçait-on?
ce la ſe pourroit faire,	ce la se pourrait faire,
CLARICE.	CLARICE.
Ah!	Ah!
Meſſieurs, s’il vous plaiſt, patlez ſans paſſio n.	Messieurs, s'il vous plaît, patlez sans passio n.
LVCRESSE.	LVCRESSE.
Ie ſuis à tout momeut dedans l’occaſion, Et s’il ne tient icy qu’à le faire paroiſtre, Ie vous feray bien voir que i’y ſuis paſſé Maiſtre, Et que ie ne crains point des gens faits comme vous.	Je suis à tout momeut dedans l'occasion, Et s'il ne tient ici qu'à le faire paraître, Je vous ferai bien voir que j'y suis passé Maître, Et que je ne crains point des gens faits comme vous.
rrouy auon quelque fois fait le coup de deſſous, Et nous ſçauons pouſſer vne botte i'preſte, Qu’il n’eſt point d’homme à qui nous ne donnions le reſte.	rroui avon quelque fois fait le coup de dessous, Et nous savons pousser une botte j'preste, Qu'il n'est point d'homme à qui nous ne donnions le reste.
GVILLOT.	GUILOT.
Le vaillant champion!	Le vaillant champion!
ne dites rien Monlieur, Ce cher petit cadet pourroit faire malheur, On dit qu’vn petit homme a touſiours du courage.	ne dites rien Monlieur, Ce cher petit cadet pourrait faire malheur, On dit qu'un petit homme a toujours du courage.
LVCRESSE.	LVCRESSE.
Le cœur vous en dit-il?	Le cœur vous en dit-il?
déguesnons, i’en enrage,	déguesnons, j'en enrage,
CLIDAMANT.	CLIDAMANT.
Si nous n’eſtions deuant le plus beau des objets Ie vous nomercrom bien,.	Si nous n'étions devant le plus beau des objets Je vous nomercrom bien,.
.	.
GVILLOT.	GUILOT.
Monſieur, non occides.	Monsieur, non occcides.
CLARICE.	CLARICE.
Pour finir promptement voſtre deſordre extrême M’aimez-vous puiſſamment;	Pour finir promptement votre désordre extrême Maimez-vous puissamment;
CLIDAMANT.	CLIDAMANT.
Tre las.	Tre las.
ii ie vous aime?	ji ici vous aime?
Pouuez vous bien douter d’vne telle amitié?	Pouvez -vous bien douter d'une telle amitié?
CLARICE I'en doute auec raiſon, vous croyant marié.	CLARICE J'en doute avec raison, vous croyant marié.
CLIDAMANT.	CLIDAMANT.
Ie ne le fus iamais, ie vous iure Madame,	Je ne le fus jamais, ie votre jure Madame,
CLARICE oſtant ſon Loup.	CLARICE ôtant son Loup.
Qui ſuis-je donc Monſieur, ſuis ie pas voſtre femme?	Qui suis-je donc Monsieur, suis -je pas votre femme?
Vous ne me dites rien.	Vous ne me dites rien.
GVILLOT.	GUILOT.
Ah;	Ah;
qu’il eſt confondu!	qu'il est confondu!
Monſieur conſolez vous, rien ne ſera perdu Vous en auriez eſté dans vne autre rencontre, Pour voſtre Diamaut, voſtre argent & la montre.	Monsieur consolez vous, rien ne sera perdu Vous en auriez été dans quelque autre rencontre, Pour votre Diamaut, votre argent et la montre.
CLARICE.	CLARICE.
Là courtisez-moy donc, mon aimable galand, Quoy voſtre amour pour moy n’eſt-il plus violẽt?	Là courtisez-moi donc, mon aimable galant, Quoi votre amour pour moi n'est-il plus violont?
CLIDAMANT.	CLIDAMANT.
Ah!	Ah!
le ciel par deux fois l’ayant fait naiſtre extrême, Madame il eſt certain qu’il faut que ie vous aime, De que le ne ſcaurois iamais aimer que vous, Mais ie puis à mon tour paroiſtre vn peu ialoux.	le ciel par deux fois l'ayant fait naître extrême, Madame il est certain qu'il faut que ie vous aime, De que le ne saurais jamais aimer que vous, Mais je puis à mon tour paraître un peu jaloux.
Cét amant.	Cet amant.
2 CLARICE.	2 CLARICE.
Vout doit eſtre vn ſuiet d’allegreſſe Puis que ſous cét habit vous y voyez Lucreſſe, gurs citiced deguier pour rateraperron bien, Mais i’aperçois Clindor, paix- là, ue diſons rien.	Vout doit être un sujet d'allégresse Puis que sous cet habit vous y voyez Lucresse, gurs citiced déguyer pour rateraperron bien, Mais j'aperçois Clindor, paix- là, ue disons rien.
UUENE IX CLIDAMANT, CLINDOR, CLARICE, nutreſſe, Beatrix, Liſette, Guillot, Ragotin.	OUENE IX CLIDAMANT, CLINDOR, CLARICE, nutresse, Beatrix, Lisette, Guillot, Ragotin.
CLINDOR A RAGOTIN T bien coquin, dis-moy, ſçay tu quelques E nouuelles?	CLINDOR A RAGOTIN T bien coquin, dis-moi, sais tu quelques nouvelles?
Ne t’a t’on rien appris de mes pertes cruelles?	Ne t'a -t-on rien appris de mes pertes cruelles?
Ces extremes malheurs me rendent abbatu.	Ces extrêmes malheurs me rendent abattu.
RAGOTIN.	RAGOTIN.
Ouy dà Monleur, r'en Içay.	Oui dà Monleur, r'en Içai.
CLINDOR.	CLINDOR.
Quelles?	Quelles?
RAGOTIN.	RAGOTIN.
Tout eſt perdu.	Tout est perdu.
CLINDOR.	CLINDOR.
Tu mourras auiourd’huy de la main de ton maiſtre, Mais ſi ie ne me trompe enfin, ie vois paroiſtre Ce galand	Tu mourras aujourd'hui de la main de ton maître, Mais si tu ne me trompe enfin, quelque vois paroistre Ce galant
LVCRESSE.	LVCRESSE.
Suis-ie exact à me rendre en ce lieu:	Suis-je exact à me rendre en ce lieu:
RAGOIIN.	RAGOIN.
C’eſt cét homme Monſieur qui ne ſçait pas le ieu.	C'est cet homme Monsieur qui ne sait pas le jeu.
CLINDOR.	CLINDOR.
Ah, vous m’auez volé, vous perirés infame.	Ah, vous m'avez volé, vous périrez infâme.
GVILLOT.	GUILOT.
Monſieur ne tués pas s’il vous plaiſt voſtre lemme Il n'eit pas de beromiey de minmnoler.	Monsieur ne tuez pas s'il vous plaît votre lemme Il n'éit pas de beromie de minmnoler.
CLINDOR.	CLINDOR.
Quoy Madame, e cidtoue qui al uuez ſceu voler?	Quoy Madame, é crétoue qui al uez su voler?
GVILLOT.	GUILOT.
Puis que tous deux vos biens ſe trouuent en vos femmes, Pour elles il vous faut renouueller vos flâmes.	Puis que tous deux vos biens se trouvent en vos femmes, Pour elles il vous faut renouveler vos flammes.
Meſſieurs tous vos diſcours ſont icy ſuperflus, Mon maiſtre aimez chez vous, & vous ne jouez plus.	Messieurs tous vos discours sont ici superflus, Mon maître aimés chez vous, et vous ne jouez plus.
Donnez-nous cependant chacun noſtre maiſtreſſe.	Donnez-nous cependant chacun este maîtresse.
CLIDAMANT.	CLIDAMANT.
Oüy, nous vous les donnons.	Oui, nous vous les donnons.
RAGOTIN.	RAGOTIN.
Gaillardiſe.	Gaillardise.
GVILLOT.	GUILOT.
Allegreſſe.	Allegresse.
Meſſieurs quand vous irez en Caroſſe à cinq ſous Si l’on vous duppe, aumoins que ce ſoit comme nous.	Messieurs quand vous irez en Carosse à cinq sous Si l'on vous dupe, aumoins que ce soit comme nous.
FIN.	FIN.
