A MADAME LA DVCHESSE DE LORRAINE.	À MADAME LA DVCHESSE DE LORAINE.
Gi 138 1 A 419440 ADAME, 2 11 Apres qu’il c’eſt treuué des perſonnes mortes pour auoir cennu ſeulement leurs maladies, & quelques autres qui ſont tombées d’vn lieu eleué par la ſeule crainte qu'elles auoient de leur chutte;	Gi 138 1 A 419440 ADAME, 2 11 Apres qu'il c'est trouvé des personnes mortes pour avoir cennu seulement leurs maladies, et quelques autres qui sont tombées qu'un lieu élevé par la seule crainte qu'elles avaient de leur chute;
i'ai ſi peur de n’agreer pas à vο̂re ALTESSE, par l'offre que ie luy fais de cet ouurage, qu’il ſemble que l'effet ait des-ja ſuius mon apprehenſion.	j'ai si peur de n'agréer pas à vο̂re ALTESSE, par l'offre que ie ans fais de cet ouvrage, qu'il semble que l'effet ait déjà suivus mon appréhension.
Ie ſçai bien, Madame, que comme il y a des vices où la fuite eſt meilleure que la reſiſtance, on voit außi des vertus que le filence exprime plus maieſtueuſement que les paroles;	Je sais bien, Madame, que comme il y a des vices où la fuite est meilleure que la résistance, on voit aussi des vertus que le silence exprime plus maiestueusement que les paroles;
& la nature a fait ſortir de ſa main des beautez que toutes les bouches de la Renommée ne peuuent publier ſans corrompre quelque choſe de leur grace.	et la nature a fait sortir de sa main des beautés que toutes les bouches de la Renommée ne peuvent publier sans corrompre quelque chose de leur grâce.
Il eſt, Madame, des perfections de vôtre ALTESSE, comme des choſes ſainctes dont on ne doit approcher qu’auec vne crainte religieuſe;	Il est, Madame, des perfections de votre ALTESSE, comme des choses saintes dont on ne doit approcher qu'avec une crainte religieuse;
& s'en propoſer le recit, c’eſt vouloir chercher vne ocupation bien iuſte, mais qui demande vne longue vie, & vn eſprit außi grand & außi noble que ſon ſujet.	et s'en proposer le récit, c'est vouloir chercher une occupation bien juste, mais qui demande une longue vie, et un esprit aussi grand et aussi noble que son sujet.
L’illuſtre maiſon dont vous eſtes ſortie n’eſt pas la ſeule choſe qui vous rend recommandable, vos bontez font vne partie de cette eſtime, & iou tes ces qualitez qui laiſſent de la honte à vôtre ſexe, & de l’admiration au nôtre en font l’accompliſſement.	L'illustre maison dont vous êtes sortie n'est pas la seule chose qui vous rend recommandable, vos bontés font une partie de cette estime, et jou tes ces qualités qui laissent de la honte à votre sexe, et de l'admiration au nôtre en font l'accomplissement.
I'euſſe bien ſouhaitté de ne vous offrir pas ſi peu que ie vous offre, & ie crains que ce preſent qui eſt vne marque de mon indigence, en ſoit encore vne de ma temerité?	J'eusse bien souhaité de ne vous offrir pas si peu que je vous offre, et ie crains que ce présent qui est une marque de mon indigence, en soit encore une de ma témérité?
Mais i’ai forcé toutes ſortes de conſiderations, i’ai voulu eſtre temeraire;	Mais j'ai forcé toutes sortes de considérations, j'ai voulu être téméraire;
& i’ai crû que la honte eſtoit vn crime lors qu’elle nous empeſchoit d’aprocher de la vertu.	et j'ai cru que la honte était un crime lors qu'elle nous empêchait d'approcher de la vertu.
Il y a certains pechez pour leſquels Dieu & les hommes n'ont point fait de chaſtiment;	Il y a certains péchés pour lesquels Dieu et les hommes n'ont point fait de châtiment;
peuteſtre, Madame, que celuy que ie fais eſt de cette nature, & qu'en tout cas vous aurez aſſez de bonté pour me le pardonner quand vous ſçaurez que ma paßion eſt pluſtoſt aueugle que mon choix.	peutestre, Madame, que celui que je fais est de cette nature, et qu'en tout cas vous aurez assez de bonté pour me le pardonner quand vous saurez que ma passion est plutôt aveugle que mon choix.
Et ſi vn Empereur a dit autrefois, qu’aucun ne s’en deuoit retourner triſte apres auoir parlé à vn Prince:	Et si ici Empereur a dit autrefois, qu'aucun ne s'en devait retourner triste après avoir parlé à un Prince:
ie me tiens le plus glorieux Domme du monde d’auoir parlé à vne des vertueuſes Princeſſes de nôtre temps, & de luy auoir fait agréer les proteſtations que ie fais d’eſtre eternellement,	Elle me tiens le plus glorieux Domme du monde d'avoir parlé à une des vertueuses Princesses de notre temps, et de rendre avoir fait agréer les protestations que je fais d'être éternellement,
MADAME,	MADAME,
De ſon ALTESSE	De son ALTESSE
TARVIRROASMNOE.	TARVIROASMNOE.
OVIS par la grace de Dieu, Roy Lde France & de Nauarre.	OUÏS par la grâce de Dieu, Roi Lde France et de Navarre.
Anos amez & feaux Conſeillers les gens tenans nos Cours de Parlemens, Maiſtres des Requeſtes ordinaires de noſtre Hoſtel, Baillifs, Seneſchaux, Preuoſts, leurs Lieutenans, & à tous autres nos Iuſticiers & Officiers qu’il appartiendra, Salut.	Anos âmez et féaux Conseillers les gens tenants nos Cours de Parlements, Maîtres des Requêtes ordinaires de notre Hôtel, Baillifs, Sénéchaux, Preuosts, leurs Lieutenants, et à tous autres nos Iuticiers et Officiers qu'il appartiendra, Salut.
Noſtre cher & bien amé TOVSSAINCT QVINET, Marchand Libraire de noſtre bonne ville de Paris, nous a fait remonſtrer Tragicomedie intitulée, La Suitte & Le Mariage du Cid, ce qu’il ne peut faire ſans auoir ſur ce nos lettres, humblement nous requerant icelles.	Notre cher et bien amé TOUSSAINCT QUINET, Marchand Libraire de notre bonne ville de Paris, nous a fait remontrer Tragicomedie intitulée, La Suite et Le Mariage du Cid, ce qu'il ne peut faire sans avoir sur ce nos lettres, humblement nous requérant ici.
Aces cauſes, deſirant traitter fauorablemẽt ledit expoſant, nous luy auons permis & permettõs par ces preſentes de faire imprimer, vendre & debiter en tous les lieux de noſtre obeïſſance ledit liure, en telles marges, en tels caracteres, & autant de fois que bon luy ſemblera, durant l’eſpace de dix ans entiers & accomplis, à compter du iour qu’il ſera acheué d’imprimes pour la premiere fois.	Aces causes, désirant traiter favorablement ledit exposant, nous lui avons permis et permettons pour ces présentes de faire imprimer, vendre et débiter en tous les lieux de notre obéissance ledit livre, en telles marges, en tels caractères, et autant de fois que bon lui semblera, durant l'espace de dix ans entiers et accomplis, à compter du jour qu'il sera achevé d'imprimes pour la première fois.
Et faiſons tresexpreſſes deffences à toutes perſonnes de quelque qualité & condition qu’elles ſoient, de l’imprimer, faire imprimer, vendre ny debiter durant ledit temps, en aucun lieu de noſtre obeyſſance, ſans le conſentement de l’Expoſant, ſous pretexte d’augmentation, correction, changement de tiltre, fauſſes marques, ou autres:	Et faisons trèsexpresses défenses à toutes personnes de quelque qualité et condition qu'elles soient, de l'imprimer, faire imprimer, vendre ny débiter durant ledit temps, en aucun lieu de notre obéissance, sans le consentement de l'Exposant, sous prétexte d'augmentation, correction, changement de tiltre, fausses marques, ou autres:
en quelque ſorte & maniere que ce ſoit:	en quelque sorte et manière que ce soit:
A peine de trois mil liures d’amende, payables ſans deport:	À peine de trois mille livres d'amende, payables sans déport:
& nonobſtant oppoſitions ou appellations quelconques, par chacun des contreuenans:	et nonobstant oppositions ou appellations quelconques, par chacun des contrevenants:
applicable vn tiers à Nous, vn tiers, à l’Hoſtel-Dieu de noſtre bonne ville de Paris:	applicable un tiers à Nous, un tiers, à l'Hôtel-Dieu de notre bonne ville de Paris:
& l’autre tiers audit Expoſant:	et l'autre tiers audit Exposant:
confiſcation des exemplaires contrefaits, & de tous deſpens dommages & intereſts.	confiscation des exemplaires contrefaits, et de tous dépens dommages et intérêts.
A condition qu’il ſera mis deux exemplaires en blanc dudit liure en noſtre Bibliothecque publique, & vn en celle de noſtre trescher & feal, ledit ſieur SEGVIER, Cheualier, Chancelier de France, auãt que de les expoſer en vente, à peine de nullité des preſentes:	À condition qu'il sera mis deux exemplaires en blanc dudit livre en notre Bibliothecque publique, et un en celle de notre trêcher et féal, ledit sieur SÉGUIER, Chevalier, Chancelier de France, avant que de les exposer en vente, à peine de nullité des présentes:
du contenu de.	du contenu de.
quelles nous vous mandons que vous faſſiez iouïr & vſer plainement & païſiblement ledit Expoſant & tous ceux qui auront droict de luy, ſans qu’il Ieur ſoit donné aucun trouble ny empeſchement.	quelles nous vous mandons que vous fassiez jouir et user plainement et paysiblement ledit Exposant et tous ceux qui auront droit de Seigneur, sans qu'il Jeur soit donné aucun trouble ici empêchement.
Voulons auſſi qu’en mettant au commencement, ou à la fin dudit liure vn Extraict des preſentes, elles ſoient tenuës pour duëment ſignifiées:	Voulons aussi qu'en mettant au commencement, ou à la fin dudit livre un Extrait des présentes, elles soient tenues pour duement signifiées:
& que foy y ſoit adiouſtée, & aux copies collationnées par l’vn de nos amez & feaux Conſeillers & Secretaires, comme à l’original.	et que foi y soit ajoutée, et aux copies collationnées par l'un de nos âmez et féaux Conseillers et Secretaires, comme à l'original.
Mandons au premier noſtre Huiſſier ou Sergent ſur ce requis, de faire pour l’expedition des preſentes, tous exploits neceſſaires, ſans demander autre permiſſion:	Mandons au premier notre Huissier ou Sergent sur ce requis, de faire pour l'expédition des présentes, tous exploits nécessaires, sans demander autre permission:
CAR tel eſt noſtre plaiſir.	CAR tel est notre plaisir.
Nonobſtant Clameur de Haro, Chartre Normande, & autres Lettres a te conttanrcs.	Nonobstant Clameur de Haro, Chartre Normande, et autres Lettres a te contanrcs.
DONNE a Paris le dernier iour de Iuillet l’an de grace 1657.	DONNE a Paris le dernier jour de Juillet l'an de grâce 1657.
Et de noſtre regne le 28.	Et de notre règne le 28.
Par le ROY en ſon Conſeil.	Par le ROY en son Conseil.
DEMONCEAVX.	DEMONCEAUX.
Et ſeellé du grand ſceau de cire iaune.	Et seellé du grand sceau de cire jaune.
Acheué d’imprimet pour la premiere fols, le dernier Octobre 1637.	Achevé d'imprimet pour la première fols, le dernier Octobre 1637.
Les exemplaires ont eſté fournls.	Les exemplaires ont été fournls.
ARGVMENT DV PREMIER ACTE.	ARGUMENT DU PREMIER ACTE.
ODRIGVE obligé de partir pour combattre les Mores, dit adieu à Chimene & reſſent en ſon ame vne triſteſſe ſi grãde de ce depart, qu’il ne ſe conſole que dans l’eſperance qu’il a de la treuuer conſtante dans ſon amour, & de triompher de ſes ennemis.	ODRIGUE obligé de partir pour combattre les Mores, dit adieu à Chimène et ressent en son âme une tristesse si grande de ce départ, qu'il ne se console que dans l'espérance qu'il a de la trouver constante dans son amour, et de triompher de ses ennemis.
L’Infante qui par compléſance auoit autre fois donné Rodrigue à Chimene, ſe treuue reduitte à la neceſſité de faire voir ſon cœur à Leonor ſa gouuernante, & ne fait plus ſcrupule de luy declarer qu’elle brule pour Rodrigue;	L'Infante qui par complésance avait autre fois donné Rodrigue à Chimène, se trouve réduite à la nécessité de faire voir son cœur à Leonor sa gouvernante, et ne fait plus scrupule de lui déclarer qu'elle brule pour Rodrigue;
& que les conſiderations de ſa naiſsãce la touchẽt moins que ſa paſſion.	et que les considérations de sa naissance la touchent moins que sa passion.
Quelqu’effort que faſſe Leonor pour l’en diuertir, elle ſe promet tout à ſon aduantage:	Quelqu'effort que fasse Leonor pour l'en divertir, elle se promet tout à son avantage:
& demeure dans la reſolution de ne rien, eſpargner pour ſon repos:	et demeure dans la résolution de ne rien, épargner pour son repos:
Chimene apres le depart de Rodrigue combatuë des reſſentimens de l’honneur & de l’amour, ſe treuue eſtonnée, & ne ſçait encore ſi elle doit plus à la mort de ſon pere & à la pitié, qu’à la foy qu’elle auoit iurée à ſon Amant:	Chimène après le départ de Rodrigue combattue des ressentiments de l'honneur et de l'amour, se trouve étonnée, et ne sait encore si elle doit plus à la mort de son père et à la pitié, qu'à la foi qu'elle avait jurée à son Amant:
Neantmoins par quelques douces violences qu’elle ſe fait, elle ne peut oublier ce dernier, & conſent preſque par force à pourſuiure le premier deſſein qu’elle auoit pour luy.	Néanmoins par quelques douces violences qu'elle se fait, elle ne peut oublier ce dernier, et consent presque par force à suivre le premier dessein qu'elle avait pour lui.
ACTEVRS,   Ma RODRIGVE, amoureux de Enmenc.	ACTEURS, Ma RODRIGUE, amoureux de Enmenc.
CHIMENE.	CHIMENE.
D.	D.
VRRAQVE, Infante.	VRAQUE, Infante.
LEONOR, gouuernante & confidente de l’Infante.	LEONOR, gouvernante et confidente de l'Infante.
ELVIRE, Damoiſelle de Chimene.	ÉLVIRE, Damoiselle de Chimène.
D.	D.
TEXNAND, Roy de Caſtille.	TEXNAND, Roi de Castille.
DARTAS, Genti-homme de Caſtille.	DARTAS, Genti-homme de Castille.
D.	D.
DIEGVE, Pere de Rodrigue.	DIÉGUE, Père de Rodrigue.
D.	D.
SANCHE, amoureux de Chimene.	SANCHE, amoureux de Chimène.
D.	D.
ALONSE, Gentil-homme de Caſtille.	ALONSE, Gentilhomme de Castille.
LA SVITTE ET LE 2 MARIAGE CIE TRAGI-COMEDIE.	LA SVITTE ET LE 2 MARIAGE CIE -THAGI-COMÉDIE.
LACI 2 D.	LACY 2 D.
RODRIGVE, CHIMENE, L’INFANTE, LEONOR, ELVIRE.	RODRIGUE, CHIMENE, L'INFANTE, LEONOR, ÉLVIRE.
CENE D.	CÈNE D.
RODRIGVE, CHIMENE.	RODRIGUE, CHIMENE.
D.	D.
ROBRIGVE.	ROBRIGUE.
Viſque le Roy le veut il y faut conſentir, dIe n’y recule pas, Chimene il faut partir, 2 Lel Les Mores derechef tâchent de nous corubatre, Mais il faut employer ces mains à les abatre 2100 Be montrer, s’il ſe peut, que je ſuis genereux, Re prudent à l’égal que ie ſuis amoureux.	Visque le Roi le veut il y faut consentir, dIe n'y recule pas, Chimène il faut partir, 2 Lel Les Mores derechef tâchent de nous corubattre, Mais il faut employer ces mains à les abattre 2100 Bé montrer, s'il se peut, que je suis généreux, Re prudent à l'égal que je suis amoureux.
Il faut, ſuiuant l’ardeur que cét âge me donne, Deſſus leur ſepulture afſurer la couronne, Etoufer ſeur orgueil, rabatre leurs efforts, Et qu’vn ſeul bras de mer engloutiſſe leurs corps;	Il faut, suivant l'ardeur que cet âge me donne, Dessus leur sépulture assurer la couronne, Etoufer seur orgueil, rabatre leurs efforts, Et qu'un seul bras de mer engloutisse leurs corps;
C’eſt en vain, c’eſt en vain que le More s’aſſemble, Ou s’ils iont tous vnis, c'eit qu’ils mourront enſemble.	C'est en vain, c'est en vain que le More s'assemble, Ou s'ils jont tous unis, c'eit qu'ils mourront ensemble.
CHIMENE.	CHIMENE.
Ces Hydres, iuſtes Dieux, nous affligent toûjours, Leurs projets & mes maux ont preſque vn méme cours, D'vne teſte coupéet il en renait vne autre, Ils n’ont point de deſſein que pour finir le nôtre.	Ces Hydres, justes Dieux, nous affligent toujours, Leurs projets et mes maux ont presque un même cours, D'une tête coupéet il en renaît une autre, Ils n'ont point de dessein que pour finir le nôtre.
Ie ne ſçay quel demon fait naitre leur orgueil, Ils ne font plus de vœux que pour nôtre cercueil:	Je ne sais quel démon fait naître leur orgueil, Ils ne font plus de vœux que pour notre cercueil:
Auiourd’huy l’inſolence eſt iointe à leur courage, Leur generoſité va iuſques à la rage, Ils font mille projets, dont ils viennent à bout, Et ces deſeſperez font des armes de tout.	Aujourd'hui l'insolence est jointe à leur courage, Leur générosité va jusques à la rage, Ils font mille projets, dont ils viennent à bout, Et ces désespérez font des armes de tout.
D.	D.
RODRIGVE.	RODRIGUE.
Ne mettez point leur mort ny la mienne en balance, Iugez de leur foibleſſe & voyez ma vaillance;	Ne mettez point leur mort ni la mienne en balance, Jugez de leur faiblesse et voyez ma vaillance;
Ne craignez point pour moy, vos cris ſont ſuperflus, Eſperez ſeulement & ne vous plaignez plus.	Ne craignez point pour moi, vos cris sont superflus, Espérez seulement et ne vous plaignez plus.
CHHIMRNE.	CHIMRNE.
Quoy?	Quoi?
vous ne voulez pas qu’auiourd’huy ie me plaigne?	vous ne voulez pas qu'aujourd'hui notre me plaigne?
1 Ah Rodrigue!	1 Ah Rodrigue!
ſçachez qu’il faut bien que ie craigne, Que ie verſe des pleurs, puis que vôtre valeur Goinmongulie votre gionda cauſé mon mal-heur, Helas!	sçachez qu'il faut bien que sans craigne, Que je verse des pleurs, puis que votre valeur Goinmongulie votre gionda causé mon malheur, Hélas!
ſi dans l’abord ie fus ſi bien deceuë, N’ai- ie pas bien raiſon d’en ſoupgonner d'ifſuë?	si dans l'abord belle fus si bien déçue, N'ai- je pas bien raison d'en soupgonner d'issue?
Et ſici’ay ſoûpiré dans le commencement Que ne ferai-ie point dedans l'euenement?	Et sici'ai soupiré dans le commencement Que ne ferai-je point dedans l'événement?
O Ciel!	Ô Ciel!
ce point d’honneur reuient dans me memoire Combattant pour l’honneur vous eûtes la victoire;	ce point d'honneur revient dans me mémoire Combattant pour l'honneur vous eûtes la victoire;
Le méme point d’honneur mit mon pere au cercueil, Vous en eûtes la gloire & l’en porte le dueil.	Le même point d'honneur mit mon père au cercueil, Vous en eûtes la gloire et l'en porte le deuil.
D.	D.
RODRIGVE.	RODRIGUE.
Eſperez vn beau iour apres tant de tenebres, Vous quitterez bien-tôt tous ces habitsfunebres, Perdez le ſouuenir de ces refſentimens Ayez à mon ſujet de meilleurs mouuemens.	Espérez un beau jour après tant de ténèbres, Vous quitterez bientôt tous ces habitsfunebres, Perdez le souvenir de ces réfsentiments Ayez à mon sujet de meilleurs mouvements.
CHIMENE.	CHIMENE.
Helas l'y tâche aſſez!	Hélas l'y tâche assez!
mais en vain le l’eſſaye Vous ſçauez que le ſang ſort encor de ma playe, Que mille empéchemens combattent mon amour, Et qu’enfin le deuoir veut regner à ſon tour:	mais en vain le l'essaye Vous savez que le sang sort encor de ma plaie, Que mille empéchemens combattent mon amour, Et qu'enfin le devoir veut régner à son tour:
Mais Rodrigue, pour vous mon amour le ſurmonte, Et c’eſt pourquoy ce dueil me fait rougir de honte !	Mais Rodrigue, pour vous mon amour le surmonte, Et c'est pourquoi ce deuil me fait rougir de honte !
Auſſi	Aussi
D.	D.
RODRIGVE.	RODRIGUE.
Madame vn mot, ſongez à cette fois Quilfaut pour mon repte oubner mes ceploits, Voir les extremitez où mon ame eſt rangée, Ne vous eſtimer pas ingratte ny vangée.	Madame un mot, songez à cette fois Quilfaut pour mon répte oubner mes ceploits, Voir les extrémités où mon âme est rangée, Ne vous estimer pas ingrate était vengée.
2 Mais mé voir à vos pieds, & non pas au combat, Me traitter en amant & non pas en ſoldat.	2 Mais mé voir à vos pieds, et non pas au combat, Me traiter en amant et non pas en soldat.
CHIMENE.	CHIMENE.
71 Adieu Rodrigue adieu, mon pere m’épouuante Au moment que ie veux me dire ton amante:	71 Adieu Rodrigue adieu, mon père m'épouvante Au moment que deux veux me dire ton amante:
Ie ſors, ie n’en puis plus.	Je sors, Seigneur n'en puis plus.
elle s’en veut aller.	elle s'en veut aller.
D.	D.
RODRIGVE.	RODRIGUE.
Eſt ce là cét adieu?	Est -ce là cet adieu?
Vous changez de deſſein quand vous ehangez de lieu, Non, non, conſolez vous, que ces yeux pleins de flâ ne Malgré ces habits noirs qui vont troublant vôtre ame, Et malgré ce deuoir qui creuſe mon tombeau murene ou mois diipemez de repandre de l'ean.	Vous changez de dessein quand vous ehangez de lieu, Non, non, consolez -vous, que ces yeux pleins de fla ne Mme ces habits noirs qui vont troublant votre âme, Et malgré ce devoir qui creuse mon tombeau murène ou mois diipemez de répandre de l'ean.
13 CHIMENE.	13 CHIMENE.
Rodrigue voulez-vous que ie ſois inſenſible Dans vn mal aparent, ou plutôt ſi viſible?	Rodrigue voulez-vous que je sois insensible Dans un mal apparent, ou plutôt si visible?
Que parmy les dangers où preſide la mort Ie n’apprehende pas les caprices du ſort?	Que parmi les dangers où preside la mort Je n'appréhende pas les caprices du sort?
Ie voy mon pere mort, on ſurprend ma patrie, Cependant vôtre eſprit ne veut pas que ie cries Vous combatrez bien tôt pour defendre le Roy, Et vous ne voulez pas que ie craigne pour moy?	Je vois mon père mort, on surprend ma patrie, Cependant votre esprit ne veut pas que ici cries Vous combattrez bien tôt pour défendre le Roi, Et vous ne voulez pas que sans craigne pour moi?
Laiſſez-moy mediter ſur ce mal heur extróme, Cherchez vôtre ennemi qui vous craint & vous ale Vousſerez aſſuré d'en eſtre le tamqueer S’il ne refiſte pas plus long-temps que mon cœur.	Laissez-moi méditer sur ce mal heur extrême, Cherchez votre ennemi qui vous craint et vous ale Vousserez assuré d'en être le tamque S'il ne résiste pas plus longtemps que mon cœur.
D.	D.
RODR IGVE.	RODR IGUE.
elle ſort.	elle sort.
Vit-on jamais amant traitté de cette ſorte?	Vit-on jamais amant traité de cette sorte?
Dieuxll’amour me retlent lors que l’honneur m’em.	Dieuxllamour me retlent lors que l'honneur m'em.
porte, Le More doit bien voir ſon tourment adouci, Sentira t’il mon cœur ſi je le laiſſe ici?	porte, Le More doit bien voir son tourment adouci, Sentira t'il mon cœur si je le laisse ici?
Si mon cœur auiourd'huy fait ſa plus grande peine Chimene le retient, qu’il craigne donc Chimene.	Si mon cœur aujourd'hui fait sa plus grande peine Chimène le retient, qu'il craigne donc Chimène.
Mais tout preſſe Rodrigue;	Mais tout presse Rodrigue;
à quoy bon diſcourir?	à quoi bon discourir?
Medite les moyens de le faire mourir, Porte pour le punir tes effroyables armes, Va répandre à ſes pieds du ſang au lieu de larmes, Il t’a nommé ſon Cid pour marquer ton bon heur, Sois donc encor ſon Cid, puis que Cid eſt ſeigneur, De leurs corps entaſſez vafaire des montagnes, Fais rougir de leur ſang les plus proches cãpagnes, Qu'ils beniſſent viuans leur ſacrificateur, En vn mot qu’en mourans ils ayment leur vainqueur.	Medite les moyens de le faire mourir, Porte pour le punir tes effroyables armes, Va répandre à ses pieds du sang au lieu de larmes, Il t'a nommé son Cid pour marquer ton bon heur, Sois donc encor son Cid, puis que Cid est seigneur, De leurs corps entassés vafaire des montagnes, Fais rougir de leur sang les plus proches cãpagnes, Qu'ils bénissent vivants leur sacrificateur, En un mot qu'en mourants ils aiment leur vainqueur.
SCENE II.	SCÈNE II.
L’INFANTE, LEONOR.	L'INFANTE, LEONOR.
L'INFANTE.	L'INFANTE.
Eonor c’eſt en vain que ie me veux contraindre, QAutretois ie bruſlay, mais ie n’oſay me plaindre, Ou ſi ie ſoûpiray, c'eſt ſi ſecretement Qu’a peine a t’on connu mon aimable tourment, Pauois celé mon feu, mais l’excez de ma flame A paru dans mes yeux auſſi bien qu’en mon ame;	Eonor c'est en vain que sans me veux contraindre, QAutretais grande brûlai, mais quelque n'osai me plaindre, Ou si ie soûpiray, c'est si secrètement Qu'a peine a -t-on connu mon aimable tourment, Pavais celé mon feu, mais l'excès de ma flamme A paru dans mes yeux aussi bien qu'en mon âme;
Cent foisi’ay fait parêtre vnefeintefroideur Pour cacher finement ma veritable ardeur, Mais enfin le reſpect auec ſa tyrannie N’a point donné de borne à ma peine infinie, Non, non, l n’eſt plustemps de le diſſimuler, Ie crains, j’ayme, j’adore, & je me ſens brûler, Rodrigue,	Cent foisi'ai fait parêtre vnefeintefroideur Pour cacher finement ma véritable ardeur, Mais enfin le respect avec sa tyrannie N'a point donné de borne à ma peine infinie, Non, non, n'est plustemps de le dissimuler, Je crains, j'aime, j'adore, et je me sens brûler, Rodrigue,
LEONOR.	LEONOR.
C'eſt aſſez, la choſe eſt manifeſte, Et ce nom ſeulement mefait iuger du reſte:	C'est assez, la chose est manifeste, Et ce nom seulement méfait juger du reste:
Mais, à quoy ſongez-vous?	Mais, à quoi songez-vous?
penſez à vôtre rang.	pensez à votre rang.
L’INFANTE.	L'INFANTE.
Ne me propoſe point mon ſceptre ny mon ſang, Confirme les deſſeins que ſa vertu me donne.	Ne me propose point mon sceptre ici mon sang, Confirme les desseins que sa vertu me donne.
Ne me fais pas porter les yeux ſur la couronne, Donne moy pour me plaire vn meilleur entretien Cars’il ne la poſſede il la merite bien, Son bras ferme & fidelle a ſauué ſa patrie, Vn chacun le regarde auec idolatrie, Ie luy dois mon ſalut, & tu ne permets pas Que pour moi ſon merite ait de ſi doux apas.	Ne me fais pas porter les yeux sur la couronne, Donne moi pour me plaire un meilleur entretien Cars'il ne la possède il la mérite bien, Son bras ferme et fidèle a sauvé sa patrie, Un chacun le regarde mieux idolâtrie, Je su dois mon salut, et tu ne permets pas Que pour moi son mérite ait de si doux apas.
LEONOR.	LEONOR.
Ie l'aduouëil eſt vrays ſes vertus ont des charmes.	Je l'aduouëil est vrais ses vertus ont des charmes.
Mais vous ne deuez pas en répandre des larmes, Qu’il vous ait pour maiſtreſſe, & qu’il luy ſoit permis De triompher de vous comme des ennnemis, Qu’vn excez de bontéterniſſe vôtre gloire;	Mais vous ne devez pas en répandre des larmes, Qu'il vous ait pour maîtresse, et qu'il lui soit permis De triompher de vous comme des ennemis, Qu'un excès de bontéternisse votre gloire;
Qu’vn ſceptre ſoit le prix d’vne telle victoire;	Qu'un sceptre soit le prix d'une telle victoire;
Qu’il ſoit à l’auenir dans le nombre des Rois;	Qu'il soit à l'avenir dans le nombre des Rois;
Qu'éleuéſur vn thrône il vous faſſe des loix:	Qu'éleuésur un trône il vous fasse des lois:
Qu’il reuere les yeux de la fille du Comte;	Qu'il révère les yeux de la fille du Comte;
Quirlune lu loreune on lunane votie Monte;	Quirlune lu loreune on lunane votie Monte;
Madame, vn tel éclat dont il pourroit iouyr Le pourroit aueugler, ou du moins l’éblouyr.	Madame, un tel éclat dont il pourrait jouir Le pourrait aveugler, ou du moins l'éblouir.
L'INFANTE.	L'INFANTE.
Quand il aura fini l’entrepriſe du More, Ie l’aymeray ſans doute à l’égal qu’il m’honore, Ie veux le receuoir en mes bras triomphant.	Quand il aura fini l'entreprise du More, Je l'aimerai sans doute à l'égal qu'il m'honore, Je veux le recevoir en mes bras triomphant.
LEONOR.	LEONOR.
Ne croyez pas l’amour, puis que c’eſt vn enfant, Mais croyez Leonor, & s’il vous eſt poſſible Que ſes premiers exploits vous treuuent moins ſenſible, Si ce n’eſt que ſon cœur qui vous va deceuant, Vous pouuez l’eſtimer ſans aller plus auant, Donner à ſa valeur d’exceſſiues loüanges, Parler par fois de luy comme on parle des Anges:	Ne croyez pas l'amour, puis que c'est un enfant, Mais croyez Leonor, et s'il vous est possible Que ses premiers exploits vous trouvent moins sensible, Si ce n'est que son cœur qui vous va décevant, Vous pouvez l'estimer sans aller plus avant, Donner à sa valeur d'excessives louanges, Parler par fois de votre comme on parle des Anges:
Mais Madame apres tout eſt onforcé d’aymer, Ce qu’on eſt bien ſouuent obligé d’eſtimer?	Mais Madame après tout est onforcé d'aimer, Ce qu'on est bien souvent obligé d'estimer?
I'eſtime des bontez, dont ie hay les perſonnes, Et quelquefois des Rois, dont i’ayme les couronnes.	J'estime des bontés, dont ici ha les don, J' aime les Rois, dont j'aime les couronnes.
L'INFANTE.	L'INFANTE.
Lors que tu ſentiras vn feu comme le mien, Tu pourras reuerer vn cœur comme le ſien;	Lors que tu sentiras un feu comme le mien, Tu pourras révérer un cœur comme le sien;
Tu ne peux pas ſçauoir comme le ſort me braue, Tu parles comme libre, & ie parle en eſclaue;	Tu ne peux pas savoir comme le sort me brave, Tu parles comme libre, et toujours parle en esclave;
Ie ne diſpoſe plus de mes bons ſentimens, L’amour ſçait empêcher mes plus ſains mouvemens Neantmoins ie ſouſcris à mon deſauantage, Si i’ay de la raiſon ie n’en ay pas l’vſage;	Je ne dispose plus de mes bons sentiments, L'amour sait empêcher mes plus sains mouvements Néanmoins ie souscris à mon désavantage, Si j'ai de la raison ie n'en ai pas l'usage;
Mais quand bien ie l’aurois, ah ie ne voudrois pas Qu’ilm’empéchât d’aimerſes aimables apas.	Mais quand bien ie l'aurais, ah ie ne voudrais pas Qu'ilm'empêchât d'aimerses aimables appas.
Témoigne moins d’ardeur & moins de diligence:	Témoigne moins d'ardeur et moins de diligence:
Ie ſçai quetu n’es pas de mon intelligence;	Je sais quetu n'es pas de mon intelligence;
Que mon ſang, Leonor, le reſpect & l’honneur.	Que mon sang, Leonor, le respect et l'honneur.
Opoſent leurs conſeils au cours de mon bon heurz Que ie deſcends du rang dans lequel ie ſuis née, Et que ie me trahis par vn tel Hymenée.	Oposent leurs conseils au cours de mon bon heurz Que ici descends du rang dans lequel ie suis née, Et que personne me trahis par un tel Hyménée.
Mais ſeule ie me crois, ce deuoir m’eſt ſuſpect, Et mon amour l’emporte au deffus du reſpect.	Mais seule grande me crois, ce devoir m'est suspect, Et mon amour l'emporte au dessus du respect.
Ce n’eſt condition, ni titre qui m’irrite, S’il n’eſt Roi de naiſſance, il l’eſt bien de merite, Et s’il ne regne pas ayant tant combatu, C’eſt manque de bon-heur, & non pas de vertu.	Ce n'est condition, ni titre qui m'irrite, S'il n'est Roi de naissance, il l'est bien de mérite, Et s'il ne règne pas ayant tant combattu, C'est manque de bonheur, et non pas de vertu.
Au reſte s’en eſt fait, quoi que tu me conſeilles, Quelque iuſte raiſon quifrappe mes oreilles, Et quelque dure loi qu’on me puiſſe impoſer Pour lui plêre vne fois ie pourrai tout oſer.	Au reste s'en est fait, quoi que tu me conseilles, Quelque juste raison quifrappe mes oreilles, Et quelque dure lois qu'on me puisse imposer Pour lui plêre une fois était pourrai tout oser.
Mais pour des ennemis i’en ay beaucoup en teſte, Vn principalement empeſche ma conqueſte, Il me glace les ſens quand il doit m’échaufer.	Mais pour des ennemis j'en ai beaucoup en tête, Un principalement empêche ma conquête, Il me glace les sens quand il doit m'échauffer.
Il ne combat jamés, mais il ſçait triompher, Son viſage & ſon port me donnent de la pêneerbiene de les yeux;	Il ne combat jamés, mais il sait triompher, Son visage et son port me donnent de la pêneerbiene de les yeux;
en vn moc c’eit Chimenc.	en un mo c'éit Chimenc.
LEONOR.	LEONOR.
Puis que cette Chimene eſt tant à redouter Vous ferez voſtre bien en daignant m’écouter.	Puis que cette Chimène est tant à redouter Vous ferez votre bien en daignant m'écouter.
L'INFANTE.	L'INFANTE.
our en venir à bout, il faut vn peu d’amorce, ’adreſſe fera tout au defaut de la force.	our en venir à bout, il faut un peu d'amorce, adresse fera tout au défaut de la force.
l'ay beaueoup de morens ue my dumier dla loy, Puis que le deſéſpoir s’entend auecque moy:	l'ai beaueoup de morents ue mi dumier dla loi, Puis que le deséspoir s'entend auecque moi:
Les poiſons & le ſang, le fer, les precipites Me rendront à la fin toutes choſes propices:	Les poisons et le sang, le fer, les précipites Me rendront à la fin toutes choses propices:
Enfin l’inuention m’aportera ce bien, L’eſprit agit ſouuent, où la main ne peut rien.	Enfin l'invention m'apportera ce bien, L'esprit agit souvent, où la main ne peut rien.
LRONOR.	LRONOR.
Pardonnez ſi ie dis que vôtre ame eſt troublée.	Pardonnez si ici dis que votre âme est troublée.
L'INFANTE.	L'INFANTE.
Ma ſiêvre Leonor, eſt auſſi redoublée, Ce nom le plus ſouuent me fait fremir d’horreur, Et change en vn moment mon amour en fureur;	Ma siêvre Leonor, est aussi redoublée, Ce nom le plus souvent me fait frémir d'horreur, Et change en un moment mon amour en fureur;
Sers moy donc Leonor, & que ta conſidence Ne mette pas vn iour ma flâme en euidence;	Sers moi donc Leonor, et que ta considence Ne mette pas un jour ma flamme en évidence;
Si tu me veux ſeruir que ce ſoit ſans regret, Et tiens pour m’obliger ce myſtere ſecret:	Si tu me veux servir que ce soit sans regret, Et tiens pour m'obliger ce mystère secret:
Mais premier promets-moy de te monſtrer fidelle, liu ponie que uupreuuer vne flâme ſi belle, Ie net’oblige à rien, ſi tu me veux rauir Ta ſeule affection t’oblige à me ſeruir.	Mais premier promets-moi de te montrer fidèle, live ponie que upreuver une flamme si belle, Je n'oblige à rien, si tu me veux ravir Ta seule affection t'oblige à me servir.
Quoy.	Quoi.
LFONOR.	LONOR.
2	2
LINFANTE.	LINFANTE.
Ne propoſe rien, fais tout en aſſûrance, Et pour me donner tout, donne moy l’eſperance,	Ne propose rien, fais tout en assurance, Et pour me donner tout, donne moi l'espérance,
LEO NOR.	LEO NOR.
Ie n’y recule plus, le ſort en eſt ietté, Madame eſperez tout de ma fidelité.	Je n'y recule plus, le sort en est jeté, Madame espérez tout de ma fidélité.
L'INFANTE.	L'INFANTE.
Tu ſçauras mon deffein, tâche donc de leſuiure.	Tu sauras mon dessein, tâche donc de lèvre.
Tu peux bien mobliger me pouuant faire viuro.	Tu peux bien mobliger me pouvant faire vivro.
SCENE III.	SCÈNE III.
CAIMANB, RIVIRE.	CAIMANB, RIVIRE.
CHIMENE.	CHIMENE.
II.	II.
je bien du ſujet de me plaindre du ſort, A8 Dois je pas ſoûpirer au milieu de la mort?	je bien du sujet de me plaindre du sort, A8 Dois je pas soupirer au milieu de la mort?
L sluire tu me vois, & tu connois ma pelne, Les hommes ont iuré la perte de Chimene, Et les Dieux dans ce mal qui rend mes ſens confus, M’aimeront feulement quand je neſeray plus, I’eſpere en mon amant, mais l’ombre de mon pere En s’offrant à mes yeux ne veut pas que i'eſpere, Et preſentant ſonſang me ſemble reprocher Le crime que ie fais & que ie tiens ſi cher, De deux extremitez mon ame eſt combatuë, Cét amant mefait viure, & cette ombre me tue, Les cendres de mon pere éteignenttous mesfeux, Son ſang me fait rougir & condamne mes vœux, Rodrigue d’autre part metémoignantſa flâme Vient me reſuſciter & r’aſſurermon ame, Et me fait confeſſer dans ce douteux mal heur Que pechant de la ſorte il pecha par honneur, Que dedans nôtre Hymen tout nous ſera proſpere, Que ſes pleurs ont payétout le ſang de mon pere, Que ce mal heur preſent ne ſe peut ſoulager.	L mais tu me vois, et tu connais ma pelne, Les hommes ont juré la perte de Chimène, Et les Dieux dans ce mal qui rend mes sens confus, M'aimeront feulement quand je néserai plus, J'espère en mon amant, mais l'ombre de mon père En s'offrant à mes yeux ne veut pas que j'espère, Et présentant sonsang me semble reprocher Le crime que je fais et que mille tiens si cher, De deux extrémités mon âme est combat, Cét amant méfait ue, et cette ombre me tue, Les cendres de mon pere éteignenttous messeux, Son a me fait rougir et condamne mes vœux, Rodrigue autre part metémoignantsa flâme Vient me resusciter et assurermon âme, Et me fait ce dans ce douteux mal heur Que pechant de la sorte il pecha par honneur, Que dedans nôtre Hymen tout nous sera prospere, Que ses pleurs ont payétout le sang de mon pere, Que ce mal heur présent ne se peut soulager.
Ou qu'vi bien auenir m’en doit bien tot vangers Il a receu ma foi dans la même iournée Qu’on deuoir celebrer vir ii ianb Hymenée, Et que cét accident ſi triſte & ſi nouueau L’arrachant de mon lit mit mon pere au tombeau.	Ou qu' devi bien avenir m'en doit bien tôt vengers Il a reçu ma foi dans la même journée Qu'on devoir célébrer vir janb Hyménée, Et que cet accident si triste et si nouveau L'arrachant de mon lit mit mon père au tombeau.
ELVIRE.	ELVIRE.
C’eſt inutilement vous ofrir vn remede, Puisquon n’en treuue point au mal qui vous poſſede:	C'est inutilement vous offrir un remède, Puisqu 'en trouve point au mal qui vous possède:
Les conſeils les plus forts ſeroient hors de ſaiſon, Eſperez moins de moy que de vôtre raiſon, Vous avez témoigné quelque effort de conſtanceAlors que vôtre amour fit tant de reſiſtance, De quemle la deuon d rurdente altiela.	Les conseils les plus forts seraient hors de saison, Espérez moins de moi que de votre raison, Vous avez témoigné quelque effort de constanceAlors que votre amour fit tant de résistance, De quemle la dévon d urdente altela.
Vous manquâtes d’vn coup de flâme & de pitié.	Vous manquâtes d'un coup de flamme et de pitié.
CHIMENE.	CHIMENE.
Cette mort n’ût pas fait ma plus grande allegeance!	Cette mort n'ût pas fait ma plus grande allégeance!
I’ay ſouhaité ſa vie en cherchant ma vengeance, I’us peur de ſon trépas quand ie l’us medité:	J'ai souhaité sa vie en cherchant ma vengeance, J'us peur de son trépas quand ie l'us médité:
Il apercut ma haine & ma ſidelité, Ie mis pour quelque temps l’vne & l’autre en balance, Et quand elle a panché c’eſt à la vlolence.	Il aperçut ma haine et ma sidélité, Je mis pour quelque temps l'une et l'autre en balance, Et quand elle a penché c'est à la vlolence.
I’excuſay ſa valeur quand ie la condannay, Ie le retins pourtant quand le l’abandonnay, Voyant ſon eſperance & ſon ame abatuë, Ie voulu ieulement le bantr de ma veue;	J'excusai sa valeur quand je la condamnai, Je le retins pourtant quand le l'abandonnai, Voyant son espérance et son âme abattue, Je voulu ieulement le bantr de ma vue;
Mais mon cœur, quoy qu’il fut touché de ſon forfait, Ne pût pas s’empeſcher d’en garder le portrait	Mais mon cœur, quoi qu'il fut touché de son forfait, Ne put pas s'empêcher d'en garder le portrait
ELVIRE.	ELVIRE.
Sans doute que vos ſens ont perdu leur vſage, Banir l’original dont vous gardez l’image, Adorer la perſonne & deteſter le bras, Montrer de la douceur à qui n’en montra pas, Entreprendre ſa perte, & tout d’vn coup la craindre, C’eſt ce qui vous aflige & ce qui me fait plaindre.	Sans doute que vos sens ont perdu leur usage, Banir l'original dont vous gardez l'image, Adorer la personne et détester le bras, Montrer de la douceur à qui n'en montra pas, Entreprendre sa perte, et tout d'un coup la craindre, C'est ce qui vous aflige et ce qui me fait plaindre.
CHIMENE.	CHIMENE.
Tu rens par ce diſcours tous mes ſens interdits, Eluire iven ay fait bien plus que tu ne dis, Ie demanday ſa mort, i’y cherchay des obſtacles, Mais ce Dieu que ie ſers fait bien d’autres miracles, Ie formay ce deſſein, ie voulu l'étoufer, Et ie voulu combatré, & non pas triempher.	Tu rends par ce discours que mes sens interdits, Elvire iven ai fait bien plus que tu ne dis, Je demandai sa mort, j'y cherchai des obstacles, Mais ce Dieu que je sers fait bien d'autres miracles, Je formai ce dessein, elle voulu l'étouffer, Et ie voulu combatré, et non pas triempher.
Iuge par ce recie ſi ma douleur eſt vraye, Regarde ma premiere & ina derniere playe.	Juge par ce récie si ma douleur est vraie, Regarde ma première et ina dernière plaie.
ELVIRE.	ELVIRE.
Il eſt vray je vous plains, & cetre affection Eſt bien digne de blâme & de compamion :	Il est vrai je vous plains, et cetre affection Est bien digne de blâme et de compamion :
Ie ne puis ſans raiſon deſauouër ſon crime, Et ie n’oſe auouer vôtre amour legitime.	Je ne puis sans raison désavouer son crime, Et ici n'ose avouer votre amour légitime.
On ne peut condanner vôtre efet ny le ſien.	On ne peut condamner votre éfet ni le sien.
Puis qu’il ne fit pas mal, & que vous faites bien, Ne cherchant pas la mort il viuoit dans la honte Et pour vanger ſon pere il a tué le Comte, L’amour qui vous ioignoit parut dans vôtre ſein, Et l’honneur ſeulement inſpira ſon deſſein:	Puis qu'il ne fit pas mal, et que vous faites bien, Ne cherchant pas la mort il vivait dans la honte Et pour venger son père il a tué le Comte, L'amour qui vous joignait parut dans votre sein, Et l'honneur seulement inspira son dessein:
Si bien que balançant ſon droit auec le vôtre, chonneur fit pecher l’vn, l’amour fit pecher l’autre, Et dans le triſte état qu’on vous treuue auiourd’hul, Et l’amour & l’honneur cauſent tout vôtre ennui.	Si bien que balançant son droit avec le vôtre, chonneur fit pécher l'un, l'amour fit pécher l'autre, Et dans le triste état qu'on vous trouve aujourd'hul, Et l'amour et l'honneur causent tout votre ennui.
CHIMENE.	CHIMENE.
Du moins éforce toy de ſoulager Chimene, Puis qu’on ne treuue point de remede à ſa pêne:	Du moins éforce toi de soulager Chimène, Puis qu'on ne trouve point de remède à sa pêne:
Tache à me conſoler en me voyant perir, Et diminuë vn mal qu’on ne peut pas guerir:	Tache à me consoler en me voyant périr, Et diminue un mal qu'on ne peut pas guérir:
Ne te reſſouuiens plus de ce mal-heur funeſte, Puis qu’il m’eſt trop ſenſible, & qu’il t’eſt manifeſte Pour vn cruel tourment qu’on veut diſſimuler, Sçache que le meilleur eſt de n’en point parler, Mais tu confeſſeras que Rodrigue a des charmes, Contre qui la raiſon n’a pas de fortes armes, Qu’on ſe defend tres mal quand il attaque bien, Qu'õ ne voit point d’eſprit qui ſoit sẽblable au ſiẽ, Qu’il a des qualitez à tenter vn barbare, Que ſa fortune eſt belle, & ſa vertu tres-rare.	Ne te ressouviens plus de ce malheur funeste, Puis qu'il m'est trop sensible, et qu'il t'est manifeste Pour un cruel tourment qu'on veut dissimuler, Sache que le meilleur est de n'en point parler, Mais tu confesseras que Rodrigue a des charmes, Contre qui la raison n'a pas de fortes armes, Qu'on se défend très mal quand il attaque bien, Qu'on ne voit point d'esprit qui soit semblable au si, Enteil a des qualités à tenter un barbare, Et sa fortune est belle, et sa vertu très -rare.
ELVIRE.	ELVIRE.
Ouy cette verité ſe doit bien auouër, Mais vous en pouuez bien parler ſans le louër A la Cour, en Caſtille, ou bien dedans l’armée;	Oui cette vérité se doit bien avouer, Mais vous en pouvez bien parler sans le louer A la Cour, en Castille, ou bien dedans l'armée;
Laifſez en ſeulement parler la renommée, Aimez le s’il ſe peut tout autant que les Dieux, Mais en le loüant moins vousferez vn peu mieux, Ne ſoyez pas d’abord ſi facile à vous rendre, Cachez pour quelque temps vôtre feu ſous la cẽdre.	Laifsez en seulement parler la renommée, Aimez le s'il se peut tout autant que les Dieux, Mais en le louant moins vousférez un peu mieux, Ne soyez pas d'abord si facile à vous rendre, Cachez pour quelque temps votre feu sous la cẽdre.
Et le temps expiré l’excez de cette amour;	Et le temps expiré l'excès de cette amour;
Qui gene votre elprit peut éclatter au iour.	Qui gène votre élprit peut éclater au jour.
CHIMENE.	CHIMENE.
Elulre ſe peut il que mon cœur diſſimule?	Elulre se peut -il que mon cœur dissimule?
Qu’on me treuue de glace au moment que iebrûle?	Qu'on me trouve de glace au moment que iebrûle?
Que i’augmente par là tant detourmens ſoufert?	Que j'augmente par là tant détourments souffert?
Et qu’on me penſelibre au milieu de mesfers?	Et qu'on me penselibre au milieu de mesfers?
Allons;	Allons;
dedans l’état mal-heureux où nous ſommes Ie crains les Dieux pour moi, pour Rodrigue les hommes.	dedans l'état malheureux où nous sommes Je crains les Dieux pour moi, pour Rodrigue les hommes.
Verrois jebien perir preſque dans vn moment, Mon païs, mon honneur, mon pere, & mon amant!	Verrais -je périr presque dans un moment, Mon pays, mon honneur, mon père, et mon amant!
Fin du premier Acte.	Fin du premier Acte.
ARGVMENT DVJRCOIVMMOIH	ARGUMENT DVJRCOIVMMOIH
DMQRIAS par la priere de Rodrigue.	DMQRIAS par la prière de Rodrigue.
QN& par la neceſſité, eſt contraint d’aller aduertir Dom Fernand, du malheur où les Mores les ont reduits;	QNet par la nécessité, est contraint d'aller avertir Dom Fernand, du malheur où les Mores les ont réduits;
& luy dit que ſans ſon aſſiſtance il eſt bien malaiſé d’esperer quelque choſe à ſon auantage.	et ainsi dit que sans son assistance il est bien malaisé d'espérer quelque chose à son avantage.
D.	D.
Fernand croyant deſ-ja tout perdu, renuoye vn renfort;	Fernand croyant déjà tout perdu, renvoie un renfort;
& ſe conſole dans l’esperance que luy donne D.	et se console dans l'espérance que lui donne D.
Diegue de la fidelité, & de la valeur de Rodrigue.	Diègue de la fidélité, et de la valeur de Rodrigue.
Comme cette nouuelle fut bien-tôt épanduë, l’Infante ſe ſeruit de l’occaſion, & pria Leonor de perſuader à Chimene la mort de Rodrigue, croyant par cette feinte la porter au deſespoir, & s’imaginant que ſon deſſein reüſſiroit par ce moyẽ dans le premier qu’elle auoit fait de poſſeder Rodrigue.	Comme cette nouvelle fut bientôt épandue, l'Infante se servit de l'occasion, et pria Leonor de persuader à Chimène la mort de Rodrigue, croyant par cette feinte la porter au désespoir, et s'imaginant que son dessein reüssiroit par ce moyẽ dans le premier qu'elle avait fait de posséder Rodrigue.
D.	D.
Sanche cependant amoureux de Chimene, non contant d’auoir épreuué la courteſie de Rodrigue, fait de nouueaux projets pour cette beauté, & malgré le deuoir & toutes les ciuilitez que luy defendoit cette amour, ſe propoſe de l’aymer encore.	Sanche cependant amoureux de Chimène, non contant d'avoir épreuué la courtesie de Rodrigue, fait de nouveaux projets pour cette beauté, et malgré le devoir et toutes les civilités que lui défendait cette amour, se propose de l'aimer encore.
Chimene tremble à la veüe de Leonor, pâme à la nouuelle de la mort de Rodrigue, & cherche tous les moyens de mourir eſtant ſeule, n’eſtimant pas honneſtede ſuruiure à la perte de ſon pere & de ſon amant.	Chimène tremble à la vue de Leonor, pâme à la nouvelle de la mort de Rodrigue, et cherche tous les moyens de mourir étant seule, n'estimant pas honnête survivre à la perte de son père et de son amant.
AICIDII.	ÀICIDII.
LE ROY, D.	LE ROY, D.
ARIAS, D.	ARIAS, D.
DIEGVE, 3 L’INFANTE, LEONOR, D.	DIEGUE, 3 L'INFANTE, LEONOR, D.
SANCHE, CHIMENE, BLVIRE.	SANCHE, CHIMENE, BLVIRE.
SCENE I.	SCÈNE I.
D.	D.
ARTAS, LE ROY, D.	ARTAS, LE ROY, D.
DIEGVE.	DIEGUE.
D.	D.
ARIAS.	ARIAS.
L eſt vrai que nos gens n'ont pas eu l'auantage.	L est vrai que nos gens n'ont pas eu l'avantage.
Qle Nous auons tout perdu, ſi ce n’eſt le courage Mais puis que le paſſé ne peut pas reuenir, Que vôtre Majeſté donne ordre à l’aduenir.	Quelle Nous avons tout perdu, si ce n'est le courage Mais puis que le passé ne peut pas revenir, Que votre Majesté donne ordre à l'avenir.
LE ROY.	LE ROY.
Comment donc.	Comment donc.
Arias,la betamt eit peruue?	Arias,la betamt eit pervue?
Nous faiſons maintenant des deſſeins dans la nuë, Les aſtres aujourd'hui nous ſont injurieux, Et tout nôtre ſecours ne dépend que des Dieux;	Nous faisons maintenant des desseins dans la nue, Les astres aujourd'hui nous sont injurieux, Et tout notre secours ne dépend que des Dieux;
Qu’à d’étranges mal heurs la fortune me ranB Que i'épreuue aujourd’hui ſon caprice & ſon change!	Qu'à d'étranges mal heurs la fortune me ranB Que j'épreuve aujourd'hui son caprice et son change!
Et que les plas grands Rois comparez aux bergers Epreuuent d'accidens, & courent de dangers!	Et que les plas grands Rois comparés aux bergers Épreuent d'accidents, et courent de dangers!
Qu’vn ſceptre eſt odieux à qui le ſçait connétre, Et que qui n’eſt point Roy doit bien craindre de l’être!	Qu'un sceptre est odieux à qui le sait connaître, Et que qui n'est point Roi doit bien craindre de l'être!
Le thrône où mes ſujets m’ont veu ſouuent monté, A parler ſainement n’eſt qu’vne vanité;	Le trône où mes sujets m'ont vu souvent monté, À parler sainement n'est qu'une vanité;
Les couronnes, l’honneur, les chreſors, les Prouinces.	Les couronnes, l'honneur, les chresors, les Provinces.
Les triomphes, la gloire & l'ornement des Princes;	Les triomphes, la gloire et l'ornement des Princes;
En vn mot ce qui peut leur donner des ialoux.	En un mot ce qui peut leur donner des jaloux.
N’eſt rien qu’vn faux éclat qui les aueugle tous;	N'est rien qu'un faux éclat qui les aveugle tous;
Les Rois ſont haut montez, & c’eſt par là poſſible, Si peu qu’ils puiſſent choir, que leur chutre eſt horrible, Et tù vois cependant qu’ils ont mille trauaux, Et pour de faux pléſirs de veritables maux, Que ceux la iont neureux qui le peauent connétre !	Les Rois sont haut montez, et c'est par là possible, Si peu qu'ils puissent choir, que leur chaître est horrible, Et tù vois cependant qu'ils ont mille travaux, Et pour de faux plésirs de véritables maux, Que ceux la jont neureux qui le peauent connaître !
Mais cent fois plus heureux ceux cui n’ont point eu l’être.	Mais cent fois plus heureux ceux cuy n'ont point eu l'être.
D.	D.
ARIAS.	ARIAS.
C’eſt en vain que ie fais des efors pour parler, Dans vn ſi grand mal heur peut-on vous conſo1012 Vous pouuez témoigner qu’autrefois i’us des ter mes, Dont le poids a rendu des eſprits afſezfermes:	C'est en vain que Dieu fais des éfors pour parler, Dans un si grand mal heur peut-on vous consoût12 Vous pouvez témoigner qu'autrefois j'us des ter mes, Dont le poids a rendu des esprits afsezfermes:
Mais dans le triſte état où nous reduit le ſort, Ie ne me reſous plus moi méme qu’à la mort.	Mais dans le triste état où nous réduit le sort, Je ne me résous plus moi -même qu'à la mort.
LE ROY.	LE ROY.
L'vſage dés long temps m’a fait aſſez parêtre, Qu’il faut du moins finir, qu’on ne peut toûjours être, Et qu'enfin nôtre eſprit, quoi qu’il ſoit retenu, Doit retourner au lieu duquel il eſt venu, Il ſe faut conſoler:	L'usage dès long temps m'a fait assez paraître, Qu'il faut du moins finir, qu'on ne peut toujours être, Et qu'enfin nôtre esprit, quoi qu'il soit retenu, Doit retourner au lieu duquel il est venu, Il se faut consoler:
ce qui fut Alexandre, N’eſt pas même auiourd’huy ſeulement de la cendre.	ce qui fut Alexandre, N'est pas même aujourd'hui seulement de la cendre.
Les plus ſimples ſujets & les Rois pleins d’orgueil Entrent également dans vn commun cercueil, La terre eſt leur ſepulchre auſſi bien que leur mere, C’eſt là que nous deuons finir nôtre miſere, Et que tant de mal heurs auec tous leurs efors, Seront enſeuelis auſſi bien que nos corps.	Les plus simples sujets et les Rois pleins d'orgueil Entrent également dans un commun cercueil, La terre est leur sépulcre aussi bien que leur mère, C'est là que nous devons finir notre misère, Et que tant de mal heurs avec tous leurs eût, Seront ensevelis aussi bien que nos corps.
Ma raiſon cede icy, la fureur me ſurmonte:	Ma raison cède ici, la fureur me surmonte:
Ie ne crains pas la mort, ie ne crains que ma honte, Et i’ay peur ſeulement que la poſterité Sçache mon infortune, & ma captiuité.	Je ne crains pas la mort, ie ne crains que ma honte, Et j'ai peur seulement que la postérité Sache mon infortune, et ma captivité.
Ce n’eſt pas le premier qui s’eſt veu miſerable, D’autres ont rencontré le ſort moins fauorable, Et les plus ignorants dans l'hiſtoire des Rois En ont treuué reduits à ces derniers abois.	Ce n'est pas le premier qui s'est vu misérable, D'autres ont rencontré le sort moins favorable, Et les plus ignorants dans l'histoire des Rois En ont trouvé réduits à ces derniers abois.
La fortune conduit diuerſement ſa rouë, Nous y ſommes cloüez, c’eſt de nous qu’elle jouë:	La fortune conduit diversement sa roue, Nous y sommes clumez, c'est de nous qu'elle joue:
Iuſtes Dieux!	Justes Dieux!
Dom Fernandſeroit ilbien ſoumis A receuoir la loy de tous ſes ennemis?	Dom Fernandserait -ilbien soumis A recevoir la loi de tous ses ennemis?
Preſque dans vn moment ma gloire eſt étoufée, Le More ſur ma perte éleue ſon trophée, Mon tombeau luy doit eſtre vn degré pour monter Dans le thrône qu’il veut, & qu’il luy faut quitcer.	Presque dans un moment ma gloire est étouffée, Le More sur ma perte élève son trophée, Mon tombeau a doit été degré pour monter Dans le trône qu'il veut, et qu'il lui faut quitcer.
Que ie me ſens confus dans l'état où nous ſommes, Qui deurois je accuſer, ou des Dieux, ou des hommes ?	Que ie me sens confus dans l'état où nous sommes, Qui devrais je accuser, ou des Dieux, ou des hommes ?
Mais qu’a donc fait Rodrigue.	Mais qu'a donc fait Rodrigue.
D.	D.
ARIAS.	ARIAS.
Apres beaucoup d’éfors, Ayant conſideré le nombre de ſes morts, Il prit ceux qui reſtoient, & ſa rare vaillance Mit dans tous les eſprits la victoire en balance, Mais nous eſtions ſi peu que chacun fut contraint D’éuiter le danger qu’il auoit deſ-ja craint.	Après beaucoup d'éfors, Ayant considéré le nombre de ses morts, Il prit ceux qui restaient, et sa rare vaillance Mit dans tous les esprits la victoire en balance, Mais nous étions si peu que chacun fut contraint D'éviter le danger qu'il avait déjà craint.
Rodrigue toutesfois ne palit pas encore, Tout impuiſſant qu’il eſt, il fait craindre le More, Et ſi toſt qu’il aura quelque petit renfort, Al dit qu’il en attend la victoire, ou la mort.	Rodrigue toutefois ne palit pas encore, Tout impuissant qu'il est, il fait craindre le More, Et si tôt qu'il aura quelque petit renfort, Al dit qu'il en attend la victoire, ou la mort.
LE ROY.	LE ROY.
Ouy, pour noſtre ſalut contentons ſon enule, Ie lui deuraibeaucoup ſi je lui dois la vie, Il n’a pas étoufé ſa premiere vertu, Que na t’il point tenté pour mon ſceptre abatu!	Oui, pour notre salut contentons son envle, Je lui devraibeaucoup si je lui dois la vie, Il n'a pas étouffé sa première vertu, Que na 'il point tenté pour mon sceptre abattu!
N'a-t’il pas releué l’éclat de ma couronne, At quand ray de reſpoir c'ex lur ieul qui m’en donne,	N'a-t-il pas relevé l'éclat de ma couronne, At quand ray de respoir c'ex lur jeul qui m'en donne,
D.	D.
DIBGVE.	DIBGUE.
SIRE, je ſuis certain que voſtre Majeſté Pourra treuuer ſon bien dans ſa fidelité:	SIRE, je suis certain que votre Majesté Pourra trouver son bien dans sa fidélité:
Il herita de moi ce puiſſant auantage, Le Ciel en le formant lui donna mon courage.	Il hérita de moi ce puissant avantage, Le Ciel en le formant lui donna mon courage.
Et pour le rendre digne & des Dieux & du Roy, Il falloit qu’il fut fils d’vn tel pere que moi;	Et pour le rendre digne et des Dieux et du Roi, Il fallait qu'il fut fils d'un tel père que moi;
Combien ai je pour vous remporté de victoires, Combien ai je groſſi de volumes d’hiſtoires?	Combien ai je pour vous remporté de victoires, Combien ai je grossi de volumes d'histoires?
Et lors que ma puiſſance a ſuiui ma valeur, Combien de fois braué la mort & le mal heur, Afronter les deſtins, & deſſous les murailles Pour le ſalut commun chercher mes funerailles, Parêtre tout ſanglant au milieu du combat.	Et lors que ma puissance a suivi ma valeur, Combien de fois bravé la mort et le mal heur, Afronter les destins, et dessous les murailles Pour le salut commun chercher mes funérailles, Paraître tout sanglant au milieu du combat.
Combatre dans le choc comme vn autre ſoldat, Soufrir la faim, la ſoif, la fatigue & les veilles, Tenter pour cét état de plus grandes merueilles, Ie n’en parlerois pas, mais vous pouuez ſçauoir Que c’eſt ce que i’ay fait quand i’en eus le pouuoir, Maintenant par mal heur la vigueur me delaiſſe, Ie n'ai preſque plus rien n’ayant plus de ieuneſfe, Sinon vn peu deſang, mais de telle façon, Que tout ce que i’en ai n’eſt plus rien qu’vn glaçon;	Combatre dans le choc comme un autre soldat, Sourir la faim, la soif, la fatigue et les veilles, Tenter pour cet état de plus grandes merveilles, Je n'en parlerais pas, mais vous pouvez savoir Que c'est ce que j'ai fait quand j'en eus le pouvoir, Maintenant par mal heur la vigueur me délaisse, Je n'ai presque plus rien n'ayant plus de jeunesse, Sinon un peu désang, mais de telle façon, Que tout ce que j'en ai n'est plus rien qu'un glaçon;
Mais mon fils maintenant ne peut moins entreprendre, Comme vn nouueau Phœnix il renaiſt de ma cendre, Conneſſant ma foibleſſe, il me vient releuer, Il pourſuit vn chemin, ie ne pû l’acheuer, car cét âge me rend & ſi ſoible, & ſi ſombre, Que ie ne ſuis qu’vn corps, dont la mort ſe dit l'omble.	Mais mon fils maintenant ne peut moins entreprendre, Comme un nouveau Phœnix il renaît de ma cendre, Connaissant ma faiblesse, il me vient relever, Il poursuit un chemin, ie ne pû l'achever, car cet âge me rend et si soible, et si sombre, Que ils ne suis qu'un corps, dont la mort se dit l'omble.
LE ROY.	LE ROY.
Dom Diegue ie ſçai bien le nombre de vos faits, Vôtre âge ne rend pas vos exploirs imparfaits, La Caſtille les ſçait, & moi ie les publie A tous ceux de ma Cour de peur qu’on les oublie:	Dom Diègue ie sais bien le nombre de vos faits, Votre âge ne rend pas vos exploirs imparfaits, La Castille les sait, et moi que les publie A tous ceux de ma Cour de peur qu'on les oublie:
Et Rodrigue ſurtout les fait bien retenir A ceux qui n’ont pas droit de s'en reſſouuenir.	Et Rodrigue surtout les fait bien retenir À ceux qui n'ont pas droit de s'en ressouvenir.
Mais donnons le ſecours à qui nous en demande, Et s’il en ſçait vſer ſa fortune eſt trop grande:	Mais donnons le secours à qui nous en demande, Et s'il en sait user sa fortune est trop grande:
Faiſons viſte ſa gloire en faiſant nôtre bien, Qu’il mette en ſeureté ſon ſalut & le mien, Que n’ai je, juſtes Dieux, cette force premiere, Le More me craindroit, il perdroit la lumière, Et ie ſerois certain d’ẽ eſtre le vainqueur, Si mes bras eſtoientgrands à l’égalde mon cœur.	Faisons vite sa gloire en faisant notre bien, Qu'il mette en sûreté son salut et le mien, Que n'ai je, justes Dieux, cette force première, Le More me craindrait, il perdrait la lumière, Et grands serais certain d'en être le vainqueur, Si mes bras estoientgrands à l'égalde mon cœur.
D.	D.
DIRGVE.	DIRGUE.
Il eſt vrai nous auons quelque ſujet de crainte, Mais non pas iuſque au point d’en former vne plainte, On cherche nos mal heurs, vous eſtes combatu, Mais la proſperité n’eſt pas vne vertu:	Il est vrai nous avons quelque sujet de crainte, Mais non pas jusque au point d'en former une plainte, On cherche nos mal heurs, vous êtes combattu, Mais la prospérité n'est pas une vertu:
Vous pouuez aquerir ce qu’aquit Alexandre, Et vous pouuez monter quand on vous fait deſcendre.	Vous pouvez aquérir ce qu'aquit Alexandre, Et vous pépé monter quand on vous fait descendre.
LE ROY.	LE ROY.
Conſidere pourtant comme le ſort agie, Nous perdons tant de ſang que la terre en rougie.	Considère pourtant comme le sort agie, Nous perdons tant de sang que la terre en rougie.
La crainte de la mort rend mes ſuiets timides.	La crainte de la mort rend mes sujets timides.
Et tous mes ennemis ſons autant d’homieides.	Et tous mes ennemis sons autant d'homieides.
D.	D.
DIBGVE.	DIBGUE.
Vne ſemblable gloire a pour vous des apas, Mais les aduerſitez ne vous afligent pas, Vn grand Roy comme vous que le ſort importune Ne change point de cœur en changeant de fortune Aujourd’hui vôtre état n’eſt pas ſi florifſant, 1 Mais pour le bien remettre eſtes-vous impuiffant, !	Une semblable gloire a pour vous des apas, Mais les adversité ne vous afligent pas, Un grand Roi comme vous que le sort importune Ne change point de cœur en changeant de fortune Aujourd'hui votre état n'est pas si florissant, 1 Mais pour le bien remettre êtes-vous impuissant, !
Non, Rodrigue écendra par la fin de la guerre Ce Roiaume & ſa gloire aux deux bouts de la terre, Songez qu’il vit encore.	Non, Rodrigue écendra par la fin de la guerre Ce Roiaume et sa gloire aux deux bouts de la terre, Songez qu'il vit encore.
LE oY.	LE oY.
A ce nom ſeulement Ie me tiens affuré, ie banis mon tourment, Ne differons dons plus à lui donner de l’aide, Rodrigue de mes maux eſt le dernier remede.	À ce nom seulement Je me tiens assuré, on banis mon tourment, Ne différons dons plus à lui donner de l'aide, Rodrigue de mes maux est le dernier remède.
SCENE II.	SCÈNE II.
L'INFANTE, LEONOR,	L'INFANTE, LEONOR,
18 L’INFANTE.	18 L'INFANTE.
Ecy nous doit ſeruir dans ce puiſſant malheur, a Soulageons s’il ſe peut vne extréme douleur, N’ayant point de ſujet pour accuſer Chimene, Ne pouuant iuſtement l’immoler à ma haine, Et ne rencontrant rien qui ne me ſoit ſuſpect, En ce cas le poiſon fera moins qu’vn regret.	Eci nous doit servir dans ce puissant malheur, à Soulageons s'il se peut une extrême douleur, N'ayant point de sujet pour accuser Chimène, Ne pouvant justement l'immoler à ma haine, Et ne rencontrant rien qui ne me soit suspect, En ce cas le poison fera moins qu'un regret.
Prenons l’occaſion, & luy faiſons acroire Que Rodrigue a perdu la moitié de ſa gloire, Qu’elle n’a pas raiſon d’eſperer ſon retour, Qu’on l’a pris, en vn mot qu’il a perdu le iour, Lors ſes ſens agiront, mais d’vne telle ſorte Que le tenant pour mort, le la croy des-ja morte:	Prenons l'occasion, et ainsi faisons acroire Que Rodrigue à perdu la moitié de sa gloire, Qu'elle n'a pas raison d'espérer son retour, Qu'on l'a pris, en un mot qu'il a perdu le jour, Lors ses sens agiront, mais d'une telle sorte Que le tenant pour mort, le la crois déjà morte:
Tu n’en peux pas douter, l’aymant parfaitement, Cecy la portera dedans le monument.	Tu n'en peux pas douter, l'aimant parfaitement, Cec la portera dedans le monument.
Iuge par ſon humeur, & voy par l'apparence Que la mort auſſi-toſt fera ſon eſperance, Et que le deſeſpoir pour en venir à bour Dans cette extremité luy preſentera tout.	Juge par son humeur, et vois par l'apparence Que la mort aussitôt fera son espérance, Et que le désespoir pour en venir à bour Dans cette extrémité lui présentera tout.
Avidla el fis Econoes na lols pas fihiacley Exerce ton eſprit portant cette nouuelle, Ne la conſole pas, bien loing de la guerir, Inuente mille mots qui la faſſent mourir:	Avidla el fis Econoes na lols pas fiacley Exerce ton esprit portant cette nouvelle, Ne la console pas, bien loin de la guérir, Invente mille mots qui la fassent mourir:
Feins ſelon mon deffein, rends ſon ame abaruë, Et raconte luy tout d’vn accent qui la tuë.	Feins selon mon dessein, rends son âme abarue, Et raconte lui tout d'Homme accent qui la tue.
LEONOR.	LEONOR.
elle ſort.	elle sort.
I'y vais, puls qu’il vous plaiſt, ie ſçauray mênager Vne femblable feinte afin de vous vanger.	J'y vais, puls qu'il vous plaît, Elle saurai mênager semblable feinte afin de vous vanger.
L’INFANTE.	L'INFANTE.
Son Amant qui brûloit ſe treuuera de glace.	Son Amant qui brûlait se trouvera de glace.
La voyant ſans beauté, ſans couleur & ſans grace, Dans le reffouuenir de leur ferme amitié, Il ſera ſans amour, mais non pas ſans pitié:	La voyant sans beauté, sans couleur et sans grâce, Dans le ressouvenir de leur ferme amitié, Il sera sans amour, mais non pas sans pitié:
Le temps conduira tout, & ſa flâme premiere Ne poura pas durer en manquant de matiere.	Le temps conduira tout, et sa flamme première Ne pourra pas durer en manquant de matière.
Si bien qu’ayant perdu ce bel objet vainqueur Ie pourray librement diſpoſer de ſon cœur.	Si bien qu'ayant perdu ce bel objet vainqueur Je pourrai librement disposer de son cœur.
Lors mes deſſeins par tout treuueront vne voye, Tous mes ſens gouterone vue partaite loye, I’entretiendray Rodrigue, & lors mille plaiſirs Succederont ſans doute à mes iuſtes deſirs.	Lors mes desseins par tout trouveront ç voye, Tous mes sens goûterone vue partaite loie, J'entretiendrai Rodrigue, et lors mille plaisirs Sucéderont sans doute à mes justes désirs.
SCENE III.	SCÈNE III.
D.	D.
SANCHE.	SANCHÉ.
T Ains & foibles reſpects ennemis de mon ame, Q Ne m’importunez plus d’eſteindre cette flâme, L'amour veut malgré vous que i'acheue d’agir Dans vn deſſein honteux, dont ie ne puis rougir:	 Ains et faibles respects ennemis de mon âme, Q Ne m'importunés plus d'éteindre cette flamme, L'amour veut malgré vous que j'achève d'agir Dans un dessein honteux, dont tu ne puis rougir:
Ce que vous propoſez ſemble eſtre legitime, Et ma raiſon s’opoſe à l’horreur de mon crime:	Ce que vous proposez semble être légitime, Et ma raison s'oppose à l'horreur de mon crime:
Ie ſçay bien dés long temps qu’elle a donné ſa foy, Que je m’en vais trahir, & Rodrigue, & le Roy, Que ſi le Ciel eſt iuſte il faut que ie perifſe, Que la honte ou la mort doit eſtre mon ſupplice, Que les plus grands malheurs ne m’abandonnent pas, Et qu’ils ſuiuẽt par tout, & mon ombre, & mes pas N’importe, il vaut bien mieux eſtre ſon homicide, Celuy qui veut la mort, du moins n’eſt pas timidé, Et pour cette beauté le trépas eſt ſi beau, Qu’vn thrône à mon âuis vaut moins que ce tombeau :	Je sais bien dès long temps qu'elle a donné sa foi, Que je m'en vais trahir, et Rodrigue, et le Roi, Que si le Ciel est juste il faut que je périsse, Que la honte ou la mort doit être mon supplice, Que les plus grands malheurs ne m'abandonnent pas, Et qu'ils suivent par tout, et mon ombre, et mes pas N'importe, il vaut bien mieux même son homicide, Celui qui veut la mort, du moins n'est pas timidé, Et pour cette beauté le trépas est si beau, Qu'un trône à mon âuis à moins que ce tombeau :
Mais ije trahis Rodrigue, & le ſeul nom de traître, Pour cette lacheré me doit faire connêtre.	Mais ije trahis Rodrigue, et le seul nom de traître, Pour cette lé me doit faire connaître.
Sortez, ſortez penſers, c’eſt trop m’entretenir, Si vous m’eſtes cruels, faut-il vous retenir?	Sortez, sortez pensers, c'est trop m'entretenir, Si vous m'êtes cruels, faut-il vous retenir?
Que ie ne viue plus dedans cette contrainte, Ce qui doit m’arriuer eſt bien moins que ma crainte:	Que personne ne vive plus dedans cette contrainte, Ce qui doit m'arriver est bien moins que ma crainte:
Il ne faut qu’vn trẽpas pour finir ma vigueur, Et ie ſoufre auiourd’huy tous les maux, dont i’al peur:	Il ne faut qu'un trépas pour finir ma vigueur, Et tu souffre aujourd'hui tous les maux, dont j'al peur:
Voyons donc ſi l'amour eſt payé de la hayne, Il eſt temps d’adoucir, ou d’acrêtre ma pêne, Rodrigue eſt au combat, & ſon eloignement Pourra bien me ſeruir à finir ſon tourment:	Voyons donc si l'amour est payé de la haine, Il est temps d'adoucir, ou d'acrêtre ma pêne, Rodrigue est au combat, et son éloignement Pourra bien me servir à finir son tourment:
Peut-eſtre à ce ſujet ſera t’il tres facile De treuuer à Chimene vn eſprit plus docile, L’abſence diminuë;	Peut-être à ce sujet sera -t-il très facile De trouver à Chimène un esprit plus docile, L'absence diminue;
vn ennuy violent Change par fois l’humeur, & rend vn feu plus lent;	un ennui violent Change par fois l'humeur, et rend un feu plus lent;
Mais ce qui d’ordinaire eſt offert à la veuë, Touche ſenſiblement, rend l’ame plus émeuë:	Mais ce qui d'ordinaire est offert à la vue, Touche sensiblement, rend l'âme plus émue:
Imprime ſon pouuoir auec facilité, Et ſouuant dans nos cœurs graue ſa qualité!	Imprime son pouvoir avoir facilité, Et souvant dans nos cœurs grave sa qualité!
Que s’il vient à paſſer, cette imageſe paſſe, La raiſon n’en veut plus, & le temps nous l’efface.	Que s'il vient à passer, cette images passée, La raison n'en veut plus, et le temps nous l'efface.
Allons donc la treuuer dans cette occaſion, Et que mon ſang plûtoſt preuue ma paſſion:	Allons donc la trouver dans cette occasion, Et que mon sang plutôt preuve ma passion:
Adorablé Chimene, objet ſeul de mon ame, Verrez vous ſans brûler la grandeur de ma flâme?	Adorablé Chimène, objet seul de mon âme, Verrez -vous sans brûler la grandeur de ma flamme?
Au moins ſi mon amour ne vous met en courroux, Plaignez moy ſi ie meurs, car ie mourray pour vous.	Au moins si mon amour ne vous met en courroux, Plaignez moi si je meurs, car toujours mourrai pour vous.
SCINE	SCINE
SCENE I CHIMENE, LEONOR, 7	SCÈNE I HIMENE, LEONOR, 7
I ie ſçauois au moins deſſous quelles murailles & Mon ſang honoreroit ſes nobles funerailles, Et malgré le deſtin pour vn ſujet ſi beau, A la fin nous n’aurions que le meſme tombeau,	I ie sçauois au moins dessous quelles murailles et Mon sang honorerait ses nobles funérailles, Et malgré le destin pour un sujet si beau, À la fin nous n'aurions que le Seigneur tombeau,
LEONOR.	LEONOR.
que le fort eſt ſeuere aux plus aimables choſet, Il met toute ſa pêne à dérruire les roſes, Et les plus rares fleurs qui naiſſent le matin, D’ordinaire le ſoir approchent de leur fin.	que le fort est sévère aux plus aimables choset, Il met toute sa pêne à dérruire les roses, Et les plus rares fleurs qui naissent le matin, D'ordinaire le soir approchent de leur fin.
Rodrigue eſt mort de même, & l’éclat de ſa vie Eſtoit trop peu commun pour éuiter l’enute:	Rodrigue est mort de même, et l'éclat de sa vie Était trop peu commun pour éviter l'enute:
Encore eſt ce beaucoup ayant ſi peu veſcu, De peur qu’il vainquit tout, que la mort l’ále vaincu :	Encore est ce beaucoup ayant si peu vécu, De peur qu'il vainquit tout, que la mort l'elle vaincu :
Vous ſçauez qu’il a fait tout ce qu’on pouuolt aaile, Mais pour nos ennemis ſa mort iue necenlère.	Vous savez qu'il a fait tout ce qu'on pouvolt aaile, Mais pour nos ennemis sa mort jue necenlère.
Et le Ciel qui le ſoufre & qui l’a veu mourir, Par ce triſte moien a creu les ſecourir.	Et le Ciel qui le souffre et qui l'a vu mourir, Par ce triste moyen a cru les secourir.
Ne le repetez plus, & ſi mon malvous touche,	Ne le répétez plus, et si mon malvous touche,
CHIMENE.	CHIMENE.
Gardez vous bien vn iour d'en ouurir vôtre bouche:	Gardez -vous bien un jour d'en ouvrir votre bouche:
Laiſſez-moi quelque temps afin de m’obliger Laiis ce tunente etat, coue lert à m’afſiger.	Laissez-moi quelque temps afin de m'obliger Laiis ce tunente état, coue lert à m'afsiger.
BLVIRE.	BLVIRE.
Madame à quel propos?	Madame à quel propos?
CHIMENE.	CHIMENE.
Obeys-moi ſans crainteG'eſt me donner beaucoup que permettre me plainte.	Obéis-moi sans crainteG'est me donner beaucoup que permettre me plainte.
SCENEV.	SCENEU.
CHIMENE ſeule.	CHIMENE seule.
Niuſte & dure loy de mon funeſte ſort, M qui tint jadis ma voix, & mon ame en conG12 trainte, Ne viens plus t'opoſer dans ce dernier efort A la liberté de ma plainte, Tu ſçais que ie n’ay pras eſperance, ni crainte, Et que mon aimable vainqueur Ne vit plus ici bas ſi ce n’eſt dans mon cœur.	Niuste et dure loi de mon funeste sort, M qui tint jadis ma voix, et mon âme en conG12 trainte, Ne viens plus t'opposer dans ce dernier eûtort A la liberté de ma plainte, Tu sais que je n'ai pras espérance, ni crainte, Et que mon aimable vainqueur Ne vit plus ici bas si ce n'est dans mon cœur.
Pour mon ſoulagement ie plaindrai mes malheurs, Maigré les loix d’honneur, & ſes vaines chimeres.	Pour mon soulagement rien plaindrai mes malheurs, Maigré les lois d'honneur, et ses vaines chimères.
Mais ie veux que mes yeux répandent tant de pleurs, Que mes deſſeins me ſoient proſperes, Et qu’en fin mes ſoûpirs ainſi que des viperes Dans ce dernier éfet d’amour, Me donnent le trepas pour leur donner le iour.	Mais me veux que mes yeux répandent tant de pleurs, Que mes desseins me soient prospères, Et qu'en fin mes soupirs ainsi que des vipères Dans ce dernières éfet d'amour, Me donnent le trépas pour leur donner le jour.
Qu’eſperai je auſſi bien de la bonté des Dieux?	Qu'espérai je aussi bien de la bonté des Dieux?
Rodrigue ne vit plus, & mon pere eſt enterre, Ce qui fut mon eſpoir eſt mort preſque à mes yeux, Et l’autre eſt mort dedans la guerre, Rodrigue eſtoit mon cœur, mais le tombeau l’enſerre:	Rodrigue ne vit plus, et mon père est enterre, Ce qui fut mon espoir est mort presque à mes yeux, Et l'autre est mort dedans la guerre, Rodrigue était mon cœur, mais le tombeau l'enserre:
Si bien qu’en ce tourment nouueau, Ie vol mon eſperance, & mon cœur au tombeãu.	Si bien qu'en ce tourment nouveau, Je vol mon espérance, et mon cœur au tombeangu.
Au point qu'vn feu ſi pur faiſoit tous mes pléſire.	Au point qu'un feu si pur faisait tous mes plésire.
De deux forts ennemis ie me vis pourſuiuie, Auſſi toſt que l’amour appreuua mes deſirs;	De deux forts ennemis on me vis poursuivie, Aussi tôt que l'amour approuva mes désirs;
L’honneur étoufa mon enule, L'vn m’a fait eſtimer, l’autre a noirci ma vie:	L'honneur étouffa mon envle, L'un m'a fait estimer, l'autre a noirci ma vie:
Et ces deux me croiant guerir, Ne m’ont point fait encor, ni viure, ni mourir.	Et ces deux me croyant guérir, Ne m'ont point fait encor, ni vivre, ni mourir.
Iuſte reffentiment, & de fang, & d’amour, Faut-il qu’en ce mal-heur Rodrigue m’entretienne, Il a donné la mort à qui ie dois le iour, Sa perte a commencé la mienne;	Juste ressentiment, et de sang, et d'amour, Faut-il qu'en ce malheur Rodrigue m'entretienne, Il a donné la mort à qui tu dois le jour, Sa perte a commencé la mienne;
Il la vient auiourd’huy d’acheuer par la ſienne, Montrons donc iuſque au monument La pitié pour le pere, & l’amour pour l’Amant.	Il la vient aujourd'hui d'achever par la sienne, Montrons donc jusque au monument La pitié pour le père, et l'amour pour l'Amant.
Mes ſens dans ce deffeln ne ſont pas égaren Le trépas pour ces deux eſt noble, ce me ſemble, Bt pource que la mort nous a tous ſeparez, Il faut que la mort nous raffemble, Ils ſont morts pour l’honneur, puis que ie leur refſemble, Portant enuie à leur bon heur, Ie veux auſſi les ſuiure, & mourir par honneur.	Mes sens dans ce défeln ne sont pas égaren Le trépas pour ces deux est noble, ce me semble, Bt pource que la mort nous a tous séparés, Il faut que la mort nous raffemble, Ils sont morts pour l'honneur, puis que sans leur refaimble, Portant envie à leur bon heur, Je veux aussi les suivre, et mourir par honneur.
Ne differe donc plus, le ſort en eſt ietté, Puis qu’auſſi bien tu voi ton eſperance vaine, Qui cherche le trépas, cherche ſa liberté, Et treuue la fin de ſa pêne.	Ne diffère donc plus, le sort en est jeté, Puis qu'aussi bien tu voi ton espérance vaine, Qui cherche le trépas, cherche sa liberté, Et trouve la fin de sa pène.
Têmoigne ta pitié pareſſant inhumêne, Et fais voir qu’en perdant le iour L’honneur te fait mourir auſſi bien que l’amour.	Témoigne ta pitié paressant inhumône, Et fais voir qu'en perdant le jour L'honneur te fait mourir aussi bien que l'amour.
Fin du ſecond Acte.	Fin du second Acte.
ARGVMENT DV TROISIEME ACTE.	ARGUMENT DU TROISIÈME ACTE.
OM RODRIGVE ſe reſioüis  auec Dom Alonſe de la victoire qu’ils ont obtenuë ſur les Mores;	OM RODRIGUE se réjouis avec Dom Alonse de la victoire qu'ils ont obtenue sur les Mores;
& lui même en va porter le premier la nouuelle au Roy.	et lui -même en va porter le premier la nouvelle au Roi.
L’Infante dans l’impatience & dans le deſir de faire mourir Chimene pour ſe faciliter l’amour de Rodrigue, aprend de Leonor ce qu’elle n’en vouloit pas aprendre, & treuue l’eſprit de cette confidente dans le repentir d’auoir perſuadé à Chimene la fauſſe nouuelle de la mort de ſon Amant;	L'Infante dans l'impatience et dans le désir de faire mourir Chimène pour se faciliter l'amour de Rodrigue, aprend de Leonor ce qu'elle n'en voulait pas apprendre, et trouve l'esprit de cette confidente dans le repentir d'avoir persuadé à Chimene la fausse nouvelle de la mort de son Amant;
& contre ſes ſentimens, & quelques menaces apparentes qu'elle lui fait d’en aduertir le Roy;	et contre ses sentiments, et quelques menaces apparentes qu'elle lui fait d'en avertir le Roi;
delibere de conduire ſes deſſeins à vn dernier but.	délibère de conduire ses desseins à un dernier but.
Rodrigue cependant inſtruit le Roy, de la victoire de ſes ennemis, qui ſe propoſe mille profuſions dans ſon eſprit pour la recompenſe de Rodrigue.	Rodrigue cependant instruit le Roi, de la victoire de ses ennemis, qui se propose mille profusions dans son esprit pour la récompense de Rodrigue.
Chimene croyant ſon Amant perdu, veut recourir aux dernieres extremitez, & dans ce temps méme elle voit Rodrigue;	Chimène croyant son Amant perdu, veut recourir aux dernières extrémités, et dans ce temps même elle voit Rodrigue;
ce qui la rend ſi confuſe, qu'à pene peut-elle treuuer dequoi faire vn raiſonnement:	ce qui la rend si confuse, qu'à pene peut-elle trouver dequoi faire un raisonnement:
leur ioie est troublée par la nouuelle veritable que leur donne D.	leur joie est troublée par la nouvelle véritable que leur donne D.
Arias de la colere du Roy qui auoit changé les premiers deſſeins qu’il auoit faits à l’aduantage de Rodrigue, à cauſe des aſſurances que Leonor lui auoit données de l’amour de l’Infante;	Arias de la colère du Roi qui avait changé les premiers desseins qu'il avait faits à l'avantage de Rodrigue, à cause des assurances que Leonor lui avait données de l'amour de l'Infante;
& pour la crainte dont il eſtoit préuenu que cette paſſion aporteroit vn grand deſordre dans ſon Eſtat.	et pour la crainte dont il était prévenu que cette passion apporterait un grand désordre dans son État.
LEOIE AII.	LEOIE AII.
D.	D.
RODRIGVE, D.	RODRIGUE, D.
ALONSE, L’INFANTE, moRery de ROIJ CHIMANB, ALVIRB, D.	ÀLONSE, L'INFANTE, moRi de ROI CHIMANB, ALVIRB, D.
ARIAS.	ARIAS.
be E3*230* SCENM 10 D.	be E3*230* SCENM 10 D.
RODRIGVE, D.	RODRIGUE, D.
ALONSE.	ÀLONSE.
D.	D.
RODRIGVE.	RODRIGUE.
vσα Lonſe ta valeur aida bien à ma gloire, Quiel Il reſte à triompher apres cette victoire, M Nos ennemis ſont morts, leurs deſſeins rulAR nez Ne les rendront jamais à ma perte obſtinez;	vite Lonse ta valeur aida bien à ma gloire, Quiel Il reste à triompher après cette victoire, M Os ennemis sont morts, leurs desseins rulAR nez Ne les rendront jamais à ma perte obstinez;
Ils n’ont pas eu ſoiſir de faire vne retraire, Ce renfort a cauſé leur entiere défaite;	Ils n'ont pas eu soisir de faire une retraire, Ce renfort a causé leur entière défaite;
Nôtre conduite, ami, les dût bien étonner, Ils ont beu le poiſon qu’ils nous vouloient donners Cet barbares contre eux excitoient cestempeſtes, Et depuis peu leurs traits ont tombé ſur leurs teſtes, Deuoient ils pas ſonger, & preuoir ci deuant, Que leur plus grand eſpoir ſe fondoit ſur du vent?	Notre conduite, ami, les dût bien étonner, Ils ont bu le poison qu'ils nous voulaient donners Cet barbares contre eux excitaient cestempêtes, Et depuis peu leurs traits ont tombé sur leurs têtes, Deuaient ils pas songer, et prévoir cy devant, Que leur plus grand espoir se fondait sur du vent?
Et nous n’auons pas craint qu’ils puſſent nous ſurprendre, Car leurs propres filets n’ont ſerui qu'à les prendre.	Et nous n'avons pas craint qu'ils pussent nous surprendre, Car leurs propres filets n'ont servi qu'à les prendre.
ALONSE.	ÀLONSE.
Nous n’aprehendons plus, mais apres ces combats Il ſe faut repoſer, mettons les armes bas:	Nous n'appréhendons plus, mais après ces combats Il se faut reposer, mettons les armes bas:
Il eſt temps d’étoufer nôtre premiere plainte, D'aller treuuer le Roy, de le tirer de crainte.	Il est temps d'étouffer notre première plainte, D'aller trouver le Roi, de le tirer de crainte.
Et de faire auouër comme amant & guerrier.	Et de faire avouer comme amant et guerrier.
Qu’on vous doit couronner de myrthe & de laurier :	Qu'on vous doit couronner de myrte et de laurier :
Quand vn ſort rigoureux tenoit l’état en butte, Vous l’auez releué d’vne terrible chutte;	Quand un sort rigoureux tenait l'état en butte, Vous l'avez relevé d'une terrible chute;
Et par vôtre valeur, & par vorre vertu Nous auons veu le More à vos pieds abatu:	Et par votre valeur, et par vorre vertu Nous avons vu le More à vos pieds abattu:
Mais étonnons le Roy par vne ardeur ſi forte, Allons refſuſciter ſon eſperance morte, Quir bemnie le Cies, qu'if vous traitté en vainqueur.	Mais étonnons le Roi par une ardeur si forte, Allons ressusciter son espérance morte, Quir bemnie le Cies, qu'if vous traité en vainqueur.
Et qu’apres ce combat il diſſipe ſa peur, On ne peut pas répondre à des bien faits ſi rares.	Et qu'après ce combat il dissipe sa peur, On ne peut pas répondre à des bien faits si rares.
D.	D.
RODRIGVE.	RODRIGUE.
Alonſe il eſt bien vrai, i'ai vaincu ces barbares, I'ai releué l’écat, ie raſſure le Roi, Mais vn autre m’attaque, & triomphe de moi, l’euſte le combat, & ietreuue des charmes A receuoir ſes loix, à lui rendre les armes, A manquer tous les touis, de d'aurene, & de cœur, Bref à me voir ſoûmis aux pieds de mon vainqueur,	Alonse il est bien vrai, j'ai vaincu ces barbares, J'ai relevé l'écat, une rassure le Roi, Mais un autre m'attaque, et triomphe de moi, l'euste le combat, et jetreuve des charmes A receuoir ses lois, à lui rendre les armes, A manquer tous les touis, de d'aurène, et de cœur, Bref à me voir soumis aux pieds de mon vainqueur,
D.	D.
ALONSE.	ÀLONSE.
Vous parlez de Chimene affurément.	Vous parlez de Chimène assurément.
D.	D.
RODRIGVE.	RODRIGUE.
C’eſt elle Qui me fait ſon captif, & qui me rend fidelle, Et i’ai tant de plêſir dans ma captiuité, l’au prix d’vn bien ſi doux ie hay ma liberté?	C'est elle Qui me fait son captif, et qui me rend fidèle, Et j'ai tant de plésir dans ma captivité, l'au prix d'un bien si doux un hai ma liberté?
Mais ſaluons le Roy, l’Infante, & ma Chimene, Et nous les tirerons d’vne incroyable pêne.	Mais saluons le Roi, l'Infante, et ma Chimène, Et nous les tirerons d'une incroyable pêne.
SCENE II.	SCÈNE II.
L'INFANTE, LEONOR.	L'INFANTE, LEONOR.
L’INFANTE.	L'INFANTE.
Ais enfin par ton alr, & par tes mouuemens ſvyιtas tu bien exprimé mes iuſtes ſentimens?	Ais enfin par ton alr, et par tes mouvements svyιtas tu bien exprimé mes justes sentiments?
Ql ECroit elle pas ſa mort?	Qul ECroit elle pas sa mort?
LEONOR.	LEONOR.
Que trop, que trop, Madame, Et i’en ai maintenant mille remords dans l’ame, Que ſi le deſeſpoir attaque ſa raiſon, Qu’elle auance ſes iours pour ſortir de priſon, Qu’elle coure bien tôt à quelque morc cruelle:	Que trop, que trop, Madame, Et j'en ai maintenant mille remords dans l'âme, Que si le désespoir attaque sa raison, Qu'elle avance ses jours pour sortir de prison, Qu'elle coure bien tôt à quelque morc cruelle:
Hé, Madame, ſongez que ie ſuis criminelle, Que vous me contraignez dedanscette action, Pour laquelle mon cœur a de l’auerſion, Qu'auec le repentir ma vie eſt languiſſante, Et que ie fais mourir vne pauure inocente.	Hé, Madame, songez que je suis criminelle, Que vous me contraignez dedanscette action, Pour laquelle mon cœur a de l'aversion, Qu'avec le repentir ma vie est languissante, Et que tu fais mourir une pauvre inocente.
L'IN FANTE.	L'IN SANTÉ.
O Dieux puis je ſoufrir vn ſemblable entretien!	Ô Dieux puis je soufrir un semblable entretien!
Quoi?	Quoi?
tu terepens donc de m’auoir fait du bien?	tu tèrepens donc de m'avoir fait du bien?
Ingrate Leonor, parois-tu genereuſe A me rendre à jamês confuſe & mal heureuſe?	Ingrate Leonor, parais-tu généreuse À me rendre à jamês confuse et mal heureuse?
Ce qui me releua, maintenant me détruit, Et ce qui m’allegea m’importune & me nuit.	Ce qui me releva, maintenant me détruit, Et ce qui m'allégea m'importune et me nuit.
LRONOR.	LRONOR.
Ie reconnois des Dieux, le remords de mon crîme M’en doit faire obtenir vn pardon legitime, Trahir ainſi Chimene, & pour vous contenter Cauſer vn deſeſpoir, qu’on ne peut arreſter;	Je reconnais des Dieux, le remords de mon crîme M'en doit faire obtenir un pardon légitime, Trahir ainsi Chimène, et pour vous contenter Causer un désespoir, qu'on ne peut arrêter;
Perdre de la façon vôtre honneur pour vous plêre, Connêtre vos douleurs, & vous plaindre, & ſetaire.	Perdre de la façon votre honneur pour vous plêre, Connêtre vos douleurs, et vous plaindre, et setaire.
Ah!	Ah!
ce que i’en aifait rend mes eſprits confus, donges degrace a vous, o ne m'en pariez plus.	ce que j'en aifait rend mes esprits confus, donges dégrâce à vous, ô ne m'en pariez plus.
L’IN FANTE.	L'IN SANTÉ.
Blen loing de prendre part au ſouci qui me touche, Tu ne permettras pas que i’en ouure la bouche, Quelle humeur, Leonor, vous oblige à changer?	Blen loin de prendre part au souci qui me touche, Tu ne permettras pas que j'en ouvre la bouche, Quelle humeur, Leonor, vous oblige à changer?
Aimez ſes intereſts, tachez de la vanger.	Aimez ses intérêts, tachés de la venger.
LEONOR.	LEONOR.
Ie fais vôtre profit, & ſoyez tres-certene, Que vôtre honneur m’eſt plus que celui de Chimene, Si l'amour donne au vôtre vn vigoureux affaut, Vous ne ſçaurieztomber qu’en tombant de blen haut;	Je fais votre profit, et soyez très -certene, Que votre honneur m'est plus que celui de Chimène, Si l'amour donne au vôtre un vigoureux assaut, Vous ne saurieztomber qu'en tombant de blen haut;
Dans vn rang eminent vous eſteséleuée, Et dans ce même rang on vous a conſeruée, Maintenant ce bon heur ſemble vous exciter, Vous faites des efors pour vous precipiter, I’ay flatté pour vn temps vôtre amoureuſe flâme, Tar des moiens honteux i’ai ſoulagé vôtre ame, Ie voulu conſentir à cette trahiſon, Comme vous en vn rien i’égarai ma raiſon, Cependant	Dans un rang éminent vous esteséleuée, Et dans ce même rang on vous a conservée, Maintenant ce bon heur semble vous exciter, Vous faites des eufors pour vous précipiter, J'ai flatté pour un temps votre amoureuse flamme, Tar des moyens honteux j'ai soulagé votre âme, Je voulu consentir à cette trahison, Comme vous en un rien j'égarai ma raison, Cependant
L'INFANTE.	L'INFANTE.
Ie vois bien qu’il ſeroit impoſſible De toucher deſormuie voue ciprie lhemable.	Je vois bien qu'il serait impossible De toucher désormuie voue ciprie lhemable.
LEONOR.	LEONOR.
Non, par d’autres moiens ſoulagez vôtre mal.	Non, par d'autres moyens soulagez votre mal.
Autrement le ſuccez vous en ſera fatal.	Autrement le succès vous en sera fatal.
elle ſort.	elle sort.
L’IN FANTE.	L'IN SANTÉ.
Fais ce que tu voudras, dequoi que tu m’acuſes, Sçacheque mon amour me fournira d’excuſes:	Fais ce que tu voudras, de quoique tu m'acuses, Sacheque mon amour me fournira d'excuses:
Peins moi comme vne Helene, & pour bien mieux agir, Fais vn portrait de moi qui mefaſſe rougir, Entretien bien le Roi du tourment qui me preſſe, Va le rendre ennemi du beau trait qui mebleſſe, Perfide, fais d’Vrraque vn impudique objet, Dy que leſuis infame, & que i'aime vn ſujet, Et raconte par tout que dans ma jalouſie Mille dereglemens troublent ma fantaiſie, Que cette amour me perd, que ie ſors de mon rangs Que mon cœur tout brûlé ne reſpire que ſang, Qu’à cauſe que Chimene empéche mon attente, Son trépas ſeulement me doit rendre contente, Et qu’enfin cét amant a charmé mes eſprits, Mais rien ne peut jamés me porter au mépris, Ie veux aimer Rodrigue, & malgré ces obſtacles.	Peins moi comme une Hélène, et pour bien mieux agir, Fais un portrait de moi qui mefasse rougir, Entretien bien le Roi du tourment qui me presse, Va le rendre ennemi du beau trait qui meblesse, Perfide, fais d' Un impudique objet, Dis que les infâme, et que j'aime un sujet, Et raconte par tout que dans ma jalousie Mille dereglemens troublent ma fantaisie, Que cette amour me perdez, que je sors de mon rangs Que mon cœur tout brûlé ne respire que sang, Qu'à cause que Chimène empéche et attente' On trépas seulement me doit rendre me, Et denfin cét ren a charmé mes esprits, Mais rien ne peut jamés me porter ' mépris, Ie veux aimer Rodrigue, et malgré ces obstacles.
Pourſuiure mes deſſeins, & faire des miracles.	Poursuivre mes desseins, et faire des miracles.
SCENE III.	SCÈNE III.
LE ROY, D.	LE ROY, D.
RODRIGVE.	RODRIGUE.
Vï ma crainte étoit forte, & mes maux redoublez Q.	Vois ma crainte était forte, et mes maux redoublés Q.
donnoient point de caime à tous mes ſens troublez.	donnaient point de caime à tous mes sens troublés.
D'abord ie crus ma perte, ou ma honte affeurée, Que ma douieur ſeroir de plus longue durée.	D'abord rien crus ma perte, ou ma honte affeurée, Que ma douieur seroir de plus longue durée.
En fin par ce raport ie me vis ſi confus, Que ie mis tout mon bien à n’en ſouhaiter plus.	En fin par ce rapport ie me vis si confus, Que tu mis tout mon bien à n'en souhaiter plus.
Maintenant que le Ciel permet que ie vous vole, Que vos faits ont acreuvôtre gloire & ma loie, Que vous me raſſurez, & que ces inhumains Ont eu le ſeul honneur de mourir par vos mains.	Maintenant que le Ciel permet que je vous vole, Que vos faits ont acreuvôtre gloire et ma loie, Que vous me rassurez, et que ces inhumains Ont eu le seul honneur de mourir par vos mains.
Que ne vous dois- ie point, de quel bienfait ſi rare Puis je vous obliger ſans me montrer auare?	Que ne vous dois- je point, de quel bienfait si rare Puis je vous obliger sans me montrer avare?
Triompher d’vn parti qui n’auoit combatu, Releuer ma couronne, & mon ſceptre abatu, Chaſſer des ennemis qui dans ma prerre terre Me liuroient tous les iours vne mortelle guerre:	Triompher d'Hô parti qui n'avait combattu, Relever ma couronne, et mon sceptre abattu, Chasser des ennemis qui dans ma prèrre terre Me livraient tous les jours une mortelle guerre:
Ce ſont de ces éfets dont on falttant de cas, Et des traits ſeulement à faire des ingrats.	Ce sont de ces éfets dont on faltant de cas, Et des traits seulement à faire des ingrats.
Pour mon contentement & pour vôtre loüange, Donnez moi le recit de ce combat étrange.	Pour mon contentement et pour votre lange, Donnez -moi le récit de ce combat étrange.
D.	D.
RODRIGVE.	RODRIGUE.
Sire au commencement nous fumes étonner, Tous les chefs des ſoldats furent abandonnez, Et ces gens inſolens en voiant cettefuitte, Vſerent contre nous d’vne rude pourſuitte.	Sire au commencement nous fûmes étonner, Tous les chefs des soldats furent abandonnés, Et ces gens insolents en voyant cettefuite, Usèrent contre nous d'une rude poursuite.
Ils fe treuuent puiſſans dans nôtre extremité, Ne donNe donnent point de place à la timidité:	Ils se trouvent puissants dans notre extrémité, Ne donNe donnent point de place à la timidité:
Ils nous ſerrent de pres, nous forcent, nous attalgnent, Les vns ſont maſſacrez, & les autres les craignent, Tous ſont au deſeſpoir, chacun quitte ſon rang, Et pâle, voit rougir la terre de ſon ſang, Mais la nuit par bon-heur auecque ſestenebres Finit leur entrepriſe, & nos plaintes funebres:	Ils nous serrent de pres, nous forcent, nous attalgnent, Les uns sont massacrez, et les autres les craignent, Tous sont au désespoir, chacun quitte son rang, Et pâle, voit rougir la terre de son sang, Mais la nuit par bonheur avec sestenebres Finit leur entreprise, et nos plaintes funèbres:
Depuis cette retraitte, & pour nous & pour eux, L’ardeur fut preſque égale, & le combat douteux, Mais apres le renfort auſſi tôt qu’ils nous virent Leur ſang ſe refroidit, leurs viſages pâlirent, Sçachant que ie deuois combarre pour vn Roi, A ce ſeul nom de Cid ils tremblerent d’éfroi:	Depuis cette retraite, et pour nous et pour eux, L'ardeur fut presque égale, et le combat douteux, Mais après le renfort aussi tôt qu'ils nous virent Leur sang se refroidit, leurs visages pâlirent, Sachant que je devais combarre pour un Roi, À ce seul nom de Cid ils tremblèrent d'éfroi:
Leurs mains dans ce combat furent preſque imobiles, Et nous ſirent treuuer des ſuccez trop facilel;	Leurs mains dans ce combat furent presque imobiles, Et nous sirent trouver des succès trop facilel;
Ie m’attaque à leur chef, i’en vins bien-tôt à bout, Bref, Sire, on perdit tout, pource qu’on craignoit tout;	Je m'attaque à leur chef, j'en vins bientôt à bout, Bref, Sire, on perdit tout, pource qu'on craignait tout;
Il combatit long temps pour la troupe ennemle, Tacha de reueiller leur fureur endormie, Et par ſes actions, & ſouuant par ſes cris Excita contre nous ces timides eſprits, Iliuccomba pourtant, & ce rare courage Treuua nôtre valeur plus forte que ſa rage, Et ſeſentant bleſſé, fit enfin ces éforts A parler aux viuans en regardant les morte.	Il combattit long temps pour la troupe ennemle, Tacha de réveiller leur fureur endormie, Et par ses actions, et souuant par ses cris Et contre nous ces timides esprits, Va pourtant, et ce rare courage Treuua nôtre valeur plus forte que a rage, Et ses blessé, fit enfin ces éforts A parler aux viuans en regardant les morte.
Eſtrange arreſt des deſtinées!	Étrange arrêt des destinées!
Les Princes meurent comme vous, Le ſort eſt implacable à tous, Chacun voit finir ſes années, Nos iours ſont filez d’vn fuſeau, Ceux des ſimples ſujets, & des puiſſans Monarques Sont entrepris de mêmes Parques Et coupezd’vn méme ciſeau.	Les Princes meurent comme vous, Le sort est implacable à tous, Chacun voit finir ses années, Nos jours sont filez d'un fuseau, Ceux des simples sujets, et des puissants Monarques Sont entrepris de mêmes Parques Et coupezd'un même ciseau.
Et cependant on nous fait croire, Pour éblouïr plutôt nos yeux Que les Roisreſſemblent aux Dieux, Et qu’ils en ont beaucoup de gloire, Mais quoi?	Et cependant on nous fait croire, Pour éblouir plutôt nos yeux Que les Roisssemblent aux Dieux, Et qu'ils en ont beaucoup de gloire, Mais quoi?
nous ſerions tous égaus, Les Dieux ſeroient mortels, ils n’aurolent plus d’hommages, Si la mort abat les images Elle en veut aux originaux.	nous serions tous égaus, Les Dieux seraient mortels, ils n'aurolent plus d'hommages, Si la mort abat les images Elle en veut aux originaux.
La les iouis ione lina aoin bien que la gloire.	La les jouis ione lina aoin bien que la gloire.
Et ſa mort commença nôtre inſigne victoire.	Et sa mort commença notre insigne victoire.
LHROY.	LHROY.
Ie plains ſon accident, i'eſtime ſa vertu, I'ai des compaſſions pour vn Sceptre abatu:	Je plains son accident, j'estime sa vertu, J'ai des compassions pour un Sceptre abattu:
Mais i’ai plus de reſon de porter quelque enuie AuxMODIesacdons qui Mhnarene tuvie.	Mais j'ai plus de réson de porter quelque envie AuxMODIesacdons qui Mharene tuvie.
Va treuuer ta Chimene, & ſur tout ſouuiens toi Que c’eſt faire beaucoup que d’obliger vn Roi.	Va trouver ta Chimène, et sur tout souviens toi Que c'est faire beaucoup que d'obliger un Roi.
D.	D.
RODRIGVE.	RODRIGUE.
il ſort.	il sort.
O Ciel!	Ô Ciel!
ie l'aperçois dans vn viſage blême, Elle n’eſt plus à moi, n’eſtant plus à ſoi-méme.	Elle l'aperçois dans un visage blême, Elle n'est plus à moi, n'étant plus à soi-même.
SCENE IV.	SCÈNE IV.
CHIMENE, D.	CHIMENE, D.
RODRIGVE, ELVIRE.	RODRIGUE, ÉLVIRE.
CHIMENE.	CHIMENE.
SV recherches ma perte en me voulant guerir CIOru rengreges mes mauxpenſant meſecourir, Eluire, au nom des Dieux contente mon enule, Soufre qu’vn deſeſpolrtriomphe de ma vie, Que j’oblige le ſort à finir ſa rigueur, Et que i’arme mes mains contre mon propre cœur.	SU recherches ma perte en me voulant guérir CIOru rengréges mes mauxpensant mesecourir, Elvire, au nom des Dieux contente mon envle, Souffre qu'un desespolrtriomphe de ma vie, Que j'oblige le sort à finir sa rigueur, Et que j'arme mes mains contre mon propre cœur.
D.	D.
RODRIGVE.	RODRIGUE.
Dieux elle veut mourir!	Dieux elle veut mourir!
2 CHIMENE.	2 CHIMENE.
Tout me llure la guerre, I'ai perdu mon amant, & mon pere eſt enterre, Puisque Rodrigue eſt mort le jour m’eſt odieux, Pour m’aprocher de lui i’abandonne ces lieux, Il faut bien que des morts i’augmente ici le nombre Et ie veux imoler mon corps à ſa belle ombre:	Tout me llure la guerre, J'ai perdu mon amant, et mon père est enterre, Puisque Rodrigue est mort le jour m'est odieux, Pour m'approcher de lui j'abandonne ces lieux, Il faut bien que des morts j'augmente ici le nombre Et ie veux imoler mon corps à sa belle ombre:
Ce guerrier redoutable & ce parfait amant, Malgré tous ces apas giſt dans vn monument, Ce miracle parfait d’amour & de nature nie aujourd hurcouene deduna ild ſepuleure, Bref ie veus obeïr aus arreſts de mon ſort, Ie veux finir mes iours puiſque Rodrigue eſt mort.	Ce guerrier redoutable et ce parfait amant, Malgré tous ces appas gît dans un monument, Ce miracle parfait d'amour et de nature nie aujourd' hurcouene déduna ild sépulure, Bref pu obéir aussi obéir aussi de mon sort, Je veux finir mes jours puisque Rodrigue est mort.
Madame, RODRIGVE.	Madame, RODRIGUE.
ELVIRE.	ELVIRE.
Iuſtes Dieux quelle étrange mer ueille!	Justes Dieux quelle étrange mer éveille!
Quoy?	Quoi?
vous n'eſtes pas mort:	vous n'êtes pas mort:
ſe peur-il que ie veille?	se peur-il que Seigneur veille?
Ses ſens ſont interdits, o Ciel quelle ri gueur?	Ses sens sont interdits, ô Ciel quelle ri veur?
L Vne foibleſſe attaque & ſes yeux & ſon cœur.	 LUne faiblesse attaque et ses yeux et son cœur.
D.	D.
RODRIGVE.	RODRIGUE.
Mais pourquoy ſurprens tu mon eſprit de la ſorte, Eluire ie ſuis mort ſi ma Chimene eſt morte.	Mais pourquoi surprends tu mon esprit de la sorte, Elvire iesuis ver si ma Chimène est morte.
Ah!	Ah!
Madame.	Madame.
CHIMENE.	CHIMENE.
Ah!	Ah!
Rodrigue eſtoit ce pas aſſez De vous crere tantoſt au rang des treſpaffez?	Rodrigue était ce pas assez De vous crère tantôt au rang des trépassez?
Sachez que mon treſpas n’eſt point mis en balence, Que deſ ja la douleur m’impoſe le ſilence, Et qu’vn reſſentiment de vôtre propre mort Acheuera mes iours par vn dernier effort.	Sachez que mon trépas n'est point mis en balence, Que des ja la douleur m'impose le silence, Et qu'un ressentiment de votre propre mort Achevera mes jours par un dernier effort.
En ſouſpirant ſi tard vôtre perte viſible Ie ſuis lente il eſt vray, mais non pas inſenſible.	En soupirant si tard votre perte visible Je suis lente il est vrai, mais non pas insensible.
Ie m’en vais contenter vôtre premier defſein Car i’ay dedans les mains dequoy m’ouurir le ſein, Ie vous ſuiurai là bas, & malgré ces lieux ſombres Le feu qui nous bruloit eclerera nos ombres:	Je m'en vais contenter votre premier dessein Car j'ai dedans les mains dequoy m'ouvrir le sein, Je vous suivrai là bas, et malgré ces lieux sombres Le feu qui nous brûlait eclera nos ombres:
Nos eſprits s’vniront dans cét afreux ſeiour Où nos embraſſemens feront naiſtre l’amour.	Nos esprits s'uniront dans cet afreux séjour Où nos embrassements feront naître l'amour.
Là nous verrons finir cette mortelle guerre Que le ſang & l’honneur nous liuroient ſur la terre:	Là nous verrons finir cette mortelle guerre Que le sang et l'honneur nous livraient sur la terre:
Les aſtres ceſſeront de nous verſer du fiel, Et l’Enfer nous ſera bien plus doux que le Ciel.	Les astres cesseront de nous verser du fiel, Et l'Enfer nous sera bien plus doux que le Ciel.
Mes ſens ſont egarez, moy-méme ie m’abuſe Que mes ſens ſont troublez!	Mes sens sont égarés, moi-même ie m'abuse Que mes sens sont troublés!
que mon ame eſt confuſe!	que mon âme est confuse!
Rodrigue n’eſt pas mort;	Rodrigue n'est pas mort;
pour croitre mon ennul I’ay parlé de ma flâme, & ſur tout deuant luy.	pour croître mon ennul J'ai parlé de ma flamme, et sur tout devant lui.
Qu’eſperai-ie bons Dieux, dans cét eſtrange orage?	Qu'espérai-je bons Dieux, dans cet étrange orage?
Ie ne verrai iamais le port ny le naufrage, I’ay tantoſt dans l’amour etabli mon bon heur, Maintenant cette amour combat auec l’honneur, Par tout egalement ie me voi pourſuiuie, I’ay crû Rodrigue mort, & ie le treuue en vie.	Je ne verrai jamais le portagez le naufrage, J'ai tantôt dans l'amour établi mon bon heur, Maintenant cette amour combat auec l'honneur, Par tout également ie me voi poursuivie, J'ai cru Rodrigue mort, et et un trouve en vie.
Au moment qu’vn hymen nous deuoit ſecourir I'ai veu mon pere mort dont i’ai penſé mourir, Ie courois à la mort, ie ſens qu’elle me quitte, Et ie crolois perdu ce qui me reſuſcite.	Au moment qu'un hymen nous devait secourir J'ai vu mon père mort dont j'ai pensé mourir, Je courais à la mort, quelque sens qu'elle me quitte, Et ie crolois perdu ce qui me résuscite.
D.	D.
RODRIGVR.	RODRIGUR.
Vne fourbe a causé de veritables pleurs, j'en deteſte la feinte, & ie plains vos douleurs, Ie ne penetre pas au fond de ces penſées Qui rendroient à la fin nos ames inſenſées;	Une fourbe a causé de véritables pleurs, j'en déteste la feinte, et ie plains vos douleurs, Je ne penetre pas au fond de ces pensées Qui rendraient à la fin nos âmes insensées;
Cette choſe m’étonne, & m’aflige beaucoup, Ne uiaitparleblas dariereltele cour 2 O Dieux!	Cette chose m'étonne, et m'aflige beaucoup, Ne aitparleblas dariereltele cour 2 Ô Dieux!
CHIMENE.	CHIMENE.
Ah!	Ah!
cher amant, noſtre perte eſt certêne;	cher amant, notre perte est certêne;
On en veut à Rodrigue auſſi bien qu’à Chimene, Mais Rodrigue pourtant dans ce triſte mal-heur, Eſt vn objet d’amour, & i'en ſuis vn d’horreur, L’Infante affurement fiſt naitre cette feinte, Tous ſes ſens ſont emeus, & ſon ame eſt ateinte;	On en veut à Rodrigue aussi bien qu'à Chimène, Mais Rodrigue pourtant dans ce triste malheur, Est un objet d'amour, et j'en suis un d'horreur, L'Infante assurément fît re cette feinte, Tous ses sens sont émeus, et son âme est ateinte;
Mais dedans ſon amour & dedans ſon couroux.	Mais dedans son amour et dedans son courroux.
N’oubliez pas du moins que Chimene eſt à vous.	N'oubliez pas du moins que Chimène est à vous.
RODRIGVE.	RODRIGUE.
Madame il eſt tout vray, je ſerois inſenſible, Si i’allois condamner vne amour ſi viſible.	Madame il est tout vrai, je serais insensible, Si j'allais condamner une amour si visible.
Si ie la meritois, ie ſerois trop heureux, Mon ſort en cét état ſeroit moins rigoureux, Mais i’acuſe le Ciel, & tout ce qui m'irrite, Eſt de voir vos beautez & mon peu de merite, Cet œil que vous voyez a veu cent regions, Ce bras que vous voiez force des legions, Par tout mes ennemis ſont reduits à l’extréme, Et ie n’ai point apris à me vaincre moi méme, Conneſſant vos vertus, ie connois mes defaus, Et ce que vous valez, & le peu qne ie vaus;	Si ici la méritais, votre serais trop heureux, Mon sort en cet état seroit moins rigoureux, Mais j'acuse le Ciel, et tout ce qui m'irrite, Est de voir vos beautés et mon peu de mérite, Cet œil que vous voyez a vu cent régions, Ce bras que vous ayez force des légions, Par Partout mes ennemis sont réduits à mextréme, Et ie mai Connais à vos vaincre moiméme, Connais mes vertus, je crois mes défaus, Et le peu vous ce, que vous peu et le peu;
I'ai meditéſouuent au bien que ie deſire, Ie l’ai plus eſtimé qu’on ne fait vn Empire, Et ie n’aijamês crû qu’il fut en mon pouuoir.	J'ai meditésouuent au bien que je désire, Je l'ai plus estimé qu'on ne fait un Empire, Et un n'aijamis crû qu'il fut en mon pouvoir.
D’entendre vos ſoûpirs, & de les receupirs Ibfaut le confeffer, i’ai fait tout mon pombie Pour me rendre agreable, ou du tout inſenſible, I’aivoulu conſeruer & banir mon amour, I'ai ſouhaitté la vie & la perte du jour,  Pai fait mille deffeins dans l'eſpoir de vous plêre.	D'entendre vos soupirs, et de les recevirs Ibfaut le confesser, j'ai fait tout mon pombie Pour me rendre agréable, ou du tout insensible, J'aivoulu conserver et banir mon amour, J'ai souhaité la vie et la perte du jour, Pai fait mille desseins dans l'espoir de vous plêvre.
Et i'en défais autant de crainte dn cyueraire.	Et j'en défais autant de crainte dn civeraire.
Mais, Madame, aujourd’hui ie connois mon bonheur, Et je vois tout confus l'excez d'vn tel honneur.	Mais, Madame, aujourd'hui jour connais mon bonheur, Et je vois tout confus l'excès d'un tel honneur.
Mon brazier m’eſt ſi cher, que tout le monde enſemble Et les plus grands threſors n’ont rien qui luireſſemble, Et ma captuice me lend piasgioneux Que ſi ie me voiois dans le thrône des Dieux.	Mon brasier m'est si cher, que tout le monde ensemble Et les plus grands trésors n'ont rien qui luiressemble, Et ma captuice me lend piasgioneux Que si tu me voyais dans le trône des Dieux.
CHIMENB.	CHIMENB.
Dans cette affection ie rougis qu’vn Alcide Pres d’vn ſi foible objet ſe ſoit rendu timide, Ie ne rougirois pas ſi quelque autre beauté, Engageoit voſtre eſprir, & voſtre liberté:	Dans cette affection Prince rougis qu'un Alcide Pres d'un si faible objet se soit rendu timide, Je ne rougirais pas si quelque autre beauté, Engageait votre éprir, et votre liberté:
On aime ſeulement ce qui n’eſt rien qu’aimable, Et l’on doit adorer ce qu’on treuue adorable, Mais moi qui n’us jamês vn éclat afſez vif, Ni pour charmer les yeux, ni pour faire vn captif, Ie crains que vôtre cœur à la fin ſoit de glace, Et qu’vn autre bien toſt occupe cette place, O Dieux!	On aime seulement ce qui n'est rien qu'aimable, Et l'on doit adorer ce qu'on trouve adorable, Mais moi qui n'us jamês un éclat assez vif, Ni pour charmer les yeux, ni pour faire un captif, Je crains que votre cœur à la fin soit de glace, Et qu'un autre bien tôt occupe cette place, Ô Dieux!
s’il eſtoit vrai;	s'il était vrai;
de combien de propos Irois-je importuner voſtre plus doux repos, A combien d’accidens reduiriez vous ma vie, Et de quel deſeſpoir ſeroit elle ſuiuie?	de combien de propos Jrois-je importuner votre plus doux repos, A combien d'accidents réduiriez vous ma vie, Et de quel désespoir serait -elle suivie?
Quand vn bien m’eſt aquis j’aime à le conſeruer, Et quand il eſt perdu, ie crains de me ſauuer, I'aprehende l’Infante.	Quand un bien m'est aquis j'aime à le conserver, Et quand il est perdu, ie crains de me sauver, J'appréhende l'Infante.
D.	D.
RODRIGVE.	RODRIGUE.
Eſperez-mieux, Madame, Vos yeux, & vos bontez entretiennent ma flâme, Pai plus ſujes de craindre,	Espérez-mieux, Madame, Vos yeux, et vos bontés entretiennent ma flamme, Pai plus sujes de craindre,
23 32 e.	23 32 .
SCENT 23 V 8 D.	SCENT 23 V 8 D.
ARIAS, D.	ARIAS, D.
RODRIGVE, CHIMENE.	RODRIGUE, CHIMENE.
D.	D.
ARIAS.	ARIAS.
N.	N.
aigne Souciampaui Le Roy tout en courroda vous attetid au Palais.	aigne Souciampaui Le Roi tout en courroda vous attetid au Palais.
Qui iure que ſes maux n’auront point d’allegeances, Qu’il ne ſoit ſatisfait d’vne entiere vengeance.	Qui jure que ses maux n'auront point d'allégeances, Qu'il ne soit satisfait d'une entière vengeance.
B ROLRIGVD.	 BOLRIGUD.
Allons y de ce pas;	Allons y de ce pas;
le Roy veut ſe vanger, D'où vient cét accident?	le Roi veut se venger, D'où vient cet accident?
qui l’oblige à changer?	qui l'oblige à changer?
CHIMENE.	CHIMENE.
l’aimerois plus ma ioye eſtant plus moderee, La plus grande fortune eſt la moins aſſeurée;	l'aimerais plus ma joie étant plus modérée, La plus grande fortune est la moins assurée;
Dans vn ſi grand bon heur ie crains de ſucomber.	Dans un si grand bon heur On crains de sucomber.
Ce qui monte plus haut eſt plus preſt à tomber.	Ce qui monte plus haut est plus prêt à tomber.
Fin du troiſieſme Acte.	Fin du troisième Acte.
ARGVMENT DV QVATRIESME ACTE.	ARGUMENT DU QUATRIÈME ACTE.
crainte & ſa furie, lors qu’elle luy raconte qu’elle a fait tout ſon poſſible pour detourner l’Infante d’vne afection ſi honteuſe & qui preiudicioit ſi fort à l’Etat.	crainte et sa furie, lors qu'elle avait raconte qu'elle a fait tout son possible pour détourner l'Infante d'une afection si honteuse et qui préjudiciait si fort à l'État.
Il en fait des reproches à D.	Il en fait des reproches à D.
Rodrigue, qui s’excuſant d’vne fauſſeté ſi apparente, par le commandement du Roy fait des protestations d’amour à l’Infante.	Rodrigue, qui s'excusant d'une fausseté si apparente, par le commandement du Roi fait des protestations d'amour à l'Infante.
Cellecy ne croiant pas qu’il y eut lieu de ſoupçon dans cette afaire, respond à ſes ciuilitez, & à ſes complimens, & comme elle auoit beaucoup d’amour, elle en témoigna beaucoup auſſi.	Celleci ne croyant pas qu'il y eut lieu de soupçon dans cette afaire, répond à ses civilités, et à ses compliments, et comme elle avait beaucoup d'amour, elle en témoigna beaucoup aussi.
Le Roy pour les toucher de pitié donne dans ce reſſentiment le Sceptre mais en fin Rodrigue eſt mené priſonnier ſans aucun reſpect, & ſans conſideration des ſeruices qu’il auoit rendus.	Le Roi pour les toucher de pitié donne dans ce ressentiment le Sceptre mais en fin Rodrigue est mené prisonnier sans aucun respect, et sans considération des services qu'il avait rendus.
D.	D.
Diegue, & Chimene le voiant ſans liberté, demandent celle de le voir en priſon, & de decouurir la verité.	Diègue, et Chimène le voyant sans liberté, demandent celle de le voir en prison, et dé couvrir la vérité.
Ce que le Roy leur aecorda, mais dans la reſolution pourtant de ne rien eſpargner pour le chaſtiment de ſa faute.	Ce que le Roi leur aecorda, mais dans la résolution pourtant de ne rien épargner pour le châtiment de sa faute.
ARCIET LE ROY, LEONOR, D.	ARCIET LE ROY, LEONOR, D.
RODRIGVR' L'INFANTE, D.	RODRIGUR L'INFANTE, D.
DIEGVE, CHIMENE, D.	DIGUE, CHIMENE, D.
SANCHE.	SANCHÉ.
SCENVT I.	SCENUT I.
LEROY à Leonor.	LEROY à Leonor.
Ermets au nom des Dieux que mon ame ſoupire, Le le dois cherir l’Infante au deſſus de l'Empire:	Ermets au nom des Dieux que mon âme soupire, Le le dois chérir l'Infante au dessus de l'Empire:
Mais l’ingratte trahit mon plus doux ſentiment, Et d’vn de mes ſuiets elle fait ſon Amant, Ne conſeille plus rien à mon ame abatuë Rodrigue veut ma perte & ma fille me tuë.	Mais l'ingratte trahit mon plus doux sentiment, Et d'un de mes sujets elle fait son Amant, Ne conseille plus rien à mon âme abattue Rodrigue veut ma perte et ma fille me tue.
Cette aueugle obſcurcitl’éclat de mon bon-heur.	Cette aveugle obscurcitl'éclat de mon bonheur.
Et me priuant de vie elle s’oſte l’honneur.	Et me privant de vie elle s'ôte l'honneur.
Ah!	Ah!
c’eſt trop conſulter ie t’apelle à mon aide, Car ſi ie doi guerir la mort eſt mon remede.	c'est trop consulter ici t'appelle à mon aide, Car si tu doi guérir la mort est mon remède.
En penſant m’obliger ru ne m’obliges pas, Tu deſires ma vie & ie veus le trépas, Et ſi ton cœur le craint pource qu’il t’eſt contrere, Ie le veus rechercher comme vn mal neceſſere.	En pensant m'obliger ru ne m'obliges pas, Tu désires ma vie et a veus le trépas, Et si ton cœur le craint pource qu'il t'est contrere, Je le veus rechercher comme un mal nécessère.
L’Infante fait ſa perte, elle m’oſte le iour, Et ma honte commence auecque ſon amour!	L'Infante fait sa perte, elle m'ôte le jour, Et ma honte commence auecque son amour!
Dleux qui m’auez rendu toutes choſes proſperes, Si vous aimez les Rois, aimez vous leurs miſeres?	Dleux qui m'avez rendu toutes choses prospères, Si vous aimez les Rois, aimez vous leurs misères?
Eſt-ce tout le ſecours que vous m’auiez promis?	Est-ce tout le secours que vous m'aviez promis?
Eſtes vous donc mes Dieux, ou bien mes ennemis?	Êtes -vous donc mes Dieux, ou bien mes ennemis?
Ai-ie brizé l’Autel?	Ai-je brisé l'Autel?
ai ie deſtruit vn Temple?	ai ici détruit un Temple?
Le moindre de mes faits eſt-ilpasvn exemple?	Le moindre de mes faits est-ilpasiel exemple?
Vous ai-ie pas connu pour des Dieux tout puiſſans?	Vous ai-je pas connu pour des Dieux tout puissans?
Vous ai-ie quelquefois refuſé des encens?	Vous ai-je quelquefois refusé des encens?
Non, non, mes actions vous ont forcé de croire Que ie n’ay rien commis qui choque voſtre gloire.	Non, non, mes actions vous ont forcé de croire Que tu n'ai rien commis qui choque votre gloire.
Cependant mes reſpects ſont payez de meſpris, Ie veux ſeruir les Dieux i’en uis entrepris, Vne fille s’opoſe à l’éclat de mes armes Et c’eſt mon propre ſang qui fait naiſtre mes larmes.	Cependant mes respects sont payés de mépris, Je veux servir les Dieux j'en uis entrepris, Une fille s'oppose à l'éclat de mes armes Et c'est mon propre sang qui fait naître mes larmes.
Penſer épouuentable!	Penser épouuentable!
a h pere malheureux!	a h ère malheureux!
Le ſort en ton endroit paroiſt bien rigoureux.	Le sort en ton endroit paraît bien rigoureux.
Ce qui cauſa la paix vient me liurer la guerre, Et ce qui m’a remis me combat & m’atterre.	Ce qui causa la paix vient me livrer la guerre, Et ce qui m'a remis me combat et terre.
Mais dy moy Leonor;	Mais dis -moi Leonor;
croi tu que la raiſon, Qui condamne ſon mal faſſe ſa gueriſon?	crois -tu que la raison, Qui condamne son mal fasse sa guérison?
LEONOR.	LEONOR.
Sire, c'eſt y chercher des reſons inutiles, On n’y ſçauroit treuuer des remede faciles.	Sire, c'est y chercher des réons inutiles, On n'y saurait trouver des remède faciles.
Le mal qu’elle entrettent choque ſon iugement, Mais elle y veut chercher quelque ſoulagement.	Le mal qu'elle entrettent choque son jugement, Mais elle y veut chercher quelque soulagement.
L’Infante n’eſtant pas d’humeur à ſe contraindre, Vous pouroit bien donner des ſuiets de vous plaindre.	L'Infante n'étant pas d'humeur à se contraindre, Vous pourrait bien donner des sujets de vous plaindre.
Rodrigue aime Chimene, il n’a point d’autrȩ obiet, Mais lors qu’vne Princeſſe entreprend vn ſuiet;	Rodrigue aime Chimène, il n'a point d'autrȩ objet, Mais lors qu'une Princesse entreprend un sujet;
Que l’honneur & le ſang n’empeſchent point ſa flamme, Et que le deſeſpoir fait des loix à ſon ame, Qu'elle voit la réſon ſans vouloir l’ecouter;	Que l'honneur et le sang n'empêchent point sa flamme, Et que le désespoir fait des lois à son âme, Qu'elle voit la réson sans vouloir l'écouter;
Ah!	Ah!
Sire, vn ſeu ſemblable eſt bien à redouter.	Sire, un seu semblable est bien à redouter.
l'ai fait ce que i’ai pû pour l'y rendre inſenſible, Mais i’ai veu qu’à la fin ie tentois l’impoſſible, Et i’ay creû qu’il eſtoit de ma condition De vous donner auis de certe affection.	l'ai fait ce que j'ai pu pour l'y rendre insensible, Mais j'ai vu qu'à la fin ie tentois l'impossible, Et j'ai cru qu'il était de ma condition De vous donner avis de certe affection.
Elle a cherché Rodrigue, & Rodrigue l’a veuë, Peut eſtre que leur ame a paru toute nuë, Que Rodrigue a ſuiui ſes laches ſentimens, Et qu’il a pû reſpondre à tous les mouuemens.	Elle a cherché Rodrigue, et Rodrigue l'a vue, Peut être que leur âme a parue toute nue, Que Rodrigue a suivi ses lâches sentiments, Et qu'il a pu répondre à tous les mouvements.
LEROY.	LEROY.
Ie le croi Leonor;	Je le crois Leonor;
cecy me met en peine, Mon Sceptre eſt auſſi beau que les yeux de Chimene Dans cette obeiffance il a du lugement, Ma Couronne vaut bien qu’on faſſe vn changement.	ceci me met en peine, Mon Sceptre est aussi beau que les yeux de Chimène Dans cette obéissance il a du lugement, Ma Couronne vaut bien qu'on fasse un changement.
Nagueres luy parlant d'vne telle entrepriſe Son eſprit fut troublé, ſon ame fut ſurpriſe, Et traittant froidement de cette paſſion, Il s'excuſa d'abord ſur ſa condition.	Naguère avait parlant d'une telle entreprise Son esprit fut troublé, son âme fut surprise, Et traitant froidement de cette passion, Il s'excusa d'abord sur sa condition.
Apres tout, Leonor, ſon credit m’épouuante, Pour iouir de mon Sceptre il peut aimer l’Infante.	Après tout, Leonor, son crédit m'épouvante, Pour jouir de mon Sceptre il peut aimer l'Infante.
Rodrigue entre.	Rodrigue entre.
Mais malgré ſa valeur:	Mais malgré sa valeur:
ô Dieux ie l’aperçoi, Aprenons s’il pourſuit & s’il veut eſtre Roy.	ô Dieux Dieux l'aperçoi, Aprenons s'il poursuit et s'il veut être Roi.
SCENE II.	SCÈNE II.
LE ROY, D.	LE ROY, D.
RODRIGVE.	RODRIGUE.
LE ROY.	LE ROY.
Vauez vous donc ſongé qui puiſſe me deſtruire?	Vavez -vous donc songé qui puisse me détruire?
vous occuperezvous dauantage à me nuire?	vous occuperezvous davantage à me nuire?
Deſcendrai-ie apreſent pour vous faire monter?	Descendrai-je après pour vous faire monter?
En fin voſtre deſſein ne peut il s'arreſter?	En fin votre dessein ne peut il s'arrêter?
D’où vient que voſtre humeur abandonne Chimene, Ses yeux vous font ils peur?	D'où vient que votre humeur abandonne Chimène, Ses yeux vous font ils peur?
vous eſt elle inhumene?	vous est elle inhomène?
L’Infante eſt plus facile & pour vn grand guerrler, Ma Couronne en vaut bien vn autre de laurier.	L'Infante est plus facile et pour un grand guerrler, Ma Couronne en vaut bien un autre de laurier.
Conſiderez pourtant que ce point m’eſt ſenſible Et que i’ai touſiours crû qu’il eſtoit impoſſible, On ne ſçauroit donner & receuoir des loix, Et pour porter vn Sceptre il ne faut point deur Roys.	Considérez pourtant que ce point m'est sensible Et que j'ai toujours cru qu'il était impossible, On ne saurait donner et recevoir des lois, Et pour porter un Sceptre il ne faut point deur Rois.
Voſtre ioye en cecy ſeroit mal afſeurée, Vn Etat qu’on diuiſe eſt de peu de durée;	Votre joie en ceci serait mal afseurée, Un Etat qu'on divise est de peu de durée;
ne Pertiand à la fin d’vn abſolu pouuoir Voudroit vne autrefois le perdre ou le rauoir.	ne Pertiand à la fin d'âme absolu pouvoir Voudrait une autrefois le perdre ou le ravoir.
Il eſt vray, ie ſçay bien qu’on vous dût recogneſtre Apres ces beaux exploits que vous fites pareſtre;	Il est vrai, Seigneur sais bien qu'on vous dût reconnaître Apres ces beaux exploits que vous fîtes paraître;
Mais Rodrigue ſongez.	Mais Rodrigue songez.
D.	D.
RODRIGVE.	RODRIGUE.
Que voſtre Majeſté N’imprime point de tache à ma fidelité!	Que votre Majesté N'imprime point de tache à ma fidélité!
Autrefois mon ſecours vous ſembla neceſſaire, Mais Sire ie faiſois ce que ie deuois faire.	Autrefois mon secours vous sembla nécessaire, Mais Sire ici faisais ce que je devais faire.
Rodrigue a ſeulement depuis qu’il voit le tour Du reſpect Du reſpect pour l’Infante & non pas de l’amour.	Rodrigue a seulement depuis qu'il voit le tour Du respect Du respect pour l'Infante et non pas de l'amour.
LE ROY.	LE ROY.
Pour ſçauoir ce miſtere & pour rauir mon ame Deſcouurez à l’Infante vne amoureuſe flâme.	Pour sçauoir ce mystère et pour ravir mon âme Découvrez à l'Infante é amoureuse flamme.
Parlez luy de ſoûpirs, cherchez des compliment, Mettez vous en ſecret au rang de ſes amans, Dites luy maintenant que vous brulez pour elie, que vous citestuiet, mais vir miet fidelle;	Parlez -lui de soupirs, cherchez des compliment, Mettez -vous en secret au rang de ses amants, Dites lui maintenant que vous brûlez pour élie, que vous citestuiet, mais vir miet fidèle;
Ie me tire à l’écart:	Je me tire à l'écart:
elle vient à propos.	elle vient à propos.
D.	D.
RODRIGVE.	RODRIGUE.
Sire, la verité vous va mettre en repos.	Sire, la vérité vous va mettre en repos.
SCENE III.	SCÈNE III.
D.	D.
RODRIGVE, L’INFANTE, LE ROY	RODRIGUE, L'INFANTE, LE ROY
D.	D.
RODRIGVE.	RODRIGUE.
Bautez pour qui mon ame a de l’idolatrie, Et pour qui ſeulement i’ay ſauué ma patrie, I'abandonne Chimene auec iuſte raiſon, 1 A preuuez mon amour par cette trahiſon, Et publiez tour haut qu’il faut que ie vous aime;	Bautés pour qui mon âme a de l'idolâtrie, Et pour qui seulement j'ai sauvé ma patrie, J'abandonne Chimène avec juste raison, 1 A vez mon amour par cette trahison, Et publiez tour haut qu'il faut que je vous aime;
Puis qu’en la trahiſſant ie me trahis moy meſme.	Puis qu'en la trahissant Seigneur me trahis moi -même.
O Dieux!	Ô Dieux!
quevos attraits ont de pouuoir ſur nous, Que vos yeux en tous temps ont de funeſtes coups!	quevos attraits ont de pouvoir sur nous, Que vos yeux en tous temps ont de funestes coups!
Qu’on a de lacheté quand on s’en veut defendre!	Qu'on a de lécheté quand on s'en veut défendre!
Et que dans ce combat il eſt doux de ſe rendre!	Et que dans ce combat il est doux de se rendre!
On ſe pert doucement aupres de vos apas, Et quand on yreſiſte on ne les connoiſt pas:	On se pert doucement auprès de vos appas, Et quand on yriste on ne les connaît pas:
Ie conſidere affezle Sceptre & la Couronne, Ce que vous poſſedez, ce que le Ciel vous donne, Ie remarque vos biens, vos threſors, vos pays.	Je considère affezle Sceptre et la Couronne, Ce que vous possédez, ce que le Ciel vous donne, Je remarque vos biens, vos trésors, vos pays.
Dont l’inſigne grandeur tient mes ſens ébaïs:	Dont l'insigne grandeur tient mes sens ébaïs:
Mais ie cheris en vous malgré cette auanture Bien moins les dons du ſort que les dons de nature.	Mais ici chéris en vous malgré cette aventure Bien moins les dons du sort que les dons de nature.
Ie peche toutefois;	Je pèche toutefois;
ce brazier eternel Me fait voir temeraire, & me rend criminel:	ce brasier éternel m fait voir téméraire, et me rend criminel:
Mais ie bruſle pourtant, & cette flame eſt telle Qu’en depit de la mort ie la iuge immortelle:	Mais ici brûle pourtant, et cette flamme est telle Qu'en dépit de la mort après la juge immortelle:
Votre bon natutel & vos pelteccions Ont ſçeu trop bien flatter mes inclinations.	Votre bon nattutel et vos pelteccions Ont su trop bien flatter mes inclinations.
Dans cete vanité moy méme ie m’acuſe, Auſſi dans ce peché ie ne veux point d’excuſe, Ma vie & mon trépas me feront des ialoux, Pourueu que l’vn des deux ne vienne que de vous.	Dans cette vanité moi -même ie m'acuse, Aussi dans ce péché ie ne veux point d'excuse, Ma vie et mon trépas me feront des jaloux, Pourvu que l'ils des deux ne vienne que de vous.
L'INFANTE.	L'INFANTE.
Que vous me croyez donc ſi contraire à moi-méme, Que de cauſer la mort aux perſonnes que i’aime?	Que vous me croyez donc si contraire à moi-même, Que de causer la mort aux personnes que j'aime?
Païctes en grand guerrier vn autre iugement, Ie viens chercher ici quelque ſoulagement.	Païctes en grand guerrier un autre jugement, Je viens chercher quelque ici soulagement.
Le Ciel nous traittera tous deux de meſme ſorte.	Le Ciel nous traitera tous deux de même sorte.
Si vous croiez mourir, ie me croy deſia morte:	Si vous croyez mourir, ie me crois déjà morte:
Ie vous alme;	Je vous alâme;
bien loin de vous diſſimuler, Vous aprendrez encor que ie me ſens bruler.	bien loin de vous dissimuler, Vous apprendrez encor que Elle me sens brûler.
Le Roy, les Elemens, la longueur des années, Les ſiecles à venir, toutes les deſtinees.	Le Roi, les Éléments, la longueur des années, Les siècles à venir, toutes les destinées.
La chutte de l’Eſtat, & la perte du iour, N’ont rien encore en eux qui changent cétte amoure l'ay bani comme vous le reſpect & la crainte, Et l’honneur netient plus mon eſprit en contrainte.	La chute de l'État, et la perte du jour, N'ont rien encore en eux qui changent cet amoure l'ai bani comme vous le respect et la crainte, Et l'honneur netient plus mon esprit en contrainte.
LE ROY dit cecy bas	LE ROY dit ceci bas
Voicy le pire coup que le reçoi du Ciel, O Dieux mon triſte cœur ne vit rien que de fiel!	Voici le pire coup que le reçois du Ciel, Ô Dieux mon triste cœur ne vit rien que de fiel!
La perfide à ces mots me met dans vn martyre Que je ne ſens que trop, mais que ie n’oze dire.	La perfide à ces mots me met dans un martyre Que je ne sens que trop, mais que sans n'ose dire.
Ma ioye en cét état depend du monument Car ie voy que la mort eſt mon moindre tourment.	Ma joie en cet état dépend du monument Car ie vois que la mort est mon moindre tourment.
SCENE I 1 LE ROY, D.	SCÈNE I 1 LE ROI, D.
RODRIGVE.	RODRIGUE.
L’INFANTE.	L'INFANTE.
ROY.	ROY.
n L Stes vous bien contents?	n L Tes vous bien contents?
toutefois i'aprehende & Que vous n’eſtimiez pas ma ruine affez grande:	toutefois j'appréhende et Que vous n'estimiez pas ma ruine assez grande:
Mais ſi vous conſeruez vn reſte de ralſon Condamnez vous au moins pour cette trahiſon, L’amour qui vous doignoit eſtoit il point capable De rendre en mon endroit vôtre eſprit ſi coupable?	Mais si vous conservez un reste de ralson Condamnez -vous au moins pour cette trahison, L'amour qui vous doignait estoit mille point capable De rendre en mon endroit votre esprit si coupable?
Enfin vous me direz que vos feus inſolens En deuoient alumer d’autres plus violens, Et que tout mon Royaume auſſi bien que vôtre ame Me deuoit faire voir la grandeur de ſa flame.	Enfin vous me direz que vos feus insolents En devaient alumer d'autres plus violents, Et que tout mon Royaume aussi bien que votre âme Me devait faire voir la grandeur de sa flamme.
Puis que ie ne fuis plus aux termes de ſlatter, Et que vous le voulez il faut vous contenter.	Puis que ici ne fuis plus aux termes de slatter, Et que vous le voulez il faut vous contenter.
Il donne le Sceptre à Rodrigue, & la Couronne à l’Infante.	Il donne le Sceptre à Rodrigue, et la Couronne à l'Infante.
Prens ce Sceptre perſide;	Prends ce Sceptre perside;
& toi cette Couronne, Ce qu’on me veut oſter enfin ie vous le donne.	et toi cette Couronne, Ce qu'on me veut ôter enfin ie vous le donne.
Mon Sceptre, ma Couronne, & mon throſne, & mon bien.	Mon Sceptre, ma Couronne, et mon trône, et mon bien.
Enfin tout eſt à vous, ie ne poffede rien.	Enfin tout est à vous, ie ne poffede rien.
Ie n’ay plus que ce cœur tirés-le à coupt d’épee.	Je n'ai plus que ce cœur tirez-le à coupt d'épée.
œeſt là que vôtre main deuroit étre occupee:	œêt là que votre main devrait être occupée:
Percez percez ce corps & me faites mourir Puis que c’eſt par ma mort que vous croiez guerir.	Percez percez ce corps et me faites mourir Puis que c'est par ma mort que vous croyez guérir.
Acheuez contre moy le feu qui vous deuore Vous verrez la dedans ce qui vous aime encore, Et vous plaindrez vn iour vn pere genereux, Qui voudroit que le ciel vous fût moins rigoureux.	Achevez contre moi le feu qui vous dévore Vous verrez la dedans ce qui vous aime encore, Et vous plaindrez un jour père généreux, Qui voudrait que le ciel vous fut moins rigoureux.
D.	D.
RODRIGVE.	RODRIGUE.
Il met leSceptre aux pieds du Roy.	Il met leSceptre aux pieds du Roi.
Ce Sceptre trop peſant s'il faut qu’on le ſoutienne Choiſiffez vne main plus forte que la mienne, l'aurois mauuaiſe grace à vous le demander;	Ce Sceptre trop pesant s'il faut qu'on le soutienne Choisiffez une main plus forte que la mienne, l'aurais mauvaise grâce à vous le demander;
Qui ne ſçait point ſeruir ne doit point commander.	Qui ne sait point servir ne doit point commander.
Mais Sire dans ces jeux il ſemble qu’on me braue, Ne m’ofrez vous ceci que pour me rendre eſclaue?	Mais Sire dans ces jeux il semble qu'on me brave, Ne m'ofrez -vous ceci que pour me rendre esclaue?
Pourquoy me traîtte-t’on d’vn ſemblable mépris?	Pourquoi me traîtte-tte-on d'un semblable mépris?
Dans ces conruſons le me treuue lurpris, Croiez vous ou ma honte, ou ma mort neceſſere?	Dans ces conrusons le me trouve lurpris, Croyez -vous ou ma honte, ou ma mort nécessère?
LE ROY.	LE ROY.
Tel ſouuent cherche vn bien qui treuue le cõtraire, Mais le Ciel qui voit tout en diſpoſe autrement.	Tel souvent cherche un bien qui trouve le cactraire, Mais le Ciel qui voit tout en dispose autrement.
Ses arreſts ne ſont pas de nôtre intelligence, Nos plus grands mouuemens & noſtre diligence, Nos vœux & nos deſirs, qui ſemblent ſi ſecrets, Bref rien ne peut changer ſes ſouuerains decrets.	Ses arrêts ne sont pas de notre intelligence, Nos plus grands mouvements et notre diligence, Nos vœux et nos désirs, qui semblent si secrets, Bref rien ne peut changer ses souuerains décrets.
Vos deſſeins ſont rompus, vôtre eſperãce eſt morte, Conduiſez deſormais vôtre eſprit d’autre ſorte.	Vos desseins sont rompus, votre espérance est morte, Conduisez désormais votre esprit d'autre sorte.
L’INFANTE.	L'INFANTE.
Dans ce premier abord que i’ay d’eſtonnement!	Dans ce premier abord que j'ai d'étonnement!
Dieux que dois je penſer d’vn tel euenement?	Dieux que dois je penser d'un tel événement?
Ie vous rends la Couronne, & vous me voyez preſte De la mettre à vos pieds pluſtoſt que ſur ma reſte.	Je vous rends la Couronne, et vous me voyez prête De la mettre à vos pieds plutôt que sur ma reste.
Et de quelque bon heur qu’on oblige mes iours, Si vous ne les aimez i’en borneray le cours.	Et de quelque bon heur qu'on oblige mes jours, Si vous ne les aimez j'en bornerai le cours.
d I x8 Tu viens croiſtre mon mal lors que tu me conſoles, Tes noires actions dementent tes paroles:	d I x8 Tu viens croître mon mal lors que tu me consoles, Tes noires actions démentent tes paroles:
Voy ie pas à mes yeux ce qu’on ne peur nier?	Vois -si pas à mes yeux ce qu'on ne peur nier?
Qu’on ſaiſifſe Rodrigue & qu’il ſoit priſonnier;	Qu'on saisifse Rodrigue et qu'il soit prisonnier;
D.	D.
RODRIGVE.	RODRIGUE.
Le grand nombre à la fin me pourtoit bien contraindre, On prend Rodrigue, Sçachez que tout captif ie ſuis encor à craindre Ah!	Le grand nombre à la fin me pourrait bien contraindre, On prend Rodrigue, Sachez que tout captif ie suis encor à craindre Ah!
vous m’auez ſurpris, & ma captiuité Fait maintenant ma rage & voſtre ſeureté C’eſt en vain reſiſter, leur perte eſt impoſſible.	vous m'avez surpris, et ma captivité Fait maintenant ma rage et votre sûreté C'est en vain résister, leur perte est impossible.
Ie me treuue impuiſſant & non pas inſenſible, Mon courage en ces lieus a tort de m’accuſer, Aulourd’huy i’ay des mains & ie n’en puis vſer.	Je me trouve impuissant et non pas insensible, Mon courage en ces lieus a tort de m'accuser, Aulourd'hui j'ai des mains et un n'en puis user.
Pour moy chaque combat eſtoit vne victoire, Chaque champ de bataille eſtoit vn chãp de gloire, Rien ne m’eſtoit contraire, & quantité de Rois Ont ſenti mon pouuoir & flechi ſous mes loix:	Pour moi chaque combat était une victoire, Chaque champ de bataille était un chang de gloire, Rien ne m'était contraire, et quantité de Rois Ont senti mon pouvoir et fléchi sous mes lois:
La fortune auiourd’huy metourne leviſage.	La fortune aujourd'hui metourne levisage.
Et mon cœur & mes bras ont perdu leur vſage.	Et mon cœur et mes bras ont perdu leur usage.
Deſtins qui gouuernez nos eſprits & nos corps Que pour nôtre mal heur vous auez des reffors!	Détins qui gouvernez nos esprits et nos corps Que pour notre mal heur vous avez des ressors!
Tantoſt pour mes ſuiets ie n’auois que des Princes, I’auois ſurpris desforts plus grands que des Prouinces, Maintenant ie n'ayrien, & le ſuis à ce point Que le plus miſerable a ce que ie n’ai point.	Tantôt pour mes sujets autres n'avais que des Princes, J'avais surpris desforts plus grands que des Provinces, Maintenant ie n'airien, et le suis à ce point Que le plus misérable à ce que je n'ai point.
Acheuez Dieux ingrats, que i’épreuue le reſte, Ay ie encore à ſentir quelque trait plus funeſte?	Achevez Dieux ingrats, que j'épreuve le reste, A ie après à sentir quelque trait plus funeste?
Auez vous d’autres lieux à me precipiter ?	Avez -vous d'autres lieux à me précipiter ?
Montrez vôtre courroux, ie ne puis l’euiter.	Montrez votre courroux, ie ne puis l'éviter.
Le deſſein de mourir m’a tantoſt fait reſoudre, A ne craindre plus rien, à rire de la foudre.	Le dessein de mourir m'a tantôt fait résoudre, À ne craindre plus rien, à rire de la foudre.
A mépriſer vos coups, à deffier vos mains Dont vous ſemblez touſiours menaſſer les humains.	À mépriser vos coups, à défier vos mains Dont vous semblez toujours menacer les humains.
Bref à vous faire voir pour vn tourment ſi rude Que vous deuez rougir de voſtre ingratitude, Que des Dieux comme vous ſont des Dieux impuiſſans, Et qu’auſfi bien que nous vous eſtes languiffans.	Bref à vous faire voir pour un tourment si rude Que vous devez rougir de votre ingratitude, Que des Dieux comme vous sont des Dieux impuissants, Et qu'aussi bien que nous vous êtes languissants.
On verra dans l’Eſtat des flames bien plus viues, Auſſitoſt que mes mains ne ſeront plus oiſiues;	On verra dans l'État des flammes bien plus vives, Aussitôt que mes mains ne seront plus oisives;
Ma fureur quelque iour rabatra ces efforts, Ie ne veux que ces bras pour briſer tout ce corps.	Ma fureur quelque jour rabatra ces efforts, Je ne veux que ces bras pour briser tout ce corps.
Mais Fernand fait ſon mal dans ce mal-heur ex.	Mais Fernand fait son mal dans ce malheur ex.
tréme, Et me penſant punir il ſe punit ſoy même, Il ruine l’Eſtat de l’vn à l’autre bout, Gar n’ayant plus Rodrigue il n’a plusrien du tout.	trême, Et me pensant punir il se punit soi -même, Il ruine l'État de l' a autre bout, Gar n'ayant plus Rodrigue il n'a plusrien du tout.
Mon eſprit le ſuſura quoy qu’il veuille entreprendre, Qu’il entre dans l’Enfer ie ſuis preſt d’y deſcendre, Ou qu’il cherche à la fin le lieu le plus ſecret, Ie veux en me voiant qu’il meure de regret.	Mon esprit le susura quoi qu'il veuille entreprendre, Qu'il entre dans l'Enfer votre suis prêt d'y descendre, Ou qu'il cherche à la fin le lieu le plus secret, Je veux en me voyant qu'il meure de regret.
SCENE DE ROI, D.	SCÈNE DE ROI, D.
RHAVF, CHIMENE.	RHAUF, CHIMENE.
LE ROY.	LE ROY.
G E feu deuoit paffer;	G E feu devait passer;
mais dites-mol, Madame, Verra t’on point paffer võtre indiſcrete flâme?	mais dites-mol, Madame, Verra -t-on point passer vue indiscrète flamme?
Qu’auez-vous entrepris?	Qu'avez-vous entrepris?
1 D.	1 D.
DIEGVE, voiant mener Rodrigue en priſon.	DIÉGUE, voyant mener Rodrigue en prison.
Quel ſenſible tourment!	Quel sensible tourment!
Dleux sontraine moinis,	Dleux sontraine moinis,
CHIMENE.	CHIMENE.
on traine mon amant.	on traine mon amant.
D.	D.
LC E.	LC E.
0 Slte, qu'a fait Rodrigue?	0 Slte, qu'a fait Rodrigue?
auez vous point enuie, Qu’aujourd’hui le perdant ie perde auſſi la vie?	avez -vous point envie, Qu'aujourd'hui le perdant tu perde aussi la vie?
Nagueres, quel guerrier a fini nos mal-heurs?	Naguères, quel guerrier a fini nos malheurs?
Quelles puiſſantes mains ont eſſuié nos pleurs?	Quelles puissantes mains ont essuyé nos pleurs?
Qui releua l'Eſtat d'vne ſi lourde chutte Au point que le mal heûr nous tenoit tous en butte?	Qui releva l'État d'une si lourde chute Au point que le mal heûr nous tenait tous en butte?
Quì vous preſta le bras quand vous crûtes tomber?	Quoi vous prêta le bras quand vous crûtes tomber?
Et qui nous obligea, tous preſts de ſuccomber?	Et qui nous obligea, tous prêts de succomber?
A IM ENE.	À IM ENE.
SIIM Ah!	SIIM Ah!
Sire, c’eſt Rodrigue.	Sire, c'est Rodrigue.
2	2
D.	D.
DIRGVE.	DIRGUE.
O victoire fatale!	Ô victoire fatale!
Qui peut vous eſtablir vne paixgenerale?	Qui peut vous établir une paixgénérale?
Qui vous peut maintenir contre tant d’étrangers?	Qui vous peut maintenir contre tant d'étrangers?
Et qui peut deſormais vous ſauuer des dangers?	Et qui peut désormais vous sauver des dangers?
Qui peut dans le mal-heur vous ſeruir de retraitte Qui peut rendre à iamais voſtre gloire parfaite?	Qui peut dans le malheur vous servir de retraite Qui peut rendre à jamais votre gloire parfaite?
Qui semonen lomere tee qur par tant defforts Bit pour noſtre ſalut tant de monceaux de morts.	Qui semon lomère teint qur par tant déforts Bit pour notre salut tant de monceaux de morts.
CHIMENE.	CHIMENE.
Ad!	Ad!
Sire c’eſt Rodrigue.	Sire c'est Rodrigue.
LE ROY.	LE ROY.
Vn tel cœur m'épouuente?	Un tel cœur m'épouvante?
Rodrigue peut beaucoup pouuãt tout ſur l’Infante.	Rodrigue peut beaucoup pouuãt tout sur l'Infante.
P'admire ſes exploits, i’eſtime ſa valeur, Puis qu’elle m’a tiré d’vn viſible malheur Chimene, comme vous ie connois ſon courage, La mort de voſtre pere en eſt vn témoignage, V ous l’en loüez ma fille, & vous auez raiſon, Car vos reſſentimens ſe font voir en ſaiſon.	P'admire ses exploits, j'estime sa valeur, Puis qu'elle m'a tiré d'un visible malheur Chimène, comme vous ie connais son courage, La mort de votre père en est un témoignage, V ous l'en louez ma fille, et vous avez raison, Car vos ressentiments se font voir en saison.
Vous l’auez eſtimé, vous l’eſtimez encore, Depuis qu’il a vaincu, voſtre pere & le More, Il a tué le Comte, il mourut pour l’honneur, C’eſt pourquoy vous deuez procurer ſon bon-heurs Mais parlons ſainement, qui peut aimer ma fille, Afin de commander à toute la Caſtille?	Vous l'avez estimé, vous l'estimez encore, Depuis qu'il a vaincu, votre père et le More, Il a tué le Comte, il mourut pour l'honneur, C'est pourquoi vous devez procurer son bonheurs Mais parlons sainement, qui peut mer ma fille, Afin de commander à toute la Castille?
Dom Diegue, C’eſt Rodrigue;	Dom Diègue, C'est Rodrigue;
& par ce traict d'amour Qui peut ſe rendre indigne & des Dieux & du iour?	et par ce trait d'amour Qui peut se rendre indigne et des Dieux et du jour?
C’eſt Rodrigue Chimene.	C'est Rodrigue Chimène.
Il eſt vray, ie l’aduoüe Rodrigue eſt genereux, tout le monde le loüe, Mais ſuborner l'Infante, vſurper ſur ſes ſens Vn pouuoir tyranique, & des droits ſi puiffans, Pratiquer cent moyens, s’aſſeurer de retraittes Pour rendre inſolemment ſes flãmes plus ſecrettes.	Il est vrai, venir l'aduoüe Rodrigue est généreux, tout le monde le loue, Mais suborner l'Infante, usurper sur ses sens Un pouvoir tyranique, et des droits si puissants, Pratiquer cent moyens, s'assurer de retraites Pour rendre insolemment ses flammes plus secrètes.
C’eſt relaſcher vn peu de ſa fidelité, Et prendre à mon aduis beaucoup d’authorite,	C'est relâcher un peu de sa fidélité, Et prendre à mon avis beaucoup d'autorité,
D.	D.
DIEGVE.	DIEGUE.
Beut eſtre qu'vn raport.	Beut être qu'un rapport.
LEROY.	LEROY.
I'en dois croire ma veuë, Son ame à ſon reſpect ſe fit voir toute emeuë.	J'en dois croire ma vue, Son âme à son respect se fit voir toute émue.
L eonor le ſçait bien.	 Lonor le sait bien.
D.	D.
DIEGVE.	DIEGUE.
Sire pour le ſçauoir Permettez moy du moins le bon heur de le voir, En ce cas ſon mal-heur n’aura point de refuge, Et ie ſeray dés l’heure & ſon pere & ſon iuge.	Sire pour le savoir Permettez moi du moins le bon heur de le voir, En ce cas son malheur n'aura point de refuge, Et personne serai dès l'heure et son père et son juge.
CHIMERRI Sire puis que mon ame a la meſme ferueur:	CHIMERI Sire puis que mon âme a la même ferveur:
Pourai-je pas iouyr de la méme faueur?	Pourrai-je pas jouir de la même faveur?
E R 9Y.	E R9 9Y.
Voyez le ie le veux;	Voyez le Prince le veux;
mais Dom Diegue & Chimene, Il dit cecy bas, Ne l'exenteront pur de la peſte prochalne.	mais Dom Diègue et Chimène, Il dit ceci bas, Ne l'exenteront pur de la peste prochalne.
CREMVT.	CREMUT.
CHIMENE ſeule.	CHIMENE seule.
2 NLEN CAIN 7101 N qui doi-le eſperer?	2 NLEN CAIN 7101 N qui dois-le espérer?
creral-ie à ces difcours?	creral-je à ces discours?
D& Et puiſ-ie honneſtement demander du ſecours?	DO Et lors-je honnêtement demander du secours?
.	.
Il n’y faut pas ſonger;	Il n'y faut pas songer;
au mal qui me poſſede La mort eſt le plus ſeur & le plus doux remede.	au mal qui me possède La mort est le plus sûr et le plus doux remède.
Rodrigue eſt en priſon, mon mal eſt infini, Pour auoir ſi bien fait doit il eſtre puni?	Rodrigue est en prison, mon mal est infini, Pour avoir si bien fait doit il être puni?
Le Roy dans ſon mal heur le prit pour ſa defenſe Et maintenant la haine en eſt la recompenſe.	Le Roi dans son mal heur le prit pour sa défense Et maintenant la haine en est la récompense.
O Ciel que doi-ie faire en cette extremité?	Ô Ciel que dois-je faire en cette extrémité?
D.	D.
SANCHR.	SANCHR.
Adame pardonnez à ma remerité, Ie vous treuue touſiours dans des termes de plainte, Vous rencontrez par tout des matieres de crainte, On treuue auecque vous les plus cuiſans malheurs, Vous pouſſez des ſoupirs, vous rependez des pleurs, vous hrumer que les lieux où regnent les tenebres Pour vous entretenir de penſers plus funebres.	Adame pardonnez à ma remerité, Je vous trouve toujours dans des termes de plainte, Vous rencontrez par tout des matières de crainte, On trouve avec vous les plus cuisants malheurs, Vous poussez des soupirs, vous rependez des pleurs, vous hrumer que les lieux où règnent les ténèbres Pour vous entretenir de pensers plus funèbres.
Pour croitre vôtre ennui vous mépriſez le iour, Et vous le haiſſez autant que mon amour.	Pour croître votre ennui vous méprisez le jour, Et vous le haïssez autant que mon amour.
CHIMENE.	CHIMENE.
Ah!	Ah!
c'eſt vn beau moien de conſoler mon ame, Que de m’entretenir de l’excez de ta flame, Adieu, n’y ſonge plus, car c’eſt trop y reſuer.	c'est un beau moyen de consoler mon âme, Que de m'entretenir de l'excès de ta flamme, Adieu, n'y songe plus, car c'est trop y rêver.
D.	D.
SANCHE.	SANCHÉ.
Elle doit à la fin me perdre, ou me ſauuer.	Elle doit à la fin me perdre, ou me sauver.
Fin du quatrieſme Acte.	Fin du quatrième Acte.
ARGVMENT Dd erle TEME	ARGUMENT Déd erle TEME
ACTE.	ACTE.
Q Himene viſite D.	Q Hymène visite D.
Rodrigue en priſon, & le conſole dans l’aſſurance qu’elle lui donne de ſon amour.	Rodrigue en prison, et le console dans l'assurance qu'elle lui donne de son amour.
D.	D.
Arias le fait ſortir, & lui raconte comme le Peuple animé par ſa captiuité, auoit pensé ſe ſoûleuer, & lui dit encore que la verité s’étoit découuerte pour l’inclination de l’Infante, & qu’il eſt eſtimé annocent.	Arias le fait sortir, et lui raconte comme le Peuple animé par sa captivité, avait pensé se soulever, dit lui dit encore que la vérité s'était découverte pour l'inclination de l'Infante, et qu'il est estimé annocent.
D.	D.
Sanche amoureux toliſiours de Chimene, eſt rencontré par l’Infante qui lui promet de toucher l’eſprit de Chimene, & de lui remontrer qu’elle doit faire vn objet d’horreur de Rodrigue, qui auoit cauſé ſa premont portuut Ihfante l’aborde, mais en vain, & elle ne treuue pas auec cette amé reſolue ce qu’elle s’étoit proposé auparauant.	Sanche amoureux tolisiours de Chimène, est rencontré par l'Infante qui lui promet de toucher l'esprit de Chimène, et de lui remontrer qu'elle doit faire un objet d'horreur de Rodrigue, qui avait causé sa premont portu Ihante l'aborde, mais en vain, et elle ne trouve pas avec cette amoue résolue ce qu'elle s'était proposé auparavant.
Pour lui faire haïr re haïr Rodrigue, elle l’aborde auec beaucoup de ciuilitez, & auec des proteſtations d’amour nompareilles.	Pour lui faire haïr rejet haïr Rodrigue, elle l'aborde avec beaucoup de civilités, et avec des protestations d'amour nompareilles.
Rodrigue conſiderant ſa condition & ſa naiſſance lui répond aſſez honneſtement:	Rodrigue considérant sa condition et sa naissance lui répond assez honnêtement:
ce qui lui donne auantage d’en auertir Chimene, qui commençant à ſoupçonner l’infidelité de ſon amant, ſemble ſe porter à toutes les extremitez.	ce qui lui donne avantage d'en avertir Chimène, qui commençant à soupçonner l'infidélité de son amant, semble se porter à toutes les extrémités.
Elle eſt appaiſée neantmoins par ſes paroles, & là verité détrompe ſes ſens.	Elle est apaisée néanmoins par ses paroles, et là vérité détrompe ses sens.
D.	D.
Sanche rencontrant Chimene auec Rodrigue la veut ſuiure, mais il ſe treuue ſeul auet Rodrigue, non content d’auoir épreuué ſi ſouuent ſa bonté & ſon courage, il l’attaque & en eſt deſarmé:	Sanche rencontrant Chimène avec Rodrigue la veut suivre, mais il se trouve seul auet Rodrigue, non content d'avoir épreuué si souvent sa bonté et son courage, il l'attaque et en est désarmé:
l’Infante les treuuant en cét état, ayant apris que Rodrigue diſputoit encore Chimene, ſort dans le dejfeuir de un cuers ams euc uutreuus auee le Roi qui empéche cette reſolution, & qui fait enfin le mariage de Chimene & de Rodrigue.	l'Infante les trouvant en cet état, ayant apprendre que Rodrigue disputait encore Chimène, sort dans le dejfeuir de un cuers ams euc utreues auee le Roi qui empêche cette résolution, et qui fait enfin le mariage de Chimène et de Rodrigue.
ANCLE D.	ANCLE D.
RODRIGVE, CHIMENE, D.	RODRIGUE, CHIMENE, D.
ARIAS, L’INFANTE, D.	ARIAS, L'INFANTE, D.
SANCHE.	SANCHÉ.
SCENE I.	SCÈNE I.
D.	D.
RODRIGVE CHIMENE, D.	RODRIGUE CHIMENE, D.
RODRIGVE, en priſon.	RODRIGUE, en prison.
& H!	et H!
qu’on rend ton ame contente!	qu'on rend ton âme contente!
Qu’on te procure de plaiſirs!	Qu'on te procure de plaisirs!
Et que tes plus iuſtes deſirs gone iuiuis d vne douce accehte!	Et que tes plus justes désirs gone juivis d ' douce acceh!
Rodrigue, tu ſauues le Roy, Tes faits font preuue de ta foy, Et malgré ta valeur que tout le monde vante Tes traitsont tombé deſſustoy.	Rodrigue, tu sauves le Roi, Tes faits font preuve de ta foi, Et malgré ta valeur que tout le monde vante Tes traitsont tombé dessustoi.
CHIMENE.	CHIMENE.
Ah!	Ah!
qu’on rend mon ame contente!	qu'on rend mon âme contente!
Qu’on me procure de plaiſirs, Et que mes plus iuſtes deſirs Sont ſuiuis d’vne douce attente!	Qu'on me procure de plaisirs, Et que mes plus justes désirs Sont suivis d'une douce attente!
Rodrigue tu ſauues le Roy, Tes faits font preuue de ta foy;	Rodrigue tu sauves le Roi, Tes faits font preuve de ta foi;
Et malgré ta valeur que tout le monde vante, Ces tralts tomberont deſſus moy	Et malgré ta valeur que tout le monde vante, Ces tralts tomberont dessus moi
D.	D.
RO DRIGVE.	RO DRIGUE.
Que le ſort a peu d'affeurance!	Que le sort a pu d'affeurance!
Que mon deſtin eſt rigoureux, Le Roy me veut voir mal-heureux, En voyant ma perſeuerance:	Que mon destin est rigoureux, Le Roi me veut voir malheureux, En voyant ma persévérance:
Il m’accuſe de laſcheté, Mais dedans cette extremité, huone uu mſonis que la morcamemon eiperance, Et nonpas ma fidelité!	Il m'accuse de lâcheté, Mais dedans cette extrémité, huone u musonis que la morcamemon eipérance, Et nonpas ma fidélité!
CHIMENE.	CHIMENE.
Que le ſort a peu d’affeurance!	Que le sort a pu d'affeurance!
Que le deſtin m’eſt rigoureux!	Que le destin m'est rigoureux!
Le Roy nous veut voir mal-heureux, Voyant noſtre perſeuerance.	Le Roi nous veut voir malheureux, Voyant notre persévérance.
Il m’accuſe de laſcheté!	Il m'accuse de lâcheté!
Mais dedans cette extremité.	Mais dedans cette extrémité.
Sache au moins que la mort finit noſtre eſperance, Et non pas ma fidelité!	Sache au moins que la mort finit notre espérance, Et non pas ma fidélité!
D.	D.
RODRIGVE.	RODRIGUE.
Que ſa rage ſoit aſſouuie, Qu’il tâche d’éteindre mes feux;	Que sa rage soit assouuie, Qu'il tâche d'éteindre mes feux;
Mais malgré ſes inluſtes vœux Ie puis conſeruer mon enuie;	Mais malgré ses inlustes vœux Je puis conserver mon envie;
Ma foy ſurmonte ſa rigueur, Chimene eſt mon obier vainqueur, Par ſa loy tyrannique il peut m’oſter la vie, Mais non pas ton portrait du cœur.	Ma foi surmonte sa rigueur, Chimène est mon obier vainqueur, Par sa loi tyrannique il peut m'ôter la vie, Mais non pas ton portrait du cœur.
CHIMENE.	CHIMENE.
Que ſa rageſoit aſſouuie, Qu’il tâche d’éteindre nos feux, Mαις isεαigre lea IIuRe τoeux Ie dois conſeruer mon enule:	Que sa ragesait assouvie, Qu'il tâche d'éteindre nos feux, Mule isigre lea JIRe τoeux Je dois conserver mon envle:
Ma foy ſurmonte ſa rigueur, Rodrigue eſt mon obiet vainqueur, Ie ſçay bien comme toy qu’on peut m’oſter la vle?	Ma foi surmonte sa rigueur, Rodrigue est mon objet vainqueur, Je sais bien comme toi qu'on peut m'ôter la veule?
Mais non pas ton portrait du cœur.	Mais non pas ton portrait du cœur.
D.	D.
RODRIGVE.	RODRIGUE.
Qu'on me iuge digne de blâme Dans l’excez de ma paſſion, l'aurav la méme affaction Et le méme objet de ma flâme.	Qu'on me juge digne de blâme Dans l'excès de ma passion, l'aurav la même affaction Et le même objet de ma flamme.
Apres tous nos ennemis morts, Apres de ſi nobles efforts, Le Roy me fait captif, mais ſache que mon ameEſt plus captiue que mon corps.	Après tous nos ennemis morts, Après de si nobles efforts, Le Roi me fait captif, mais sache que mon âmeEst plus captive que mon corps.
CHIMENE.	CHIMENE.
Qu'on me iuge digne de blâme Dans l’excez de ma paſſion, l'auray la méme a ffection Et le n'éme objet de ma flâme:	Qu'on me juge digne de blâme Dans l'excès de ma passion, l'aurai la même a section Et le n'même objet de ma flamme:
Apres tous nos ennemis morts, Apres de ſi nobles efforts, Le Roy te fait captif, mais fache que mon ame Eſt plus captiue que ton corps.	Après tous nos ennemis morts, Après de si nobles efforts, Le Roi te fait captif, mais fache que mon âme Est plus captive que ton corps.
SCENE II.	SCÈNE II.
D.	D.
ARIAS, D.	ARIAS, D.
RODRIGVE, CHIMENE.	RODRIGUE, CHIMENE.
8 D.	8 D.
ARIAS.	ARIAS.
L eſt temps d’étoufer ces vains ſulets de plaintes, Q Rapellez vos plaiſirs & baniſſez vos craintes.	L est temps d'étouffer ces vains sulets de plaintes, Q Rapelez vos plaisirs et banissez vos craintes.
C’eſt eſtre trop long temps dans la captluité, Iouiſſez pleinement de vôtre liberté.	C'est être trop long temps dans la captluité, Jouissez pleinement de votre liberté.
Vos mal-heurs ont trainé toute vne populace Qui vient par ſes clameurs d’obtenir voſtre grace.	Vos malheurs ont trainé toute une populace Qui vient par ses clameurs d'obtenir votre grâce.
D.	D.
RODRIGVE.	RODRIGUE.
Cette grace Arias, eſt pour les criminels, Et ie meriterois des tourmens eternels, Si la moindre action m’auoit rendu coupable;	Cette grâce Arias, est pour les criminels, Et tu mériterais des tourments éternels, Si la moindre action m'avait rendu coupable;
Qui peche contre vn Roy doit mourir miſerable, Mais dy quelle maxime, ou bien quelle autre loy Pût ainſi m’attirer la diſgrace du Roy?	Qui pèche contre un Roi doit mourir misérable, Mais dis quelle maxime, ou bien quelle autre loi Pût ainsi m'attirer la disgrâce du Roi?
Ah!	Ah!
les Roys, Arias, ont détranges maximes Qui font ſouuent treuuer leurs pechez legitimes.	les Rois, Arias, ont détranges maximes Qui font souvent trouver leurs péchés légitimes.
Cecy les authoriſe & dedans leurs erreurs Tous leurs refſentimens ſont détranges fureurs.	Ceci les autorise et dedans leurs erreurs Tous leurs ressentiments sont détranges fureurs.
Pour regner ſurement il ſemble neceſſere De ſe faire ainſi craindre & d’eſtre ſanguinere De bâtir ſur du ſang vn foible porentat Et d’eſtre vicieux par maxime d’Eſtat:	Pour régner sûrement il semble nécessère De se faire ainsi craindre et d'être sanguinere De bâtir sur du sang une faible porentat Et d'être vicieux par maxime d'État:
Peut-eſtre quirrité du credit de mon pere Il a craint pour nous deux quelque ſort plus proſpere.	Peut-être quirité du crédit de mon père Il a craint pour nous deux quelque sort plus prospère.
M’ayant vu triompher de tous mes ennemis Il a crû trebucher du thrône ou ie l'ay mis, Et m’enuiant la gloire où tu mas veu parêtre ll a conſideré ce que le pouuoisêtre, Qu'à la fin mes exploits cauſeroient mon orgueil.	M'ayant vu triompher de tous mes ennemis Il a cru trébucher du trône ou beau l'ai mis, Et m'enviant la gloire où tu mas vu paraître ll a considéré ce que le pouvais, Qu'à la fin mes exploits causeraient mon orgueil.
Et que ie luy ferois de ſon thrône vn cercueil.	Et que ie cy ferais de son trône un cercueil.
Mais ſuiſ ie criminel pource qu’il me ſoupçonne?	Mais suis ici criminel pource qu'il me soupçonne?
Pour aimer tant l’honneur en veuſ je à ſa Couronne?	Pour aimer tant l'honneur en veux je à sa Couronne?
Luy meſme s’ofenſa de mon humilité, Et i’ay pris ſans deſſein l’apas qu’il m’a ietté.	Lui même s'ofensa de mon humilité, Et j'ai pris sans dessein l'apas qu'il m'a jeté.
D.	D.
ARIAS.	ARIAS.
Le Roy dans le regret d'vne action ſi pronte, Vient d’embraſſer Dom Diegue & confeſſer ſa honre Et nagueres l’Infante a fait voir elerement, Qu’vn faux raport cauſa vôtre empriſonnement.	Le Roi dans le regret d'une action si prompte, Vient d'embrasser Dom Diègue et confesser sa honre Et naguères l'Infante a fait voir élément, Qu'un faux rapport causa votre emprisonnement.
Il crût vn peu trop toſt, ſon amefut deceüe, L'oreille le troubla de méme que la veuë Le mal qu’il vous a fait c’eſt luy qui le reſſent, En vn mot il vous aime, & vous treuue innocent.	Il crut un peu trop tôt, son âmefut déçue, L'oreille le troubla de même que la vue Le mal qu'il vous a fait c'est même qui le ressent, En un mot il vous aime, et vous trouve innocent.
D.	D.
RODRIGVB.	RODRIGUB.
Tu ſçale bien que le temps de noſtre marlage Eſt tantot expire.	Tu sais bien que le temps de notre marlage Est tantôt expire.
CHIMENE.	CHIMENE.
N'en dis pas dauantage.	N'en dis pas davantage.
D.	D.
RODRIGVE.	RODRIGUE.
Le Roy de tous coſtez doit me donner la paix Autrement la priſon m’eſt autant qu’vn Palais.	Le Roi de tous côtés doit me donner la paix Autrement la prison m'est autant qu'un Palais.
A quelle extremité reduiroit-il mon ame S’il empeſchoit l’effet d’vne ſi iuſte flamme?	À quelle extrémité réduirait-il mon âme S'il empêchait l'effet d'une si juste flamme?
Et que luy ſeruira de m’aller éblouïr Dvn treſor precieux, ſi je n’en puis iouïr?	Et que mille servira de m'aller éblouir Dame trésor précieux, si je n'en puis jouira
C’eſt de vous que dépend cette fortune extréme Madame, mon amour vous demande à vous méme.	C'est de vous que dépend cette fortune extrême Madame, mon amour vous demande à vous -même.
Ne reſiſtez plus tant c’eſt aſſez combatu, Vos pleurs & vos ennuis preuuent vôtre vertu.	Ne résistez plus tant c'est assez combattu, Vos pleurs et vos ennuis preuuent votre vertu.
En ce point ſeulement vous m’eſtes ſecourable Et par là ie rencontre vn deſtin fauorable, I’ay ſurmonté le More & tous nos ennemis, Ils poſſedoient nosbiens, ie les en ai demis, Tout eſtoit en deſordre, & ſoufrez que ie die.	En ce point seulement vous m'êtes secourable Et par là ie rencontre un destin favorable, J'ai surmonté le More et tous nos ennemis, Ils possedoient nosbiens, Se lesen ai eur, Tout es en désordre, et souffrez que Un die.
Que ſeul i’ay mis la fin à cetts Tragedie, Que i’ai ſauuéle peuple, & l'Eſtat & le Roy, Mais que vous en auez plus de gloire que moy.	Que seul j'ai mis la fin à cels Tragédie, Que j'ai sauvé peuple, et l'État et le Roi, Mais que vous en avez plus de gloire que moi.
Le deſir de vous plére auoit cét auantage Que luy ſeul aux combats échaufoit mon courage, Reſeuoit mon eſpoir & mon cœur en tous lieux Et portoitla fureur iuſque dedans mes yeux, Au moindre ſouuenir de ma gloire future Ma force tout d’vn coup ſurpaſſoit ma nature, I’afrontois les hazards, ie brauois lerrépas, Bref vous vainquites tout où vous ne fûtes pas.	Le désir de vous plère avait cet avantage Que lui seul aux combats échaufoit mon courage, Reseuoit mon espoir et mon cœur en tous lieux Et portoitla fureur jusqu' à mes yeux, Au moindre souvenir de ma gloire future Ma force tout d'un coup surpassait ma nature, J'afrontais les hasards, notre bravais lerrépas, Bref vous vainquîtes tout où vous ne fûtes pas.
Car ſans le ſeul eſpoir de poſſeder vos charmes Tune expire cem iois au milieu des alarmes, Et bien loin de chercher des moyens de guerir I’uſſe voulu moy méme en chercher pour mourir.	Car sans le seul espoir de posséder vos charmes Tune expire cem jois au milieu des alarmes, Et bien loin de chercher des moyens de guérir J'usse voulu moi -même en chercher pour mourir.
CHIMENE.	CHIMENE.
Il eſt vray que le Roy preſcriuit vne année Pour mon dueil legitime, & pour noſtre Hymenée, Cetemps eſt bien paſſé, mais non pas ma douleur, paiet-moy plus fulis temps toûpirer ce malheur.	Il est vrai que le Roi prescrivit une année Pour mon deuil légitime, et pour notre Hyménée, Cetemps est bien passé, mais non pas ma douleur, paiet-moi plus fulis temps soupirer ce malheur.
Vousſçauez mon amour, chacun la doit connêtre, Ie n’ai pû m’empeſcher de la faire parêtre, Mais ſoufrez que le ſang.	Voussçauez mon amour, chacun la doit connaître, Je n'ai pu m'empêcher de la faire paraître, Mais souffrez que le sang.
D.	D.
RODRIGVE.	RODRIGUE.
N’acheue pas mon eœur, Fais que beſpoir ſuccede à ma premiere peur, Apres que les ennuis ont fait palir tes roſes, Qu’ils ont fait ſur ton corps tant de metamorp hoſes, Que ton ame a ſenti de ſi viues douleurs, Et qu'enfintes beaux yeux ont versé tant de pleurs, On ne peut deſormais t’eſtimer inſenſible, Aiant fait contre moy ce qui tefut pouible.	N'achève pas mon eœur, Fais que bespoir succède à ma première peur, Après que les ennuis ont fait pâlir tes roses, Qu'ils ont fait sur ton corps tant de métamorp hoses, Que ton âme à senti de si vives douleurs, Et qu'enfintes beaux yeux ont versé tant de pleurs, On ne peut désormais t'estimer insensible, Aiant fait contre moi ce qui tefut pouible.
Dans ce reffentiment eu demandas ma mort, Ta colere irrita la rigueur de mon ſort, Tuvoulus mon trépas;	Dans ce ressentiment eu demandas ma mort, Ta colère irrita la rigueur de mon sort, Toulus mon trépas;
dans l’honneur dete plére, Ie t’obligai moi-meſme à le rendre exemplére, Et lors que ta pitié me ſembla ſecourir, Ie fis deſſein deviure, & ne crus pas mourir.	dans l'honneur de plére, Je t'obligai moi-même à le rendre exemplère, Et lors que ta pitié me sembla secourir, Je fis dessein devivre, et ne crus pas mourir.
Mais dans l’état preſent c’eſt de ta ſeule enuie Que dépend mon trépas, ou ma gloire, ou ma vie, Mifin ta reſiſtence, ou bien vn pront ſecours a oicurreicer mes haua, ou prolonger leur cours.	Mais dans l'état présent c'est de ta seule envie Que dépend mon trépas, ou ma gloire, ou ma vie, Mifin ta résistence, ou bien un pro secours à oicurreicer mes hava, ou prolonger leur cours.
CHIMENE.	CHIMENE.
Ie ne te laiſſe point de matiere de craindre.	Je ne te laisse point de matière de craindre.
Mais tu doy confeſſer que mon mal eſt à plaindre, Que l’honneur & le ſang me contraignent d’agir Contre vn feu qui me brule, & qui me fait rougir, Et que pour dire tout la loi de la nature Condannent mon eſprit dedans cette auanture, Mais maigre ces reſpects ta paſſion me plaiſt, Et i’entretiens mon vœu tout iniuſte qu’il eſt.	Mais tu dois confesser que mon mal est à plaindre, Que l'honneur et le sang me contraignent d'agir Contre un feu qui me brule, et qui me fait rougir, Et que pour dire tout la lois de la nature Condannent mon esprit dedans cette aventure, Mais maigre ces respects ta passion me plaît, Et j'entretiens mon vœu tout injuste qu'il est.
D.	D.
RODRIGVE.	RODRIGUE.
C’eſt dedans ces plêſirs que mon ame ſe nole, Mais tâche d’augmenter, & ma gloire, & ma iole.	C'est dedans ces plésirs que mon âme se nole, Mais tâche d'augmenter, et ma gloire, et ma iole.
Puis que tu veux flatter mes deſirs amoureux, Et que tu me cneris, rend moi donc plus heureux.	Puis que tu veux flatter mes désirs amoureux, Et que tu me cèneris, rend moi donc plus heureux.
Banis de ton eſprit tout ce qui m’importune, Et ne recule plus à ma bonne fortune.	Banis de ton esprit tout ce qui m'importune, Et ne recule plus à ma bonne fortune.
CHIMENE.	CHIMENE.
Ie n’i metraiiamais aucun empeſchement, Ton intereſt me touche aſſez ſenſiblement.	Je n'y metraiiamais aucun empêchement, Ton intérêt me touche assez sensiblement.
Mais ſoufre pour le moins.	Mais souffre pour le moins.
E RODRIOVB.	E RODRIOUB.
Adorable Chimene, Pour empeſcher ma mort tu dois finir ma pêne.	Adorable Chimène, Pour empêcher ma mort tu dois finir ma pêne.
Pais parêtre auiourd’huy ta promeſſe & ta foy.	Pais paraître aujourd'hui ta promesse et ta foi.
CHIMENE.	CHIMENE.
En tout cas le dépends des volontez du Roy.	En tout cas le dépends des volontés du Roi.
D.	D.
RODRIGVE.	RODRIGUE.
Ie vai le ſalüer deffus cette aſſeurance, Ce que l’appreh endois ſe tourne en eſperance, bas,	Je vais le saluer dessus cette assurance, Ce que l'appréh endais se tourne en espérance, bas,
SCENE III.	SCÈNE III.
L’INFANTE, D.	L'INFANTE, D.
SANCHE, L'INFANTE.	SANCHE, L'INFANTE.
1ors) Ous mes ſoins deſormals ſont pour finir les tiens, Iil faudra s’il ce peut la mettre en tes liens, Faire agréer l’Hymen, & ſur tout la contraindre D’apreuuer ce braſier, que tu ne peus éteindre.	1ors) Ous mes soins désormals sont pour finir les tiens, Jil faudra s'il ce peut la mettre en tes liens, Faire agréer l'Hymen, et sur tout la contraindre D'apreuver ce brasier, que tu ne pût éteindre.
Cependant continuë;	Cependant continue;
& par ces mouuemens Fais-toi jour ſi tu peux à tes contentemens.	et par ces mouvements Fais-toi jour si tu peux à tes contentements.
Sois certain que tes vœeux ne ſeront pas rrruoles, Si Chimene eſt d’humeur à crêre à mes paroles.	Sois certain que tes vœux ne seront pas ruruoles, Si Chimène est d'humeur à crêvre à mes paroles.
Ie parlerai de toi ſi bien & ſi ſouuant, Qu’elle t’eſtimera quelque bucher viuant.	Je parlerai de toi si bien et si souvant, Qu'elle t'estimera quelque bûcher vivant.
D.	D.
SANCHE.	SANCHÉ.
Pourrois ie bien, Madame, en cette attente haute, eſperer le repos de celle qui me l’oſte!	Pourrais ie bien, Madame, en cette attente haute, espérer le repos de celle qui me l'ôte!
Pourſuiure auec ardeur la choſe qui me nuit!	Poursuivre ici ardeur la chose qui me nuit!
Et tirer mon bon heur de ce qui le dérruie!	Et tirer mon bon heur de ce qui le dérruie!
Deurois je auſſi, Madame, en cette amour extréme, Parler ſi librement de la beauté que i'aime?	Deurais -je aussi, Madame, en cette amour extrême, Parler si librement de la beauté que j'aime?
En ceci mon eſprit vous eſt-il point ſuſpect?	En ceci mon esprit vous est-il point suspect?
Que direz-vous enfin de mon peu de reſpect?	Que direz-vous enfin de mon peu de respect?
Pour rendre mon amour, & ma gloire éuidente, Ce qui fut ma Princefſe eſt donc ma confidente?	Pour rendre mon amour, et ma gloire évidente, Ce qui fut ma Princefse est donc ma confidente?
Madame, pardonnez à cette liberté, Ie n’abuſeral pas d’vne telle bonté:	Madame, pardonnez à cette liberté, Je n'abuseral pas d'une telle bonté:
Au contraire bien loin d’entirer auantage, En vous obeïſſant, ie manque de courage:	Au contraire bien loin d'entirer avantage, En vous obéissant, tu manque de courage:
Ie ſuis de ces faueurs vn trop indigne objes, ous treuue Princeſſe, & ie me voi ſujet, Ma bafſeſſe paroiſt prés de vôtre merite, Vôtre naiffance eſt grande, & la mienne eſt petite:	Je suis de ces faveurs un trop indigne objes, ous trouve Princesse, et toujours me voi sujet, Ma bassesse paraît près de votre mérite, Votre naissance est grande, et la mienne est petite:
Et le pis en ceci, m’obligeant deſormals, Vous faites vn ingrat à force de bienfaits.	Et le pis en ceci, m'obligeant désormals, Vous faites un ingrat à force de bienfaits.
Entre ces mouuemens ie me ſens tout conſondre, Ie n’oſerois me taire, & ie ne puis répondre.	Entre ces mouvements on me sens tout consondre, Je n'oserais me taire, et toujours ne puis répondre.
L’INFANTE.	L'INFANTE.
Adieu, ſonge à Chimene, & ſur tout ſouulens tola Que ie trauaillerai de meme que pour moi.	Adieu, songe à Chimène, et sur tout souulents tola Que femme travaillerai de meme que pour moi.
SCENE IV.	SCÈNE IV.
LINFANTE ſeule.	LINFANTE seule.
2	2
PE) Ans doute ſon amour doit ſeruir à la mienne &Il faut que ie l’augmente, & que ie l’entretienne, Que le treuue la fin des mauxque i’ai ſoufers, Que ie mefaſſe libre en détachant ſes fers, Et que malgré le Roy, qui condamne ma vie, Ie meure deſormais dans ma premiere enuie.	PE) Ans doute son amour doit servir à la mienne eTIl faut que je l'augmente, et que sans l'entretienne, Que le trouve la fin des mauxque j'ai soufferts, Que me défasse libre en détachant ses fers, Et que malgré le Roi, qui condamne ma vie, Je meure désormais dans ma première envie.
Mes pleurs l’ont amoli, mes ſoûpirs l’ont touché, Il croit en m’acuſant auoir fait vn peché, Et de peur d’obſcurcir nôtre parfaite gloire, Il veut mal à ſes ſens, il blâme ſa memoire, Et dans le repentir d’vn pareil iugement, Il me traicte depuis prus amouremſement.	Mes pleurs l'ont amoli, mes soupirs l'ont touché, Il croit en m'acusant avoir fait un péché, Et de peur d'obscurcir notre parfaite gloire, Il veut mal à ses sens, il blâme sa mémoire, Et dans le repentir d'un pareil jugement, Il me traite depuis prus amouremissement.
Tout arriue à propos, voici venir Chimene.	Tout arrive à propos, voici venir Chimène.
Rendra-t’elle touiours mon eſperance vaine?	Rendra-t-elle toujours mon espérance vaine?
SCENEV.	SCENEU.
L’INFANTE, CHIMENE.	L'INFANTE, CHIMENE.
2 u* L’INFANTE.	2 * L'INFANTE.
Nfin le Ciel vous aime auec vn tel excez, Que vos plus grande deſirs ne ſont pas ſans ſuccez.	Nfin le Ciel vous aimez avec un tel excès, Que vos plus grande désirs ne sont pas sans succès.
CHIMENE.	CHIMENE.
I’ai touiours ſounaitté que l’atatrut uurable, Que le ſort à nos maux ſe montrât ſecourable, Que le Ciel à iamês vous comblât de plêſirs, Bt qu’il me donnât lieu de fairevos deſirs.	ai touiours sounaitté que atatrut uurable, Que le sort nos maux se montrât secourable, Que le J' ai iamês vous souhait de plêsirs, quil me donnât lieu ' fairevos désirs.
L’INFANTE.	L'INFANTE.
Puis que vous le voulez il faut que ie l’effaie, Et vous me rauirez, ſi la rêponſe eſt vraie.	Puis que vous le voulez il faut que ici l'effaie, Et vous me ravirez, si la réponse est vraie.
Vous deuez donc, ma fille, en cette occaſion Témoigner vos vertus & vôtre afection.	Vous devez donc, ma fille, en cette occasion Témoigner vos vertus et votre afection.
Songez-y bien ſur tout, Rodrigue vous honore, Vous ſçauez d’autre part que Sanche vous adore:	Songez-y bien sur tout, Rodrigue vous honore, Vous savez d'autre part que Sanche vous adore:
L’vn tua vôtre pere, & l’autre vous vangea, L’vn fit naitre vos pleurs, l’autre vous ſoulàgea.	L'un tua votre père, et l'autre vous vengea, L'un fit naître vos pleurs, l'autre vous soulàgea.
Ce n’eſt pas le moien de finir ſa miſere, Que d’épouſer ainſi le boureau de ſon pere:	Ce n'est pas le moyen de finir sa misère, Que d'épouser ainsi le boureau de son père:
Il vous faut par raiſon guerir de cét erreur, Et d’vn objet d’amourfaire vn objet d’horreur.	Il vous faut par raison guérir de cet erreur, Et d'un objet d'amourfaire un objet d'horreur.
Qui peut authoriſer la noirceur de ce crime?	Qui peut autoriser la noirceur de ce crime?
Et qui fera treuuer cette amour legitime?	Et qui fera trouver cette amour légitime?
Eſt ce bien proceder que fonder ſon bon heur?	Est -ce bien procéder que fonder son bon heur?
Et chercher ſon repos aux dépens del’honneur?	Et chercher son repos aux dépens dél'honneur?
Etoufez cette ardeur, & cette iniuſte enuie, Bt tenez He tenez vôtre honneur plus cher que võtre vie, Malgré ces mouuemens i’aime ce qui vous plaiſt, Mais ſoufrez qu’en ceci i’aime vôtre intereſt:	Étouffez cette ardeur, et cette injuste envie, Bout tenez He tenez votre honneur plus cher que vendre vie, Malgré ces mouvements j'aime ce qui vous plaît, Mais souffrez qu'en ceci j'aime votre intérêt:
Rodrigue a des apas, vous en faites du conte, Mais faiſant vôtre bien vous faites vôtre honte, ne vous donmesiuleta la poicerise D'accuſer iuſtement voſtre infidelité.	Rodrigue a des apât, vous en faites du conte, Mais faisant votre bien vous faites votre honte, ne vous donmesivleta la poicerise D'accuser justement votre infidélité.
CHIMENE.	CHIMENE.
Madame la raiſon qui condamnoit ma flâme A perdu tout l’efet qu’elle auoit ſur mon ame, Connefſant mon amour, vous ſçauez que ie dol Conſeruer mon honneur en conſeruant ma foy, Et méme par le Roy ie me vis obligée De garder cette ardeur où i’eſtois engagée.	Madame la raison qui condamnait ma flamme A perdu tout l'efet qu'elle avait sur mon âme, Connefsant mon amour, vous savez que je dol Conserver mon honneur en conservant ma foi, Et même par le Roy ie me vis obligée De garder cette ardeur où j'étais engagée.
Icy Rodrigue paroit, & l’Infante fait retirer Chimene pour lui faire entendre ce qui ſuit.	Ici Rodrigue parait, et l'Infante fait retirer Chimène pour lui faire entendre ce qui suit.
L’INFANTE.	L'INFANTE.
Tu penſes que Rodrigue eſtime ta vertu, 12 Mais voi les mouuemens dont il eſt combatu.	Tu penses que Rodrigue estime ta vertu, 12 Mais voi les mouvements dont il est combattu.
SCENE VI.	SCÈNE VI.
L’INFANTE, D.	L'INFANTE, D.
RODRIGVE	RODRIGUE
L'INFANTE.	L'INFANTE.
Epuis les complimens dont vous m’auez traittée, L’amour me ſuit par tout;	Epuis les compliments dont vous m'avez traitée, L'amour me suit par tout;
i’en ſuis perſecutée, Et quoi que la raiſon s’opoſe à tous mes vœux, L’honneur & le reſp ect n’étoufent point mes feux, Et i'ai voulu banir ces noms de ma memoire, Comme les principaux ennemis de ma gloires Y al reliite long-cemps, mais eninl’aiconclu De vous voir ſur mes ſens vn pouuoir abſolu, Et qu’en vain deſormais ie me voulois contraindre, Pour celuy que la terre a tant ſujet de craindre.	j'en suis persécutée, Et quoi que la raison s'oppose à tous mes vœux, L'honneur et le resp ect n'étoufent point mes feux, Et j'ai voulu bannir ces noms de ma mémoire, Comme les principaux ennemis de ma gloires Y al reliite longtemps, mais eninl'aiconclu De vous voir sur mes sens un pouvoir absolu, Et qu'en vain désormais sans me voulais contraindre, Pour celui que la terre a tant sujet de craindre.
D.	D.
RODRIGVE.	RODRIGUE.
Madame cét honneur m’oblige infiniment, Vous ſçaurez à la fin que ie ſuis digne Amant.	Madame cet honneur m'oblige infiniment, Vous saurez à la fin que je suis digne Amant.
LNFANTE.	LNFANTE.
En ſortant dit cecibas à Chimene.	En sortant dit cecibas à Chimène.
Vous voyez apres tout que Rodrigue eſt fidelle, Et qu’il faut conſeruer vne flâme ſi belle.	Vous voyez après tout que Rodrigue est fidèle, Et qu'il faut conserver une flamme si belle.
SCENE VII.	SCÈNE VII.
CHIMENE, D.	CHIMENE, D.
RODRIGVE.	RODRIGUE.
CHIMENE.	CHIMENE.
OVS ſçaurez à la ſin que ie ſuls digne Amant, θυsς C’eſt comme il faut finir ou flatter mon tourment;	OUS Saurez à la sin que je suls digne Amant, θυsς est comme il faut finir ou flatter mon tourment;
Pourſuiuez Dom Rodrigue, & careſſez l’Infante, La couronne pour vous eſt vne douce attente.	Poursuivez Dom Rodrigue, et caressez l'Infante, La couronne pour vous est une douce attente.
Dites lui deuant moi pour ſon contentement, Vous ſçaurez à la fin que ie ſuis digne Amant.	Dites -lui devant moi pour son contentement, Vous saurez à la fin que je suis digne Amant.
Ah!	Ah!
Rodrigue infidelle, où ſont ces affurances?	Rodrigue infidèle, où sont ces assurances?
Que doiuent deuenir toutes mes eſperances?	Que doivent devenir toutes mes espérances?
A quel point le deſtin ne met il auiourd’huj, Et que faut-il tenter pour croire mon ennui?	À quel point le destin ne met il aujourd'huj, Et que faut-il tenter pour croire mon ennui?
Mon eſperance eſt morte auſſi bien que mon pere, Ie pretends vôtre amour, & l’Infanté l’eſpere, Et puis vous me direz dans mon étonnement, Vous ſçaurez à la fin que leſuis digne Amant.	Mon espérance est morte aussi bien que mon père, Je prétends votre amour, et l'Infanté l'espère, Et puis vous me direz dans mon étonnement, Vous saurez à la fin que lesuis digne Amant.
Enfin donc ie deuois par cette ingratitude Tirer du repentir de mon inquietude, Et iuger ſainement vous voiant en priſon, Que vous eſtiez puni pour vnetra hiſon.	Enfin donc ie Pois par cette ingratitude Tirer du repentir de mon inquiétude, Et juger sainement vous voyant en prison, Que vous étiez puni pour vnetra hison.
Vſez bien du bon-heur que le Ciel vous preſente, Abandonnez Chimene, & reuerez l’Infante;	Vsez bien du bonheur que le Ciel vous présente, Abandonnez Chimène, et réverez l'Infante;
Dites-lui de nouueau pour ſon ſoulagement, Vous ſçaurez à la fin que ie ſuis digne Amant.	Dites-lui de nouveau pour son soulagement, Vous saurez à la fin que ie suis digne Amant.
Et pour tout acheuer que l’on die en Caſtille Que vous fites mourir, & le pere & la fille, Quẽ l’vn receut vos coups, & l’autre vôtre cœur, Mais qu’à la fin chacun ſentit vôtre rigueur:	Et pour tout achever que l'on die en Castille Que vous fîtes mourir, et le père et la fille, Quẽ sentit votre reçut vos coups, et l'autre votre cœur, Mais qu'à la fin chacun sentit votre rigueur:
Croiez que vôrre bras n’aura pas cette gloire, Et ie dois enuier vne telle victoire:	Croyez que vôrre bras n'aura pas cette gloire, Et je dois envier une telle victoire:
Vous verrez que l’honneur n’é eignit pas mes feus, andis que le igar mounr alors que ie te veus.	Vous verrez que l'honneur n'é eignit pas mes feus, andis que le igar mounr alors que mille te veux.
D.	D.
RODRIGVE.	RODRIGUE.
Ne me condannez pas pour vn ſi long ſilence, Vous n’auez pas ſuiet de vous mettre en couroux, Ce que ie luy diſois ie l’entendois de vous:	Ne me condamnés pas pour un si long silence, Vous n'avez pas sujet de vous mettre en courroux, Ce que ie lui disois ie entendois de vous.
Le Ciel en eſt témoin, & mon cœur le conlure, Si ce diſcours n’eſt vrai de vanger cetre iniure, Ie ne le puis nier, j’ai dit ſubtilement, Vous ſçaurez à la fin que je ſuis digne Amant.	Le Ciel en est témoin, et mon cœur le conlure, Si ce discours n'est vrai de venger cet injure, Je ne le puis nier, j'ai dit subtilement, Vous saurez à la fin que je suis digne Amant.
Mais c’eſt de vous, Madame, & non pas de l’Infante, vous eſtes mon uenr, & ma derniere atrento, Et ſi vous reſiſt ez à cette verité, Mon trépas doit aprendre à la poſterité,	Mais c'est de vous, Madame, et non pas de l'Infante, vous êtes mon ouvenr, et ma dernière atrento, Et si vous résist êtes à cette vérité, Mon trépas doit apprendre à la postérité,
CHIMENE.	CHIMENE.
C'eſt deſfus vos ſermens que i’établis mon aiſe, Et ce qui m’afligoit maintenant me rapaiſe, De même qu’vn ſeul mot ſuffit à me guerir, Auſſi n’enfaut-il qu’vn pour me faire mourir;	C'est défus vos serments que j'établis mon aise, Et ce qui m'afligait maintenant me rapaise, De même qu'un seul mot suffit à me guérir, Aussi n'enfaut-il qu'un pour me faire mourir;
Ie penſe qu’en ceci mon bon heur eſt extrême, Et ie croitout de vous, pource que le vous aime, La crainte maintenant me mettoit au cercueil, Et l’eſpoir maintenant vient de changer mox dueil.	Je pense qu'en ceci mon bon heur est extrême, Et grands croitout de vous, pource que le vous aime, La crainte maintenant me mettait au cercueil, Et l'espoir maintenant vient de changer mox deuil.
Entre deux mouuemens & d'eſpoir & de crainte, Ie pouſſe des ſoûpirs, & le finis ma plainte;	Entre deux mouvements et d'espoir et de crainte, Je pousse des soupirs, et le finis ma plainte;
L’vn me met aux enfers, l'autre dans le Ciel, L'vn m’ofre des douceurs, l’autre m’ofre du fiel :	L'un me met aux enfers, l'autre dans le Ciel, L'un m'ofre des douceurs, l'autre m'ofre du fiel :
Ces deux gênent mes ſens, & combattent mon ame, L’vn nourit mon braſier, & l’autre éteint ma flâme, Et dedans ces combats d’eſperance & de peur, Le ſort mefait toujours l’objet de ſa rigueur.	Ces deux gênent mes sens, et combattent mon âme, L'un nourit mon brasier, et l'autre éteint ma flamme, Et dedans ces combats d'espérance et de peur, Le sort méfait toujours l'objet de sa rigueur.
D.	D.
RODRIGVE.	RODRIGUE.
Peut eſtre qu’en ce iour finirons-nous ces pênes, Ec que nous ſertirons de plus aimables chaines:	Peut être qu'en ce jour finirons-nous ces pênes, Ec que nous sertirons de plus aimables chaînes:
Le Roy dans le regret de ma capriuiré.	Le Roi dans le regret de ma capriviré.
Veut me donner Chimere auec ma liberté;	Veut me donner Chimère avec ma liberté;
Raui d’vne fortune & ſi douce & ſi belle, l’en ai voulu premier aporter la nouuelle, Et coniurer ton cœur de ne differer pas de momene qui peue leur dinerer ſon trépas.	Rauj d'une fortune et si douce et si belle, l'en ai voulu premier apporter la nouvelle, Et conjurer ton cœur de ne différer pas de momene qui peue leur dinerer son trépas.
CHIMENE.	CHIMENE.
La volonté du Roy m’eſt vne grande amorce.	La volonté du Roi m'est une grande amorce.
D.	D.
RODRIGVE.	RODRIGUE.
pour me plêre ſur tout n’obeïs pas parforce.	pour me plaire sur tout n'obéis pas parforse.
OnlManEs Voici venir Dom Sanche, adieu pour vn moment.	OnlManEs Voici venir Dom Sanche, adieu pour un moment.
D.	D.
RODRIGVE.	RODRIGUE.
Vous ſçaurez à la fin que ie ſuis digne Amant.	Vous saurez à la fin que je suis digne Amant.
SCENE VIII.	SCÈNE VIII.
D.	D.
SANCHE, D.	SANCHE, D.
RODRIGVE,	RODRIGUE,
05 D.	05 D.
SANCHE.	SANCHÉ.
Ciel ie voi qu'enfin ma paſſion l'irrite'.	Ciel été voi qu'enfin ma passion l'irrite.
Auec cette beauté l’eſperance me quirteie la ſui vainement, ſes iniuſtes mépris DLaifſent le deſeſpoir à mes foibles eſprits:	Avec cette beauté l'espérance me quirte la zvi vainement, ses injustes mépris DLaifsent le désespoir à mes faibles esprits:
Tout eſt perdu pour moi, ſa haine eſt découuerte Et ne la voyant plus ie ne voì que ma perte;	Tout est perdu pour moi, sa haine est découverte Et ne la voyant plus ici ne vo que ma perte;
Mais la ſuiure, pourquoi?	Mais la suivre, pourquoi?
c’eſt ſuiure mon malheur, C'eſt courir au poignard qui me perce le cœur, C'eſt chercher le poiſon qui vient croitre ma pêne, Et prier le boureau qui me donne la gêne, Dans ces triſtes penſers où me voi je reduit!	c'est suivre mon malheur, C'est courir au poignard qui me perce le cœur, C'est chercher le poison qui vient croître ma pêne, Et prier le boureau qui me donne la gêne, Dans ces tristes pensers où me voi je réduit!
I'aime ce qui me hait, ie ſui ce qui me fuit, I'adore l’ennemi qui n’en veur qu’à ma vie, Ie lui ſuis en horreur, & i’en fais mon enuie, Aujour d’hui mon mal-heur eſt il pas ſans égal, Si ie fais mon plêſir de ce qui fait mon mal?	J'aime ce qui me hait, Seigneur su ce qui me fuit, J'adore l'ennemi qui n'en eur qu'à ma vie, Je lui suis en horreur, et j'en fais mon envie, Aujour d'hui mon malheur est il pas sans égal, Si belle fais mon plésir de ce qui fait mon mal?
Et toi puiffant guerrier, Rodrigue redoutable, Qui connois ma conſtance, & mon ſort lamentable:	Et toi puiffant guerrier, Rodrigue redoutable, Qui connais ma constance, et mon sort lamentable:
D.	D.
Sanche met ici la main à l’é pec.	Sanche met ici la main à l'é pec.
Voiant mon deſeſpoir, ne ſois pas étonné, Si ie diſpute encorce que tu m’as donné, 2 Ma mort eſt plus honneſte & beaucoup plus humaine, En venant de ta main que des yeux de Chimene, Tu punis, acheuant ma vie & mes trauaux, Tes plus grands ennemis, & tes plus grands tle uans.	Voyant mon désespoir, ne sois pas étonné, Si sensible dispute encor que tu m'as donné, 2 Ma mort est plus honnête et beaucoup plus humaine, En venant de ta main que des yeux de Chimène, Tu punis, achevant ma vie et mes travaux, Tes plus grands ennemis, et tes plus grands tle ans.
D V CID.	D V CID.
Be, ne a le lvEs	Be, ne a le luEs
Quoi?	Quoi?
n'eſt ce pas aſſez?	n'est ce pas assez?
D.	D.
Sanche eſt-il poſſible D.	Sanche est-il possible D.
Rodrigue deſarme D.	Rodrigue désarme D.
Sanche.	Sanche.
Qu’à ce dernier bien fait on vous treuue inſenſible?	Qu'à ce dernier bien fait on vous trouve insensible?
Pour la ſeconde fois vous me voiez vainqueur.	Pour la seconde fois vous me voyez vainqueur.
D.	D.
SANCHE.	SANCHÉ.
Auolr ſi peu d'adreſſe auecque tant de cœur!	Avolr si peu d'adresse auecque tant de cœur!
O Dieux qu’à de mal-heurs ma fortune eſt ſoûmiſe!	Ô Dieux qu'à de malheurs ma fortune est soumise!
Que ie reuſſi hien dedans chaque entrepriſe!	Que quelque réussi hien dedans chaque entreprise!
D.	D.
SANCHE.	SANCHÉ.
Il n’en faut plus douter, Chimene & ce guerrier ſont bien à redouter, L’vn a le bras puiſſant, l’autre a d’étranges charmes, Et tous deux ont toûjours d’inéuitables armes.	Il n'en faut plus douter, Chimène et ce guerrier sont bien à redouter, L'un a le bras puissant, l'autre a d'étranges charmes, Et tous deux ont toujours d'inévitables armes.
D RoDRMIB.	D RoDRMIB.
Il m’étoit bien aiſé de lui donner la lol, Car l’honneur & l’amour ont combatu pour moi, Chimene m’animoit.	Il m'était bien aisé de lui donner la lol, Car l'honneur et l'amour ont combattu pour moi, Chimène m'animait.
L'IN FANTE.	L'IN SANTÉ.
Quoi ie ſuis mépriſée!	Quoi là suis méprisée!
Et ie ſuis à Rodrigue vn obiet de riſée ?	Et ici suis à Rodrigue un objet de risée ?
Ah!	Ah!
ces deffeins pour toi ſont tous pernicieux, Ta Chimene aujourd’hui doit perir à mes yeux;	ces desseins pour toi sont tous pernicieux, Ta Chimène aujourd'hui doit périr à mes yeux;
Pour vanger cét afront ie veus eſtre cruelle, Et rendre par ſa mort ta douleur immortelle, L’immoler à ma haine, & dans cette rigueur Lui percer de ma main,& lui tirer le cœur;	Pour venger cet afront ie dans cette cruelle, Et rendre par sa mort ta douleur immortelle, L'immoler à ma haine, et dans cette rigueur Lui percer de ma main,et lui tirer le cœur;
I’i vole de ce pas;	J'y vole de ce pas;
mais Chimene s’auance, Dom Diegue la conduit, & le Roi la seuance.	mais Chimène s'avance, Dom Diegue la conduit, et le Roi la sévance.
SCRIV DERNIERE.	SCRIV DERNIÈRE.
LR ROY, D.	LR ROY, D.
RODRIGVE, L’INFANTE.	RODRIGUE, L'INFANTE.
D.	D.
SANCHE, D.	SANCHE, D.
DIEGVE, CHIMENE.	DIEGUE, CHIMENE.
LE ROY.	LE ROY.
Odrigue finiſſez vôtre ſort rigoureux.	Odrigue finissez votre sort rigoureux.
q Ce iour acheuera vos deſſeins amoureux:	 Ce jour achèvera vos desseins amoureux:
M& Pourſuiuez grand Heros;	MET Poursuivez grand Héros;
vôtre inſigne victoire Commence mes plêſirs, commençant vôtre gloire:	votre insigne victoire Commence mes plésirs, commençant votre gloire:
Nôtre guerre eſt finie, & l'aſtre du mal-heur, Ne ſçait plus irriter vôtre extréme valeur.	Notre guerre est finie, et l'astre du malheur, Ne sait plus irriter votre extrême valeur.
D.	D.
RODRIGVE.	RODRIGUE.
n attenciez pas de moy quelque longue harangue, Mais ſçachez que ce bras fait bien mieux que ma langue, Et que tous mes deſſeins butteront deſormais A vous faire ioüir d’vne eternelle paix.	n attenciez pas de moi quelque longue harangue, Mais sachez que ce bras fait bien mieux que ma langue, Et que tous mes desseins butteront désormais À vous faire jouir d'une éternelle paix.
L’INFANTE.	L'INFANTE.
Ce changement doit-il apaiſer ma colere, Elle dit ceci bas.	Ce changement doit-il apaiser ma colère, Elle dit ceci bas.
Que puis-je plus tenter, Chimene eſt ſon ſalêre.	Que puis-je plus tenter, Chimène est son salère.
D.	D.
SANCHE.	SANCHÉ.
Hé Madame nos maux auront leur gueriſon Par le temps, par la mort, ou bien par la raiſon.	Hé Madame nos maux auront leur guérison Par le temps, par la mort, ou bien par la raison.
LE ROY, dit cecy à Chimene.	LE ROY, dit ceci à Chimène.
Quï ma fille, il eſt temps d'acheuer la iournée, Par vne telle ioie, & par vôtre Hymenée, Triomphez de vos maux, & que ce grand vainqueur Ait aiourd'hul l'honneur de gaigner vôtre cœur.	Quoi ma fille, il est temps d'achever la journée, Par une telle joie, et par votre Hyménée, Triomphez de vos maux, et que ce grand vainqueur Ait aiourd'hul l'honneur de gagner votre cœur.
A ſes feux violens n’opoſez plus de glace, Et ne differez plus à lui rendre la place.	À ses feux violents n'opposés plus de glace, Et ne différez plus à lui rendre la place.
D.	D.
DIEGVE.	DIEGUE.
Cette gloire eſt la fin de ſon ambition, Et Madame la doit à ſon afection.	Cette gloire est la fin de son ambition, Et Madame la doit à son afection.
CHIMENB.	CHIMENB.
Mais, Sire, permettez.	Mais, Sire, permettez.
LA ROY.	LA ROY.
Oc que ie vous conſeille Doit charmer vôtre eſprir, & flatter vôtre veille:	Oc que ici vous conseille Doit charmer votre éprir, et flatter votre veille:
La loi que ie vous donne eſt vne douce loi, Conſiderez Rodrigue, & le temps, cle Moy.	La lois que je vous donne est une douce lois, Considérez Rodrigue, et le temps, clé Oi.
bas.	bas.
D.	D.
SANCHE.	SANCHÉ.
Cette poffeſſion étoufe mon attente,	Cette poffession étouffe mon attente,
L'INFANTE.	L'INFANTE.
Il faur donc apres tout que non ecur le conten- te.	Il saur donc après tout que non ecur le conten- te.
bas.	bas.
CHIMENE.	CHIMENE.
Que vôtre Majeſté conſidere pourtant.	Que votre Majesté considère pourtant.
LE ROY.	LE ROY.
Non paroiſſez conſtante, ou Rodrigue eſt conſtant.	Non paraissez constante, ou Rodrigue est constant.
Finiſſez vos ennuis, ne verſez plus de larmes, Que le lote conbro vous n’ait deſormais plus d’armes.	Finissez vos ennuis, ne versez plus de larmes, Que le lote conbro vous n'ait désormais plus d'armes.
Il dit ceci à Rodrigue.	Il dit ceci à Rodrigue.
Ie ſçai bien ce qu’on doit à vos nobles trauaux, Auſſi pourai-je en peu recompenſer vos maux.	Je sais bien ce qu'on doit à vos nobles travaux, Aussi pourrai-je en peu récompenser vos maux.
D.	D.
RODRIGVE.	RODRIGUE.
Grand Roy tous mes trauaux ont eu leur recõpenſe, Et ſi l'en demandandois ie ferois vne ofenſez Tous les biens deſormais me ſeront ſuperflus, Car apres celui-ci ie n’en demande plus.	Grand Roi tous mes travaux ont eu leur recõpense, Et si l'en demandandais homme ferais une offensez Tous les biens désormais me seront superflus, Car après celui-cy autre n'en demande plus.
Madame vos bontez m’oſtent des mains des Parques, Et me font plus heureux que les plus grands Monarques, Je meritois ſans doute vn ſort moins glorieux.	Madame vos bontés m'ôtent des mains des Parques, Et me font plus heureux que les plus grands Monarques, Je méritais sans doute un sort moins glorieux.
Ie m’eſtimois par tout indigne de vos yeux.	Je m'estimais par tout indigne de vos yeux.
Helas!	Hélas!
vôtre pitié dans vn ſi grand orage Me preſente le port, où i’ai cru mon naufrage, Vous en eſtes loüable, & c’eſt reſcuſciter Que de donner la vie alors qu’on peut l’oſter.	votre pitié dans un si grand orage Me présente le port, où j'ai cru mon naufrage, Vous en êtes louable, et c'est réscusciter Que de donner la vie alors qu'on peut l'ôter.
Fin de la ſuitte & du Mariage du Cid.	Fin de la suite et du Mariage du Cid.
France	France
rafice	rafice
