TROCSNO 1 Le Theatre repreſente une Plaine bornée par la veuë de Marly.	TROCSNO 1 Le Théâtre représente une Plaine bornée par la vue de Marli.
0 MELICERTE.	0 MELICERTE.
Déja la vigilante Aurore A payé le tribut qu’elle devoit à Flore.	Déjà la vigilante Aurore A payé le tribut qu'elle devait à Flore.
PALEMON, MELICERTE, PARTHENOPE.	PALÉMON, MELICERTE, PARTHENOPE.
Oittez, quittez, Bergers, vos paiſibles hameaux.	Oittez, quittez, Bergers, vos paisibles hameaux.
PARTHENOPE.	PARTHENOPE.
Le Soleil ſort du ſein des eaux, Et ſes premiers rayons vont dorer nos cõteaux.	Le Soleil sort du sein des eaux, Et ses premiers rayons vont dorer nos compteaux.
PALE’MON.	PALEMON.
Mille fleurs ſe preſſent d’éclore, Et l’Echo ſe réveille au doux chant des oiſeaux.	Mille fleurs se pressent d'éclore, Et l'Écho se réveille au doux chant des oiseaux.
Tous trois enſemble.	Tous trois ensemble.
Quittez, quittez, Bergers, vos paiſibles hameaux.	Quittez, quittez, Bergers, vos paisibles hameaux.
LE CHOEUR.	LE CHOEUR.
Quittons nos paiſibles hameaux.	Quittons nos paisibles hameaux.
PALE'MON, MELICERTE, PARTHENOPE.	PALE'MON, MELICERTE, PARTHENOPE.
Ah!	Ah!
que nos deſtins ſont tranquiles!	que nos destins sont tranquiles!
Cerés dans nos plaines fertiles Répand ſes plus riches moiſſons:	Cerrez dans nos plaines fertiles Répand ses plus riches moissons:
Nos jours coulent dans l’innocence, Et nous bornons nôtre eſperance Aux ſeuls biens dont nous joüiſſons.	Nos jours coulent dans l'innocence, Et nous bornons notre espérance Aux seuls biens dont nous jouissons.
PALE'MON.	PALEMON.
En vain le flambeau de la Guerre Etincéle de toutes parts, En vain l’impitoyable Mars Fait voler ſa fureur aux deux boûts de la Terre:	En vain le flambeau de la Guerre Etincle de toutes parts, En vain l'impitoyable Mars Fait voler sa fureur aux deux bouts de la Terre:
On ne craint point icy ſes ravages affreux, Et tandis que la foudre gronde Nous joüiſſons d’un calme heureux A l’abri des lauriers du plus grand Roy du monde.	On ne craint point ici ses ravages affreux, Et tandis que la foudre gronde Nous jouissons d'un calme heureux A l'abri des lauriers du plus grand Roi du monde.
MELICERTE.	MELICERTE.
Ce Roy toüjours victorieux Détourne loin de nous la Guerre & les allarmes.	Ce Roi toujours victorieux Détourne loin de nous la Guerre et les alarmes.
C’eſt luy qui ſoûtient ſeul par l’effort de ſes armes Les droits de la Terre & des Cieux,	C'est lui qui soutient seul par l'effort de ses armes Les droits de la Terre et des Cieux,
PARTHENOPE.	PARTHENOPE.
Sa gloire eſt parvenué aux plus lointains rivages, Et ſes Exploits ſont reverez Juſques dans ces Climats ſauvages Où les Duua font preſque ignorez.	Sa gloire est parvenué aux plus lointains rivages, Et ses Exploits sont révérez Jusques dans ces Climats sauvages Où les Dua font presque ignorez.
Tous trois enſemble.	Tous trois ensemble.
Deſtins favorables Recevez, nos vœux, S lue ſes jours durables Soient toûjours heureux.	Détins favorables Recevez, nos vœux, S ue ses jours durables Soient toujours heureux.
PARTHENOPE.	PARTHENOPE.
O!	Ô!
vous, dont le pouvoir remplit la Terre & l’Onde, Souverains arbitres du monde, Vous, qui dans vos puiſſantes mains Tenez le ſort des Rois, & les jours des humains;	vous, dont le pouvoir remplit la Terre et l'Onde, Souverains arbitres du monde, Vous, qui dans vos puissantes mains Tenez le sort des Rois, et les jours des humains;
Grands Dieux, conſervez-nous nôtre unique eſperance, Prenez ſoin d’un Heros, le bonheur des mortels, L’appuy de la Vertu, l’eſpoir de l’Innocence, Et le ſoûtien de vos Autels.	Grands Dieux, conservez-nous notre unique espérance, Prenez soin d'un Héros, le bonheur des mortels, L'appui de la Vertu, l'espoir de l'Innocence, Et le soutien de vos Autels.
UNE BERGERE chante cette Gigue au milieu de l’Entrée.	UNE BERGÈRE chante cette Gigue au milieu de l'Entrée.
Demeurons dans ce doux azile, Vivons-y contens;	Demeurons dans ce doux asile, Vivons-y contents;
Des jours que la Parque nous file Il faut ménager les inſtans.	Des jours que la Parque nous file Il faut ménager les instants.
Profitons du Jour qui nous eclaire, Il va bien-toſt faire place à la nuit.	Profitons du Jour qui nous eclaire, Il va bientôt faire place à la nuit.
D’une aile legere Le temps s’enfuit.	D'une aile légère Le temps s'enfuit.
La beauté n’eſt rien qu’une fleur paſſagere Qu iin byver deiruii, Et pour peu qu’on differe On en perd le fruit.	La beauté n'est rien qu'une fleur passagère Qu in biver deirui, Et pour peu qu'on diffère On en perd le fruit.
PARTHENOPE.	PARTHENOPE.
Dequoy vous peut ſervir une attente frivole?	Dequoy vous peut servir une attente frivole?
Soupirez, jeunes cœurs, profitez des beaux jours:	Soupirez, jeunes cœurs, profitez des beaux jours:
Comme un Zéphir leger la jeuneſſe s’envole, Enuoomonions ou on penu font peruus pour toujours.	Comme un Zéphir léger la jeunesse s'envole, Envoomonions ou on penu font pervus pour toujours.
Sans eſpoir de retour cette onde fuit ſa ſource, Et ces flots vers la Mer par les flots ſont chaſſez:	Sans espoir de retour cette onde fuit sa source, Et ces flots vers la Mer par les flots sont chassez:
Nos plaiſirs, nos beaux jours, vont d’une egale courſe, Et ne reviennent plus ſi-toſt qu’ils ſont paſſez.	Nos plaisirs, nos beaux jours, vont d'une égale course, Et ne reviennent plus sitôt qu'ils sont passez.
UNE BERGERE chante ce Menuet avec le Chœur.	UNE BERGÈRE chante ce Menuet avec le Chœur.
Profitez de la vie, Beautez, faites un choix;	Profitez de la vie, Beautés, faites un choix;
L’Amour vous y convie, Aimez, ſuivez ſes loix.	L'Amour vous y convie, Aimez, suivez ses lois.
Le Chœur répéte ces quatre Vers.	Le Chœur répéte ces quatre Vers.
LA BERGERE.	LA BERGÈRE.
Que ſert de ſe deffendre De ſes charmans appas?	Que sert de se défendre De ses charmants appas?
Ce Dieu ſçait nous ſurprendre Quand nous n'y penſons pa	Ce Dieu sçait nous surprendre Quand nous n'y pensons pa
DLOGUE.	DLOGUE.
DIANE ſur ſon Char.	DIANE sur son Char.
CeſſeZ de profaner un encens legitime, Ne mêlez plus l’Amour & ſes coupables loix Au recit des Vertus du plus parfait des Rois, Songez en quel affreux abîme Ce Dieu précipite les cœurs Qui ſe laiſſent ſurprendre à ſes charmes trompeurs.	Cessez de profaner un encens légitime, Ne mêlez plus l'Amour et ses coupables lois Au récit des Vertus du plus parfait des Rois, Songez en quel affreux abîme Ce Dieu précipite les cœurs Qui se laissent surprendre à ses charmes trompeurs.
Adonis autrefois ſoûmis à ma puiſſance, N’oſa luy faire reſiſtance;	Adonis autrefois soumis à ma puissance, N'osa tu faire résistance;
Je vay vous retracer ſon ſort:	Je vais vous retracer son sort:
Heureux, ſi l’exemple fidele Des maux où le plongea cette ardeur criminelle, Peut vous porter à fuir ln fomoiaoie tranſport.	Heureux, si l'exemple fidèle Des maux où le plongea cette ardeur criminelle, Peut vous porter à fuir l omoiaoie transport.
AnimeZ d’une ardeur plus belle, Pour le plus grand des Rois reſervez, vos concerts, Et faites retentir les airs Du récit éclatant de ſa gloire immortéle.	Animez d'une ardeur plus belle, Pour le plus grand des Rois réservez, vos concerts, Et faites retentir les airs Du récit éclatant de sa gloire immortéle.
LE HOEUR.	LE HOUR.
AnimeZ d’une ardeur plus belle, Pour le plus Grand des Rois réſervons nos concerts, Et faiſons retentir les airs, Du récit éclatant de ſa gloire immortelle.	Animez d'une ardeur plus belle, Pour le plus Grand des Rois réservons nos concerts, Et faisons retentir les airs, Du récit éclatant de sa gloire immortelle.
FIN DU PROLOGUE.	FIN DU PROLOGUE.
UN SUIVANT DE MARS.	UN SUIVANT DE MARS.
Chœur & Troupe de Peuples de differens endroits de l’Iſle de Cypre.	Chœur et Troupe de Peuples de différents endroits de l'Île de Cypre.
LA JALOUSIE.	LA JALOUSIE.
Suite de la Jalouſie, les Soupçons, le Dépit, la Fureur, la Haine, &c.	Suite de la Jalousie, les Soupçons, le Dépit, la Fureur, la Haine, etc.
La Scene eſt dans l’Iſle de Cypre.	La Scène est dans l'Isle de Cypre.
LTIIDONTS, TRAGEDIE.	LTIIDONTS, TRAGÉDIE.
MCIEIIEMIER.	MCIEIEMIÈR.
Le Theatre repreſente le coſté de la Foreſt d’Ida le plus proche d’Amathonte, & dans l’enfoncement un Temple conſacré à Venus.	Le Théâtre représente le côté de la Forêt d'Ida le plus proche d'Amathonte, et dans l'enfoncement un Temple consacré à Venus.
SCENE PREMIERE.	SCÈNE PREMIÈRE.
CYDIPE ſeule.	CYDIPE seule.
Ieux écartez, demeure obſcure, Solitaires témoins des peines que j’endure, Aſile impénetrable à la clarté du jour;	Jeux écartés, demeure obscure, Solitaires témoins des peines que j'endure, Asile impénétrable à la clarté du jour;
Redoublez, s’il ſe peut, l’épaiſſeur de vos ombres, Et cacheZ à jamais dans vos retraites ſombres Mon deſeſpoir & mon amour.	Redoublez, s'il se peut, l'épaisseur de vos ombres, Et cachez à jamais dans vos retraites sombres Mon désespoir et mon amour.
L’inſenſible Adonis ne connoît point encore Ce qui fait naiſtre ma langueur;	L'insensible Adonis ne connaît point encore Ce qui fait naître ma langueur;
Quel ſupplice pour moy ſi mon cruel vainqueur Sçavoit l’ardeur qui me devore!	Quel supplice pour moi si mon cruel vainqueur Savait l'ardeur qui me dévore!
Amour, ſeul confident du trouble de mon cœur, Ne luy révele point un ſecret qu’il ignore, Puiſque les maux que j’ay ſoufferts, N’ont pû me délivrer d’une chaîne cruelle, Epargne-moy, du moins, la triſteſſe mortelle D'étaler à ſes yeux la honte de mes fers.	Amour, seul confident du trouble de mon cœur, Ne lui rèvele point un secret qu'il ignore, Puisque les maux que j'ai soufferts, N'ont pu me délivrer d'une chaîne cruelle, Épargne-moi, du moins, la tristesse mortelle D'étaler à ses yeux la honte de mes fers.
CENE SECONDE.	CÈNE SECONDE.
CYDIPE, ADONIS.	CYDIPE, ADONIS.
ADONIS.	ADONIS.
I Enus vient honorer nos tranquilles rivages, V Le choix d’un nouveau Roy l’améne en ce ſejour, Nos Peuples raſſemblez dans ces heureux boccages Celebrent par leurs chants la Mere de l’Amour.	I Enus vient honorer nos tranquilles rivages, V Le choix d'un nouveau Roi l'amène en ce séjour, Nos Peuples rassemblez dans ces heureux boccages Célèbrent par leurs chants la Mère de l'Amour.
Sa tendreſſe pour vous éxige vos hommages, Vous poſſedez ſon cœur, vous regnez, dans ſa Cour;	Sa tendresse pour vous éxige vos hommages, Vous possédez son cœur, vous régnez, dans sa Cour;
Cependant vous venez rêver ſous ces ombrages, Et ſemblez ſeule ignorer ce grunu four.	Cependant vous venez rêver sous ces ombrages, Et semblez seule ignorer ce grun four.
CYDIPE.	CYDIPE.
motepos Duu duia vuinent mon eſperance, Et je les trouve dans ces lieux.	modépos Du duia vinent mon espérance, Et je les trouve dans ces lieux.
ONIS.	ONIS.
Nos jeux, noſtre réjouiſſance, Nont lis rien qui faite vus yeux?	Nos jeux, notre réjouissance, Nont lis rien qui faite vus yeux?
A nos Concerts harmonieux Pouvez-vous preferer les horreurs du ſilence?	À nos Concerts harmonieux Pouvez-vous préférer les horreurs du silence?
DIPE.	DIPE.
Le Jllente des Bou dinſpire de leffroy Qu'aux cœurs exemts d’inquietude;	Le Jllente des Bou dinspire de leffroi Qu'aux cœurs exemts d'inquiétude;
Vous eſtes trop heureux pour ſentir comme moy Les douceurs de la ſolitude.	Vous êtes trop heureux pour sentir comme moi Les douceurs de la solitude.
ADONIS.	ADONIS.
D’un importun chagrin craigneZ-vous les rigueurs?	D'un importun chagrin craignez-vous les rigueurs?
Il n’eſt point parmy nous de Princeſſe plus belle, Tout cede à vos attraits vainqueurs;	Il n'est point parmi nous de Princesse plus belle, Tout cède à vos attraits vainqueurs;
L’amitié vous unit avec une Immortelle, Et vous partageZ avec elle La conqueſte de tous les cœurs.	L'amitié vous unit avec une Immortelle, Et vous partagez avec elle La conquête de tous les cœurs.
Helas!	Hélas!
YDIPE,	YDIPE,
ONIS, De ce ſoûpir que faut-il que je penſe?	ONIS, De ce soupir que faut-il que je pense?
Quels ſont vos ſecrets déplaiſirs?	Quels sont vos secrets déplaisirs?
YDIPE.	YDIPE.
v ous avez trop d'indiſſerence Pour pouvoir penetrer d’où naiſſent mes ſoûpirs.	 vous avez trop d'indisserence Pour pouvoir pénétrer d'où naissent mes soupirs.
ADON S.	ADON S.
Si c’eſt l’amour qui cauſe vos allarmes, Que je plains voſtre ſort!	Si c'est l'amour qui cause vos alarmes, Que je plains votre sort!
& qu’il eſt rigoureux!	et qu'il est rigoureux!
YDIPE.	YDIPE.
Vous plaignez mes malheurs ſans partager mes larmes;	Vous plaignez mes malheurs sans partager mes larmes;
Helas!	Hélas!
que vous eſtes heureux!	que vous êtes heureux!
ADONES.	ADONES.
Les Bois m’ont donné la naiſſance, J'ay toûjours reveré Diane & ſon pouvoir;	Les Bois m'ont donné la naissance, J'ai toujours révéré Diane et son pouvoir;
Et des cœurs aſſervis à ſon obeïſſance L’indifference eſt le premier devoir.	Et des cœurs asservis à son obéissance L'indifférence est le premier devoir.
Tous deux enſemble.	Tous deux ensemble.
Charmante indifference, QQue vous avez d’attraits!	Charmante indifférence, QQue vous avez d'attraits!
Redoutons à jamais L’amour & ſa puiſſance:	Redoutons à jamais L'amour et sa puissance:
De ſes funeſtes traits Craignons la violence, Sa plus belle apparence Sçait tromper nos ſouhaits;	De ses funestes traits Craignons la violence, Sa plus belle apparence Sait tromper nos souhaits;
Charmante indifference, Que vons uots danraus!	Charmante indifférence, Que vons uots danraus!
Mais le peuple en ces lieux vient chanter la Déeſſe, Nous devons partager la commune allegreſſe.	Mais le peuple en ces lieux vient chanter la Déesse, Nous devons partager la commune allégresse.
Is CENE TROISIE’ME.	Is CÈNE -THROISIE'ME.
CIDIE ADONTS.	CIDIE ADONTS.
Chœur & Troupe de Peuples de differens endroits de l’Iſle de Cypre.	Chœur et Troupe de Peuples de différents endroits de l'Île de Cypre.
LE CHOEUR.	LE CHOEUR.
E nos tranſports Suivons l’ardeur fidéle, Une immortéle Deſcend ſur ces bords;	E nos transports Suivons l'ardeur fidèle, Une immortéle Descend sur ces bords;
Formons pour elle Nos plus doux accords.	Formons pour elle Nos plus doux accords.
Avec les jeux les amours vont paraître, Mille plaiſirs Vont combler nos deſirs, Dans ces beaux lieux Venus les fait renaître.	Avec les jeux les amours vont paraître, Mille plaisirs Vont combler nos désirs, Dans ces beaux lieux Venus les fait renaître.
Deux des Filles du Chœur.	Deux des Filles du Chœur.
Tout rit dans ce charmant ſéjour, Nos bois ſont parez de verdure;	Tout rit dans ce charmant séjour, Nos bois sont parés de verdure;
Dans les bocages d’alentour, L'air retentit d’un doux murmure;	Dans les bocages d'alentour, L'air retentit d'un doux murmure;
Jeunes cœurs ſongeZ à plaire, C’est un doux amuſement;	Jeunes cœurs songés à plaire, C'est un doux amusement;
Aux ſoupirs d’un cœur ſincere L’on reſiſte foiblement, Et la fierté ne tient guere Contre les ſoins d’un amant.	Aux soupirs d'un cœur sincère L'on résiste faiblement, Et la fierté ne tient guère Contre les soins d'un amant.
TRAGEDIE.	TRAGÉDIE.
LE CHOEUR pendant que Venus deſcend.	LE CHOEUR pendant que Venus descend.
Chantons, célebrons les appas De la divinité qui deſcend icy bas:	Chantons, célébrons les appas De la divinité qui descend ici bas:
Que de beaux jours ſa preſence nous donne, Les graces & les ris la ſuivent en tous lieux, Et la pompe qui l’environne Rtepon tom jon cetas de ceiuy de jes ſeux.	Que de beaux jours sa présence nous donne, Les grâces et les ris la suivent en tous lieux, Et la pompe qui l'environne Rpon tom jon cetas de cejui de jes seux.
SCENE QUAIRIEME.	SCÈNE QUAIRIEME.
VENUS, ADONIS, CYDIPE.	VENUS, ADONIS, CYDIPE.
Chœur & Troupe, &c.	Chœur et Troupe, etc.
TENUS.	TENUS.
r Ous qui reconnoiſſeZ ma puiſſance ſuprême, V Peuples, ecoutez-moy, ſuivez mes juſtes loix, Pour remplir en ces lieux l’honneur du Diadême En faveur d’Adonis j’ay ſçeu fixer mon choix:	Ô Jus qui reconnaissés ma puissance suprême, V Peuples, écoutez-moi, suivez mes justes lois, Pour remplir en ces lieux l'honneur du Diadme En faveur d'Adonis j'a sçeu ver mon choix:
11 Dans le ſang de vos Rois ce Prince a pris naiſſance, Hſonorez a jamais un choix ſi glorieux, Le ſeul tribut qui puiſſe plaire aux Dieux Eſt la ſincere obeïſſance.	11 Dans le sang de vos Rois ce Prince a pris naissance, Hsonorez à jamais un choix si glorieux, Le seul tribut qui puisse plaire aux Dieux Est la sincère obéissance.
ADONIS.	ADONIS.
Quels reſpects!	Quels respects!
quel encens:	quel encens:
TENUS.	TENUS.
Il ſuffit, laiſſeZ-moi, Vôtre moindre bon-heur eſt celuy d’être Roi:	Il suffit, laissez-moi, Votre moindre bonheur est celui d'être Roi:
Vous connoiſtreZ bien-toſt quel eſt voſtre partage, Vous peuples que mon choix a rangez ſous ſa loy, Allez dans ſon Palais par un pompeux hommage Faire a ſes yeux eclater voſtre foy.	Vous connaîtrez bientôt quel est votre partage, Vous peuples que mon choix a rangez sous sa loi, Allez dans son Palais par un pompeux hommage Faire a ses yeux éclater votre foi.
SCENE CINQUIE’ME.	SCÈNE CINQUIE'ME.
VENUS, CYDIPE.	VENUS, CYDIPE.
YDIPE.	YDIPE.
A Donis eſt comblé de gloire, Vos bienfaits vont encore redoubler ſa fierté.	À Donis est comblé de gloire, Vos bienfaits vont encore redoubler sa fierté.
ENUS.	ENUS.
Adonis est content, il m’eſt doux de le croire;	Adonis est content, il m'est doux de le croire;
Mais ſi par mes bienfaits ſon orgüeil eſt flatté, Quel doit eſtre l’excez de ſa felicité Quand il connoiſtra la victoire Que le cœur de Venus offre à ſa vanité?	Mais si par mes bienfaits son orgueil est flatté, Quel doit être l'excès de sa félicité Quand il connaîtra la victoire Que le cœur de Venus offre à sa vanité?
CYDIPE à part.	CYDIPE à part.
Qu'entens-fet'v Ciet?	Qu'entends-fet'une Ciét?
VENUS.	VENUS.
S.	S.
Il faut parler ſans feinte;	Il faut parler sans feinte;
En vain je te voudrois celer L’ardeur dont mon ame eſt atteinte, Mon mal s’accroit à le diſſimuler:	En vain je te voudrais celer L'ardeur dont mon âme est atteinte, Mon mal s'accroît à le dissimuler:
Il te ſouvient du jour qu’un pompeux ſacrifice Me fit deſcendre dans ces lieux, Sur l'aimable Adonis je détournay les yeux;	Il te souvient du jour qu'un pompeux sacrifice Me fit descendre dans ces lieux, Sur l'aimable Adonis je détournai les yeux;
Ce funeſte regard commença mon ſupplice, ſe pemiis à vinſant dans mes eſprits charmez, Naiſtre tous les tranſports d’une ardeur violente, Et le ſeul ſouvenir du Heros qui m’enchante Ne les a que trop confirmez.	Ce funeste regard commença mon supplice, se pémiis à vinsant dans mes esprits charmés, Naître tous les transports d'une ardeur violente, Et le seul souvenir du Héros qui m'enchante Ne les a que trop confirmez.
IPE.	IPE.
Pouvez-vous du Dieu Mars oublier la tendreſſe?	Pouvez-vous du Dieu Mars oublier la tendresse?
Favorable autrefois aux feux qu’il ſent pour vous D’un mutuel amour vous reſſentiez les coups, Pour un ſimple mortel aurez-vous la foibleſſe De briſer des liens ſi doux?	Favorable autrefois aux feux qu'il sent pour vous D'un mutuel amour vous ressentiez les coups, Pour un simple mortel aurez-vous la faiblesse De briser des liens si doux?
Adonis eſt mortel, Mars eſt un Dieu terrible:	Adonis est mortel, Mars est un Dieu terrible:
Ses ſoins me ſeroient précieux, Si la ſplendeur du rang pouvoit rendre ſenſible;	Ses soins me seraient précieux, Si la splendeur du rang pouvait rendre sensible;
Mais le penchant du cœur ſuit le plaiſir des yeux, Et l’amour rend égaux les mortels & les Dieux.	Mais le penchant du cœur suit le plaisir des yeux, Et l'amour rend égaux les mortels et les Dieux.
PE.	PE.
Par cette injuſte préférence, Craignez d’aigrir la violence, De ſon implacable couroux, La plus redoutable vangeance Eſt celle de l’amour jaloux.	Par cette injuste préférence, Craignez d'aigrir la violence, De son implacable courroux, La plus redoutable vengeance Est celle de l'amour jaloux.
Mes ſoins garantiront l’objet qui m’a ſçeu plaire Des tranſports de ce Dieu fatal, Les vains efforts de ſa colere Seruironi de tropnet a fon munux rival;	Mes soins garantiront l'objet qui m'a su plaire Des transports de ce Dieu fatal, Les vains efforts de sa colère Servironi de tropnet a son munux rival;
Mais allons voir ce que j’adore, Amour!	Mais allons voir ce que j'adore, Amour!
toy qui cauſas l’ardeur qui me dévore, Frappe ſon cœur des meſmes traits, J'oublirai tous les maux que ta rigueur m’a faits.	toi qui causas l'ardeur qui me dévore, Frappe son cœur des mêmes traits, J'oublirai tous les maux que ta rigueur m'a faits.
CYDIPE en s’en allant.	CYDIPE en s'en allant.
Dieux qui voyeZ les maux dont je ſuis pourſuivie, Prevenez ce malheur, ou m’arrachez, la vie.	Dieux qui voyeZ les maux dont je suis poursuivie, Prévenez ce malheur, ou m'arrachez, la vie.
Fin du premier Acte.	Fin du premier Acte.
APTI TA Le Theatre repreſente le Palais des Rois de Cypre.	APTI TA Le Théâtre représente le Palais des Rois de Cypre.
SCENE PREMIERE.	SCÈNE PREMIÈRE.
ADONIS ſeul.	ADONIS seul.
Ommages importuns que ma grandeur m’attire, Dans le rang auguſte où je ſuis, Pour un moment ſouffrez que je reſpire, Et laiſſez-moi ſans vous rêvor u mos thnuis.	Omages importuns que ma grandeur m'attire, Dans le rang auguste où je suis, Pour un moment souffrez que je respire, Et laissez-moi sans vous rêvor os thnuis.
Quels tranſports inconnus!	Quels transports inconnus!
quelle langueur ſecrette!	quelle langueur secrète!
Dieux que mon cœur eſt agité!	Dieux que mon cœur est agité!
Malheureux Adonis, quel trouble t’inquiete, Ah!	Malheureux Adonis, quel trouble t'inquiète, Ah!
ſi tu dois enfin perdre ta liberté, Faut-il qu’une Divinité Soit le premier objet de ta flâme indiſcrete?	si tu dois enfin perdre ta liberté, Faut-il qu'une Divinité Soit le premier objet de ta flamme indiscrète?
Mais elle porté icy ſes pas, Que de troubles divers s'élévent dans mon ame!	Mais elle porté ici ses pas, Que de troubles divers s'évent dans mon âme!
Mes yeux ne me trahiſſez pas, Cachez bien le ſecret de ma coupable flâme.	Mes yeux ne me trahissez pas, Cachez bien le secret de ma coupable flamme.
SCENE SECONDE.	SCÈNE SECONDE.
TENUS, ADONIS.	TENUS, ADONIS.
E vous voy ſeul en ce Palais, Quoy ucju vou fuſeß tu Cour & ſes attraits?	E vous vois seul en ce Palais, Quoi ucju vou fuse tu Cour et ses attraits?
Tous les ſoins d’un grand Peuple attentif à vous plaire, Sont-ils d’aſſez, triſtes objets Poûr vous renart inquiet, reveur & ſolitaire?	Tous les soins d'un grand Peuple attentif à vous plaire, Sont-ils d'assez, tristes objets Pour vous renart inquiet, rêveur et solitaire?
ADONIS.	ADONIS.
La ſolitude à ſes douceurs, Et quelquefois la rêverie Fait le plus doux charme des cœurs.	La solitude à ses douceurs, Et quelquefois la rêverie Fait le plus doux charme des cœurs.
JS.	JS.
La ſolitude eſt ſans douceurs, Si l’amoureuſe rêverie Ne prena ſoin u y porter les cœurs.	La solitude est sans douceurs, Si l'amoureuse rêverie Ne prena soin y porter les cœurs.
Vous aimez, malgré vous vôtre ardour eſt trahie, Vos yeux de vôtre cœur découvrent l’embarras.	Vous aimez, malgré vous votre ardour est trahie, Vos yeux de votre cœur découvrent l'embarras.
ONIS.	ONIS.
Moy j’aimerois?	Moi j'aimerais?
ô Dieux!	ô Dieux!
non ne le croyez pas.	non ne le croyez pas.
Vous voulez affecter le titre d’inſenſible;	Vous voulez affecter le titre d'insensible;
Cependant vôtre cœur ſoûpire en ce moment, Et les ſoûpirs ſont rarement Le langage d’un cœur paiſible:	Cependant votre cœur soupire en ce moment, Et les soupirs sont rarement Le langage d'un cœur paisible:
Ne puis-je enfin vous arracher Un aveu qui ſoit plus ſincére?	Ne puis-je enfin vous arracher Un aveu qui soit plus sincère?
S.	S.
En que me fertoirou d eciaircir un myſtere Que je dois à jamais cacher?	En que me fertoir d eciaircir un mystère Que je dois à jamais cacher?
Non non, quand j’aimerois tout me force à me taire, Il n’appartient qu’aux Dieux d’aſpirer à vous plaire.	Non non, quand j'aimerais tout me force à me taire, Il n'appartient qu'aux Dieux d'aspirer à vous plaire.
Les ſoüpirs d’un mortel pouroiomens vous toucher?	Les soupirs d'un mortel pouroiomens vous toucher?
Les Dieux à qui tout eſt poſſible, Du bonheur d’un mortel pourroient eſtre jaloux, Il en eſt qui peut eſtre ont un cœur plus ſenſible, Et qui ſont moins heureux que vous.	Les Dieux à qui tout est possible, Du bonheur d'un mortel pourraient être jaloux, Il en est qui peut être ont un cœur plus sensible, Et qui sont moins heureux que vous.
Ciel!	Ciel!
quel aveu charmant!	quel aveu charmant!
qui l'eût jamais pû croire?	qui l'eût jamais pu croire?
3.	3.
Connoiſſez, il eſt tems, quelle eſt vôtre victoire?	Connaissez, il est temps, quelle est votre victoire?
JENUS ET ADONIS.	JENUS ET ADONIS.
Aimons à jamais, aimons-nous, putſons a un nœuu ſi vrau noirt vonheur ſupréme:	Aimons à jamais, aimons-nous, putsons à un nœu si vrau noir vonheur suprême:
Eh quel autre bien eſt plus doux Que celuy d’eſtre aimé du ſeul objet qu’on aime?	Eh quel autre bien est plus doux Que celui d'être aimé du seul objet qu'on aime?
S.	S.
D'une Cour empreſſée alleZ remplir l’eſpoir, Elle attend le moment de vous marquer ſon zéle;	D'une Cour empressée allez remplir l'espoir, Elle attend le moment de vous marquer son zèle;
AueS, uuns peu ue temo je pourray vous revoir, Et je veux qu’une fête auguſte & ſolennelle Signale avec éclat nôtre ardeur mutuelle.	AueS, uuns peu ue temo je pourrai vous revoir, Et je veux qu'une fût auguste et solennelle Signale avec éclat notre ardeur mutuelle.
SCENE TROISIE'ME.	SCÈNE -TROISIE'ME.
VENUS, CYDIPE.	VENUS, CYDIPE.
3.	3.
Ren part, chere Cydipe, au bonheur de mes feux, Adonis répond à mes vœux.	Ren part, chère Cydipe, au bonheur de mes feux, Adonis répond à mes vœux.
DIPE.	DIPE.
Que dites-vous?	Que dites-vous?
l’amour a pû fléchir ſon ame?	l'amour a pu fléchir son âme?
S.	S.
Mes regards ont eſté les témoins de ſa flâme, Du deſtin de Venus conçois-tu la douceur?	Mes regards ont été les témoins de sa flamme, Du destin de Venus conçois-tu la douceur?
Mais non, jamais l’amour n’a ſçeu toucher ton cœur, Et pour pouvoir juger de mon bonheur extréme, Il faudroit aimer comme j’aime.	Mais non, jamais l'amour n'a su toucher ton cœur, Et pour pouvoir juger de mon bonheur extrême, Il faudrait aimer comme j'aime.
DIPE à part.	DIPE à part.
Ciel!	Ciel!
puis-je ſoûtenir l’horreur de mon tourment?	puis-je soutenir l'horreur de mon tourment?
3 Adieu, l’amour m’appelle auprés de mon amant, je ne puis reſiſter à mon impatience;	3 Adieu, l'amour m'appelle auprès de mon amant, je ne puis résister à mon impatience;
Quunue on uimt parfaitement C’eſt toûjours une longue abſence, Que l’abſence d’un ſeul moment.	Quunue on uimt parfaitement C'est toujours une longue absence, Que l'absence d'un seul moment.
CENE JATRIE’ME.	CÈNE JATRIE'ME.
DIPE ſeule.	DIPE seule.
Y-je aſſez éprouvé ton injuſte colere I YAmour, eſt-tu content des rigueurs de mon ſort?	Y-je assez éprouvé ton injuste colère I YAmour, est-tu content des rigueurs de mon sort?
Quoi?	Quoi?
prête à découvrir mon funeſte myſtere, Quand je viens ſur l’ingrat faire un dernier effort, J'apprens qu'une autre à ſceu luy plaire?	prête à découvrir mon funeste mystère, Quand je viens sur l'ingrat faire un dernier effort, J'apprends qu'une autre à sutîle plaire?
Le barbare, content de me donner la mort, Affectoit pour moy ſeule un orgueil ſi ſevére:	Le barbare, content de me donner la mort, Affectait pour moi seule un orgueil si sévère:
Ah Dieux!	Ah Dieux!
mais que me ſert de répandre des pleurs?	mais que me sert de répandre des pleurs?
Frivoles déplaiſirs, inutiles douleurs!	Frivoles déplaisirs, inutiles douleurs!
Tandis que je me déſeſpere Ma Rivale en repos joüit de mes malheurs.	Tandis que je me désespère Ma Rivale en repos jouit de mes malheurs.
O Mars, ſouffriras-tu cette injure cruelle?	Ô Mars, souffriras-tu cette injure cruelle?
Que fais-tu dans les Cieux, tandis qu’une infidéle Trahit pour un mortel ton eſpoir le plus doux?	Que fais-tu dans les Cieux, tandis qu'une infidèle Trahit pour un mortel ton espoir le plus doux?
Mars terrible, Mars formidable, De ton couroux vangeur, fay-leur ſentir les coups, Immole ces ingrats à ta haine implacable:	Mars terrible, Mars formidable, De ton courroux vengeur, fais-leur sentir les coups, Immole ces ingrats à ta haine implacable:
Et toy farouche Deïté, Affreuſe Jalouſie aux mortels ſi funeſte, Pren ton eſſor vers le ſéjour Celeſte, Empare-toy du cœur de ce Dieu redouté;	Et toi farouche Deïté, Affreuse Jalousie aux mortels si funeste, Pren ton essor vers le séjour Céleste, Empare-toi du cœur de ce Dieu redouté;
Fay-luy d’un ſi ſenſible outrage Une image pleine d’horreur, Et lance dans ce fier courage Ces traits de rage & de fureur Des vangeances d’un Dieu redoutable preſage.	Fais-lui d'un si sensible outrage Une image pleine d'horreur, Et lance dans ce fier courage Ces traits de rage et de fureur Des vengeances d'un Dieu redoutable présage.
CENEEE JIE'ME.	CENEEE IIE'ME.
YDIPE, LA JALOUSIE.	YDIPE, LA JALOUSIE.
LA JALOUSIE.	LA JALOUSIE.
A voix a réveillé mes tranſports furieux, Je veux ſeconder ta vangeance;	A voix a réveillé mes transports furieux, Je veux seconder ta vengeance;
Et par de promts effets ſignaler ma puiſſance;	Et par de prêts effets signaler ma puissance;
C’eſt trop laiſſer en paix & la Terre & les Cieux.	C'est trop laisser en paix et la Terre et les Cieux.
Miniſtres de mes barbaries, Noirs ſoupçons, jalouſes furies, Quittez le ſejour des Enfers Pour venir avec moy troubler tout l’Univers:	Ministres de mes barbaries, Noirs soupçons, jalouses furies, Quittez le séjour des Enfers Pour venir avec moi troubler tout l'Univers:
Volez, diſperſeZ-vous du couchant à l’aurore, Exerçons en tous lieux nos funeſtes rigueurs, Et juſques dans les Cieux allons remplir les cœurs De la fureur qui nous dévore.	Volez, dispersez-vous du couchant à l'aurore, Exerçons en tous lieux nos funestes rigueurs, Et jusque dans les Cieux allons remplir les cœurs De la fureur qui nous dévore.
SCENE SIXIE’ME.	SCÈNE SIXIE'ME.
LA JALOUSIE, SUITE DE LA JALOUSIE.	LA JALOUSIE, SUITE DE LA JALOUSIE.
Les Soupçons, le Dépit, la Fureur, Le Deſeſpoir, la Haine, &c.	Les Soupçons, le Dépit, la Fureur, Le Désespoir, la Haine, etc.
CHOEUR.	CHOEUR.
Uittons le ſéjour des Enfers, QAllons troubler tout l'Univers, Volons, diſperſons-nous du couchant à l’aurore, Exerçons en tous tum nos funeſtes rigueurs, Et juſques dans les Cieux, allons remplir les cœurs De la fureur qui nous devore.	Uittons le séjour des Enfers, QAllons troubler tout l'Univers, Volons, dispersons-nous du couchant à l'aurore, Exerçons en tous tum nos funestes rigueurs, Et jusque dans les Cieux, allons remplir les cœurs De la fureur qui nous dévore.
La ſuite de la Jalouſie exprime la joye que luy donnent les ordres qu’elle vient de recevoir.	La suite de la Jalousie exprime la joie que Elle donnent les ordres qu'elle vient de recevoir.
T CIOEUR.	 TIOUR.
Quel plaiſir de répandre Dans un cœur trop tendre Un trouble fatal:	Quel plaisir de répandre Dans un cœur trop tendre Un trouble fatal:
Les plus triſtes allarmes Nous offrent les charmes D'un bien ſans égal:	Les plus tristes alarmes Nous offrent les charmes D'un bien sans égal:
La fureur & la ras Quand on les partage Ne ſont plus un mal.	La fureur et la ras Quand on les partage Ne sont plus un mal.
Quel plaiſir de répandre Dans un cœur trop tendre, Un trouble fatal.	Quel plaisir de répandre Dans un coeur trop tendre, Un trouble fatal.
Nous chaſſons l’allegreſſe, L’affreuſe triſteſſe Nous ſuit en tous lieux.	Nous chassons l'allégresse, L'affreuse tristesse Nous suit en tous lieux.
Nôtre rage inhumaine Triomphe ſans peine, Juſques dans les Cieux.	Notre rage inhumaine Triomphe sans peine, Jusques dans les Cieux.
Leur demeure tranquille N’eſt pas un azile Pour les grands Dieux.	Leur demeure tranquille N'est pas un asile Pour les grands Dieux.
Nous chaſſons l’allegreſſe, L’affreuſe triſteſſe Nous ſuit en tous lieux.	Nous chassons l'allégresse, L'affreuse tristesse Nous suit en tous lieux.
Fin du ſecond Acte.	Fin du second Acte.
VENOS ET ADONIS,	VENOS ET ADONIS,
IITE IIT Le Theatre repreſente un Jardin, que Venus à fait orner pour la Feſte qu’elle prépare à Adonis.	IITE IIT Le Théâtre représente un Jardin, que Venus à fait orner pour la Fête qu'elle prépare à Adonis.
Uelle pompe nouvelle éclate dans ces lieux ?	VUelle pompe nouvelle éclate dans ces lieux ?
Pour qui ſont deſtinez ces apprets odieux?	Pour qui sont destinés ces apprêts odieux?
Tout me confirme icy mon funeſte préſage;	Tout me confirme ici mon funeste présage;
Secrets preſſentimens qui deſſilleZ mes yeux, Ah!	Secrets pressentiments qui dessillez mes yeux, Ah!
ne m’aveZ-vous fait abandonner les Cieux, Que pour eſtre témoin des feuu ume vomge?	ne m'avez-vous fait abandonner les Cieux, Que pour être témoin des feuu me vomge?
SCENE PREMIERE.	SCÈNE PREMIÈRE.
MARS ſeul.	MARS seul.
Allons, il faut m'en éclaircir, Je ſçauray pénétrer ce funeſte myſtere, dai enm d ein ceun ve mna funt colere, Malheur à qui m'oſe trahir.	Allons, il faut m'en éclaircir, Je saurai pénétrer ce funeste mystère, dai enm d' in ceun ve mina fonct colère, Malheur à qui m'ose trahir.
CENE SECONDE.	CÈNE SECONDE.
MARS, UN SUIVANT DE MARS.	MARS, UN SUIVANT DE MARS.
VANT DE MARS.	VANT DE MARS.
E ne puis rien comprendre à ce deſordre horrible Où vôtre cœur ſemble floter.	E ne puis rien comprendre à ce désordre horrible Où votre cœur semble flotter.
I A Tu vois un exemple terrible Des tourmens où l’amour ſçait nous précipiter:	I À Tu vois un exemple terrible Des tourments où l'amour pourrait nous précipiter:
l'ignorois l’affreuſe triſteſſe Qu'une jalouſe crainte excite dans les cœurs, A mes yeux prévenus l’amour s’offroit ſans ceſſe Entoure de mille douceurs:	l'ignorais l'affreuse tristesse Qu'une jalouse crainte excite dans les cœurs, À mes yeux prévenus l'amour s'offrait sans cesse Entoure de mille douceurs:
Mais Venus ſur la terre aujourd’huy deſcenduë, Pour la premiere fois éloigné de ſes yeux, Tout ce qu’un noir ſoupçon à de plus furieux A frappé mon ame éperduë;	Mais Venus sur la terre aujourd'hui descendue, Pour la première fois éloigné de ses yeux, Tout ce qu'un noir soupçon à de plus furieux À frappé mon âme éperdue;
J’ay crû dans mes ſombres terreurs Voir en de nouveaux fers cette Amante volage, Bien-toſt la Jalouſie altumant mes fureurs.	J'ai cru dans mes sombres terreurs Voir en de nouveaux fers cette Amante volage, Bientôt la Jalousie altumant mes fureurs.
M’a tracé vers ces lieux un fidele paſſage, Et py viens piein u amour, ue colere & de rage, D’un ſoupçon ſi cruel éclaircir les horreurs.	M'a tracé vers ces lieux un fidèle passage, Et py viens piein amour, ue colère et de rage, un soupçon si cruel éclaircir les horreurs.
IVANT DE MARS.	IVANT DE MARS.
Un cœur qui s’abandonne à ſon inquiétude, Se repent bien ſouvent d'en avoir trop appris, Et peu d’Amans ſçavent le prix D’une flatteuſe incertitude.	Un cœur qui s'abandonne à son inquiétude, Se repent bien souvent d'en avoir trop appris, Et peu d'Amands savent le prix D'une flatteuse incertitude.
Non, il faut pour calmer l’exceZ de mon tourment, En immoler la cauſe à mon reſſentiment.	Non, il faut pour calmer l'excès de mon tourment, En immoler la cause à mon ressentiment.
Tremble Déeſſe criminelle, Tremble pour ton heureux Amant;	Tremble Déesse criminelle, Tremble pour ton heureux Amant;
Je vais par une mort cruelle Le punir de ton changement, Et le malheur d’être immortéle, Suffira pour ton châtiment.	Je vais par une mort cruelle Le punir de ton changement, Et le malheur d'être immortéle, Suffira pour ton châtiment.
ANT DE MARS.	ANT DE MARS.
Laiſſez-vous moins ſeduire au conſeil peu fidéle D’un téméraire emportement.	Laissez-vous moins séduire au conseil peu fidèle D'un téméraire emportement.
Une Maîtreſſe qu’on offence, Par une trop rude vangeance, Toſt ou tard ſe vange à ſon tour:	Une Maîtresse qu'on offense, Par une trop rude vengeance, Tôt ou tard se venge à son tour:
Et dans une beauté légere L'aigreur à mnt funt colere;	Et dans une beauté légère L'aigreur à mnt funt colère;
Eſt plus à craindre que l’amour.	Est plus à craindre que l'amour.
M A Si je puis averer l’outrage Que mon cœur me fait preſſentir, Je ſçauray m'épargner les maux d’un repentir Par le mépris d’une volage.	M MA Si je puis avérer l'outrage Que mon cœur me fait pressentir, Je sçauray m'épargner les maux d'un repentir Par le mépris d'une volage.
Mais de quels chants nouveaux retentiſſent les airs?	Mais de quels chants nouveaux retentissent les airs?
Qu'entens-je?	Qu'entends-je?
ANT DE MARS.	ANT DE MARS.
C’eſt Venus que nous voyons paroître.	C'est Venus que nous voyons paraître.
Sans doute cet Amant que je cherche à connoître Vient prendre part à ces concerts:	Sans doute cet Amant que je cherche à connaître Vient prendre part à ces concerts:
Cachons-nous aux yeux de l’ingrate, Pour un moment encor contraignons mes fureurs, Avant que ma vangeance éclate Je veux approfondir le ſecret de leurs cœurs.	Cachons-nous aux yeux de l'ingrate, Pour un moment encor contraignons mes fureurs, Avant que ma vengeance éclate Je veux approfondir le secret de leurs cœurs.
SCENE TROISIE'ME.	SCÈNE -TROISIE'ME.
VENUS, ADONIS, SUITE DE VENUS, SUITE D’ADONIS.	VENUS, ADONIS, SUITE DE VENUS, SUITE D'ADONIS.
LE CHOEUR.	LE CHOEUR.
Eureux Amans que vos flâmes ſont IN belles, Que vos nœuds ſont doux!	Eurux Amants que vos flammes sont IN belles, Que vos nœuds sont doux!
Soyez fidelles, Les plus beaux jours ne ſont faits que pour vous;	Soyez fidèles, Les plus beaux jours ne sont faits que pour vous;
Les doux tranſports de vôtre ardeur naiſſante Font tous vos plaiſirs:	Les doux transports de votre ardeur naissante Font tous vos plaisirs:
L’amour prend ſoin de former vos deſirs, It voua exemte Des triſtes ſoûpirs.	L'amour prend soin de former vos désirs, It voua exemte Des tristes soupirs.
Heureux Amans que vos flâmes ſont belles, Que vos nœuds ſont doux!	Heureux Amants que vos flammes sont belles, Que vos nœuds sont doux!
Soyez fidelles, Les plus beaux jours ne ſont faits que pour vous.	Soyez fidèles, Les plus beaux jours ne sont faits que pour vous.
ENUS ET ADONIS.	ENS ET ADONIS.
Tendre prix des ames conſtantes, Ardeurs charmantes, Douces langueurs, Soyte jans teſe renaiſſames.	Tendre prix des âmes constantes, Ardeurs charmantes, Douces langueurs, Soite jans tes renaissames.
Douces 210 Douces langueurs, AAbours vuurmuntes, Regnez à jamais dans nos cœurs.	Douces 210 Douces langueurs, AAbours vuurmuntes, Regnez à jamais dans nos cœurs.
DEUR.	DEUR.
Connoy le prix d’une ſi grande Gloire Mortel trop heureux.	Connais le prix d'une si grande Gloire Mortel trop heureux.
Quelle victoire Le tendre Amour vient offrir à tes vœux!	Quelle victoire Le tendre Amour vient offrir à tes vœux!
C’eſt pour toy ſeul qu’une aimable Déeſſe Deſcend dans ces lieux.	C'est pour toi seul qu'une aimable Déesse Descend dans ces lieux.
Tu la contrains de mépriſer les Cieux, Et la tendreſſe D’un des plus grands Dieux, Connoy le prix d’une ſi grande gloire Mortel trop heureux.	Tu la contrains de mépriser les Cieux, Et la tendresse D'un des plus grands Dieux, Connoi le prix d'une si grande gloire Mortel trop heureux.
Quelle victoire Le tendre Amour vient offrir à tes vœux!	Quelle victoire Le tendre Amour vient offrir à tes vœux!
Les Graces, les Tianis, ce toute la Jeuneſſe galante de l’Iſle de Cypre, viennent rendre leurs hommages à Venus & à Adonis.	Les Grâces, les Tianis, ce toute la Jeunesse galante de l'Île de Cypre, viennent rendre leurs hommages à Venus et à Adonis.
UN DES PLAISIRS chante ce Menuet avec le Chœur.	UN DES PLAISIRS chante ce Menuet avec le Chœur.
Non, ce n’eſt point la grandeur ſuprême Qui fait trouver le ſort le plus heureux.	Non, ce n'est point la grandeur suprême Qui fait trouver le sort le plus heureux.
HOEUR.	HOUR.
Non ce n’eſt point la grandeur ſuprême Qui fait trouver le ſort le plus heureux.	Non ce n'est point la grandeur suprême Qui fait trouver le sort le plus heureux.
UN DES PLAISIRS.	UN DES PLAISIRS.
Leiai pompeux a une puiſſance extréme N’exemte pas de mille ſoins facheux.	Liai pompeux a une puissance extrême N'exempte pas de mille soins fâcheux.
LE CHOEUR.	LE CHOEUR.
Non ce n’eſt point la grandeur ſuprême Qui fait trouver le ſort le plus heüreux.	Non ce n'est point la grandeur suprême Qui fait trouver le sort le plus heüreux.
DES PLAISIRS.	DES PLAISIRS.
Se voir cheri de l’objet que l’on aime, Vivre contens, former les mêmes vœux, C’eſt le ſouverain bien des Dieux même.	Se voir chéri de l'objet que l'on aime, Vivre contens, former les mêmes vœux, C'est le souverain bien des Dieux même.
LE CHOEUR.	LE CHOEUR.
Non ce ce n’eſt point la grandeur ſuprême Qui fait trouver le ſort le plus heureux.	Non ce ce n'est point la grandeur suprême Qui fait trouver le sort le plus heureux.
one des Graces enance ce menuet alternativement	one des Grâces enance ce menuet alternativement
avec le Chœur.	avec le Chœur.
Lors que l’amour dans ſes nœuds nous appelle, Pourquoy s’armer d’une vaine fierté?	Lors que l'amour dans ses nœuds nous appelle, Pourquoi s'armer d'une vaine fierté?
Il vaut mieux prendre une chaîne ſi belle, Que de languir dans nôtre liberté.	Il vaut mieux prendre une chaîne si belle, Que de languir dans notre liberté.
Second Couplet.	Second Couplet.
Ne craignons point de luy rendre les armes, Ne craignons point de pouſſer des ſoûpirs;	Ne craignons point de Seigneur rendre les armes, Ne craignons point de pousser des soupirs;
Si quelquefois tue fani ourfer uieo turmes, On en eſt trop payé par ſes plaiſirs.	Si quelquefois tue sani ourfer uieo turmes, On en est trop payé par ses plaisirs.
LE CHOEUR.	LE CHOEUR.
Aauie puious jupos Duua:	Aavie pu jupos Dua:
queut fureur l’inſpire!	queut fureur l'inspire!
Quels regards menaçans ſes yeux lancent ſur nous.	Quels regards menaçans ses yeux lancent sur nous.
S.	S.
Ne craignez rien, allez, que chacun ſe retire, Jupuiſeruſ vuncioſ ſes mouvemens jaloux.	Ne craignez rien, allez, que chacun se retire, Jupuiserus vuncios ses mouvements jaloux.
SCENE QUATRIE’ME.	SCÈNE QUATRIE'ME.
MARS, VENUS.	MARS, VENUS.
U ſont-ils ces objets de ma juſte vengeance?	V sont-ils ces objets de ma juste vengeance?
J Ces Amans odieux, que ſont-ils devenus?	 Ces Amants odieux, que sont-ils devenus?
En quel lieu?	En quel lieu?
Mais je voy l’infidéle V’enus:	Mais je vois l'infidèle V'enus:
Perfide, pouves bous jouienu ma préſence Aprés vôtre infidélité, Et ne craigneZ-vous point mon amour irrité.	Perfide, pouvez bous jouienv ma présence Après votre infidélité, Et ne craignez-vous point mon amour irrité.
S.	S.
De quel injuſte effroy vôtre ame eſt-elle atteinte?	De quel injuste effroi votre âme est-elle atteinte?
Quels ſont ces indignes ſoupçons?	Quels sont ces indignes soupçons?
S Ah finiſſeZ une importune feinte, Mes yeux ont éclaircy toutes vos trahiſons;	S Ah finissez une importune feinte, Mes yeux ont éclairci toutes vos trahisons;
Mais ne préſumeZ pas qu’un rival témeraire Puiſſe ſe garantir des traits de ma colére:	Mais ne présumez pas qu'un rival témeraire Puisse se garantir des traits de ma colère:
En vain à mes regards vos ſoins l’ont ſceu cacher, Juſques dans les Enfers je ſçauray le chercher.	En vain à mes regards vos soins l'ont su cacher, Jusque dans les Enfers je saurai le chercher.
Ne tardons plus, cedons au couroux qui m’anime, Suivons cet Amant fortuné, Qu’il ſoit de mes fureurs la premiere victime, Et que l’Univers étonné Frémiſſe en apprenant ma vengeance & ſon crime.	Ne tardons plus. cédons au courroux qui m'anime, Suivons cet Amant fortuné, Qu'il soit de mes fureurs la première victime, Et que l'Univers étonné Frisse en apprenant ma vengeance et son crime.
Je vois avec plaiſir ce dépit éclatant, Il m'aſſure un amour delicat & conſtant.	Je vois avec plaisir ce dépit éclatant, Il m'assure un amour délicat et constant.
On connoiſt mieux un cœur ſenſible Dans l'éclat d’un jaloux tranſport, Que dans l’aſſurance paiſible Dun Amunt content de ſon fort.	On connaît mieux un cœur sensible Dans l'éclat d'un jaloux transport, Que dans l'assurance paisible Dun Amunt content de son fort.
1 Non n’eſpereZ pas infidéle Que je puiſſe oublier un ſi noir changement.	1 Non n'espérez pas infidèle Que je puisse oublier un si noir changement.
Venus ſçaura calmer un tel emportement.	Venus sçaura calmer un tel emportement.
Non n’eſperez pas infidéle Que je puiſſe oublier un ſi noir changement;	Non n'espérez pas infidèle Que je puisse oublier un si noir changement;
Plus je von amuſ tommument, Plus ma haine ſera cruelle.	Plus je von amus tommument, Plus ma haine sera cruelle.
S.	S.
Ceſſez de m’outrager par d’injuſtes tranſports;	Cessez de m'outrager par d'injustes transports;
Mon départ vous a fait douter de ma tendreſſe, Et j’ay ſceu que cette foibleſſe Vous avoit conduit ſur ces bords.	Mon départ vous a fait douter de ma tendresse, Et j'ai su que cette faiblesse Vous avait conduit sur ces bords.
J'ay voulu vous punir d’un ſoupçon qui m’offenſe;	J'ai voulu vous punir d'un soupçon qui m'offense;
Sous le voile trompeur d’un amour concerté, J’ay ſurpris en ces lieux vôtre crédulité Par une frivole apparence:	Sous le voile trompeur d'un amour concerté, J'ai surpris en ces lieux votre crédulité Par une frivole apparence:
avran c'eſt aſſeZ long-tems jouir de votre erreur, J’ay pitié des frayeurs où s’égare vôtre ame, Et mon cœur doit à voſtre flâme Le ſoin de diſſiper cette vaine terreur.	avran c'est assez longtemps jouir de votre erreur, J'ai pitié des frayeurs où s'égare votre âme, Et mon cœur doit à votre flamme Se soin de dissiper cette vaine terreur.
ARS.	ARS.
Ciel!	Ciel!
croiray-je?	croirai-je?
mais non je voy voſtre artifice.	mais non je vois votre artifice.
Quoy?	Quoi?
vous oſez douter de ma ſincerité?	vous osez douter de ma sincérité?
Ah c’eſt trop d’un Amant éprouver l’injuſtice, Je doy rougir de ma lâche bonté.	Ah c'est trop d'un Amant éprouver l'injustice, Je dois rougir de ma lâche bonté.
ParteZ, ſuivez en liberté Les injuſtes conſeils d’un aveugle caprice, Je vous laiſſe nourrir vos ſoupçons odieux, Allez, & gardez-vous de paraître à mes yeux.	Partez, suivez en liberté Les injustes conseils d'un aveugle caprice, Je vous laisse nourrir vos soupçons odieux, Allez, et gardez-vous de paraître à mes yeux.
Ah cruelle arrêtez.	Ah cruelle arrêtez.
Ciel quelle eſt ma foibleſſe!	Ciel quelle est ma faiblesse!
Mais il faut de mon ſort ſubir la triſte loy, Un funeſte penchant m'entraîne malgré moy, Et fait de mon dépit triompher ma tendreſſe.	Mais il faut de mon sort subir la triste loi, Un funeste penchant m'entraîne malgré moi, Et fait de mon dépit triompher ma tendresse.
Non, vôtre amour n’eſt point égal à mon ardeur.	Non, votre amour n'est point égal à mon ardeur.
Ah!	Ah!
daignez mieux juger des tranſports de mon cœur.	daignez mieux juger des transports de mon cœur.
Tous deux enſemble.	Tous deux ensemble.
Mon ame n'eſt aſſervie Qu’au ſeul deſir de vous voir;	Mon âme n'est asservie Qu'au seul désir de vous voir;
Il fait mon plus doux eſpoir, Il fait ma plus chere envie.	Il fait mon plus doux espoir, Il fait ma plus chère envie.
Qu'il m'eſt doux de vous voir goûter un plein repos!	Qu'il m'est doux de vous voir goûter un plein repos!
Je vais quitter ces lieux pour me rendre à Paphos, Je joüiray bien-toſt de l’heureux avantage De revoir le Dieu qui m’engage.	Je vais quitter ces lieux pour me rendre à Paphos, Je jouirai bientôt de l'heureux avantage De revoir le Dieu qui m'engage.
CENE CINQUIE’ME.	CÈNE CINQUIE'ME.
MARS, ſeul.	MARS, seul.
Outons un repos pleïn d’attraits, T Le calme d’une heureuſe paix Succéde à mes inquiétudes.	Outons un repos plein d'attraits, T Le calme d'une heureuse paix Succède à mes inquiétudes.
Cruels ſoupçons, triſtes ſoûpirs, C’est à vos tourmens les plus rudes Que je doy mes plus doux plaiſirs.	Cruels soupçons, tristes soupirs, C'est à vos tourments les plus rudes Que je dois mes plus doux plaisirs.
Sortons d’une terreur funeſte, Venus a diſſipe les troubles de mon cœur, Retournons au ſejour Céleſte.	Sortons d'une terreur funeste, Venus a dissipe les troubles de mon cœur, Retournons au séjour Céleste.
CENE SIXIE’ME.	CÈNE SIXIE'ME.
MARS, CYDIPE.	MARS, CYDIPE.
DIPE.	DIPE.
Rrête, Dieu credule, & repren ta fureur:	Rrête, Dieu crédule, et repren ta fureur:
Séduit par un vain artifice, Sur la foy des ſermens d’une ingrate beauté, Tu crois tes feux en ſeureté;	Séduit par un vain artifice, Sur la foi des serments d'une ingrate beauté, Tu crois tes feux en sûreté;
Mais c’eſt trop faire grace à ſa noire injuſtice.	Mais c'est trop faire grâce à sa noire injustice.
Tu vois un cœur en proye aux plus vives douleurs, Devorée en ſecret d’une flame fatale, J’adorois un ingrat, heureuſe en mes malheurs, Puiſque j’aimois du moins ſans craindre de rivale.	Tu vois un cœur en proie aux plus vives douleurs, Devorée en secret d'une flamme fatale, J'adorais un ingrat, heureuse en mes malheurs, Puisque j'aimais du moins sans craindre de rivale.
Mon cœur ſouffroit tranquillement:	Mon cœur souffrait tranquillement:
Ah falloit-il Déeſſe trop cruelle Oter encor à ma douleur mortelle Un ſi foible ſoulagement.	Ah fallait-il Déesse trop cruelle Oter encor à ma douleur mortelle Un si faible soulagement.
M A RS.	M À RS.
O Ciel!	Ô Ciel!
en quelle erreur mon aveugle tendreſſe Avoit-elle pû me plonger!	en quelle erreur mon aveugle tendresse Avait-elle pu me plonger!
Ah je rougis de ma foibleſſe, Ne quittons pas du moins ces lieux ſans nous vanger.	Ah je rougis de ma faiblesse, Ne quittons pas du moins ces lieux sans nous venger.
M I 2 ET CYDIPE.	M I 2 ET CYDIPE.
Courons à la vangeance, Uniſſons-nous dans nos tranſports:	Courons à la vengeance, Unissons-nous dans nos transports:
Vangeons par de communs efforts Nôtre amour qu’on offenſe.	Vengeons par de communs efforts Notre amour qu'on offense.
Fin du troiſiéme Acte.	Fin du troisième Acte.
ACTE IV.	ACTE IV.
AROIEIV Le Ineatre repreſente la Ville d’Amathonte.	AROIEIV Le Ineâtre représente la Ville d'Amathonte.
SCENE PREMIERE.	SCÈNE PREMIÈRE.
VENUS, ADONIS.	VENUS, ADONIS.
S.	S.
Une aveugle fureur Mars n’eſt plus ité, Pour vos jours déſormais je n’ay plus rien à craindre;	Une aveugle fureur Mars n'est plus ité, Pour vos jours désormais je n'ai plus rien à craindre;
Et nôtre amour en ſûreté Peut s’expliquer ſans ſe contraindre.	Et notre amour en sûreté Peut s'expliquer sans se contraindre.
Les Peuples de Paphos s’aſſemblent dans ce jour Pour célébrer celuy de ma naiſſance:	Les Peuples de Paphos s'assemblent dans ce jour Pour célébrer celui de ma naissance:
Je ne puis à leurs jeux refuſer ma préſence;	Je ne puis à leurs jeux refuser ma présence;
Mais j'eſpere bien-toſt par un heureux retour Repurer cos momono que verrt vriſte abſencę Va dérober à mon amour.	Mais j'espère bientôt par un heureux retour Répurer cos momono que verrt vriste absenc Va dérober à mon amour.
ADONIS.	ADONIS.
O Ciel!	Ô Ciel!
que veneZ-vous m’aprendre?	que venez-vous m'apprendre?
A quel ſuppuice aſreux m'oſez-vous condamner?	À quel supice asreux m'osez-vous condamner?
A peine mes ſoûpirs ont ſceu ſe faire entendre, Et vous voulez m’abandonner?	À peine mes soupirs ont su se faire entendre, Et vous voulez m'abandonner?
3.	3.
Eſt-ce abandonner ce qu’on aime Que de s'en eloigner pour un jour ſeulement?	Est-ce abandonner ce qu'on aime Que de s'en éloigner pour un jour seulement?
ADONIS.	ADONIS.
Abumi uuns mu veuleur extréme, Que ce jour malheureux coulera lentement!	Abumi uuns mu leur extrême, Que ce jour malheureux coulera lentement!
5.	5.
Plus l’abſence cauſe d’allarmes, Plus le retour promet de douceurs & de charmes.	Plus l'absence cause d'alarmes, Plus le retour promet de douceurs et de charmes.
8 S.	8 S.
Songez aux déplaiſirs que vous m’allez couter.	Songez aux déplaisirs que vous m'allez coûter.
IUS.	JUS.
J'en reſſens comme vous les cruelles atteintes.	J'en ressens comme vous les cruelles atteintes.
A S.	À S.
Vous eſtes ſenſible à mes plaintes, Cepenimni cous m'allez quitter?	Vous êtes sensible à mes plaintes, Cépenimni cous m'allez quitter?
Par cet éloignement ſouffrez que je ménage L’amour que je vous ay donné:	Par cet éloignement souffrez que je ménage L'amour que je vous ai donné:
Vous en ſereZ moins fortuné;	Vous en sereZ moins fortuné;
Mais vous en aimereZ peut-eſtre davantage.	Mais vous en aimez peut-être davantage.
Pouvez-vous douter de ma foy?	Pouvez-vous douter de ma foi?
Que cette défiance eſt injuſte & cruelle!	Que cette défiance est injuste et cruelle!
Ah quand on aime comme moy, Plus on ſe voit heureux & plus on eſt fidelle.	Ah quand on aime comme moi, Plus on se voit heureux et plus on est fidèle.
Un cœur ſans crainte & ſans deſirs Se laſſe bien-toſt de ſes chaînes:	Un cœur sans crainte et sans désirs Se lasse bientôt de ses chaînes:
L’amour s’éteint par les plaiſirs Et ſe rallume par les peines.	L'amour s'éteint par les plaisirs Et se rallume par les peines.
Aprés avoir flatté les plus doux de mes vœux, Vous m'accablez des traits d’une rigueur mortelle, Ma peine ſeroit moins cruelle Si j’avois eſté moins heureux.	Après avoir flatté les plus doux de mes vœux, Vous m'accablez des traits d'une rigueur mortelle, Ma peine serait moins cruelle Si j'avais été moins heureux.
C’eſt par les chagrins & les larmes Que l’amour fait payer ſes plus tendres faveurs:	C'est par les chagrins et les larmes Que l'amour fait payer ses plus tendres faveurs:
On eſt peu ſenſible à ſes charmes, Lors que l'on n'a jamais éprouvé ſes rigueurs.	On est peu sensible à ses charmes, Lors que l'on n'a jamais éprouvé ses rigueurs.
Mais c’eſt trop differer un depart néceſſaire:	Mais c'est trop différer un départ nécessaire:
Adieu, conſolez-vous dans cet éloignement, S’il ne faut pour vous ſatisfaire Tupuiugembotre tourment.	Adieu, consolez-vous dans cet éloignement, S'il ne faut pour vous satisfaire Tupviugembotre tourment.
SCENE SECONDE.	SCÈNE SECONDE.
ADONIS ſeul.	ADONIS seul.
FUneſte & rigoureuſe abſence, Que vous m’allez coûter de ſoûpirs & de pleurs.	FUneste et rigoureuse absence, Que vous m'allez coûter de soupirs et de pleurs.
En vain d’un promt retour la flateuſe eſperance Veut calmer mes vives douleurs.	En vain d'un prompt retour la flatteuse espérance Veut calmer mes vives douleurs.
Bioigne ues etuux yeux dont je ſens la puiſſance, Je ne ſonge qu'a mes malheurs:	Bioigne êtes étuux yeux dont je sens la puissance, Je ne songe qu'a mes malheurs:
Funeſte & rigoureuſe abſence Que vous m’allez coûter de ſoûpirs & de pleurs?	Funeste et rigoureuse absence Que vous m'allez coûter de soupirs et de pleurs?
SCENE TROISIE'ME.	SCÈNE -TROISIE'ME.
MARS, CYDIPE, ADONIS.	MARS, CYDIPE, ADONIS.
MARS ET CYDIPE.	MARS ET CYDIPE.
Eſt tarder trop long-tems à punir ton audace, Reconnoy le Dieu de la Thrace, Tremble témeraire rival, Il eſt tems qu’une mort cruelle v ange le dejejpoir jatal, Où nous livre aujourd’huy ta flâme criminelle.	Est tarder trop longtemps à punir ton audace, Reconnais le Dieu de la Thrace, Tremble témeraire rival, Il est temps qu'une mort cruelle v ange le dejejpoir jatal, Où nous livre aujourd'hui ta flamme criminelle.
Eſt-ce un crime de trop aimer, uand le Ciel nous a fait un cœur ſenſible & tendre?	Est-ce un crime de trop aimer, uand le Ciel nous a fait un cœur sensible et tendre?
Si l’amour peut forcer des Dieux à s’enflâmer, Un mortel peut-il s’en deffendre?	Si l'amour peut forcer des Dieux à s'enflammer, Un mortel peut-il s'en défendre?
MARS ET CYDIPE.	MARS ET CYDIPE.
En vain tu crois nous attendrir;	En vain tu crois nous attendrir;
Perfide ta mort eſt certaine, Il faut te reſoudre à périr Ou rompre une fatale chaine.	Perfide ta mort est certaine, Il faut te résoudre à périr Ou rompre une fatale chaine.
ADONIS, à Cydipe.	ADONIS, à Cydipe.
Quel ſujet de couroux vous arme contre moy?	Quel sujet de courroux vous arme contre moi?
IPE.	IPE.
Puis-je aſſez te punir de m’avoir trop ſceu plaire?	Puis-je assez te punir de m'avoir trop su plaire?
Par les tranſports de ma colére, Ingrat connoy l’amour dont je brûle pour toy;	Par les transports de ma colère, Ingrat connais l'amour dont je brûle pour toi;
Renonce au penchant qui te guide, Evite un affreux chatiment.	Renonce au penchant qui te guide, Évite un affreux châtiment.
S.	S.
Suivez, ſuivez plûtoſt vôtre reſſentiment, Je crains moins le trépas que le nom de perfide.	Suivez, suivez plutôt votre ressentiment, Je crains moins le trépas que le nom de perfide.
MARS.	MARS.
Traitre, c'eſt trop fouffrir tes inſolens diſcours, Il eſt tems que la mort en termine le cours.	Taitre, c'est trop souffrir tes insolents discours, Il est temps que la mort en termine le cours.
TDIPE.	TDIPE.
Dieux!	Dieux!
que vois-je ?	que vois-je ?
arrêtez, que prétendez vous faire ?	arrêtez, que prétendez -vous faire ?
Dieu puiſſant, révoqueZ, un arreſt ſi ſevére.	Dieu puissant, révoquez, un arrêt si sévère.
Ah ſi votre couroux ne ſçauroit s’appaiſer Que par un ſanglant ſacrifice, De mes funeſtes jours vous pouvez diſpoſer;	Ah si votre courroux ne saurait s'apaiser Que par un sanglant sacrifice, De mes funestes jours vous pouvez disposer;
Frappez, & terminant ma vie & mon ſupplice, Dans les flots de mon ſang puiſſiez vous épuiſer Les rigueurs de vôtre juſtice.	Frappez, et terminant ma vie et mon supplice, Dans les flots de mon sang puissiez vous épuiser Les rigueurs de votre justice.
MARS.	MARS.
Quelle indigne pitié calme vôtre couroux?	Quelle indigne pitié calme votre courroux?
Mais je veux bien vous ſatisfaire, Et les tranſports de ma colére Dédaignent d’éclater par de ſi foibles coups.	Mais je veux bien vous satisfaire, Et les transports de ma colère Dédaignent d'éclater par de si faibles coups.
C’eſt peu d’une ſeule victime Pour calmer mon reſſentiment, Il faut à mon injure un vaſte chatiment, Les peuples de ces bords ont partagé ſon crime Par leur lache applaudiſſement, Ils vont tous éprouver la fureur qui m’anime.	C'est peu d'une seule victime Pour calmer mon ressentiment, Il faut à mon injure un vaste châtiment, Les peuples de ces bords ont partagé son crime Par leur lâche applaudissement, Ils vont tous éprouver la fureur qui m'anime.
Fuy traître, hate-toy de partir de ces lieux;	Fui traître, hâte-toi de partir de ces lieux;
Et vous qui prenez ſa deffenſe, AlleZ de ſon deſtin gémir loin de mes yeux, Et ne troublez plus ma vengeance.	Et vous qui prenez sa défense, Allez de son destin gémir loin de mes yeux, Et ne troublez plus ma vengeance.
CENE QUATRIE'ME.	CÈNE QUATRIE'ME.
MARS ſeul.	MARS seul.
’En eſt fait, le dépit vient d’éteindre mes feux;	Ç'En est fait, le dépit vient d'éteindre mes feux;
Aprés un tourment rigoureux, Qu'il eſt doux de pouvoir punir une volage!	Après un tourment rigoureux, Qu'il est doux de pouvoir punir une volage!
Trop heureux un cœur outragé Qui jouit du bonheur de ſortir d’eſclavage, Et du plaiſir d’être vangé.	Trop heureux un cœur outragé Qui jouit du bonheur de sortir d'esclavage, Et du plaisir d'être vengé.
VeneZ implacable Bellone, ObéïſſeZ aux loix que ma fureur vous donne:	Venez implacable Belone, Obéissez aux lois que ma fureur vous donne:
Sauvez-moy de l’affront d’immoler des ingrats, Indignes de périr ſous l’effort de mon bras;	Sauvez-moi de l'affront d'immoler des ingrats, Indignes de périr sous l'effort de mon bras;
Secondez ma jalouſe rage, Portez dans ces triſtes climats L’effroy, la mort, & le carnage;	Secondez ma jalouse rage, Portez dans ces tristes climats L'effroi, la mort, et le carnage;
Que ce Peuple odieux de coups mortels frappé Sous ſes murs abbatus periſſe enveloppé, Et qu’un fleuve de ſang inondant ce rivage, Aille par cent canaux divers Annoncer ma vangeance au bout de l’Univers.	Que ce Peuple odieux de coups mortels frappé Sous ses murs abattus périsse enveloppé, Et qu'un fleuve de sang inondant ce rivage, Aille par cent canaux divers Annoncer ma vengeance au bout de l'Univers.
SCENE CINQUIE’ME.	SCÈNE CINQUIE'ME.
MARS, BELLONE.	MARS, BÉLLONE.
BELLONE.	BÉLONE.
J Ar mes empreſſemens connoy quel eſt mon zéle, Je vole où ta fureur m’appelle, Bien- toſt mes cruauteZ appuyant ton couroux, Vont détruire un peuple coupable, Pour le cœur de Bellone eſt-il un bien plus doux Qu'une vangeance impitoyable.	JE Ar mes empressements connais quel est mon zèle, Je vole où ta fureur m'appelle, Bien- tôt mes cruautéz appuyant ton courroux, Vont détruire un peuple coupable, Pour le cœur de Blone est-il un bien plus doux Qu'une vengeance impitoyable.
Vous qui m’accompagnez dans l’horreur des combats, HateZ-vous de ſuivre mes pas;	Vous qui m'accompagnez dans l'horreur des combats, Hatez-vous de suivre mes pas;
Servons d’un Dieu vangeur la haine impatiente, Courons, uniſſons nos efforts:	Servons d'un Dieu vengeur la haine impatiente, Courons, unissons nos efforts:
Répandons en ces lieux l’horreur & l’épouvante, Ravageons ces funeſtes bords.	Répandons en ces lieux l'horreur et l'épouvante, Ravageons ces funestes bords.
Que ces murs embraſez, que la terre ſanglante Signalent nos cruels tranſports.	Que ces murs embrasés, que la terre sanglante Signalent nos cruels transports.
Servons d’un Dieu vangeur la haine impatiente, Courons, uniſſons nos efforts.	Servons d'un Dieu vengeur la haine impatiente, Courons, unissons nos efforts.
SCENE VI.	SCÈNE VI.
SCENE SIXIE’ME.	SCÈNE SIXIE'ME.
MARS, BELLONE, SUITE DE BELLONE.	MARS, BÉLLONE, SUITE DE BELONE.
CHOEUR.	CHOEUR.
Ervons d’un Dieu vangeur la haine impatiente, Courons, uniſſons nos efforts:	Ervons d'un Dieu vengeur la haine impatiente, Courons, unissons nos efforts:
Répandons en ces lieux l’horreur & l’épouvante, Ravageons ces funeſtes bords.	Répandons en ces lieux l'horreur et l'épouvante, Ravageons ces funestes bords.
Que ces murs embraſez, que la terre ſanglante Signalent nos cruels tranſports;	Que ces murs embrasés, que la terre sanglante Signalent nos cruels transports;
Servons d’un Dieu vangeur la haine impatiente, Courons, uniſſons nos efforts.	Servons d'un Dieu vengeur la haine impatiente, Courons, unissons nos efforts.
Les ſuivans de Bellone un poignard dans une main, & des torches allumées dans l’autre, portent le ravage dans Amathonte, & en pourſuivent les habitans.	Les suivants de Belone un poignard dans une main, et des torches allumées dans l'autre, portent le ravage dans Amathonte, et en poursuivent les habitants.
LE CHOEUR.	LE CHOEUR.
Vangeons-nous de l’amour fatal D’un trop heureux rival.	Vengeons-nous de l'amour fatal D'un trop heureux rival.
De ce coupable objet il faut purger la terre, Que ſa mort couronne à nos yeux Les maux qu’ont faits en ces lieux La flâme & la guerre;	De ce coupable objet il faut purger la terre, Que sa mort couronne à nos yeux Les maux qu'ont faits en ces lieux La flamme et la guerre;
Vangeons-nous de l’amour fatal D’un trop heureux rival.	Vengeons-nous de l'amour fatal D'un trop heureux rival.
MA L s Arrêtez, ſuſpendez l’ardeur qui vous anime, Et ne vous chargez point d’une indigne victime.	MA L Arrêtez, suspendez l'ardeur qui vous anime, Et ne vous chargez point d'une indigne victime.
Le ſort d’un rival odieux, S’il tomboit ſous vos coups ſeroit trop glorieux:	Le sort d'un rival odieux, S'il tombait sous vos coups serait trop glorieux:
Je veux que ſa mort ſoit l’ouvrage Du plus vil habitant des bois.	Je veux que sa mort soit l'ouvrage Du plus vil habitant des bois.
O toy dont ce perfide oſe trahir les loix Diane, ſi ton cœur eſt ſenſible à l’outrage Que ſes feux t’ont fait recevoir, Sers-toy pour le punir, de ton fatal pouvoir, Qu'un monſtre furieux s’arme pour ſon ſupplice, Et par cet affreux ſacrifice, Inſtruiſons à jamais les cœurs audacieux Du reſpect qu’ils doivent aux Dieux.	Ô toi dont ce perfide ose trahir les lois Diane, si ton cœur est sensible à l'outrage Que ses feux t'ont fait recevoir, Sers-toi pour le punir, de ton fatal pouvoir, Qu'un monstre furieux s'arme pour son supplice, Et par cet affreux sacrifice, Instruisons à jamais les cœurs audacieux Du respect qu'ils doivent aux Dieux.
Fin du quatriéme Acte.	Fin du quatrième Acte.
AYORE Le Theatre repreſente les ruïnes d’Amathonte & des Campagnes voiſines.	AYORE Le Théâtre représente les ruines d'Amathonte et des Campes voisines.
CENE PREMIE’RE.	CÈNE PREMIE'RE.
MARS, CHOEURS DE PEUPLES derriere le Theatre.	MARS, CHOEURS DE PEUPLES derrière le Théâtre.
al ld D Nfin je vay bien-toſt voir punir qui m’offenſe Diane à ſatisfait à mon impatience;	al léd D Nfin je vay bientôt voir punir qui m'offense Diane à satisfait à mon impatience;
Et ſans interreſſer la gloire de mon bras, Elle a de mon rival préparé le trépas.	Et sans interresser la gloire de mon bras, Elle a de mon rival préparé le trépas.
CHOEUR derrière le Theatre.	CHOEUR derrière le Théâtre.
Prenez pitié de nôtre peine, Dieux puiſſans que nos pleurs appaiſent vôtre haine.	Prenez pitié de notre peine, Dieux puissants que nos pleurs apaisent votre haine.
MARS.	MARS.
ſe vou a tes vri pieins d’horreur, Que le monſtre déja fait ſentir ſa fureur.	se vou a tes vry pieins d'horreur, Que le montre déjà fait sentir sa fureur.
CHOEUR derriere le Theatre.	CHOEUR derrière le Théâtre.
Prenez pitié de nôtre peine, Dieux puiſſans que nos pleurs appaiſent vôtre haine.	Prenez pitié de notre peine, Dieux puissants que nos pleurs apaisent votre haine.
MARS.	MARS.
Que ces gémiſſemens ſont pour moy pleins d’appas!	Que ces gémissements sont pour moi pleins d'appas!
La perfide Venus ne triomphera pas De mes tourmens & de ſon inconſtance.	La perfide Venus ne triomphera pas De mes tourments et de son inconstance.
Qu’il eſt doux aux cœurs mepriſez De retrouver dans la vangeance, Les plaiſirs que l’amour leur avoit refuſez!	Qu'il est doux aux cœurs méprisés De retrouver dans la vengeance, Les plaisirs que l'amour leur avait refusés!
SCENE SECONDE.	SCÈNE SECONDE.
MARS, CYDIPE.	MARS, CYDIPE.
DIPE.	DIPE.
CIel!	CIel!
quel effroyable ravage!	quel effroyable ravage!
O Mars, ſoyez touché d’un ſi funeſte ſort!	Ô Mars, soyez touché d'un si funeste sort!
Un monſtre anime par la rage, Séme de toutes parts l’épouvante & la mort.	Un montre anime par la rage, Sême de toutes parts l'épouvante et la mort.
Ah faut-il que nos pleurs vous trouvent inſenſible, Et le couroux tues Duun doit-il eſtre infléxible.	Ah faut-il que nos pleurs vous trouvent insensible, Et le courroux tues Duun doit-il être infléxible.
MARS.	MARS.
Non non, rien ne peut m’attendrir, Vos peuples inſolens ne ſçauroient trop ſouffrir:	Non non, rien ne peut m'attendrir, Vos peuples insolents ne sauraient trop souffrir:
Je ne puis trop punir le criminel hommage, Dont ils ont couronné les feux d’une volage;	Je ne puis trop punir le criminel hommage, Dont ils ont couronné les feux d'une volage;
Mais leur juſte trépas n’eſt qu’un degré fatal A la perte de mon rival.	Mais leur juste trépas n'est qu'un degré fatal À la perte de mon rival.
Diane a de ſa mort flatté mon eſperance, Je n’ay plus qu’à quitter un ſéjour odieux, Je pars, & je vai dans les Cieux Attendre le ſuccez d’une juſte vangeance.	Diane a de sa mort flatté mon espérance, Je n'ai plus qu'à quitter un séjour odieux, Je pars, et je vais dans les Cieux Attendre le succès d'une juste vengeance.
CYDIPE ſeule.	CYDIPE seule.
n uiſparou, o fuſtes Dieux!	 nuisparou, ô fûtes Dieux!
Adonis va périr, Ciel!	Adonis va périr, Ciel!
prenez, ſa défenſe!	prenez, sa défense!
SCENE TROISIE’ME.	SCÈNE -TROISIE'ME.
CYDIPE, ADONIS.	CYDIPE, ADONIS.
DIPE.	DIPE.
AAH Prince où portez-vous vos pas?	AH Prince où portez-vous vos pas?
ADONIS.	ADONIS.
fe vais d’un monſtre affreux délivrer ces climats.	se vais d'un monstre affreux délivrer ces climats.
I E.	I Y.
An fuyez unt mort certaine Diane, & le Dieu Mars s’arment contre vos jours.	An fuyez unt mort certaine Diane, et le Dieu Mars s'arment contre vos jours.
9.	9.
Je ſçay que ma perte eſt prochaine, Mais mon Peuple gémit, je vole à ſon ſecours.	Je sais que ma perte est prochaine, Mais mon Peuple gémit, je vole à son secours.
DIPE.	DIPE.
Tout s’unit, tout conſpire à flater vôtre envie;	Tout s'unit, tout conspire à flatter votre envie;
La fortune & l’amour favoriſent vos vœux.	La fortune et l'amour favorisent vos vœux.
Ah ſi vous mépriſez la vie, Que feront les cœurs malheureux?	Ah si vous méprisez la vie, Que feront les cœurs malheureux?
ADONIS.	ADONIS.
Quand les honneurs du Diadême M’offriroient encor plus d’appas, Abſent de la beauté que j’aime, Puis-je redouter le trépas!	Quand les honneurs du Diadme M'offriraient encor plus d'appas, Absent de la beauté que j'aime, Puis-je redouter le trépas!
Vos feux ont contre moy ſoûlevé l’injuſtice D'un Dieu tout preſt à m’immoler:	Vos feux ont contre moi soulevé l'injustice D'un Dieu tout prêt à m'immoler:
Si pour moy vôtre cœur ſe ſent encor brûler, Ma mort ſera vôtre ſupplice.	Si pour moi votre cœur se sent encor brûler, Ma mort sera votre supplice.
SCENE QUATRIE’ME.	SCÈNE QUATRIE'ME.
DIPE ſeule.	DIPE seule.
IL me fuit?	IL me fuit?
Dieux quelle rigueur!	Dieux quelle rigueur!
Malgré tous ſes mépris je puis l’aimer encore, Il me fuit?	Malgré tous ses mépris je puis l'aimer encore, Il me fuit?
& mon lache cœur Ne ſçauroit étouffer l’ardeur qui le dévore?	et mon lache cœur Ne saurait étouffer l'ardeur qui le dévore?
VeneZ juſte dépit, venez briſer mes fers, C’eſt à vous de finir ma peine:	Venez juste dépit, venez briser mes fers, C'est à vous de finir ma peine:
L’amour livre mon cœur à mille maux divers, Je ne puis réſiſter au penchant qui m’entraîne, Et les tourmens que j’ay ſoufferts Ne font que reſſerrer ma chaine:	L'amour livre mon cœur à mille maux divers, Je ne puis résister au penchant qui m'entraîne, Et les tourments que j'ai soufferts Ne font que resserrer ma chaine:
Venez juſte dépit, veneZ briſer mes fers, C’eſt à vous de finir ma peine.	Venez juste dépit, venez briser mes fers, C'est à vous de finir ma peine.
Pour punir un ingrat trop digne de ma haine, De funeſtes ſecours en vain me ſont offerts, Helas!	Pour punir un ingrat trop digne de ma haine, De funestes secours en vain me sont offerts, Hélas!
contre des jours ſi chers Je ſens que ma colére eſt vaine.	contre des jours si chers Je sens que ma colère est vaine.
VeneZ juſte dépit, venez-briſer mes fers, C’eſt à vous de finir ma peine.	Venez juste dépit, venez-briser mes fers, C'est à vous de finir ma peine.
CHOEUR derriére le Theatre Adonis a domté le monſtre & ſa fureur, De nos champs déſolez il hannit la terreur.	CHOEUR derrièvre le Théâtre Adonis a dompté le montre et sa fureur, De nos champs désolés il hannit la terreur.
YDIPE.	YDIPE.
Par ces chants de réjoüiſſance, J’aprens qu’Adonis eſt vainqueur:	Par ces chants de réjoüissance, J'apprends qu'Adonis est vainqueur:
Quoy?	Quoi?
des Dieux conjurez il brave la rigueur?	des Dieux conjurés il brave la rigueur?
Mais le peuple en ces lieux s’avance, Je ne puis plus cacher le trouble de mon cœur, Puyons, cvuuns ja préſence.	Mais le peuple en ces lieux s'avance, Je ne puis plus cacher le trouble de mon cœur, Puyons, cuuns ja présence.
SCENE CINQUIEME.	SCÈNE CINQUIÈME.
Chœur & Troupe de Peuples d’Amathonte, & des Campagnes voiſines.	Chœur et Troupe de Peuples d'Amathonte, et des Campagnes voisines.
LE GRAND CHOEUR.	LE GRAND CHOEUR.
Donis a domté le monſtre & ſa fureur, IY De nos Champs déſolez il bannit la terreur.	Doncis a dompté le monstre et sa fureur, IY De nos Champs désolés il bannit la terreur.
LE PETIT CHOEUR.	LE PETIT CHOEUR.
Chantons ſa Victoire, Rendons hommage à ſa Gloire.	Chantons sa Victoire, Rendons hommage à sa Gloire.
LE GRAND CHOEUR.	LE GRAND CHOEUR.
Célébrons à jamais ſes efforts généreux, C’eſt ſa rare valeur qui va nous rendre heureux.	Célébrons à jamais ses efforts généreux, C'est sa rare valeur qui va nous rendre heureux.
UNE DES FILLES DU CHOEUR.	UNE DES FILLES DU CHOEUR.
Le Ciel attendri par nos larmes, Fait enfn ceſſer nos allarmes.	Le Ciel attendri par nos larmes, Fait enfn cesser nos alarmes.
Les Les plaiſirs les beaux jours, Vont reprendre leurs cours.	Les Les plaisirs les beaux jours, Vont reprendre leurs cours.
LE GRAND CHOEUR.	LE GRAND CHOEUR.
Les plaiſirs les beaux jours, Vont reprendre leur cours.	Les plaisirs les beaux jours, Vont reprendre leur cours.
CHOEUR DES FILLES.	CHOEUR DES FILLES.
Aprés avoir ſouffert des rigueurs inhumaines, Goütons le bon-heur de voir finir nos peines, On ne connoît le prix des plus parfaits plaiſirs, Qu'aprés avoir pouſſé de rigoureux ſoûpirs.	Après avoir souffert des rigueurs inhumaines, Goütons le bonheur de voir finir nos peines, On ne connaît le prix des plus parfaits plaisirs, Qu'après avoir poussé de rigoureux soupirs.
V DES HABITANS.	V DES HABITANS.
Nous devons à nôtre Auguſte Maître Le repos que nous voyons renaître.	Nous devons à notre Auguste Maître Le repos que nous voyons renaître.
Puel objet eſt plus beau pour la valeur d’un Roy, Que le calme des cœurs qui vivent ſous ſa loy.	Puel objet est plus beau pour la valeur d'un Roi, Que le calme des cœurs qui vivent sous sa loi.
LE GRAND CHOEUR.	LE GRAND CHOEUR.
Nous devons à nôtre Auguſte Maître Le repos que nous voyons renaître.	Nous devons à notre Auguste Maître Le repos que nous voyons renaître.
Quel objet eſt plus beau pour uil valeur d’un Roy, ue le calme des cœurs qui vivent ſous ſa loy.	Quel objet est plus beau pour uil valeur d'un Roi, ue le calme des cœurs qui vivent sous sa loi.
E PETIT CHOEUR.	E PETIT CHOEUR.
Trop heureuſe immortéle, Revenez en ces lieux, Adonis vous apelle, ParoiſſeZ à ſes yeux.	Trop heureuse immortéle, Revenez en ces lieux, Adonis vous apelle, Paraissez à ses yeux.
Quuiſe doux de revon auiuun Amant fidéle Un vainqueur glorieux.	Quuise doux de revon aujuun Amant fidèle Un vainqueur glorieux.
LE GRAND CHOEUR.	LE GRAND CHOEUR.
Adonis a domté le monſtre & ſa fureur, De nos Champs déſolez il bannit la terreur.	Adonis a domté le monstre et sa fureur, De nos Champs désolés il bannit la terreur.
v enus de fecour do tapnos ubicond de ſon Char au milieu des dances, & des acclamations du Peuple.	v enus de fecour do tapnos ubicond de son Char au milieu des dances, et des acclamations du Peuple.
SCENE SIXIE’ME.	SCÈNE SIXIE'ME.
VENUS, LE CHOEUR.	VENUS, LE CHOEUR.
ENUS.	ENUS.
V’un triſte éloignement m'a fait verſer de 2 larmes!	V'un triste éloignement m'a fait verser de 2 larmes!
Que mes yeux vont trouver de charmes A revoir en ces lieux l’objet de mon amour.	Que mes yeux vont trouver de charmes A revoir en ces lieux l'objet de mon amour.
On ſe plaint, on languit loin d’un Amant fidéle;	On se plaint, on languit loin d'un Amant fidèle;
Mais l’abſence la plus cruelle, Ne ſert qu'à préparer aux douceurs du retour.	Mais l'absence la plus cruelle, Ne sert qu'à préparer aux douceurs du retour.
Mille voix m’ont appris les perils & la gloire Du Heros qui fait mes deſirs, Allons mêler le bruit de nos tendres ſoûpirs Avet les tuams de ja vuoire.	Mille voix m'ont appris les périls et la gloire Du Héros qui fait mes désirs, Allons mêler le bruit de nos tendres soupirs Avet les tuams de ja voire.
OELETTIEME, VENUS, CYDIPE, LE CHOEUR.	OELETTIEME, VENUS, CYDIPE, LE CHOEUR.
YDIPE.	YDIPE.
O Rgueilleuſe Divinité, Pleure, pleure à jamais ta tendreſſe fatale, Quitte l’aveugle eſpoir dont ton cœur eſt flatté, Et connois enfin ta rivale.	Ô Rangueilleuse Divinité, Pleure, pleure à jamais ta tendresse fatale, Quitte l'aveugle espoir dont ton cœur est flatté, Et connais enfin ta rivale.
C’eſt moy qui pour vanger mon amour offenſé, De l’implacable Mars ay reveillé la haine;	C'est moi qui pour venger mon amour offensé, De l'implacable Mars ai réveillé la haine;
En vain le monſtre terraſſé Bemvion jujpendre noire peine.	En vain le monstre terrassé Bemvion jujpendre noire peine.
Diane en le rendant à la clarté des Cieux, A ſceu contre Adonis renouveller ſa rage, Et le ſang d’un ingrat verſé ſur ce rivagé, Vange mes tourmens & les Dieux.	Diane en le rendant à la clarté des Cieux, A sceu contre Adonis renouveler sa rage, Et le sang d'un ingrat versé sur ce rivagé, Venge mes tourments et les Dieux.
S Il eſt mort!	S Il est mort!
Dieux cruels !	Dieux cruels !
perfide à quel ſupplice?	perfide à quel supplice?
DIPE.	DIPE.
Arrête, je ſçay trop ce ce que j’ay mérité, Et voicy le coup ſoühaité Qui d’un funeste amour va te faire justice, Elle ſe tuë.	Arrête, je sais trop ce ce que j'ai mérité, Et voici le coup soühaité Qui d'un funeste amour va te faire justice, Elle se tue.
C’en eſt fait, je ſens que je meurs, Trop heureuſe de voir la fin de mes malheurs, Te condamne à ſouffrir une peine éternelle.	C'en est fait, je sens que je meurs, Trop heureuse de voir la fin de mes malheurs, Te condamne à souffrir une peine éternelle.
DCLNE DERNIERE.	DCLNE DERNIÈRE.
VENUS, LE CHOEUR.	VENUS, LE CHOEUR.
9.	9.
L'est mort!	L'est mort!
Ciel barbare!	Ciel barbare!
ô destins ennemis, IImpitoyables Dieux vous l’avez-donc permis!	ô destins ennemis, IImpitoyables Dieux vous l'avez-donc permis!
Je ne verray plus ce que j’aime?	Je ne verrai plus ce que j'aime?
Le ſommeil de la mort a fermé pour jamais, Ces yeux de qui l’amour empruntoit tous ſes traits, O diſgrace, ô rigueur extrême!	Le sommeil de la mort a fermé pour jamais, Ces yeux de qui l'amour empruntait tous ses traits, Ô disgrâce, ô rigueur extrême!
Eclatez, mes ſoûpirs, couleZ, coulez, mes pleurs, Je n’en puis trop verſer en de ſi grands malheurs.	Éclatez, mes soupirs, coulez, coulez, mes pleurs, Je n'en puis trop verser en de si grands malheurs.
Que toute la terre gémiſſe, Que l’air de nos cris retentiſſe	Que toute la terre gémisse, Que l'air de nos cris retentisse
LE CHOEUR.	LE CHOEUR.
Que toute la terre gémiſſe, Que tutr ue nos cris retentiſſe.	Que toute la terre gémisse, Que tutr ue nos cris retentisse.
S.	S.
Le plus beau des mortels vient de perdre le jour.	Le plus beau des mortels vient de perdre le jour.
LE CHOEUR.	LE CHOEUR.
Que toute la Terre gémiſſe.	Que toute la Terre gémisse.
Venus perd ce qu'elle aime, & le perd ſans retour.	Venus perd ce qu'elle aime, et le perd sans retour.
E CHOEUR.	E CHOEUR.
Que l’air de nos cris retentiſſe, Que chacun partage à ſon tour L’horreur d’un ſi cruel ſupplice	Que l'air de nos cris retentisse, Que chacun partage à son tour L'horreur d'un si cruel supplice
DCLNE DERNIERE.	DCLNE DERNIÈRE.
VENUS, LE CHOEUR.	VENUS, LE CHOEUR.
9.	9.
L'est mort!	L'est mort!
Ciel barbare!	Ciel barbare!
ô destins ennemis, IImpitoyables Dieux vous l’avez-donc permis!	ô destins ennemis, IImpitoyables Dieux vous l'avez-donc permis!
Je ne verray plus ce que j’aime?	Je ne verrai plus ce que j'aime?
Le ſommeil de la mort a fermé pour jamais, Ces yeux de qui l’amour empruntoit tous ſes traits, O diſgrace, ô rigueur extrême!	Le sommeil de la mort a fermé pour jamais, Ces yeux de qui l'amour empruntait tous ses traits, Ô disgrâce, ô rigueur extrême!
Eclatez, mes ſoûpirs, couleZ, coulez, mes pleurs, Je n’en puis trop verſer en de ſi grands malheurs.	Éclatez, mes soupirs, coulez, coulez, mes pleurs, Je n'en puis trop verser en de si grands malheurs.
Que toute la terre gémiſſe, Que l’air de nos cris retentiſſe	Que toute la terre gémisse, Que l'air de nos cris retentisse
LE CHOEUR.	LE CHOEUR.
Que toute la terre gémiſſe, Que tutr ue nos cris retentiſſe.	Que toute la terre gémisse, Que tutr ue nos cris retentisse.
S.	S.
Le plus beau des mortels vient de perdre le jour.	Le plus beau des mortels vient de perdre le jour.
LE CHOEUR.	LE CHOEUR.
Que toute la Terre gémiſſe.	Que toute la Terre gémisse.
Venus perd ce qu'elle aime, & le perd ſans retour.	Venus perd ce qu'elle aime, et le perd sans retour.
E CHOEUR.	E CHOEUR.
Que l’air de nos cris retentiſſe, Que chacun partage à ſon tour L’horreur d’un ſi cruel ſupplice	Que l'air de nos cris retentisse, Que chacun partage à son tour L'horreur d'un si cruel supplice
