ET A PRESENT Aux Beurieres de Paris.	ET A PRÉSENT Aux Beurieres de Paris.
SECONDE EDITION.	SECONDE ÉDITION.
AVX IEVNES VEVFVES ET aux vieilles Fiſſes.	AUX JEUNES VEUFUES ET aux vieilles Fisses.
ELLES Dames, à qui la Nature & l’honneur ne peuuent permettre de donner l’aliment neceſP ſaire à vos contentemens, les vnes par la perte de vos maris, & les autres pour n’oſer gouſter l’excellence du fruict de vie qui donne naiſſance aux creatures raiſonnables, voicy Alizon Fleurie veufue, & ſa ſœur Vieux Thaudis, fille aagée de ſoixante ans, qui viennent par l’exemple de leur vie & de leur patience, vous monſtrer le miroir jiir lequel il faut, MESDAMES, que vos eſprits ſe conforment, que vos vertus ſe reglent, que voſtre prudence ſe mire, & que vos actions ſa aßent, afin de trouuer des partis dignes de voſtre longue attente.	ELLES Dames, à qui la Nature et l'honneur ne peuvent permettre de donner l'aliment néces zaïre à vos contentements, les unes par la perte de vos maris, et les autres pour n'oser goûter l'excellence du fruit de vie qui donne naissance aux créatures raisonnables, voici Alison Fleurie vue, et sa sœur Vieux Thaudis, fille aagée à soixante ans, qui viennent par l'exemple de leur vie et de leur patience, vous montrer le miroir jiir lequel il faut, MESDAMES, que vos esprits se conforment, que vos vertus se règlent, que et prudence se mire, et que vos es sa assent, afin de trouuer des partis se ré vôtre longue attente,
C’eſt le parfait modelle d’vne vieille & vertueuſe amitié, recherchée de la Nobleſſe, de la Iuſtice, & du tiers Eſtat:	C'est le parfait modèle d'une vieille et vertueuse amitié, recherchée de la Noblesse, de la Justice, et du tiers État:
Dans laquelle vous trouuerez la verité du prouerbe, qui dit, Que dans vn vieux pot on fait ſouuent de bonne ſouppe;	Dans laquelle vous trouverez la vérité du prouerbe, qui dit, Que dans un vieux pot on fait souvent de bonne soupe;
veu qu’apres vne infinité de trauerſes qui ont accompagné la ſuite de leurs années, elles ont heureuſement rencontré le palais de la felicité, dans lequel elles font entrées par la poſſeſſion de deux parfaits Amans, qui les faiſans iouïr du bien ſi longtemps attendu, ont encore fait naiſtre l’occaſion des aduantageux mariages des trois filles d’Alizon Fleurie.	vu qu'après une infinité de traverses qui ont accompagné la suite de leurs années, elles ont heureusement rencontré le possession de la félicité, dans lequel elles font entrées par la possession de deux parfaits Amants, qui les faisant jouir du bien si longtemps attendu, ont encore fait naître l'occasion des avantageux mariages des trois filles d'Alison Fleurie.
Il fant, MESDAMES, que vous n’eſperiez pas vne moindre recompenſe de voſtre ennuyeuſe attente, & que vous croyez que ce temps qui court n’eſt que pour atteindre le bon-heur qui vous eſt reſerué, & dont quelque iour le Ciel vous donnera vne entiere iouyſſance.	Il fant, MESDAMES, que vous n'espériez pas une moindre récompense de votre ennuyeuse attente, et que vous croyez que ce temps qui court n'est que pour atteindre le bonheur qui vous est réservé, et dont quelque jour le Ciel vous donnera une entière jouissance.
C’eſt ce que ſouhaite auec paſ	C'est ce que souhaite avec pas
MESDAMES,	MESDAMES,
Voſtre tres-humble & aſſectionné ſeruiteur,	Votre très-humble et assectionné serviteur,
L.	L.
C.	Ç.
DISCRET.	DISCRET.
A MESDAMES MESDAMES Les Beurieres de Paris.	À MESDAMES MESDAMES Les Beurieres de Paris.
Faiſant aſſez ſouuent des reflexions ſerieuſes ſur les Liures qu’on imprime de iour en iour, ie ſuis autant de fois tombé dans vn proſond eſtonnement de ce que tant d’Autheurs qui trauaillent, ne ſe ſont encore auiſez de voms dedier quelqu’vn de leurs ouurages;	Faisant assez souvent des réflexions sérieuses sur les Livres qu'on imprime de jour en jour, je suis autant de fois tombé dans un pros étonnement de ce que tant d'Auteurs qui travaillent, ne se sont encore avisés de voms dédier quelque autre de leurs ouvrages;
veu que ſans vous flatter, MES BONNES, c'eſt vous qui en faites le plus grand debit.	vu que sans vous flatter, MES BONNES, c'est vous qui en faites le plus grand débit.
Vous ne vendez pas vn quartrou de beurre ny d’eſpinards en Careſme, que l’enueloppe ne ſoit des Oeuures de Meßieurs les Poëtes du temps, de Meſsieurs de l’Acadenuie des entretiens pieux des Peres Contemplatife, ou de nos faiſeurs de Romans, & ſans faire tort à leurs forts raiſonnements & profonde ſcience, c’eſt mal reconnoiſtre les obligations qu’ils vous ont;	Vous ne vendez pas un quartrou de beurre ni d'épinards en Carésame, que l'enveloppe ne soit des Oeuures de Messieurs les Poètes du temps, de Messieurs de l'Acadenvie des entretiens pieux des Pères Contemplatife, ou de nos faiseurs de Romans, et sans faire tort à leurs forts raisonnements et profonde science, c'est mal reconnaître les obligations qu'ils vous ont;
Car, comme vous faites toutes choſes auec poids & meſure, la balance que vous tenez ſi ſouuent à la main, (veritable marque de Dame Iuſtice,) fait que vous les peſez auec tant d’équité, que tel qui n’a pas vn eſcu pour acheter vn Liure entier, en void du moins quelque petite partie à bon marché, puiſque vous en donnez toûjours quelque lambeau par deſſus les denrées que vous debitez;	Car, comme vous faites toutes choses avec poids et mesure, la balance que vous tenez si souvent à la main, (véritable marque de Dame Justice,) fait que vous les pesez avec tant d'équité, que tel qui n'a pas un écu pour acheter un Livre entier, en voit du moins quelque petite partie à bon marché, puisque vous en donnez toujours quelque lambeau par -dessus les denrées que vous débitez;
& par ce moyen il peut, pour peu d’argent qu’il ait, gouſter les charmans entretiens de ces grands Genies, s’il ne ſe ſert de leurs Oeuures à autre vſage dans le Cabinet.	et par ce moyen il peut, pour peu d'argent qu'il ait, goûter les charmand entretiens de ces grands Génies, s'il ne se sert de leurs Oeuures à autre usage dans le Cabinet.
Ie ne ſuis pas, MES CHEPES, de ces ingrats, i’auouë ingenuëment que la plus grande partie des ouurages de mon eſprit ont paßé par vos mains, vous auez eſté la Iuſtice diſtribu.	Je ne suis pas, MES CHÉPES, de ces ingrats, j'avoue ingénument que la plus grande partie des ouvrages de mon esprit ont passé par vos mains, vous avez été la Justice distribu.
tiue de mes Vers & de ma Proſe, & comme il a pris fantaiſie à Meßieurs les Libraires de faire reuiure Dame Alizon qui eſtoit enſeuelie dans le Tombeau depuis plus de vingt ans, d’ay creu eſtre obligé de vous en faire preſent, ne pouuant la mettre en des mains plus douces & plus coulantes que les voſtres, afin que ſi les Vers ne ſont aſſez coulans à la fantaiſie de ces Meßieurs qui les vouurunt tire, vous tes frottiez de beurre frais pour les rendre plus gliſſans & plus faciles à paſſer dãs leurs delicates oreilles, n’eſtant pas de l’humeur de ceux qui dediant vn mauuais Ouurage à de grands Seigneurs, s’imaginent qu’ils en paſſeront pour meilleurs;	tive de mes Vers et de ma Prose, et comme il a pris fantaisie à Messieurs les Libraires de faire reuiure Dame Alison qui était ensevelie dans le Tombeau depuis plus de vingt ans, d'ai cru être obligé de vous en faire présent, ne pouvant la mettre en des mains plus douces et plus coulantes que les vôtres, afin que si les Vers ne sont assez coulants à la fantaisie de ces Messieurs qui les vourunt tire, vous tes frottiez de beurre frais pour les rendre plus glissants et plus faciles à passer dans leurs délicates oreilles, estant pas de humeur de ceux qui dédiant mauuais Ore de grands Seigneurs, n'étant pas de ceux qui de;
ſi Alizon ſe trouue rude, vostre marchandiſe la peut adoucir;	si Alison se trouve rude, votre marchandise la peut adoucir;
ſi ſes paroles & ſes complimens ſont bas, ils ont du rapport auec les voſtres;	si ses paroles et ses compliments sont bas, ils ont du rapports avec les vôtres;
ſi ſon humeur eſt gaye & enjoüée, elle a de la ſimpatie auec celle des Dames de voſtre qualité, & pour le preſent qu'ie vous fais, ie ſouhaite deux choſes de vous;	si son humeur est gaie et enjouée, elle a de la sympatie auec celle des Dames de votre qualité, et pour le présent qu'ie vous fais, ie souhaite deux choses de vous;
l’vne que ma ſeruante allant au marché, vous ayez la bonté de luy donner du meilleur de la motte ou du panier, & l'autre, que vous me teniez de voprt cttevre compagnie,	l'une que ma servante allant au marché, vous ayez la bonté de reste donner du meilleur de la motte ou du panier, et l'autre, que vous me teniez de vod cttevre compagnie,
MESDAMES,	MESDAMES,
Le tres-humble & affectionné ſeruiteur, L.	Le très-humble et affectionné serviteur, L.
C.	Ç.
DISCRET.	DISCRET.
ADVERTISSEMENT tinporians an fcetenra	ADVERTISEMENT tinporiants an fcetenra
L ECTEVR, apres tant de raj res Poëmes, qui depuis l quelques années ont paru ſur le theatre de nos Comediens auec tant d’éclat & d’admiration de chacun, i’ay creu qu’en ſuite de ces ſujets ſi graues, il te falloit donner quelque piece Comique pour diuertir ton eſprit de leurs Hiſtoires melancoliques.	LE ECTEUR, après tant de raj -rés Mes, qui depuis l quelques années ont paru sur le théâtre de nos Comédients était tant d'éclat et d'admiration de chacun, j'ai cru qu'en suite de ces sujets si graves, il te fallait donner quelque pièce Comique pour divertir ton esprit de leurs Histoires mélancoliques.
Et pour cét effet vne Dame de mes Amies m’ayãt fait le recit des groteſques & veritables Amours de la vefue d’vn pauure Bourgeois de Paris, i’en ay traicté l’Hiſtoire en Rime ſous le nom d’Alizon Fleurie, auec des paroles les plus approchantes de la ſorte de parler des perſonnages qui y ſont introduits, & chacun ſelon ſa condition, pour rendre le ſujet plus riſible:	Et pour cet effet apprimé Dame de mes Amies m'ayant fait le récit des grotesques et véritables Amours de la veuve d'une pauvre Bourgeois de Paris, j'en ai traité l'Histoire en Rime sous le nom d'Ali Fleurie, auec des paroles les plus approchantes de la sorte de parler des personnages qui y sont introduits, et chacun selon sa condition, pour rendre le sujet plus risible:
Quoy que de luy-meſme il ſoit extremement recreatif, intrigué, & diuertiſſant.	Quoi que de Seigneur-même il soit extrêmement récréatif, intrigué, et divertissant.
Ett ie puis dire auec la meſme verité, qu’aux repreſentations qui en ont eſté faites, perſonne ne s’y eſt ennuyé.	Ett ie puis dire avec la même vérité, qu'aux représentations qui en ont été faites, personne ne s'y est ennuyé.
Au ſurplus, Lecteur, ie t’aduertis, qu’encore que dans cette piece i’aye mis des Airs & des Chãſons à dancer, les Acteurs qui la repreſenterõt, en pourront chanter de celles qu’ils ſçaurõt, ſans s’abſtraindre à celles-là qui ne ſeruent à mon ſuiet, que pour en faire voir l’ordre & la ſuitte:	Au surplus, Lecteur, ie t'avertis, qu'encore que dans cette pièce j'aie mis des Airs et des Chansons à dancer, les Acteurs qui la représenteront, en pourront chanter de celles qu'ils sauront, sans s'abstraindre à celles-là qui ne servent à mon sujet, que pour en faire voir l'ordre et la suitte:
Que tu ne trouueras pourtant ny dans les regles des vingt-quatre heures, ny ſans rencontre de voyelles.	Que tu ne trouveras pourtantgez dans les règles des vingt-quatre heures, ni sans rencontre de voyelles.
Mais vn ſuiet veritable eſt plus difficile à traicter, que les fabuleux des Autheurs du temps, Adieu.	Mais un sujet véritable est plus difficile à traicter, que les fabuleux des Auteurs du temps, Adieu.
Comedie d’Alizon.	Comédie d'Alison.
SA	SA
7Stime qui voudra tous les ſujets tragiques Alizon qui fait rire a bien d'autrès appas Ceux là font les humains ſi fort m'elancoliees, Qu’il faut que celle- cy les tirent du treſpas,	7Stime qui voudra tous les sujets tragiques Alison qui fait rire a bien d'autrés appas Ceux là font les humains si fort m'elancoliees, Qu'il faut que celle- cy les tirent du trépas,
Cuutesjarntnne a l'Ampresion.	Culutesjarntine a l'Amprèsion.
Age 2, vers 3.	Age 2, vers 3.
liſez il eſtoit, au lieu de c’eſtoit mon I p.	lisez il était, au lieu de c'était mon I .
4.	4.
vers 8.	vers 8.
oſtez le ſecond des, meſme page v.	ôtez le second des, même page v.
18.	18.
iſ elle eſt à ſa, page 5.	Y elle est à sa, page 5.
V.	V.
22.	22.
liſez Anſpeſade on m’a fait, au lieu, de on m’a fait Anſpeſade, p.	lisez Anspesade on m'a fait, au lieu, de on m'a fait Anspesade, p.
9.	9.
v.	v.
8.	8.
oſtez pas, p.	ôtez pas, p.
16.	16.
V.	V.
4.	4.
liſez chacun, au lieu, de tout le monde, 1.	lisez chacun, au lieu, de tout le monde, 1.
2o.	2o.
v.	v.
dernier oſteZ pas, p.	dernier ôtez pas, p.
28.	28.
V.	V.
14.	14.
liſez dans la Cour, 33.	lisez dans la Cour, 33.
V.	V.
9.	9.
oſtez bien, p.	ôtez bien, p.
48.	48.
v.	v.
2o.	2o.
ujna re, meime page 29.	ujna re, meime page 29.
au lieu de mettez en, p.	au lieu de mettez en, p.
62.	62.
V.	V.
16.	16.
liſez c’eſt vn res grand plaiſir, & eſtez extréme, meſme page v.	lisez c'est un rés grand plaisir, et estez extrême, même page v.
22.	22.
l.	l.
eux qui font telles Loix.	eux qui font telles Lois.
Entreparleurs.	Entreparleurs.
M.	M.
IEREMIE,	JEREMIE,
Mr KAROLV, vieil Bourgeois de Paris.	Mr AROLU, vieil Bourgeois de Paris.
POLIANDRE, BELANGE, (Gentils.	POLYANDRE, BÉLANGE, (Gentils.
hommes.	hommes.
ROSELIS,	ROSELIS,
SILINDE.	SILINDE.
CLARISTE, PFilles d’Alizon Fleurie.	CLARISTE, PIlles d'Alison Fleurie.
FLORIANE,S	FLORIANE,S
Er MARRON, muet.	Er MARON, muet.
LE BATELIER de la Grenoüilliere, LES ASSISTANS au Chariuaris.	LE BATELIER de la Grenoüilliere, LES ASISTANS au Chariuaris.
VN SOLDAT.	UN SOLDAT.
Ce nombre d’Acteurs ſe reduit faci.	Ce nombre d'Acteurs se réduit sacy.
lement à dix.	lement à dix.
ALIZO	ÀLIZO
medie.	médie.
ACTE PREMIER.	ACTE PREMIER.
FLEVRIE.	FLEURIE.
LE COLPORTEVR.	LE COLPORTEUR.
MAISTRE IEREMIE.	MAÎTRE IEREMIE.
ME KA.	ME KA.
ROLV.	ROLV.
POLIANDRE.	POLYANDRE.
ROSELIS.	ROSELIS.
BELANGE.	BÉLANGE.
SCENE PREMIERE.	SCÈNE PREMIÈRE.
FLEVRIE.	FLEURIE.
I proüerbe dit vray, qui m’apprend qu’vne femme Perd auec ſon mary la moitié de ſon ame, Quaud la mort ſeparant leurs deux cœurs bien vnis Luy laiſſe pour iamais des regrets infinis.	I proverbe dit vrai, qui m'apprend qu'une femme Perd avec son mari la moitié de son âme, Quaud la mort séparant leurs deux cœurs bien unis Lui laisse pour jamais des regrets infinis.
Ha!	Ha!
que la mort du mien m’a fait de faſcheries Le pauure homme mouroit, s’il ne voyoit Fleurie Toûjours auprés de luy, rire, chanter, cauſer, N’eſtant pas vn moment ſans me venir baiſer:	que la mort du mien m'a fait de fâcheries Le pauvre homme mourait, s'il ne voyait Fleurie Toujours auprès de lui, rire, chanter, causer, N'étant pas un moment sans me venir baiser:
I’eſtois ſon Alizon, ſon amour, ſon delice, I’eſtois ſa Penelope, il eſtoit mon Vlyſſe:	J'étais son Alison, son amour, son délice, J'étais sa Penelope, il était mon Vlysse:
Chez nous tous les plaiſirs eſtoient à l’abandon, Si i’eſtois ſon Aſtrée, c’eſtoit mon Celadon.	Chez nous tous les plaisirs étaient à l'abandon, Si j'étais son Astrée, c'était mon Céladon.
Bref toutes ces douceurs, cette amitié parfaite Fait qu’encor tous les iours mon eſprit le regrette.	Bref toutes ces douceurs, cette amitié parfaite Fait qu'encor tous les jours mon esprit le regrette.
Mais heias!	Mais héjas!
ce pla ſir eut eſté bien plus doux Si de mes actions il n’eut eſté jaloux Ie ne ſçay quels appas j’auois en ma ieuneſſe, Mais chacun m’appelloit ſa petite maiſtreſſe.	ce pla sir eut été bien plus doux Si de mes actions il n'eut été jaloux Je ne sais quels appas j'avais en ma jeunesse, Mais chacun m'appelait sa petite maîtresse.
I’auois des ſeruiteurs en chacune ſaiſon Autant que pas vn Prince en ait en ſa maiſon:	J'avais des serviteurs en chacune saison Autant que pas un Prince en ait en sa maison:
Et Monſieur Karolu & Maiſtre Ieremie Vous diroient bien encor que i’eſtois leur amie.	Et Monsieur Arrolu et Maître Jéremie Vous diraient bien encor que j'étais leur amie.
Mais quoy que nos diſcours foſſent fort innocens, Ils ne laiſſoient pourtant de luy troubler les ſens;	Mais quoi que nos discours fossent fort innocents, Ils ne laissaient pourtant de soins troubler les sens;
Iuſqu’au poinct quelquesfois de m’auoir condamnée A ne point voir le iour que par la cheminée.	Jusqu'au point quelquefois de m'avoir condamnée À ne point voir le jour que par la cheminée.
Ie ne voyois les champs que dans vn vieux tableau Où eſtoit peint Monceaux auec Fontainebleau.	Je ne voyais les champs que dans un vieux tableau Où était peint Monceaux auec Fontainebleau.
Il n’auoit iamais mis ſon cœur à la verdure, Auſſi l’ay-ie ſouuent appellé trop me dure.	Il n'avait jamais mis son cœur à la verdure, Aussi l'ai-je souvent appelé trop me dure.
En Hyuer, en Eſté, ie gardois le logis:	En Hiver, en Été, Seigneur gardais le logis:
I’ay cent fois ſouhaitté d’eſtre Vrgande ou Maugis Pour aller quelquesfois faire la promenade Quand ſes gouttes au lict le retenoient malade.	J'ai cent fois souhaité d'être Vrgande ou Maugis Pour aller quelquefois faire la promenade Quand ses gouttes au lit le retenaient malade.
Et pourtant aujourd’huy la feparation M’apporte en verité beaucoup d’affliction.	Et pourtant aujourd'hui la séparation M'apporte en vérité beaucoup d'affliction.
Croyez, s’il faut vn iour que ie me remarie On me verra bien fort faire la rencherie:	Croyez, s'il faut un jour que je me remarie On me verra bien fort faire la renchérie:
I’ay deſia ſur les bras deux ou trois amoureux Qui du moindre regard s’eſtiment trop heureux, Et combien que pour moy leur amour ſoit extreme, Si veux-ie bien connoiſtre auparauant que i’aime.	J'ai déjà sur les bras deux ou trois amoureux Qui du moindre regard s'estiment trop heureux, Et combien que pour moi leur amour soit extrême, Si veux-je bien connaître auparavant que j'aime.
En voicy déja l’vn :	En voici déjà l'amour :
Or ſus vous dis-je pas De moment en moment ils ſont deſſus mes pas.	Or sus vous dis-je pas De moment en moment ils sont dessus mes pas.
Ie me veux retirer au fond de mon allée:	Je me veux retirer au fond de mon allée:
Car ie ne me plais pas d’eſtre tat caj ollée;	Car ie ne me plais pas d'être tat caj ollée;
Encore celuy-cy jargonne inceſſamment, Quoy qu’il faſſe ſans ceſſe vn meſme compliment.	Encore celui-cy jargonne incessamment, Quoi qu'il fasse sans cesse un même compliment.
SOLNDIA	SOLNDIA
LE COLPORTEVR.	LE COLPORTEUR.
Ay touſiours quelque choſe, auecque quelque choII’ay des liures icy tant en rime qu’en proſe, Le duel de deux gueux dedans le pré aux Clers:	Ai toujours quelque chose, avec quelque choIIIai des livres ici tant en rime qu'en prose, Le duel de deux gueux dedans le pré aux Clers:
I’ay les noms des filoux, la miſere des Clers:	J'ai les noms des filoux, la misère des Clers:
I’ay les nouueaux Edits, les nouuelles gazettes:	J'ai les nouveaux Édits, les nouvelles gazettes:
I’ay la commodité des bottes & des garſettes:	J'ai la commodité des bottes et des garsettes:
I’ay le remede auſſi pour les paſles couleurs:	J'ai le remède aussi pour les pâles couleurs:
I’ay l’amour des Sergens, la pitié des voleurs:	J'ai l'amour des Sergents, la pitié des voleurs:
I’ay tous les complimens de la langue Françoiſe, La perte depuis peu d’vne ieune Bourgeoiſe Au quartier que chacun nomme des Grauilliers:	J'ai tous les compliments de la langue Française, La perte depuis peu d'une jeune Bourgeoise Au quartier que chacun nomme des Gravilliers:
I'ay le contract paſſé dedans Hautberuilliers Entre Gnillot Grand jan & Gillette Ventruë:	J'ai le contrat passé dedans Hautbervilliers Entre Gnillot Grand jan et Gillette Ventrue:
I ay le cruel combat d’vn cinge & d’vne gruë:	I ai le cruel combat d'ins cinge et d'une grue:
I’ay grande quantité de bons liures nouueaux:	J'ai grande quantité de bons livres nouveaux:
I'ay la maniere auſſi comine on ſevre les veaux, Auec le teſtament du bon Gaultier garguille:	J'ai la manière aussi comine on sevre les veaux, Avec le testament du bon Gaulier garguille:
I’ay le galand qu’il faut à vne belle fille.	J'ai le galant qu'il faut à une belle fille.
Voicy l’inuention pour prendre à toutes mains, Vtile aux Procureurs autant qu’aux Medecins:	Voici l'invention pour prendre à toutes mains, Vtyle aux Procureurs autant qu'aux Médecins:
ſe, I’ay le pouuoir qu’on donne à chacune ſeruante De coucher au grand lict quand Madame eſt abſente.	se, J'ai le pouvoir qu'on donne à chacune servante De coucher au grand lit quand Madame est absente.
I’ay les perfections de la Dame Alizon Pour captiuer chacun dans ſa belle priſon;	J'ai les perfections de la Dame Alison Pour captiver chacun dans sa belle prison;
Dans va petit cahier i’ay la bonté des femmes:	Dans va petit cahier j'ai la bonté des femmes:
I’ay toute leur malice en trois ou quatre rames:	J'ai toute leur malice en trois ou quatre rames:
I’ay la methode auſſi pour gagner force eſcus:	J'ai la méthode aussi pour gagner force écus:
I’ay les liſtes icy des garces & des cocus, Et l’art de les trouuer iour & nuict ſans lanternes:	J'ai les listes ici des garces et des cocus, Et l'art de les trouver jour et nuit sans lanternes:
I’ay comme il faut ſortir ſans payer aux tauernes:	J'ai comme il faut sortir sans payer aux tavernes:
I’ay quelque choſe enfin pour tous les bons eſprits;	J'ai quelque chose enfin pour tous les bons esprits;
Mais en criant ainſi ie ſuis preſque ſorpris.	Mais en criant ainsi Dieux suis presque sorpris.
Voila le beau Palais où loge ma Maiſtreſſe Qui ſurpaſſe en beauté la Romaine Lucrece:	Voilà le beau Palais où loge ma Maîtresse Qui surpasse en beauté la Romaine Lucrece:
Ie ſçay que mon humeur luy plaiſt extrémement, Que de ſes Amoureux ie ſuis le cher Amant:	Je sais que mon humeur lui plaît extrêmement, Que de ses Amoureux ici suis le cher Amant:
Car dés qu’elle m’entend ie vois ſon œil pareſtre, al cen eſt a la porte, c eit par vne fenentte.	Car dès qu'elle m'entend ie vois son œil paraître, al clen est à la porte, ç it par une fenentte.
Puis qu’on ne luy void pas, ſans doute elle eſt au Cours, Adieu belle priſon de mes vieilles amours.	Puis qu'on ne nous voit pas, sans doute elle est au Cours, Adieu belle prison de mes vieilles amours.
FLEVRIE.	FLEURIE.
En dépit du vilain, i’ay honte de vous dire Que i’ay laſché de l’eau à force de trop rire.	En dépit du vilain, j'ai honte de vous dire Que j'ai lâché de l'eau à force de trop rire.
Mon Dien qu’il eſt plaiſant, ſi i’auois bien dequoy Et que ie le vouluſſe, il voudroit bien de moy:	Mon Dien qu'il est plaisant, si j'avais bien dequoy Et que je le voulusse, il voudrait bien de moi:
Mais le profit qu’il fait à crier des gazettes Ne poutroit en vn an nous fournir de lunettes.	Mais le profit qu'il fait à crier des gazettes Ne poutrait en un an nous fournir de lunettes.
Non, ce n’eſt pas mon fait, i’ay des partis meilleurs, Ie ne veux empeſcher qu’il ſe pouruoye ailleurs:	Non, ce n'est pas mon fait, j'ai des partis meilleurs, Je ne veux empêcher qu'il se pourvoie ailleurs:
&ie bernemme donc y cherche ſa fortune.	etie berne donc y cherche sa fortune.
O dieux qu’en voicy vn qui ſouuent m’importune!	Ô dieux qu'en voici un qui souvent m'importune!
C’eſt maiſtre Ieremie:	C'est maître Jéremie:
En voila déja deux:	En voilà déjà deux:
Si l’on dit qu’à preſent ie ſuis ſans Amoureux, Auoüez maintenant que c’eſt bien ſe méprendre Pour ne point m’amuſer ie ne veux pas l’attendre, Ioint que i’attens icy mon autre Seruiteur, Qui peut-eſtre ialoux feroit quelque malheur.	Si l'on dit qu'à présent je suis sans Amoureux, Avez maintenant que c'est bien se méprendre Pour ne point m'amuser ici ne veux pas l'attendre, Joint que j'attends ici mon autre Serviteur, Qui peut-être jaloux ferait quelque malheur.
SCENE III.	SCÈNE III.
AnMIIRE LEREMIE, vieux ſoldat.	AnMIIRE LEREMIE, vieux soldat.
v’Eſt grand cas qu’aujourd’huy dans le ſiecle où O nous ſommes On ne fait plus eſtat de la vertu des hommes, Quelque belle action qu’ils puiſſent faire voir La recompenſe manque où finit le deuoir:	v'Est grand cas qu'aujourd'hui dans le siècle où Ô nous sommes On ne fait plus état de la vertu des hommes, Quelque belle action qu'ils puissent faire voir La récompense manque où finit le devoir:
La toiſon d’or n’eſt plus l’honneur de leur conqueſte;	La toison d'or n'est plus l'honneur de leur conquête;
Depuis quatre-vingts ans que i’ay deſſus la teſte I’en ay près de cinquante endoſſé le harnois Au ſeruice actuel de quatre de nos Roys.	Depuis quatre-vingts ans que j'ai dessus la tête J'en ai près de cinquante endossé le harnais Au service actuel de quatre de nos Rois.
Ie me ſuis rencontré en quarante eſcarmouches Où l’on tuoit le monde auſſi dru que des mouches I’ay veu deux cens aſſauts, trois cent combats rangez:	Je me suis rencontré en quarante escarmouches Où l'on tuait le monde aussi dru que des mouches J'ai vu deux cents assauts, trois cent combats rangés:
I’ay veu des Chaſteaux pris, & des bourgs ſaccagez:	J'ai vu des Châteaux pris, et des bourgs saccagez:
I'ay veu grand nombre auſſi de villes imprenables Miſes en des eſtats grandement déplorables, Le fer, le feu, le ſang, ſeruoit à les punir.	J'ai vu grand nombre aussi de villes imprenables Mises en des états grandement déplorables, Le fer, le feu, le sang, servait à les punir.
Encore maintenant ce triſte ſouuenir Fait ſortir de mes yeux abondance de larmes.	Encore maintenant ce triste souvenir Fait sortir de mes yeux abondance de larmes.
Enfin, depuis le temps que ie porte les armes, Pour me recompenſer apres tant de tourment On m’a fait Anſpeſade dans vn vieux Regiment;	Enfin, depuis le temps que ie porte les armes, Pour me récompenser après tant de tourment On m'a fait Anspesade dans un vieux Regiment;
Quoy que ſans me vanter i’aye fait des proüeſſes Dont la moindre en effet meritoit des largeſſes Telles qu’vn puiſſant Roy les doit à ſes ſuiets, Lors qu’il a deuant luy leurs vertus pour obiets.	Quoi que sans me vanter j'aie fait des prouesses Dont la moindre en effet méritait des largesses Telles qu'un puissant Roi les doit à ses sujets, Lors qu'il a devantages leurs vertus pour objets.
ALIZON, Car ie me reſſouuiens que du temps du Roy Charles Ie fus preſque aſſommé deuant la ville d’Arles.	ÀLIZON, Car ie me ressouviens que du temps du Roi Charles Je fus presque assommé devant la ville d'Arles.
En ce temps ie n’eſtois qu’vn perit embrelin, Gouiat ſuiuant la Cout, mais pourtant bien malin:	En ce temps ici n'étais qu'autre périt embrelin, Gouiat suivant la Cout, mais pourtant bien malin:
Car trouuant vn corps mort étendu ſur la plaine I’eſtois tout le premier à luy tirer la laine;	Car trouvant un corps mort étendu sur la plaine J'étais tout le premier à M tirer la laine;
Ie foüillois au gouſſet s’il auoit de l’argent:	Je fouillais au gousset s'il avait de l'argent:
De courir au butin ie n’eſtois negligent.	De courir au butin ie n'étais négligent.
Et meſme ce grand iour que l’on dit de ſaint Gilles, Ie demeuray tout ſeul de trois ou quatre mille.	Et même ce grand jour que l'on dit de saint Gilles, Je demeurai tout seul de trois ou quatre mille.
Aux combats de Loudun, S.	Aux combats de Loudun, S.
Denis, & de Dreux I’eſtois couuert de ſang tout iuſques aux cheueux.	Denis, et de Dreux J'étais couvert de sang tout jusques aux cheveux.
A ceux de Moncontour, d’Onneau, de Rochebelle On perça mon chapeau eſtant en ſentinelle:	À ceux de Moncontour, d'Onneau, de Rochebelle On perça mon chapeau étant en sentinelle:
Et du temps d’Henry trois le dernier des Valois ſçois.	Et du temps d'Henri trois le dernier des Valais soupais.
On me nommoit par tout le grand Mars des FranSoudain qu’il ſe faiſoit quelqu’hardie entrepriſe, Pour eſtre des premiers i’y courois en chemiſe.	On me nommait par tout le grand Mars des FranSoudain qu'il se faisait quelqu'hardie entreprise, Pour être des premiers j'y courais en chemise.
Auſſi lors qu’on donna la bataille à Coutras Vn coup de fauconneau me perça les deux bras.	Aussi lors qu'on donna la bataille à Coutras Un coup de fauconneau me perça les deux bras.
Et du temps du feu Roy à la bataille d’Arques Ie fus bien prés d’aller au Royaume des Parques:	Et du temps du feu Roi à la bataille d'Arques Je fus bien près d'aller au Royaume des Parques:
Meſme en celle d’Y vry il y faiſoit ſi chaut, Qu’vn autte homme que moy, ſeroit mort à l’aſſaut.	Même en celle d'Y vry il y faisait si chaut, Qu'un autte homme que moi, serait mort à l'assaut.
Mais que diray-ie encor de Fontaine Françoiſe, Où l’ennemy touſiours m’approchoit d’vne toiſe Sans apprehenſion le coutelas au poing I’abbatois les ſoldats comme on fauche le foin.	Mais que dirai-je encor de Fontaine Française, Où l'ennemi toujours m'approchait d'une toise Sans appréhension le coutelas au poing J'abatais les soldats comme on fauche le foin.
Enfin l’on void toûjours que Maiſtre Ieremie N’a non plus qu’autrefois la valeur endormie En ces troubles derniers, enttous les preceuens Les effets de mon bras ſe ſont veus éuidens.	Enfin l'on voit toujours que Maistre Remie N'a non plus qu'autrefois la valeur endormie En ces troubles derniers, enttous les preceuens Les effets de mon bras se sont vus évidents.
It quoy que i’aye acquis vne immortelle gloire, L’Amour a maintenant deſſus moy la victoire:	It quoi que j'aie acquis une immortelle gloire, L'Amour a maintenant dessus moi la victoire:
Ce beau petit Archer rauiſſant mes lauriers, i eui dire auoir vainca le premier des guertiers:	Ce beau petit Archer ravissant mes lauriers, j' y dire avoir vainca le premier des guertiers:
Le feu, le fer, le plomb, la poudre, ny la méche N’ont pû faire à mon cœur ce que m’a fait ſa fléchez Les attraits de Fleurie ont eu ſeuls le pouuoir De me faire oublier le martial deuoir;	Le feu, le fer, le plomb, la poudre, ni la mèche N'ont pu faire à mon cœur ce que m'a fait sa fléchez Les attraits de Fleurie ont eu seuls le pouvoir De me faire oublier le martial devoir;
Depuis que ſa beauté loge dans ma poitrine A pas vn autre object ie n’ay fait bonne mine?	Depuis que sa beauté loge dans ma poitrine A pas un autre object était n'ai fait bonne mine?
Ie n’en regarde aucun qu’auecque du mépris Voyant que leurs appas n’égale ma Cypris.	Je n'en regarde aucun qu'avec mon mépris Voyant que leurs appas n'égale ma Cypris.
Mais i’ay tant de mal-heur qu’en cherchant l’inhuIe ne la trouue point pour luy dire ma peine.	Mais j'ai tant de malheur qu'en cherchant l'inhuIe ne la trouve point pour luidire ma peine.
[maine Tantoſt vn Preſident l’emmeine promener.	[maine Tantôt un Président l'emmène promener.
Tantoſt vn Conſeiller vient chez elle diſner:	Tantôt un Conseiller vient chez elle dîner:
Souuent elle eſt au Cours ou à la Comedie.	Souvent elle est au Cours ou à la Comédie.
Ha!	Ha!
fi fi de l’amour, il faut que ie le die Exprés ie viens icy pour trouuer guariſon Lors que le Medecin n’eſt plus à la maiſon, Puis qu’vn de mes amis m’a dit qu’elle eſt ſortie Il me raut a demain remettre la partie.	fi fi de l'amour, il faut que je le die Exprès je viens ici pour trouver garison Lors que le Médecin n'est plus à la maison, Puis qu'un de mes amis m'a dit qu'elle est sortie Il me raut a demain remettre la partie.
SOENE IV FLEVRIE ET Mr KAROLV.	ZONE IV FLEURIE ET Mr KAROLV.
FLEVRIE.	FLEURIE.
E bien!	E bien!
que dites-vous de ce braue Amoureux?	que dites-vous de ce brave Amoureux?
I IIl eſt vaillant ſoldat, ſon cœur eſt genereux.	I IIl est vaillant soldat, son cœur est généreux.
Mais quoy?	Mais quoi?
me marier à vn homme de guerre C’eſt fonder mon eſpoir ſur la force d’vn verre, D’vn ſoldat, d’vn couureur, d'vn marinier auſſi La femme eſt toûjours veufue à ce qu’on tient icy.	me marier à un homme de guerre C'est fonder mon espoir sur la force d'un verre, D'un soldat, d'un couvreur, d'un marinier aussi La femme est toujours veuve à ce qu'on tient ici.
I'en ay tant à choiſir que i’ay crainte de dire Ainſi que beaucoup font, que i’ay fait choix du pire Quelqu’vn le ſuit de prés:	J'en ai tant à choisir que j'ai crainte de dire Ainsi que beaucoup font, que j'ai fait choix du pire Quelqu'un le suit de près:
ſi ie n’ay le trelu, Celuy qui vient à moy c’eſt Monſieur Karolu.	si ici n'ai le trelu, Celui qui vient à moi c'est Monsieur Karolu.
Mr KAROLV.	Mr AROLU.
Ma belle, c’eſt luy-meſme à voſtre humble ſeruice, al pour vn ter nouneur vous le luger piopice Il eſt preſt d’obeir à vos commandemens.	Ma belle, c'est lui-même à votre humble service, al pour un ter nouneur vous le luger piopice Il est prêt d'obéir à vos commandements.
FLEVRIE.	FLEURIE.
Vous vous mettez toûjours deſſus les complimens:	Vous vous mettez toujours dessus les compliments:
Mais ne pouuant répondre à tout ce que vous dites, C’eſt deuant les pourceaux ſemer des marguerites.	Mais ne pouvant répondre à tout ce que vous dites, C'est devant les pourceaux semer des marguerites.
Mr KAROLV.	Mr AROLU.
Te ne iç̧adrois touniir tene compara lou, Auec vn bon eſprit vous auez la raiſon Qui ne doit point ceder à perſonne du monde.	Te ne iç̧adrois touniir téne compara lou, Auec un bon esprit vous avez la raison Qui ne doit point céder à personne du monde.
FLEVRIE.	FLEURIE.
Ma ſcience pourtant n’eſt pas beaucoup profonde:	Ma science pourtant n'est pas beaucoup profonde:
Monſieur, pour m’obliger ne m’entreprenez pas:	Monsieur, pour m'obliger ne m'entreprenez pas:
cul lene veus anea que da puudacaos	cul lene vus anea que da puudacaos
Mr KAROLV.	Mr AROLU.
Dans vn ſens tout parfait voſtre rare eloquence Des meilleurs Orateurs tient la gloire en balance.	Dans un sens tout parfait votre rare éloquence Des meilleurs Orateurs tient la gloire en balance.
FLEVRIE.	FLEURIE.
Si n’ay-ie iamais leu que Rablais & Marot, Dont à peine à preſent me ſouuiens ie d’vn mot:	Si n'ai-je jamais lu que Rablais et Marot, Dont à peine à présent me souviens ie d'un mot:
Ces modernes autheurs ne me plaiſent à lire S’ils n’ont dans leurs Romans le petit mot pour rire.	Ces modernes auteurs ne me plaisent à lire S'ils n'ont dans leurs Romans le petit mot pour rire.
MI KAROLV.	MI AROLU.
Il n’y a point d’Autheurs que voſtre eſprit n’ait leu.	Il n'y a point d'Auteurs que votre esprit n'ait lu.
FLEVRIE Pas vn d’eux ne reſſemble à Monſieur Karolu,	FLEURIE Pas un d'eux ne ressemble à Monsieur Karolu,
Mr KAROLV.	Mr AROLU.
C’eſt trop de vanité que voſtre amour me donne.	C'est trop de vanité que votre amour me donne.
FLEVRIE.	FLEURIE.
Iamais vn bon eſprit n’en reçoit de perſonne.	Jamais un bon esprit n'en reçoit de personne.
Mr KAROLV.	Mr AROLU.
Le mien manquant auſſi de cette qualité, A ces diuins Autheurs ſa gloire il a quitté.	Le mien manquant aussi de cette qualité, À ces divins Auteurs sa gloire il a quitté.
Mais cpaipnae li pea Nu dmarle teue pue, Et croyez ſeulement que i’aime bien Fleurie.	Mais cépaiphae li péa Nu dmarle tue pue, Et croyez seulement que j'aime bien Fleurie.
FLEVRIE.	FLEURIE.
C’eſt me rendre vn deuoir que ie n’ay merité;	C'est me rendre un devoir que ici n'ai mérité;
s’il m’eſt deub quelqu’honneur c’eſt mon antiquité Qui me donne cela par deſſus la jeuneſſe Qui doit auec l’honneur reſpect à la vieilleſſe.	s'il m'est devb quelqu'honneur c'est mon antiquité Qui me donne cela par -dessus la jeunesse Qui doit avec l'honneur respect à la vieillesse.
Mr KAROLV.	Mr AROLU.
Voſtre âge ne permet pas de tenir tels propos, Voſtre viſage gay, vos membres ſi diſpos Font voir aſſez l’éclat de vos beautez parfaites, Qui fourniſſent l’amour de bottes d’alumettes Pour enflamer le cœur d’vn amant comme moy:	Votre âge ne permet pas de tenir tels propos, Votre visage gai, vos membres si dispos Font voir assez l'éclat de vos beautés parfaites, Qui fournissent l'amour de bottes d'alumettes Pour enflamer le cœur d'Hannant comme moi:
Reſolu maintenant de vous donner la foy Si voſtre affection accepte ſon ſeruice.	Résolu maintenant de vous donner la foi Si votre affection accepte son service.
FLEVRIE.	FLEURIE.
C’eſt iuſtement fraper où mon deſir ſe gliſſe;	C'est justement frapper où mon désir se glisse;
A l’inſtant que mes yeux ſe ſont iettez ſur vous Ils ont veu dans l’abord vn entretien ſi doux, Que puiſque maintenant l’occaſion ſe treuue Vous eſtant homme vœuf, auſſi bien que moy veufue Pour encore gouſter quelque doux paſſe-temps, Et viute entemble ainn le reſte de nos ans.	À l'instant que mes yeux se sont jetés sur vous Ils ont vu dans l'abord un entretien si doux, Que puisque maintenant l'occasion se trouve Vous étant homme vœuf, aussi bien que moi veuve Pour encore goûter quelque doux passe-temps, Et vivte entemble ainn le reste de nos ans.
I’ay creu qu’en vous prenant ie ne perdrois au change, Pourueu que voſtre eſprit ne donne de loüange A ce petit ſuiet qui n’en merite pas [ cas.	J'ai cru qu'en vous prenant je ne perdrais au change, Pourvu que votre esprit ne donne de louange À ce petit sujet qui n'en mérite pas [ cas.
Mais quoy?	Mais quoi?
de peu de choſe on fait ſouuent grand	de peu de chose on fait souvent grand
Mr KAROLV.	Mr AROLU.
Vos mépris ne font rien qu’accroiſtre voſtre gloire, Déja vous auez place au temple de memoire, Et c’eſt trop offencer ce que i’ay de plus cher;	Vos mépris ne font rien qu'accroître votre gloire, Déjà vous avez place au temple de mémoire, Et c'est trop offenser ce que j'ai de plus cher;
De vous baiſer icy ie ne puis m’empeſcher, Afin de reparer vne ſi grande iniure, Que mon parfait amour ne veux pas que i’endure.	De vous baiser ic ie ne puis m'empêcher, Afin de réparer une si grande injure, Que mon parfait amour ne veux pas que j'endure.
FLEVRIE.	FLEURIE.
Hola, n’approchez pas:	Hola, n'approchez pas:
toubeau, tenez-vous bien, Et dites mon amy que vous ne tenez rien.	toubeau, tenez-vous bien, Et dites mon ami que vous ne tenez rien.
mnui Monteur Raroſu, vous m'adez decoiffée, Et iuſques au mourir vous m’auez échauffée.	ménui Monteur Rarosu, vous m'adez décoiffée, Et jusques au mourir vous m'avez échauffée.
Mr KAROLV.	Mr AROLU.
Ce plaiſir eſt ſi doux, qu’il n’eſt poïnt d’Amoureux Qui de mourir ainſi ne ſe creut bien-heureux:	Ce plaisir est si doux, qu'il n'est poïnt d'Amoureux Qui de mourir ainsi ne se crut bienheureux:
Mais dieux, ce doux baiſer m’interdit la parole.	Mais dieux, ce doux baiser m'interdit la parole.
FLEVRIE.	FLEURIE.
Perſonne ne l’a veu, c’eſt ce qui me conſole.	Personne ne l'a vu, c'est ce qui me console.
que l’aurois de regret ſi quelqu’vn par hazard A ce moment ſur nous euſt ietté ſon regard:	que l'aurais de regret si quelqu'un par hasard A ce moment sur nous eût jeté son regard:
Ie vous laiſſe à penſer ce que l’on pourtoit dire.	Je vous laisse à penser ce que l'on pourrtait dire.
Mr KAROLV.	Mr AROLU.
Que ce ſont des Amans qui s’amuſent à rire.	Que ce sont des Amants qui s'amusent à rire.
FLEVRIE.	FLEURIE.
I’auoüe bien qu’autrefois cela m’euſt ſemblé bon:	J'auoüe bien qu'autrefois cela m'eût semblé bon:
mrais ia peau reſſemblant la coine d’vn iambon Faiſant voir auiourd huy ma face riſſolée Comme vne ſolle fritte ou à demy bruſlée, Rend tous mes ſeruittdibuuinuorus qu'vn glaçon.	mrais ja peau ressemblant la coine d'vn Rambon Faisant voir aujourd ' ace rissolée Comme une solle fritte ou à demi brûlée, Rend tous mes seruittdibuuinuorus qu'un glaçon.
Mr KAROLV.	Mr AROLU.
Tant mieux, en vous prenant i’auray chair & poiſſon.	Tant mieux, en vous prenant j'aurai chair et poisson.
FLEVRIE.	FLEURIE.
Mais ſi telle action mes filles auoient veuë?	Mais si telle action mes filles avaient vue?
MT RAROLV.	MT RAROLV.
Quoy?	Quoi?
voir baiſer leur mere au milieu d’vne ruë.	voir baiser leur mère au milieu d'une rue.
FLEVRIE.	FLEURIE.
Ouy vrayment, ie ne ſçay ce qu’elles en diroient.	Oui vraiment, Madame ne sais ce qu'elles en diraient.
Mr KAROLV.	Mr AROLU.
Que deux parfaits amisgrandement s’aimeroient.	Que deux parfaits amisgrandement s'aimeraient.
FLEVRIE.	FLEURIE.
seroit a des enfans donner vn bon exemple	serait à des enfants donner un bon exemple
Mr KAROLV.	Mr AROLU.
Adieu, quelqu’autre iour noſtre entretien plus ample Me donnera loiſir de conclure auec vous.	Adieu, quelqu'autre jour notre entretien plus ample Me donnera loisir de conclure après vous.
C.	Ç.
FLEVRIE.	FLEURIE.
L’offre que ie vous fais.	L'offre que personne vous fais.
MT RAROLV.	MT RAROLV.
d’eſtre vn iour voſtre eſpoux.	d'être un jour votre époux.
FLEVRIE.	FLEURIE.
Il faut toûjours courir au bien plus neceſſaire.	Il faut toujours courir au bien plus nécessaire.
Mr KAROLV.	Mr AROLU.
Vn Partiſan m’attend pour reſoudre vne affaire.	Un Partisan m'attend pour résoudre une affaire.
Touchant certains auis que ie luy vais donner our la place du Change où ie vais promener:	Touchant certains avis que ie cy vais donner our la place du Change où tu vais promener:
C’eſt là que joliment ſe gagne la pecune, Alors qu’en peu de temps on veut faire fortune.	C'est là que joliment se gagne la pecune, Alors qu'en peu de temps on veut faire fortune.
Allez, faites profit, moy ie vais au bouquet Ioüer vn triquetrac, ou peut-eſtre vn piquet.	Allez, faites profit, moi -je vais au bouquet Iouer un triquettrac, ou peut-être un piquet.
On me doit bien nommerda Perrette l’heureuſe.	On me doit bien nommerda Perrette l'heureuse.
Voila trois amoureux qui n’ont qu’vne amoureuſe:	Voilà trois amoureux qui n'ont qu'une amoureuse:
Le Noble, la Iuſtice, auec le tiers Eſtat, A qui m’aura pour femme ont enſemble debat:	Le Noble, la Justice, avec le tiers État, À qui m'aura pour femme ont ensemble débat:
Mais pourtant celuy-cy a de bons exercices.	Mais pourtant celui-cy a de bons exercices.
Il donne des auis, fait vendre des Offices, Il eſt gagne-denier, il pourſuit des procez, Et fait preſter argent à rente ou intereſts.	Il donne des avis, fait vendre des Offices, Il est gagne-dénier, il suit des procès, Et fait prêter argent à rente ou intérêts.
SCENE V.	SCÈNE V.
POLIANDRE.	POLYANDRE.
ROSELIS.	ROSELIS.
BELANGE	BÉLANGE
POLIANDRE.	POLYANDRE.
’Eſtime plas Amour le pouuoir de tes armes, N Puis que ma paſſion n’a ſceu gouſter leurs charmes;	Estime plas Amour le pouvoir de tes armes, N Puis que ma passion n'a su goûter leurs charmes;
2 11 DOICII De dix milles objets que ie vois dans la Cour Pas vn iuſqu’auiourd’huy ne m’a donné d’amour:	2 11 DOICII De dix mille objets que je vois dans la Cour Pas un jusqu'aujourd'hui ne m'a donné d'amour:
I’ay beau conſiderer l’excés de leurs merites, Ils ont pour ma froideur des chaleurs trop petites Pour ne point captiuer ma chere liberté.	J'ai beau considérer l'excès de leurs mérites, Ils ont pour ma froideur des chaleurs trop petites Pour ne point captiver ma chère liberté.
I’haîrois les appas d’vne diuinité.	J'haîrois les appas d'une divinité.
Mais quoy que mon humeur paroiſſe vagabonde, Ie ne laiſſe pourtant de cherir tout le monde;	Mais quoi que mon humeur paraisse vagabonde, Je ne laisse pourtant de chérir tout le monde;
Ie careſſe vne Dame autant comme vn amy.	Je caresse une Dame autant comme un ami.
12 Ie n’ay dans l’Vniuers qu’Amour pour ennemy.	12 -Je n'ai dans l'Univers qu'Amour pour ennemi.
Et quelque blaſme encor qu’on donne à l’inconſtanct Ie veux iuſqu’au mourir ſuiure l’iudifference, Malgré tous les ehdim detelbueejpris.	Et quelque blâme encor qu'on donne à l'inconstanct Je veux jusqu'au mourir suivre l'iudifférence, Malgré tous les édim detelbuéejpris.
ROSELIS.	ROSELIS.
0 Lurene, mraut qjue lu mneure auectpie ton mépris.	0 Lurène, maut qjue lu méneure auectie ton mépris.
BELANGE.	BÉLANGE.
L SQUEDonnez moy le loiſir de tirer mon épée.	 SQUEDonnez moi le loisir de tirer mon épée.
ROSELIS.	ROSELIS.
Il faut que dans ton ſang la mienne ſoit trempée.	Il faut que dans ton sang la mienne soit trempée.
POLIANDRE.	POLYANDRE.
Quel prodige eſt-ce icy, deux freres inhumains Pour ſe faire mourir ont les armes aux mains?	Quel prodige est-ce ici, deux frères inhumains Pour se faire mourir ont les armes aux mains?
Il faut les ſeparer ſans dauantage attendre.	Il faut les séparer sans davantage attendre.
ROSELIS.	ROSELIS.
En vain voſtre ſeçours taſche de le deffendre.	En vain votre seçours tâche de le défendre.
BELANGE.	BÉLANGE.
Monſieur, obligez nous de vous mettre à l’eſcart, tour iuger qui des coups aura meilleure part.	Monsieur, obligez nous de vous mettre à l'écart, tour juger qui des coups aura meilleure part.
POLIANDRE.	POLYANDRE.
Ie veux auparauant ſçauoir voſtre querelle.	Je veux auparavant sçauoir vôtre querelle.
NOSELIS.	NOSELIS.
Vous n’en pouuez ſçauoir vne plus criminelle.	Vous n'en pouuez savoir une plus criminelle.
BELANGE.	BÉLANGE.
Si vous appellez crime vn conſeil fraternel, Ie confeſſe en effet que ie ſuis criminel.	Si vous appelez crime un conseil fraternel, Je confesse en effet que personne suis criminel.
Mais pourtant la raiſon qui me doit rendre ſage Ne m’a fait dire rien à ton deſauantage.	Mais pourtant la raison qui me doit rendre sage Ne m'a fait dire rien à ton désavantage.
ROSELIS.	ROSELIS.
Perfide, oſe-tu bien proferer ce diſcours Me voyant en l'eſtat de terminer tes iours?	Perfide, ose-tu bien proférer ce discours Me voyant en l'état de terminer tes jours?
Icy je veux apprendre à ta ieune ceruelle Qu'en blaſmant mon amour tu effences ma Belle.	Ici je veux apprendre à ta jeune cervelle Qu'en blâmant mon amour tu essences ma Belle.
DEBANu.	DEBANu.
Ie meure, ſi iamais i’ay voulu l’offencer.	Je meure, si jamais j'ai voulu l'offenser.
POLIANDRE.	POLYANDRE.
ou fatisraction doſt fon crime (ffacer.	ou fatisraction dôt son crime (ffacer.
ROSELIS.	ROSELIS.
Pourquoy m’empeſchez vous de punir vn infame Qui jette ſon venin ſur l’honneur d’vne Dame.	Pourquoi m'empêchez vous de punir un infâme Qui jette son venin sur l'honneur d'une Dame.
POLIANDRE.	POLYANDRE.
le ne ſouffriray point que l’on paſſe à l’effet Que mon ioſte deſir vous n’ayez ſatisfait;	le ne souffrirai point que l'on passe à l'effet Que mon ioste désir vous n'ayez satisfait;
et de quelque coſté que tourne l’iniuſtice le ſeray le premier à punir ſa malice.	et de quelque côté que tourne l'injustice le serai le premier à punir sa malice.
ROSELIS.	ROSELIS.
Fais-en donc le recit, mais ſi diſcretement Que ie n’aye ſujet de mécontentement.	Fais-en donc le récit, mais si discrètement Que je n'aie sujet de mécontentement.
BELANGE.	BÉLANGE.
ouuent l’occaſion ſe montre fauorable celuy que l’Amour veut rendre miſerable:	ouvent l'occasion se montre favorable celui que l'Amour veut rendre misérable:
Dans le commencement que naiſt l’affection, On ne void rien d’égal à cette paſſion:	Dans le commencement que naît l'affection, On ne voit rien d'égal à cette passion:
Tout ce qu’on ſe propoſe en ce premier rencontre Doit ce ſemble arriuer tel que l’eſprit le montre:	Tout ce qu'on se propose en ce premier rencontre Doit ce semble arriver tel que l'esprit le montre:
Mais helas!	Mais hélas!
les effets en ſont ſi differents, Que i’en voudrois les Dieux prendre pour mes gatẽds, Ce propos que ie tiens ne me ſemble inutile Pour faire voir l’état d’vn eſprit bien fragile.	les effets en sont si différents, Que j'en voudrais les Dieux prendre pour mes gatẽds, Ce propos que ie tiens ne me semble inutile Pour faire voir l'état d'être esprit bien fragile.
Mon frere que le Ciel a veu naiſtre amoureux Auec autant d’ardeur comme il eſt genereux;	Mon frère que le Ciel a vu naître amoureux Avec autant d'ardeur comme il est généreux;
Eſpris de la beauté d’vne ieune étrangere Qu’on ne nomme à la Cour que la belle bergere;	Épris de la beauté d'une jeune étrangère Qu'on ne nomme à la Cour que la belle bergère;
A tant flaté ſon mal par vn eſpoir caché Que dix ans de tourment ne l’en ont empeſché.	À tant flatté son mal par un espoir caché Que dix ans de tourment ne l'en ont empêché.
Pendant les premiers feux de ſon dur eſclauage La Coquette toûjours luy faiſoit bon viſage:	Pendant les premiers feux de son dur esclavage La Coquette toujours homme faisait bon visage:
Tout ce qu’elle a voulu n’a pas manqué d’effet;	Tout ce qu'elle a voulu n'a pas manqué d'effet;
Quand l’eſprit ne l’a pû, le courage l’a fait;	Quand l'esprit ne l'a pu, le courage l'a fait;
Où la faueur n’a pû faire voir ſa puiſſance Il a forcé les Dieux à prendre ſa deffence.	Où la faveur n'a pu faire voir sa puissance Il a forcé les Dieux à prendre sa défense.
Luy tout ſeul l’a rauit à Montreüil ſur le bois Malgré tous les efforts de deux cent villageois:	Lui tout seul l'a ravit à Montreil sur le bois Malgré tous les efforts de deux cent villageois:
Il eſt cauſe auiourd'hny que toute la Nobleſſe L’eſtime dans la Cour autant qu’vne Princeſſe.	Il est cause aujourd'hni que toute la Noblesse L'estime dans la Cour autant qu'une Princesse.
Mais comme cét eſprit remply de vanité A veu que tout le monde admire ſa beauté, Que chaque Courtiſan ſans ceſſe la careſſe, Meſme qu’vn ieune Duc l’appelle ſa maiſtreſſe, Sa grande ambition a porté ſes eſprits A ne luy plus parler qu’auecque du mépris:	Mais comme cet esprit rempli de vanité A vu que tout le monde admire sa beauté, Que chaque Courtisan sans cesse la caresse, Même qu'un jeune Duc l'appelle sa maîtresse, Sa grande ambition a porté ses esprits A ne lui plus parler qu'avec du mépris:
Si mon frere l’aborde, elle tourne viſage;	Si mon frère l'aborde, elle tourne visage;
Penſant la cajoller elle entretient vn page:	Pensant la cajoler elle entretient un page:
S’il preſente la main pour la mener au bal, Peur de l’incommouer ene prene miraui.	S'il présente la main pour la mener au bal, Peur de l'incommouer ene prène miraui.
S’il preſſe ſa raiſon de vouloir reconnoiſtre.	S'il presse sa raison de vouloir reconnaître.
Le veritable amour que ſon cœur fait paroiſtre;	Le véritable amour que son cœur fait paraître;
Elle dit froidement qu’elle n’a rien promis Qui le puiſſe empeſcher de viure bons amis.	Elle dit froidement qu'elle n'a rien promis Qui le puisse empêcher de vivre bons amis.
Voyez ſi c’eſt parler en termes d’vne fille Dont le nom ſeulement bleſſe noſtre famille;	Voyez si c'est parler en termes d'une fille Dont le nom seulement blesse notre famille;
De ſimple villageoiſe elle a eu le bon-heur D’eſtre par ſon credit au comble de l’honneur?	De simple villageoise elle a eu le bonheur D'être par son crédit au comble de l'honneur?
Mais elle cependant tout ce bien-fait oublie, En luy faiſant affront l’ingrate le publie.	Mais elle cependant tout ce bienfait oublie, En Ah faisant affront l'ingrate le publie.
Et quand ie penſe icy dire mon ſentiment Qu’il ne doit pas paroiſtre inſenſible en aimant Tienant tous mes propos pour vne grande iniure Il me veut mettre à mort pourueu que ie l’endure.	Et quand grande pense ici dire mon sentiment Qu'il ne doit pas paraître insensible en aimant Tienant tous mes propos pour une grande injure Il me veut mettre à mort pourvu que je l'endure.
Iugez doncques, Monſieur, ſi le ſuiet le vaut.	Jugez donc, Monsieur, si le sujet le vaut.
POLIANDRE.	POLYANDRE.
Roſelis en cela me ſemble vn peu trop chaut:	Roselis en cela me semble un peu trop chaut:
Mais pourueu qu’à l’amour ſon honneur il prefere, Puis qu’à mon iugement il a remis l’affaire, le teuxdie e palant par forme de deuis Qu’en ce cas ſa raiſon doit ſuiure voſtre auis Que vous deuez tous deux vous aimer comme freres, Sans iamais contre vous animer vos coleres.	Mais pourvu qu'à l'amour son honneur il préfère, Puis qu'à mon jugement il a remis l'affaire, le teuxdie e allant par forme de deuis Qu'en ce cas sa raison doit suivre votre avis Que vous devez tous deux vous aimer comme frères, Sans jamais contre vous animer vos colères.
BELANGE.	BÉLANGE.
Cét équitable Arreſt nous impoſe vne loy Que mon frere doit ſuiure auſſi bien comme moy?	Cet équitable Arrêt nous impose une loi Que mon frère doit suivre aussi bien comme moi?
Toutefois ie crains fort qu’il y trouue à redire.	Toutefois Seigneur crains fort qu'il y trouve à redire.
POLIANDRE.	POLYANDRE.
Ie ne crains pas auſſi qu’il me vueille dédire.	Je ne crains pas aussi qu'il me veuille dédire.
Re dnares Monſieur, nous vous auons trop d’obligation, Voſtre Arreſt prononcé ie ſuis ſans paſſion;	Re dnares Monsieur, nous vous avons trop d'obligation, Votre Arrêt prononcé quelque suis sans passion;
Et quoy que ſon effet me ſemble difficile I'eſpere auec le temps me le rendre facile.	Et quoi que son effet me semble difficile J'espère avec le temps me le rendre facile.
POLIANDRE.	POLYANDRE.
Adieu donc, cependant demeurez bons amis;	Adieu donc, cependant demeurez bons amis;
Et me tenez tous deux ce que m’auez promis.	Et me tenez tous deux ce que m'avez promis.
B	B
BELANGE.	BÉLANGE.
Plutoſt que d’y manquer ie veux perdre la vie.	Plutôt que d'y manquer un veux perdre la vie.
ROSELIS.	ROSELIS.
Ta reſolution de la mienne eſt ſuiuie, Pourueu que deſormais paroiſſant plus diſcret Tu n’ailles à tout le monde decouurir mon ſecret.	Ta résolution de la mienne est suivie, Pourvu que désormais paraissant plus discret Tu n'ailles à tout le monde découvrir mon secret.
din au premter dtie.	din au premer dtie.
TAM AT	TAM AT
SCENE PREMIERE.	SCÈNE PREMIÈRE.
SILINDE.	SILINDE.
CLARISTE.	CLARISTE.
FLORIANE.	FLORIANE.
FLEVRIE.	FLEURIE.
SILINDE.	SILINDE.
Eſt trop dans le logis demeurer enfermée, O he ooiei nujaut pras la forte accouſtumée:	Est trop dans le logis demeurer enfermée, Ô hé ooiei nujaut pras la forte accoustumée:
D'vn air plus temperé fait gouſter les douceurs.	D'un air plus tempéré fait goûter les douceurs.
Clariſte, Floriane, où eſtes vous, mes ſœurs?	Clariste, Floriane, où êtes -vous, mes sœurs?
Pour icy trauailler apportez voſtre ouurage.	Pour ici travailler apportez Seigneur ouvrage.
Nous nous diuertirons auec le voiſinage.	Nous nous divertirons avec le voisinage.
CLARISTE.	CLARISTE.
Auec meſme deſſein nous deualions en bas.	Avec même dessein nous dévalions en bas.
FLORTANE.	FLORTANE.
Déja pour commencer i’auois pris deux rabas.	Déjà pour commencer j'avais pris deux rabas.
SILINDE.	SILINDE.
Ma lœur, apporte-moy vne chaire bien baſſe.	Ma lœur, apporte-moi une chaire bien basse.
FLORIANE.	FLORIANE.
En voila déja deux, ô dieux que ie ſuis laſſe!	En voilà déjà deux, ô dieux que tu suis lasse!
Or ſus, auparauant que ie remonte en haut Pour n’y plus retourner dites ce qu’il vous faut.	Or sus, auparavant que je remonte en haut Pour n'y plus retourner dites ce qu'il vous faut.
CLANISIE.	CLANISIE.
Deſſus noſtre buffet eſt mon poinct de Hongrie.	Dessus notre buffet est mon point de Hongrie.
SILINDE.	SILINDE.
Mon métier eſt auprés de ſa tapiſſerie;	Mon métier est auprès de sa tapisserie;
Petite pareſſeuſe haſtez-vous de venir.	Petite paresseuse hâtez-vous de venir.
aullarores Il ne faudra rien qu’elle à nous entretenir Si ſon gentil eſprit n’a point d’autres penſées.	aullares Il ne faudra rien qu'elle à nous entretenir Si son gentil esprit n'a point d'autres pensées.
FLORIANE.	FLORIANE.
Mes peines deuroient bien eſtre recompenſées.	Mes peines devraient bien être récompensées.
Mais quoy?	Mais quoi?
le droit d’aiſneſſe auec ſa primauté Me rauit bien ſouuent ce que i’ay merité:	le droit d'aînesse avec sa primauté Me ravit bien souvent ce que j'ai mérité:
Il faut que la plus ieune endure de l’aiſnée, Il faut tout luy ceder pour n’eſtre mal-menée, Il faut aller par tout, & bien viſte marcher Sans qu’aucune raiſon vous en puiſſe empeſcher.	Il faut que la plus jeune endure de l'aînée, Il faut tout cela céder pour n'être mal-menée, Il faut aller par tout, et bien vite marcher Sans qu'aucune raison vous en puisse empêcher.
S’il ſe trouue vn party ſera pour la premiere, La plus ieune touſiours demeure la derniere.	S'il se trouve un parti sera pour la première, La plus jeune toujours demeure la dernière.
Enfin s’il ſe pouuoit, pour les fort obliger Mon âge auec le leur ie voudrois bien changer:	Enfin s'il se pouvait, pour les fort obliger Mon âge avec le leur vie voudrais bien changer:
Car i’ay bien du regret de ne les point voir femmes, Et d’obeïr touſiours à ces belles Madames.	Car j'ai bien du regret de ne les point voir femmes, Et d'obéir toujours à ces belles Madames.
SILINDE.	SILINDE.
Cauſeuſe, taiſez-vous, trauaillez ſeulement, Et nous donnez loiſir de parler vn moment.	Causeuse, taisez-vous, travaillez seulement, Et nous donnez loisir de parler un moment.
FLORIANE.	FLORIANE.
Quand i’ay de la raiſon ie ne me ſçaurois taire.	Quand j'ai de la raison ie ne me saurais taire.
CLARISTE.	CLARISTE.
Vous eſtes d’vn humeur grandement volontaire,	Vous êtes d'un humeur grandement volontaire,
B iij Il falloit ajouſfer à voſtre beau diſcours, Qu’à la ieuneſſe auſſi nous pardonnons touſiours	 iij Il fallait ajouffer à votre beau discours, Qu'à la jeunesse aussi nous pardonnons toujours
FLORIANE.	FLORIANE.
Il eſt vray que ſouuent i’euſſe eſté bien tapée, or courant upres moy vous meumnen attrapée:	Il est vrai que souvent j'eusse été bien tapée, or courant uprès moi vous meumnen attrapée:
Mais ma fuitte ſouuent m’a ſeruy de pardon.	Mais ma fuite souvent m'a servi de pardon.
SILINDE.	SILINDE.
Briſez ſur ce propos pour en entendre vn bon, I’ay ce matin appris de ma bonne commere  Monſieur Karolu recherche noſtre mere, Qu'à quel prix que ce ſoit il la veut épouſer, Memme qu'’en celtaineuron les a veus banicre.	Brisez sur ce propos pour en entendre un bon, J'ai ce matin appris de ma bonne commere Monsieur Karolu recherche notre mère, Qu'à quel prix que ce soit il la veut épouser, Memme qu'en celtaineuron les a vus banicre.
CLARISTE.	CLARISTE.
O Dieux !	Ô Dieux !
eſt-il poſſible?	est-il possible?
SILINDE.	SILINDE.
Il eſt trop veritable, Les articles ce iour ſeront mis ſur la table:	Il est trop véritable, Les articles ce jour seront mis sur la table:
Et maiſtre Jeremie & ce vieux Colporteur Ont ſeur conge tous uenx auet grand creuecœur.	Et maître Jérémie et ce vieux Colporteur Ont sûr congé tous uenx au grand creuecœur.
FLORIANE.	FLORIANE.
Ils me déplaiſoient fort, quoy qu’ils me fiſſent rire, Et i’auois ſans mentir le deſſein de leur dire.	Il me déplaisaient fort, quoi qu'ils me fissent rire, Et j'avais sans mentir le dessein de leur dire.
CLARISTE.	CLARISTE.
Il eſt vray qu’à ces deux ie n’euſſe conſenty:	Il est vrai qu'à ces deux ie n'eusse consenti:
Mais Monſieur Karolu, c’eſt vn fort bon party, Oncomiont ia fgnec autant que ion merite;	Mais Monsieur Arolu, c'est un fort bon parti, Oncomiont ja fgne autant que ion mérite;
On ſçait qu’il a du bien qui n’a point de limite, Que par tout chez ſes Grands il eſt le bien venu, Et qu’il eſt dans Paris de tout chacun connu:	On sais qu'il a du bien qui n'a point de limite, Que par tout chez ses Grands il est le bien venu, Et qu'il est dans Paris de tout chacun connu:
Bref, il nous fait faueur d’eſtre noſtre beaupere.	Bref, il nous fait faveur d'être notre beaupère.
da BilaDE Hola, n’en parlons plus:	da BilaDE Holà, n'en parlons plus:
car voicy noſtre mere.	car voici notre mère.
FLEVRIE.	FLEURIE.
Hé bien, que faites vous, que dit-on au quartier?	Hé bien, que faites -vous, que dit-on au quartier?
FLORIANE.	FLORIANE.
Voila d’vn des garçons de noſtre Sauetier qui vient de demander l’argent de deux ſemelles.	Voilà d'un des garçons de notre Savetier qui vient de demander l'argent de deux semelles.
FLEVRIE.	FLEURIE.
Taiſez-vous, baboüine, eſt-ce là les nouuelles Qu’aujourd’huy mon eſprit veut entendre de vous?	Taisez-vous, baboüine, est-ce là les nouvelles Qu'aujourd'hui mon esprit veut entendre de vous?
FLORIANE.	FLORIANE.
Que nous aurons bien-toſt vn beau-pere chez.	Que nous aurons bientôt un beau-père chez.
nous.	nous.
FLEVRIE.	FLEURIE.
Mais regardez vn peu la petite ruſée Qui luy peut auoir dit?	Mais regardez un peu la petite rusée Qui lui peut avoir dit?
FLORIANE.	FLORIANE.
Madame la Roſée.	Madame la Rosée.
FLEVRIE.	FLEURIE.
Puis que ma bequenots me prend icy ſans ver, Ie ne puis plus celer ce qu’elle a découuert;	Puis que ma bequenots me prend ici sans ver, Je ne puis plus celer ce qu'elle a découvert;
La mine eſt éuentée au temps que l’on deſire, Auſſi bien aujourd’huy falloit-il vous le dire.	La mine est éventée au temps que l'on désire, Aussi bien aujourd'hui fallait-il vous le dire.
Sçãchez-donc qu’il eſt vray que Monſieur Karolus De m’auoir pour ſa femme eſt bien fort reſolu;	Sçãchez-donc qu'il est vrai que Monsieur Arolus De m'avoir pour sa femme est bien fort résolu;
Ie croy que toutes trois vous en ſerez contentes.	Je crois que toutes trois vous en serez contentes.
SILINDE.	SILINDE.
On nous eſtimeroit tout à fait imprudentes, Si voyante le bon heur nous preſenter la maim Nous ne courions apres par vn meſme chemin:	On nous estimerait tout à fait imprudentes, Si voyante le bon heur nous présenter la maim Nous ne courions après par un même chemin:
En cela nous deuons ſuiure voſtre ſageſſe, Imitans vos vertus nous furdrons ia nobieſſe.	En cela nous devons suivre votre sagesse, Imitants vos vertus nous furdrons ja nobiesse.
Et puis que l’vn & l’autre y ſont tous deux portez, Nous ſerons toutes trois d’égales volontez.	Et puis que l'un et l'autre y sont tous deux portés, Nous serons toutes trois d'égales volontés.
FLEVRIE.	FLEURIE.
Ce diſcours me plaiſt fort:	Ce discours me plaît fort:
tu ne dis rien Glariſte?	tu ne dis rien Glariste?
CLARISTE.	CLARISTE.
Elle a parlé pour moy.	Elle a parlé pour moi.
FLEVRIE.	FLEURIE.
Que tu me femnple tiiize -	Que tu me femnple tize -
CLARISTE.	CLARISTE.
Vous me pardonnerez.	Vous me pardonnerez.
FLORIANE.	FLORIANE.
Ce tein blanc ſans chaleurs Reſſemble extrémement à des pâles couleurs:	Ce tein blanc sans chaleurs Ressemble extrêmement à des pâles couleurs:
Elle mange du ſel, elle boit du vinaigre Pour auoir la peau oranene de le vage maigre:	Elle mange du sel, elle boit du vinaigre Pour avoir la peau oranène de le vage maigre:
C’eſt ſans doute ſon mal.	C'est sans doute son mal.
FLEVRIE.	FLEURIE.
Ha!	Ha!
que voicy grand cas.	que voici grand cas.
FLORTANE.	FLORTANE.
Il luy faut vn mary.	Il lui faut un mari.
FLEVRIE.	FLEURIE.
vous ne vous tairez pas?	vous ne vous tairez pas?
FLORIANE.	FLORIANE.
lauray bien de la peine.	laurai bien de la peine.
FLEVRIE.	FLEURIE.
En verité ie iure.	En vérité Seigneur jure.
FLORIANE.	FLORIANE.
Que ſi vous me battez, il faudra que i’endure.	Que si vous me battez, il faudra que j'endure.
TEEVRED.	TEURED.
Entrez dans la maiſon, & nous laiſſez icy.	Entrez dans la maison, et nous laissez ici.
FLORIANE.	FLORIANE.
Bien, ne vous faſchez pas, ie m’en allois auſſi.	Bien, ne vous fâchez pas, Seigneur m'en allais aussi.
CLARISTE.	CLARISTE.
Ie loüe extremement le bon choix que vous faites.	Je loue extrêmement le bon choix que vous faites.
FLEVRIE.	FLEURIE.
Mon ſentiment n’a point que des regles parfaites;	Mon sentiment n'a point que des règles parfaites;
Ie ne fais rien pour moy que ce ne ſoit pour vous.	Je ne fais rien pour moi que ce ne soit pour vous.
Si ie prens vn mary vous aurez des eſpoux Selon voſtre merite, & plus à l’auantage Que ie n’euſſe pû faire au temps de mon vefuage:	Si ici prends un mari vous aurez des époux Selon votre mérite, et plus à l'avantage Que notre n'eusse pu faire au temps de mon vefuage:
Nous ferons ſeulement vn petit déjeuner, Et puis dans vn batteau nous irons promener.	Nous ferons seulement un petit déjeuner, Et puis dans un batteau nous irons promener.
SILINDE.	SILINDE.
Quand nous arriuera cette bonne fortune?	Quand nous arrivera cette bonne fortune?
CLARISTE.	CLARISTE.
Imune.	Imune.
Telle on la peut nommer, puis qu’elle n’eſt pas com	Telle on la peut nommer, puis qu'elle n'est pas com
FLEVRIE.	FLEURIE.
peut-eſtre des demain, ſelon l’occaſion.	peut-être des demain, selon l'occasion.
CLARISTE.	CLARISTE.
La haſte apporteroit de la confuſion, Il vaut mieux retarder quelque peu dauantage.	La hâte apporterait de la confusion, Il vaut mieux retarder quelque peu davantage.
FLEVRIE.	FLEURIE.
Queiqu vm tient m'aoorder, ehangeons noſtre langage.	Queiqu viens tient m'aoorder, Ehangeons notre langage.
SILINDE.	SILINDE.
Nous irons promener, il eſt tout reſolu.	Nous irons promener, il est tout résolu.
CLARISTE.	CLARISTE.
Vrayment bien à propos vient Monſieur Karolu.	Vraiment bien à propos vient Monsieur Karolu.
Mr KAROLV.	Mr AROLU.
Ie ſuis de la partie, & veux que ſoit Dimanche Ie porte auec du vin vn bon paſté d’éclanche.	Je suis de la partie, et veux que soit Dimanche Je porte avec du vin un bon pas d'éclanche.
Pour vn ſou nous aurons vn carroſſe à courtaux, Qui n’a pour le mener ny cocher ny cheuaux, Mais la Matne & la Seine, & quelque petit voile, Conduit par vn cocher veſtu de groſſe toile.	Pour un sou nous aurons un carrosse à courtaux, Qui n'a pour le mener toujours cocher avait cheaux, Mais la Matne et la Seine, et quelque petit voile, Conduit par un cocher vêtu de grosse toile.
LEETRIE.	LETRIE.
I'apprehende bien fort la pluye auec le vent.	J'appréhende bien fort la pluie avec le vent.
Mr XAROLV.	Mr XAROLV.
Au beſoin ce chapron nous ſeruiroit d’hauuent.	Au besoin ce chapron nous servirait d'hauvent.
FLEVRIE.	FLEURIE.
Hè bien, bien, mocquez-vous, vous eſtes à voſtre aiſe.	HÉ bien, bien, moquez-vous, vous êtes à votre aise.
Mr KAROLV.	Mr AROLU.
Vous y ſerez auin, pourueu que ſe vous plaiſe.	Vous y serez auin, pourvu que se vous plaise.
FLEVRIE.	FLEURIE.
na!	na!
ne me faillez point, vous auez trop d’appas.	ne me faillez point, vous avez trop d'appas.
Pour n’eſtre pas aimé par vn ſuiet ſi bas.	Pour n'être pas aimé par un sujet si bas.
Mais	Mais
Mr KAROLV.	Mr AROLU.
Quoy?	Quoi?
vous ſoûpirez.	vous soupirez.
FLEVRIE.	FLEURIE.
Puiſque mon cœur ſoûpire:	Puisque mon cœur soupire:
C’eſt vn ſigne certain qu’il n’a ce qu’il deſire.	C'est un signe certain qu'il n'a ce qu'il désire.
Mr KAROLV.	Mr AROLU.
Si vous me deſirez, ie ſuis du tout à vous.	Si vous me désirez, Seigneur suis du tout à vous.
FLEVRIE.	FLEURIE.
Fhit chttez dedans, pour vn peu laiſſez-nous, Prenez place, Monſieur, & cauſons vn quart d’heure.	Fhit chtés dedans, pour un peu laissez-nous, Prenez place, Monsieur, et causons un quart d'heure.
Mr KAROLV.	Mr AROLU.
Ie ne pouuois auoir de rencontre meilleure.	Je ne pouvais avoir de rencontre meilleure.
CENE II Me IEREMIE.	CÈNE II Me IEREMIE.
Mr KAROLV.	Mr AROLU.
FLEVRIE.	FLEURIE.
M.	M.
IEREMIE.	JEREMIE.
NOuffriray-ie vn riual piller ſur mes talons?	NOuffrirai-je un rival piller sur mes talons?
OQuand ie penſe auancer ie tombe à reculons, Ie porte mon eſpoir à poſſeder Fleurie;	OQuand Madame pense avancer ie tombe à reculons, Je porte mon espoir à posséder Fleurie;
Lors qu’vn autre la ſert ſans craindre ma furie:	Lors qu'un autre la sert sans craindre ma furie:
Sus, il faut que ſa mort ſatis faſſe ma foy:	Sus, il faut que sa mort satî fasse ma foi:
Mais tout beau, parlons bas, ils ſont proche de moy, Ie les veux accoſter ſous vn autre viſage, Et par vn feint diſcours remaſcher mon courage:	Mais tout beau, parlons bas, ils sont proche de moi, Je les veux accoster sous un autre visage, Et par un feint discours remâcher mon courage:
Que font icy tous leuis cesdeux parlaits amans?	Que font ici tous levis cesdeux parlaits amants?
Mr KAROLV.	Mr AROLU.
dis accendent i'nonneur de vos commahdemens.	dis accendent j'nonneur de vos commahdements.
M.	M.
IEREMIE.	JEREMIE.
Vos elprits ſont contens.	Vos elleprits sont contents.
Mr KAROLV.	Mr AROLU.
Donnons-luy des caſſades.	Donnons-lui des cassades.
FLEVRIE.	FLEURIE.
Nous nous entretenions du temps des barricades.	Nous nous entretenions du temps des barricades.
M.	M.
IEREMIE.	JEREMIE.
Aucun n’en peut parler de meſme comme moy:	Aucun n'en peut parler de même comme moi:
Car Maheutre en ce temps ie tenois pour le Roy.	Car Heutre en ce temps ie tenais pour le Roi.
FLEVRIE.	FLEURIE.
Aſſiſez-vous donc là pour nous dire de grace Quel étrange malheur cauſa cette diſgrace.	Assisez-vous donc là pour nous dire de grâce Quel étrange malheur causa cette disgrâce.
M.	M.
IEREMIE.	JEREMIE.
La Religion ſeule apporta tous ces maux, Deux contraires partis cauſerent nos trauaux:	La Religion seule apporta tous ces maux, Deux contraires partis causèrent nos travaux:
Le party Huguenot, choque le Catholique;	Le parti Huguenot, choque le Catholique;
Celuy-là des Papots reſiſte à l’heretique:	Celui-là des Papots résiste à l'hérétique:
Ainſi l’eauë & le feu formerent des debats, Qui par plus de dix ans troublerent nos Eſtats;	Ainsi l'eaue et le feu formèrent des débats, Qui par plus de dix ans troublèrent nos États;
Car apres Henry trois, le grand Roy de Nauarre, Des Princes vertueux l’exemple le plus rare, Succedant à ſon ſceptre auſſi bien qu’à ſes mœurs, Eſprouua des Ligueurs les mauuaiſes humeurs:	Car après Henri trois, le grand Roi de Navarre, Des Princes vertueux l'exemple le plus rare, Sucédant à son sceptre aussi bien qu'à ses mœurs, Éprouva des Ligueurs les mauvaises humeurs:
En venant à Paris on luy ferme la porte, Sous vn pretexte feint on le traite de ſorte, Qu’auecques ſon armée il eſt contraint enfin De reſoudre ſa force à la prendre par faim;	En venant à Paris on lui ferme la porte, Sous un prétexte feint on le traite de sorte, Qu'avec son armée il est contraint enfin De résoudre sa force à la prendre par faim;
Il aſſiege ſes murs, ſa peine eſt inutile, onaeun veuteitre malitie en cette grande ville, Chacun veut commander, chacun veut eſtre Roy, On n’y trouue raiſon, ny police, ny loy;	Il assiège ses murs, sa peine est inutile, onaeun viteitre malitie en cette grande ville, Chacun veut commander, chacun veut être Roi, On n'y trouve raison, Seigneur police, ni loi;
Neantmoins à la fin leur eſperance eſt vaine.	Néanmoins à la fin leur espérance est vaine.
Mr KAROLV.	Mr AROLU.
Il eſt vray qu’à l’inſtant que feu Monſieur du Maine, Fut par le peuple éleu Lieutenant General, Du quartier de la Gréue on me fit Caporal.	Il est vrai qu'à l'instant que feu Monsieur du Maine, Fut par le peuple élev Lieutenant Général, Du quartier de la Grève on me fit Caporal.
HIEREMIE.	HIEREMIE.
De toutes nations du ſecours on mandie:	De toutes nations du secours on mandie:
Mais chacune à deſſein ioüant ſa Comedie Eſt contrainte à manger auec ceux de Paris, Des chiens, des chats, des rats, auecque des ſouris.	Mais chacune à dessein ioüant sa Comédie Est contrainte à manger avec ceux de Paris, Des chiens, des chacune, des rats, avec des souris.
FLEVRIE.	FLEURIE.
O que de Lanſquenets, d’Eſpagnols & de Suiſſes!	Ô que de Lansquenets, d'Espagnols et de Suisses!
Regretoient l’aliment de leurs merts nourrices, Ils ne viuoient ſinon de raues & de nauets, Qu’ils s’en alloient cueillir la haut ſur ces marais Li nie m’en ſouuiens le Capitaine Iacques Me fit don d’vne miche aſſez proche de Paſques.	Regretaient l'aliment de leurs merts nourrices, Ils ne vivaient sinon de raves et de navets, Qu'ils s'en allaient cueillir la haut sur ces marais Li nie m'en souviens le Capitaine Iacques Me fit don d'une miche assez proche de Pasques.
M.	M.
IEREMIE.	JEREMIE.
Sans doute que ce fut alors que deux batteaux Paſſerent malgré nous à la faueur des eaux.	Sans doute que ce fut alors que deux batteaux Passèrent malgré nous à la faveur des eaux.
FLEVRIE.	FLEURIE.
Ce fut pluſtoſt le iour qu’on nomme des farines.	Ce fut plutôt le jour qu'on nomme des farines.
M.	M.
IEREMIE.	JEREMIE.
Les Seize & L’vnion cauſerent vos ruines:	Les Sise et L'vnion causèrent vos ruines:
cainie peupie vny duxvoomes cu Roy Les eut abandonnez, ſous ce zele de foy, Ils n’euſſent pas duré vne ſeule iournée.	cie peupie uni duxvoomes cv Roi Les eut abandonnés, sous ce zèle de foi, Ils n'eussent pas duré une seule journée.
Mr KAROLV.	Mr AROLU.
La Cour de Parlement eſtant empriſonnée, Le peuple eſtoit trop foible, & trop dans les dangers, Pour penſer reſiſter au nombre d’étrangers.	La Cour de Parlement étant emprisonnée, Le peuple était trop faible, et trop dans les dangers, Pour penser résister au nombre d'étrangers.
M.	M.
IERUMIE.	JERUMIE.
Sous le viſage faux d’vn maſque politique, Chaque ſeditieux ſe diſoit Catholique, Meſme encor à beaucoup on ne le peut oſter.	Sous le visage faux d'une masque politique, Chaque séditieux se disait Catholique, Même encor à beaucoup on ne le peut ôter.
FLEVRIE.	FLEURIE.
Voire, voire, vrayment vous m’en voulez conter, Ma foy l’on ne fit rien que ſelon l’Euangile.	Voire, voire, vraiment vous m'en voulez conter, Ma foi l'on ne fit rien que selon l'Euangile.
Que les Predicateurs preſchoient en cette ville.	Que les Prédicateurs prêchaient en cette ville.
M.	M.
IEREMIE.	JEREMIE.
Pauures eſprits trompez.	Pauvres esprits trompez.
FLEVRIE.	FLEURIE.
Hola n’en parlons plus;	Holà n'en parlons plus;
Car nous en viendrions aux priſes là-deſſus.	Car nous en viendrions aux prises là-dessus.
M.	M.
IEREMIE.	JEREMIE.
2 Si eſt-ce que pourtant ie n’en ay point d’enuie:	2 Si est-ce que pourtant ici n'en ai point d'envie:
La Ligue pluſieurs fois ma prerque oite la vie:	La Ligue plusieurs fois ma prêt oite la vie:
Car voulant ſouſtenir le party de mon Roy, Les femmes de Paris ſe bandans contre moy l’euſſent défiguré:	Car voulant soutenir le parti de mon Roi, Les femmes de Paris se bandans contre moi l'eussent défiguré:
mais par vne ſortie.	mais par une sortie.
oul euiter debat ie quittois la partie.	oul éviter débat ainsi quittais la partie.
FLEVRIE.	FLEURIE.
Ienez vous aſſeuré que i’en ferois autant, Nous appelles ligueurs, l’affront eſt important, teit taener nonte nonneur par vne caſomnie, Qui ne peut en effet eſtre par trop punie.	Jenez vous assuré que j'en ferais autant, Nous appelles ligueurs, l'affront est important, teit taener nonte nonneur par une casomnie, Qui ne peut en effet être par trop punie.
M.	M.
IEREMIE.	JEREMIE.
par la verité du diſcours commencé oſtre eſprit maintenant ſe trouue eſtre offencé.	par la vérité du discours commencé ôtre esprit maintenant se trouve être offensé.
eſt vne ſigne certain qu’il en eſt quelque choſe.	est une signe certain qu'il en est quelque chose.
TLEVRIE.	TLEURIE.
riſons-donc là deſſus, voſtre diſcours eſt cauſe de la colere icy m'empeſche de parler.	risons-donc là dessus, votre discours est cause de la colère ici m'empêche de parler.
M.	M.
TEREMIE.	TEREMIE.
14 uſtoſt que vous faſchet i’ayme mieux m’en aller.	14 ustost que vous fâchet j'aime mieux m'en aller.
Mr KAROLV.	Mr AROLU.
ion, Monſieur, ne bougez.	ion, Monsieur, ne bougez.
M.	M.
IEREMIE.	JEREMIE.
Madame eſt en colere.	Madame est en colère.
FLEVRIE.	FLEURIE.
eſt vray ie la ſuis, ie ne m’en ſçauroistante.	est vrai assez la suis, ie ne m'en sçauroistante.
M.	M.
IEREMIE.	JEREMIE.
ous me pardonnerez, adieu iuſqu’at reuoir, lenards, dans peu de temps vous verrez mon pouonx	ous me pardonnerez, adieu jusqu'at revoir, lenards, dans peu de temps vous verrez mon pouonx
FLEVRIE.	FLEURIE.
dé bien, ne voila pas vne excellente ruſet	de bien, ne voilà pas une excellente ruset
Mr KAROLV.	Mr AROLU.
four demeurer icy le galand n’a d’excuſe.	four demeurer ici le galant n'a d'excuse.
FLEVRIE.	FLEURIE.
Il m’importunoit fort.	Il m'importunait fort.
Mr KAROLV.	Mr AROLU.
O le peſant fardeau.	Ô le pesant fardeau.
FLEVRIE.	FLEURIE.
le ſouhaittois fort au fa	le souhaitais fort au fa
Mr KAROLV.	Mr AROLU.
ruis qué nous voicy ſeuls, ſans tarder dauantage, Il nous faut auiſer à noſtre mariage.	ruis qué nous voici seuls, sans tarder davantage, Il nous faut aviser à notre mariage.
TLETRAM.	TLETRAM.
Ie ne ſuy en cela que voſtre volonté.	Je ne suis en cela que votre volonté.
Mr KAROLV.	Mr AROLU.
Il faut premierement changer de qualité, Il faut que deſormais vous ſoyez Damoiſelle;	Il faut premièrement changer de qualité, Il faut que désormais vous soyez Damoiselle;
Mais parce que Madame a l’emphaſe plus belle ii vous faut appenens oirvous ſemble à propos Madame Karolu, ou de la ſauſſe au ros, C’eſt vn bon ſief que i’ay proche le Bourg-lareine.	Mais parce que Madame a l'emphase plus belle ji vous faut appens oirvous semble à propos Madame Arolu, ou de la sausse au ros, C'est un bon sièf que j'ai proche le Bourg-lareine.
FLEVRIE.	FLEURIE.
Ha!	Ha!
vrayment bien ſouuent il faudra qu’on m’y meine, Soit pour faire vendange, ou en autre ſaiſon.	vraiment bien souvent il faudra qu'on m'y mène, Soit pour faire venge, ou en autre saison.
M.	M.
KAROLV.	VAROLV.
Il faut qu’aum daiis peu vous enangrende maiſon, Afin de s’éloigner de cette connoiſſance Qu'on ne peut frequenter ſans que l’honneur s’offence.	Il faut qu'aum daiis peu vous enangrende maison, Afin de s'éloigner de cette connaissance Qu'on ne peut fréquenter sans que l'honneur s'offense.
FLEVRIE.	FLEURIE.
Ie marcheray par tout où vous deſirerez, I1 tous vos bons dentme les miens ſont meſurez, Ie ne ſçaurois faillir deſſous voſtre conduite.	Je marcherai par tout où vous désirerez, I1 tous vos bons dentme les miens sont mesurés, Je ne saurais faillir dessous votre conduite.
Mr RAROLV.	Mr RAROLU.
Pourueu que ma raiſon ait la voſtre à ſa ſuitte:	Pourvu que ma raison ait la vôtre à sa suitte:
Ne nous amuſons point à diſcours ſupelflus.	Ne nous amusons point à discours supelflus.
TLEVRIE.	TLEURIE.
Le temps ne permet pas que nous en faſſions plus.	Le temps ne permet pas que nous en fassions plus.
Mr KAROLV.	Mr AROLU.
Quand nous maritons-nous?	Quand nous maritons-nous?
FLEVRIE.	FLEURIE.
Ceit bieit d'autres affaires	Ceit bieit d'autres affaires
Mr KAROLV.	Mr AROLU.
fin des iours Caniculaires,	fin des jours Caniculaires,
FLEVRIE.	FLEURIE.
Le temps eſt par trop bref pour y mettre la main, Il faut auparauant des habits à Fleurie.	Le temps est par trop bref pour y mettre la main, Il faut auparavant des habits à Fleurie.
4 Mr KAROLV.	4 Mr AROLV.
Nous trouuerons de tout dedans la Fripperie, Pour trois ou quaile ercus nous iouerons des atours Qui nous pourront ſeruir pendant deux ou trois iours.	Nous trouverons de tout dedans la Fripérie, Pour trois ou quaile ercus nous jouerons des atours Qui nous pourront servir pendant deux ou trois jours.
FLEVRIE.	FLEURIE.
Vous auez bien raiſon:	Vous avez bien raison:
car pour mes trois fillettes Ie les habilleray comme des bauolettes;	car pour mes trois fillettes Je les habillerai comme des bavolettes;
Tandis que le Tailleur nous fera des habits.	Tandis que le Tailleur nous fera des habits.
MI RANOLV.	MI RANOLU.
Voila donc qui vaut fait, priez tous vos amis, Mettez bon ordre à tout, Adieu ma chere amante.	Voilà donc qui vaut fait, priez tous vos amis, Mettez bon ordre à tout, Adieu ma chère amante.
FLEVRIE.	FLEURIE.
A dieu mon petit cœur, ie ſuis voſtre ſeruante.	À dieu mon petit cœur, je suis votre servante.
Emes, miles, toſt, toſt, deualez viſte en bas Pour venir chez les luifs, ne vous amuſez pas.	Âmes, miles, tôt, tôt, dévalez vite en bas Pour venir chez les luifs, ne vous amusez pas.
H12 SILINDE.	H12 SILINDE.
En quel lieu dites-vous?	En quel lieu dites-vous?
4 114 FLEVRIE.	4 114 FLEURIE.
Droict à la Iuifuerie Au logis de Lambert ſous la Tonnellerie:	Droit à la Juifuerie Au logis de Lambert sous la Tonnellerie:
Marchons, ie vous diray le ſuiet en allant, Que chacune de vous doit trouuer excellent.	Marchons, Seigneur vous dirai le sujet en allant, Que chacune de vous doit trouver excellent.
SCENVE III.	SCENVE III.
POLIANDRE.	POLYANDRE.
ROSELIS.	ROSELIS.
BELANGE.	BÉLANGE.
POLIANDRE.	POLYANDRE.
Auorables effets qui ſuiuez mes caprices, IQue ie ſuis redeuable à tous vos bons offices.	Avorables effets qui suivez mes caprices, IQue tu suis redevable à tous vos bons offices.
Depuis quatre ou cinq iours ie vois tous les plaiſirs Suiure les mouuemens de mes ieunes deſirs.	Depuis quatre ou cinq jours je vois tous les plaisirs Suivre les mouvements de mes jeunes désirs.
Ie ne void dans la Cour aucune Courtiſane, Soit l’agreable Armille, où la belle Diane, Qui pour gouſter l’appas de mon doux entretien A celuy des plus grands ne prefere le mien.	Je ne voit dans la Cour aucune Courtisane, Soit l'agréable Armille, où la belle Diane, Qui pour goûter l'appas de mon doux entretien À celui des plus grands ne préfère le mien.
I’ay par tout où ie vais de nouuelles maiſtreſſes L’vne aime mes diſcours & l’autre mes careſſes, Et pas vne pourtant ne ſe ſçauroit vanter D’auoir pû quatre iours mon eſprit arreſter.	J'ai par tout où je vais de nouvelles maîtresses L'une aime mes discours et l'autre mes caresses, Et pas une pourtant ne se saurait vanter D'avoir pu quatre jours mon esprit arrêter.
Les beautez de la Cour me paroiſſent fardées Bien plus facilement ie reçois les idées D’vn viſage bourgeois & d’vn œil innocent, Que d’vn, qui dans le cœur paſſe pour rauiſſant.	Les beautés de la Cour me paraissent fardées Bien plus facilement un reçois les idées D'un visage bourgeois et d'un œil innocent, Que d'un, qui dans le cœur passe pour ravissant.
Le rouge me déplaiſt auſſi bien que le plaſtre, Poliandre iamais n’en peut eſtre idolatre:	Le rouge me déplaît aussi bien que le plâtre, Poliandre jamais n'en peut être idolâtre:
Et quelques grands effets que l’amour faſſe voir Pour vaincre mon eſprit il n’a pas le pouuoir:	Et quelques grands effets que l'amour fasse voir Pour vaincre mon esprit il n'a pas le pouvoir:
Auſſi-toſt qu’amoureux ie veux la iouyſſance, Dés que le mal me tient ie cherche l’allegeance, Et I’ay tant de bon-heur en mon affection Que ie fais à l’inſtant mourir ma paſſion.	Aussitôt qu'amoureux ie veux la jouissance, Dès que le mal me tient toujours cherche l'allégeance, Et J'ai tant de bonheur en mon affection Que ie fais à l'instant mourir ma passion.
L.	L.
Voyez ſi mon plaiſit ne doit pas eſtre extréme;	Voyez si mon plaisit ne doit pas être extrême;
Roſelis que voicy n’en reçoit pas de meſme.	Roselis que voici n'en reçoit pas de même.
ROSELIS.	ROSELIS.
Monſieur, fort à propos ie vous rencontre icy, Pour tirei mon eiprit d'vn penible foucy, Bellange ce matin m’a depeſché ſon page, Pour m’apprendre vn duel où ſon honneur l’engage, A marcher pour ſecond, ſans autre paſſion, Il faut rompre ce coup par quelque inuention.	Monsieur, fort à propos je vous rencontre ici, Pour tirei mon eiprit d'un pénible fouci, Bellange ce matin m'a dépêché son page, Pour m'apprendre un duel où son honneur l'engage, À marcher pour second, sans autre passion, Il faut rompre ce coup par quelque invention.
POLIANDRE.	POLYANDRE.
On m’en a dit vn mot aujourd’huy chez la Reine, Mais croyant qu’il fuſt faux ie negligeois ma peine:	On m'en a dit un mot aujourd'hui chez la Reine, Mais croyant qu'il fût faux ie négligeais ma peine:
Toutesfois puis qu’entii le oruit le trouue vray, Il y faut donner ordre & ſans ples de delay	Toutefois puis qu'enti le oruit le trouve vrai, Il y faut donner ordre et sans ples dé lai
ROSELIS.	ROSELIS.
du di D'vne ſeule arme égale.	du di D'une seule arme égale.
2 POLIANDRE.	2 POLYANDRE.
En quel endroit ſera-ce?	En quel endroit sera-ce?
OSELIS.	OSELIS.
A la place Royale.	À la place Royale.
TANMRA EUIAII Qui ſont les combatans?	TANMRA EUIAI Qui sont les combattants?
ROSELIS.	ROSELIS.
Lt le leuns ſimnai.	Lt le leuns simnai.
Floramante, Amindor,	Floramante, Amindor,
POLIANDRE.	POLYANDRE.
EIL.	EIL.
Mais a quelle heure encor?	Mais a quelle heure encor?
ROSELIS.	ROSELIS.
Dans vne heure au plus tard ſans aucune remiſe.	Dans une heure au plus tard sans aucune remise.
U,1.	V,1.
POLIANDRE.	POLYANDRE.
AI Allons, & ſoyez leur que ie romps l’entrepriſe.	AI Allons, et soyez leur que Ne romps l'entreprise.
ENET	ENET
1u1 M.	1u1 M.
IEREMIE.	JEREMIE.
Eplorable ſoldat, Amant infortuné, 2490 LMaudit dix mille fois le iour que tu fus né, T’a langue ta trahy, ha pauure Ieremie!	Éplorable soldat, Amant infortuné, 2490 LAudit dix mille fois le jour que tu fus né, T'a langue ta trahi, ha pauvre Ieremie!
Voila donc à preſent ta maiſtreſſe ennemie;	Voilà donc à présent ta maîtresse ennemie;
Celle de qui dépend ta ioye & ton bon-heur Delaiſſe ton amour & s’arme de fureur:	Celle de qui dépend ta joie et ton bonheur Délaisse ton amour et s'arme de fureur:
La Ligue eſt vn ſuîet qu’à ta flame on oppoſe, Karolu, Karolu, vous en eſtes la cauſe.	La Ligue est un sujet qu'à ta me on oppose, Karolu, Karolu, vous en estes la cause.
Mais ſoyez aſſeuré que dés apres demain Nous nous verrons tous deux les armes à la main.	Mais soyez assuré que dès apres demain Nous nous verrons tous deux les armes à la main.
C iiij Ie ſçay que viuement vous pourſuiuez Fleurie Afin qu’auecque vous elle ſe remarie:	Ç Cijà Je sais que vivement vous poursuivez Fleurie Afin qu'avec vous elle se remarie:
Meſme que vous auez jdiſpoſé ſon eſprit A me faite donner mon congé parécrit.	Même que vous avez idisposé son esprit À me faite donner mon congé parécrit.
Mais s’il ſe paſſe rien à mon deſauantage, Vous verrez ce que peut vn homme de courage.	Mais s'il se passe rien à mon désavantage, Vous verrez ce que peut un homme de courage.
On ne me betne pas d’vne telle façon:	On ne me bétne pas d'une telle façon:
Et Karolu n’eſt pas aſſez mauuais garçon.	Et Arolu n'est pas assez mauvais garçon.
I’entends battre vn tambour, c’eſt vn Regiment Suiſſe, uga dll tad Qpeut entre dujquid naplumereaceice:	J'entends battre un tambour, c'est un Regiment Suisse, uga dll tad Qpeut entre dujquid naplumereaceice:
Pour apprendre que c’eſt il faut que i’aille voir.	Pour apprendre que c'est il faut que j'aille voir.
SCENE V.	SCÈNE V.
BELANGE.	BÉLANGE.
IEREMIE.	JEREMIE.
POLIANDRE,  ROSELIS.	POLYANDRE, ROSELIS.
ROUA	ROUA
eſte Y BELANGE.	este Y BÉLANGE.
TA Ciel, ie ſuis perdu, le Roy nous veut auoir!	TA Ciel, je suis perdu, le Roi nous veut avoir!
10Y IIly vient en perſonne, ou enuoye ſa garde:	10Y IIly vient en personne, ou envoie sa garde:
Belange où fuiras-tu, tout chacun te regarde Ietri& ſans manteau, tout tes gens t’ont quitté Sans auoir l’vn ſur l’autre aucun prix emporté;	Bélange où fuiras-tu, tout chacun te regarde Ietriet sans manteau, tout tes gens t'ont quitté Sans avoir l'un sur l'autre aucun prix emporté;
Se ſauue qui pourra, ie l’eſtimeray ſage.	Se sauve qui pourra, ie l'estimerai sage.
M.	M.
IEREMIE.	JEREMIE.
Ie n’ay rien ven du tout.	Je n'ai rien ven du tout.
10	10
BELANGE.	BÉLANGE.
10 Ie ſuis pris au paſſage, Ce vieil ſoldat attend pour me prendre au collet O	10 Je suis pris au passage, Ce vieil soldat attend pour me prendre au collet Ô
2 20 M.	2 20 M.
IERE'MIE.	JERE'MIE.
Ha, Monſieur, qu’eſt-ce-cy?	Ha, Monsieur, qu'est-ce-cy?
1U11	1U11
Hem LEDANvor.	Hem LÉDANvor.
e ſui 1 0 LL DAUO LEI2 Meſme au danger de voir ma fortune acheuée, Si par ton prompt ſecours elle ne m’eſt ſauuée.	 eût 1 0 LL DAUO LEI2 Même au danger de voir ma fortune achevée, Si par ton prompt secours elle ne m'est sauvée.
M.	M.
IEREMIE.	JEREMIE.
Que faut-il que ielfaſſe, aller droict au tombeau?	Que faut-il que jelfasse, aller droit au tombeau?
BELANGE.	BÉLANGE.
a lennqueuuerque tonchapca, Afin que déguiſé i’eſquiue la menotte.	à lennqueuuerque tonchappca, Afin que déguisé j'esquiue la menotte.
M.	M.
TEREMIE.	TEREMIE.
Oüy da, tres-volontiers.	Oui da, très-volontiers.
car i’ay ma bourguignotte Et mon bonnet de nuict attachez à mon dos, Qui pour vn tel ſuiet viennent fort à propos.	car j'ai ma bourguignotte Et mon bonnet de nuit attachez à mon dos, Qui pour un tel sujet viennent fort à propos.
ROSELIS.	ROSELIS.
O mon Dieu le bon tour !	Ô mon Dieu le bon tour !
ROSELIS.	ROSELIS.
Ne nous découurons pas	Ne nous découvrons pas
BELANGE.	BÉLANGE.
0 Sur tout gardons la priſe.	0 Sur tout gardons la prise.
dl laleEMATein M.	dl laleMATein M.
Ne marchez pas ſi fort.	Ne marchez pas si fort.
BELANGE.	BÉLANGE.
Sauuons nous viſtement.	Sauvons nous vitement.
M.	M.
IEREMIEG MCAE Ie ie connois de veue, & non pas autrement, Que ſçay-ie maintenant, ſi ce n’eſt point vn drolle Qui pour mieux m’attraper me vient ioüer ce rolle?	IEREMIEG MCAE Je ie connais de veue, et non pas autrement, Que sais-je maintenant, si ce n'est point un drolle Qui pour mieux m'attraper me vient jouer ce rolle?
Monneul anons moins vnte.	Monneul ânons moins unte.
POLIANDRE.	POLYANDRE.
Belange le déguiſe.	Bélange le déguise.
the	thé
BELANGE.	BÉLANGE.
Ha Meſſieurs ſuiuez moyt Vous ſçaurez à loiſir d’où prouient mon effroy.	Ha Messieurs suivez moit Vous saurez à loisir d'où provient mon effroi.
ROSELIS.	ROSELIS.
Toubeau frere, toubeau, pour vn moment arreſte.	Toubeau frère, toubeau, pour un moment arrête.
BELANGE.	BÉLANGE.
Voulez-vous m’arreſtant que ie perde la teſte?	Voulez-vous m'arrêtant que Ne perde la tête?
C iiij	Ç Cijà
ROSELIS.	ROSELIS.
Non, mais corter la peur dont ie te vois tranſi.	Non, mais corter la peur dont ici te vois transi.
M.	M.
IEREMIE.	JEREMIE.
Ie ne ſçay pas à quoy doit aboutir cecy:	Je ne sais pas à quoi doit aboutir ceci:
81 9 Mais voila des façons qui ne me prartent guere:	81 9 Mais voilà des façons qui ne me prartent guère:
Ie crains que ma caſaque aille voir la Fripiere.	Je crains que ma casaque aille voir la Fripière.
9 POLIANDRE.	9 POLYANDRE.
Belange, hé quoy?	Bélange, hé quoi?
la peur a gagné voſtre cœur;	la peur a gagné votre cœur;
Ce n’eſt pas le moyen de demeurer vainqueur.	Ce n'est pas le moyen de demeurer vainqueur.
Or ſus, raſſeurez vous, & croyez qu’vne feinte Aun quimne combatans a cauſe cette crainte, Le tambour n’a batu que pour l’amour de vous, Et comme auec deſſein de ſe ſaiſir dé tous.	Or sus, rassurez -vous, et croyez qu'une feinte Aun quimne combatants a cause cette crainte, Le tambour n'a battu que pour l'amour de vous, Et comme avec dessein de se saisir de tous.
ROSELIS.	ROSELIS.
Puis que la feinte a eu l'effet que l’on deſire Allons vous r’habiller pour à loiſir en rire.	Puis que la feinte a eu l'effet que l'on désire Allons vous rhabiller pour loisir en rire.
Da ui Quou3 M AEREMIE.	Da ui Quou3 M EREMIE.
Ie veux aller apres.	Je veux aller après.
11	11
BELANGE.	BÉLANGE.
*¶ FAHCIEM2N Camarade ſuy-nous	*¶ FACHIEM2N Camarade suivi-nous
110i M.	110i M.
IEREMIE.	JEREMIE.
Ie n’ay pas garde auſſi de m’éloigner de vous.	Je n'ai pas garde aussi de m'éloigner de vous.
Fin du ſecond Acte.	Fin du second Acte.
P ¶ AT Li III	 PLi IT Li III
SCENE PREMIERE.	SCÈNE PREMIÈRE.
M.	M.
KAROLV.	VAROLV.
FLEVRIE.	FLEURIE.
LE BATELIER, CLARISTE, FLORIANE, Mr MARRON, muet.	LE BATELIER, CLARISTE, FLORIANE, MAr MARON, muet.
Mr KAROLV.	Mr AROLU.
Llons chere moitié faire vne promenade.	Llons chère moitié faire une promenade.
TE TLLVRIE.	TE TLVRIE.
Filles n’oubliez-pas noſtre capilotade.	Filles n'oubliez-pas notre capilotade.
LE DAIELIER.	LE DAIELIÈR.
A Chaillot, à Chaillot, allons vn ſol chacun.	À Chaillot, à Chaillot, allons un sol chacun.
FLEVRIE.	FLEURIE.
Nous ne deſirons pas eſtre auec le commun.	Nous ne désirons pas être apprendre le commun.
Mr KAROLV.	Mr AROLU.
Nous voulons vn batteau pour noſtre compagnie.	Nous voulons un batteau pour notre compagnie.
LE BATEEIER.	LE BATEIÈR.
Monſieur en voila vn.	Monsieur en voilà un.
FLEVRIE.	FLEURIE.
Sus, ſans ceremonie, batt, Entrons, Monſieur Marron, rangeons-nous à ce coin.	Sus, sans cérémonie, batt, Entrons, Monsieur Marron, rangeons-nous à ce coin.
cout	coût
LE BATELIER.	LE BATELIER.
Auee les gens d’honneur ie ne marchande point;	Avée les gens d'honneur ici ne marchande point;
2 Pour payer ma voiture en monnoyes bien gentilles Ie me contenterois d’vne de ces trois filles:	2 Pour payer ma voiture en monnoyes bien gentilles Je me contenterais d'une de ces trois filles:
Elles ont le tein bien vif & l’œil bien ératé.	Elles ont le tein bien vif et l'œil bien ératé.
SILINDE.	SILINDE.
Vrayment ce batelier n’eſt pas trop dégouſté.	Vraiment ce batelier n'est pas trop dégoûté.
CLARISTE.	CLARISTE.
Tu n’as rien qu’à choiſir & prendre la plus belle.	Tu n'as rien qu'à choisir et prendre la plus belle.
DE DARELIEN.	DE DARELIEN.
Ne vous mocquez-vous point?	Ne vous moquez-vous point?
FLORTANE.	FLORTANE.
I’en dis autant comme ell	J'en dis autant comme elle
LE BATELIER.	LE BATELIER.
Ma mere l’autre iour filant à ſon roüet, Me diſoit qu’vne fille auoit vn beau ioüet, Et depuis ce temps-là, i’ay vne frenaiſie Qui ne ſçauroit fortir nors de ma fantane;	Ma mère l'autre jour filant à son rouet, Me disait qu'une fille avait un beau jet, Et depuis ce temps-là, j'ai une frénaisie Qui ne saurait sortir nors de ma fantane;
Ie ne dors nuict ny iour, ie me ſens tout émeu Sans que i’aye la fiévre.	Je ne dors nuit ni jour, je me sens tout ému Sans que j'aie la fièvre.
FLEVRIE.	FLEURIE.
O Ie plaiſant can	Ô Je plaisant can
Mr KAROLY.	Mr KÁROLY.
Il faut l’entretenir, il nous fera bien rire,  2311 Quana on eit amoureux c’eſt vn cruel martyre, L’eſprit inquieté ne prend point de repos, Et peu, l'occaſion ſe rencontre à propos Pour vous faire ioüir de l’objet qu’on deſire.	Il faut l'entretenir, il nous fera bien rire, 2311 Quana on eit amoureux c'est un cruel martyre, L'esprit inquiété ne prend point de repos, Et peu, l'occasion se rencontre à propos Pour vous faire jouir de l'objet qu'on désire.
LE BATÉLIER.	LE BATELIÈR.
Ie n’entends point du tout ce que rous voulez dire.	Je n'entend point du tout ce que rous voulez dire.
Mr KAROLV.	Mr AROLU.
N’as-tu iamais aymé?	N'as-tu jamais aimé?
LE BATELIER.	LE BATELIER.
Ouy, i’ayme bien l’arge	Oui, j'aime bien l'arge
Mr.	Mr.
KAROLV.	VAROLV.
O Dieux!	Ô Dieux!
que ton eſprit eſt peu intelligent!	que ton esprit est peu intelligent!
Quand ie parle d’aimer c’eſt vne creature:	Quand ici parle d'aimer c'est une créature:
LE BATELIER.	LE BATELIER.
I’auois vn petit chien de fort bonne nature 2 Qui danſoit, qui ſautoit, ie l’aimois comme moy, Et quand il fut noyé, ie pleurois, par ma fcy.	J'avais un petit chien de fort bonne nature 2 Qui dansait, qui sautait, plein l'aimais comme moi, Et quand il fut noyé, ie pleeurais, par ma fci.
FLEVRIE.	FLEURIE.
u ne repond pas bien à ce qu’on te demande.	Ou ne répond pas bien à ce qu'on te demande.
LE BATELIER.	LE BATELIER.
arlez plus clairement afin que ie l’entende.	arlez plus clairement afin que sans l'entende.
Mr KAROLV.	Mr AROLU.
anne l’des appas i’doux & ſi charmans que qui ne l’aime point vid ſans contentemens.	anne l'des appas j'doux et si charmants que qui ne l'aime point vit sans contentements.
LE BATELIER.	LE BATELIER.
a fille à voſtre conte eſt donc vne ſorciere.	a fille à votre conte est donc une sorcière.
e me ſouuiens d’vn iour que noſtre chambriere eule dans le logis me prenant au menton, eut ie penſe étranglé ſans vn coup de baſton:	Je me souviens d' iour que notre chambrière éle dans le logis me prenant au menton, eut Seigneur pense étranglé sans un coup de bâton:
que ie luy déchargeay bien ſerré ſur la teſte;	que ici ici déchargeai bien serré sur la tête;
unt qu’en s’en allant elle m'appella beſte, ourdaut, niais & ſot, que i’eſtois ſans amour, t que ie meritois de ne plus voir le iour.	unt qu'en s'en allant elle m'appela bête, ourdaut, niais et sot, que j'étais sans amour, t que on méritais de ne plus voir le jour.
FLEVRIE.	FLEURIE.
rayment c’eſtoit auſſi de trop rudes careſſes.	raiment c'était aussi de trop rudes caresses.
MILINDE.	MILINDE.
e pareils ſeruiteurs n’auroient point de maiſtreſſes.	 pareils serviteurs n'auraient point de maîtresses.
CLARISTE.	CLARISTE.
our moy ie ſçay fort bien que ie n’en voudrois pas.	our mo ie sçay fort bien que je n'en voudrais pas.
FLORIANE.	FLORIANE.
y Floriane auſſi, fuſt-il Prince icy bas.	y Floriane aussi, fût-il Prince ici bas.
FLEVRIE.	FLEURIE.
2 1 mueuilant voyez en quel endroit nous ſommes.	2 1 muvilant voyez en quel endroit nous sommes.
Mr KAROLV.	Mr AROLU.
[mes.	[mes.
my, mets-nous a bord, nous paſſons les Bons-hom	mi, mets-nous a bord, nous passons les Bonshom
FLEVRIE.	FLEURIE.
llons tous dans le bois faire noſtre feſtin.	lons tous dans le bois faire notre festin.
ien Batelier.	yen Batelier.
CLARISTE.	CLARISTE.
LE BATELIER.	LE BATELIER.
I’y vais.	J'y vais.
SILINDE.	SILINDE.
Il eſt encor matin	Il est encor matin
ENE II ROSELIS.	ENE II ROSELIS.
POLIANDRE.	POLYANDRE.
BELANGE.	BÉLANGE.
BELANGE.	BÉLANGE.
Ie croy qu’il vaudroit mieux ioüer vn coup de dez, Ou bien voir la Critique où nous ſommes mandez.	Je crois qu'il vaudrait mieux jouer un coup de dés, Ou bien voir la Critique où nous sommes mandez.
POLIANDRE.	POLYANDRE.
Pour eſtre renfermez la ſaiſon eſt trop belle, On void touſiours au Cours quelque Dame nouuelle;	Pour être renfermés la saison est trop belle, On voit tousiours au Cours quelque Dame nouvelle;
Ioint que la promenade en ce temps doux & beau Nous fait ſembler Paris eſtre vn triſte tombeau,	Joint que la promenade en ce temps doux et beau Nous fait sembler Paris te triste tombeau,
DEEAIOL.	DEAIOL.
Bien-donc, le Rendez-vous.	Bien-donc, le Rendez-vous.
ROSELIS.	ROSELIS.
Deuant les Thuilleries.	Devant les Thuilleries.
POLIANDRE.	POLYANDRE.
Dans vne heure à cheual, i’y ſuis, ſans railleries.	Dans une heure à cheval, j'y suis, sans railleries.
CENE III.	CÈNE III.
CAROLV.	CAROLV.
FLEVRIE.	FLEURIE.
SILINDE.	SILINDE.
CLARISTE.	CLARISTE.
FLORIANE.	FLORIANE.
LE BATELIER.	LE BATELIER.
IOLIANDRE.	JOLIANDRE.
RO.	RO.
SELIS.	SEIGNEUR.
BELANGE.	BÉLANGE.
Mr KAROLV.	Mr AROLU.
Amliouras-tu rien veu de plus delicieux Que la douceur de l’air & l’odeur de ces lieux?	Amliouras-tu rien vu de plus délicieux Que la douceur de l'air et l'odeur de ces lieux?
En verite ce bois eſt vn ſe our aimable.	En vérité ce bois est un se our aimable.
SILINDE.	SILINDE.
Vn de ſes tapis vers nous ſeruira de table.	Un de ses tapis vers nous servira de table.
FLEVRIE.	FLEURIE.
Choiſiſſons vn bocage où le Soleil hauſſant Re pume nous y von non pius que le paſſant.	Choisissons un bocage où le Soleil haussant Re pume nous y von non pius que le passant.
SILINDE.	SILINDE.
Apres auoir par tout fait exacte reuetë, En voila le plus beau qui parorſſe à ma veuë.	Après avoir par tout fait exacte revetée, En voilà le plus beau qui paraisse à ma vue.
Mr CAROLV.	Mr CAROLU.
Arreſtons-nous y donc, & ſans confuſion Que ron apponte ſej nontte prouinon.	Arrêtons-nous y donc, et sans confusion Que ron te sej ontte provinon.
CLARISTE.	CLARISTE.
La faim commençoit fort à me faire la guerre.	La faim commençait fort à me faire la guerre.
TLORIANE.	TLORIANE.
Voila noſtre gondolle à la place d’vn verre.	Voilà votre gondolle à la place d'H verre.
FLEVRIE.	FLEURIE.
Là, Monſieur Karolu, entamez ce paſté, Il charme l’odorat par ſa ſuauité.	Là, Monsieur Arolu, entamés ce pâté, Il charme l'odorat par sa suavité.
Mr KAROLV.	Mr AROLU.
Il eſt encor meilleur quand la langue le gouſte, L’amoureux n’a ian ais fait de ſi bonne crouſte.	Il est encor meilleur quand la langue le goûte, L'amoureux n'a jan ais fait de si bonne croûte.
FLEVRIE.	FLEURIE.
Il eſt fort excellent, là mes filles taſtez, Ioüiſſez en ce lieu de toutes priuautez.	Il est fort excellent, là mes filles tâtez, Iouissez en ce lieu de toutes privautés.
SILINDE.	SILINDE.
O ma ſœur qu’il eſt bon!	Ô ma sœur qu'il est bon!
CLARDSIE.	CLARDSIE.
Vrayment i’en ſuis rauie.	Vraiment j'en suis ravie.
FLORIANE.	FLORIANE.
Ie n’en ay point mangé de meilleur en ma vie.	Je n'en ai point mangé de meilleur en ma vie.
FLEVRIE.	FLEURIE.
Donnez au batelier.	Donnez au batelier.
Mr KAROLV.	Mr AROLU.
Amy, voila pour toy Prenez, Monſieur Marron, & puis voicy pour moy.	Ami, voilà pour toi Prenez, Monsieur Marron, et puis voici pour moi.
Comme on dit qu’il fait bon de peſcher en eau trouble, T'ay trouué dans le fonds vn morceau de gras double, Qui vaut en verité autant qu’vn perdreau.	Comme on dit qu'il fait bon de pêcher en eau trouble, T'ai trouvé dans le fond . morceau de gras double, Qui vaut en vérité autant qu'un perdreau.
FLEVRIE.	FLEURIE.
Nous auons apporte du vin auec de l’eau.	Nous avons apporte du vin auec de l'eau.
Mr KAROLV.	Mr AROLU.
Or ſus, beuuons vn coup, & ſi l’on me veux croire Ious chanterons apres vn petit air à boire.	Or sus, buons un coup, et si l'on me veux croire Jous chanterons après un petit air à boire.
FLEVRIE.	FLEURIE.
La mauque cle complette en Monſieur Karolu.	La mauque clé complète en Monsieur Alarolu.
CLARISTE.	CLARISTE.
Chantons les Tricotets, ou bien le Lanturlu.	Chantons les Tricotets, ou bien le Lenturlu.
Mr KAROLV.	Mr AROLU.
Touſiours vn air nouueau charme mieux les oreilles.	Toujours un air nouveau charme mieux les oreilles.
LE BATELIER.	LE BATELIER.
Eſcoutez-donc le mien, ie chante des merueilles.	Écoutez-donc le mien, on chante des merveilles.
AIR DV BATELIER.	AIR DU BATELIER.
C’eſt vne folle vanité Que d’eſtimer l’antiquité.	C'est une folle vanité Que d'estimer l'antiquité.
Car les murs de Babylone Ne ſont plus veus de perſonne.	Car les murs de Babylone Ne sont plus vus de personne.
Le grand Colloſſe de Rhodes Eſt cheu dans les antipodes.	Le grand Collosse de Rhodes Est cheu dans les antipodes.
Ce beau Temple de Diane, N’eſt plus rien qu’vne cabane.	Ce beau Temple de Diane, N'est plus rien qu'une cabane.
Du Phare la renommée A mis ſa gloire en fumée.	Du Phare la renommée A mis sa gloire en fumée.
Et ces grandes Pyramides Ne ſont que des places vuides.	Et ces grandes Pyramides Ne sont que des places vides.
Le ſimulacre Olympique N’eſt qu’vne triſte relique.	Le simulacre Olympique N'est qu'une triste relique.
Et ce riche Mauſolée N’eſt plus qu’vne vieille allée.	Et ce riche Mausolée N'est plus qu'une vieille allée.
Mais le vin & les bouteilles Ce font olen d’autres merueilles.	Mais le vin et les bouteilles Ce font olen d'autres merveilles.
Hé bien, qu’en dites-vous?	Hé bien, qu'en dites-vous?
i’aurois fort bonne voix Si ie ne mangeois point ny chaſteignes ny noix.	j'aurais fort bonne voix Si On ne mangeais point ni chasteignes mains noix.
Mr KAROLV.	Mr AROLU.
Ton air n’eſt pas mauuais:	Ton air n'est pas mauvais:
mais écoute le noſtre Et puis tu iugeras qu’il en vaut bien vn autre.	mais écoute le vôtre Et puis tu jugeras qu'il en vaut bien un autre.
AIR.	AIR.
Rire & chanter touſiours C’eſt vne choſe aimable:	Rire et chanter toujours C'est une chose aimable:
Mais tréue de diſcours Lors que l’on eſt à table:	Mais trêve de discours Lors que l'on est à table:
Car ces plaiſirs de vent Ne me font point d’enuie;	Car ces plaisirs de vent Ne me font point d'envie;
Boire & manger ſouuent C’eſt bien paſſer ſa vie.	Boire et manger souvent C'est bien passer sa vie.
La Muſique eſt vn bien Qui vainement me touche;	La Musique est un bien Qui vainement me touche;
Sinon quand ie n’ay rien Pour mettre dans ma bouche.	Sinon quand ici n'ai rien Pour mettre dans ma bouche.
Le ſon d’vn inſtrument, Le recit d’vne hiſtoire Me plaiſent rarement Si ce n’eſt apres boire.	Le son d'être instrument, Le récit d'une histoire Me plaisent rarement Si ce n'est après boire.
Tous les jeux où l’on voy Que l’eſprit ſe réueille, Ne gagnent rien ſur moy Quand ie tiens la bouteille.	Tous les jeux où l'on vois Que l'esprit se réveille, Ne gagnent rien sur moi Quand quelque tiens la bouteille.
Mon diuertiſſement Dépend de cette belle, Ie ſuis ſans mouuement Eſtant éloigné d’elle.	Mon divertissement Dépend de cette belle, Je suis sans mouvement Étant éloigné d'elle.
POLIANDRE.	POLYANDRE.
Page, tiens nos cheuaux à la porte du bois.	Page, tiens nos chevaux à la porte du bois.
au BELANGE.	au BÉLANGE.
un l'entenas protne de nous vi cuncert de voix.	un l'entenas protne de nous vi uncert de voix.
ROSELIS.	ROSELIS.
O Dieux ie ſuis rauy, l’excellente Muſique!	Ô Dieux ie suis ravi, l'excellente Musique!
POLIANDRE.	POLYANDRE.
du On la peut à bon droict appeller Angelique, Mon oreille iamais n’a rien ouy de plus doux.	du On la peut à bon droit appeler Angélique, Mon oreille jamais n'a rien oui de plus doux.
DEſunaa de Pour les enuiſager doucement coulons-nous.	DEsuna de Pour les envisager doucement coulons-nous.
TLEVRIE.	TLEURIE.
C’eſt aſſez de Muſique, il faut que chacun dance.	C'est assez de Musique, il faut que chacun dance.
ROSELIS.	ROSELIS.
Allons les accoſter auant que l’on commence.	Allons les accoster avant que l'on commence.
POLIANDRE.	POLYANDRE.
E teiat de ces beauter emirme meo ſentimens.	E teiat de ces beauter emirme meo sentiments.
BELANGE.	BÉLANGE.
Mon ame à leur aſpect n’a plus de mouuemens, Ie croy que ſous l’habit de ces trois bauolettes, Nous voyons de la Cour les Dames plus parfaites.	Mon âme à leur aspect n'a plus de mouvements, Je crois que sous l'habit de ces trois bavolettes, Nous voyons de la Cour les Dames plus parfaites.
ROSELIS.	ROSELIS.
rur ce uepoiſement quelque deſſein caché Nous ſera découuert.	rur ce uepoisement quelque dessein caché Nous sera découvert.
POLIANDRE.	POLYANDRE.
Ie ſuis bien empeſche A former vn ſuict poef faire ma harangue, Mercure aſſiſte moy de ta diuine langue.	Je suis bien empêche A former un sujet posef faire ma harangue, Mercure assiste moi de ta divine langue.
FLEVRIE.	FLEURIE.
Batelier viſtement, allez, retirez-vous, Il n’eſt pas de beſoin qu'on vous voye auec nous.	Batelier vite, allez, retirez-vous, Il n'est pas de besoin qu'on vous voie avec nous.
LE BATELIER.	LE BATELIER.
N’arreſtez-pas long-temps de peur qu’il ne m’ennuye	N'arrêtez-pas longtemps de peur qu'il ne m'ennuie
SILINDE.	SILINDE.
Voicy des Caualiers.	Voici des Cavaliers.
LE BATELIER SORTANT.	LE BATELIER SORTANT.
Nous aurons de la pluye.	Nous aurons de la pluie.
POLIANDRE.	POLYANDRE.
Meſſieurs excuſez-nous ſi l’importunité Nous faiſant oublier noſtte ciuilité, Force nos actions à paroiſtre inſolentes, Venans troubler l’accord de vos voix excellentes.	Messieurs excusez-nous si l'importunité Nous faisant oublier nostte civilité, Force nos actions à paraître insolentes, Venants troubler l'accord de vos voix excellentes.
Mais les rares beautez que nous voyons icy, La bonne compagnie, & la muſique auſſi Nous attirent à vous ſans autres artifices;	Mais les rares beautés que nous voyons ici, La bonne compagnie, et la musique aussi Nous attirent à vous sans autres artifices;
Sinon pour vous offrir nos tres-humbles ſeruices.	Sinon pour vous offrir nos très-humbles services.
Mr KAROLV.	Mr AROLU.
Nous vous auons, Meſſieurs, trop d’obligation:	Nous vous avons, Messieurs, trop d'obligation:
Mais vous venez trop tard pour la collation;	Mais vous venez trop tard pour la collation;
Il falloit vous haſter vn petit dauantage, Pour gouſter du paſté, du fruit & du breuuage Que l’on auoit exprés apportez en ces lieux.	Il fallait vous hâter un petit davantage, Pour goûter du pâté, du fruit et du breuage Que l'on avait exprès apportez en ces lieux.
FLEVRIE.	FLEURIE.
Filles diſcretement, gardez le ſerieux, Voila trois Caualiers de tres belle apparence.	Filles discrètement, gardez le sérieux, Voilà trois Cavaliers de très belle apparence.
RODEETO Mais, nous ne venons pas pour troubler voſtre dance Continuez, ou bien nous rebrouſſons chemin,	RODETO Mais, nous ne venons pas pour troubler votre dance Continuez, ou bien nous rebroussons chemin,
Mr KAROLV.	Mr AROLU.
Vous dancerez auſſ.	Vous dancerez aussi.
FLEVRIE.	FLEURIE.
Meſſieurs prenez la main,	Messieurs prenez la main,
42 Et pour vous mettre en train ie diray la premiete.	42 Et pour vous mettre en train ie dirai la premiète.
POLIANDRE.	POLYANDRE.
Et moy ie vous promets de dire la derniere.	Et moi ici vous promets de dire la dernière.
Chanſon de Fleurie.	Chanson de Fleurie.
I’ay bien le meilleur homme Qui ſoit dedans Paris, En tous lieux il me nomme Sa gentille Cloris.	J'ai bien le meilleur homme Qui soit dedans Paris, En tous lieux il me nomme Sa gentille Cloris.
Nous piſſons dans meſme pot, Nous nous baiſons à gogo, Nous chantons tan-tffe-li ra-lire Sans iamais nous dire mot.	Nous pissons dans même pot, Nous nous baisons à gogo, Nous chantons tan-tffe-li ra-lire Sans jamais nous dire mot.
Touſiours l’vn contre l’autre L’on void nos deux mentons, Et louuent nl te vcautre Deſſus mes blancs tetons.	Toujours l'un contre l'autre L'on voit nos deux mentons, Et lament nl te vécautre Dessus mes blancs tétons.
Nous piſſons, &c.	Nous pissons, etc.
Il décrote mes chauſſes, Mia cotte & mon pmron, Et fait de bonnes ſauſſes Tant à chair qu’à poiſſon.	Il décrote mes chausses, Mia cotte et mon penron, Et fait de bonnes sausses Tant à chair qu'à poisson.
Nous piſſons, &c.	Nous pissons, etc.
Tout le ménage il range Le ſoir & le matin, Et ſi ne boid ne mange Que quand ie n’ay plus faim.	Tout le ménage il range Le soir et le matin, Et si ne boyd ne mange Que quand quelque n'ai plus faim.
Nous piſſons, &c.	Nous pissons, etc.
BELANGE.	BÉLANGE.
L'excellente chanſon, que l'ait eit rauiſſant.	L'excellente chanson, que l'ait eit ravissant.
Mr KAROLV.	Mr AROLU.
oila comme l’on prend vn plaiſit innocent.	oilà comme l'on prend un plaisit innocent.
FLEVRIE.	FLEURIE.
Ne vous en moquez-pas, Clarille, dit la tienne Elle vaut pour le moins autant comme la mienne,	Ne vous en moquez-pas, Clarille, dit la tienne Elle vaut pour le moins autant comme la mienne,
CLARISTE.	CLARISTE.
a iinume queique peu m'empeiene de cnanter, Et ſi ie vous la dis c’eſt pour vous contenter.	a jinume queique peu m'empeiene de cnanter, Et si je vous la dis c'est pour vous contenter.
Chanſon de Clariſte.	Chanson de Clariste.
Que ſert de me prier de vous aimer Siluie?	Que sert de me prier de vous aimer Silvie?
Mon ame en verité n’en euſt iamais d’enuie:	Mon âme en vérité n'en eût jamais d'envie:
Ie ſçay bien que vos yeux ont de charmans appas, Mais ſur tout vous aimez, & moy ie n’aime pas A quoy ſeruent ces pleurs alors que l’on me baiſe?	Je sais bien que vos yeux ont de charmants appas, Mais sur tout vous aimés, et mo ie n'aime pas Aleurs servent ces pleurs alors que l'on me baise?
C’eſt ierter beaucoup d’eau deſſus vn peu de braiſe.	C'est jerter beaucoup d'eau dessus un peu de braise.
Ie ſçay bien que vos yeux, &c.	Je sais bien que vos yeux, etc.
A quoy bon ces ſoûpirs qui ſortent de voſtre ame, C’eſt du vent qui d’ameur veut éteindre ma flame:	À quoi bon ces soupirs qui sortent de votre âme, C'est du vent qui d'ameur veut éteindre ma flamme:
Ie ſçay bien que vos yeux, &c.	Je sais bien que vos yeux, etc.
ROSELIS.	ROSELIS.
Dicux, ia Donne cuanton.	Dicux, ja Donne cuanton.
POLIANDRE.	POLYANDRE.
Ie confeſſe à cetre heure Que ie n’en ay iamais entendu de meilleure.	Je confesse à cetre heure Que tu n'en ai jamais entendu de meilleure.
BELANGE.	BÉLANGE.
Ces Dames que voicy n’en diront elles pas?	Ces Dames que voici n'en diront elles pas?
RaE vRIE.	RaE vRIE.
Le temps nous preſſe trop, il faut doubler le pas;	Le temps nous presse trop, il faut doubler le pas;
Dites viſte la voſtre, & puis dans le cartoſſe, Nous allons remonter pour eſtre à vne nopce, Où nous ſommes ce ſoir obligez d’aſſiſter.	Dites vite la vôtre, et puis que le quartosse, Nous allons remonter pour être à une noce, Où nous sommes ce soir obligez d'assister.
POLIANDRE.	POLYANDRE.
Et bien, pour ootu iuui duuuiſues chanter.	Et bien, pour ootu iuui duuuisues chanter.
Chanſon de Poliandre.	Chanson de Poliandre.
Les loix que l’amour nous donne Ont de ſi charmans appas, Que qui ne les gouſte pas Me doit iamais voir perſonne:	Les lois que l'amour nous donne Ont de si charmants appas, Que qui ne les goûte pas Me doit jamais voir personne:
Pour obeir à l’amour Que chacun bane e'lontour.	Pour obéir à l'amour Que chacun bane elontour.
Cette ordonnance eſt ſi belle Que l’amant n’eſt pas courtois Qui ne la ſuit qu’vne fois Eſtant aupres ſa fidelle:	Cette ordonnance est si belle Que l'amant n'est pas courtois Qui ne la suit qu'une fois Étant auprès sa fidèle:
Pour obeir, &c.	Pour obéir, etc.
C’eſt contre luy faire vn crime, Puis que ce Dieu des Amans Veut qu’on baiſe à tous momens Pour ſon nom mettre en eſtime:	C'est contre deux faire un crime, Puis que ce Dieu des Amants Veut qu'on baise à tous moments Pour son nom mettre en estime:
Pour obeir, &c.	Pour obéir, etc.
FLEVRIE.	FLEURIE.
O ma fille, apres luy, il a tiré l’eſchelle!	Ô ma fille, après lui, il a tiré l'échelle!
La tienne maintenant ne me ſemble plus belle, S’il eſt auſſi courtois qu’il eſt prompt à baiſer, Autant de la chanton ſ'ne peut refuſer.	La tienne maintenant ne me semble plus belle, S'il est aussi courtois qu'il est prompt à baiser, Autant de la chanton s'ne peut refuser.
POLIANDRE.	POLYANDRE.
Cette obligation me ſemble trop petite Pour ſeruir des ſuiets de ſi rare merite,	Cette obligation me semble trop petite Pour servir des sujets de si rare mérite,
Mr KAROLV.	Mr AROLU.
C’eſt aſſez pour ce coup.	C'est assez pour ce coup.
POLIANDRE.	POLYANDRE.
Dites nous s’il vous plaiſt Le nom de voſtre Hoitei.	Dites nous s'il vous plaît Le nom de votre Hoitei.
Mr KAROLV.	Mr AROLU.
Au milieu du mareſt Demandez Karolu, c’eſt ainſi qu’on me nomme, On vous l’enſeignera.	Au milieu du marest Demandez Karolu, est ainsi on me nomme, On vous enseignera.
ROSELIS.	ROSELIS.
Vous eſtes vn braue homme Nous ne manquerons pas de nous donner l’honneu D'aller vous viſiter.	Vous êtes un brave homme Nous ne manquerons pas de nous donner l'honnu D'aller vous visiter.
Mr KAROLV.	Mr AROLU.
Ce nous ſera fau	Ce nous sera fau
ROSELIS, Cependant permettez que noſtre main vous meine Iuſqu’a voſtre carroſſe.	ROSELIS, Cependant permettez que notre main vous mène Jusqu'a votre carrosse.
FLEVRIE.	FLEURIE.
Ha!	Ha!
ſeroit trop de peine.	serait trop de peine.
Bien qu’vn méchant habit nous couure par effet, Ivous n'aouierons pas de l'honneur qu’on nous fait;	Bien qu'un méchant habit nous couvre par effet, Ivous n'aouierons pas de l'honneur qu'on nous fait;
Demeurez donc, Monſieur, auecques voſtre ſuitte.	Demeurez donc, Monsieur, avec votre suitte.
POLIANDRE.	POLYANDRE.
Ie baiſeray ſes mains auant que ie les quitte.	Je baiserai ses mains avant que ici les quitte.
SILINDE.	SILINDE.
Monſieurmamereir, ous rousmecmhodez.	Monsieurmamereir, ous rousmecmhodez.
POLIANDRE.	POLYANDRE.
Ie le veux, puis qu’ainſi vous me le commandez.	Je le veux, puis qu'ainsi vous me le commandez.
ROSELIS.	ROSELIS.
Madame, obligez-moy, cependant notre abſence D’auoir de Roſelis quelquesfois ſouuenance.	Madame, obligez-moi, cependant notre absence D'avoir de Roselis quelquefois souvenance.
CLARISIE.	CLARISIE.
Si ie vous puis ſeruir, par ce doux ſouuenir Croyez qu’il me viendra ſouuent entretenir.	Si ici vous puis servir, par ce doux souvenir Croyez qu'il me viendra souvent entretenir.
BELANGE.	BÉLANGE.
Madame, abſent de vous, Belange ne peut viure, S’il vous quitte de l’œil ſon eſprit vous veut ſuiure.	Madame, absent de vous, Bélange ne peut vivre, S'il vous quitte de l'œil son esprit vous veut suivre.
Bref, ſon bien ne dépend que de voſtre amitié.	Bref, son bien ne dépend que de votre amitié.
FLORIANE.	FLORIANE.
Peut-eſtre quelque iour en auray-ie pitié.	Peut-être quelque jour en aurai-je pitié.
FLEVRIE.	FLEURIE.
Bon ſoir, Meſſieurs, boutoii	Bon soir, Messieurs, boutoyi
FLORIANE.	FLORIANE.
I’ay des cartes ma mere.	J'ai des cartes ma mère.
FLEVRIE.	FLEURIE.
Tant mieux, dans le batteau, c’eſt pour ioüer vn here.	Tant mieux, dans le batteau, c'est pour jouer un hère.
Toutesfois il fait beau.	Toutefois il fait beau.
Mr KAROLV.	Mr AROLU.
Il ne faut craindre rien	Il ne faut craindre rien
FLEVRIE.	FLEURIE.
D’icy iuſques à Paris ie marcheray fort bien, Allons y doucement, c’eſt autant d’exercice.	D'ici jusques à Paris ie marcherai fort bien, Allons y doucement, c'est autant d'exercice.
Mr KAROLV.	Mr AROLU.
Ma faſſitude aum vous fera prejudice, I’ay bien peur que ce ſoir ie ne couche auec vous	Ma fassitude aum vous fera préjudice, J'ai bien peur que ce soir apprendre ne couche après vous
FLEVRIE.	FLEURIE.
Allons, allons cauſeur, ne faites pas le fou.	Allons, allons causeur, ne faites pas le fou.
Mr KAROLV.	Mr AROLU.
Et noſtre batelier on payra de la ſorte?	Et notre batelier on payra on la sorte?
TLEVRIE.	TLEURIE.
Ce bon Monſieur Marron loge contre ſa porte, Il nous obligera de luy porter l’argent.	Ce bon Monsieur Marron loge contre sa porte, Il nous obligera de lui porter l'argent.
Mr KAROLV.	Mr AROLU.
Allons, ie ne crains pas qu’il m’enuoye vn Sergent:	Allons, Seigneur ne crains pas qu'il m'envoie un Sergent:
Mais le pauure garçon aura beau nous attendre.	Mais le pauvre garçon aura beau nous attendre.
Il croira qu’on aura ſon gouſté voulu vendre.	Il croira qu'on aura son goûté voulu vendre.
JCLNLI	JCLNLI
LE BATELIER.	LE BATELIER.
Ncore que le iour commence à decliner, L le ne vois point mes gens deuers moy cheminet Ils n’apprehendent point de mauuaiſe fortune:	Ncore que le jour commence à décliner, L le ne vois point mes gens devers moi cheminet Ils n'appréhendent point de mauvaise fortune:
S’ils s’en eſtoient allez que i’en aurois bien d’vne, Ie ſerois bien payé de ma peine aujourd’huy, Iamais ie ne mettrois ma fiance en autruy, Touſiours argent contant auant que ie demare.	S'ils s'en étaient allés que j'en aurais bien d'une, Je serais bien payé de ma peine aujourd'hui, Jamais personne ne mettrais ma fiance en autrui, Tousiours ance en aut que ie demare.
Le monde maintenant me ſemble bien auare, Pour auoir beu deux coups, mangeant des reliquas Vn Loüis de trente ſols payera mon repas.	Le monde maintenant me semble bien avare, Pour avoir bu deux coups, mangeant des reliquas Ven Loüis de trente sols payera mon repas.
C’eſt vendre vn peu trop cher vne telle denrée:	C'est vendre un peu trop cher une telle denrée:
La campagne n’eſt plus du Soleil éclairée, Il s’en va toute nuict, ha ie ſuis attrapé!	La campagne n'est plus du Soleil éclairée, Il s'en va toute nuit, ha a suis attrapé!
Ils ont heureuſement de mes mains échapé.	Ils ont heureusement de mes mains échappé.
Que l’on void de méchans dans le temps où nous ſommes, Il faut que mon batteau ie remene aux Bons-hommes:	Que l'on voit de méchants dans le temps où nous sommes, Il faut que mon batteau toujours remène aux Bonshommes:
Peut-eſtre en m’en allant trouueray-ie quelqu’vn, A Paris, à Paris, allons vn ſol chacun.	Peut-être en m'en allant trouverai-je quelqu'un, À Paris, à Paris, allons un sol chacun.
SCENE V.	SCÈNE V.
BELANGE.	BÉLANGE.
POLIANDRE.	POLYANDRE.
ROSELIS.	ROSELIS.
BELANGE.	BÉLANGE.
E me le celez plus.	E me le celez plus.
POLIANDRE.	POLYANDRE.
Ie confeſſe Belange Que ie ſens dans mon ame vn mouuement étrange;	Je confesse Bélange Que ainsi sens dans mon âme un mouvement étrange;
L’amour iuſqu’aujourd’huy cedant à mes deſirs Vla pas eu le pouuoir de troubler mes plaiſirs.	L'amour jusqu'aujourd'hui cédant à mes désirs Vla pas eu le pouvoir de troubler mes plaisirs.
Mais depuis que Silinde a fait voir ſon viſage Auſſi beau qu’vn Soleil au ſortir d’vn nuage, La glace que mon cœur conſeruoit là dedans A perdu ſa froideur par diuers accidens.	Mais depuis que Silinde a fait voir son visage Aussi beau qu'un Soleil au sortir d'un nuage, La glace que mon cœur conservait là dedans À perdu sa froideur par divers accidents.
Mes deux yeux ont porté la chaleur dans mon ame, jes belles actions ont allumé la flame, Mon eſprit s’eſt flaté d’vn vain contentement, Et l’eſpoir a charmé mon diuertiſſement.	Mes deux yeux ont porté la chaleur dans mon âme, jes belles actions ont allumé la flamme, Mon esprit s'est flatté d'un vain contentement, Et l'espoir a charmé mon divertissement.
Mais puis que ie vous dis mon ſecret veritable, De me dire le voſtre il eſt bien raiſonnable.	Mais puis que je vous dis mon secret véritable, De me dire le vôtre il est bien raisonnable.
Confeſſez librement que Floriane auſſi I mis dans voſtre eſprit vnſemblable foucy.	Confessez librement que Floriane aussi I mis dans votre esprit mansemblable foucy.
Et Roſeſis apres auouëra que Clariſte, Luy a fait oublier ſa bergere Floriſte.	Et Rosesis après avouera que Clariste, Lui a fait oublier sa bergère Floriste.
BELANGE.	BÉLANGE.
De quoy me ſeruiroit de vous diſſimuler, Mes yeux trop clairement vous l’ont dit ſans parles.	De quoi me servirait de vous dissimuler, Mes yeux trop clairement vous l'ont dit sans parles.
Ie diray franchement que iamais nulle Dame N’a tant qu’elle gaigné de pouuoir ſur mon ame:	Je dirai franchement que jamais nulle Dame N'a tant qu'elle gagné de pouvoir sur mon âme:
Et puis que ie la vois ſortable a mon humeur, Ie defire l’auoir par les degrez d’honneur.	Et puis que ici la vois sortable a mon humeur, Je désire l'avoir par les degrés d'honneur.
ROSELIS.	ROSELIS.
Vne ſimple Bergere eſt plus qu’vne Princeſſe, Alors que la vertu s’eſt iointe à ſa baſſeſſe;	Une simple Bergère est plus qu'une Princesse, Alors que la vertu s'est jointe à sa bassesse;
Auſſi ma qualité qui flate mes eſprits Par l’eſpoir d’épouſer vne Dame de prix, Portoit mon iugement à quelque repugnance, Contre le plus bel œil qui ſoit dedans la France.	Aussi ma qualité qui flatte mes esprits Par l'espoir d'épouser une Dame de prix, Portait mon jugement à quelque répugnance, Contre le plus bel œil qui soit dedans la France.
Clariſte c’eſt le tien, dont l’extreme beauté Triomphe maintenant deſſus la vanité:	Clariste c'est le tien, dont l'extrême beauté Triomphe maintenant dessus la vanité:
Toutes tes actions luy ſont de qurs fartyres:	Toutes tes actions lui sont de qurs fartyres:
Elle void tes vertus au deſſus des Empires, Elle void dans tes feux les ſiens enſeuens:	Elle voit tes vertus au dessus des Empires, Elle voit dans tes feux les siens ensevens:
Bref, elle ne retient plus le cœur de Roſelis.	Bref, elle ne retient plus le cœur de Roselis.
POLIANDRE.	POLYANDRE.
Eitrange enret d'amour, admirable rencontre.	Étrange enret d'amour, admirable rencontre.
BELANGE.	BÉLANGE.
Pourueu qu’à nos deſſeins fauorable il ſe monſtre, Et que nos chers objects bruſſent de meſmes feux, Il aura fait ce iour ſix parfaits amoureux.	Pourvu qu'à nos desseins favorable il se montre, Et que nos chers objects brussent de mêmes feux, Il aura fait ce jour six parfaits amoureux.
POLIANDRE.	POLYANDRE.
Auiſons entre nous au moyen ſalutaire l faut pour ſagement conduire cette affaire.	Avisons entre nous au moyen salutaire l faut pour sagement conduire cette affaire.
ROSELIS.	ROSELIS.
Pour l’acheminement de cét heureux project, La chanſon à danſer ſeruira de ſuiet;	Pour l'acheminement de cet heureux project, La chanson à dans servira de sujet;
L’entrée de leur logis nous eſt deja permiſe, En leur allant porter voſtre chanſon promiſe, Et Belange auec moy vous accompagnera;	L'entrée de leur logis nous est déjà permise, En leur allant porter votre chanson promise, Et Bélange avec moi vous accompagnera;
Ainſi chacun de nous ſa maiſtreſſe verra.	Ainsi chacun de nous sa maîtresse verra.
POLIANDRE.	POLYANDRE.
Il faut s’apriuoiſer, & frequenter chez elles, Ie croy que c’eſt leur bien qui les fait Damoiſelles?	Il faut s'apriuoiser, et fréquenter chez elles, Je crois que c'est leur bien qui les fait Damoiselles?
Mais n’importe, chacune a des perfections Qui teleuent l’eſtat de leurs extractions.	Mais n'importe, chacune a des perfections Qui telèvent l'état de leurs extractions.
rortons-la nos deſſeins, & fa ſons voir au monde Que c’eſt ſur la vertu que noſtre eſprit ſe fonde.	rortons-la nos desseins, et fa sons voir au monde Que c'est sur la vertu que notre esprit se fonde.
BELANGE.	BÉLANGE.
Il faut noſtre viſite executer demain, Si le Roy ne va point coucher à ſaint Germain.	Il faut notre visite exécuter demain, Si le Roi ne va point coucher à saint Germain.
POLIANDRE.	POLYANDRE.
Sans doute il n’y va pas, car l’on tient chez la Reine Le voyage remis iulqu'a l’autre ſemaine.	Sans doute il n'y va pas, car l'on tient chez la Reine Le voyage remis jusqu'a l'autre semaine.
ROSELIS.	ROSELIS.
Le pluſtoſt vaut bien mieux de crainte d'vn riual,	Le plutôt vaut bien mieux de crainte d'un rival,
POLIANDRE.	POLYANDRE.
Allons-nous en tous trois remonter à cheual, Eu nous en retournant nous penſerons au reſte	Allons-nous en tous trois remonter à cheval, Eu nous en retournant nous penserons au reste
BELANGE.	BÉLANGE.
Pour moy ie ne croy pas qu’aucun me la conteſte.	Pour moi ici ne crois pas qu'aucun me la conteste.
ae  MAISTRE IEREMIE, KAROLV.	ae MAÎTRE JÉREMIE, KAROLV.
FLEVRIE.	FLEURIE.
Les aſſiſtans au Chariuaris.	Les assistants au Chariuaris.
M.	M.
IEREMIE, & ſes camarades.	JEREMIE, et ses camarades.
Areil à ſes hiboux qui ne vont que de nuit, Ie n’oſerois paroiſtre où le Soleil me luit.	Arreil à ses hiboux qui ne vont que de nuit, Je n'oserais paraître où le Soleil me luit.
Apres le mauuais tour que m’a ioüé Fleurie Il faut que ma raiſon cedant à ma furie,	Après le mauvais tour que m'a joué Fleurie Il faut que ma raison cédant à ma furie,
Pour vanger cét affront faſſe vn chariuaris, Dont iamais on ait fait le ſemblable à Paris.	Pour venger cet affront fasse un chariuaris, Dont jamais on ait fait le semblable à Paris.
Ie n’oſe me monſtrer où la gloire m’appelle, Qu’à l’inſtant mes amis ne m’entretiennent d’elle?	Je n'ose me montrer où la gloire m'appelle, Qu'à l'instant mes amis ne m'entretiennent d'elle?
L’vn dit que Karolu ſeul a cauſé ce mal, Qu’il a ſurpris l’eſprit de ce ſot animal;	L'un dit que Œarolu seul a causé ce mal, Qu'il a surpris l'esprit de ce sot animal;
Que ie meritois bien d’auoir la preference.	Que Elle méritais bien d'avoir la préférence.
L’autre s’offre ſecond ſi i’en veux la vengeance.	L'autre s'offre second si j'en veux la vengeance.
Enfin chacun pour moy veut porter le cartel, Et iuſques dans le ſein donner le coup mortel.	Enfin chacun pour moi veut porter le cartel, Et jusques dans le sein donner le coup mortel.
I’ay dans mon regiment quatre cent camarades, Qui s’en iroient chez luy faire mil algarades Deſſous l’authorité de mon conſentement:	J'ai dans mon régiment quatre cent camarades, Qui s'en iraient chez lui faire mil algarades Dessous l'autorité de mon consentement:
Mais i’ay trop de courage & trop de iugement;	Mais j'ai trop de courage et trop de jugement;
Ie ne veux point meſler perſonne en ma querelle, I’ay la force à la main & la raiſon pour elle;	Je ne veux point mêler personne en ma querelle, J'ai la force à la main et la raison pour elle;
Ioint qu’on m’accuſeroit d’vn crime d’aſſaſſin.	Joint qu'on m'accuserait d'un crime d'assassin.
Pourſuiuons ſeulement noſtre premier deſſein.	Poursuivons seulement notre premier dessein.
Or ſus donc, mes enfans, hardiment que l’on ſonne, Faiſons vn ſi grand bruit que Paris s’en eſtonne:	Or sus donc, mes enfants, hardiment que l'on sonne, Faisons un si grand bruit que Paris s'en étonne:
Faiſons que la rumeur de tous ces inſtrumens Aille auecque frayeur réueiller ces Amaus:	Faisons que la rumeur de tous ces instruments Aille auecque frayeur rueiller ces Amaus:
Mais à mon premier cry qu’auſſi-toſt chacun ceſſe:	Mais à mon premier cri qu'aussitôt chacun cesse:
C’a voila la maiſon, frappons, le temps nous preſſe.	C'a voilà la maison, frappons, le temps nous presse.
Ils font le Chariuaris, puis Ieremie dit:	Ils font le Chariaris, puis Jérémie dit:
Or écoutez petits & grands, d ut quaujuia nay dame Picalia A Karolu ſe remarie, Mrage de luraunte ce quinde alis;	Or écoutez petits et grands, d' ut quaujà né dame Picalia A Karolu se remarie, Mrage de luraunte ce quinde alis;
S’il ne luy peut faire d’enfans Ie ſuis bien d’auis qu’il m’en prie.	S'il ne ç rois faire d'enfants Ie qu' en fants il m'en prie.
Ils recommencent le Chariuaris, & Mr Karelu paroiſt à la feneſtre diſant:	Ils recommencent le Chariuaris, et Mr Arelu paraît à la fenêtre disant:
Qui ſont ces inſolens parlans ainſi la bas?	Qui sont ces insolents parlants ainsi la bas?
Sus, ſus, ma halebarde a uec mon couſtelas.	Sus, sus, ma halebarde a ec mon coûtelas.
COMEDIE.	COMÉDIE.
Mon piſtolet, mon caſque, allez ouurir la porte, Des pierres viſtement, depeſchons que ie ſorte.	Mon pistolet, mon casque, allez ouvrir la porte, Des pierres vitement, dépêchons que femme sorte.
FLEVRIE.	FLEURIE.
Ha Monſieur Karolu, vous ne ſortirez pas!	Ha Monsieur Arvolu, vous ne sortirez pas!
aul ll nlas vi Aux voleurs, aux voleurs.	aul as nlas vi Aux voleurs, aux voleurs.
M.	M.
IEREMIE.	JEREMIE.
Retournons ſur nos pas, De peur que la commune à preſent éueillée Ne nous vienne engager dedans vne meſlée,	Retournons sur nos pas, De peur que la commune à présent éveillée Ne nous vienne engager dedans une mêlée,
Mr.	Mr.
KAROLV.	VAROLV.
l veaniaurj pencatds:	l veaniaurais pencatds:
FLEVRIE.	FLEURIE.
Ie les aſſommeray.	Je les assommerai.
Mr KAROLV.	Mr AROLU.
Ie n’entends plus de bruit, chacun s’eſt retiré.	Je n'entends plus de bruit, chacun s'est retiré.
Que nous auons icy vn pauure voiſinage, Aucun n’a pas monſtré ſeulement ſon viſage.	Que nous avons ici un pauvre voisinage, Aucun n'a pas montré seulement son visage.
ELENRIL C’eſt parce qu’à la nopce ils n’ont eſté mandez.	ÉLENRIL C'est parce qu'à la noce ils n'ont été mandés.
Mr NAROLV.	Mr NAROLU.
Allons nous recoucher.	Allons nous recoucher.
FLEVRIE.	FLEURIE.
Ie vous prie attendez.	Je vous prie attendez.
M AnRoln Depeſchons viſtement.	M AnRoln Dépêchons vitement.
FLEVRIE.	FLEURIE.
Ie crains que ces beliſtres Ne reuiennent bien toſt caſſer toutes nos viſtres.	Je crains que ces bélîtres Ne reviennent bien tôt casser toutes nos vôtres.
Mr CAROLV.	Mr CAROLU.
Maudits ſoient les maraux, ſans ce bruit ſuruenu, I’aurois déja baſty vn petit Karolu, Mais ie m’eu vangeray, la choſe eſt tres-certaine, Et Maiſtre Ieremie en portera la peine.	Maudits soient les maraux, sans ce bruit survenu, J'aurais déjà bâti un petit Arolu, Mais On m'eu vengerai, la chose est très -certaine, Et Maître Jérémie en portera la peine.
Fin du troiſiéme Acte.	Fin du troisième Acte.
A C TE I	À Ç TE I
SCENE PREMIERE.	SCÈNE PREMIÈRE.
CLARISTE.	CLARISTE.
Vre neceſſité contraire à mon bon-heur, DQue vous tyranniſez le reſpect & l’honneur.	Vre nécessité contraire à mon bonheur, DQue vous tyrannisez le respect et l'honneur.
Le mortel captiué ſous voſtre triſte empire, N’oſe ouurir à ſon cœur ce que l’eſprit deſire, Le reſpect eſt à bas, & la grandeur le fuit, L’homme neceſſiteux void la peur qui le ſuit, Mil apprehenſions cherchent le miſerable, Alors qu’il veut cacher ſon eſtat deplorable, La triſteſſe eſt ſa mere, & ſon pere vn regret De n’oſer découurir à chacun ſon ſecret.	Le mortel captivé sous votre triste empire, N'ose ouvrir à son cœur ce que l'esprit désire, Le respect est à bas, et la grandeur le fuit, L'homme nécessiteux voit la peur qui le suit, Mil appréhensions cherchent le misérable, Alors qu'il veut cacher son état déplorable, La tristesse est sa mère, et son pereait regret De n'oser découvrir à chacun son secret.
Ce n’eſt pas ſans raiſon que ie tiens ce langage, On me fait prendre icy ce gentil equipage.	Ce n'est pas sans raison que ie tiens ce langage, On me fait prendre ici ce gentil équipage.
Et cependant mes ſœurs auſſi bien comme moy Pour aſpirer ſi haut n’ont pas aſſez dequoy.	Et cependant mes sœurs aussi bien comme moi Pour aspirer si haut n'ont pas assez dequoy.
Nous ne ſommes pourtant qu’enfans d’obeiſſance, Noſtre felicité dépend de l’eſperance.	Nous ne sommes pourtant qu'enfants d'obéissance, Notre félicité dépend de l'espérance.
Si le Ciel qui peut tout a pour nous de l’amour L’eſpoir que nous auons peut arriuer vn iour.	Si le Ciel qui peut tout à pour nous de l'amour L'espoir que nous avons peut arriver un jour.
C’eſt donc à luy qu’il faut faire noſtre priere, Suiuant le ſentiment de noſtre bonne mere, Afin que les effets fauoriſans nos vœux Donnent à nos deſſeins des ſuccez bien-heureux.	C'est donc à peine qu'il faut faire notre prière, Suivant le sentiment de notre bonne -mère, Afin que les effets favorisants nos vœux Donnent à nos desseins des succès bienheureux.
Helas!	Hélas!
ſi Roſelis ſçauoit combien ie l’aime, Combien pour le ſeruir mon delir eſt extreme;	si Roselis Savait combien Prince l'aime, Combien pour le servir mon délir est extrême;
Sans doute ſa raiſon me voudroit preferer A tontes les beautez qu’il pourroit adorer.	Sans doute sa raison me voudrait préférer A tontes les beautés qu'il pourrait adorer.
Mais qui l’aſſeurera de mon obeiſſance, Si ce n’eſt mon ſeruice auec ma bien-veillance?	Mais qui l'assurera de mon obéissance, Si ce n'est mon service avec ma bienveillance?
Aucun autre en effet ne luy peut témoigner:	Aucun autre en effet ne te peut témoigner:
S’il vient nous viſiter ſera beaucoup gaigner:	S'il vient nous visiter sera beaucoup gagner:
Mais i’apprehende fort que la chanſon promiſe Nous faſſe long-temps voir leur viſite remiſe.	Mais j'appréhende fort que la chanson promise Nous fasse longtemps voir leur visite remise.
Pourtant ſi ces Meſſieurs l’executent ce iour, C’eſt vn ſigne certain qu’ils ſont touchez d’amour, Laiſſons-en la conduite à la bonne fortune.	Pourtant si ces Messieurs l'exécutent ce jour, C'est un signe certain qu'ils sont touchés d'amour, Laissons-en la conduite à la bonne fortune.
O mon Dieu, qu’à preſent Silinde m’importune!	Ô mon Dieu, qu'à présent Silinde m'importune!
SILINDE.	SILINDE.
Ma ſœur, tu ne ſçay pas vn ſecret important;	Ma sœur, tu ne sais pas un secret important;
Floriane aujourd’huy n’a point l’eſprit contant belaiige alſeurement luy donne dans la veue;	Floriane aujourd'hui n'a point l'esprit contant belige alsurement lui donne dans la vue;
Contre ſon naturel ie la vois toute émeuë, Triſte, penſiue:	Contre son naturel ie la vois toute émue, Triste, pensive:
Enfin c’eſt vn grand changement,	Enfin c'est un grandement changement,
CLARISTE.	CLARISTE.
Ilf aut donc confeſſer qu’elle eſt ſans iugement, Veu l’inegalité de l’vn auecque l’autre.	Ilf aut donc confesser qu'elle est sans jugement, Veu l'inégalité de l'un auecque l'autre.
SILINDE.	SILINDE.
Pourquoy?	Pourquoi?
mon ſentiment eſt donc contraire au voſtre, Floriane eſt gentille, & Belange a du bien.	mon sentiment est donc contraire au vôtre, Floriane est gentille, et Bélange a du bien.
CLARISTE.	CLARISTE.
La beauté maintenant eſt vn foible moy ei Il faut que les richeſſes accompagne les belles, Ou bien en ce temps-cy point de partis pour elles, Le plus triſte vilage en parlant contre moy, Eſt autant eſtimé pourueu qu’il ait dequoy.	La beauté maintenant est un faible moi ei Il faut que les richesses accompagne les belles, Ou bien en ce temps-cy point de partis pour elles, Le plus triste vilage en parlant contre moi, Est autant estimé pourvu qu'il ait dequoy.
SILINDE.	SILINDE.
La vertu toutefois merite quelque choſe,	La vertu toutefois mérite quelque chose,
CLARISTE.	CLARISTE.
C’eſt vn grand argument que ton eſprit propoſe, Dont l’explication trop longue à mon auis, Me fera couper court pour changer de deuis.	C'est un grand argument que ton esprit propose, Dont l'explication trop longue à mon avis, Me fera couper court pour changer de uis.
SILINDE.	SILINDE.
Dit ce qu’il te plaira, mais neantmoins confeſſe, Qu’apres vne beauté l’on vor tonnouis la preſſe;	Dit ce qu'il te plaira, mais néanmoins confesse, Qu'après une beauté l'on vor tonnouis la presse;
Elle a cent ſeruiteurs, contre vne laide deux.	Elle a cent serviteurs, contre une laide deux.
CLARISTE.	CLARISTE.
Iu t'engages, ma fœur, dans vn plege hazardeux, Tu ſouſtiens les beautez à cauſe de la tienne.	Ju t'engages, ma fœur, dans un plee hasardeux, Tu soutiens les beautés à cause de la tienne.
SILINDE.	SILINDE.
Helas!	Hélas!
en verité ie ne penſe à la mienne, C’eſt vn trop bas ſuiet pour nous entretenir.	en vérité ie ne pense à la mienne, C'est un trop bas sujet pour nous entretenir.
CLARISTE.	CLARISTE.
A queiqu' autre denem tu veux doncques venir.	À queiqu' autre denem tu veux donc venir.
Ton parler d’action, & ton cœur qui ſouſpire Cache quelque lecret que tu ne veux pas dire.	Ton parler d'action, et ton cœur qui soupire Cache quelque lecret que tu ne veux pas dire.
SILINDE.	SILINDE.
Point du tout, ſans mentir.	Point du tout, sans mentir.
CLARISTE.	CLARISTE.
Dit ce que lu voudras:	Dit ce que lu voudras:
Mais vn ſoupçon conceu tu ne m’oſtera pas.	Mais un soupçon conçu tu ne m'ôtera pas.
Quel?	Quel?
SILINDE.	SILINDE.
CLARISTE.	CLARISTE.
C’eſt que Poliandre a gliſſé dans ton ame Quelque douce chaleur de l’amoureuſe flame.	C'est que Poliandre a glissé dans ton âme Quelque douce chaleur de l'amoureuse flamme.
Ie ne le penſe pas.	Je ne le pense pas.
SILINDE.	SILINDE.
CLARISTE.	CLARISTE.
Tu rougis neantmoins.	Tu rougis néanmoins.
Va, va, ie n'eit veux point de plus fermes témoins.	Va, va, Madame n'éit veux point de plus fermes témoins.
Il n’en faut pas tant dire en ce temps où nous ſommes, Mais pleût à Dieu, mes ſœurs, que ces trois Gentils- hommes Euſſent pour nous aimer vn deſir genereux.	Il n'en faut pas tant dire en ce temps où nous sommes, Mais plet à Dieu, mes sœurs, que ces trois Gentils- hommes Eussent pour nous aimer un désir généreux.
SILINDE.	SILINDE.
Roſelis en ce cas feroit ton amoureux.	Roselis en ce cas ferait ton amoureux.
CLARISTE.	CLARISTE.
Ie m’en contenterois.	Je m'en contenterais.
SILINDE.	SILINDE.
Que tu fais bien la fine!	Que tu fais bien la fine!
qualiu eu reux dey drrerque tu rais ponne mine, Que tu m’as battu froid dan le commencement.	qualive eu reux de drrerque tu rais onne mine, Que tu m'as battu froid dan le commencement.
CLARISTE.	CLARISTE.
La crainte à ta raiſon ſeruoit de truchement, Dés que pour me parler tu as ouuert la bouche I’ay porté mon eſprit ſur le mal qui te touche.	La crainte à ta raison servait de truchement, Dès que pour me parler tu as ouvert la bouche J'ai porté mon esprit sur le mal qui te touche.
SILINDE.	SILINDE.
Ie confeſſe vrayment que c’eſt bien deuiner:	Je confesse vraiment que c'est bien deviner:
Mais auſſi i’ay ſuiet de beaucoup m’étonner, Maſtenant que ie vois Roſelis dans ton ame;	Mais aussi j'ai sujet de beaucoup m'étonner, Mâtenant que ie voisins Roselis dans ton âme;
Toy qui faiſois tantoſt des leçons à ma flame, Ie venois bien icy me confeſſer au loup.	Toi qui faisais tantôt des leçons à ma flamme, Je venais bien ici me confesser au loup.
CLARISTE.	CLARISTE.
Nos trois cœurs ont eſté frappez d’vn meſme coupr Et pourueu que celuy des Amans ne ſoit moindre, ma læ dl, aneurement nous ne deuons nous plaindre.	Nos trois cœurs ont été frappés d'un même coupr Et pourvu que celui des Amants ne soit moindre, ma læ dl, aneurement nous ne devons nous plaindre.
Mais où va Floriane?	Mais où va Floriane?
STLTNDE.	STLTNDE.
Elle vient à grand pas.	Elle vient à grand pas.
Mes ſœurs:	Mes sœurs:
FLORIANE.	FLORIANE.
42	42
OILIIVDE.	ÔILIVDE.
Que voulez-vous?	Que voulez-vous?
FLORIANE.	FLORIANE.
Ces Meſſieurs ſoht là bas;	Ces Messieurs soht là bas;
Ils demandent Monſieur, Madame, ou bien leurs filles.	Ils demandent Monsieur, Madame, ou bien leurs filles.
SITIIDE.	SITIIDE.
Allons au deuant d’eux, pareſſons bien gentilles.	Allons au devant d'eux, paressons bien gentilles.
Rangez bien tout icy, courons-toſt?	Rangez bien tout ici, courons-tôt?
9* q	9* 
CEARISTE.	CEARISTE.
Ho ma ſœur!	Ho ma sœur!
Que le Ciel aujourd’huy nous promet de bon-heur!	Que le Ciel aujourd'hui nous promet de bonheur!
JGENE II POLIANDRE.	JGENE II POLYANDRE.
SILINDE.	SILINDE.
ROSE.	ROSE.
LIS.	LIS.
CLARISTE.	CLARISTE.
BELANGE.	BÉLANGE.
FLORIANE.	FLORIANE.
POLIANDRE.	POLYANDRE.
Fin de n’eſtre pas accuſé de pareſſe, 1 Ale viens chaſtes beautez, acquitter ma promeſſe;	Fin de n'être pas accusé de paresse, 1 Ale viens chastes beautés, acquitter ma promesse;
Cette chanſon promiſe hier dedans le bois, Pour vous la preſenter nous fait venir tous trois.	Cette chanson promise hier dedans le bois, Pour vous la présenter nous fait venir tous trois.
SILINDE.	SILINDE.
Meſſieurs, vos actions ſont les vrais témoignages Des vertutux ucnems qui porcent ros courages:	Messieurs, vos actions sont les vrais témoignages Des vertutux ucnems qui porcent ros courages:
Par les humbles effets que vous nous faites voir, Nous manquons de vertu autant que de pouuoir Pour reconnoiſtre vn iour vne faueur ſi grande.	Par les humbles effets que vous nous faites voir, Nous manquons de vertu autant que de pouvoir Pour reconnaître un jour une faveur si grande.
POLIANDRE.	POLYANDRE.
L’honneur à nos eſprits, cette gloire demande, Pour ſeruir vos beautez n’ont rien de limité.	L'honneur à nos esprits, cette gloire demande, Pour servir vos beautés n'ont rien de limité.
Auſſi quand le deuoir eſt eſtimé ſeruice, On ne ſçautoit iamais rendre vn meilleur office.	Aussi quand le devoir est estimé service, On ne sçautoit jamais rendre un meilleur office.
CLARISTE.	CLARISTE.
Si par vn tel eſtime, encor qu’injuſtement Nous pouuons vous donner quelque contentement.	Si par un tel estime, encor qu'injustement Nous pouvons vous donner quelque contentement.
Meſſieurs, aſſeurez-vous qu’il tient place en noſtre ame Du plus grand qui iamais fuſt receu d’vne Dame.	Messieurs, assurés-vous qu'il tient place en notre âme Du plus grand qui jamais fut reçu d'une Dame.
ROSELIS.	ROSELIS.
Ha!	Ha!
que parfaitement vous ſçauez obliger, le vois bien que par là vous voulez vous vanger:	que parfaitement vous savez obliger, le vois bien que par là vous voulez -vous venger:
Mais quoy que vous faſſiez, ie veux par ialouſie, Voir ceder vos deſits à noſtre courtoiſie.	Mais quoi que vous fassiez, je veux par jalousie, Voir céder vos désits à notre courtoisie.
FLORIANE.	FLORIANE.
La bonne volonté ne manquera iamais, Et ſi vous n’en voyez quelqu’effet deſormais, neeurt zele dertin dont la noitc malice Nous rauit le bon heur de vous rendre ſernice.	La bonne volonté ne manquera jamais, Et si vous n'en voyez quelqu'effet désormais, neeurt zèle dertin dont la noitc malice Nous ravit le bon heur de vous rendre sernice.
BELANGE.	BÉLANGE.
A faire l’impoſſible on n’eſt point obligé, La volonté ſuffit, ſi l’effet negligé N’impute à la raiſon le ſujet de la faute.	À faire l'impossible on n'est point obligé, La volonté suffit, si l'effet négligé N'impute à la raison le sujet de la faute.
SILINDE.	SILINDE.
route conception me ſemole vn peu trop haute Demeurez ſur ce point, pour prendre ſeulement sur ces chaires icy le repos d’vn moment.	route conception me semole un peu trop haute Demeurez sur ce point, pour prendre seulement sur ces chaires ici le repos d'un moment.
POLIANDRE.	POLYANDRE.
Nous pouuons librement diſcourir vn quart d’heure.	Nous pouvons librement discourir un quart d'heure.
SIEIRNED.	SIEIRNED.
Vous trouueriez ailleurs occaſion meilleure.	Vous trouveriez ailleurs occasion meilleure.
CLARDSIE.	CLARDSIE.
Prenez noſtre entretien par diuertiſſement.	Prenez notre entretien par divertissement.
ROSELIS.	ROSELIS.
On n’en ſçauroit trouuer vn qui ſoit plus charmant.	On n'en saurait trouver un qui soit plus charmant.
SILINDE.	SILINDE.
Aucun n’a iamais pleu dauantage à mon ame:	Aucun n'a jamais plu davantage à mon âme:
l faut fort franchement vous auoüer, Madame, Que vos perfections ont tant gagné ſur moy, Qe mion cœur derormais ne tuit plus d’autre loy.	l faut fort franchement vous avouer, Madame, Que vos perfections ont tant gagné sur moi, Qe myon cœur derormais ne tuit plus d'autre loi.
ROSELIS.	ROSELIS.
Monſieur, vous me flatez d’vne eſperance vaine, Vous, dont la qualité vaut le prix d’vne Reine.	Monsieur, vous me flattez d'une espérance vaine, Vous, dont la qualité vaut le prix d'une Reine.
CLARISTE.	CLARISTE.
Que ie ſerois heureux, ſi de mes actions Nelqu’vne pouuoit plaire à vos perfections.	Que était serais heureux, si de mes actions Nelqu'une pouvait plaire à vos perfections.
CLARISTE.	CLARISTE.
Puis qu’en toutes façons chacune eſt ſalutaire, Ie ne ſçaurois penſer qu’elles puiſſent déplaire.	Puis qu'en toutes façons chacune est salutaire, Je ne saurais penser qu'elles puissent déplaire.
BELANGE.	BÉLANGE.
Madame, cronez-vous que dans vonie entretien Ie trouue en verité mon plus ſouuerain bien.	Madame, cronez-vous que dans vonie entretien Je trouve en vérité mon plus souverain bien.
FLORIANE.	FLORIANE.
Iugerez-vous, Monſieur, que mon cœur incredule, M’aduertit que le voſtre à preſent diſſimule.	Jugerez-vous, Monsieur, que mon cœur incrédule, M'avertit que le vôtre à présent dissimule.
TOCIANDRE.	TOCIANDRE.
La feinte & la grandeur ne font point de ſejour, Où loge le ſuiet d’vn veritable amour.	La feinte et la grandeur ne font point de séjour, Où loge le sujet d'un véritable amour.
SILINDE.	SILINDE.
Quoy que la paſſion en donne vne aſſeurance, Il faut touſiours douter de la perſeuerance.	Quoi que la passion en donne une assurance, Il faut toujours douter de la persévérance.
ROSELIS.	ROSELIS.
I’eſpere auec le temps, ſeruant voſtre beauté, Luj montier les cirete de ma auente.	J'espère avec le temps, servant votre beauté, Luj montier les cirete de ma avente.
CLARISTE.	CLARISTE.
Certaine opinion où mon ame eſt plongée, Me dit qu’aſſeurément la voſtre eſt eũgagée.	Certaine opinion où mon âme est plongée, Me dit qu'assurément la vôtre est eũgagée.
BELANGE.	BÉLANGE.
Ie meure ſi i’aimay iamais en aucuns lieux, Sinon depuis hier que ie vis vos beaux yeux.	Je meure si j'aimai jamais en aucuns lieux, Sinon depuis hier que ici vis vos beaux yeux.
FLORIANE.	FLORIANE.
Alois qu’vn Courtiran dente nous ſurprendre Il eſt fort mal-aiſé de s’en pouuoir deffendre.	Alois qu'un Courtyran denté nous surprendre Il est fort malaisé de s'en pouvoir défendre.
POLIANDRE.	POLYANDRE.
Les preuues ſe verront dans les occaſions Qui pourront confirmer nos perſuaſions.	Les preuves se verront dans les occasions Qui pourront confirmer nos persuasions.
SILINDE.	SILINDE.
Ie trouue fort aiſé de dire que l’on aime;	Je trouve fort aisé de dire que l'on aime;
Mais de le croire auſſi le peril eſt extreme.	Mais de le croire aussi le péril est extrême.
ROOLEIO.	ROLEIO.
I’ay chery quelque temps vn Aſtre de la Cour:	J'ai chéri quelque temps un Astre de la Cour:
Mais ſon laſche mépris a banny mon Amour.	Mais son lâche mépris a banni mon Amour.
CLARISTE.	CLARISTE.
l’apprehende bien plus que ce ſoit l’inconſtance, Qui marque voſtre eſprit de ſon indifferance.	l'appréhende bien plus que ce soit l'inconstance, Qui marque votre esprit de son indifférance.
BELANGE.	BÉLANGE.
Dhioiconcenteuent ucpem de vous reruir, Mauuaiſe, voulez-vous ce bon heur me rauir.	Dhioiconcenteuent ucpem de vous revir, Mauvaise, voulez-vous ce bon heur me ravir.
FLORIANE.	FLORIANE.
L'Amant veut qu’on le croye en toutes ſes paroles, Quoy que le plus ſouuent il diſe des friuoles,	L'Amant veut qu'on le croie en toutes ses paroles, Quoi que le plus souvent il dise des frivoles,
POLIANDRE.	POLYANDRE.
Si nous auions icy vn moment de loiſir, Ie vous declarerois quel eſt noſtre deſir.	Si nous avions ici un moment de loisir, Je vous déclarerais quel est notre désir.
SILINDE.	SILINDE.
Monſieur, vous le pouuez, l’occaſion preſente Rendra par ce moyen noſtre ame fort contente.	Monsieur, vous le pouvez, l'occasion présente Rendra par ce moyen notre âme fort contente.
ROSELIS.	ROSELIS.
Poliandre tout ſeul ſçait quel eſt mon deſſein, Comme pareilſuinantray le heirdans mon ſein,	Poliandre tout seul sçait quel est mon dessein, Comme pareilsvinantrai le héirdans mon sein,
CLARISTE.	CLARISTE.
Pour moy ie iugerois que ce qui vous ameine, Eit pour paſſer le temps peut-eſtre vne ſemaine.	Pour moi ici jugerais que ce qui vous âmeine, Eit pour passer le temps peut-être semaine.
BELANGE.	BÉLANGE.
Mon eſpoir appuyé d’vn deſir genereux, Me donne en voſtre endroit le titre d’Amoureux.	Mon espoir appuyé d'amour des généreux, Me donne en votre endroit le titre d'Amoureux.
FLORIANE.	FLORIANE.
Emcere qu’irfuit viay le lorciois vous croire, Mon merite, Monſieur, n’approchant voſtre gloire.	Emère qu'irfuit vivai le lorciais vous croire, Mon mérite, Monsieur, n'approchant votre gloire.
POLIANDRE.	POLYANDRE.
Apres que dans la Cour i’ay veu chaque beauté, I’ay trouué que la voſtre a l’honneur emporté.	Après que dans la Cour j'ai vu chaque beauté, J'ai trouvé que la vôtre a l'honneur emporté.
SILINDE.	SILINDE.
Sçachant trop les deffauts qui ſont en mon viſage, Mon eſprit n’eſt point vain pour croire ce langage.	Sachant trop les défauts qui sont en mon visage, Mon esprit n'est point vain pour croire ce langage.
ROSELIS.	ROSELIS.
Croyez qu’il n’eſt ſur terre aucun objet mortel A qui pluſtoſt qu’à vous mon cœur dreſſe vn autel.	Croyez qu'il n'est sur terre aucun objet mortel À qui plutôt qu'à vous mon cœur dresse un autel.
CLARISTE.	CLARISTE.
I’eſtime grandement vn choix ſi fauorable:	J'estime grandement un choix si favorable:
Mais vn feu violent n’eſt pas beaucoup durable.	Mais un feu violent n'est pas beaucoup durable.
BELANGE.	BÉLANGE.
Tuntent que de mamuerd encin dos appas, Ie voudrois que le Ciel me donnaſt le treſpas.	Tuntent que de mamuerd encin dos appas, Je voudrais que le Ciel me donnât le trépas.
FLORIANE.	FLORIANE.
Auant que de cauſer vn malheur ſi funeſte, Ie voudrois que le mien fuſt à tous manifeſte.	Avant que de causer un malheur si funeste, Je voudrais que le mien fût à tous manifeste.
POLIANDRE.	POLYANDRE.
Madame, nous venons pour apprendre de vous ( En qualité d’Amans) ſi vous voudrez de nous.	Madame, nous venons pour apprendre de vous ( En qualité d'Amant) si vous voudrez de nous.
SILINDE.	SILINDE.
L’offre d’vn ſi grand heur eſt d’vne conſequence Qu’il merite, Monſieur, que noſtre eſprit y penſe.	L'offre d'Honneur si grand heur est d'une conséquence Qu'il mérite, Monsieur, que notre esprit y pense.
ROSELIS.	ROSELIS.
Pourueu que vous n’ayez point d’autre ſeruiteur, ntorene querque four paguuia tenic cœeur.	Pourvu que vous n'ayez point d'autre serviteur, ntorène querque four pagua tenic cœeur.
CL'ARISTE.	CL'ARISTE.
Clariſte & ſes deux ſœurs que vous voyez preſentes, En matiere d’amour ſont beaucoup innocentes.	Clariste et ses deux sœurs que vous voyez présentes, En matière d'amour sont beaucoup innocentes.
BELANGE.	BÉLANGE.
Ie voy bien que le Ciel a ſoin de nos Amours, Puis que pas vn riual n’en interrompt le cours.	Je vois bien que le Ciel a soin de nos Amours, Puis que pas un rival n'en interrompt le cours.
FLORIANE.	FLORIANE.
Noſtre peu de beauté nous cauſe ce dommage:	Notre peu de beauté nous cause ce dommage:
Mais ſur d’autres auſſi vous auez l’auantage.	Mais sur d'autres aussi vous avez l'avantage.
Lon en lra de Nous auons de vous trois fait vne eſlection, Suiuant le mouuement de noſtre affection:	Lon en lra de Nous avons de vous trois fait une élection, Suivant le mouvement de notre affection:
Penſez-y meurement, & croyez que la feinte N’exerce ſon pouuoir ſur vne ame contrainte.	Pensez-y meurement, et croyez que la feinte N'exerce son pouvoir sur une âme contrainte.
SILINDE.	SILINDE.
Pour éuiter le bruit de queiques amerenus, Nous en prendrons auis de nos proches parens.	Pour éviter le bruit de queiques amenus, Nous en prendrons avis de nos proches parents.
ROSELIS.	ROSELIS.
L’affaire le merite, auecque diligence, De crainte que le Roy ne nous meine en Prouenee.	L'affaire le mérite, avec diligence, De crainte que le Roi ne nous mène en Prouenee.
CLARISTE.	CLARISTE.
Vous en aurez demain la reſolution.	Vous en aurez demain la résolution.
BELANGE.	BÉLANGE.
vous vidrons cependant dans l’apprehienſion Qu’il ſe trouue à nos vœux quelque demon contraire.	vous vidrons cependant dans l'appréhiension Qu'il se trouve à nos vœux quelque démon contraire.
FLORIANE.	FLORIANE.
Non, non, ne craignez pas, la choſe eſt volontaire, Du nous aime par trop pour forcef nos plaiſirs.	Non, non, ne craignez pas, la chose est volontaire, Du nous aime par trop force pours nos plaisirs.
SILINDE.	SILINDE.
On ne nous marira que ſelon nos deſirs.	On ne nous marira que selon nos désirs.
CLANISIE.	CLANISIE.
ourueu que noſtre pere à ce deſſein conſente, toyez que noſtre mere en ſera fort contente.	ourvu que notre père à ce dessein consente, toyez que notre mère en sera fort contente.
POLIANDRE.	POLYANDRE.
Jous-nous eſtions promis le bon-heur de les voir;	Jous-nous étions promis le bonheur de les voir;
lais puis qu’ils n’y ſont pas, par vn iuſte deuoir, ous ſeul fendrons deniain la lemblable viſite:	lais puis qu'ils n'y sont pas, par un juste devoir, ous seul fendrons deniain la lemblable visite:
ependant la nuict vient, il faut que chacun quitte on charmant entretien;	eupendant la nuit vient, il faut que chacun quitte on charmant entretien;
auant nous ſeparer le vos commandemens voulez-vous m’honorer.	avant nous séparer le vos commandements voulez-vous m'honorer.
SILINDE.	SILINDE.
ie puis commander en qualité d’Amante, veux que voſtre eſprit me croye ſa ſeruante.	Les puis commander en qualité d'Amante, veux que votre esprit me croie sa servante.
POLIANDRE.	POLYANDRE.
honneur de vous ſeruir m’eſt vn treſor ſi cher, que ie mourray pluſtoſt que de m’en empeſcher.	honneur de vous servir m'est un trésor si cher, que tu mourrai plutôt que de m'en empêcher.
ROSELIS.	ROSELIS.
ladame, obligez-moy de voſtre bien-veillance, t de mon amitié ie vous donne aſſeurance.	ladame, obligez-moi de votre bienveillance, toi de mon amitié homme vous donne assurance.
CLARISTE.	CLARISTE.
60 lonſieur, ſoyez certain que ſelon mon pouuoir, i toute occaſion ie vous le feray voir.	60 lonsieur, soyez certain que selon mon pouvoir, y toute occasion ie vous le ferai voir.
BELANGE.	BÉLANGE.
Adieu donc pour ce iour Reyne de ma penſée, Iamais voſtre beauté n’en peut eſtre effacée.	Adieu donc pour ce jour Reine de ma pensée, Jamais votre beauté n'en peut être effacée.
FLORIANE.	FLORIANE.
Monſieur, ce n’eſt vn bien qui part d’vn naturel Plus courtois qu’amoureux:	Monsieur, ce n'est un bien qui part d'un naturel Plus courtois qu'amoureux:
toutefois il eſt tel Que l’en feray touſiours vne eſtſme incroyable, Afin qu’en vous ſeruant, ie vous ſois agreable.	toutefois il est tel Que l'en ferai toujours une estsme incroyable, Afin qu'en vous servant, Seigneur vous sois agréable.
SILINDE.	SILINDE.
Hé bien, mes cheres ſœurs, quels ſont vos ſentimens aur le doux cutrerren de nos purrand Amans?	Hé bien, mes chères sœurs, quels sont vos sentiments aur le doux cutreren de nos purrand Amants?
Pour moy ie vous diray le mien ſans flaterie;	Pour moi ici vous dirai le mien sans flatterie;
C’eſt qu’ils parlent tous trois ſans nulle raillerie.	C'est qu'ils parlent tous trois sans nulle raillerie.
CLARISTE.	CLARISTE.
Il eſt facile à voir, leur emulation Témoigne clairement quelle eſt leur paſſion, Ie n’ay rien entendu que des paroles bonnes, Et veu des actions dignes de leurs perſonnes.	Il est facile à voir, leur émulation Témoigne clairement quelle est leur passion, Je n'ai rien entendu que des paroles bonnes, Et vu des actions dignes de leurs personnes.
FL'ORIANE.	FL'ORIANE.
Si l'on peut du projet paruennt à reffet, C’eſt vn plaiſir extréme que la vertu nous fait;	Si l'on peut du projet parvennt à reffet, C'est un plaisir extrême que la vertu nous fait;
Il en faut conſulter auec noſtre beau-pere, Qui vient tout à propos auecque noſtre mere.	Il en faut consulter auec jours beau-père, Qui vient tout à propos avec notre mère.
Mr CAROLV.	Mr CAROLU.
La couſtume eſt ainſi, les femmes de Paris Doiuent vne viſite aux parens des maris.	La coutume est ainsi, les femmes de Paris Doivent une visite aux parents des maris.
FLEVRIE.	FLEURIE.
La mode eſt importune aux perſonnes aagées Ceux qui ont fait ces loix nous ont deſ-obligées Et pour mon regard ſeul i’ay les deux pieds ſi las, Que tres-aſſeurément ie n’y retourne pas.	La mode est importune aux personnes aagées Ceux qui ont fait ces lois nous ont des-obligées Et pour mon regard seul j'ai les deux pieds si las, Que trèsassurément tu n'y retourne pas.
Mr.	Mr.
KAROLV.	VAROLV.
Les nouueaux mariez font cela d’ordinaire.	Les nouueaux mariés font cela d'ordinaire.
FLEVRIE.	FLEURIE.
On ne m’y tiendroit pas ſi c’eſtoit à refaire.	On ne m'y tiendrait pas si c'était à refaire.
Mr KAROLV.	Mr AROLU.
Quoy?	Quoi?
vous eſtes deſia dedans le repentir.	vous êtes déjà dedans le repentir.
FLEVRIE.	FLEURIE.
Ie dis harratmient la choſe ſans mentir:	Je dis harratmient la chose sans mentir:
Mais tant de parenté déplaiſt fort à Fleurie.	Mais tant de parenté déplaît fort à Fleurie.
Mr KAROLV.	Mr AROLU.
Hé bien, nous n’irons plus, parlons bas, ie vous pris, Silinde & ſes deux lœurs nous viennent aborder.	Hé bien, nous n'irons plus, parlons bas, où vous pris, Silinde et ses deux lœurs nous viennent aborder.
Mes mignonnes, quelqu’vn m’eſt venu demander?	Mes mignonnes, quelqu'un m'est venu demander?
SILINDE.	SILINDE.
Qui croyez-vous que c’eſt?	Qui croyez-vous que c'est?
Mr KAROLV.	Mr AROLU.
Momeur de l Fuſtaille.	Momeur de l' Fûtaille.
FLEVRIE.	FLEURIE.
C’eſt ma ſœur vieux thodis, ou Madame Racaille.	C'est ma sœur vieux thodis, ou Madame Racaille.
FLORTANE.	FLORTANE.
Non, ce ſont ces Meſſieuts trouuez dedans le bois Qui témoignent auoir de l’amour pour nous trois.	Non, ce sont ces Messiuts trouvés dedans le bois Qui témoignent avoir de l'amour pour nous trois.
LLETRIE.	LLETRIE.
Floriane, vrayment vous eſtes trop hardie.	Floriane, vraiment vous êtes trop hardie.
FLORTANE.	FLORTANE.
Sçachant la verité il faut que ie la die.	Sachant la vérité il faut que je la die.
FLEVRIE.	FLEURIE.
Ioiruy point encor veu rien de plus effronté.	Joirui point encor vu rien de plus effronté.
CLARISTE.	CLARISTE.
Il eſt vray qu’ils ſont pleins de bonne volonté, Ils nous ont fait icy mil’offres de ferſices, Que l’on lit ſur leur front eſtre ſans artifices.	Il est vrai qu'ils sont pleins de bonne volonté, Ils nous ont fait ici mil’ offres de fersices, Que l'on lit sur leur front être sans artifices.
Mr KAROLV.	Mr AROLU.
Ne vous y fiez pas, ces eſprits ſi courtois Pour mieux vous attraper font ainſi les matois.	Ne vous y fiez pas, ces esprits si courtois Pour mieux vous attraper font ainsi les matois.
SILINDE.	SILINDE.
Non veritablement ie n’y void rien à craindre, Leur ame ſans mentir, ne ſçait que c’eſt de feindre, Les ſermens qu’ils ont faits auec leuts actions Nous informent aſſez de leurs affections.	Non véritablement je n'y voit rien à craindre, Leur âme sans mentir, ne sait que c'est de feindre, Les serments qu'ils ont faits après luts actions Nous informent assez de leurs affections.
FLEVRIE.	FLEURIE.
Ha!	Ha!
que n’eſtois-je icy, en trois mots & ſans peint Iaurois leu dans leur cœur le deſſein qui les meine.	que n'étais-je ici, en trois mots et sans peint Jaurais lu dans leur cœur le dessein qui les mène.
CLARISTE.	CLARISTE.
Il ne faut point douter qu’il eſt fort bon pour nous, Chacun duun des demann s’pnre pour noſtre eſpour Ils vous viendront eux meſmes en faire la demande.	Il ne faut point douter qu'il est fort bon pour nous, Chacun du sort des démnre pour notre épour Ils vous viendront eux mêmes en faire la demande.
FLEVRIE.	FLEURIE.
I’ay de la peine à croire vne faueur ſi grande, Et ie crains que ſçachant noſtre incommodité Ils ne cheriſſent plus l’habit ny la beauté.	J'ai de la peine à croire une faveur si grande, Et a crains que sachant notre incommodité Ils ne chérissent plus l'habit ni la beauté.
SILINDE.	SILINDE.
Ie ne le penſe pas;	Je ne le pense pas;
la parfaite nobleſſe Donnite à prercrerl'honneur a la richeſſe:	la parfaite noblesse Donnite à prercrerl'honneur à la richesse:
Ioint qu’à tous ces perils, leurs eſprits diſpoſez Ne craignent ſeulement que d’eſtre refuſez.	Joint qu'à tous ces périls, leurs esprits disposez Ne craignent seulement que d'être refusez.
Mr KAROLV.	Mr AROLU.
Vous n’auez rien promis qui nous puiſſe déplaire.	Vous n'avez rien promis qui nous puisse déplaire.
CEnRIsIL.	CEnRIsIL.
Que de ſuiure en cela voſtre auis neceſſaire.	Que de suivre en cela votre avis nécessaire.
Mr KAROLV.	Mr AROLU.
Laiſſons-les donc venir.	Laissons-les donc venir.
FLEVRIE.	FLEURIE.
O filles qu’à propos On vous a mis ce iour ces habits ſur le dos!	Ô filles qu'à propos On vous a mis ce jour ces habits sur le dos!
Vous paſſer dopres d'eux pour ſeunes Daiſloiſelles.	Vous passer doprès d'eux pour seunes Daisloiselles.
FLORIANE.	FLORIANE.
Il s’en trouue beaucoup qui ne ſont point ſi belles.	Il s'en trouve beaucoup qui ne sont point si belles.
Mr KAROLV.	Mr AROLU.
Il eſt vray, ie vous iure.	Il est vrai, Seigneur vous jure.
FLEVRIE.	FLEURIE.
Allons mon petit cœur Prendre ſur le ſoupper quelque peu de vigueur.	Allons mon petit cœur Prendre sur le souper quelque peu de vigueur.
Mr KAROLV.	Mr AROLU.
Entrez toûjours decant, faites ſettre à la broche.	Entrez toujours décant, faites settre à la broche.
Mais que veut ce ſoldat qui prés de moy s’approche?	Mais que veut ce soldat qui près de moi s'approche?
COMEDIE.	COMÉDIE.
Las!	Las!
ce ieune garçon n'elt guere relolu.	ce jeune garçon n'él guère relolu.
SOLDAT.	SOLDAT.
Monſieur, eſt-ce point vous qu’on nomme Karolu, Mary d’vne Alizon en beautez ſans exemple, Et qu’on m’a dit loger dans les marais du Temple.	Monsieur, est-ce point vous qu'on nomme Arrolu, Mari d'une Alison en beautés sans exemple, Et qu'on m'a dit loger dans les marais du Temple.
MI RAROEV.	MI RAROEU.
Mon enfant, c’eſt moy-meſme.	Mon enfant, c'est moi-même.
SOLDAT.	SOLDAT.
Vn guerrier immortel Pour voir voſtre valeur enuoye ce cartel.	Un guerrier immortel Pour voir votre valeur envoie ce cartel.
Mr KAROLV.	Mr AROLU.
nejons de quelle fare.	néjons de quelle sare.
SOLDAT.	SOLDAT.
C’eſt de noſtre Anſpeſade.	C'est de notre Anspesade.
Mr KAROLV.	Mr AROLU.
le fuis fort aiſe, amy, d’vne telle ambaſſade, Cartel de Maiſtre Ieremie à Monſieur Karolu, Si tu te veux monſtrer quelque peu genereux, Rends-toy demain matin derriere les Chartreux;	le fuis fort aise, ami, d'une telle ambassade, Cartel de Maître Jéremie à Monsieur Arolu, Si tu te veux montrer quelque peu généreux, Rends-toi demain matin derrière les Chartreux;
Du le vaiſiant autheur des belles entrepriſes Je trouuera tout ſeul à ſix heures preciſes;	Du le vaisiant auteur des belles entreprises Je trouvera tout seul à six heures précises;
Et comme il a le cœur autant bon que courtois Des armes du combat il te donne le choix.	Et comme il a le cœur autant bon que courtois Des armes du combat il te donne le choix.
Mr KAROLV.	Mr AROLU.
Voila qui va fort bien, à Dieu mon camarade, le m’y rendray demain auec vne eſtocade, Qui vient du Cheualier qu’on appelloit Longis.	Voilà qui va fort bien, à Dieu mon camarade, le m'y rendrai demain avec une estocade, Qui vient du Chevalier qu'on appelait Longis.
SOLDAT.	SOLDAT.
Adieu, n’oubliez pas voſtre adreſſe au logis.	Adieu, n'oubliez pas Seigneur adresse au logis.
An dernier.	An dernier.
SCENE PREMIERE.	SCÈNE PREMIÈRE.
M.	M.
IEREMIE.	JEREMIE.
Eſolu de mourir, ou d’auoir la victoire, NIe marche maintenant ſur le champ de la gloire;	Éolu de mourir, ou d'avoir la victoire, NIe marche maintenant sur le champ de la gloire;
L’honneur de mon duel predeſtiné du ſort Me donne dans vne heure ou la vie ou la mort.	L'honneur de mon duel prédestiné du sort Me donne dans une heure ou la vie ou la mort.
Vous generoſité, hardieſſe, vaillance, Force, adreſſe, bon-heur, agilité, prudence, Ne m’abandonnez pas en ma neceſſité.	Vous générosité, hardiesse, vaillance, Force, adresse, bonheur, agilité, prudence, Ne m'abandonnez pas en ma nécessité.
Ie n’ay iamais tremblé deuant vne Cité;	Je n'ai jamais tremblé devant une Cité;
Et ſongeant au combat que ie vais entreprendre, A peine ay-ie le cœur de me pouuoir deffendre;	Et songeant au combat que ici vais entreprendre, À peine ai-je le cœur de me pouvoir défendre;
Quelque ſecret caché cauſe ce changement, Et peut-eſtre le Ciel ne veut pas autrement.	Quelque secret caché cause ce changement, Et peut-être le Ciel ne veut pas autrement.
Karolu me fait peur, & cent fois vne armée N’a point donné de crainte à ma droite animée I’executois des faits reſeruez au Dieu Mars:	Çarolu me fait peur, et cent fois une armée N'a point donné de crainte à ma droite animée J'exécutais des faits réservez au Dieu Mars:
Ie cherchois de la gloire au milieu des hazards.	Je cherchais de la gloire au milieu des hasards.
Et maintenant poltron vne ſeule perſonne Eſpouuante ton ame, & ton courage eſtonne.	Et maintenant poltron une seule personne Espouuante ton âme, et ton courage étonne.
Ah!	Ah!
ſans doute l’amour opere ces effets, Et d’vn œil de trauers il regarde mes faits.	sans doute l'amour opère ces effets, Et d'un œil de travers il regarde mes faits.
Mais que dis-ie, ignorant, ce demon ne void goutte;	Mais que dis-je, ignorant, ce démon ne voit goutte;
S’il oſte ſon bandeau, c’eſt donc qu’il me redoute:	S'il ôte son bandeau, c'est donc qu'il me redoute:
S’il void clair à preſent, c’eſt afin d’éuiter.	S'il voit clair à présent, c'est afin d'éviter.
Les traicts que contre luy ma fureur peut ietter.	Les traits que contre nô ma fureur peut jeter.
Que ne peut en ce ſiecle vn guerrier de ma ſorte, Lors que la ialouſie & la fureur l’emporte?	Que ne peut en ce siècle un guerrier de ma sorte, Lors que la jalousie et la fureur l'emporte?
Hardiment ſa valeur s’attacheroit aux cieux, Et contraindroit l’Amour d’abandonner ces lieux.	Hardiment sa valeur s'attacherait aux cieux, Et contraindrait l'Amour d'abandonner ces lieux.
Alizon, ton mépris cauſe tout ce deſordre, Cette faſcheuſe enuie à ſur moy voulu mordre Mais i’eſpere dans peu monſtrer à ton mignon Qu’il ne m’a deub traiter en petit compagnon:	Alison, ton mépris cause tout ce désordre, Cette fâcheuse envie à sur moi voulu mordre Mais j'espérer dans peu montrer à ton mignon Qu'il ne m'a devb traiter en petit compagnon:
e vais comme vn oyſeau le prendre à la pipée, Quand chez vn Fourbiſſeur i’auray pris vne eſpée.	 vais comme un oiseau le prendre à la pipée, Quand chez un Fourbisseur j'aurai pris un épée.
SCEINE II.	SCEINE II.
LEVRIE.	LEURIE.
SILINDE.	SILINDE.
CLARISTE.	CLARISTE.
FLORIANE.	FLORIANE.
TLEVRIE.	TLEURIE.
Mon Dieu qu’eſt-cecy!	Mon Dieu qu'est-ceci!
las que viens de voir?	las que viens de voir?
Mes filles accourez, ie ſuis au deſeſpoir, n’ay plus de mary, vous n’auez plus de pere.	Mes filles accourez, je suis au désespoir, n'ai plus de mari, vous n'avez plus de père.
SILINDE.	SILINDE.
elas!	Ell!
elle ſe paſme:	elle se pâme:
hé qu’auez vous ma mere?	hé qu'avez -vous ma mère?
FLEVRIE.	FLEURIE.
oyez dans ce papier le ſuiet de mon dueil, ui voſtre pere & moy conduit dans le cercueil, pauure homme en ſortant l’a laiſſé ſur la table, ſin de m’auertir de ſa mort lamentable.	oyez dans ce papier le sujet de mon deuil, ui votre père et moi conduit dans le cercueil, pauvre homme en sortant l'a laissé sur la table, sin de m'avertir de sa mort lamentable.
Lettre de Morſieur Karolu à Fleurie, que Silinde lit, amour, vn vieil ſoldat plus ialoux qu’amoureux, a fait faire vn appel derriere les Chartreux;	Lettre de Morsieur Karolu à Fleurie, que Silinde lit, amour, un vieil soldat plus jaloux qu'amoureux, a fait faire un appel derrière les Chartreux;
1 on courage & l’honneur veulent que i’y compare.	1 on courage et l'honneur veulent que j'y compare.
lieu chere moitié, le deſtin nous ſepare,	lieu chère moitié, le destin nous sépare,
68 ALIZON, Ne vous affligez pas, ayez ſoin ſeulement De me faire dreſſer vn riche monument.	68 ALIZON, Ne vous affligez pas, ayez soin seulement De me faire dresser un riche monument.
SILINDE.	SILINDE.
Iuſte Ciel, de quel œil voyez vous nos fortunes, Ne confeſſez-vous pas qu’elles ne ſont communes, Puis qu’eſtant ſur le point d’atteindre le bon-heur, Vous les faites mourit par vn coup de mal heur.	Juste Ciel, de quel œil voyez vous nos fortunes, Ne confessez-vous pas qu'elles ne sont communes, Puis qu'étant sur le point d'atteindre le bonheur, Vous les faites mourit par un coup de mal heur.
O mes ſœurs, c’eſt ce iour qu’il faut verſer des larmes;	Ô mes sœurs, c'est ce jour qu'il faut verser des larmes;
Puis que pour nous vanger nous n’aurons que ces armes.	Puis que pour nous venger nous n'aurons que ces armes.
Il faut que le torrent de tant de triſtes pleurs Aille aujourd’huy noyer l’autheur de nos douleurs.	Il faut que le torrent de tant de tristes pleurs Aille aujourd'hui noyer l'auteur de nos douleurs.
CLARISTE.	CLARISTE.
O que ce foible eſpoir contente mal mon ame!	Ô que ce faible espoir contente mal mon âme!
Cheres ſœurs, ie me meurs, la vengeance m’enflame, Il faut que mes deux mains faſſent mourir celuy Qui nous cauſe à preſent tant de mal & d’ennuy.	Chères sœurs, je me meurs, la vengeance m'enflamme, Il faut que mes deux mains fassent mourir celui Qui nous cause à présent tant de mal et d'ennui.
FLORIANE.	FLORIANE.
Mcias, que tes dilcours ine remolent mmatnes;	Mcias, que tes dilcours ine remolent mématnes;
Cherchons pour le ſauuer des moyens plus faciles, Et s’il n’eſt point trop tard, courons viſte apres eux, Empeſcher du combat l’euenement douteux.	Cherchons pour le sauver des moyens plus faciles, Et s'il n'est point trop tard, courons vite après eux, Empêcher du combat l'événement douteux.
FLEVRIE.	FLEURIE.
Mes enfans s’en eſt fait, il a trop de courage Pounir auon lurqu lepinis peſcrime en vſage:	Mes enfants s'en est fait, il a trop de courage Pounir avon lurqu lepinis pescrime en usage:
Pourtant ſans plus tarder, ie croy qu’il faut pluſtoſt Aiier en dinigence aduertn le Pleuont, Afin que promptement il leur donne des gardes, Qui pour les ſeparer portent des hallebardes.	Pourtant sans plus tarder, je crois qu'il faut plutôt Ajier en dinigence avertn le Plévont, Afin que promptement il leur donne des gardes, Qui pour les séparer portent des hallebardes.
CLARISTE.	CLARISTE.
C’eſt fort bien auiſé.	C'est fort bien avisé.
FLEVRIE.	FLEURIE.
Que l’on m’aide à marener.	Que l'on m'aide à marener.
Nous prendrons en paſſant noſtre voiſin l’Archer;	Nous prendrons en passant notre voisin l'Archer;
Depuis qu’il eſt du guet, l’eſpée & l’eſcarlatte Luy font abandonner l’aleſne & la ſauate.	Depuis qu'il est du guet, l'épée et l'écarlatte Lui font abandonner l'alêne et la saute.
s’il n’a fait cette nuict capture de filoux.	s'il n'a fait cette nuit capture de filoux.
Il ſera fort ioyeux de venir auec nous:	Il sera fort joyeux de venir ages nous:
Et i’ay mis dans ma bourſe vn teſton de Loraine, Pour le recompenſer du ſuccez de ſa peine,	Et j'ai mis dans ma bourse un teston de Loraine, Pour le récompenser du succès de sa peine,
SILINDE.	SILINDE.
Allons, il faut paſſer la porte de Buſſi.	Allons, il faut passer la porte de Bussi.
SCLNVE TII.	SCLNVE -TII.
M.	M.
KAROLV.	VAROLV.
Emblable à l’innocent que l’on meine au ſupplice, JIe ne ſçaurois ſçauoir de quoy ie ſuis complice, On me fait mon procez, on me condamne à mort, it l’on ne me dit point à qui i’ay fait du tort.	Emblable à l'innocent que l'on mène au supplice, JIe ne saurais savoir de quoi -je suis complice, On me fait mon procès, on me condamne à mort, it l'on ne me dit point à qui j'ai fait du tort.
e mal que i’ay commis, & dont ce ſoldat crie, iſt d’auoir épouſé l’agreable Fleurie, eremie aujourd’huy ne ſçauroit endurer Je voir à ſa valeur ma vertu preferer:	Je crois que j'ai commis, et dont ce soldat crie, ist d'avoir épousé l'agréable Fleurie, éremie aujourd'hui ne saurait endurer Je voir à sa valeur ma vertu préférer:
our en auoir raiſon il veut que nos épées diſputer ſon prix ſoient ce iour occupées:	our en avoir raison il veut que nos épées disputer son prix soient ce jour occupées:
lais helas!	lais hélas!
le pauure homme y vient vn peu trop tard ans canon cette nuict i’ay fait breſche au rampart, i ſi dés à preſent ie deſcend dans la foſſe, puis bien aſſeurer que ie la laiſſe groſſe.	le pauvre homme y vient un peu trop tard ans canon cette nuit j'ai fait brèche au rampart, y si dés à présent jamais descend dans la fosse, puis bien assurer que sans la laisse grosse.
nfin me voicy preſt de le bien receuoir, e veux à ce guerrier ma force faire voir eluy veux témoigner que ie me ſçay deffendre lors qu’vn temeraire oſe bien m’entreprendre.	nfin me voici prêt de le bien recevoir, e veux à ce guerrier ma force faire voir elle veux témoigner que Ne me sais défendre lors qu'un téméraire ose bien m'entreprendre.
ar la plume & l’eſpée auec le point d’honneur int vne ſimpatie auecque mon humeur:	ar la plume et l'épée avec le point d'honneur int Un simpatie auecque mon humeur:
m’en ſçay eſcrimer, alors que la rencontre our en voir les effets à ma gloire ſe monſtre.	m'en sais escrimer, alors que la rencontre our en voir les effets à ma gloire se montre.
Voicy doncques la place où preſide le ſort La vie eſt d’vn coſté, de l’autre on void la mort;	Voici donc la place où preside le sort La vie est d'un côté, de l'autre on voit la mort;
Et toutesfois les deux dedans l’indifference, Donnent à mon eſprit vne meſme eſperance.	Et toutefois les deux dedans l'indifférence, Donnent à mon esprit une même espérance.
La iuſtice diuine a le foudre à la main Pour punir le mortel quand il eſt inhumain, L’iniquité n’a point de plus grand ennemie.	La justice divine a le foudre à la main Pour punir le mortel quand il est inhumain, L'iniquité n'a point de plus grand ennemie.
Enfin ie ne vois point approcher Ieremie, Ie croy qu’il a changé de reſolution;	Enfin ici ne vois point approcher Jéremie, Je crois qu'il a changé de résolution;
La nuict chaſſe ſouuent la folle paſſion.	La nuit chasse souvent la folle passion.
Peut-eſtre que rentré dans vne raiſon forte, A ce folaſtre amour il a fermé la porte.	Peut-être que rentré dans une raison forte, À ce folâtre amour il a fermé la porte.
Mais n’eſt-ce poipt auſſi qu’il a ſceu ma valeur:	Mais n'est-ce poipt aussi qu'il a su ma valeur:
En ce cas ie craignois ceux à qui ie fais peur.	En ce cas Prince craignais ceux à qui prem fais peur.
Ie n’ay point de beſoin de chemiſes de mailles, Vne main de papier peut garder mes entrailles.	Je n'ai point de besoin de chemises de mailles, Une main de papier peut garder mes entrailles.
Il fait bon conſeruer le moule du pourpoint, L’eſpée aſſeurément ne la percera point:	Il fait bon conserver le moule du pourpoint, L'épée assurément ne la percera point:
Elle eſt ſi proprement deſſus le petit ventre, Qu’il ne faut auoir peur que l’eſtocade y entre.	Elle est si proprement dessus le petit ventre, Qu'il ne faut avoir peur que l'estocade y entre.
O qu’il verra tantoſt eſcrimer joliment!	Ô qu'il verra tantôt escrimer joliment!
Ie ne le crains non plus que tout ſon regiment, Pourueu que mes deux yeux me ſeruent d’auant-gat des.	Je ne le crains non plus que tout son régiment, Pourvu que mes deux yeux me servent d'avant-gat des.
Mais le voicy qui vient, tenons-nous ſur nos gardes, On no a dont, diteon, nei a renchiy.	Mais le voici qui vient, tenons-nous sur nos gardes, On nô a dont, diteon, ney a renchi.
M.	M.
IEREMIE.	JEREMIE.
Dieu te gard Karolu.	Dieu te gard Karolu.
Mr KAROLV.	Mr AROLU.
Dieu te gard mon amj	Dieu te gard mon ami
M.	M.
IEREMIE.	JEREMIE.
I’ay beaucoup plus tardé que l’heure entre nous priſe	J'ai beaucoup plus tardé que l'heure entre nous prise
Mr KAROLV.	Mr AROLU.
I’ay creu que ta folie eſtoit vn peu raſſiſe, Et que depuis hier, ayant dormy la nuiet, Tu pourrois oublier l’appel qui nous conduit.	J'ai cru que ta folie était un peu rassise, Et que depuis hier, ayant dormi la nuit, Tu pourrais oublier l'appel qui nous conduit.
M.	M.
IEREMIE.	JEREMIE.
Ia colere en ce cas trompe donc ton attente, lar plus elle vieillit, plus elle eſt violente, t ſans vn Fourbiſſeur qui m’a long-temps tenu, adubitablement ie t’aurois preuenu;	Ia colère en ce cas trompe donc ton attente, lar plus elle vieillit, plus elle est violente, t sans un Fourbisseur qui m'a longtemps tenu, adubitablement tu t'aurais prévenu;
u ſerois maintenant en l’eſtat de paroiſtre, e ceux qu’au Chaſtelet on va pour reconnoiſtre:	U serais maintenant en l'état de paraître, est ceux qu'au Châtelet on va pour reconnaître:
tais c’eit trop dilconn, ça, ça le manteau bas, e pourpoiut, le chapeau.	tais c'éit trop dilconn, ça, ça le manteau bas, e pourpoiut, le chapeau.
Mr KAROLV.	Mr AROLU.
Ie n’y manqueray pas?	Je n'y manquerai pas?
lais tire-toy plus loin, car la main meurtriere es gens de ta façon peut fraper par derriere.	lais tire-toi plus loin, car la main meurtrière est gens de ta façon peut frapper par derrière.
M.	M.
IEREMIE.	JEREMIE.
ne ſuis pas bourreau pour te traiter ainſi, l’honneur dans mon ſein a logé iuſqu’icy,  mais la trahiſon n’euſt de place en mon ame.	ne suis pas bourreau pour te traiter ainsi, l'honneur dans mon sein a logé jusqu'ici, mais la trahison n'eût de place en mon âme.
ais c’eſt toy, vieux hibou, qui fut traiſtre à ma flame, il les Iatenes detours de lildennte, de uai u m’as rauy le bien que i’auois merité.	ais c'est toi, vieux hibou, qui fut traître à ma flamme, il les Iatenes détours de lildennte, de uai aas ravi le bien que j'avais mérité.
Mr KAROLV.	Mr AROLU.
ſuure foux, ie te plains auec ta reſuerie.	suure foux, Seigneur te plains avec ta rêverie.
M.	M.
IEREMIE.	JEREMIE.
prends donc aujourd’huy que tu meurs pour Fleu.	prends donc aujourd'hui que tu meurs pour Flu.
rie.	rie.
Mr KAROLV.	Mr AROLU.
meure!	meure!
il s’en rencontre aux petites maiſons ui diſent plus que toy de meilleures raiſons;	il s'en rencontre aux petites maisons ui disent plus que toi de meilleures raisons;
pour moy ſi l’on croit ma ſcience certaine, tu reſte viuant il faut que l’on t’y meine.	pour moi si l'on croit ma science certaine, tu reste vivant il faut que l'on t'y mène.
M.	M.
IEREMIE.	JEREMIE.
eſt trop long-temps cauſer, es-ip eſt, depeſchons.	est trop longtemps causer, es-jp est, dépêchons.
46 Mr KARO verra ce papier ſi nouen4 rochons, Vn peu de patience, attends, car mon eſpée Tient dedans ſon foureau.	46 Mr KARO verra ce papier si nouven4 rochons, Un peu de patience, attends, car mon épée Tient dedans son foureau.
M.	M.
IEREMIE.	JEREMIE.
La plaiſante équipées Au peules proionger tavae xuncoan?	La plaisante équipées Au peules proionger tavae xuncoan?
, Lors qu’il vaudroit bien mieux te reſoudre à mourir.	, Lors qu'il vaudrait bien mieux te résoudre à mourir.
Mr KAROLV.	Mr AROLU.
Or ſus, venons aux mains, prend garde à cette botte.	Or sus, venons aux mains, prend garde à cette botte.
M.	M.
IEREMIE.	JEREMIE.
La riſpoſte eſt meilleure.	La risposte est meilleure.
Mr XAROLV.	Mr XAROLV.
Ai que le complote, Dans vn petit moment deſſus vn auant- pas Karolu s’en va mettre vn Anſpeſade bas.	Ai que le complote, Dans un petit moment dessus un avant- na Rolu s'en va mettre un Anspesade bas.
M.	M.
IEREMIE.	JEREMIE.
Pare ce coup fourré, car c’eſt luy qui t’aſſeure Qu’il faut aller là bas reparer mon injure.	Pare ce coup fourré, car c'est lui qui t'assure Qu'il faut aller là bas réparer mon injure.
Mi nnneses Pouſſe, pour le parer ie me mets en eſtat.	Mi nnneses Pousse, pour le parer ici me mets en état.
M.	M.
IEREMIE.	JEREMIE.
Tien donc, voila ta mort d’vn coup de vieux ſoldat	Tiens donc, voilà ta mort d'un coup de vieux soldat
Mr KAROLV.	Mr AROLU.
Ie deffends celuy-là qui paſſe la jartiere:	Je défends celui-là qui passe la jartière:
101 otrue, le rois queiqu'in qui te prend par derriere.	101 otrue, le rois queiqu'in qui te prend par derrière.
M.	M.
IEREMIE.	JEREMIE.
Ta feinte en mon endroit ne reüſſira pas, Mes yeux n’ont point d’object que celuy de ton bras.	Ta feinte en mon endroit ne réussira pas, Mes yeux n'ont point d'object que celui de ton bras.
Montre ny ton effort:	Montre ici ton effort:
& point de ſtratagéme.	et point de stratagème.
M.	M.
KAROLV.	VAROLV.
Ie garde vn delcier coup qui te va rendre bleſme, Regarde ma poſtu	Je garde un délcier coup qui te va rendre blême, Regarde ma postu
M.	M.
EREMIE.	EREMIE.
O que ie la void bien!	Ô que ici la voit bien!
Mr RAM top preſſé mon çoup n’a valu neM.	Mr RAM top pressé mon çoup n'a valu neM.
Il	Il
M.	M.
IEREMIE.	JEREMIE.
Je ſçais-tu que cela, ie me ris de ta peine.	Je sais-tu que cela, ie me ris de ta peine.
Mr KAROLV.	Mr AROLU.
Iola, tout doucement, prenons vn peu d’haleine.	Iola, tout doucement, prenons un peu d'haleine.
Mie Alaa Mie 'on, non, apres ta mort tu ſeras en repos.	Mie Ala Mie 'on, non, après ta mort tu seras en repos.
n Mr.	n Mr.
KAROLV.	VAROLV.
à vaillance toûjours le rencontre à propos, u la verras bien toſt par les lauriers ſuiuie.	à vaillance toujours le rencontre à propos, la verras bien tôt par les lauriers suiuie.
M.	M.
TEREMIE.	TEREMIE.
i tu veux m’arreſter demande moy la vie, eut-eſtre ma pitié te pourra pardonner.	y tu veux m'arrêter demande moi la vie, eut-être ma pitié te pourra pardonner.
Mr KAROLV.	Mr AROLU.
e ne demande point ce qu’on ne peut donner, Ve t’imagine pas l’auoir en ta puiſſance landis que cette main ſera ſur la deffence,	Je ne demande point ce qu'on ne peut donner, Ve t'imagine pas l'avoir en ta puissance landis que cette main sera sur la défense,
M.	M.
IEREMIE.	JEREMIE.
Pourſuiuons-donc le fil du duel commencé.	Poursuivons-donc le fil du duel commencé.
Ils ſe	Ils se
Mr.	Mr.
KAROLV.	VAROLV.
J’il t’en arriue mal ie ne t’en ay preſſé.	J'il t'en arrive mal On ne t'en ai pressé.
Di ſus, c’eſt maintenat qu’il taut iouer du reſte, le theaſmplorant le ſecours de la bonté celeſte.	Dis sus, c'est maintenat qu'il taut jouer du reste, le treasmplorant le secours de la bonté celeste.
CCEIVE DEIENJIENL.	CCEIVE DEIENIENL.
LEVRIE.	LEURIE.
ROSELIS.	ROSELIS.
SILINDE.	SILINDE.
FLORIANE.	FLORIANE.
CLARISTE.	CLARISTE.
POLIANDRE.	POLYANDRE.
MR.	MR.
KAROLV.	VAROLV.
M.	M.
IEREMIE.	JEREMIE.
BELANGE,	BÉLANGE,
FLEVRIE.	FLEURIE.
I Eſſieurs, qu’heureuſement nous vous auons VT trouuez, l'our venir appaiſer le mal que vous ſçauez.	I Isssieurs, qu'heureusement nous vous avons VT trouvez, l'our venir apaiser le mal que vous avez.
Helas, noſtre douleur eſt tellement ſenſible!	Hélas, notre douleur est tellement sensible!
Que d’en voir ſa ſemblable il vous eſt impoſſible.	Que d'en voir sa semblable il vous est impossible.
ROSELIS.	ROSELIS.
Nous ſortions du togis pour domer le von iour A vn Ambaſſadeur logeant pres Luxembour.	Nous sortions du togis pour domer le von jour A un Ambassadeur logeant pres Luxembour.
SILINDE.	SILINDE.
De grace donc, Meſſieurs, haſtons noſtre voyage.	De grâce donc, Messieurs, hâtons notre voyage.
POLIANDRE.	POLYANDRE.
Mais encor, quel deſſein portoit voſtre courage.	Mais encor, quel dessein portait votre courage.
CLARISTE.	CLARISTE.
Nous allions au logis du Preuoſt Deffunctis, L’aduertir du malheur quand vous eſtes ſortis.	Nous allions au logis du Prévôt Deffunctis, L'avertir du malheur quand vous êtes sortis.
DELANGE.	DELANGE.
Pourueu qu’ils ſoient viuans lors de noſtre arriuée, Vous verrez par la paix leur diſpute acheuée.	Pourvu qu'ils soient vivants lors de notre arrivée, Vous verrez par la paix leur dispute achevée.
FLORIANE.	FLORIANE.
Pleuſt au Ciel que déja nous y fuſſions ſautez.	Plût au Ciel que déjà nous y fussions sautés.
FLEVRIE.	FLEURIE.
Ie crains bien que la mort ne nous les ait oſtez voitre pere eit hardy:	Je crains bien que la mort ne nous les ait ôtés voitre père eit hardi:
mais l’autre à la vaillance, Et des tours de la guerre il a l’experience.	mais l'autre à la vaillance, Et des tours de la guerre il a l'expérience.
Le pauure corps, helas, n’aura guere duré !	Le pauvre corps, hélas, n'aura guère duré !
O ſans doute il eſt mort, c’eſt vn fait aſſeuré!	Ô sans doute il est mort, c'est un fait assuré!
POLIANDRE, De trop d’afflittioloro, eipiito le trauurſlent.	POLYANDRE, De trop d'afflittioloro, éjpiito le travurslent.
FLEVRIE.	FLEURIE.
rilies tourtenez-moy, car les fambes me faillent.	rilies tourtenez-moi, car les fambes me faillent.
ROSELIS.	ROSELIS.
Ca ça, donnez la main, nous approchons le lieu.	Ça ça, donnez la main, nous approchons le lieu.
FLEVRIE.	FLEURIE.
Encor ſi ie pouuois luy donner vn adieu.	Encor si grands pouvais était donner un adieu.
POLIANDRE Oüy, ie vous le promets, puis que deſſus ces mottes Nous les voyons tous deux ſe porter quelques bottes.	POLYANDRE Oui, je vous le promets, puis que dessus ces mottes Nous les voyons tous deux se porter quelques bottes.
BELANGE.	BÉLANGE.
Ies Dames, demeurez cependant que nous trois es irons ſeparer.	Jes Dames, demeurez cependant que nous trois es irons séparer.
FLEVRIE.	FLEURIE.
Non, non, ie ne ſçaurois.	Non, non, Madame ne saurais.
NODERTO.	NODERTO.
ne heure ſeulement.	ne heure seulement.
FLEVRIE.	FLEURIE.
Auant vne demie faut que mes deux mains étranglent Ieremie, ay trop d’affection pour demeurer icy.	Avant une demie faut que mes deux mains étranglent Jérémie, ai trop d'affection pour demeurer ici.
llons viſte.	lons vite.
FLORIANE.	FLORIANE.
SILINDE.	SILINDE.
Courons.	Courons.
Maiſtre Ieremie ſortant de derriere le Theatre.	Maître Jérémie sortant de derrière le Théâtre.
Mr KAROLV.	Mr AROLU.
l'as menty, voieur, laiais le ne rus ter, a vomiras le mot auec ce coup mortel.	l'as menti, voyeur, layais le ne rus ter, a vomiras le mot avec ce coup mortel.
POLIANDRE.	POLYANDRE.
oubeau, toubeau, Meſſieuts, nola, que l’on s’arreſte.	oubeau, toubeau, Messiuts, nola, que l'on s'arrête.
M IEREMIE.	M MEREMIE.
ue le plus las de viure à la parque s’appreſte, quelle laſcheté d’eſtre quatre contre vn !	Que le plus las de vivre à la parque s'apprête, quelle lâcheté d'être quatre contre un !
FLEVRIE.	FLEURIE.
vieux ratatiné, tu veux tuer mon homme!	vieux ratiné, tu veux tuer mon homme!
imaſſons des cailloux, garre que ie l’aſſomme.	imassons des cailloux, garre que Rome l'assomme.
G i	G y
M.	M.
IEREMIE.	JEREMIE.
Si vous venez plus prés ie vous enfileray.	Si vous venez plus près ie vous enfileray.
FLEVRIE.	FLEURIE.
Mon fils, aſſeure.	Mon fils, assure.
toy que le te rangeray, Preſte-moy ton eſpée.	toi que le te rangerai, Preste-moi ton épée.
M, IENEMTE.	M, JENEMTE.
O la plaiſante folle!	Ô la plaisante folle!
MI KAROLV.	MI AROLU.
En l’eſpoir de ta mort mon eſprit ſe conſole.	En l'espoir de ta mort mon esprit se console.
ROSELIS.	ROSELIS.
Soldat, oblige-nous de ne point offehcer Ceux qui tiennent en main ce qui t’y peut forcer:	Soldat, oblige-nous de ne point offehcer Ceux qui tiennent en main ce qui t'y peut forcer:
Reiniertoy plutoit, nous t'en donnons licence.	Reiniertais plutait, nous t'en donnons licence.
BELANGE.	BÉLANGE.
Ie croy que ce ſoldat eſt de ma conhoiſſance.	Je crois que ce soldat est de ma conhaissance.
POLIANDRE.	POLYANDRE.
Camarade, remets ton eſpée au fourreau, Ou t’aſſeure bien toſt d’eſtre ſur le carreau.	Camarade, remets ton épée au fourreau, Ou t'assure bien tôt d'être sur le carreau.
M.	M.
IEREMIE.	JEREMIE.
onconeitoit que vous ie n'aurois point de crainte.	onconeitait que vous ici n'aurais point de crainte.
BELANGE.	BÉLANGE.
Amy, i’ay contre toy, vn vray ſujet de plainte, Si ton cœur ne ſuit pas nôtre iuſte deſir.	Ami, j'ai contre toi, un vrai sujet de plainte, Si ton cœur ne suit pas notre juste désir.
M.	M.
IEREMIE.	JEREMIE.
Ha!	Ha!
Monſieur, eſt ce vous qui m’oſtez le plaiſir;	Monsieur, est ce vous qui m'ôtez le plaisir;
De vanger maintenant vn affront d’importance.	De venger maintenant un affront d'importance.
BELANGE.	BÉLANGE.
Nous en auons appris toute la conſequence, Il faut auant partir que rous foyez aiis, Ou nous croire tous trois tes plus grands ennemis.	Nous en avons appris toute la conséquence, Il faut avant partir que rous soyez aiis, Ou nous croire tous trois tes plus grands ennemis.
FLEVRIE.	FLEURIE.
A quoy fert ce diſcours, il n’eſt point neceſſaire, Mettez.	À quoi sert ce discours, il n'est point nécessaire, Mettez.
le moy par terre, ou bien me laiſſez faire.	le moi par terre, ou bien me laissez faire.
M.	M.
IEREMIE.	JEREMIE.
Le reſpect que ie dois à voſtre qualité Fait ceder la raiſon à ma brutalité, Ie mets les armes bas:	Le respect que Prince dois à votre qualité Fait céder la raison à ma brutalité, Je mets les armes bas:
mais c’eſt ſous l’aſſeurance Qu’il ne me ſera fait aucune violance.	mais c'est sous l'assurance Qu'il ne me sera fait aucune violance.
BELANGE.	BÉLANGE.
von, ie te le promets, & ces Meſſieurs & moy Seront ſi tu le veux vn accord auec toy.	von, Seigneur te le promets, et ces Messieurs et moi Seront si tu le veux un accord avec toi.
Quel?	Quel?
M.	M.
IEREMIE.	JEREMIE.
ROSELIS.	ROSELIS.
Monſieur Karolu tiendra la meſme place Qu’il auoit dans ton ame auant cette diſgrace.	Monsieur Arolu tiendra la même place Qu'il avait dans ton âme avant cette disgrâce.
M.	M.
IEREMIE.	JEREMIE.
Le n’eſt pas là, Meſſieurs, la ſatisfaction, J’auoir rauy Fleurie à mon affection.	Le n'est pas là, Messieurs, la satisfaction, J'avoir ravi Fleurie à mon affection.
Mr KAROLV.	Mr AROLU.
Tu te trompe, Soldat, elle m’eſtoit promiſe ruumt qu'ene eult lamdis ta vinte peimie.	Tu te trompe, Soldat, elle m'était promise ruumt qu'ène eult lamdis ta vinte peimie.
FLEVRIE.	FLEURIE.
ſon Dieu, laiſſez le dire, & ne l’irritez plus, leſerrez voſtre eſpée.	son Dieu, laissez le dire, et ne l'irritez plus, leserrez votre épée.
M.	M.
IEREMIE.	JEREMIE.
O que ie ſuis confus!	Ô que ici suis confus!
Dù eſt le temps jadis, où eſt ma hardieſſe, Iui portoit la terreur au cœur de la Nobleſſe:	Dù est le temps jadis, où est ma hardiesse, Jui portait la terreur au cœur de la Noblesse:
nent honmes contre moy deſlus le pont de Sé, Je m’étonnoient non plus qu’vn poulet fricaſſé;	nent honmes contre moi délus le pont de Sé, Je m'étonnaient non plus qu'un poulet fricassé;
euſſe bien fait la nique aux gens de voſtre ſorte:	eusse bien fait la nique aux gens de votre sorte:
e n’y veux plus ſonger, la colere m’emporte, dieu, Meſſieurs, adieu.	eu n'y veux plus songer, la colère m'emporte, dieu, Messieurs, adieu.
FLEVRIE.	FLEURIE.
Si l’on le laiſſe aller evois que dés demain il vous fait rappeller.	Si l'on le laisse aller évais que dès demain il vous fait rappeler.
G nj	G néj
POLIANDRE.	POLYANDRE.
Soldat, encore vn mot, oblige nous de dire La ſatisfaction que ton eſprit deſire.	Soldat, encore un mot, oblige nous de dire La satisfaction que ton esprit désire.
M.	M.
IEREMIE.	JEREMIE.
La mort de Karolu, pour auoir épouſé Celle, qui de ſes vœux m’auoit fauoriſé.	La mort de Arolu, pour avoir épousé Celle, qui de ses vœux m'avait favorisé.
FLEVRIE.	FLEURIE.
Certes cela n’eſt pas?	Certes cela n'est pas?
Mr KAROLV.	Mr AROLU.
Non, ie iure en mon ame.	Non, Seigneur jure en mon âme.
ROSELIS.	ROSELIS.
Enfin le mal eſt fait, c’eſt maintenant ſa femme.	Enfin le mal est fait, c'est maintenant sa femme.
FLEVRIE.	FLEURIE.
Ie crois que ce bon homme a les ſens interdits:	Je crois que ce bon homme a les sens interdits:
Hé bien, contentez-vous de ma ſœur, vieux thodis, Si vous la deſirez ie me fais forte d’elle;	Hé bien, contentez-vous de ma sœur, vieux thodis, Si vous la désirez Seigneur me fais forte d'elle;
Elle n’eſt moins que moy, propre, gentille & belle:	Elle n'est moins que moi, propre, gentille et belle:
Pour des biens elle en a (ie dis ſans vanité) dincapoar voandlerde lanccemte.	Pour des biens elle en a (ie dis sans vanité) dincapoar voandlerde lanccemette.
POLIANDRE.	POLYANDRE.
L’offre eſt tres-raiſonnable, & Monſieur, ſans excuſe, Nous deſobligera s’il faut qu’il la refuſe.	L'offre est très -raisonnable, et Monsieur, sans excuse, Nous désobligera s'il faut qu'il la refuse.
M IEREMIE.	M MEREMIE.
Vous liez mon eſprit d’vne obligation Contraire tout à fait à mon intention:	Vous liez mon esprit d'une obligation Contraire tout à fait à mon intention:
Et toutesfois forcé par voſtre courtaiſie, Ie vois par vos raiſors vainere ma fantaiſie:	Et toutefois forcé par votre courtaisie, Je vois par vos raisors vaine ma fantaisie:
Il faut qu’elle obeïſſe à vos commandemens, Quoy qu’elle ſente en ſoy d’étranges mouuemens.	Il faut qu'elle obéisse à vos commandements, Quoi qu'elle sente en soi d'étranges mouvements.
BELANGE.	BÉLANGE.
Cher amy, tu nous fais vn plaiſir indicible.	Cher ami, tu nous fais un plaisir indicible.
POLIANDRE.	POLYANDRE.
La paix d’entre vous deux nous oblige au poſſible.	La paix d'entre vous deux nous oblige au possible.
M.	M.
IEREMIE.	JEREMIE.
Oüy donc, executant les mots qui me ſont dits.	Oui donc, exécutant les mots qui me sont dits.
Mr KAROLV.	Mr AROLU.
Oüy, ce ſera pour vous Madame, vieux thodis.	Oui, ce sera pour vous Madame, vieux thodis.
ROSELIS.	ROSELIS.
Vous voila donc d’accord?	Vous voilà donc d'accord?
OIEINDE.	ÔIEINDE.
Mon Dieu, que i’en ſuis aiſe!	Mon Dieu, que j'en suis aise!
FLEVRIE.	FLEURIE.
pproche petit cœur, il faut que ie te baiſe.	pproche petit cœur, il faut que Un te baise.
Mr RAROLV.	Mr RAROLU.
etite follichon, tu n’as point de reſpect.	étite follichon, tu n'as point de respect.
FLEVRIE.	FLEURIE.
e ne vois pas icy quelqu’vn qui ſoit ſuſpect les Meſſieurs ont appris comme quoy ie vous aime, ar le reſſentiment de ma douleur extreme?	Je ne vois pas ici quelqu'avoir qui soit suspect les Messieurs ont appris comme quoi toujours vous aime, ar le ressentiment de ma douleur extrême?
ous leur eſtes, mon fils grandement obligé.	ous leur êtes, mon fils grandement obligé.
Mr KAROLV.	Mr AROLU.
t ne veux pas mourir ſans m’en eſtre vangé;	t ne veux pas mourir sans m'en être vengé;
i le Ciel quelque iour fait l’occaſion naiſtre, la bonne volonté ie leur feray paraiſtre.	y le Ciel quelque jour fait l'occasion naître, la bonne volontépris leur ferai paraître.
POLIANDRE.	POLYANDRE.
i vous eſtes, Monſieur, en reſolution l’vſer de recompenſe à noſtre affection:	y vous êtes, Monsieur, en résolution l'user de récompense à notre affection:
ous ne verrez iamais d’occaſions plus belles, oicy proche de nous trois ieunes Damoiſelles, ie qui nous eſperons d’eſtre vn iour les eſpoux, noſtre bon deſſein s’accorde auecques vous.	ous ne verrez jamais d'occasions plus belles, oici proche de nous trois jeunes Damoiselles, une qui nous espérons d'être un jour les époux, notre bon dessein s'accorde auecques Vous.
Mr KAROLV.	Mr AROLU.
Ious voilà ſurchargez de faueurs infinies;	Jous voilà surchargés de faveurs infinies;
ſon amour, qu’en dis.	son amour, qu'en dis.
tu, nos querelles finies, lous voyons maintenant que la felicité Ieut combler nos maiſons d’heur & proſperité, lous goûtons tout d’vn coup mille plaiſirs enſemble, G inij	tu, nos querelles finies, lous voyons maintenant que la félicité Jeut combler nos maisons d'heur et prospérité, lous goûtons tout d'un coup mille plaisirs ensemble, G inij
FLEVRIE.	FLEURIE.
Filles approchez vous.	Filles approchez -vous.
Hé bien, que vous en ſemble?	Hé bien, que vous en semble?
Ces Meſſieurs maintenant s’offrent pour vol maris, Ie croy qu’il s’en void peu de pareils à Paris.	Ces Messieurs maintenant s'offrent pour vol maris, Je crois qu'il s'en voit peu de pareils à Paris.
ROSELIS.	ROSELIS.
Adorables ſujets de l’amoureux ſeruage, C’eſt mettre trop long-temps le filence en vſage, Iuſques icy, la peur auecque les ſanglots Dans vn eſpoir douteux retenoit vos propos, Mais puis que le deſtin ne fait plus de menace, Et qu’il tourne rers nous vne riante race:	Adorables sujets de l'amoureux servage, C'est mettre trop longtemps le silence en usage, Jusques ici, la peur apprendre les sanglots Dans avoir douteux retenait vos propos, Mais puis que le destin ne fait plus de menace, Et qu'il tourne rers nous une riante race:
Ne penſons ſeulement qu’à Hre deſormais, Et que du temps paſſé l’on ne parle iamais.	Ne pensons seulement qu'à Hre désormais, Et que du temps passé l'on ne parle jamais.
FLORIANE.	FLORIANE.
Ie confeſſe, Monſieur, que la peur & la crainte A nos foibles eſprits ont donné telle atteinte, Que comme moy mes ſœurs ont toutes à la fois Perdu la noente des lens ce de la vorx.	Je confesse, Monsieur, que la peur et la crainte A nos faibles esprits ont donné telle atteinte, Que comme moi mes sœurs ont toutes à la fois Perdu la noente des lens ce de la vorx.
CLARISTE.	CLARISTE.
Pour moy i’en ſuis encor ſi puiſſamment eſmeuë, Que ie ne ſçay comment la langue me remuë.	Pour moi j'en suis encor si puissamment émue, Que ils ne sais comment la langue me remue.
SILINDE.	SILINDE.
Ie puis bien aſſeurer que l’apprehenſion N’a iamais fait ſur moy ſi forte impreſſſon:	Je puis bien assurer que l'appréhension N'a jamais fait sur moi si forte impressons:
Mais petit à petit ie ſens qu’elle me quitte.	Mais petit à petit mot sens qu'elle me quitte.
BELANGE.	BÉLANGE.
Ceit aiors qu’ene void nos deſirs à ſa ſuitte.	Ceit aiors qu'ène void nos désirs à sa suitte.
FLEVRIE.	FLEURIE.
Reſpondez donc, Silinde, à ces Meſſieurs icy?	Respondez donc, Silinde, à ces Messieurs ici?
Si vous le voulez bien, nous le voulons auſſi;	Si vous le voulez bien, nous le voulons aussi;
La fille rarement refuſe d’eſtre femme.	La fille rarement refuse d'être femme.
SILINDE.	SILINDE.
Il ſeroit mal ſeant que deuant vous, Madame, Aucune de nous trois entrepriſt de parler;	Il serait mal séant que devant vous, Madame, Aucune de nous trois entreprît de parler;
Par tout ſous voſtre eſprit le noſtre doit aller, Et ſuiuant de vos loix les plus obeïſi Etes, Si vous le deſirez nous en ſerons contentes.	Par tout sous votre esprit le nôtre doit aller, Et suivant de vos lois les plus obéissi Ères, Si vous le désirez nous en serons contentes.
Mr KAROLV.	Mr AROLU.
Meſſieurs, vous l’entendez, que deſirez-vous plus, P'as vne maintenant ne fait aucun refus;	Messieurs, vous l'entendez, que désirez-vous plus, P'as une maintenant ne fait aucun refus;
Prenez chacun la voſtre, & ſelon vos partages Allons executer vos quatre mariages.	Prenez chacun la vôtre, et selon vos partages Allons exécuter vos quatre mariages.
POLIANDRE.	POLYANDRE.
Madame, ſi iamais vn parfait amoureux d equelduelajcedea cladlel llsaleua, Ie luy veux diſputer vne faueur ſi grande, Puis qu’en vous poſſedant i’ay l’heur que ie demande.	Madame, si jamais un parfait amoureux d' equelduelajcedea cladlela llsaleua, Je lui veux disputer une faveur si grande, Puis qu'en vous possédant j'ai l'heur que je demande.
SILINDE.	SILINDE.
Monſieur, aſſeurément vous vous trompez au choix, Regardez que Silinde eſt la moindre des trois.	Monsieur, assurément vous vous trompez au choix, Regardez que Silinde est la moindre des trois.
Pourtant ſi voſtre amour deſire ma perſonne, Vn abſolu pouuoir ſur elle ie vous donne.	Pourtant si votre amour désire ma personne, Un absolu pouvoir sur elle ie vous donne.
ROSELIS.	ROSELIS.
Ie confeſſe, Madame, auecques verite, Que dans vos doux appas giſt ma felicité, Et que par le bonheur de voſtre iouyſſance, Ie ſeray le Phenix des Amans de la France.	Je confesse, Madame, avec vérité, Que dans vos doux appas gît ma félicité, Et que par le bonheur de votre jouissance, Je serai le Phenix des Amants de la France.
aſiiſelslos, Le Ciel vous a pourueu de tant de qualitez, Qu’elles m’ont preſqu’oſté toutes mes volontez;	asiiselslos, Le Ciel vous a pourvu de tant de qualités, Qu'elles m'ont presqu'ôté toutes mes volontés;
De ſorte qu’à preſent il ne m’en reſte qu’vne, Pour ſelon vos deſirs ſuiure vôtre fortune.	De sorte qu'à présent il ne m'en reste qu'une, Pour selon vos désirs suivre votre fortune.
BELANGE.	BÉLANGE.
Madame, puis qu’Amour comme ſon fauory Veut que preſentement ie ſois vôtre mary, Receuez ce baiſer d’vne bouche enflamée D’vn doux feu dont pour vous mon ame eſt conſõmée.	Madame, puis qu'Amour comme son favori Veut que présentement je sois votre mari, Recez ce baiser d'une bouche enflammée D'un doux feu dont pour vous mon âme est consommée.
FLORIANE.	FLORIANE.
Permettez-moy, Monſieur, d’éuiter l’accident, ue me pourroit cauſer vôtre baiſer ardent, Ie ne pourrois ſounfin vhem vide hame:	Permettez-moi, Monsieur, d'éviter l'accident, ue me pourrait causer votre baiser ardent, Je ne pourrais souhinfin vhém vide hame:
Toutesfois vſez en comme de vôtre femme.	Toutefois ussez en comme de votre femme.
FLEVRIE.	FLEURIE.
Sus, ſus, geſt aſſez dit, pour ne point differer;	Sus, sus, gest assez dit, pour ne point différer;
Allons diligemment les nopces preparer, Marchons mon amitié.	Allons diligemment les nopces préparer, Marchons mon amitié.
Mr KAROLV.	Mr AROLU.
Allons, chere Fleurie, Certes ie penſe encore que ie me remarie.	Allons, chère Fleurie, Certes sans pense encore que tu me remarie.
M.	M.
IEREMIE.	JEREMIE.
Or puis que tout chacun s’y trouue ſi content, Il faut que de ma part i’en faſſe tout aurant, Comme vn ieune galand monſtrant à la ieuneſſe Que pour faire l’amour il n’eſt que la vieilleſſe.	Or puis que tout chacun s'y trouve si content, Il faut que de ma part j'en fasse tout aurant, Comme un jeune galant montrant à la jeunesse Que pour faire l'amour il n'est que la vieillesse.
FLORIANE.	FLORIANE.
Permettez-moy, Monſieur, d’éuiter l’accident, ue me pourroit cauſer vôtre baiſer ardent, Ie ne pourrois ſounfin vhem vide hame:	Permettez-moi, Monsieur, d'éviter l'accident, ue me pourrait causer votre baiser ardent, Je ne pourrais souhinfin vhém vide hame:
Toutesfois vſez en comme de vôtre femme.	Toutefois ussez en comme de votre femme.
FLEVRIE.	FLEURIE.
Sus, ſus, geſt aſſez dit, pour ne point differer;	Sus, sus, gest assez dit, pour ne point différer;
Allons diligemment les nopces preparer, Marchons mon amitié.	Allons diligemment les nopces préparer, Marchons mon amitié.
Mr KAROLV.	Mr AROLU.
Allons, chere Fleurie, Certes ie penſe encore que ie me remarie.	Allons, chère Fleurie, Certes sans pense encore que tu me remarie.
M.	M.
IEREMIE.	JEREMIE.
Or puis que tout chacun s’y trouue ſi content, Il faut que de ma part i’en faſſe tout aurant, Comme vn ieune galand monſtrant à la ieuneſſe Que pour faire l’amour il n’eſt que la vieilleſſe.	Or puis que tout chacun s'y trouve si content, Il faut que de ma part j'en fasse tout aurant, Comme un jeune galant montrant à la jeunesse Que pour faire l'amour il n'est que la vieillesse.
