A MONSEIGNEUR MONSEIGNEUR LE CARDINAL DUC DE NICIELIEC.	À MONSEIGNEUR MONSEIGNEUR LE CARDINAL DE NE NICIELIC.
MONSEIGNEVR, E n’aurois iamai eu la temerité de preſenter à Voſtre Eminence ce mauuais portrait d’Horace, ſi ie n’euſſe cõſideré qu’apres tant de bien faits, que i’ay reçeus d’elle, le ſilence, où mon reſpect m’a retenu iuſqu’à preſent, paſſeroit pour ingratitude, & que quelque juſte defiance que i’aye de mon trauail, ie dois auvir encore plus de confiance en voſtre bonté.	MONSEIGNEUR, E n'aurais jamai eu la témérité de présenter à Votre Eminence ce mauvais portrait d'Horace, si je n'eusse cõsideré qu'après tant de bien faits, que j'ai reçus d'elle, le silence, où mon respect m'a retenu jusqu'à présent, passerait pour ingratitude, et que quelque juste défiance que j'aie de mon trauail, je dois auvir encore plus de confiance en votre bonté.
C’eſt d’elle que ie tiens tous ce que ie ſuis;	C'est d'elle que votre tiens tous ce que je suis;
& ce n’eſt pas ſans rougir que pour toute reconnoiſſance ie vous fais vn preſent ſi peu digne de Vous, & ſi peu proportionné à ce que ie vous dois.	et ce n'est pas sans rougir que pour toute reconnaissance ici vous fais un présent si peu digne de Vous, et si peu proportionné à ce que je vous dois.
Mais dans cette confuſion, qui m’eſt commune auec tous ceux qui eſcriuent, i’ay cet aduantage, qu’on ne peut ſans quelque iniuſtice condamner mon choix, & que ce genereux Romain que ie mets aux pies de V.	Mais dans cette confusion, qui m'est commune avec tous ceux qui écrivent, j'ai cet avantage, qu'on ne peut sans quelque injustice condamner mon choix, et que ce généreux Romain que je mets aux pies de V.
E.	E.
euſt pù paroiſtre deuant elle auec moins de honte, ſi les forces de l’Artiſan euſfent reſpondu à la dignité de la matiere, I’en ay pour garand l’Autheur dont ie l’ay tiree, qui commence à décrire cette fameuſe Hiſtoire par ce glorieux Eloge, qu’il n’y a preſque aucune choſe plus noble dans toute l’Antiquité.	Est pitié paraître devant elle avec moins de honte, si les forces de l'Artisan eussent répondu à la dignité de la matière, J'en ai pour garand l'Auteur dont quelque l'ai tirée, qui commence à décrire cette fameuse Histoire par ce glorieux Éloge, qu'il n'y a presque aucune chose plus noble dans toute l'Antiquité.
Ie voudrois que ce qu’il a dit de l’action ſe peuſt dire de la peinture que i’en ay faite, non pour en tirer plus de vanité, mais ſeulement pour vous offrir quelque choſe vn peu moins indigne de vous eſtre offert.	Je voudrais que ce qu'il a dit de l'action se pût dire de la peinture que j'en ai faite, non pour en tirer plus de vanité, mais seulement pour vous offrir quelque chose un peu moins indigne de vous être offert.
Le ſuiet eſtoit capable de plus de graces s’il euſt eſté traité d’vne main plus ſçavante, mais du moins il à receu de la mienne toutes celles qu’elle eſtoit capable de luy donner, & qu’on pouuoit raiſonnablement attendre d’vne Muſe de Province, qui n’eſtant pas aſſez heureuſe pour iouir ſouuent des regards de V.	Le sujet était capable de plus de grâces s'il eût été traité d'une main plus savante, mais du moins il à reçu de la mienne toutes celles qu'elle était capable de lui donner, et qu'on pouvait raisonnablement attendre d'une Muse de Province, qui n'étant pas assez heureuse pour jouir souvent des regards de V.
E.	E.
n’a pas les meſmes lumieres à ſe conduire qu’ont celles qui en ſont continuellement eſclairées.	n'a pas les mêmes lumières à se conduire qu'ont celles qui en sont continuellement éclairées.
Et certes, Monſeigneur, ce changement viſibile qu’on remarque en mes Ouurages, depuis que i’ay l’honneur d’eſtre à V.	Et certes, Monseigneur, ce changement visibile qu'on remarque en mes Ouvrages, depuis que j'ai l'honneur d'être à V.
E.	E.
qu’eſtce autre choſe qu’vn effet des grandes Idées qu’elle m’inſpire quand elle daigne ſouffrir que ie luy rende mes deuoirs;	qu'estce autre chose qu'un effet des grandes Idées qu'elle m'inspire quand elle daigne souffrir que de lui rende mes devoirs;
& a quoi peut-on attribuer ce qui s’y meſle de mauuais qu’aux teintures großieres que ie reprends quand ie demeure abandonné à ma propre foibleſſe?	et a quoi peut-on attribuer ce qui s'y mêle de mauvais qu'aux teintures grossières que Ne reprends quand elle demeure abandonné à ma propre faiblesse?
Il faut Monſeigneur, que tous ceux qui donnent leurs veilles au Theatre, publient hautement auec moy que nous vous auons deux obligations tres ſignaſées;	Il faut Monseigneur, que tous ceux qui donnent leurs veilles au Théâtre, publient hautement avec moi que nous vous avons deux obligations très signasées;
l’vne d’auoir ennobly le but de l’Art, l’autre de nous en auoir facilité les connoiſſances.	l'une d'avoir ennobli le but de l'Art, l'autre de nous en avoir facilité les connaissances.
Vous aueZ ennobly le but de l’Art, puis qu’au lieu de ceIuy de plaire au peuple, que nous preſcriuent nos Maiſtres, & dont les deux plus honneſtes gens de leur ſiecle, Scipion & Lelie, ont autrefois pro teſté de ſe contenter, vous nous aueZ donné celuy de vous plaire & de vous diuertir;	Vous avez ennobli le but de l'Art, puis qu'au lieu de ceIui de plaire au peuple, que nous prescrivent nos Maîtres, et dont les deux plus honnêtes gens de leur siècle, Scipion et Lelie, ont autrefois pro prote de se contenter, vous nous avez donné celui de vous plaire et de vous divertir;
& qu’ainſi uous ne rendons pas un petit ſervice à l’Eſtat, puiſque contribuant à vos divertiſſemens, nous contribuons à I’entretien d’vne ſanté qui luy eſt ſi precieuſe & ſi neceſſaire.	et qu'ainsi -vous ne rendons pas un petit service à l'État, puisque contribuant à vos divertissements, nous contribuons à J'entretien d'une santé qui lui est si précieuse et si nécessaire.
pons nomen auez fattint tes tonnoiſſanſances, puiſque nous n’auons plus beſoin d’autre eſtude pour les acquerir, que d’attacher nos yeux ſur V.	pons nomen avez fattint tes tonnoissansances, puisque nous n'avons plus besoin d'autre étude pour les acquérir, que d'attacher nos yeux sur V.
E.	E.
quand elle honnore de ſa preſence & de ſon attention le recit de nos Poëmes.	quand elle honore de sa présence et de son attention le récit de nos Poèmes.
C’eſt là que liſant ſur ſon viſage ce qui luy plaiſt, & ce qui ne luy plaiſt pas:	C'est là que lisant sur son visage ce qui lui plaît, et ce qui ne porte plaît pas:
nous nous inſtruiſons auec certitude de ce qui eſt bon, & de ce qui eſt mauuais, & tirons des regles infaillibles de ce qu’il faut ſuiure & de ce qu’il faut euiter.	nous nous instruisons avec certitude de ce qui est bon, et de ce qui est mauvais, et tirons des règles infaillibles de ce qu'il faut suivre et de ce qu'il faut éviter.
C’eſt la que i’ay ſouuent appris en deux heures ce que mes liures n’euſſent pû m’apprendre en dix ans;	C'est la que j'ai souvent appris en deux heures ce que mes livres n'eussent pu m'apprendre en dix ans;
c’eſt là que i’ay puiſé ce qui m’a valu l’applaudiſſement du Publie, & c’eſt là qu’auec voſtre faueur i’eſpere puiſer aſſez pour eſtre vn iour vne œuure digne de vos mains.	c'est là que j'ai puisé ce qui m'a valu l'applaudissement du Publie, et c'est là qu'avec votre faveur j'espère puiser assez pour rendre jour une œuvre digne de vos mains.
Ne trouueZ, donc pas mauuais, Monſeigneur, que pour vous remercier de ce que i’ay de reputation, dont ie vous ſuis entierement redeuable, i’imprunte quatre vers d’vn autre Horace que celuy que ie vous preſente, & que ie vous exprime par eux les plus veritables ſentimens de mon ame.	Ne trouvez, donc pas mauvais, Monseigneur, que pour vous remercier de ce que j'ai de réputation, dont je vous suis entièrement recevable, j'imprunte quatre vers d'un autre Horace que celui que je vous présente, et que je vous exprime par eux les plus véritables sentiments de mon âme.
Totum muneris hoc tui eſt.	Totum munéris hoc tui est.
Quod monſtror digito prætereuntium Scenæ non levis aitifex, Quod ſpiro & placeo, ſi placeo, tuum eſt.	Quod montror digito præteuntium Scenæ non levis aitifex, Quod spiro et placeo, si placeo, tuum est.
Ie n’adiouſteray qu’vne verité à cellecy, en vous ſuppliant de tiuite que le jaur e feray toute ma vis tres paßionnement.	Je n'ajouterai qu'une vérité à cellecy, en vous suppliant de tuite que le jaur ai toute ma vis très passionnément.
MONSEIGNEVR,	MONSEIGNEUR,
De V.	De V.
E.	E.
Le tres humble, tres-obeïſſant & tresfidelle ſerviteur.	Le très humble, très-obeïssant et tresfidelle serviteur.
CORNEILLE.	CORNEILLE.
d E 3	d E 3
LES ACTEURS.	LES ACTEURS.
TVLLE, Roy de Rome.	TULE, Roi de Rome.
Le vieit HORACE, Cheuaner Romain.	Le vieit HORACE, Chevaner Romain.
HORACE, ſon fils.	HORACE, son fils.
CVRIACE, Gentil homme d’Albe, Amant de Camille.	CURICE, Gentil homme d'Albe, Amant de Camille.
minmmueuponmnalier Romain amoureux de Camille.	minmueuponmnalier Romain amoureux de Camille.
SADINE, femme a Hoiuce, o faur ue Curiace.	SADINE, femme a Hoivce, ô saur ue Curiace.
CAMILLE, Amante de Curiace & ſœur d’Horace.	CAMILLE, Amante de Curiace et sœur d'Horace.
IVLIE, Dame Romaine, Confidante de Sabine & de Camille.	IVLIE, Dame Romaine, Confidante de Sabine et de Camille.
FLAVIAN, ſoldat de l’armée d’Albe,	FLAVIAN, soldat de l'armée d'Albe,
PROEVHE, fouuruobummee de Rome.	PROUHÉ, fouuruobummee de Rome.
La Scene eſt à Rome dans une ſale de la maiſon d’Horace.	La Scène est à Rome dans une sale de la maison d'Horace.
HORA	HORA
HORACE TRAGEDIE.	HORACE -TRAGÉDIE.
ACTE PREMIER.	ACTE PREMIER.
SCENE PREMIERE.	SCÈNE PREMIÈRE.
SABINE, IVLIE.	SABINE, IVLIE.
98 E ſa s 9 M SABINE.	98 E sa sau9 M SABINE.
Pprouuez ma foibleſſe, & ſouffrez ma douleur, Elle n’eſt que trop juſte en vn ſi grand mal-heur;	Pprouvez ma faiblesse, et souffrez ma douleur, Elle n'est que trop juste en un si grand malheur;
Si prez de voir ſur ſoy fondre de tels orages, L’eſbranlement ſied bien aux plus fermes courages, Et l’eſprit le plus maſle & le moins abbatu Ne ſçauroit ſans deſordre exercer ſa vertu.	Si prendrez de voir sur soi fondre de tels orages, L'ébranlement sied bien aux plus fermes courages, Et l'esprit le plus mâle et le moins abattu Ne saurait sans désordre exercer sa vertu.
Quoy que le mien s’eſtonne à ces rudes alarmes, Le trouble de mon cœur ne peut tien ſur mes larmes, Et parmy les ſoûpirs qu’il pouſſe vers les Cieux, Ma cõſtance du moins regne encor ſur mes yeux.	Quoi que le mien s'étonne à ces rudes alarmes, Le trouble de mon cœur ne peut tien sur mes larmes, Et parmi les soupirs qu'il pousse vers les Cieux, Ma compstance du moins règne encor sur mes yeux.
Quund dnarcerte la ſes depiuimto d vnie umie, Si l’on fait moins qu’vn homme, on fait plus qu’vne femme:	Quund dnarcerte la ses dépiuimto d unie umie, Si l'on fait moins qu'un homme, on fait plus qu'une femme:
Commander à ſes pleurs en cette extremité, C’eſt monſtrer pour le ſexe aſſez de fermeté.	Commander à ses pleurs en cette extrémité, C'est montrer pour le sexe assez de fermeté.
VLIE.	VLIE.
C’en eſt aſſés, & trop pour vne ame commune, Qui du moindre peril n’attend qu’vne infortune, A4 uvlaD'vn tel abaiſſement vn grand cœur eſt honteux.	C'en est assez, et trop pour une âme commune, Qui du moindre péril n'attend qu'une infortune, A4 uvlaD' tel abaissement un grand cœur est honteux.
Il oſe eſperer tout dans vn ſuccés douteux.	Il ose espérer tout dans un succès douteux.
Les deux camps ſont rangez au pied de nos murailles, (batailles, Mais Rome ignore encor comme on perd des Loin de trembler pour elle, il luy faut applaudir, Puis qu’elle va combatre, elle va s’agrandir:	Les deux camps sont rangés au pied de nos murailles, (batailles, Mais Rome ignore encor comme on perd des Loin de trembler pour elle, il lui faut applaudir, Puis qu'elle va combattre, elle va s'agrandir:
Banniſſés, banniſſés vne frayeur ſi vaine, Et concevés des vœux dignes d’vne Romaine.	Bannissez, bannissez une frayeur si vaine, Et concevez des vœux dignes d'une Romaine.
SABINE.	SABINE.
Ie ſuis Romaine, helas!	Je suis Romaine, hélas!
puiſque mon eſpous l’eſt;	puisque mon épous l'est;
L’Hymen me fait de Rome embraſſer l’intereſt, Mais il tiendroit mõ ame en eſclaue enchaiſnée.	L'Hymen me fait de Rome embrasser l'intérêt, Mais il tiendrait mon âme en esclave enchaînée.
S’il m’oſtoit le penſer des lieux où ie ſuis née.	S'il m'ôtait le penser des lieux où tu suis née.
Albe où i’ay commencé de reſpirer le iour, Albe mon cher pays & mon premier amout, Quãd entre nous & toy ie voy la guerre ouuerte, Ie crains noſtre victoire autant que noſtre perte.	Albe où j'ai commencé de respirer le jour, Albe mon cher pays et mon premier amout, Quand entre nous et toi personne vois la guerre ouuerte, Je crains notre victoire autant que notre perte.
Rome, ſi tu te plains que c’eſt là te trahit, Fay-toy des ennemis que ie puiſſe hair:	Rome, si tu te plains que c'est là te trahit, Fais-toi des ennemis que ie puisse haïr:
ſtre, Quand ie voy de tes murs leur armée & la noMes trois freres dans l’vne, & mon mary dans l'autre.	stre, Quand der vois de tes murs leur armée et la noMes trois frères dans l'une, et mon mari dans l'autre.
Puiſ-je former des vœux, & ſans impieté Importuner le Ciel pour ta felicité?	Puis-je former des vœux, et sans impiété Importuner le Ciel pour ta félicité?
Ie ſçay que ton Eſtat encore en ſa naiſſance Ne ſçauroit, ſans la guerre, affermir ſa puiſſance:	Je sais que ton État encore en sa naissance Ne saurait, sans la guerre, affermir sa puissance:
Ie ſçay qu’il doit s’accroiſtre, & que tes bons Deſtins Ne le borneront pas chez les peuples Latins, Que les Dieux t’ont promis l’Empire de la terre, Et que tu n’en peux voir l’effet que par la guerre.	Je sais qu'il doit s'accroître, et que tes bons Destins Ne le borneront pas chez les peuples Latins, Que les Dieux t'ont promis l'Empire de la terre, Et que tu n'en peux voir l'effet que par la guerre.
Bien loin de m’oppoſer à cette noble ardeur Qui ſuit l’arreſt des Dieux, & court à ta grãdeur, Ie voudrois déja voir tes troupes couronnées D'vn pas victorieux franchir les Pyrenees;	Bien loin de m'opposer à cette noble ardeur Qui suit l'arrêt des Dieux, et court à ta grandeur, Je voudrais déjà voir tes troupes couronnées D'un pas victorieux franchir les Pyrènes;
Vaiuſque en l’Orient pouſſer tes bataillons, Va ſur les bords du Rhin planter tes pauillons, Fay trẽbler ſous tes pas les colomnes d’Hercule, Mais reſpecte vne ville à qui tu dois Romule;	Vaisusque en l'Orient pousser tes bataillons, Va sur les bords du Rhin planter tes pavillons, Fais trẽbler sous tes pas les colomnes d'Hercule, Mais respecte une ville à qui tu dois Romule;
Ingrate, ſouuien toy que du ſang de ſes Rois Tu tiens ton nom, tes murs, & tes premieres loix;	Ingrate, souvien toi que du sang de ses Rois Tu tiens ton nom, tes murs, et tes premières lois;
Albe eſt ton origine, arreſte, & conſidere Que tu portes le fer dans le ſein de ta mere, Tourne ailleurs les efforts de tes bras triomphãs, Sa joye eſclatera dans l’heur de ſes enfans, Et ſe laiſſant rauir à l’amour mateinelle, Ses veux ſeront pour toy, ſi tu n’es plus cõtre elle.	Albe est ton origine, arrête, et considere Que tu portes le fer dans le sein de ta -mère, Tourne ailleurs les efforts de tes bras triomphants, Sa joie éclatera dans l'heur de ses enfants, Et se laissant ravir à l'amour mateinelle, Ses veux seront pour toi, si tu n'es plus comme elle.
IVLIE.	IVLIE.
Ce diſcours me ſurprend, veu que depuis le temps Qu’on a contre ſon peuple armé nos combatans, Ie vous ay veu pour elle autant d’indifference, Que ſi dedãs nos murs vous auiez pris naiſlance:	Ce discours me surprend, vu que depuis le temps Qu'on a contre son peuple armé nos combattants, Je vous ai vu pour elle autant d'indifférence, Que si dedans nos murs vous aviez pris naislance:
I’admirois la Vertu qui reduiſoit en vous Vos plus chers intereſts à ceux de voſtre eſpous, Et ie vous confolois au milieu de vos plaintes, Cõme ſi noſtre Rome euſt fait toutes vos craintes.	J'admirais la Vertu qui réduisait en vous Vos plus chers intérêts à ceux de votre épous, Et ie vous consolais au milieu de vos plaintes, Comme si nôtre Rome eût fait toutes vos craintes.
SABINE.	SABINE.
bats Tant qu’on ne s’eſt choqué qu’en de legers comTtop foible pour ietter vn des partis à bas, Tant qu’vn eſpoir de paix a peu flater ma peine, Oüy, i’ay fait vanité d’eſtre toute Romaine.	bats Tant qu'on ne s'est choqué qu'en de légers comTtop faible pour jeter un des partis à bas, Tant qu'un espoir de paix a peu flatter ma peine, Oui, j'ai fait vanité d'être toute Romaine.
Si i’ay veu Rome heuteuſe auec quelque regret, Soudaîn i’ay condamné ce mouuement ſecret;	Si j'ai vu Rome heuteuse avec quelque regret, Soudaînt j'ai condamné ce mouvement secret;
Et ſi i’ay reſſenty dans ſes deſtins contraïres Quelque maligne joye en faueur de mes freres, Soudain pour l’eſtouffer rappellant ma raiſon, I’ay pleuré quand la gloire entroit dans leur maiſon.	Et si j'ai ressenti dans ses destins contraïres Quelque maligne joie en faveur de mes frères, Soudain pour l'étouffer rappelant ma raison, J'ai pleuré quand la gloire entrait dans leur maison.
tombe, Mais auiourd’huy qu’il faut que l’vne ou l'autre Qu'Albe deuienne eſclave, ou que Rome ſuccombe, A 5 Et Et qu’aptes la bataille il ne demeure plus Ny d’obſtacle aux vainqueurs, ny d’eſpoir aux vaincus, I’aurois pour mon pays vne cruelle haine Si ie pouuois encore eſtre toute Romaine, Et ſi ie demandois voſtre triomphe aux Dieux, Au prix de tant de ſang qui m’eſt ſi precieux.	tombe, Mais aujourd'hui qu'il faut que l'une ou l'autre Qu'Albe devienne esclave, ou que Rome succombe, A 5 Et Et qu'aptes la bataille il ne demeure plus Ni d'obstacle aux vainqueurs, ni d'espoir aux vaincus, J'aurais pour mon pays une cruelle haine Si ie pouuois encore être toute Romaine, Et si ie demandois votre triomphe aux Dieux, Au prix de tant de sang qui m'est si précieux.
Ie m’attache vn peu moins aux intereſts d’vn homme, (Rome, Ie ne ſuis point pour Albe, & ne ſuis plus pour Ie crains pour l’vne & l'autre en ce dernier effort, Et ſeray du party qu’affligera le ſort.	Je m'attache un peu moins aux intérêts d'un homme, (Rome, Je ne suis point pour Albe, et ne suis plus pour Je crains pour l'une et l'autre en ce dernier effort, Et serai du parti qu'affligera le sort.
Eſgale à tous les deux iuſques à la victoire, Ie prendray part aux maux, ſans en preudre à la gloire, Et gulde, en ateendant les funentes pig̨ueals, Mes larmes aux vaincus, & ma haine aux vainqueurs,	Égale à tous les deux jusqu' à la victoire, Je prendrai part aux maux, sans en preudre à la gloire, Et gulde, en ateendant les funentes piguveals, Mes larmes aux vaincus, et ma haine aux vainqueurs,
VLIE.	VLIE.
Qu’on voit naiſtre ſouuent de pareilles trauerſes En des eſprits diuers des paſſions diverſes, Et qu’en cecy Camille agit bien autrement!	Qu'on voit naître souvent de pareilles traverses En des esprits divers des passions diverses, Et qu'en ceci Camille agit bien autrement!
Son frere eſt voſtre eſpous, le voſtre eſt ſon amãt, Mais elle voit d’vn œil bien different du voſtre, Son ſang dans vne armée, & ſon amour dans l’autre.	Son frère est votre épous, le vôtre est son amants, Mais elle voit d'un œil bien différent du vôtre, Son sang dans une armée, et son amour dans l'autre.
Lors que vous conſeruiez vn eſprit tout Romain Le ſien irreſolu, tremblotant, incertain, De la moindre meſlée apprehendoit l’orage, De tous les deux partis deteſtoit l’auantage, Au malheur des vaincus donnoit touſiours ſes pleurs, Et nourriſſoit ainſi d’eternelles douleurs.	Lors que vous conserviez un esprit tout Romain Le sien irrésolu, tremblotant, incertain, De la moindre mêlée appréhendait l'orage, De tous les deux partis détestait l'avantage, Au malheur des vaincus donnait toujours ses pleurs, Et nourrissait ainsi d'éternelles douleurs.
née, Mais hier, quand elle ſceut qu’on auoit pris iourEt qu’en fin la bataille alloit eſtre donnée, Vne ſoudaine ioye eſclata ſur ſon front.	née, Mais hier, quand elle sut qu'on avait pris jourEt qu'en fin la bataille allait être donnée, Une soudaine joie éclata sur son front.
SABINE.	SABINE.
Ah!	Ah!
que ie crains, lulie, vn chãgement ſi plompu Hier dans ſa belle humeur elle entretint Valere, Pour ce riual, ſans doute, elle quitte mon frere, Son eſprit eſbranlé par les obiets preſens (ans.	que ici crains, lulie, un chemgement si plompu Hier dans sa belle humeur elle entretint Valère, Pour ce rival, sans doute, elle quitte mon frère, Son esprit ébranlé par les objets presens (ans.
Ne trouue point d’abſent aymable apres deux Mais excuſez l’ardeur d’vne amour fraternelle, Le ſoin que i’ay de luy me fait craindre tout d’elle Ie forme des ſoupçons d’vn ſuiet trop leger, Le iour d’vne bataille eſt mal propre à changer.	Ne trouve point d'absent aimable après deux Mais excusés l'ardeur d'une amour fraternelle, Le soin que j'ai de Seigneur me fait craindre tout d'elle Je forme des soupçons d'un sujet trop léger, Le jour d'une bataille est mal propre à changer.
D’vn nouueau trait alors peu d’ames ſõt bleſſées, Et dans vn ſi grand trouble on a d’autres penſées:	D'un nouveau trait alors peu d'âmes sont blessées, Et dans un si grand trouble on a d'autres pensées:
Mais on n’a pas auſſi de ſi gays entretiens, Ny de contentemẽts qui ſoient pareils aux ſiens, IVLIE.	Mais on n'a pas aussi de si gais entretiens, Ni de contentements qui soient pareils aux siens, JVLIE.
obſcures, Les cauſes, comme à vous, m’en ſemblent foit	obscures, Les causes, comme à vous, m'en semblent soit
Ie ne me ſati fais d’aucunes conjectures, C’eſt aſſez de conſtance en vn ſi grand danger Que de le voir, l’attendre, & ne point s’affliger, Mais certes c’en eſt trop d’aller iuſque à la ioye.	Je ne me satî fais d'aucunes conjectures, C'est assez de constance en un si grand danger Que de le voir, l'attendre, et ne point s'affliger, Mais certes c'en est trop d'aller jusque à la joie.
ABINE.	ÀBINE.
Voyez qu’vn bon Genie à propos nous l’enuoye.	Voyez qu'un bon Génie à propos nous l'envoie.
Eſſayez fur ce poinct à la faire parler, Elle vous ayme aſſez pour ne vous rien celer.	Essayez fur ce point à la faire parler, Elle vous aime assez pour ne vous rien celer.
Ie vous laiſſe.	Je vous laisse.
Ma ſœur, entretenez Iulie, I’ay honte de monſtrer tant de melancolie, Et mon cœur accablé de mille déplaiſirs, cherene la iontude à cacner les loulpiis.	Ma sœur, entretenez Julie, J'ai honte de montrer tant de mélancolie, Et mon cœur accablé de mille déplaisirs, chérène la jontude à cacerner les loulpiis.
SCENE II.	SCÈNE II.
CAMILLE, IVLIE.	CAMILLE, IVLIE.
CAMILLE.	CAMILLE.
DOurquoy fuyr, & vouloir que ie vous entretienne ?	DOurquoy fuir, et vouloir que je vous entretienne ?
Croit-elle ma douleur moins vive que la ſienne, Et que plus inſenſible à de ſi grands malheurs A mes triſtes diſcours ie meſle moins de pleurs?	Croit-elle ma douleur moins vive que la sienne, Et que plus insensible à de si grands malheurs À mes tristes discours ie mêle moins de pleurs?
De pareilles frayeurs mon ame eſt alarmée, Cõme elle ie perdray dans l’vne & l’autre armée.	De pareilles frayeurs mon âme est alarmée, Comme elle avait perdrai dans l'une et l'autre armée.
Ie verray mon amant, mon plus vnique bien, Mourir pour ſon pays, ou deſtruire le mien:	Je verrai mon amant, mon plus unique bien, Mourir pour son pays, ou détruire le mien:
Et cét obiet d’amour deuenir pour ma peine	Et cet objet d'amour devenir pour ma peine
Ou digne de mes pleurs, ou digne de ma haine.	Ou digne de mes pleurs, ou digne de ma haine.
Helas!	Hélas!
IVLIE.	IVLIE.
Elle eſt pourtãt plus à plaindre que vous;	Elle est pourtant plus à plaindre que vous;
ſpous.	spous.
On peut changer d’amant, mais non changer d’eOubliez Cutiace, & receuez Valere, Vous ne tremblerez plus pour le party contraire, Vous ſerez toute noſtre, & voſtre eſprit remis N’aura plus rien à perdre au camp des ennemis.	On peut changer d'amant, mais non changer d'OUbliez Cutiace, et recevez Valère, Vous ne tremblerez plus pour le parti contraire, Vous serez toute notre, et votre esprit remis N'aura plus rien à perdre au camp des ennemis.
CAMILLE.	CAMILLE.
mes, Donnez moy des conſeils qui ſoient plus legitiEt plaignez mes malheurs ſans m’ordonner des crimes:	mes, Donnez -moi des conseils qui soient plus légitiEt plaignez mes malheurs sans m'ordonner des crimes:
Quoy qu’à peine à mes maux ie puiſſe reſiſter, I’ayme mieux les ſouffrir que de les meriter.	Quoi qu'à peine à mes maux Prince puisse résister, J'aime mieux les souffrir que de les mériter.
RVETER Quoy?	RUETER Quoi?
vous appellez crime vn chãge raiſonnable?	Vous appelez crime un chezge raisonnable?
CAMILLE.	CAMILLE.
ble?	blé?
Quoy?	Quoi?
le manque de foy vous ſemble perdonna	le manque de foi vous semble perdonna
VLIE.	VLIE.
Enuers vn ennemy qui nous peut obliger?	Envers un ennemi qui nous peut obliger?
CAMILLE.	CAMILLE.
D’vn ſerment ſolemnel qui nous peut deſgager?	D'un serment solennel qui nous peut dégager?
IVLIE.	IVLIE.
Vous deſguiſez en vain vne choſe trop claire, Ie vous vis encore hier entretenir Valere, Et l’accueil gracieux qu’il receuoit de vous Luy permet de nourrir vn eſpoir bien plus doux,	Vous déguisez en vain une chose trop claire, Je vous vis encore hier entretenir Valère, Et l'accueil grâce qu'il recevait de vous Lui permet de nourrir un espoir bien plus doux,
CAMILLE.	CAMILLE.
Siie l’entretins hier, & luy fis bon viſage, N’en	Siie l'entretins hier, et lui fis bon visage, N'en
a le lle n a lEo N’en imaginez rien qu’à ſon desaduantage, De mon contentement vn autre eſtoit l’obiet:	a le lèle n ' lEo N'en imaginez rien qu'à son désavantage, De mon contentement un autre était l'objet:
Mais pour ſortir d’erreur ſçachez en le ſuiet, Ie garde à Curiace vne amitié trop pure (jure, Pour ſouffrir plus long temps qu’on m’eſtime parQuelques cinq ou ſix mois apres que de ſa ſœur L’Hymenée euſt rendu mon frere poſſeſſeur (Vous le ſçauez Iulie) il obtint de mon pere Que de ſes chaſtes feux ie ſerois le ſalaire.	Mais pour sortir d'erreur sachez en le sujet, Je garde à Curiace une amitié trop pure (jure, Pour souffrir plus long temps qu'on m'estime parQuelques cinq ou six mois après que de sa sœur L'Hyménée eût rendu mon frère possesseur (Vous le savez Julie) il obtint de mon père Que de ses chastes feux Seigneur serais le salaire.
Ce iour nous fut propice & funeſte à la fois, Vniſſant nos maiſons il deſ-vnit nos Rois, (guerre En meſme inſtant conclud noſtre Hymen & la Fit naiſtre noſtre eſpoir & le ietta par terre, Nous oſta tout ſi toſt qu’il nous euſt tout promis, Et nous faiſant amant il nous fit ennemis, Combien nos deſplaiſirs parurent lors extremes, Combien contre le ciel il vomit de blaſphemes, Et combien de ruiſſeaux coulerent de mes yeux, Ie ne vous le dy point, vous viſtes nos Adieux, Vous auez veu depuis les troubles de mon ame, Vous ſçauez pour la paix quels vœux a fait ma flamme.	Ce jour nous fut propice et funeste à la fois, Unissant nos maisons il des-vnit nos Rois, (guerre En même instant conclu tôt Hymen et la Fit naître notre espoir et le jeta par terre, Nous ôta tout si tôt qu'il nous eût tout promis, Et nous faisant amant il nous fit ennemis, Combien nos déplaisirs parurent lors extrêmes, Combien contre le ciel il vomit de blasphères, Et combien de ruisseaux coulèrent de mes yeux, Ie ne vous le dis point, vous vite nos Adieux, Vous avez vu depuis les troubles de mon âme, Vous sauvez pour la paix quels vœux a fait ma flamme.
Et quels pleurs i’ay verſés à chaque euenement, Tantoſt pour mon pays, tantoſt pour mon amant.	Et quels pleurs j'ai versés à chaque événement, Tantôt pour mon pays, tantôt pour mon amant.
En fin mon deſeſpoir parmy ces longs obſtacles M’a fait auoir recours à la voix des oracles.	En fin mon désespoir parmi ces longs obstacles M'a fait avoir recours à la voix des oracles.
Eſcoutés ſi celuy qui me fut hier rendu Eut droit de r’aſſeurer mon eſprit eſperdu.	Écoutés si celui qui me fut hier rendu Eut droit de rassurer mon esprit éperdu.
Ce Grec ſi renommé qui depuis tant d’années Au pied de l’Auentin predit nos deſtinées, Luy qu’Appollon iamais n’a fait parler à fauk, Me promit par ces vers la fin de mes trauaux:	Ce Grec si renommé qui depuis tant d'années Au pied de l'Aventin prédit nos destinées, Lui qu'Apollon jamais n'a fait parler à favk, Me promit par ces vers la fin de mes travaux:
Albe & Rome demain prendront vne autre face, Tes vœux ſont exaucés, elles auront la paix Et tu ſeras unie auec ton Curiace Sans qu’aucun mauuais ſort t’en ſepare iamais.	Albe et Rome demain prendront une autre face, Tes vœux sont exaucés, elles auront la paix Et tu seras unie était ton Curiace Sans qu'aucun mauvais sort t'en sépare jamais.
Ie pris ſur cet Oracle vne entiere aſſeurance, Et comme le ſuccés paſſoit mon eſperance, I’abandonnay mon ame à des rauiſſemens Qui paſſoiẽt les tranſports des plus heureux amãts.	Je pris sur cet Oracle un entière assurance, Et comme le succès passait mon espérance, J'abandonnai mon âme à des ravissements Qui passaient les transports des plus heureux amants.
Iugez de leut excés.	Jugez de leut excès.
Ie renconttay Valere Et contre ſa couſtume il ne me pût déplaire, Il me parla d’amour ſans me donnere d’ennuy, Ie ne m’apperceus pas que ie parlois à luy, Ie ne luy pûs monſtrer de meſpris ny de glace.	Je rencontaitai Valère Et contre sa coutume il ne me put déplaire, Il me parla d'amour sans me donne d'ennui, Je ne m'aperçus pas que sans parlais à Seigneur, Je ne lui pûs montrer de mépris ni de glace.
Tout ce que ie voyois me ſembloit Curiace, Tout ce qu’on me diſoit me parloit de ſes feux, Tout ce que ie diſois l’aſſeuroit de mes vœux.	Tout ce que ici voyais me semblait Curiace, Tout ce qu'on me disait me parlait de ses feux, Tout ce que jour disais l'assurait de mes vœux.
Le combat general auiourd’huy ſe hazarde, I’en ſceus hier la nouuelle, & ie n’y pris pas garde, Mon eſprit reiettoit ces funeſtes obiets Charmè des doux penſers d’Hymen & de la paix.	Le combat général aujourd'hui se hasarde, J'en sceus hier la nouvelle, et autre n'y pris pas garde, Mon esprit rejettait ces funestes objets Charmèrent des doux pensers d'Hymen et de la paix.
La nuict a diſſipé des erreurs ſi charmantes, Mille ſonges affreux, mille images ſanglantes, Ou pluſtoſt mille amas de carnage & d’horreur M’ont atraché ma ioye & renduma terreur.	La nuit a dissipé des erreurs si charmantes, Mille songes affreux, mille images sanglantes, Ou plutôt mille amas de carnage et d'horreur M'ont atraché ma joie et renduma terreur.
I'ay veu du ſang, des morts, & n’ay rien veu de.	J'ai vu du sang, des morts, et n'ai rien vu de.
iuite, Vn ſpectre en paroiſſant prenoit ſoudain la fuite, Ils s’effaçoient I’vn l’autre, & chaque illuſion Redoubloit mon effroy par ſa confuſion.	juite, Un spectre en paraissant prenait soudain la fuite, Ils s'effaçaient J'un l'autre, et chaque illusion Rédoublait mon effroi par sa confusion.
IVLIE.	IVLIE.
C’eſt en contraire ſens qu’vn ſonge s’interprete.	C'est en contraire sens qu'un songe s'interprète.
CAMILLE.	CAMILLE.
Ie le auis eronc am puis que le le Iounaite, Mais ie me trouue en fin malgré tous me ſouhaits Au jour d’vne bataille & non pas d’vne paix.	Je le avis eronc am puis que le le Jounaite, Mais tu me trouve en fin malgré tous me souhaits Au jour d'une bataille et non pas d'une paix.
IVLIE.	IVLIE.
Par là finit la guerre, & la paix luy ſuccede.	Par là finit la guerre, et la paix Seigneur succède.
CAMILLE.	CAMILLE.
Dure à iamais le mal s’il y faut ce reméde!	Dure à jamais le mal s'il y faut ce reméde!
Soit que Rome y ſuccombe, ou qu’Albe ait le deſſous, Cher Cher amant n’attend plus d’eſtre vn iour mon eſpous, (ſomne) Mon cœur (quelque grand feu qui pour toy le conNe veut ny le vainqueur, ny l’eſclaue de Rome.	Soit que Rome y succombe, ou qu'Albe ait le dessous, Cher Cher amant n'attend plus d'être un jour mon épous, (somne) Mon cœur (quelque grand feu qui pour toi le conNe veutgez le vainqueur, ni l'esclave de Rome.
Mais quel obiet nouueau ſe preſente en ces lieux?	Mais quel objet nouveau se présente en ces lieux?
Ele ce toy curiace:	Éle ce toi curiace:
en croray le mles yeux?	en crorai le mles yeux?
SCENE III.	SCÈNE III.
CVRIACE, CAMILLE, IVLIE.	CURICE, CAMILLE, IVLIE.
CVRIACE.	CURICE.
’En doutés point, Camille, & renuoyés vn homme Qui n’eſt ny le vainqueur, ny l’eſclaue de Rome:	Ç'En doutés point, Camille, et renvoyez un homme Qui n'est ni le vainqueur, Seigneur l'esclaue de Rome:
Ceſſés d’aprehendet de voir rougir mes mains Du poids honteux des fers ou du ſang des Romains, I’ay creu que vous aymiez aſſés Rome & la gloire Pour meſpriſer ma chaiſne & hayr ma victoire, Et comme eſgalement en cette extremité Ie craignois la victoire & la capriuité.	Cessez d'appréhendet de voir rougir mes mains Du poids honteux des fers ou du sang des Romains, J'ai cru que vous aimiez assez Rome et la gloire Pour mépriser ma chaîne et haïr ma victoire, Et comme également en cette extrémité Je craignais la victoire et la caprivité.
CAMILLE.	CAMILLE.
Curiace, il ſuffit, ie deuine le reſte, Tu fuis vne bataille à tes vœus ſi funeſte.	Curiace, il suffit, Seigneur devine le reste, Tu fuis quelque bataille à tes vœus si funeste.
Et ton cœur tout à moy pour ne me perdre pas Deſiobe à ton pays le ſecours de ton bras Qu’vn autre conſidere icy ta renommée, Et te blaſme s’il veut de m’auoir trop aymée, Ce n’eſt point à Camille à t’en meſeſtimer, Plus ton amour paroiſt, plus elle doit t’aymer, Et ſi tu dois beaucoup aux lieux qui t’ont veu naiſtre, d.	Et ton cœur tout à moi pour ne me perdre pas Désiobe à ton pays le secours de ton bras Qu'un autre considère ici ta renommée, Et te blâme s'il veut de m'avoir trop aimée, Ce n'est point à Camille à t'en mésestimer, Plus ton amour paraît, plus elle doit t'aimer, Et si tu dois beaucoup aux lieux qui t'ont veu naître, d.
211 Plus tu quittes pour moy, plus tu le fais paroiſtre, Mais as-tu veu mon pere, & peut- il endurer Qu’ainſi dans ſa maiſon tu t’oſes retiter?	211 Plus tu quittes pour moi, plus tu le fais paraître, Mais as-tu vu mon père, et peut- il endurer Qu'ainsi dans sa maison tu t'oses retiter?
Ne prefere-t’il point l’Eſtat à ſa famille?	Ne préfère-t-il point l'État à sa famille?
Ne regarde t’il point Rome plus que ſa fille?	Ne regarde t'il point Rome plus que sa fille?
En fin noſtre bon heur eſt-il bien affermy?	En fin notre bon heur est-il bien affermi?
my?	mi?
I’a t’il veu comme gelldle ou oien comme enne	J'a t'il vu comme gellèdle ou oyen comme enne
CVRIACE.	CURICE.
Il m’a veu comme gendre auec vne tendreſſe, Qui teſmoignoit aſſez vne entiere allegreſſe:	Il m'a vu comme gendre auectaît tendresse, Qui témoignait assez entière allégresse:
Mais il ne m’a point veu par vne trahiſon Indigne de l’honneur d’entrer dans ſa maiſon.	Mais il ne m'a point vu par une trahison Indigne de l'honneur d'entrer dans sa maison.
Ie n’abandonne point l’intereſt de ma ville, I’ayme encor mon honneur en adorant Camille;	Je n'abandonne point l'intérêt de ma ville, J'aime encor mon honneur en adorant Camille;
Tant qu’a duré la guerre on m’a veu conſtamment Auſſi bon citoyen comme fidelle amant.	Tant qu'a duré la guerre on m'a vu constamment Aussi bon citoyen comme fidèle amant.
D’Albe auec mon amour i’accordois la querelle, le ſouſpirois pour vous en combatant pour elle;	D'Albe avec mon amour j'accordais la querelle, le soupirais pour vous en combattant pour elle;
Et s’il falloit encor que l’on en vint aux coups Ie combatrois pour elle en ſouſpirant pour vous.	Et s'il fallait encor que l'on en vint aux coups Je combatrais pour elle en soupirant pour vous.
Oüy, malgré les deſirs de mon ame charmée, Si la guerre duroit ie ſerois dans l’armée:	Oui, malgré les désirs de mon âme charmée, Si la guerre durait apprendre serais dans l'armée:
ces, C’eſt la paix qui chez vous me donne vn libre acLa paix à qui nos feux doiuent ce beau ſuccés.	ces, C'est la paix qui chez vous me donne un libre acLa paix à qui nos feux doivent ce beau succès.
CAMILLE.	CAMILLE.
La paix!	La paix!
& le moyen de croire vn tel miracle?	et le moyen de croire un tel miracle?
IVLIE.	IVLIE.
Camille pour le moins croyez en voſtre oracle.	Camille pour le moins croyez en votre oracle.
Et ſçachons pleinement par quels heureux effets L’heure d’vne bataille a produit cette paix.	Et sachons pleinement par quels heureux effets L'heure d'une bataille a produit cette paix.
CVRIACE.	CURICE.
mées Dieux, qui l’euſt iamais creu!	mens Dieux, qui l'eût jamais cru!
Deſia les deux arD’vne eſgale chaleur au combat animées Se menaçoient des yeux, & marchant fierement N’attendoient pour donner que le cõmandement, Quand noſtre Dictateur deuant les rangs s’avance, Demande à voſtre Prince vn moment de ſilence, Et l’ayant obtenu.	Déjà les deux arD'une égale chaleur au combat animées Se menaçaient des yeux, et marchant fièrement N'attendaient pour donner que le commandement, Quand notre Dictateur devant les rangs s'avance, Demande à votre Prince un moment de silence, Et l'ayant obtenu.
Que faiſons-nous, Romains, Dit-il, & quel Demon nous fait venir aux mains?	Que faisons-nous, Romains, Dit-il, et quel Démon nous fait venir aux mains?
Souffions que la raiſon eſclaire en fin nos ames, Nous	Souffions que la raison éclaire en fin nos âmes, Nous
ANAGEDIL.	ANAGEDIL.
11 Nous ſommes vos voiſins, nos filles ſont vos femmes.	11 Nous sommes vos voisins, nos filles sont vos femmes.
nœuds Et l’Hymen nous a ioints par tant & tant de Qu’il eſt peu de nos fils qui ne ſoient vos neueux, Nous ne ſommes qu’vn ſang, & qu’vn peuple en deux villes, Pourquoy nous deſchirer par des guerres civiles, Où la mort des vaincus affoiblit les vainqueuts, Et le plus beau triomphe eſt arrouſé de pleurs?	nœuds Et l'Hymen nous a joints par tant et tant de Qu'il est peu de nos fils qui ne soient vos neueux, Nous ne sommes qu'un sang, et qu'un peuple en deux villes, Pourquoi nous déchirer par des guerres civiles, Où la mort des vaincus affaiblit les vainqueuts, Et le plus beau triomphe est arrousé de pleurs?
Nos ennemis communs attendent auec joye Qu’vn des partis deffait leur dõne l’autre en proye, Laſſé, demy rõpu, vainqueur, mais pour tout fruit Deſnué d’vn ſecours par luy-meſme deſtruit.	Nos Ennemis communs attendent avec joie Qu'un des partis défait leur donné l'autre en proie, Lassé, demi répu, vainqueur, mais pour tout fruit Desnué d'autre secours par un-même détruit.
Ils ont aſſés long temps iouy de nos diuorces, Cõtre eux doreſnauant ioignons toutes nos forces Et noyons dans l’oubly ces petits differents Qui de ſi bons guerriers font de mauuais parents.	Ils ont assez long temps joui de nos divorces, Constre eux dorénavant joignons toutes nos forces Et noyons dans l'oubli ces petits différents Qui de si bons guerriers font de mauvais parents.
Que ſi l’ambition de commander aux autres (ſtres, Fait marcher auiourd’huy vos troupes & les noPourueu qu’à moins de fang nous voulions l’appaiſer, Elle nous vnira loin de nous diuiſer, Nommons des combatans pour la cauſe cõmune, Que chaque peuple aux ſiens attache ſa fortune, Et ſuiuant ce que d’eux ordonnera le ſort, Que le party plus foible obeiſſe au plus fort:	Que si l'ambition de commander aux autres (stres, Fait marcher aujourd'hui vos troupes et les noPourvu qu'à moins de sang nous voulions l'apaiser, Elle nous unira loin de nous diviser, Nommons des combattants pour la cause commune, Que chaque peuple aux siens attache sa fortune, Et suivant ce que d'eux ordonnera le sort, Que le parti plus faible obéisse au plus fort:
Mais ſans indignité pour des guerriers ſi braues, Qu’ils deuiennent ſuiets ſans deuenir eſclaués, Sans honte, ſans tribut & ſans autre rigeur, (queur.	Mais sans indignité pour des guerriers si braves, Qu'ils deviennent sujets sans devenir esclaués, Sans honte, sans tribut et sans autre rigeur, (queur.
Que de ſuiure en tous lieux les drapeaux du vainriintr lios cieur Eitats le feront qu’vn Empire.	Que de suivre en tous lieux les drapeaux du vainriintr ios cieur Eitats le feront qu'un Empire.
A ces mots il ſe taiſt, d’aiſe chacun ſouſpire, Chacun iettant les yeux dans vn rang ennemy Recognoiſt vn beaufrere, vn couſin, vn amy, Ils s’eſtonnent comment leurs mains de ſang aui	À ces mots il se taît, d'aie chacun soupire, Chacun jetant les yeux dans un rang ennemi Recognoist un beauffre, un cousin, un ami, Ils s'étonnent comment leurs mains de sang aujun
vOVoloient ſans y penſer à tant de parricides, Et font paroiſtre vn front couuert tout à la fois D’horteur pour la bataille, & d’ardeur pour ce choix.	vOUolaient sans y penser à tant de parricides, Et font paraître un front couvert tout à la fois D'horteur pour la bataille, et d'ardeur pour ce choix.
En fin l’offre s’accepte, & la paix deſirée Sous ces conditionis eſt auſſi-toſtiurée, (choiſir Trois combatront pour tous, mais pour les mieux Nos chefs ont voulu prendre vn peu plus de loiſir, Le voſtre eſt au Senat, le noſtre dans ſa tente.	En fin l'offre s'accepte, et la paix désirée Sous ces conditionis est aussi-tostiurée, (choisir Trois combatront pour tous, mais pour les mieux Nos chefs ont voulu prendre un peu plus de loisir, Le vôtre est au Sénat, le vôtre dans sa tente.
CAMILLE.	CAMILLE.
O Dieux, que ce diſcours rend mon ame contenté!	Ô Dieux, que ce discours rend mon âme contenté!
CVRIACE.	CURICE.
Dans deux heures au plus par vn commun accord Le ſort de nos guerriers reglera noſtre ſort, Cependant tout eſt libre attendant qu’on les nomme, (Rome, Rome eſt dans noſtre camp, & noſtre camp dans D’vn & d’autre coſté l’accés eſtant permis Chacun va renouër auec ſes vieux amis Pour moy, ma Paſſion m’a fait ſuiure vos freres, Et mes deſirs ont eu des ſuccés ſi proſperes, Que l’autheur de vos iours m’a promis à demain Le bon-neur lans paren de vous domiet la main.	Dans deux heures au plus par un commun accord Le sort de nos guerriers réglera notre sort, Cependant tout est libre attendant qu'on les nomme, (Rome, Rome est dans notre camp, et notre camp dans D'un et d'autre côté l'accès étant permis Chacun va renouer avec ses vieux amis Pour moi, ma Passion m'a fait suivre vos frères, Et mes désirs ont eu des succès si prospères, Que l'auteur de vos jours m'a promis à demain Le bon-neur lans paren de vous domiet la main.
Vous ne deuiendrez pas rebelle à ſa puiſſance?	Vous ne deviendrez pas rebelle à sa puissance?
CAMILLE.	CAMILLE.
Le deuoir d’vne fille eſt en l’obeiſſance.	Le devoir d'une fille est en l'obéissance.
CVRIACE.	CURICE.
Venes donc receuoir ce doux commandement Qui doit mettre le comble à mon contentement.	Venes donc recevoir ce doux commandement Qui doit mettre le comble à mon contentement.
CAMILLE.	CAMILLE.
Ie vay ſuiure vos pas, mais pour reuoir mes freres, Et ſçavoir d’eux encor la fin de nos miſeres.	Je vais suivre vos pas, mais pour revoir mes frères, Et savoir d'eux encor la fin de nos misères.
IVLIE.	IVLIE.
Allés, & cependant au pied de nos autels l’iray rendre pour vous graces aux immortels.	Allz, et cependant au pied de nos autels l'irai rendre pour vous grâces aux immortels.
Fin du premier Acte.	Fin du premier Acte.
ACTE	ACTE
TRAGE DIE.	TRAGE DIE.
ACTE II.	ACTE II.
SCENE PREMIERE, HORACE, CVRIACE.	SCÈNE PREMIÈRE, HORACE, CURIACE.
CVRIACE.	CURICE.
InſiRome n’a point ſeparé ſon eſtime, Elle euſt creu faire ailleurs vn choix illegitime, (vous Cette ſuperbe ville en vos freres & Ttouue le trois guerriers qu’elle prefere à tous, Et ne nous oppoſant d’autres bras que les voſtres D'vne ſeule maiſon braue toutes les noſtres:	InsiRome n'a point séparé son estime, Elle eût cru faire ailleurs un choix illégitime, (vous Cette superbe ville en vos frères et Ttouve le trois guerriers qu'elle préfère à tous, Et ne nous opposant d'autres bras que les vôtres D'une seule maison brave toutes les nôtres:
Nous croirons, la voyant toute entiere en vos mains, (mains:	Nous croirons, la voyant toute entière en vos mains, (mains:
Que hors les fils d’Horace il n’eſt poin de RoCe choix pouuoit comblet trois families de gloire.	Que hors les fils d'Horace il n'est poin de RoCe choix pouvait comblet trois families de gloire.
Conſacrer hautement leurs nom à la memoire, Ouy, l’honneur que reçoit la voſtre par ce choir En pouuoir à bon tiltre immortaliſer trois, Et puiſque c’eſt chez vous que mon heur & ma flame M’ont faict placer ma ſœur, & choiſir vne femme, Ce que ie vous dois eſtre & ce que ie vous ſuis Me font y prendre pait autant que ie le puis.	Consacrer hautement leurs nom à la mémoire, Oui, l'honneur que reçoit la vôtre par ce choir En pouvoir à bon titre immortaliser trois, Et puisque c'est chez vous que mon heur et ma flamme M'ont fait placer ma sœur, et choisir une femme, Ce que je vous dois être et ce que ie vous suis Me font y prendre paît autant que je le puis.
te, Mais vn autre intereſt tient ma ioye en contrainEt parmy ſes douceurs meſle beaucoup de crainte;	te, Mais un autre intérêt tient ma joie en contrainEt parmi ses douceurs mêle beaucoup de crainte;
La guerre en tel eſclat a mis voſtre valeur Que le trenioie poul Aibe & preuoy ion malheut, Puiſque vons combatez ſa perte eſt aſſurée, En vous faiſaut nommer le deſtin l’a iurée.	La guerre en tel éclat a mis votre valeur Que le trenioie poul Aibe et preuoi ion malheut, Puisque vons combattez sa perte est assurée, En vous faisaut nommer le destin l'a jurée.
Ie voy trop dans ce choix ſes funeſtes projets Et me conte deſia pour vn de vos ſuiets.	Je vois trop dans ce choix ses funestes projets Et me conte déjà pour un de vos sujets.
HORACE.	HORACE.
Loin de trembler pour Albe, il vous fau plaindre Rome, Veu Veu ceux qu’elle reiette & les trois qu’elle nomme, C’eſt vn aueuglement pour elle bien fatal D’auoir tant a choiſir & de choiſir ſi mal.	Loin de trembler pour Albe, il vous fau plaindre Rome, Veu ceux qu'elle rejette et les trois qu'elle nomme, C'est un aveuglement pour elle bien fatal D'avoir tant à choisir et de choisir si mal.
Mille de ſes enfans beaucoup plus dignes d’elle, Pouuoient bien mieux que nous ſouſtenir ſa querelle;	Mille de ses enfants beaucoup plus dignes d'elle, Pouvaient bien mieux que nous soutenir sa querelle;
cueil, Mais quoy que ce combat me promette vn cerLa gloire de ce choix m’enfle d’vn iuſte orgueil, Mon eſprit en conçoit vne maſle aſſeurance, I’oſe eſperer beaucoup de mon peu de vaillance, Et du ſort enuieux quels que ſoient les proiets Ie ne me conte point pour vn de vos ſuiets Rome a trop creu de moy, mais mon ame rauie Remplira ſon attente ou quittera la vie, Qui veut mourir, ou vaincre, eſt vaincu rarement, Ce noble deſeipoir perit maſaiſement :	cueil, Mais quoi que ce combat me promette un cerLa gloire de ce choix m'enfle d' iuste orgueil, Mon esprit en conçoit une mâle assurance, J'ose espérer beaucoup de mon peu de vaillance, Et du sort envieux quels que soient les prois -je ne me conte point pour un de vos sujets Rome a trop cru de moi, mais mon âme ravie Remplira son attente ou quittera la vie, Qui veut mourir, ou vaincre, est vaincu rarement, Ce noble deseipoir périt masaisement :
Rome, quoy qu’il en ſoit, ne ſera point ſuiette Que mes derniers ſouſpirs n’aſſeurent ma de faite.	Rome, quoi qu'il en soit, ne sera point suite Que mes derniers soupirs n'assurent ma de faite.
CVRIACE.	CURICE.
Helas, c’eſt bien icy que ie dois eſtre plaint!	Hélas, c'est bien ici que je dois être plaint!
Ce que veut mon pays, mon amitié le craint.	Ce que veut mon pays, mon amitié le craint.
Dures extremités, de voir Albe aſſernie Où ſa victoire au prix d’vne ſi chere vie, Et que l’vnique bien où tendent ſes deſits S’achepte ſeulement par vos derniers ſouſpirs?	Dures extrémités, de voir Albe assernie Où sa victoire au prix d'une si chère vie, Et que l'unique bien où tendent ses désits S'achepte seulement par vos derniers soupirs?
Quels veux puiſie former, & quel bonheur attendre?	Quels veux puisie former, et quel bonheur attendre?
dre, De tous les deux coſtés i’ay des pleurs à reſpanDe tous les deux coſtés mes defirs ſont trahis.	dre, De tous les deux côtés j'ai des pleurs à respanDe tous les deux côtés mes désirs sont trahis.
pays!	pays!
HORACE.	HORACE.
Quoy!	Quoi!
vous me pleureriez mourant pour mon Pour vn cœur genereux ce treſpas à des charmes, La gloire qui le ſuit ne ſouffre point de larmes, Et ie le receurois beniſſant mon ſort	vous me pleureriez mourant pour mon Pour un cœur généreux ce trépas à des charmes, La gloire qui le suit ne souffre point de larmes, Et tu le recevrais bénissant mon sort
Si Rome & tout l’Eſtat perdoient moins à ma mort.	Si Rome et tout l'État perdaient moins à ma mort.
C	Ç
CVRIACE.	CURICE.
A vos amis pourtant permettez de le craindre, Dans vn ſi beau treſpas ils ſont les ſeuls à plaindre, La gloire en eſt pour vous, & la perte pour eux:	À vos amis pourtant permettez de le craindre, Dans un si beau trépas ils sont les seuls à plaindre, La gloire en est pour vous, et la perte pour eux:
Il vous fait immortel & les rend malheureux, On perd tout quand on perd vn amy ſi fidelle, Mais Prauiaii m apporte icy quelque nouuelle, Albe de trois guerriers à t’elle fait le choix?	Il vous fait immortel et les rend malheureux, On perd tout quand on perd un ami si fidèle, Mais Praviai m apporte ici quelque nouvelle, Albe de trois guerriers à t'elle fait le choix?
SCENE II.	SCÈNE II.
HORACE, CVRIACE, FLAVIAN.	HORACE, CURIACE, FLAVIAN.
FLAVIAN.	FLAVIAN.
IE viens pour vous l’apprendre.	JE viens pour vous l'apprendre.
CVRIACE.	CURICE.
Et bien qui ſont les trois?	Et bien qui sont les trois?
FLAVIAN.	FLAVIAN.
Vos deux freres & vous.	Vos deux frères et vous.
CVRIACE.	CURICE.
Qui?	Qui?
FLAVIAN.	FLAVIAN.
oes ce vos deux freres.	oes ce vos deux frères.
Mais pourquoy ce front triſte & ſes regards ſeveres, Ce choix vous deſplaiſt-il?	Mais pourquoi ce front triste et ses regards sévères, Ce choix vous déplaît-il?
CVRIACE.	CURICE.
Non, mais il me ſurprend, le mi ertimois trop peu pour vn honneur ſi grand.	Non, mais il me surprend, le mi ertimais trop peu pour un honneur si grand.
FLAVIAN.	FLAVIAN.
Diray-ie au Dictateur qui deuers vous m’enuoye Que vous le receuez auec ſi peu de ioye?	Dirai-je au Dictateur qui devers vous m'envoie Que vous le recevez toujours si peu de joie?
tour.	tour.
Ce morne & froid accueil me ſurprend à mon	Ce morne et froid accueil me surprend à mon
CVRIACE.	CURICE.
Dy luy que l’amitié, l’alliance & l’amour Ne pourront empeſcher que les trois Curiaces Ne ſeruent leur pays contre les trois Horaces.	Dis lui que l'amitié, l'alliance et l'amour Ne pourront empêcher que les trois Curiaces Ne servent leur pays contre les trois Horaces.
FLA	FLA
FLAVIAN.	FLAVIAN.
mots!	mots!
concte eux dis, cert uraueoup me dire en peude	conte eux dis, cert uraveoup me dire en peude
VRIACE.	VRICE.
Porte luy ma reſponle & nous laiſſe en repos.	Porte nô ma réponle et nous laisse en repos.
CENE III.	CÈNE III.
CVRTACE, HORACE.	CURTACE, HORACE.
CVRIACE.	CURICE.
Ve deſormais le Ciel, les Enfers, & la terre 2Vniſſent leurs fureurs à nous faire la guerre, Que les hommes, les Dieux, les Demons & le ſont Preparent contre nous vn general effort, Ie mets à faire pis en l’eſtat où nous ſommes, Le ſort, & les Demons, & les Dieux & les hommes, Ce qu’ils ont de cruel.	Ve désormais le Ciel, les Enfers, et la terre 2Unissent leurs fureurs à nous faire la guerre, Que les hommes, les Dieux, les Demons et le sont Préparent contre nous un général effort, Je mets à faire pis en l'état où nous sommes, Le sort, et les Demons, et les Dieux et les hommes, Ce qu'ils ont de cruel.
& d’horribile & d’affreux, L’eſt bien moins que l’honneur qu’on nous fait à tous deux.	et d'horribile et d'affreux, L'est bien moins que l'honneur qu'on nous fait à tous deux.
HORACE.	HORACE.
Le ſort qui de l’honneur nous ouure la barriere, Offre à noſtre conſtance vne illuſtre matiere, Il eſpuiſe ſa force à fermer vn malheur.	Le sort qui de l'honneur nous ouvre la barrière, Offre à notre constance une illustre matière, Il épuise sa force à fermer un malheur.
Pour mieux ſe meſurer auec noſtre valeur, Comme il ne nous prend pas pour des ames communes, Hors de l’ordre commun il nous fait des fortunes.	Pour mieux se mesurer auec jours valeur, Comme il ne nous prend pas pour des âmes communes, Hors de l'ordre commun il nous fait des fortunes.
Combatre vn ennemy pour le ſalut de tous, Et contre vn incognu s’expoſer ſeul aux coups, D’vne ſimple vertu c’eſt l’effet ordinaire, Mille deſia l’ont fait mille pourroient le faire, Mourir pour le pays eſt vn ſi digne ſort Qu’on brigueroit en foule vne ſi belle mort.	Combatre un ennemi pour le salut de tous, Et contre un inconnu s'exposer seul aux coups, D'une simple vertu c'est l'effet ordinaire, Mille déjà l'ont fait mille pourraient le faire, Mourir pour le pays est un si digne sort Qu'on briguerait en foule une si belle mort.
Mais vouloir au public immoler ce qu’on ayme, S’attachet au combat contre vn autre ſoy-meſme, Attaquer vn party qui prend pour defenſeur Le frere d’vne femme, & l’amant d’vne ſœur, Et rompant tous ces nœuds s’armer pour la patrie Contre vn ſang qu’on voudroit rachepter de ſa vie, Vne telle vertu n’appartenoit qu’à nous, L’ſclat de ſon grand nom luy fait peu de ialoux, Et peu d’hommes au cœur l’ont aſſés imprimée Pour oſer aſpirer à tant de renommée.	Mais vouloir au public immoler ce qu'on aime, S'attachet au combat contre un autre soi-même, Attaquer un parti qui prend pour défenseur Le frère d'une femme, et l'amant d'une sœur, Et rompant tous ces nœuds s'armer pour la patrie Contre un sang qu'on voudrait rachepter de sa vie, telle vertu appartenoit nous, sclat de son grand nom lui fait peu de ialoux, Et peu hommes au cœur ont assés imprimée Pour oser aspirer tant de renommée.
CVRIACE.	CURICE.
Il eſt vray que nos noms ne ſçauroient plus perir, L’occaſion eſt belle, il nous la faut cherir, Nous ſerons les miroirs d’vne vertu bien rare:	Il est vrai que nos noms ne sauraient plus périr, L'occasion est belle, il nous la faut chérir, Nous serons les miroirs d'une vertu bien rare:
Mais voſtre fermeté tient vn peu du barbare, Peu, meſme des grands cœur, tireroient vanité D’aller par ce chemin à l’immortalité, A quelque prix qu’on mette vne telle fumée, L’obſcurité vaut mieux que tant de renommée.	Mais votre fermeté tient un peu du barbare, Peu, même des grands cœur, tireraient vanité D'aller par ce chemin à l'immortalité, À quelque prix qu'on mette une telle fumée, L'obscurité vaut mieux que tant de renommée.
Pour moy ie l’oſe dire, & vous l’auez peu voir, Ie n’ay point conſulté pour ſuiure mon deuoir, Noſtre longue amitié, l’amour, ny l’alliance N’ont peu mettre vn moment mon eſprit en balance, Et puiſque par ce choix Albe monſtre en effet Qu’elle m’eſtime autant que Rome vous a fait, Ie croy faire pour elle autant, que vous pour Rome, I’ay le cœur auſſi bon, mais en fin ie ſuis homme.	Pour moi quelquefois l'ose dire, et vous l'avez pu voir, Je n'ai point consulté pour suiure mon devoir, Notre longue amitié, l'amour, ni l'alliance N'ont pu mettre un moment mon esprit en balance, Mais puisque par ce choix Albe montre en effet Qu'elle m'estime autant que Rome vous a fait, Je crois faire pour elle autant, que vous pour Rome, J'ai le cœur aussi bon, mais en fin ie suis me.
Ie voy que voſtre honneur giſt à verſer mon ſang, Que tout le mien conſiſte à vous percer le flanc, Preſt d’eſpouſer la ſœur qu’il faut tuer le frere, Et que pour mon pays i’ay le ſort ſi contraire;	Je vois que votre honneur gît à verser mon sang, Que tout le mien consiste à vous percer le flanc, Prêt d'épouser la sœur qu'il faut trouver le frère, Et que pour mon pays j'ai le sort si contraire;
Encor qu’à mon deuoir ie coure ſans terreur, Mon cœur s’en effarouche, & i’en fremis d’horreur, (vie, I’ay pitié de moy-meſme, & iette vn œil d’enSur ceux dont noſtre guerre a conſommé la vie, Sans ſouhait toute fois de pouuoir reculer, Ce triſte & fier honneur m’eſmeut ſans m’ébranſler, (m’oſte, I'ayme ce qu’il me donne, & ie plains ce qu’il Et ſi Rome demande vne vertu plus haute.	Encor qu'à mon devoir ie coure sans terreur, Mon cœur s'en effarouche, et j'en frémis d'horreur, (vie, J'ai pitié de moi-même, et jette un œil d'enSur ceux dont notre guerre a consommé la vie, Sans souhait toute fois de pouvoir reculer, Ce triste et fier honneur m'émeut sans m'ébranler, (m'ôte, J'aime ce qu'il me donne, et et pleins ce qu'il Est si Rome demande une vertu plus haute.
Ie rends graces aux Dieux de n’eſtre pas Romain Pour conſeruer encor quelque choſe d’humain.	Je rends grâces aux Dieux de n'être pas Romain Pour conserver encor quelque chose d'humain.
HORACE.	HORACE.
Si vous n’eſtes Romain, ſoyés digne de l’eſtre, Et ſi vous m’eſgales faites le mieux paroiſtre.	Si vous n'êtes Romain, soyez digne de l'être, Et si vous m'égales faites le mieux paraître.
La ſolide vertu dont ie fais vanité N’admet point de foibleſſe auec ſa fermeté, Et c’eſt mal de l’honneur entrer dans la carriere Que dés le premier pas regarder en arriere.	La solide vertu dont votre fais vanité N'admet point de faiblesse avec sa fermeté, Et c'est mal de l'honneur entrer dans la carrière Que dès le premier pas regarder en arrière.
Noſtre malheur eſt grand, il eſt au plus haut point Ie l’enviſage entier, mais ie n’en fremis point.	Notre malheur est grand, il est au plus haut point Je l'envisage entier, mais toujours n'en frémis point.
Contre qui que ce ſoit que mon pays m’employe I’accepte aueuglement cette gloire auec ioye, Celle de receuoir de tels commandements Doit eſtouffer en nous tous autres ſentiments, Qui prés de le ſeruir conſidere autre choſe A faire ce qu’il doit laſchement ſe diſpoſe, Ce droit ſaint & ſacré rompt tout autre lien, Rome a choiſi mon bras, ie n’examine rien, Auec vne aſlegreſſe auiſi pleiſle & ſiſicere Que i’eſpouſay la ſœur, ie combatray le frere.	Contre qui que ce soit que mon pays m'emploie J'accepte aveuglement cette gloire avec joie, Celle de recevoir de tels commandements Doit étouffer en nous tous autres sentiments, Qui près de le servir considère autre chose A faire ce qu'il doit lâchement se dispose, Ce droit saint et sacré rompt tout autre lien, Rome a choisi mon bras, pleins n'examine rien, A legresse auisi pleisle et sisicere Que j'épousai la sœur, je combatrai le frère.
Et pour trancher en fin ces diſcours ſuperflus Albe vous a nommé, ie ne vous cognois plus.	Et pour trancher en fin ces discours superflus Albe vous a nommé, toujours ne vous connais plus.
e vl l lla E Ie vous cognois encor, & c’eſt ce qui me tue;	Je vl a Éta E Je vous connais encor, et c'est ce qui me tue;
Mais ceſte aſpre vertu ne m’eſtoit pas connuê, Comme noſtre malheur elle eſt au plus haut point, Souffrés que ie l’admire, & ne l’imite point.	Mais cette âpre vertu ne m'était pas connuêmes, Comme notre malheur elle est au plus haut point, Souffrés que ie padmire, et ne l'imite point.
HORACE.	HORACE.
te, Non, non, n’embraſles pas de vertu par contrainEt puiſq;	te, Non, non, n'embrasles pas de vertu par contrainEt puisque;
vous trouuez plus de charme à la plainte;	vous trouvez plus de charme à la plainte;
En toute liberté gouſtés vn bien ſi doux, voicr Voicy venir ma ſœur pour ſe plaindre auec vous.	En toute liberté goûtez un bien si doux, voicr Voici venir ma sœur pour se plaindre auec vous.
Ie voy reuoir la voſtre, & reſoudre ſon ame A ſe reſſouuenir qu’elle eſt touſiours ma femme.	Je vois revoir la vôtre, et résoudre son âme À se ressouvenir qu'elle est toujours ma femme.
A vous aymer encor ſi ie meurs pas vos mains.	À vous aimer encor si ici meurs pas vos mains.
Et prédre en ſon malheur des ſentimens Romains.	Et prédre en son malheur des sentiments Romains.
8 HORACE.	8 HORACE.
Vez vous ſceu l’eſtat qu’on fait de Curiace, AMa ſœur?	Vez -vous su l'état qu'on fait de Curiace, AMa sœur?
CAMILLE.	CAMILLE.
HORACE.	HORACE.
ſœur, Armez vous de conſtance, & monſtrés vous ma Et ſi par mon treſpas il retourne vainqueur, Ne le receuez point en meurtrier d’vn frere (faire.	sœur, Armez -vous de constance, et montrez -vous ma Et si par mon trépas il retourne vainqueur, Ne le recevez point en meurtrier d'âme frère (faire.
Mais en homme d’honneur qui fait ce qu’il doit Qui ſert bien ſon pays & ſçait monſtrer à tous Par ſa haute vertu qu’il eſt digne de vous;	Mais en homme d'honneur qui fait ce qu'il doit Qui sert bien son pays et sait montrer à tous Par sa haute vertu qu'il est digne de vous;
Comme fi ie viuois acheuez l’Hymenée.	Comme fi Princes vivais achevez l'Hyménée.
Mais ſi ce fer auſſi tranche ſa deſtinée Faites à ma victoire vn pareil traitement, Ne me reprochez point la mort de voſtre amant, Vos larmes vont couler, & voſtre cœur ſe preſſe, Conſommés auec luy toute ceſte foibleſſe, Querellez Cſer & terre, & maudiſſez le ſort, Mais apres le combat ne penſez plus au mort.	Mais si ce fer aussi tranche sa destinée Faites à ma victoire un pareil traitement, Ne me reprochez point la mort de votre amant, Vos larmes vont couler, et votre cœur se presse, Consommès mille mille toute cette faiblesse, Querellez Cser et terre, et maudissez le sort, Mais après le combat ne pensez plus au mort.
Ie ne vous laiſſeray qu’vn momẽt auec elle, (pellePuis nous irons enſemble où l’honneur nous ap	Je ne vous laisserai qu'Hommes moment quelque elle, (pellePuis nous irons ensemble où l'honneur nous ap
SCENE V.	SCÈNE V.
CAMILLE, CVRIACE.	CAMILLE, CURIACE.
CAMILLE.	CAMILLE.
Ras.	Ras.
tu ma chere ame, & ce funeſte honneur Te plait-il au deſpens de tout noſtre bonheur?	tu ma chère âme, et ce funeste honneur Te plaît-il au dépens de tout notre bonheur?
CVRIACE.	CURICE.
Helas, ie voy trop bien qu’il faut, quoy que ie face.	Hélas, Seigneur vois trop bien qu'il faut, quoi que sans face.
Mourir, ou de douleur, ou de la main d’Horace, Ie vay comme au ſupplice à cét illuſtre employ, Ie maudis mille fois l’eſtat qu’on fait de moy, Ie hay cette valeur qui facit qu’Albe m’eſtime, Ma flamme au deſeſpoir paſſe iuſques au crime, Elle le prend aun Dioun juanuidie quereller, Ie vous plains, ie me plains, mais il y faut aller.	Mourir, ou de douleur, ou de la main d'Horace, Je vais comme au supplice à cet illustre emploi, Je maudis mille fois l'état qu'on fait de moi, Je haï cette valeur qui facit qu'Albe m'estime, Ma flamme au désespoir passe jusques au crime, Elle le prend aun Dioun juanuidie que, Ie que plains, je vous plains, mais il y faut aller.
CAMILLE.	CAMILLE.
Non, ie te cognoy mieux, tu veux que ie te prie, Et qu’ainſi mon pouuoir t’excuſe à ta parrie.	Non, Seigneur te connais mieux, tu veux que ie te prie, Et qu'ainsi mon pouvoir t'excuse à ta parrie.
Tu n’es que trop fameux par tes autres exploits, Albe a receu par eux tout ce que tu luy dois, Autre n’a mieux que toy ſouſtenu cette guerre, Autre dé plus de morts n'a couueit cetteterre, Tõ nõ ne peut plus croiſtre, il ne luy manque rien, Souffre qu’vn autre icy puiſſe ennoblir le ſien.	Tu n'es que trop fameux par tes autres exploits, Albe a reçu par eux tout ce que tu lui dois, Te n'a mieux que toi soutenu cette guerre, Autre de plus de morts n'a couvit cetterre, Tõ Tendre ne peut plus croître, il ne le manque rien, Souffre qu'un autre ici puisse ennoblir le sien.
CVRIACE.	CURICE.
teſte	tête
Que ie ſouffre à mes yeux qu’on ceigne vne autre Des lauriers immortels que la gloire m’appreſte, Ou que tout mon pays reproche à ma vertu Qu’il auroit triomphé ſi i’auois combatu, Et que par mon amour ma valeur endormie Couronne tant d’exploits d’vne telle infamie?	Que était souffre à mes yeux qu'on ceigne une autre Des lauriers immortels que la gloire m'apprête, Ou que tout mon pays reproche à ma vertu Qu'il aurait triomphé si j'avais combattu, Et que par mon amour ma valeur endormie Couronne tant d'exploits d'une telle infamie?
V Non, Albe, apres l’honneur que i’ay receu de toy Tu ne ſuccomberas ny vaincras que par moy;	V Non, Albe, après l'honneur que j'ai reçu de toi Tu ne succomberas ni vaincras que par moi;
te, Tu m’as cõmis ton ſort, ie t’en rendray bon conEt vidiay lalls lepoenle, our fiiiruy lune cronte.	te, Tu m'as commis ton sort, je t'en rendrai bon conEt vidiay lalls lepole, our fiirri lune crompte.
CAMILLE.	CAMILLE.
Quoy!	Quoi!
tu me veux pas voir qu’ainſi tu me trahis!	tu me veux pas voir qu'ainsi tu me trahis!
CVRIACE.	CURICE.
Auant que d’eſtre à vous ie ſuis à mon pays.	Avant que d'être à vous je suis à mon pays.
CAMILLE.	CAMILLE.
Mais te priuer pour luy toy-meſme d’vn beau frere Ta ſœur de ſon mary!	Mais te priver pour lui toi-même d'H beau frère Ta sœur de son mari!
CVRIACE.	CURICE.
Telle eſt noſtre miſere, Le choix d’Albe & de Rome oſte toute douceur Aux noms iadis ſi doux de beau frere & de ſœur.	Telle est notre misère, Le choix d'Albe et de Rome ôte toute douceur Aux noms jadis si doux de beau frère et de sœur.
CAMILLE.	CAMILLE.
Viendras-tu point encor me preſenter ſa teſte, Et demander ma main pour prix de ta conqueſte?	Viendras-tu point encor me présenter sa tête, Et demander ma main pour prix de ta conquête?
CVRIACE.	CURICE.
Il n’y faut plus penſer, en l’eſtat où ie ſuis:	Il n'y faut plus penser, en l'état où tu suis:
Vous aymer ians eipoir c’eſt tout ce que ie puis.	Vous aimer jants éjpoir c'est tout ce que je puis.
Vous pleurés, ma chere ame,	Vous pleurez, ma chère âme,
CAMILLE.	CAMILLE.
Il faut bien que ie pleure, Mon inſenſible amant ordonne que ie meure, Et lors que monſtre Hymen allume ſon flambeau, Il r’eſtemt de la mam pour m’ouurir le tombeau, Ce cœur impitoyable à ma perte s’obſtine, Et dit qu’il m’ayme encor alors qu’il m’aſſaſſine.	Il faut bien que Seigneur pleure, Mon insensible amant ordonne que A meure, Et lors que montre Hymen allume son flambeau, Il restemt de la mam pour m'ouvrir le tombeau, Ce cœur impitoyable à ma perte s'obstine, Et dit qu'il m'aime encor alors qu'il m'assassine.
CVRIACE.	CURICE.
cours,	cours,
Que les pleurs d’vne amante ont de puiſſants diſEt qu’vn bel œil eſt fort auec vn tel ſecours!	Que les pleurs d'une amante ont de puissants disait qu'un bel œil est fort avec un tel secours!
Que mon cœur s’attendrit à cette triſte veuë!	Que mon cœur s'attendrit à cette triste vue!
Ma conſtance contra elle à regret s’euertuë.	Ma constance contra elle à regret s'évertue.
N’attaqués plus ma gloire auecque vos douleurs, Et laiſſés moy ſauuer ma vertu de vos pleurs;	N'attaquez plus ma gloire avec vos douleurs, Et laissés moi sauver ma vertu de vos pleurs;
Ie ſens qu’elle chancelle, & defend mal la place, Plus ie ſuis voſtre amant, moins ie ſuis Curiace, Foible d’auoir deſia combatu l’amitié Vaincroit-elle à la fois l’amour & la pitié?	Je sens qu'elle chancelle, et défend mal la place, Plus je suis votre amant, moins ie suis Curiace, Foible d'avoir déjà combattu l'amitié Vaincroit-elle à la fois l'amour et la pitié?
Allés, ne m’aymés plus ne verſez plus de larmes, Où i’oppoſe l’offenſe à de ſi fortes armes, Ie me defendray mieux contre voſtre couroux, Et pour le meriter, ie n’ay plus d’yeux pour vous, Vangez vous d’vn ingrat, puniſſez vn volage, (ge?	Allez, ne m'aimez plus ne versez plus de larmes, Où j'oppose l'offense à de si fortes armes, Je me défendrai mieux contre votre courroux, Et pour le mériter, Seigneur n'ai plus d'yeux pour vous, Vengez vous d'un ingrat, punissez un volage, (ge?
Vous ne vous monſtrez point ſenſible à cet outraIe n’ay plus d’yeux pour vous, vous en auez pour moy !	Vous ne vous montrez point sensible à cet outraIe n'ai plus d'yeux pour vous, vous en avez pour moi !
B 2 ER En faut-il plus encor?	 2 ER En faut-il plus encor?
ie renonce à ma foy, Rigoureuſe vertu dont ie ſuis la victime, Ne peux tu reſiſter ſans le lecouis d’vnermme?	Les renonce à ma foi, Rigoureuse vertu dont je suis la victime, Ne peux tu résister sans le couis d'unermme?
CAMILLE.	CAMILLE.
Ne fay point d’autre crime, & i’attaſte les Dieux Qu’au lieu de t’en hair, ie t’en aymeray mieux, Ouy, ie te cheriray tout ingrat & perfide, Et ceſſe d’aſpirer au nom de fratricide.	Ne fais point d'autre crime, et j'attaste les Dieux Qu'au lieu de t'en haïr, quelque t'en aimerai mieux, Oui, ainsi te chérirai tout ingrat et perfide, Et cesse d'aspirer au nom de fratricide.
main?	main?
Pourquoy ſuis je Romaine, on que n’es tu RoIe te preparerois des lauriers de ma main, Ie t’encouragerois au lieu de te diſtraire, Et ie te traiterois comme i’ay fait mon frere.	Pourquoi suis je Romaine, on que n'es tu RoIe te préparerais des lauriers de ma main, Je t'encouragerais au lieu de te distraire, Et quelque te traiterais comme j'ai fait mon frère.
Helas !	Hélas !
i’eſtois aueugle en mes vœux auiourd’huy Ferruy fuit contre toy quand i’en ay fait pour luy, Il revient, quel malheur!	j'étais aveugle en mes vœux aujourd'hui Ferrui fuit contre toi quand j'en ai fait pour lui, Il revient, quel malheur!
ſi l’amour de ſa femme Ne peut non plus ſur luy que le mien ſur ton ame.	si l'amour de sa femme Ne peut non plus sur Rome que le mien sur ton âme.
DCENE VI.	DCENE VI.
HORACE, CVRIACE, SABINE, CAMILLE.	HORACE, CURIACE, SABINE, CAMILLE.
CVRIACE.	CURICE.
Ieux!	Jeux!
Sabine le ſuit!	Sabine le suit!
Pour eſbranler mon cœut DEſt ce peu de Canma?	Pour ébranler mon cœur DEst ce peu de Canma?
y loignenvous ma ſœur?	y loignenvous ma sœur?
Et laiſſant à ſes pleurs vaincre ce grand courage L’amenez vous icy chercher meſme aduantage?	Et laissant à ses pleurs vaincre ce grand courage L'amenez vous ici chercher même avantage?
SABINE.	SABINE.
Non, non, mon frere, non, ie ne viens en ce lieu Que pour vous embraſſer, & pour vous dire Adieu, (che, Voſtre ſang eſt trop bon, n’en craignés rien de laſRien dont la fermeté de ces grands cœurs ſe faſche;	Non, non, mon frère, non, je ne viens en ce lieu Que pour vous embrasser, et pour vous dire Adieu, (che, Votre sang est trop bon, n'en craignez rien de lasRien dont la fermeté de ces grands cœurs se fâche;
Si ce malheur illuſtre eſbranloit l’vn de vous Ie le deſaduoüerois pout frere ou pour eſpous.	Si ce malheur illustre ébranlait l'op de vous Je le désavouerais pout frère ou pour épous.
Pourray ie toutefois vous faire vne priere Digne d’vn tel elpomsce uigne d’vn tel frere?	Pourra ie toutefois vous faire une prière Digne d'un tel épomsce uigne d'un tel frère?
TRAGEDIE.	TRAGÉDIE.
Ie veux d’vn coup ſi noble oſter l’impieté;	Je veux d'un coup si noble ôter l'impiété;
A l’honneur qui l’attend rendre ſa pureté, 23 La mettre en ſon eſclat ſans meſlange de crimes, En fin ie vous veux faite ennemis legitimes, Du ſaint nœud qui vous ioint ie ſuis le ſeul lien, Quand ie ne ſeray plus, vous ne vous ſerez rien, Briſez voſtre alliance & rompez en la chaiſne, Et puiſque voſtre honneur veut des effets de haine Acheptés par ma mort le droit de vous hair, Albe le veut & Rome, il faut leur obeyr, (vange, Qu’vn de vous deux me tuë, & que l’autre me Alors voſtre combat n’aura plus rien d’eſtrange, Et du moins l’vn des deux ſera iuſte aggreſſeur;	À l'honneur qui l'attend rendre sa pureté, 23 La mettre en son éclat sans mélange de crimes, En fin encore vous veux faite ennemis légitimes, Du saint nœud qui vous joint tu suis le seul lien, Quand Je ne serai plus, vous ne vous serez rien, Brisez votre alliance et rompez en la chaîne, Et puisque votre honneur veut des effets de haine Acheptés par ma mort le droit de vous haïr, Albe le veut et Rome, il faut leur obéir, (vange, Qu'un de vous deux me tue, et que l'autre me Alors votre combat n'aura plus rien d'étrange, Et du moins l'un des deux sera iuste aggresseur;
Ou pour vanger ſa femme, vn pour vanger ſa ſœur.	Ou pour venger sa femme, un pour venger sa sœur.
Mais quoy!	Mais quoi!
vous ſoüilleriez vne gloire ſi belle, Si vous vous animiez par quelque autre querelle, Voſtre zele au pays vous deſend de tels ſoins, Vous feriés peu pour luy ſi vous en faiſiez moins, Il luy faut, & ſans haine, immoler vn beau frere:	vous soüilleriez une gloire si belle, Si vous vous animiez par quelque autre querelle, Votre zèle au pays vous désend de tels soins, Vous feriez peu pour un si vous en faisiez moins, Il lui faut, et sans haine, immoler un beau frère:
Ne differés donc plus ce que vous deués faire, Commencés par ſa ſœur à reſpandre ſon ſang, Commencés par ſa femme à luy percer le flanc.	Ne différez donc plus ce que vous devez faire, Commencez par sa sœur à répandre son sang, Commencez par sa femme à notre percer le flanc.
Commencés par Sabine à faire de vos vies Vn digne ſacrifice à vos cheres patries, Vous eſtes ennemis en ce combat fameux (deux, Vous d’Albe, vous de Rome, & moy de toutes Quoy?	Commencez par Sabine à faire de vos vies Un digne sacrifice à vos chères patries, Vous êtes ennemis en ce combat fameux (deux, Vous d'Albe, vous de Rome, et moi de toutes Quoi?
me reſeruez vous à voir vne victoire, Où pour haut appareil d’vne pompeuſe gloire Ie verray les lauriers d’vn frere ou d’vn mary Fumer encor d’vn ſang que i’auray tant chery:	me réservez -vous à voir une victoire, Où pour haut appareil d'une pompeuse gloire Je verrai les lauriers d'un frère ou d'un mari Fumer encor d'un sang que j'aurai tant chéri:
Pourray-je entre vos deux regler alors mon ame?	Pourrai-je entre vos deux régler alors mon âme?
Satisfaire au deuoir & de ſœur & de femme?	Satisfaire au devoir et de sœur et de femme?
Embraſſer le vainqueur en pleurant le vaincu?	Embrasser le vainqueur en pleurant le vaincu?
Non, non, auant ce coup Sabine aura veſcu, Ma mort le preuiendra de qui que ie l’obtienne, Le refus de vos mains y condamne la mienne, Sus donc qui vous retient?	Non, non, avant ce coup Sabine aura vécu, Ma mort le préviendra de qui que sans l'obtienne, Le refus de vos mains y condamne la mienne, Sus donc qui vous retient?
Allés, cœurs inhumains, I’auray trop de moyens pour y forcer vos mains, Vous ne les aurez point au combat occupées Que ce corps au milisu n’arreſte vos eſpées, Et malgté vos refus il faudroit que leurs coups Se faſſent iour icy pour aller iuſqu’à vous.	Allez, cœurs inhumains, J'aurai trop de moyens pour y forcer vos mains, Vous ne les aurez point au combat occupées Que ce corps au milisu n'arrête vos épées, Et malgé vos refus il faudrait que leurs coups Se fassent jour ici pour aller jusqu'à vous.
O ma femme!	Ô ma femme!
AORMCE.	ÀORMCE.
EVRIACE O ma ſœur !	EURICE Ô ma sœur !
CAMILLE.	CAMILLE.
Courage ils s’amolliſſent	Courage ils s'amollissent
SABINE.	SABINE.
Vous pouſſez de ſouſpirs, vos viſages palliſſent!	Vous poussez de soupirs, vos visages pâlissent!
Quelle peur vous ramtaont ce la ces grands cœurs, Ces heros qu’Albe & Rome ont pris pour defenſeurs?	Quelle peur vous rambtaont ce la ces grands cœurs, Ces héros qu'Albe et Rome ont pris pour défends?
HORACE.	HORACE.
Femme, que t’ay ie fait, & quelle eſt mon offenſe, Qui t’oblige à chercher vne telle vengeance?	Femme, que t'a ie ici, et quelle est mon offense, Qui t'oblige à chercher une telle vengeance?
Que t’a fait mon honneur, femme, & pourquoy viens-tu Auec toute ta force attaquer ma vertu?	Que t'a fait mon honneur, femme, et pourquoi viens-tu Auec toute ta force attaquer ma vertu?
Du moins contente toy de l’auoir eſtonnée, Et me laiſſe acheuer cette grande iournée, Tu me viens de reduire en vn eſtrange point, Ayme aſſez ton mary pour n’en triompher point, Va t’en & ne rends plus la victoire douteuſe, La diſpute deſia m’en eſt aſſez honteuſe, Souffre qu’auec honneur ie termine mes iours.	Du moins contente toi de l'avoir étonnée, Et me laisse achever cette grande journée, Tu me viens de réduire en un étrange point, Aime assez ton mari pour n'en triompher point, Va t'en et ne rends plus la victoire douteuse, La dispute déjà m'en est assez honteuse, Souffre qu'au honneurois termine mes jours.
ABINE.	ÀBINE.
Va, ceſſe de me craindre, on vient à ton ſecours.	Va, cesse de me craindre, on vient à ton secours.
SCE	SCE
TRAGEDIE.	TRAGÉDIE.
SCENE VII.	SCÈNE VII.
23 Le vieil HORACE, HORACE, CVRIACE, SABINE, CAMILLE.	23 Le vieil HORACE, HORACE, CURIACE, SABINE, CAMILLE.
Le vieil HORACE.	Le vieil HORACE.
V’eſt ce cy mes enfans?	V'est ce cy mes enfants?
eſcoutez vous vos  flammes, Et perdez-vous encor le temps auec des femmes?	écoutez -vous vos flammes, Et perdez-vous encor le temps au des femmes?
preſts à verſer du ſang regardez-vous des pleurs?	prêts à verser du sang regardez-vous des pleurs?
Fuyez & laiſſez les déplorer leurs malheurs, Leurs plaintes ont pour vous trop d’art & de tendreſſe, Elles vous feroient part en fin de leur foibleſſe, Et ce n’eſt qu’en fuyant qu’on pare de tels coups.	Fuyez et laissez les déplorer leurs malheurs, Leurs plaintes ont pour vous trop d'art et de tendresse, Elles vous feraient part en fin de leur faiblesse, Et ce n'est qu'en fuyant qu'on pare de tels coups.
ABINE.	ÀBINE.
vous, N’apprehendez rien d’eux, ils ſont dignes de Malgré tous nos efforts vous en deuez attendre Ce que vous ſouhaittez & d’vn fils & d’vn gendre, Et ſi noſtre foibleſſe auoit peu les changer Nous vous laiſſons icy pour les encourager.	vous, N'appréhendez rien d'eux, ils sont dignes de Malgré tous nos efforts vous en devez attendre Ce que vous souhaitez et d'un fils et d'un gendre, Et si notre faiblesse avait pu les changer Nous vous laissons ici pour les encourager.
mes, Allons, ma ſœur, allons, ne perdons point de larContre tant de vertus ce ſont de foibles armes, Ce n’eſt qu’au deſeſpoir qu’il nous faut recourir, Tigres allés combatre, & nous allons mourir.	mes, Allons, ma sœur, allons, ne perdons point de larContre tant de vertus ce sont de faibles armes, Ce n'est qu'au désespoir qu'il nous faut recourir, Tigres allés combattre, et nous allons mourir.
SCENE VIII.	SCÈNE VIII.
Le vieil HORACE, HORACE, CVRIACE.	Le vieil HORACE, HORACE, CURIACE.
HORACE.	HORACE.
On pere retinés des femmes qui s’emportent, N Et de grace empeſchez ſur tout qu’elles ne ſortent.	On père retinez des femmes qui s'emportent, N Et de grâce empêchés sur tout qu'elles ne sortent.
Leur amour importun viendroit auec eſclat Par des cris & des pleurs troubler noſtre combat, Et ce quelles nous ſont feroit qu’auec iuſtice On nous imputeroit ce mauuais artifice, (peté L’honneur d’vn ſi beau choix ſeroit trop acheD 4 51 ori da nouoioap gumon de ſacuamomuniete,	Leur amour importun viendrait avec éclat Par des cris et des pleurs troubler notre combat, Et ce quelles nous sont ferait qu'avec justice On nous imputerait ce mauvais artifice, (pété L'honneur d'un si beau choix serait trop achD 4 51 ori da nouvoyoap gumon de sacuamomuniete,
Le vieil HORACE.	Le vieil HORACE.
I’en auray ſoin, allez, vos freres vous attendent, Ne pemez qu’aux devoirs que vos pays demandent.	J'en aurai soin, allez, vos frères vous attendent, Ne pemez qu'aux devoirs que vos pays demandent.
CVRIACE.	CURICE.
Quel Adieu vos diray-ie & par quels complimens.	Quel Adieu vos dirai-je et par quels compliments.
Le vieil HORACE.	Le vieil HORACE.
Ah!	Ah!
n’attendriſſez point icy mes ſentimens, Pour vous encourager ma voix manque de termes, (mes, Mon cœur ne forme point de penſers aſſez ferMoy-meſme en cét Adieu i’ay les larmes aux yeux, Faites voſtre devoir, & laiſſez faire aux Dieux.	n'attendrissez point ici mes sentiments, Pour vous encourager ma voix manque de termes, (mes, Mon cœur ne forme point de pensers assez ferMoi-même en cet Adieu j'ai les larmes aux yeux, Faites vôtre avoir, et laissez faire aux Dieux.
Fin du ſecond Acte.	Fin du second Acte.
AILEIT.	ÀILEIT.
SCENE PREMIERE.	SCÈNE PREMIÈRE.
SABINE.	SABINE.
Renons party mon ame, en de telles diſgraces, Soyons femme d’Horace, ou ſœur des Cutiaces, Ceſſons de partager nos inutiles ſoins, Souhaitons quelque choſe, & craignons vn peu moins.	Renons parti mon âme, en de telles disgrâces, Soyons femme d'Horace, ou sœur des Cutiaces, Cessons de partager nos inutiles soins, Souhaitons quelque chose, et craignons un peu moins.
traire?	traire?
Mais las!	Mais las!
quel party prendre en vn ſort ſi conQuel ennemy choiſir d’vn eſpous ou d’vn frere?	quel parti prendre en un sort si conQuel ennemi choisir d'un épous ou d'un frère?
La nature ou l’amour parlent pour chacun d’eux, Et la loy du deuoir m’attache à tous les d’eux.	La nature ou l'amour parlent pour chacun d'eux, Et la loi du devoir m'attache à tous les d'eux.
Sur leurs hauts ſentiments reglons pluſtoſt les noſtres, Soyons femme de l'vn enſemble & ſœur des autres, (bien, Regardons leur honneur comme vn ſouuerain Imi	Sur leurs hauts sentiments réglons plutôt les nôtres, Soyons femme de l'un ensemble et sœur des autres, (bien, Regardons leur honneur comme un souuerain Imi
I Ie ai e De a de Imitons leur conſtance, & ne craignont plus rien.	I Je ai e De a de Imitons leur constance, et ne craignont plus rien.
La mort qui les menace eſt vne mort ſi belle Qu’il en faut ſans frayeur attendre la nouuelle:	La mort qui les menace est une mort si belle Qu'il en faut sans frayeur attendre la nouvelle:
N’appellons point alors les deſtins inhumains, Songeons pour quelle cauſe, & non par quelles mains, (re Reuoyons les vainqueurs ſans penſer qu’à la gloiQue toute leur maiſon reçoit de leur victoité.	N'appelons point alors les destins inhumains, Songeons pour quelle cause, et non par quelles mains, (re Revoyons les vainqueurs sans penser qu'à la gloiQue toute leur maison reçoit de leur victaité.
Et ſans conſiderer aux deſpens de quel ſang Leut vertu les eſleue en cét i luſtre rang, 10 Faiſons nos intereſts de ceux de leur famille, En l’vne ie ſuis femme, en l’autre ie ſuis fille, Et tiens à toutes deux par de ſi forts liens Qu’on ne peut triompher que par les bras des miens.	Et sans considérer aux dépens de quel sang Leut vertu les élève en cet y lustre rang, 10 Faisons nos intérêts de ceux de leur famille, En l'une Princes suis femme, en l'autre je suis fille, Et tiens à toutes deux par de si forts liens Qu'on ne peut triompher que par les bras des miens.
Fortune, quelques maux que ta rigueur m’enuoye, I’ay trouué les moyens d’en tirer de la ioye, Et puis voir maintenant le combat ſans terreur, Les morts ſans deſeſpoir, les vainqueurs ſans horreur, Flauteuſe illuſion, erreur douce & groſſiere.	Fortune, quelques maux que ta rigueur m'envoie, J'ai trouvé les moyens d'en tirer de la joie, Et puis voir maintenant le combat sans terreur, Les morts sans désespoir, les vainqueurs sans horreur, Flauteuse illusion, erreur douce et grossière.
Vain effort de mon ame, impuiſſante lumiere, De qui le faux brillant prend droit de meſbloüir, Que tu ſçais peu durer, & toſt t’eſuanouïr!	Vain effort de mon âme, impuissante lumière, De qui le faux brillant prend droit de mesbloüir, Que tu sais peu durer, et tôt t'esuanouïr!
Pareille à ces eſclairs qui dans le fort des ombres, Pouſſent vn iour qui ſuit, & rend les nuits plus ſombres, Tu n’as frappé mes yeux d’vn moment de clarté.	Pareille à ces éclairs qui dans le fort des ombres, Poussent un jour qui suit, et rend les nuits plus sombres, Tu n'as frappé mes yeux d'un moment de clarté.
Que pour les abyſmer dãs plus d’obſcurité.	Que pour les abîmer dans plus d'obscurité.
ſche, Tu charmois trop ma peine, & le Ciel qui s’en faMe vend deſia bien cher ce moment de relaſche, Ie ſens mon triſte cœur percé de tous les coups Qui m’oſtent maintenant-vn frere, ou mon eſpous.	sche, Tu charmais trop ma peine, et le Ciel qui s'en faMe vend déjà bien cher ce moment de relâche, Je sens mon triste cœur percé de tous les coups Qui m'ôtent maintenant-un frère, ou mon épous.
poſe, Quand ie ſonge à leur mort, quoy que ie me proIe ſonge par quel bras, & non pour quelle cauſe, Et ne voy les vainqueurs en leur illuſtre rang, Que pour conſidere aux deſpens de quel ſang, La maiſon des vaincus touche ſeule mon ame, En l’vne ie ſuis fille, en l’autre ie ſuis femme, Et tiens à toutes deux par de ſi fors liens (miens.	pose, Quand der songe à leur mort, quoi que de me proIe songe par quel bras, et non pour quelle cause, Et ne vois les vainqueurs en leur illustre rang, Que pour considère aux dépens de quel sang, La maison des vaincus touche seule mon âme, En l'une je suis fille, en l'autre ie fois femme, Et tiens à toutes deux par de si fors liens (miens.
Qu’on ne peut triompher que par la mort des C’eſt là donc cette paix que i’ay tant ſouhaitée!	Qu'on ne peut triompher que par la mort des C'est là donc cette paix que j'ai tant souhaitée!
Trop favorables Dieux, vous m’auez eſcoutée!	Trop favorables Dieux, vous m'avez écoutée!
Quels foudres lancés vous quãd vous vous irritez, Si meſme vos faueurs ont tant de cruautez, Et de quelle façon pummiiez vous l’offenſe, Si vous traités ainſi les veux de l’innocence?	Quels foudres lancés vous quand vous vous irritez, Si même vos faveurs ont tant de cruautés, Et de quelle façon pummiés vous l'offense, Si vous traitez ainsi les veux de l'innocence?
SCENE II SABINE, IVLIE.	SCÈNE II SABINE, IVLIE.
SABINE.	SABINE.
E Neſt-ce fait, Iulie, & que m’apportez vous?	E Nêt-ce fait, Julie, et que m'apportez -vous?
D'Eſt ce la mort d’vn frere, ou celle d’vn eſpous?	D'Est ce la mort d'Han frère, ou celle d'un épous?
Ou ſi le triſte ſort de leurs armes impies Dt tous les combatans a fait autant d’hoſties, Et m’enuiant l’horreur que i’aurois des vainqueuls, (pleurs?	Ou si le triste sort de leurs armes impies Dt tous les combattants a fait autant d'hosties, Et m'enviant l'horreur que j'aurais des vainqueuls, (pleurs?
Pour tous tant qu’il eſtoient m’a condamnés aux	Pour tous tant qu'il étaient m'a condamnés aux
IVLIE.	IVLIE.
Quoy, ce qui s’eſt paſſé vous l’ignorez encore?	Quoi, ce qui s'est passé vous l'ignorez encore?
SABINE.	SABINE.
Vous faut-il eſtonner de ce que ie l’ignore, Et ne ſcavez vous point que de cette maiſon Pour Cainme d pour ſoy l'on fait viſe priſon?	Vous faut-il étonner de ce que ici l'ignore, Et ne savez -vous point que de cette maison Pour Cainme d pour soi l'on fait vise prison?
Iulie on nous renferme, on à peur de nos larmes, Sans cela nous ſerions au milieu de leurs armes, Et par les deſeſpoirs d’vne chaſte amitié Nous aurions des deux camps tiré quelque pitié.	Julie on nous renferme, on à peur de nos larmes, Sans cela nous serions au milieu de leurs armes, Et par les désespoirs d'une chaste amitié Nous aurions des deux camps tiré quelque pitié.
IVLIE.	IVLIE.
Il n’eſtoit pas beſoin d’vn ſi tendre ſpectacle, Leur veuë à leur combat apporte aſſez d’obſtacle, si toſt qu’ils ont paru preſts à ſe meſurer, Et l’vn & l’autre camp s’eſt mis à murmurer:	Il n'était pas besoin d'un si tendre spectacle, Leur vue à leur combat apporte assez d'obstacle, si tôt qu'ils ont paru prêts à se mesurer, Et l'un et l'autre camp s'est mis à murmurer:
Auoir de tels amis, des perſonnes ſi proches Venir pour leur patrie aux mortelles approches, L’vn s’eſmeut de pitié, l’autre eſt ſaiſi d’horreur.	Avoir de tels amis, des personnes si proches Venir pour leur patrie aux mortelles approches, L'un s'émut de pitié, l'autre est saisi d'horreur.
L’autre d’vn ſi grand zele admire la fureur, Tel porte iuſqu’aux Cieux leur vertu ſans égale, Ettel l’oſe nommer ſacrilege & brutale.	L'autre d'un si grand zèle admire la fureur, Tel porte jusqu'aux Cieux leur vertu sans égale, Étel l'ose nommer sacrilège et brutale.
Ces diuers ſentimens n’on pourtant qu’vne voix, Tous accuſent leurs chefs, tous deteſtent leur, choix, Et ne pouuant ſouffrir vn combat ſi barbare On s’eſcrie, on s’avance, en fin on les ſepare.	Ces divers sentiments n'on pourtant qu'une voix, Tous accusent leurs chefs, tous détestent leur, choix, Et ne pouvant souffrir un combat si barbare On s'écrie, on s'avance, en fin on les sépare.
SABINE.	SABINE.
xaucés!	xaucés!
IVLIE.	IVLIE.
Vous n’eſtes pas, Sabine, encor où vous penſés.	Vous n'êtes pas, Sabine, encor où vous pensez.
Vous pouuez eſperer, vous auez moins à craindre, Mais il vous reſte encor aſſez dequoy vous plainEn vain d’vn ſort ſi triſte on les veut garãtir, (dre, Ces cruels genereux n’y peuuent conſentir, La gloire de ce choix leur eſt ſi precieuſe Et charme tellement leur ame ambitieuſe, Qu’alors qu’on les deplore ils s’eſtiment heureux, Et prennent pour affront la pitié qu’on a d’eux, Le trouble des deux camps ſoüille leur renommée, Ils combatront pluſtoſt & l’vne & l’autre armée, Et mourront par les mains qui les ont ſeparés, Que quitter les honneurs qui leur ſont deferés.	Vous pouvez espérer, vous avez moins à craindre, Mais il vous reste encor assez dequoy vous plainEn on les veut garant triste on les veut garantir, (dre, Ces cruels généreux n'y peuvent consentir, La gloire de ce choix leur est si précieuse Et charme tellement leur âme ambitieuse, Qu'alors qu'on les déplore ils s'estiment heureux, Et prennent pour affront la pitié qu'on a d'eux, Le trouble des deux camps soüille leur renommée, Ils combatront plutôt et l'une et l'autre armée, Et mourront par les mains qui les mains separés, Que quitter les hommes qui leur sont deferés.
SABINE.	SABINE.
Quoy?	Quoi?
dans leur dureté ces cœurs de fers s’obſtinent?	dans leur dureté ces cœurs de fers s'obstinent?
IVLIE.	IVLIE.
Ils le font, mais d’ailleurs les deux camps ſe mutinent, (temps Et leurs cris des deux parts pouſſez en meſme Demandent la bataille ou d’autres combatans.	Ils le font, mais d'ailleurs les deux camps se mutinent, (temps Et leurs cris des deux parts poussez en même Demandent la bataille ou d'autres combattants.
La preſence des chefs à peine eſt reſpectée, Leur pouuoir eſt douteux, leur voix mal eſcoutée, Le Roy meſme s’eſtonne, & pour dernier effort, Puiſque chacun, dit-il, s’eſchauffe en ce diſcord, Conſultons des grands Dieux la Majeſté facrée Et voyons ſi ce change à leurs bontez agrée;	La présence des chefs à peine est respectée, Leur pouvoir est douteux, leur voix mal écoutée, Le Roi même s'étonne, et pour dernier effort, Puisque chacun, dit-il, s'échauffe en ce discord, Consultons des grands Dieux la Majesté sacrée Et voyons si ce change à leurs bontés agrée;
Quel impie oſera ſe prendre à leur vouloir, Lors qu’en vn ſacrifice ils nous l’auront fait voir?	Quel impie osera se prendre à leur vouloir, Lors qu'en un sacrifice ils nous l'auront fait voir?
Il ſe tait, & ces mots ſemblent eſtre des charmes, Meſme aux ſix combatans ils arrachent les armes, Et ce deſir d’honneur qui leur ferme les yeux Tout aueugle qu’il eſt reſpecte encor les Dieux;	Il se taît, et ces mots semblent être des charmes, Même aux six combattants ils arrachent les armes, Et ce désir d'honneur qui leur ferme les yeux Tout aveugle qu'il est respecte encor les Dieux;
Leur plus boüillante ardeur cede à l’aduis de Tulle, Et foit par deference, ou par vn prompt ſcrupule Malls Tvne & l'’autre armec on s'en raſt vne loy, Comme ſi toutes deux le cognoiſſoient pour Roy.	Leur plus bouillante ardeur cède à l'avis de Tulle, Et soit par déférence, ou par un prompt scrupule Malls Tune et l'autre armec on s'en rast une lois, Comme si toutes deux le connaissaient pour Roi.
Le reſte s’appendra par la mort des victimes.	Le reste s'appendra par la mort des victimes.
SA BINELes Dieux n’aduoüeront point vn combat plein de ciiines, I’en eſpere beaucoup puis qu’il eſt differé, Et ie commence à voir ce que i’ay deſiré.	SA BINELes Dieux n'avoueront point un combat plein de ciines, J'en espère beaucoup puis qu'il est différé, Et ie commence à voir ce que j'ai désiré.
SCENE III.	SCÈNE III.
SABINE, CAMILLE, IVLIE.	SABINE, CAMILLE, IVLIE.
SABINE.	SABINE.
A ſœur, qui ie vous die vne bonne nouuelle.	À sœur, qui Rome vous die une bonne nouvelle.
M	M
CAMILLE.	CAMILLE.
Ie penſe la ſçauoir, s’il faut la nommer telle, On l’a dite à mon pere, & i’eſtois auec luy, Mais ie n’en conçoy rien qui flatte mon ennuy, Ce delay de nos maux rẽdra leurs coups plus rudes, Ce n’eſt qu’vn plus long terme à nos inquietudes, Et tout l’allegement qu’il en faut eſperer, C’eſt de pleurer plus taid etux qu'al laduta pleurer.	Je pense la savoir, s'il faut la nommer telle, On l'a dite à mon père, et j'étais auec luy, Mais apprendre n'en conçois rien qui flatte mon ennui, Ce délai de nos maux rudra leurs coups plus rudes, Ce n'est qu'un plus long terme à nos inquiétudes, Et tout l'allégement qu'il en faut espérer, C'est de pleurer plus taid et qu'al laduta pleurer.
SA	SA
SABINE.	SABINE.
Les Dieux n’ont pas en vain inſpiré ce tumulte.	Les Dieux n'ont pas en vain inspiré ce tumulte.
CAMILLE.	CAMILLE.
ſulte.	sute.
Diſons pluſtoſt, ma ſœur, qu’en vain on les conLes meſmes Dieux à Tulle ont inſpiré ce choix, Et la voix du public n’eſt pas touſiours leur voix.	Disons plutôt, ma sœur, qu'en vain on les conLes mêmes Dieux à Tulle ont inspiré ce choix, Et la voix du public n'est pas toujours leur voix.
Que dans l’ame des Rois leurs viuantes images.	Que dans l'âme des Rois leurs vivantes images.
Et de qui l’abiolue & iamte autnonte Eſt vn rayon ſecret de leur diuinité.	Et de qui l'abiolue et jamte autnonte Est un rayon secret de leur divinité.
IVLIE.	IVLIE.
C’eſt vouloir ſans raiſon vous former des obſtacles (cles, Que de cherchet leut voix ailleurs qu’en leurs oraEt vous ne vous pouuez figurer tout perdu Sans dementir celuy qui vous fut hier rendu.	C'est vouloir sans raison vous former des obstacles (cles, Que de cherchet lut voix ailleurs qu'en leurs orat vous ne vous pouvez figurer tout perdu Sans démentir celui qui vous fut hier rendu.
CAMILLE.	CAMILLE.
Vn oracle iamais ne ſe laiſſe comprendre, (tendre, On l’entend d’autant moins que plus en croit l’enEt loin de s’aſſeuret ſur vn pareil arreſt, (l’eſt.	Un oracle jamais ne se laisse comprendre, (tendre, On l'entend d'autant moins que plus en croit l'enEt loin de s'assuret sur un pareil arrêt, (l'est.
Qui n’y voit rien d’obſcur doit croire que tout SABINE.	Qui n'y voit rien d'obscur doit croire que tout SABINE.
rance, Sur ce qui fait pour nous prenons plus d’aſſeuEt ſouffrons les douceurs d’vne iuſte eſperance.	rance, Sur ce qui fait pour nous prenons plus d'assèvEt souffrons les douceurs d'une juste espérance.
Quand la faueur du Ciel ouure à demy ſes bras, Qui ne s’en promet rien ne la merite pas, I'emperenie iouuent qu’elle ne ſe deſploye, Et lots qu’elle deſcend ſon tefus la renuoye.	Quand la faveur du Ciel ouvre à demi ses bras, Qui ne s'en promet rien ne la mérite pas, J'empérénie jouvent qu'elle ne se déploie, Et lots qu'elle descend son tefus la renvoie.
CAMILLELe Cielagit ſans nous en ces euenemens, Et ne les regle point deſſus nos ſentimens.	CAMILLELe Cielagit sans nous en ces événements, Et ne les règle point dessus nos sentiments.
IVLIE.	IVLIE.
Il ne vous à ſait peur que pour vous faire grace, Adieu, ie vay ſçauoir comme en fin tout ſe paſſe, Moderez vos frayeurs, i’eſpere à mon retour, Ne vous entretenir que de propos d’amour, Et que nous n’employerons la fin de la iournée Qu'aux dour preparatiis dl vn heureux Hymenée.	Il ne vous à sait peur que pour vous faire grâce, Adieu, tu vais savoir comme en fin tout se passe, Modérez vos frayeurs, j'espère à mon retour, Ne vous entretenir que de propos d'amour, Et que nous n'emploierons la fin de la journée Qu'aux dour préparatiis d ' Heureux Hyménée.
A BINE.	À BINE.
Comme vous ie l'elpere.	Comme vous ie l'elpère.
CAMILLE.	CAMILLE.
Et ie n’oſe y ſonger.	Et ici n'ose y songer.
Ai BIEo.	Ai BYE.
L’effet nous fera voir qui ſçait mieux en iuger.	L'effet nous fera voir qui sait mieux en juger.
CENE IV.	CÈNE IV.
SABINE, CAMILLE,	SABINE, CAMILLE,
SABINE.	SABINE.
D'Army nos deſplaiſirs ſouffrés que ie vous blaſme.	D'Armi nos déplaisirs souffrez que je vous blâme.
Ie ne puis approuuer tãt de trouble en voſtre ame, Que feriez vouz, ma ſœur, au point où ie me voy Si vous auiez à craindre autant que ie le doy, Et ſi vous attendiez de leurs armes fatales (les?	Je ne puis approuver tant de trouble en votre âme, Que feriez voulez, ma sœur, au point où on me vois Si vous aviez à craindre autant que personne le dois, Et si vous attendiez de leurs armes fatales (les?
Des maux pareils aux miens, & des pertes eſga	Des maux pareils aux miens, et des pertes éga
CAMILLE.	CAMILLE.
Parlez plus ſainement de vos maux & des miens, Chacun voit ceux d’autruy d’vn autre œil que les ſiens, Mais à bien regarder ceux où le Ciel me plonge, Les voſtres apres d’eux vous ſembleront vn ſonge.	Parlez plus sainement de vos maux et des miens, Chacun voit ceux d'autrui d'un autre œil que les siens, Mais à bien regarder ceux où le Ciel me plonge, Les vôtres après d'eux vous sembleront un songe.
La ſeule mort d’Horace eſt à craindre pour vous, Des freres ue ſontrien à l’égal d’vn eſpoux, L’Hymen qui nous attache en vn autre famille, Nous détache de celle où l’on a veſcu fille, On ne compare point des nœuds ſi differens, Et pour ſuiure vn mary l’on quitte ſes parens:	La seule mort d'Horace est à craindre pour vous, Des frères ue si d ifségal ren ts, L'Hymen qui nous attache en un autre famille, Nous détache de celle où l'on a vécu fille, On ne compare point des nœuds si différents, Et pour suivre un mari l'on quitte ses parents:
pere Mais ſi prés d’vn Hymen l’amant que donne vn Nous eſt moins qu’vn eſpoux & non pas moins qu’vn frere, Nos ſentimens entre eux demeurent ſuſpendus, Noſtre choix impoſſible, & nos vœux confondus, Ainſi, ma ſœur, du moins vous auez dans vos plaintes, Où porter vos ſouhaits, & terminer vos craintes, Mais ſi le Ciel s’obſtine à nous perſecuter, Pour moy i’ay tout à craindre & rien à ſouhaiter,	père Mais si prés d' Hymen l'amant que donne un Nous est moins qu'un époux et non pas moins qu'un frère, Nos sentiments entre eux demeurent suspendus, Notre choix impossible, et nos vœux confondus, Ainsi, ma sœur, du moins vous avez dans vos plaintes, Où porter vos souhaits, et terminer vos craintes, Mais si le Ciel s'obstine à nous persécuter, Pour moi j'ai tout à craindre et rien à souhaiter,
SABINE.	SABINE.
Quand il faut que l’vn meure, & par les mains de l’autre.	Quand il faut que l'un meure, et par les mains de l'autre.
ſtre.	stre.
C’eſt vn raiſonnement bien mauuais que le voQuoy que ce ſoient, ma ſœur, des nœuds bien differens, C’eſt ſans les oublier qu’on quitte ſes parens;	C'est un raisonnement bien mauvais que le voQuoi que ce soient, ma sœur, des nœuds bien différents, C'est sans les oublier qu'on quitte ses parents;
L’Hymen n’efface point ces profonds caracteres, Pour aimer vn mary l’on ne haït pas ſes freres, La nature en tout temps garde ſes premiers droits, Aux deſpens de leur vie on ne fait point de choix, Auſſi bien qu’vn eſpoux, ils ſont d’autres nous meſmes, (mes:	L'Hymen n'efface point ces profonds caractères, Pour aimer un mari l'on ne hait pas ses frères, La nature en tout temps garde ses premiers droits, Aux dépens de leur vie on ne fait point de choix, Aussi bien qu' Houx, ils sont d'autres nous mêmes, (mes:
Et tous maux ſont pareils alors qu’ils ſont extréMais l’amant qui vous charme, & pour qui vous bruſlés Ne vous eſt apres tout que vous voulez, Vne mauuaiſe humeur, vn peu de jalouſie, Le peuuent mettre hors de voſtre fantaiſie, Ce quelles font ſouuent, faites le par raiſon, Et laiſſés voſtre ſang hors de comparaiſon, C’eſt crime qu’oppoſer des liens volontaires A ceux que la naiſſance a rendus neceſſaires ordone le ciers obitine a ſous pelceuter, Seule i’ay tout à craindre & rien à ſouhaiter, mais pour vous, le devoir vous donne dans vos plaintes Où porter vos ſouhaits & terminer vos craintes.	Et tous maux sont pareils alors qu'ils sont extréMais l'amant qui vous charme, et pour qui vous brûlez Ne vous est encore tout que vous voulez, Vaine mauvaise humeur, vn eur de jalousie, Le peuvent mettre hors de votre fantaisie, Ce quelles font souvent, faites le par raison, Et laissez votre sang hors de comparaison, C'est crime qu'opposer des liens volontaires À ceux que la naissance a rendus nécessaires ordone le ciers obitine a sous pelcuter, Seule i’, mais pour craindre et rien à souhaiter, mais pour vous, le devoir vous donne dans vos plaintes porter vos souhaits et terminer vos craintes.
CAMILLE.	CAMILLE.
Ie le voy bien, ma ſœur, vous n’aymaſtes iamais, vous Vous ne cognoiſſez point ny l’Amour ny ſes traits:	Je le vois bien, ma sœur, vous n'aimâtes jamais, vous Vous ne connaissez point ainsi l'Amour On ses traits:
4 On peut luy reſiſter quand il commence à naiſtre, Mais non pas le bannir quand il s’eſt rendu maiſtre, Et que l’adueu d’vn pere engageant noſtre foy A faict de ce Tyran vn legitime Roy.	4 On peut lui résister quand il commence à naître, Mais non pas le bannir quand il s'est rendu maître, Et que l'aveu gère engageant notre foi A fait de ce Tyran un légitime Roi.
Il entre auec douceur, mais il regne par force, Et quand l’ame vne fois a gouſté ſon amorce, Vouloit ne plus aymer c’eſt ce qu’elle ne peut, Puiſqu’elle ne peut plus vouloir que ce qu’il veut;	Il entre avec douceur, mais il règne par force, Et quand l'âme une fois a goûté son amorce, Voulait ne plus aimer c'est ce qu'elle ne peut, Puisqu'elle ne peut plus vouloir que ce qu'il veut;
Ses chaines ſont pour nous auſſi fortes que belles.	Ses chaines sont pour nous aussi fortes que belles.
BCENEV.	BCENEU.
Le vieil HORACE, SABINE, CAMILLE.	Le vieil HORACE, SABINE, CAMILLE.
Le vieil HORA CE.	Le vieil HORA CE.
IE viens vous apporter de faſcheuſes novelles;	JE viens vous apporter de fâcheuses novelles;
Mes filles, mais en vain ie voudrois vous celer Ce qu’on ne vous ſçautoit long temps diſſimuler.	Mes filles, mais en vain ie voudrais vous celer Ce qu'on ne vous sautait long temps dissimuler.
Vos freres ſont aux mains, les Dieux ainſi l’otdonnent.	Vos frères sont aux mains, les Dieux ainsi l'otdonnent.
SABINEE.	SABINE.
Ie veux bien l’aduouër, ces nouuelles m’eſtõnent, Et je me m’imaginois dans la divinité Beaucoup moins d’injuſtice, & bien plus de bonté.	Je veux bien l'avouer, ces nouvelles m'estõnent, Et je me m'imaginais dans la divinité Beaucoup moins d'injustice, et bien plus de bonté.
Ne nous conſolez point, la raiſon importune Quand elle oſe combatre vne telle infortune, Nous auons en nos mains la fin de nos douleurs, Qui peut vouloir mourir, peut braver les malheurs.	Ne nous consolez point, la raison importune Quand elle ose combattre un telle infortune, Nous avons en nos mains la fin de nos douleurs, Qui peut vouloir mourir, peut braver les malheurs.
Nous pourrions aiſément faire en voſtre preſence De noſtre deſeſpoir vne fauſſe conſtance, Mais quand ou peut ſans honte eſtre ſans fermeté La vouloir contre-faire eſt vne laſcheté, L’vſage d’vn tel art nous le laiſſons aux hommes, Et ne voulons paſſer que pour ce que nous ſommes.	Nous pourrions aisément faire en votre présence De notre désespoir vne fausse constance, Mais quand ou peut sans honte été sans fermeté La vouloir contrefaire est une lâcheté, L'usage d'un tel art nous le laissons aux hommes, Et ne voulons passer que pour ce que nous sommes.
Nous ne demandons point qu’vn courage ſi fort S’abaiſſe à noſtre exemple à ſe plaindre du ſort;	Nous ne demandons point qu’vn courage si fort S'abaisse à notre exemple à se plaindre du sort;
Receuez ſans fremir ces mortelles alarmes, Voyes couler nos pleurs ſans y meſſer vos larmes.	Recevez sans frémir ces mortelles alarmes, Voies couler nos pleurs sans y messer vos larmes.
en Ml peur toute gaass en as dea depuiais, Gardés voſtre conſtance & ſouffrez nos ſouſpirs.	en Ml peur toute gass en as dea dépuiais, Gardezez votre constance et souffrez nos soupirs.
Le vieil HORACE.	Le vieil HORACE.
Loin de blaſmer les pleurs que ie vous voy reſpandre, Ie croy faire beaucoup de m’en pouuoir defendre, Et cêderois peut-eſtre à de ſi rudes coups Si ie prenois icy meſme intereſt que vous.	Loin de blâmer les pleurs que je vous vois répandre, Je cro faire beaucoup de m'en pouvoir défendre, Et céderais peut-être à de si rudes coups Si tu prenais ici même intérêt que vous.
freres.	frères.
Non qu’Albe par ſon choix m’ait fait hayr vos Tous trois me ſont encor des perſonnes bien cheres, Mais en fin l’amitié n’eſt pas du meſme rang Et n’a point les effets de l’amour ny du ſang.	Non qu'Albe par son choix m'ait fait haïr vos Tous trois me sont encor des personnes bien chères, Mais en fin l'amitié n'est pas du même rang Et n'a point les effets de l'amour ni du sang.
Ie ne ſens point pour eux la douleur qui tourmẽte Sabine comme ſœur, Camille comme amante, Ie puis les regarder comme nos ennemis, Et donne ſans regret mes ſouhaits à mes fils.	Je ne sens point pour eux la douleur qui tourment Sabine comme sœur, Camille comme amante, Je puis les regarder comme nos ennemis, Et donne sans regret mes souhaits à mes fils.
Ils ſont, grace, aux Dieux, dignes de leur patrie.	Ils sont, grâce, aux Dieux, dignes de leur patrie.
Aucun eſtonnement n’a leur gloire fleſtrie, Et i’ay veu leur honneur croiſtre de la moitié, Quandils ont des deux camps refuſé la pitié, Si par quelque fo bleſſe ils l’auoient mandiée, Si leur haute vertu ne l’euſt repudiée, Ma main bien toſt ſur eux m’eſt vangé hautement De l’affront que m’euſt fait ce mol conſentement.	Aucun étonnement n'a leur gloire flétrie, Et j'ai vu leur honneur croître de la moitié, Quandils ont des deux camps refusé la pitié, Si par quelque fo lesse ils l'avaient mandiée, Si leur haute vertu ne l'eût répudiée, Ma main bien tôt sur eux m'est vengé hautement De l'affront que m'eût fait ce mol consentement.
Mais lors qu’en deſpir d’eux on en a voulu d’autres, Ie ne le cele point, i’ay joint mes vœux aux voſtres Si le ciel pitoyable euſt eſcouté ma voix, Albe ſeroit reduite à faire vn autre choix, Nous pourrions voir tantoſt triompher les Horaces, Sans voir leurs bras ſoüillés du ſang des Curiaces Et de l’euenement d’vn combat plus humain Dependroit maintenant l’honneur du nom Romain.	Mais lors qu'en dépir d'eux on en a voulu d'autres, Je ne le cèle point, j'ai joint mes vœux aux vôtres Si le ciel pitoyable eût écouté ma voix, Albe serait réduite à faire un autre choix, Nous ions voir tantôt triompher les Horaces, Sans voir leurs bras soüillés du sang des Curiaces Et de l'événement d'un combat plus humain Dependroit maintenant l'honneur du nom Romain.
La prudence des Dieux autrement en diſpoſe, Sur leur ordre eternel mon eſprit ſe repoſe, Il s’arme en ce beſoin de generoſité, Et du bon-heur public fait ſa felicité.	La prudence des Dieux autrement en dispose, Sur leur ordre éternel mon esprit se repose, Il s'arme en ce besoin de générosité, Et du bonheur public fait sa félicité.
nes Taſchés d’en faire autant pour ſoulager vos peiEt ſongez toutes deux que vous eſtes Romaines, Vous l’eſtes deuenuë, & vous l’eſtes encor:	nés Tâchés d'en faire autant pour soulager vos péiEt songez toutes deux que vous êtes Romaines, Vous l'êtes devenue, et vous l'êtes encor:
Vn ſi glorieux tiltre eſt vn digne treſor, Vn jour, vn iour viendra que par toute la terre, Rome ſe fera craindre à l’eſgal du tonnetre, Et que tout l’Vniuers tremblant deſſous ſes loix, Ce grand nom deuiendra l’ambition des Rois;	Un si glorieux titre est un digne trésor, Un jour, un iour viendra que par toute la terre, Rome se fera craindre à l'égal du tonnetre, Et que tout l'Univers tremblant dessous ses lois, Ce grand nom deviendra l'ambition des Rois;
Les Dieux à noſtre Ænée ont promis cette gloire	Les Dieux à notre Ænée ont promis cette gloire
OCENE VI.	OCE VI.
Le vieil HORACE, SABINE, CAMILLE, IVLIE.	Le vieil HORACE, SABINE, CAMILLE, IVLIE.
Le vieil HORACE.	Le vieil HORACE.
Ous venez vous, Iulie, apprendre la victoire?	Ous venez -vous, Julie, apprendre la victoire?
4V.	4V.
, 11E.	, 11E.
2) Mais pluſtoſt du combat les funeſtes effets, Rome eſt ſuiette d’Albe, & vos fils ſont deffaits, Des trois les deux ſont morts, ſon eſpoux ſeul vous reſte.	2) Mais plutôt du combat les funestes effets, Rome est suite d'Albe, et vos fils sont défaits, Des trois les deux sont morts, son époux seul vous reste.
Le vieil HORACE.	Le vieil HORACE.
O d’vn triſte combat effet vrayement funeſte?	Ô d'un triste combat effet vraiment funeste?
Rome eſt ſuiette d’Albe, & pour l’en garantir Il n’a pas employé iuſqu’au dernier ſoupir!	Rome est suite d'Albe, et pour l'en garantir Il n'a pas employé jusqu'au dernier soupir!
Non, non, cela n'eſt point, on vous trompe, luſies Rome Rome n’eſt point ſuiette, ou mon fils eſt ſans vie, Ie cognois mieux mon ſang, il ſçait mieux ſon devofr	Non, non, cela n'est point, on vous trompe, lusies Rome Rome n'est point suite, ou mon fils est sans vie, Je connais mieux mon sang, il sait mieux son dévofr
IVLIE.	IVLIE.
Mille de nos ramparts comme moy l’ont peu voir.	Mille de nos remparts comme moi l'ont pu voir.
Il s’eſt fait admirer tant qu’ont duré ſes freres, Mais comme il s’eſt veu ſeul contre trois adverlaltes, Preſt d’eſtre enfermé d’eux ſa fuite l’a ſauué,	Il s'est fait admirer tant qu'ont duré ses frères, Mais comme il s'est vu seul contre trois adverlaltes, Prêt d'être enfermé d'eux sa fuite l'a sauvé,
Le vieil HORACE.	Le vieil HORACE.
Et nos ſoldats trahis ne l’ont pas achevé!	Et nos soldats trahis ne l'ont pas achevé!
traite?	traite?
Dans leurs rangs à ce laſche ils ont donné re	Dans leurs rangs à ce lâche ils ont donné re
IVLIE.	IVLIE.
Ie i'ay fien rountt voir apres cette defaite.	Je j'ai sien rount voir après cette défaite.
O mes freres!	Ô mes frères!
CAMILLE.	CAMILLE.
Le vieil HORACE.	Le vieil HORACE.
Tout beau ne les pleurés pas tous, Deux iouyſſent d’vn ſort dont leur pere eſt ialoux, Que des plus nobles fleurs leur tombe ſoit couuerte, La gloite de leur mort m’a payé de leur perte, Ce bon-heur a ſuiuy leur courage inuaincu Qu’ils ont veu Rome libre autant qu’ils ont veſcu, Et ne l’auront point veuë obeyr qu’a ſon Prince, Ny d’vn eſtat voiſin deuenir la Prouince.	Tout beau ne les pleurés pas tous, Deux jouissent d'un sort dont leur père est jaloux, Que des plus nobles fleurs leur tombe soit couverte, La gloite de leur mort m'a payé de leur perte, Ce bonheur a suivi leur courage invaincu Qu'ils ont vu Rome libre autant qu'ils ont vécu, Et ne l'auront point vue obéir qu'a son Prince, Ni d'un état voisin devenir la Province.
Pleurez l’autre, pleurez l’itreparable affront Quie lafunte nonteure mpimle dhente lront, Pleurez le deshonneur de toute noſtre race, Et l’opprobre eternel qu’il laiſſe au nom d’Horace.	Pleurez l'autre, pleurez l'itréparable affront Quie lafunte nonteure mpimle denté lront, Pleurez le déshonneur de toute notre race, Et l'opprobre éternel qu'il laisse au nom d'Horace.
IVLIE.	IVLIE.
Que vouliez vous qu’il fiſt contre trois?	Que vouliez -vous qu'il fît contre trois?
Le vieil HORACE.	Le vieil HORACE.
Qu’il mouruſt.	Qu'il mourût.
On qu’vn beau deſeſpoir alors le ſecouruſt N’euſt-il que d’vn moment reculé ſa deffaite, Roine Rome euſt eſté du moins vn peu trop tard ſuiette, Il euſt auec honneur laiſſée mes cheueux gris, Et c’eſtoit de ſa vie vn aſſez dignez prix, Il eſt de tout ſon ſang comptable à ſa patrie, Chaque goute eſpargnée a ſa gloite fleſtrie, Chaque inſtant de ſa vie apres ce laſche tour, Met d’autant plus ma honte auec la ſienne au iour.	On qu'un beau désespoir alors le secourût N'eût-il que d'un moment réculé sa défaite, Roine Rome eût été du moins un peu trop tard suite, Il eût avec honneur laissée mes cheveux gris, Et c'était de sa vie un assez dignez prix, Il est de tout son sang comptable à sa patrie, Chaque goute épargnée à sa gloite flétrie, Chaque instant de sa vie après ce lâche tour, Met d'autant plus ma honte avec la sienne au jour.
I’en rompray bien le cours, & ma iuſte colere Contre vn indigne fils vſant des droits d’vn pere Sȩaura bienralre voir daiis la puſsition L’eſclatant deſadueu d’vne telle action.	J'en romprai bien le cours, et ma juste colère Contre un indigne fils usant des droits d'un père Sacaura bienralère voir daiis la pussition L'éclatant désaveu ne telle action.
SABINE.	SABINE.
Eſcoutez vn peu moins ces ardeurs genereuſes, Et ne nous rendez point tout à fait mal heureuſes,	Écoutez un peu moins ces ardeurs généreuses, Et ne nous rendez point tout à fait mal heureuses,
Le vieil HORACE.	Le vieil HORACE.
Sabine, voſtre cœur ſe conſole aiſément, (ment, Nos malheurs iuſqu’icy vous touchent foibleVous n’auez point encor de part à nos miſeres, Le Cieil vous à ſauué voſtre eſpoux & vos freres, Si nous ſommes ſuiets, c’eſt de voſtre pays, (trahis, Vos fietes ſont vainqueurs quand nous ſommes Et voyant le haut point où leur gloire ſe monte (æe:	Sabine, votre cœur se console aisément, (ment, Nos malheurs jusqu'ici vous touchent foibleVous n'avez point encor de part à nos misères, Le Cieil vous à sauvé votre époux et vos frères, Si nous sommes sujets, c'est de votre pays, (trahis, Vos fiètes sont vainqueurs quand nous sommes Et voyant le haut point où leur gloire se monte (æe:
Vous regardez fort peu ce qui nous vient de honMais voſtre trop d’amour pour cét infame eſpoux, Vous donnera bien toſt à plaindre comme à nous.	Vous regardez fort peu ce qui nous vient de honMais votre trop d'amour pour cet infâme époux, Vous donnera bien tôt à plaindre comme à nous.
Vos pleurs en ſa faueur ſont de foibles defenſes, l’atteſte des grands Dieux les ſuprémes puiſſances Qu’autant ce iour finy ces mains, ces propres mains, Laueront dans ſon ſang la honte des Romains.	Vos pleurs en sa faveur sont de faibles défenses, l'atteste des grands Dieux les suprémes puissances Qu'autant ce jour fini ces mains, ces propres mains, Laveront dans son sang la honte des Romains.
SABINE.	SABINE.
Suiuons-le promptement, la colere l’emporte.	Suivons-le promptement, la colère l'emporte.
Dieux!	Dieux!
verrons nous touſiours des malheurs de la 4 ſorte?	verrons nous toujours des malheurs de la 4 sorte?
grands, Nous faudra- t’il touſiours en craindre de plus Et touſiours redouter la main de nos parents?	grands, Nous faudra- t-il toujours en craindre de plus Et toujours redouter la main de nos parents?
Mn du troiſieſme Acte.	Mn du troisième Acte.
ACTE	ACTE
TRAGEDIE.	TRAGÉDIE.
ACTE IV.	ACTE IV.
SCENE PREMIERE.	SCÈNE PREMIÈRE.
Le vieil HORACE, CAMILLE.	Le vieil HORACE, CAMILLE.
Le vieil HORACE.	Le vieil HORACE.
E me parlez iamais en faueur d’vn infame, (femme, Qu’il me fuye à l’eſgal des freres de ſa Pour conſeruer vn ſang qu’il tient ſi precieux Il n’a rien fait encoi s’il n’éuite mes yeux.	E me parlez jamais en faveur d'un infâme, (femme, Qu'il me fuie à l'égal des frères de sa Pour conserver un sang qu'il tient si précieux Il n'a rien fait encoi s'il n'évite mes yeux.
Sabine y peut mettre ordre, ou derechef i’atteſte, Le ſouuerain pouuoir de la troupe celeſte.	Sabine y peut mettre ordre, ou derechef j'atteste, Le souverain pouvoir de la troupe céleste.
CAMILLE.	CAMILLE.
Hé!	Hé!
mon pere, prenez vn plus doux ſentiment, Vous verrez Rome meſmé en vſet autrement.	mon père, prenez un plus doux sentiment, Vous verrez Rome mémé en uset autrement.
Et de quelque malheur que le Ciel l’ait comblée, Excuſer la vertu ſoubs le nombre accablée.	Et de quelque malheur que le Ciel l'ait comblée, Excuser la vertu sous le nombre accablée.
Le vieil HORACE.	Le vieil HORACE.
Le iugement de Rome eſt peu pour mon regard, Camille, ie ſuis pere, & i’ay mes droits à part.	Le jugement de Rome est peu pour mon regard, Camille, Elle suis père, et j'ai mes droits à part.
Ie ſçay trop comme agit la vertu veritable, C'eſt fans en triompher que le homore i'accable, Et ſa maſle vigueur touſiours en meſme point Sueconibe ioubs ia lorce & ne luy cede point.	Je sais trop comme agit la vertu véritable, C'est sans en triompher que le honore j'accable, Et sa mâle vigueur toujours en même point Sueuonibe joubs ja lorce et ne lui cede point.
Taiſez-vous, & ſçachons ce que nous veut Valere.	Taisez-vous, et sachons ce que nous veut Valère.
SCENE II.	SCÈNE II.
Le vieil HORACE, VALERE, CAMILLE.	Le vieil HORACE, VALÈRE, CAMILLE.
2 VALERE.	2 VALÈRE.
G Nuoyé par le Roy pour conſoler vn pere, LEt pour luy teſmoigner.	G Nuoyé par le Roi pour consoler un père, LEt pour lui témoigner.
Le vieil HORACE.	Le vieil HORACE.
N’en prenez aucun ſoin, Cet C’eſt vn ſoulagement dont ie n’ay pas beſoin, Et i’ayme mieux voir morts que couuerts d’infamie Ceux que vient de m’oſter vne main ennemie;	N'en prenez aucun soin, Cet C'est un soulagement dont ie j'ai pas besoin, Et j'aime mieux voir morts que couverts d'infamie Ceux que vient de m'ôter une main ennemie;
Tous deux pour leur pays ſont mors en gens d’honneur, Il me ſuffit,	Tous deux pour leur pays sont mors en gens d'honneur, Il me suffit,
VALERE.	VALÈRE.
mais l'auitre eit vn tare bonheur, De tous les trois chez vous il doit tenir la place.	mais l'avitre eit un tare bonheur, De tous les trois chez vous il doit tenir la place.
Le vieil HORACE.	Le vieil HORACE.
Euſt-il fait auec luy perir le nom d’Horace,	Eût-il fait avec lui périr le nom d'Horace,
VALERE.	VALÈRE.
Seul vous le mal traités apres ce qu’il a fait.	Seul -vous le mal traitez après ce qu'il a fait.
Le vieil HORACE.	Le vieil HORACE.
C eit a moy teur aum de pumt ion rorfaite	C' it a moi teur aum de pumt ion rorfaite
VALERE.	VALÈRE.
Quel forfait trouuez vous en ſa bonne conduite?	Quel forfait trouvez -vous en sa bonne conduite?
Le vieil HORACE.	Le vieil HORACE.
Quel eſclat de vertu trouuez vous en ſa fuite?	Quel éclat de vertu trouvez -vous en sa fuite?
VALERE.	VALÈRE.
La fuite eſt glorieuſe en ceſte occaſion.	La fuite est glorieuse en cette occasion.
Levien ΠORACE.	Levien ORACE.
Vous tedoublez ma honte & ma confuſion, Certes l’exemple eſt rare & digne de memoire De trouuer dans la fuite vn chemin à la gloire.	Vous tedoublez ma honte et ma confusion, Certes l'exemple est rare et digne de mémoire De trouver dans la fuite un chemin à la gloire.
VALERE.	VALÈRE.
Quelle comunon, ce quene nonte a vous.	Quelle comunon, ce quène nonte a vous.
D’auoir produit vn fils qui nous conſerve tous, Qui fait triompher Rome, & luy gaigne vn empire?	D'avoir produit un fils qui nous conserve tous, Qui fait triompher Rome, et ton gagne un empire?
aſpire?	aspire?
A quels plus grands honneurs faut-il qu’vn pere	À quels plus grands honneurs faut-il qu'un père
Le vieil HORACE.	Le vieil HORACE.
Quels honneurs, quel triomphe, & quel empire enfin Lors qu’Albe ſoubs ſes loix range noſtre deſtin:	Quels honneurs, quel triomphe, et quel empire enfin Lors qu'Albe sous ses lois range notre destin:
VA	VA
VALERE.	VALÈRE.
Que parlez vous icy d’Albe, & de ſa victoire?	Que parlez -vous ici d'Albe, et de sa victoire?
lgnorez vous encor la moitie de l'hiſtoire?	Lgnorez -vous encor la moitie de l'histoire?
Le vieil HORACE.	Le vieil HORACE.
Le combat par ſa fuité eſt-il pas terminé?	Le combat par sa fuité est-il pas terminé?
VALERE.	VALÈRE.
Albe ainſi quelque temps ſe l’eſt imaginé, (me Mais ene a bient tort veu que e eitoit fuir en homQui ſçauoit meſnager l’auantage de Rome.	Albe ainsi quelque temps se l'est imaginé, (me Mais ene a bient tort vu que e itait fuir en homQui savait ménager l'avantage de Rome.
Le vien HORACE.	Le viens HORACE.
Quoy, Rome donc triomphe?	Quoi, Rome donc triomphe?
VALERE.	VALÈRE.
Apprenez, apprenez La valeur de ce fils qu’à tort vous condemnez Reſté ſeul contre trois, mais en ceſte auanture Tous trois eſtans bleſſez & luy ſeul ſans bleſſure, Trop foible pour eux tous, trop fort pour chacun d’eux.	Apprenez, apprenez La valeur de ce fils qu'à tort vous condamnez Resté seul contre trois, mais en cette aventure Tous trois étants blessés et un seul sans blessure, Trop faible pour eux tous, trop fort pour chacun d'eux.
Il ſçait bien ſe retirer d’vn pas ſi hazardeux, (ruſe Il fuit pour mieux combatre, & cette prompte Diuiſe adroitement trois freres qu’elle abuſe, Chacun le ſuit d’vn pas ou plus ou moins preſſé, Selon qu’il ſe rencontre ou plus ou moins bleſſé, Leur ardeur eſt eſgale à pour ſuiure ſa fuite, Mais leurs coups inégaux ſeparent leur pourſuite, Horace les voyant l'vn de l’autre eſcartez, Se retourne, & deſia les croit demy domprez, Il attend le premier & c’eſtoit voſtre gendre:	Il sçait bien se retirer d'Hôn pas si hazardeux, (roise Il fuit pour mieux combattre, et cette prompte Divise adroitement trois frères qu'elle abuse, Chacun le suit d'un pas ou plus ou moins pressé, Selon qu'il se rencontre ou plus ou moins blessé, Leur ardeur est égale à pour suivre sa fuite, Mais leurs coups inégaux séparent leur poursuite, Horace les voyant l'un de l'autre écartés, Se retourne, et déjà les croit demi iomprez, Il attend le premier et c'était votre gendre:
L’autre tout indigné qu’il ait oſé l’attendre, En vain en l’attaquant fait paroiſtre vn grand cœur, 11.	L'autre tout indigné qu'il ait osé l'attendre, En vain en l'attaquant fait paraître un grand cœur, 11.
10( Le ſang qu’il a perdu rallentit ſa vigueur.	10( Le sang qu'il a perdu ralentit sa vigueur.
Albe à ſon tour commence à craindre vn ſort contraire, Elle crie au ſecond qu’il ſecoure ſon frere, Il ſe haſte & s’eſpuiſe en efforts ſuperflns.	Albe à son tour commence à craindre un sort contraire, Elle crie au second qu'il secoure son frère, Il se hâte et s'épuise en efforts superfls.
arttouue enles joiguant que ſon frereur eſt plus,	artoue enles joiguant que son frèreur est plus,
Helase CAMILLE.	Hélase CAMILLE.
VALERE.	VALÈRE.
Tout hors d’haleine il prend pourtant ſa place, Et redouble bien toſt la victoire d’Horace, Son courage ſans force eſt vn debile appuy, Voulant vanger ſon frere il tombe aupres de luy.	Tout hors d'haleine il prend pourtant sa place, Et redouble bien tôt la victoire d'Horace, Son courage sans force est un débile appui, Voulant venger son frère il tombe auprès de Seigneur.
L’air reſonne des cris qu’au Ciel chacun enuoye, Albe en iette d’angoiſſe & les Romains de ioye.	L'air résonne des cris qu'au Ciel chacun envoie, Albe en jette d'angoisse et les Romains de joie.
Comme noſtre Heros ſe voit prés d’acheuer, C’eſt peu pour luy de vaincre, il veut encor brauer:	Comme notre Héros se voit près d'achever, C'est peu pour lui de vaincre, il veut encor braver:
I’en viens d’immoler deux aux Manes de mes freres, Rome aura le dernier de mes trois aduerſaires, C’eſt à ſes intereſts que ie vay l’immoler, (Dit-il) & tout d’vn temps on le voit y voler, La victoire entr’eux deux n’eſtoit pas incertaine, L’Albain percé de coups ne ſe traiſnoit qu’à peine, la Et comme vne victime aux marches de l’Autel, Il ſembloit preſenter ſa gorge au coup mortel;	J'en viens d'immoler deux aux Manes de mes frères, Rome aura le dernier de mes trois adversaires, C'est à ses intérêts que sans vais l'immoler, (Dit-il) et tout d'un temps on le voit y voler, La victoire entr'eux deux n'était pas incertaine, L'Albain percé de coups ne se traînait qu'à peine, la Et comme une victime aux marches de l'Autel, Il semblait présenter sa gorge au coup mortel;
Auſſi le reçoit-il, peu s’en faut, ſans deffence, Et ſon treſpas de Rome eſtablit la puiſſance.	Aussi le reçoit-il, peu s'en faut, sans défense, Et son trépas de Rome établit la puissance.
Le vieil HORACE.	Le vieil HORACE.
O mon fils, ô ma ioye, ô l’honneur de nos iours!	Ô mon fils, ô ma joie, ô l'honneur de nos jours!
O d’vn eſtat panchant l’ineſperé ſecours!	Ô d'un état penchant l'inespéré secours!
Vertu digne de Rome, & ſang digne d’Horace, Appuy de ton pays & gloire de ta race!	Vertu digne de Rome, et sang digne d'Horace, Apui de ton pays et gloire de ta race!
ments Quand pourray-ie eſtouffer dans tes embraſſeL’erreur dont i’ay formé de ſi faux ſentiments?	mens Quand pourrai-je étouffer dans tes embrasseL'erreur dont j'ai formé de si faux sentiments?
Quand pourra mon amour baigner auec tendreſſe Ton front victorieux de larmes d’allegreſſe?	Quand pourra mon amour baigner avec tendresse Ton front victorieux de larmes d'allégresse?
VALERE.	VALÈRE.
Vos careſſes bien toſt pourront ſe deſployer, Le Roy dans vn moment vous le va renuoyer, Et remet à demain le pompeux ſacrifice Que nous deuons aux Dieux pour vn tel benefice, Auiourd’huy ſeulement on s’acquitte vers eux Par des chants de victoire & par de ſimples vœux;	Vos caresses bien tôt pourront se déployer, Le Roi dans un moment vous le va renvoyer, Et remet à demain le pompeux sacrifice Que nous devons aux Dieux pour un tel bénéfice, Aujourd'hui seulement on s'acquitte vers eux Par des chants de victoire et par de simples vœux;
C’eſt où le Roy le mene, & tandis il m’enuoye Faire office vers vous de douleur & de ioye, Mais cet office encor n’eſt pas aſſez pour luy, Il y viendra luy-meſme & peut-eſtre auiourd’huy.	C'est où le Roi le mène, et tandis il m'envoie Faire office vers vous de douleur et de joie, Mais cet office encor n'est pas assez pour un, Il y viendra lui-même et peut-même aujourd'hui.
Cette belle action ſi puiſſamment le touche, Qu’il vous veut rendre grace, & de ſa propre bouche, D’auoir donné vos fils au bien de ſon eſtat.	Cette belle action si puissamment le touche, Qu'il vous veut rendre grâce, et de sa propre bouche, D'avoir donné vos fils au bien de son état.
Le vieil HORACE.	Le vieil HORACE.
De teis remeiciements ont pour moy trop d’eſclat, Et ie me tiens deſia trop payé par les voſtres Du ſeruice de l’vn & du ſang des deux autres.	De teis reméiciements ont pour moi trop d'éclat, Et tu me tiens déjà trop payé par les vôtres Du service de l'une et du sang des deux autres.
VALERE.	VALÈRE.
Le Roy ne ſçait que c’eſt d’honorer à demy, Et ſon ſceptre arraché des mains de l’ennemy, Fait qu’il eſtime encor l’honneur qu’il vous veur faire;	Le Roi ne sait que c'est d'honorer à demi, Et son sceptre arraché des mains de l'ennemi, Fait qu'il estime encor l'honneur qu'il vous veut faire;
Au deſſous du merite & du fils & du pere.	Au dessous du mérite et du fils et du père.
ic vay luy temioiglier queis nooies ſentiments La vertu vous inſpire en tous vos mouuements, Et combien vous monſtrez d’ardeur pour ſon ſeruice.	ic vais beau temioiglier queis noères sentiments La vertu vous inspire en tous vos mouvements, Et combien vous montrez d'ardeur pour son service.
Le vieil HORACE.	Le vieil HORACE.
Ie vous deuray beaucoup pour vn ſi bon office.	Je vous devrai beaucoup pour un si bon office.
SCENE III.	SCÈNE III.
Levieil HORACE, CAMILLE.	Levieil HORACE, CAMILLE.
Le vieil HORACE.	Le vieil HORACE.
A fille, il n’eſt plus temps de reſpandre des M pleurs, (neurs, Il fied mal d’en verſer où l’on void rant d’honOn pleure iniuſtement des pertes domeſtiques C Malta Quand on en voit ſortir des victoires publiques.	À fille, il n'est plus temps de répandre des M pleurs, (neurs, Il sied mal d'en verser où l'on voit rant d'honOn pleure injustement des pertes domestiques Ç Alta Quand on en voit sortir des victoires publiques.
Rome triomphe d’Albe, & c’eſt aſſez pour nous, Tous nos maux à ce prix nous doiuẽt eſtre doux, En la mort d’vn amant vous ne perdrez qu’vn homme Dont la perte eſt aiſée à reparer dans Rome:	Rome triomphe d'Albe, et c'est assez pour nous, Tous nos maux à ce prix nous doivent être doux, En la mort d'un amant vous ne perdrez qu'Un homme Dont la perte est aisée à réparer dans Rome:
Apres cette victoire il n’eſt point de Romain Qui ne ſoit glorieux de vous donner la main.	Après cette victoire il n'est point de Romain Qui ne soit glorieux de vous donner la main.
Ie m’en vais à Sabine en porter la nouuelle, Ce coup ſera ſans doute aſſez rude pour elle, Et ſes trois freres morts par la main d’vn eſpoux Luy donneront des pleurs bien plus iuſtes qu’à vous:	Je m'en vais à Sabine en porter la nouvelle, Ce coup sera sans doute assez rude pour elle, Et ses trois frères morts par la main d'un époux Lui donneront des pleurs bien plus justes qu'à vous:
Mais i’eſpere aiſément en diſſiper l’orage, (rage, Et qu’vn peu de prudence aydant ſon grand couFera bien toſt regner ſur vn ſi noble cœur Le genereux amour qu’elle doit au vainqueur.	Mais j'espère aisément en dissiper l'orage, (rage, Et qu'un peu de prudence aidant son grand couffera bien tôt régner sur un si noble cœur Le généreux amour qu'elle doit au vainqueur.
Cependans eſtouffez cette laſche triſteſſe, Receuez le, s’il vient, auec moins de foibleſſe, Faites vous voir ſa ſœur, & qu’en vn meſme flanc Le Ciel vous a tous deux formez d’vn meſme ſang.	Cépendants étouffés cette lâche tristesse, Récevez le, s'il vient, avec moins de faiblesse, Faites vous voir sa sœur, et qu'en un même flanc Le Ciel vous a tous deux formez d'un autre sang.
SCENE IV.	SCÈNE IV.
CAMILLE.	CAMILLE.
Vy, ie luy feray voir par d’infallibles marques (ques Qu’vn veritable amout braue la main des ParEt ne prend point de loix de ces cruels tyrans Qu’vn aſtre iniurieux nous donne pour parens, Tu blaſmes ma douleur, tu l’oſes nommer laſche, Ie l’ayme d’autant plus que plus elle te faſche, Impitoyable pere, & par on iuſte effort Ie la veux rendre eſgale aux rigueurs de mon ſort.	Vi, ie luy ferai voir par d'infallibles marques (ques Qu'elle véritable amout brave la main des ParEt ne prend point de lois de ces cruels tyrans Qu'être astre injurieux nous donne pour parents, Tu blâmes ma douleur, tu l'oses nommer lâche, Je l'aime d'autant plus que plus elle te fâche, Impitoyable père, et par on juste effort Je la veux rendre égale aux rigueurs de mon sort.
En vit-on iamais vn dont les rudes traverſes Priſſent	En vit-on jamais un dont les rudes traverses Prissent
priſſent en moins de rien tant de faces diuerſes, Qui fuſt doux tant de fois, & tant de fois cruël.	prissent en moins de rien tant de faces diverses, Qui fût doux tant de fois, et tant de fois cruel.
Et portaſt tant de coups auant le coup mortel?	Et portât tant de coups avant le coup mortel?
Vit on iamais vne ame en iour plus atteinte De ioye & de douleur, d’eſperance & de crainte, Aſſeruie en eſclaue à plus d’euenements, Et le piteux ioüet de plus de changements?	Vit on jamais une âme en jour plus atteinte Deoise et de douleur, d'espérance et de crainte, Asservie en esclave à plus d'événements, Et le piteux jet de plus de changements?
Vn oracle m’aſſeure, vn ſong m'eſpouuante, La bataille m’effraye, & la paix me contente, Mon Hymen ſe prepare, & preſque en vn moment Pour combatre mon frere on choiſit mon amant, Les deux camps mutinez vn tel choix deſaduoüent, Ils rompent la partie, & les Dieux la renouent, Rome ſemble vaincuë & ſeul des trois Albains Curiace en mon ſang n’a point trempé ſes mains;	Un oracle m'assure, ainsi song m'épouvante, La bataille m'effraie, et la paix me contente, Mon Hymen se prépare, et presque en un moment Pour combattre mon frère on choisit mon amant, Les deux camps mutinez un tel choix desaduoüent, Ils rompent la partie, et les Dieux la renouent, Rome semble vaincue et seul des trois Albains Curiace en mon sang n'a point trempé ses mains;
Dieux!	Dieux!
ſentois-je point lors des douleurs trop legeres Pour le malheur de Rome, & la mort des deux freres?	sentais-je point lors des douleurs trop légères Pour le malheur de Rome, et la mort des deux frères?
Me flattoy-je point trop quand ie croyois pouuoir L’aymer encor ſans crime & nourrir quelque eſpoir?	Me flattoi-je point trop quand je croyais pouvoir L'aimer encor sans crime et nourrir quelque espoir?
Sa mort m’en punit bien, & la façon cruelle Dont mon ame eſperduë en reçoit la nouuelle, Son riual me l’apprend, & faiſant à mes yeux D’vn ſi triſte ſuccés le recit odieux, Il porte ſur le front vne allegreſſe ouuerte (perte, Que le bonheur public fait bien moins que ma Et baſtiſſant en l’air ſur le malheur d’autruy Auſſi bien que mon frere il triomphe de luy.	Sa mort m'en punit bien, et la façon cruelle Dont mon âme éperdue en reçoit la nouvelle, Son rival me l'apprend, et faisant à mes yeux D'un si triste succès le récit odieux, Il porte sur le front une allégresse ouuerte (perte, Que le bonheur public fait bien moins que ma Et bâtissant en l'air sur le malheur d'autrui Aussi bien que mon frère il triomphe de même.
Mais ce n’eſt encor rien au prix de ce qui reſte, On demande ma ioye en vn coup ſi funeſte, Il me faut applaudir aux exploits du vainqueur, Et baiſer vne main qui me perce le cœur En vn ſuiet de pleuts ſi grand, ſi legitime, Se plaindre eſt vne honte & ſouſpirer vn crime, Leur brutale vertu veut qu’on s’eſtime heureux, Et ſi l’on n’eſt barbare on n’eſt point genereux, Degenerons, mon cœur, d’vn ſi vertueux pere, Soyons indigne ſœur d’vn ſi genereux frere, C’eſt gloire de paſſer pour des cœurs abbatus Quand la brutalité fait les hautes vertus, (dre?	Mais ce n'est encor rien au prix de ce qui reste, On demande ma joie en un coup si funeste, Il me faut applaudir aux exploits du vainqueur, Et baiser une main qui me perce le cœur En un sujet de pleuts si grand, si légitime, Se plaindre est une honte et soupirer un crime, Leur brutale vertu veut qu'on s'estime heureux, Et si l'on n'est barbare on n'est point généreux, Dégénérons, mon cœur, mon vn si vertueux pereun Soyons indigne sœur d'un si généreux frère, C'est gloire de passer pour des cœurs abbatus Quand la me fait les hautes vertus, dre?
Eſclatés mes douleurs, à quoy bon vous contrainQuand on a tout perdu que ſçauroit-on plus craindre?	Esclatés mes douleurs, à quoi bon vous contrainuand on a tout perdu que saurait-on plus craindre?
Pour ce cruel vainqueur n’ayés point de reſpect, Loin d’éuiter ſes yeux croiſſez à ſon aſpect, Offenſez ſa victoire, irritez ſa colere, Et prenez s’il ſe peut, plaiſir à luy déplaire.	Pour ce cruel vainqueur n'ayez point de respect, Loin d'éviter ses yeux croissez à son aspect, Offensez sa victoire, irrités sa colère, Et prenez s'il se peut, plaisir à lui déplaire.
Il vient, preparons nous à monſtrer conſtamment Ce que doit vne amante à la mort d’vn amant.	Il vient, préparons nous à montrer constamment Ce que doit une amante à la mort d'un amant.
SCENE V.	SCÈNE V.
HORACE, CAMILLE, PROCVLE.	HORACE, CAMILLE, PROCULE.
& deux autres Soldats portant chacun vne eſpée des Curiaces.	et deux autres Soldats portant chacun ton épée des Curiaces.
HORACE.	HORACE.
A ſœur, voicy le bras qui vange nos deux freM res, Le bras qui rompt le cours de nos deſtins contraires, (bras urnous renu mhanttes d’Albe, en fin voicy le Qui ſeul fait auiourd’huy le ſort de deux Eſtats.	À sœur, voici le bras qui venge nos deux fréM rés, Le bras qui rompt le cours de nos destins contraires, (bras urnous renu mhantes d'Albe, en fin voicy le Qui seul fait aujourd'hui le sort de deux États.
voy ces marques d’honneur, ces teſoins de ma gloire, Et rends ce que tu dois à l’heur de ma victoire.	vois ces marques d'honneur, ces témoins de ma gloire, Et rends ce que tu dois à l'honneur de ma victoire.
CAMILLE.	CAMILLE.
Receuez donc mes pleurs, c’eſt ce que ie luy doibs.	Recez donc mes pleurs, c'est ce que ie cy doibs.
HORACE.	HORACE.
Rome n’en veut point voir aprés de tels exploits.	Rome n'en veut point voir après de tels exploits.
Et nos deux freres morts dans le malheur des armes, Sont trop payés de ſang pour exiger des larmes, Quand la perte eſt vangee on il a pitis rien perdu.	Et nos deux frères morts dans le malheur des armes, Sont trop payés de sang pour exiger des larmes, Quand la perte est venge on il a pitis rien perdu.
CAMILLE.	CAMILLE.
Puiſqu’ils ſont ſatisfaits par le ſang eſpandu, Ie ceſſeray pour eux de paroiſtre affligée, Et i’oublieray leur mort que vous auez vangée.	Puisqu'ils sont satisfaits par le sang épandu, Je cesserai pour eux de paraître affligée, Et j'oublierai leur mort que vous avez vengée.
Mais qui me varigera de cene d’vn amant Pour me faire oublier ſa perte en vn moment?	Mais qui me varigera de cène d'Hannant Pour me faire oublier sa perte en un moment?
HORACE.	HORACE.
Que dis tu malheureuſe?	Que dis tu malheureuse?
CAMILLE.	CAMILLE.
O mon chet Curiace!	Ô mon chet Curiace!
HORACE.	HORACE.
O d’vne indigne ſœur l’inſuportable audace!	Ô d'une indigne sœur l'insuportable audace!
D’vn ennemy public dont ie reuiens vainqueur Le nom eſt dans ta bouche, & l’amour dans ton cœur, Ton ardeur criminelle à la vangeance aſpire, Ta bouche la demande & ton cœur la reſpire, Suy moins ta paſſion, regle mieux tes deſirs, Ne me fay plus fougir d’entendre tes louipirs, Tes flames deſormais doiuent eſtre eſtouffées, Banny les de ton ame, & ſonge à mes trophées Qu’il, ſoient doreſnauant ton vnique entretien.	D'un ennemi public dont Seigneur reviens vainqueur Le nom est dans ta bouche, et l'amour dans ton cœur, Ton ardeur criminelle à la vengeance aspire, Ta bouche la demande et ton cœur la respire, Sui moins ta passion, règle mieux tes désirs, Ne me fais plus fougir d'entendre tes louipirs, Tes flammes désormais doivent être étouffées, Banni les de ton âme, et songe à mes trophées Qu'il, soient doresnauant ton unique entretien.
CAMILLE.	CAMILLE.
Donne moy donc, barbare, vn cœur cõme le tien, Et ſi tu veux enfin que ie t’ouure mon ame, Rends moy mon Curiace, ou laiſſe agir ma flame, Ma ioye & mes douleurs dependoient de ſon ſort, Ie l’adorois viuant, & ie le pleure mort.	Donne moi donc, barbare, un cœur comme le tien, Et si tu veux enfin que ie t'ouvre mon âme, Rends moi mon Curiace, ou laisse agir ma flamme, Ma joie et mes douleurs dépendaient de son sort, Je l'adorais vivant, et ainsi le pleure mort.
Ne cherche plus ta ſœur où tu l’auois laſſée, Tu ne reuois en moy qu’vne amante offenſée Qui comme vne furie attachée à tes pas Te veut inceſſamment reprocher ſon treſpas.	Ne cherche plus ta sœur où tu l'avais lassée, Tu ne rêvais en moi qu'une amante offensée Qui comme une furie attachée à tes pas Te veut incessamment reprocher son trépas.
TigrE Tigre affamé de ſang qui me deffends les larmes, Qui veux que dans ſa mort ie trouue encor des charmes, Et que iuſques au Ciel eſleuant tes exploits Moy meſme ie le tuë vne ſeconde fois.	TigrE Tigre affamé de sang qui me défends les larmes, Qui veux que dans sa mort avec trouve encor des charmes, Et que jusques au Ciel élevant tes exploits Moi mêmeait le tuë une seconde fois.
Puiſſent de tels malheurs accompagner ta vie Que tu tombes au point de me porter enuie, Et toy bien toſt ſoüiller par quelque laſcheté Cette gloire ſi chere à ta brutalité!	Puissent de tels malheurs accompagner ta vie Que tu tombes au point de me porter envie, Et toi bien tôt souiller par quelque lâcheté Cette gloire si chère à ta brutalité!
HORACE.	HORACE.
O Ciel, qui vit iamais vne pareille rage!	Ô Ciel, qui vit jamais une pareille rage!
Crois-tu donc que ie ſois inſenſible à l’outrage, Que ie ſouffre en mon ſang ce mortel deshonneur?	Crois-tu donc que ainsi sois insensible à l'outrage, Que tu souffre en mon sang ce mortel déshonneur?
Aijane, uy me cette mnort qur ſait nonre conneur, Et prefere du moins au ſouuenir d’vn homme Ce que doit ta naiſſance aux intereſts de Rome.	Ajane, ou me cette mnort qur sait non conneur, Et préfère du moins au souvenir d' Homme Ce que doit ta naissance aux intérêts de Rome.
CAMILLE.	CAMILLE.
Rome, i’vnique obiet de mon reſſentiment!	Rome, j'unique objet de mon ressentiment!
Rome à qui vient ton bras d’immoler mon amant !	Rome à qui vient ton bras d'immoler mon amant !
Rome qui t’a veu naiſtre, & que ton cœur adore!	Rome qui t'a vu naître, et que ton cœur adore!
Rome en ſin que ie hay parce qu’elle t’houore!	Rome en sin que ici haï parce qu'elle t'houore!
Puiſſent tous ſes voiſins enſembles coniutés Sapper ſes fondemens encor mal aſſeurez, Et ſi ce n’eſt aſſez de toute l’Italie Que l’Orient contr’elle à l’Occident s’allie, Que cent peuples vnis des bouts de l’vniuers Paſſent pour la deſtruire & les mons & les mets, Qu’elle meſme ſur ſoy renuerſe ſes murailles Et de ſes propres mains deſchire ſes entrailles, Que le couroux du Ciel allumé par mes vœux Face pleuuoir ſur elle vn deluge de feux, Puiſſay-ie de mes yeux voir tomber ceſte foudre, Voir ſes maiſons en cendre & tes lauriers en pou dre, Voir le dernier Romain à ſon dernier ſoupir, Moy leuie enettae eaule, & iouin de plaiſir.	Puissent tous ses voisins ensembles coniutés Saper ses fondements encor mal assurés, Et si ce n'est assez de toute l'Italie Que l'Orient contr'elle à l'Occident s'allie, Que cent peuples unis des bouts de l'univers Passent pour la détruire et les m et les ts, Qu'elle avait sur soi renverse ses murailles Et de ses propres mains déchire ses entrailles, Que le couroux le Ciel allumé par mes vœux Face voir sur elle déluge de feux, Puissai-je de mes yeux voir tomber cette foudre, Voir ses maisons en cendre et tes pau en pou , Voir le dernier Romain son dernier soupir, leuie et la, et cou de plaisir.
HORACE mettant l’eſpée à la main, & pour ſuiuant ſa ſœur qui s’enfuit.	HORACE mettant l'épée à la main, et pour suivant sa sœur qui s'enfuit.
C’eſt trop, ma patience à la raiſon fait place, Va dedans les Enfers joindre ton Curiace.	C'est trop, ma patience à la raison fait place, Va dedans les Enfers joindre ton Curiace.
JORNE VI.	JORNE VI.
HORACE, PROCVLE.	HORACE, PROCULE.
PROCVLE.	PROCULE.
Ve venez vous de faire?	Ve venez -vous de faire?
HORACE.	HORACE.
Vn acte de iuſtice, Vn ſemblable forfait veut vn pareil ſupplice.	Un acte de justice, Un semblable forfait veut un pareil supplice.
PROCVLE.	PROCULE.
Vous deuiez la traicter auec moins de rigueur.	Vous deviez la traiter avec moins de rigueur.
HORACE.	HORACE.
Ne me dy point qu’elle eſt & mon ſang & ma ſœur, Mon pere ne peut plus l’aduoüer pour ſa fille, Qui maudit ſon pays renonce à ſa famille.	Ne me dis point qu'elle est et mon sang et ma sœur, Mon père ne peut plus l'avouer pour sa fille, Qui maudit son pays renonce à sa famille.
De noms ſi plains d’amour, ne luy ſont plus permis, De ſes plus chers parent il fait ſes ennemis, Le ſang meſme les arme en haine de ſon crime, La plus prompte vangeance en eſt plus legitime, Et ce ſouhait impie, encore qu’impuiſſant, Eſt vn monſtre qu’il faut eſtouffer en naiſſant.	De noms si plains d'amour, ne lui sont plus permis, De ses plus chers parent il fait ses ennemis, Le sang même les arme en haine de son crime, La plus prompte vengeance en est plus légitime, Et ce souhait impie, encore qu'impuissant, Est un monstre qu'il faut étouffer en naissant.
8 HORACE CENE VII.	8 HORACE CÈNE VII.
MmOdencEs DADINES AROCVLE.	MémOdencEs DADINES AROCULE.
SABINE.	SABINE.
Quoy s’arreſte icy ton illuſtre colote?	Quoi s'arrête ici ton illustre colote?
AY Vien voir mourir ta ſœur dans les bras de ton pere, Vien repaiſtre tes yeux d’vn ſpectacle ſi doux, Ou ſi tu n’es point las de ces genereux coups, Immole au cher pays des vertueux Horaces.	AY Viens voir mourir ta sœur dans les bras de ton père, Viens repaître tes yeux d'un spectacle si doux, Ou si tu n'es point las de ces généreux coups, Immole au cher pays des vertueux Horaces.
Ce reſte malheureux du ſong des Curiaces, Si prodigue du tien n’eſpargne par le leur, Ioints Sabine à Camille, & ta femme à ta ſœur, Nos crimes ſont pareils ainſi que nos miſeres, Ie ſoûpire comme elle & déplore mes fteres, Plus coupable eu ce point contre tes dures loix Qu’elle n’en pleuroit qu’vn & que i’en pleure trois, Qu’aptes ſon chaſtiment ma faute continuë.	Ce reste malheureux du song des Curiaces, Si prodigue du tien n'épargne par le leur, Joints Sabine à Camille, et ta femme à ta sœur, Nos crimes sont pareils ainsi que nos misères, Je soupire comme elle et déplore mes fères, Plus coupable eu ce point contre tes dures lois Qu'elle n'en pleurait qu'un et que j'en pleure trois, Qu'aptes son châtiment ma faute continue.
HORACE.	HORACE.
Seche tes pleurs, Sabine, ou les cache à ma veuë, Rends toy digne du nom de ma chaſte moitié, Et ne m’accable point d’vne indigne pitié.	Séche tes pleurs, Sabine, ou les cache à ma vue, Rends toi digne du nom de ma chaste moitié, Et ne m'accable point d'une indigne pitié.
Si l’abſolu pouuoir d’vne pudique flame (ame, Ne nous laiſſe à tous deux qu’vn penſer & qu’vne C’eſt à toy d’eſleuer tes ſentiments aux miens, Non à moy de deſcendre à la honte des tiens.	Si l'absolu pouvoir d'une pudique flamme (ame, Ne nous laisse à tous deux qu'un penser et qu'une C'est à toi d'élever tes sentiments aux miens, Non à moi de descendre à la honte des tiens.
Ie t’ayme & ie cognoy la douleur qui te preſſe, Embraſſe ma vertu pour vaincre ta foibleſſe, Participe à ma gloire au lieu de la ſouiller, Taſche à t’en reueſtir, non à m’en deſpoüiller.	Je t'aime et ie connais la douleur qui te presse, Embrasse ma vertu pour vaincre ta faiblesse, Participe à ma gloire au lieu de la souiller, Tâche à t'en reuestir, non à m'en dépouiller.
Et tu de mon honneur ſi mortelle ennemie Que ie te plaiſe mieux tombé dans l’infamie?	Et tu de mon honneur si mortelle ennemie Que ie te plaise mieux tombé dans l'infamie?
Sois plus femme que ſœur, & te reglant ſur moy Fay toy de mon exemple vne immuable loy.	Sois plus femme que sœur, et te réglant sur moi Fais toi de mon exemple une immuable loi.
SA	SA
SABINE.	SABINE.
Cherche pour t’imiter des ames plus parfaites, Ie ne t’impute point les pertes que i’ay faites, I’en ay les ſentiments que ie dois en auoir, Et ie m’en prends au ſort pluſtoſt qu’à ton deuoir.	Cherche pour t'imiter des âmes plus parfaites, Je ne t'impute point les pertes que j'ai faites, J'en ai les sentiments que personne dois en avoir, Et ainsi m'en prends au sort plutôt qu'à ton devoir.
Mais auſſi ie renonce à la vertu Romaine Si pour la poſſeder ie dois eſtre inhumaine, Et ne puis voir en moy la femme du vainqueur Sans y voir des vaincus la déplorable ſœur.	Mais aussi ici renonce à la vertu Romaine Si pour la posséder tu dois avoir inhumaine, Et ne puis voir en moi la femme du vainqueur Sans y voir des vaincus la déplorable sœur.
Prenons part en public aux victoires publiques, Pleutons dans la maiſon nos malheurs domeſtiques, Et ne regardons point des biens communs à tous Quand nous voyons des maux qui ne ſoht que pour nous.	Prenons part en public aux victoires publiques, Plutons dans la maison nos malheurs domestiques, Et ne regardons point des biens communs à tous Quand nous voyons des maux qui ne souht que pour nous.
Pourquoy veux tu, cruel, agir d’vn autre ſorte?	Pourquoi veux tu, cruel, agir d'un autre sorte?
Laiſſe en entrant icy tes lauriers à la porte.	Laisse en entrant ici tes lauriers à la porte.
cours Meſle tes pleurs aux miens.	cours Mêle tes pleurs aux miens.
Quoy-ces laſches diſN’arment point ta vettu contre mes triſtes iours !	Quoi-ces lâches disN'arment point ta vétu contre mes tristes jours !
Mon crime redoublé n’eſmeut point ta colere!	Mon crime redoublé n'émut point ta colère!
Que Camille eſt heureuſe!	Que Camille est heureuse!
elle a peu te déplaire, Elle a receu de toy ce qu’elle a pretendu, Et recouure là bas tout ce qu’elle a perdu.	elle a pu te déplaire, Elle a reçu de toi ce qu'elle a prétendu, Et recouvre là bas tout ce qu'elle a perdu.
ſe, Cher eſpoux, cher auteur du tourment qui me preſEſcoute la pitié li ta colere ceſſe, Exerce l’vn ou l’autre apres de tels malheurs A punir ma foibleſſe, ou finir mes douleurs, Io uoiante la hiort pour grace ou pour ſupplice, Qu’elle ſoit vn effet d’amour ou de iuſtice, N’importe, tous ſes traits me ſembleront fort doux Si ie les voy partir de la main d’vn eſpoux.	se, Cher époux, cher auteur du tourment qui me presEscoute la pitié li a colère cesse, Exerce l'un ou l'autre après de tels malheurs A punir ma faiblesse, ou finir mes douleurs, Io oiante la hiort pour grâce ou pour supplice, Qu'elle soit un effet d'amour ou de justice, N'importe, tous ses traits me sembleront fort doux Si après les vois partir de la main d'vn époux.
HORACE.	HORACE.
Quelle iniuſtice aux Dieux d’abandonner aux femmes Vn empire ſi grand ſur les plus belles ames, Et de ſe plaire à voir de ſi foibles vainqueurs Regner ſi puiſſamment ſur les plus nobles cœurst A quel point ma vertu deuient elle reduite?	Quelle injustice aux Dieux d'abandonner aux femmes Un empire si grand sur les plus belles âmes, Et de se plaire à voir de si faibles vainqueurs Règner si puissamment sur les plus nobles cœurt A quel point ma vertu devient elle réduite?
Rien ne la ſçauroit plus garantir que la fuite, Adieu, ne me ſuy point, ou retiens tes ſouſpirs.	Rien ne la saurait plus garantir que la fuite, Adieu, ne me suis point, ou retiens tes soupirs.
SABINE ſeule.	SABINE seule.
O colere, ô pitié, ſourdes à mes deſirs!	Ô colère, ô pitié, sourdes à mes désirs!
laſſe Vous negligez mon crime, & ma dou’eur vous Et ie n’obtiens de vous ny ſupplice, ny grace.	lasse Vous négligez mon crime, et ma douteur vous Et tu n'obtiens de vous ni supplice, ni grace.
Allons y par los pieurs raire elicor vn effort Et n’employons aprés que nous à noſtre mort.	Allons y par los pieurs raire elicor un effort Et n'employons après que nous à notre mort.
Fin dls quarrieſme Acte.	Fin dès quarrième Acte.
ACTEV.	ACTEU.
SCENE PREMIERE.	SCÈNE PREMIÈRE.
Le vieil HORACE, HORACE.	Le vieil HORACE, HORACE.
Ques(Or Le vieil HORACE.	Ques(Or Le vieil HORACE.
Etirons nos regards de cét obiet funeſte Pour admirer icy le iugement celeſte, Quand la gloite nous enfle il ſçait bien comme il faut Confondie noſtre orgueil qui s’eſleue trop haut, Nos plaiſirs les plus doux ne vont point ſans triſteſſe, Il meſle à nos vertus des marques de foibleſſe, Et rarement accorde à noſtre ambition, L’entier & pur honneur d’vne bonne action, Ie ne plains point Camille, elle eſtoit criminelle, Ie me tiens plus à plaindre, & ie te plains plus qu’elle, (main, Moy, d’auoir mis au iour vn cœur ſi peu RoToy, d’auoir par ſa mort deshonnoré ta main.	Etirons nos regards de cet objet funeste Pour admirer ici le jugement celeste, Quand la gloite nous enfle il sait bien comme il faut Confondie notre orgueil qui s'esleue trop haut, Nos plaisirs les plus doux ne vont point sans tristesse, Il mêle à nos vertus des marques de faiblesse, Et rarement accorde à notre ambition, L'entier et pur honneur d'une bonne action, Je ne plains point Camille, elle était criminelle, Je me tiens plus à plaindre, et un te plains plus qu'elle, (main, Moi, d'avoir mis au jour un cœur si peu Roeu, si peu par d' avoir par sa main.
le ne la trouue point iniuſte ny trop prompte, Majs Mais tu pouuois, mon fils, t’en eſpargner la honte, Son crime, quoy qu’enorme & digne du treſpas, Eſtoit mieux impuny que puny par ton bras.	le ne la trouve point injuste ni trop prompte, Maj à tu pouuois, mon fils, t'en épargner la honte, Son crime, quoi qu’énorme et digne du trépas, Était mieux impuni que puni par ton bras.
HORACE.	HORACE.
Diſpoſés de mon ſort, les loix vous en ſont maiſtre, (naiſtre, I’ay creu deuoir ce coup aux lieux qui m’ont veu Si mon zele au pays vous ſemble criminel, S’il m’en faut receuoir vn reproche eternel, Si ma main en deuient honteuſe & profanée, Vous pouuez d’vn ſeul mot trancher ma deſtinée, Reprenez voſtre ſang de qui ma laſcheté A ſi mal à propos ſoüillé la puréte, Ma main n’a peu ſouffrir de crime en voſtre race, Ne ſouffrez point de tache en la maiſon d’Horace, C’eſt en ces actions dont l’honneur eſt bleſſé Qu’vn pere tel que vous ſe monſtre intereſſé, Son amour doit ſe taire ou toute excuſe eſt nulle, Luy meſme il y prend part lors qu’il les diſſimule, Et de ſa propre gloire il fait trop peu de cas Quand il ne punit point ce qu’il n’approuue pas.	Disposez de mon sort, les lois vous en sont maître, (naistre, J'ai cru deuoir ce coup aux lieux qui m'ont vu Si mon zèle au pays vous semble criminel, S'il m'en faut recevoir un reproche éternel, Si ma main en devient honteuse et profanée, Vous pouvez d'un seul mot trancher ma destinée, Reprenez votre sang de qui ma lascheté A si mal à propos soüillé la puréte, Ma main n'a pu souffrir de crime en votre race, Ne souffrez point de tache en la maison d'Horace, C'est en ces actions dont l'honneur est blessé pere tel que vous se monstre interessé, Son amour doit se taire ou toute excuse est nulle, même il y prend part lors il les dissimule, Et de sa propre gloire il fait trop peu de cas Quand il ne punit point ce il approuue pas.
Le vieil HORACE.	Le vieil HORACE.
Il n’vſe pas touſiours d’vne rigueur extréme, Il eſpargne ſes fils bien ſouuent pour ſoymeſme, da vieilleſle lur eux ayme dtouiteni, Et ne les punit point pour ne ſe pas punir Ie te voy d’vn autre œil que tu ne te regardes, (des.	Il n'une pas toujours d'une rigueur extrême, Il épargne ses fils bien souvent pour soymesme, da vieillesse lur eux âme douiteni, Et ne les punit point pour ne se pas punir Je te vois d'un autre ir que tu ne te regardes, (des.
le rguy, mlais le ſeoy vient, le vois entrerles gar	le rgui, mêlais le seoy vient, le vois entrerles gar
SCENE II.	SCÈNE II.
TVLLE, Le vieil HORACE, VALERE, HORACE, Troupe des Gardes.	TULLE, Le vieil HORACE, VALÈRE, HORACE, Troupe des Gardes.
Le vieil HORACE.	Le vieil HORACE.
A HSire, vn tel honneur à trop d’excez pour IY moy, (Roy, Ce n’eſt point en ce lieu que ie dois voir mon Permettez qu’à genoux.	À HYdire, un tel honneur à trop d'excès pour IY moi, (Roi, Ce n'est point en ce lieu que je dois voir mon Permettez qu'à genoux.
TVL	TUL
TVLLE.	TULE.
Non, luez-vous, mon pere, Ie fay ce qu’en ma place vn bon Prince doit faire.	Non, luez-vous, mon père, Je fais ce qu'en ma place un bon Prince doit faire.
Vn ſi rare ſeruice, & ſi fort important Veut l’honneur le plus rare, & le plus eſclatant:	Un si rare service, et si fort important Veut l'honneur le plus rare, et le plus éclatant:
Vous en auiez deſia ſa parole pour gage, Ie ne l’ay pas voulu differer dauantage.	Vous en aviez déjà sa parole pour gage, Je ne l'ai pas voulu différer davantage.
I’ay ſçeu par ſon rapport ( & ie n’en doutois pas) Comme de vos deux fils vous portez le treſpas.	J'ai su par son rapport ( et ie n'en doutais pas) Comme de vos deux fils vous portez le trépas.
Et que deſia voſtre ame eſtant trop reſoluë Ma conſolation vous ſeroit ſuperfluë:	Et que déjà votre âme étant trop résolue Ma consolation vous serait superflue:
Mais ie viens de ſçauoir quel eſtrange malheur D’vn fils victorieux a ſuiuy la valeur, Et que ſon trop d’amour pour la cauſe publique Aur leu flariirit loupere otte vnle fille unique, Ie ſçay que peut ce coup ſur l’eſprit le plus fort, Et le doute comment vous portez cette mort.	Mais petit viens de savoir quel étrange malheur D'un fils victorieux a suivi la valeur, Et que son trop d'amour pour la cause publique Aur leu flariirit loupère otte vnle fille unique, Je sais que peut ce coup sur l'esprit le plus fort, Et le doute comment vous portez cette mort.
Le vieil HORACE.	Le vieil HORACE.
Sire, auec deſplaiſir, mais auec patience.	Sire, avec déplaisir, mais Seigneur patience.
Sire, puiſque le Ciel entre les mains des Rois Depoſe ſa iuſtice & la force des loix, Et que l’Eſtat demande aux Princes legitimes Des prix pour les vertus, des peines pour les crimes.	Sire, puisque le Ciel entre les mains des Rois Dépose sa justice et la force des lois, Et que l'État demande aux Princes légitimes Des prix pour les vertus, des peines pour les crimes.
couffrez	couffrez
TVLLE.	TULE.
C’eſt l’effet vertueux de voſtre experience, Beaucoup par vn long aage ont appris comme vous Que le malheur ſuccede au bonheur le plus doux, Peu ſçauent comme vous s’appliquer ce remede, Et dans leut intereſt toute leur vertu cede.	C'est l'effet vertueux de votre expérience, Beaucoup par un long aage ont appris comme vous Que le malheur succède au bonheur le plus doux, Peu savent comme vous s'appliquer ce remède, Et dans lut intérêt toute leur vertu cède.
Si vous pouuez trouuer dans ma compaſſion Quelque ſoulagement pour voſtre affliction, Ainſi que voître mal ſçachez qu’elle eſt extréme, Et que Tulle vous plaint autant comme il vous ayme.	Si vous pouvez trouver dans ma compassion Quelque soulagement pour votre affliction, Ainsi que voître mal sachez qu'elle est extrême, Et que Tulle vous plaint autant comme il vous aime.
VALERE.	VALÈRE.
Souffrez qu’vn bon furet vous face ſouuenir.	Souffrez qu'un bon furet vous face souvenir.
Que vous plaignez beaucoup ce qu’il vous faut punit, Souffiez.	Que vous plaignez beaucoup ce qu'il vous faut punit, Souffiez.
Le vieil HORACE.	Le vieil HORACE.
Quoy?	Quoi?
qu’on enuoye vn vainqueur au ſupplice?	qu'on envoie un vainqueur au supplice?
FVLLE.	FULE.
Permettez, qu’il acheue, & ie feray iuſtice, (lieu, I’ayme à la rendre à tous, à toute heure, en tout C’eſt par elle qu’vn Roy ſe fait vn demy Dieu, Et c’eſt dont ie vous plains qu’apres vn tel ieruice.	Permettez, qu'il achève, et un ferai justice, (lieu, J'aime à la rendre à tous, à toute heure, en tout C'est par elle qu'un Roi se fait un demi Dieu, Et c'est dont je vous plains qu'après un tel jervice.
On puiſſe contre luy me demander iuſtice.	On puisse contre deux me demander justice.
VALERE.	VALÈRE.
Soufftez donc ô grand Roy le plus iuſte des Rois, Que tous les gens de bien vous parlent par ma voix.	Soufftez donc ô grand Roi le plus juste des Rois, Que tous les gens de bien vous parlent par ma voix.
tent Non que nos cœurs ialoux de ſes honneurs s’itriS’il en reçoit beaucoup ſes hauts faits les meritent, Adiouſtez-y pluſtoſt que d’en deminuer, Nous ſommes tous encor preſts d’y contribuer;	tent Non que nos cœurs jaloux de ses honneurs s'itriS’il en reçoit beaucoup ses hauts faits les méritent, Adioustez-y plustost que d'en deminuer, Nous sommes tous encor prêts d'y contribuer;
Mais puiſque d’vn tel crime il s’eſt monſtré capable Ible, Qu’il triomphe en vainqueur & periſſe en coupaArreſtez ſa fureur, & ſauuez de ſes mains Si vous voulez regner le reſte des Romains, Il y va de la perte, ou du ſalut du reſte, Veu le ſang qu’a verſé cette guerre funeſte, (ſtins Et tant de nœuds d’Hymen dont nos heureux deOnt vny ſi ſouuent des peuples ſi voiſins, Peu de nous ont ioüy d’vn ſuccés ſi proſpere Qu’ils n’ayent perdu dans Albe vn couſin, vn beau fiere, (pleurs Vn oncle, vn grendre meſme, & ne donnent des Dans le bonheur public à leurs propres m.	Mais puisque d'un tel crime il s'est montré capable Ible, Qu'il triomphe en vainqueur et périsse en coupaArrestez sa fureur, et sauvez de ses mains Si vous voulez régner le reste des Romains, Il y va de la perte, ou du salut du reste, Veu le sang qu'a versé cette guerre funeste, (stins Et tant de nœuds d'Hymen dont nos heureux deOnt uni si souvent des peuples si voisins, Peu de nous ont ioüy si pros de nous ont J'ils n'aient perdu dans Albe un cousin, beau fière, (pleurs oncle, un beau même, et ne donnent des Dans et ne public à des bon m.
lheurs.	leurs.
Si c’eſt offenſer Rome & que l’heur de ſes armes L’authoriſe à punir ce crime de nos larmes;	Si c'est offenser Rome et que l'heur de ses armes L'autorise à punir ce crime de nos larmes;
HURACE Quel ſang eſpargnera ce barbare vainqueur Qui ne pardonne pas à celuy de ſa ſœur, Et ne peut excuſer la douleur vehemente Que la mort d’vn amant iette au cœur d’vne amante, (beau Quand preſts d’eſtre eſclairez du nuptial flamElle voit auec luy ſon eſpoir au tombeau?	HURACE Quel sang épargnera ce barbare vainqueur Qui ne pardonne pas à celui de sa sœur, Et ne peut excuser la douleur véhémente Que la mort d'un amant jette au cœur d'une amante, (beau Quand prêts d'être éclairez du nuptial flammes voit avec lui son espoir au tombeau?
Faiſant triompher Rome il ſe l’eſt aſſeruie Il a ſur nous vn droit & de moit & de vie, Et nos iours criminels ne pourront plus durez Qu’autant qu’à ſa clemence il plaira l’endurer.	Faisant triompher Rome il se l'est asservie Il a sur nous un droit et de moit et de vie, Et nos jours criminels ne pourront plus durez Qu'autant qu'à sa clémence il plaira l'endurer.
le pourrois adiouſter aux intereſts de Rome Combien vn pateil coup eſt indigne d’vn homme, Ie pourrois demander qu’on miſt deuant vos yeux Ce grand & rare exploit d’vn bras victorieux, Vous vertiez vn beau ſang pour accuſer ſa rage D’vn frere-ſi cruebreiaillir au viſage, (uoit, Vous verriez des horreurs qu’on ne peut conceSon aage & ſa beauté vous pourroient eſmouuoit, Mais ie hay ces moyens qui ſentent l’artifice, Vous auez à demain remis le ſacrifice, Penſez vous que les Dieux vangeurs dés innocents, D’vne main parricide acceptent de l’encens?	le pourrais ajouter aux intérêts de Rome Combien un pateil coup est indigne d'un homme, Je pourrais demander qu'on mît devant vos yeux Ce grand et rare exploit d'être bras victorieux, Vous m' un beau sang pour accuser sa rage D'un frère-si cruebreaillir au visage, (vait, Vous verriez des horreurs qu'on ne peut conceSon aage et sa beauté vous pourraient esmouuoit, Pourraient ie Mais ces moyens qui sentent l'artifice, Vous avez à demain remis le sacrifice, Pensez -vous que les Dieux vengeurs dés innocents, D'une main pare acceptent de 'encens?
Sur vous ce ſacrilege attireroit ſa peine, Ne le conſiderez qu’en obiet de leur haine, Et croyez auec nous qu’en tous ſes trois combats Le bon deſtin de Rome à plus fait que ſon bras, Puiſque ces meſmes Dieux autheurs de ſa victoire Ont permis qu’auſſi-toſt il en ſoüillaſt la gloire, Et qu’vn ſi grand courage apres ce noble effort Fuſt digne en meſme iour de triomphe & de mort.	Sur vous ce sacrilège attirerait sa peine, Ne le considérez qu'en objet de leur haine, Et croyez avec nous qu'en tous ses trois combats Le bon destin de Rome à plus fait que son bras, Puisque ces mêmes Dieux auteurs de sa victoire Ont permis qu'aussitôt il en souillât la gloire, Et qu'un si grand courage après ce noble effort Fût digne en même jour de triomphe et de mort.
Sire, c’eſt ce qu’il faut que voſtre arreſt decide, En ce lieu Rome a veu le premiet parricide, La ſuitte en eſt à craindre, & la haine des Cieux, Sauuez nous de ſa main & redoutez les Dieux.	Sire, c'est ce qu'il faut que votre arrêt décide, En ce lieu Rome a vu le premiet parricide, La suitte en est à craindre, et la haine des Cieux, Sauvez nous de sa main et redoutez les Dieux.
TVLLE.	TULE.
Deſſendez vous, nloracer	Dessendez -vous, nloracer
HORACE.	HORACE.
A quoy bon me deffendre?	À quoi bon me défendre?
Vous ſçauez l’a ction, vous le venęz d’entendre, Ce que vous en croyez me doit eſtre vne loy:	Vous savez l'a ction, vous le venz d'entendre, Ce que vous en croyez me doit être une loi:
Sire, on ſe defend mal contre l’aduis d’vn Roy, Et le plus innocent que le Ciel ait veu naiſtre Quand il le croit coupable, il commence de l’eſtre, C’eſt crime qu’enuers luy le vouloir excuſer.	Sire, on se défend mal contre l'avis d'un Roi, Et le plus innocent que le Ciel ait vu naître Quand il le croit coupable, il commence de l'être, C'est crime qu'envers lui le vouloir excuser.
Noſtre ſang eſt ſon bien, il en peut diſpoſer, Et c’eſt à nous de croire alors qu’il en diſpoſe Qu’il ne s’en priue point ſans vne iuſte cauſe.	Notre sang est son bien, il en peut disposer, Et c'est à nous de croire alors qu'il en dispose Qu'il ne s'en prive point sans une juste cause.
Sire, prononcez donc, ie ſuis preſt d’obeyt, D’autres ayment la vie, & ie la dois hair.	Sire, prononcez donc, je suis prêt d'obéit, D'autres aiment la vie, et que la dois haïr.
Ie ne reproche point à l’ardeur de Vale reQu’en amant de la ſœur il accuſe ſe frere, Mes vœux auec les ſiens conſpirent auiourd’huy Il demande ma mort, ie la veux comme luy;	Je ne reproche point à l'ardeur de Vale reQu'en amant de la sœur il accuse se frère, Mes vœux avec les siens conspirent aujourd'hui Il demande ma mort, ainsi la veux comme lui;
Vn ſeul point entre nous met cette difference Que mon honneur par là cherche ſon aſſeurance, Et qu'à ce meſme but nous voulons arriuer Luy pour fleſtrit ma gloire, & moy pour la ſauuer.	Un seul point entre nous met cette différence Que mon honneur par là cherche son assurance, Et qu'à ce même but nous voulons arriver Lui pour flétrit ma gloire, et mo pour la sauver.
Sire, c’eſt tarement qu’ils s’offre vne matiere A monſtrer d’vn grand cœur la vertu toute entiere.	Sire, c'est tarement qu'ils s'offre une matière A montrer d'un grand cœur la vertu toute entière.
Suiuant l’occaſion elle agiſt plus ou moins Et paroiſt forte ou foible aux yeux de ſes teſmoins.	Suivant l'occasion elle agît plus ou moins Et paraît forte ou faible aux yeux de ses témoins.
Le peuple qui voit tout ſeulement par l’eſcorce Prend droit par ſes effets de iuger de ſa force, Et s’oſe imaginer par vn mauuais diſcours Que qui fait vn miracle en doit faite touſiours.	Le peuple qui voit tout seulement par l'écorce Prend droit par ses effets de juger de sa force, Et s'ose imaginer par un mauvais discours Que qui fait un miracle en doit faite toujours.
Apres vne action pleine, haute, éclatante, Tout- ce qui brille moins templit mal ſon attente, Il veut qu’on ſoit égal en tout temps, en tous lieux, Il n’examine point ſi lors on pouuoit mieux.	Après une action pleine, haute, éclatante, Tout- ce qui brille moins templit mal son attente, Il veut qu'on soit égal en tout temps, en tous lieux, Il n'examine point si lors on pouvait mieux.
Ny que s’il ne voit pas ſans ceſſe vne merueille,	Ni que s'il ne voit pas sans cesse une merveille,
20	20
L’occaſion eſt moindre & la vertu pareille.	L'occasion est moindre et la vertu pareille.
Son iniuſtice accable & deſtruit les grands noms, L’honneur des premiers faits ſe perd par les ſeconds, Et quand la renommée a paſſé l’ordinaire Si l’on n’en veut déchoir il ne faut plus rien faire.	Son injustice accable et détruit les grands noms, L'honneur des premiers faits se perd par les seconds, Et quand la renommée a passé l'ordinaire Si l'on n'en veut déchoir il ne faut plus rien faire.
Ie ne vanteray point les exploits de mon bras, Voſtre Maieſté, Sire, a veu mes trois combats, Il eſt bien mal aiſé qu’vn pareil les ſeconde, Qu’vne autre occaſion à celle-cy reſponde, Et que tout mon courage aprés de ſi grands coups Paruiennent à des ſuccés qui n’aillent au deſſous, Si bien que pour laiſſer vne illuſtre memoire La mort ſeule auiourd’huy peut conſeruer ma gloire, Encor la falloit-il ſi toſt que i’eus vaincu, Puiſque pour mon honneur i’ay deſia trop veſcu, Vn nomme tel que moy voit ſa gloire ternie Quand il tombe en peril de quelque ignominie, Et ma main auroit ſçeu deſia m’en garantir, Mais ſans voſtre congé mon ſang n’oſe ſortir, Comme il vous appartient, voſtre adveu doit ſe prendre, C’eſt vous le deſrober qu’autrement le reſpandre, Rome ne manque point de genereux guerriets, Aſſez d’autres ſans moy ſouſtiendront vos lauriers, Que voſtre Majeſté deſormais m’en diſpenſe, Et ſi ce que i’ay fait vaut quelque recompenſe Permertez, ô grand Roy que de ce bras vainqueur Ie m’immole à ma gloire, & non pas à ma ſœur.	Je ne vanterai point les exploits de mon bras, Votre Maiestéà-moi, à vu mes trois combats, Il est bien mal aisé qu'Honneur pareil les seconde, Qu'une autre occasion à celle-cy réponde, Et que tout mon courage après de si grands coups Parviennent à des succès qui n'aillent au dessous, Si bien que pour laisser une illustre mémoire La mort seule aujourd'hui peut conserver ma gloire, Encor la fallait-il si tôt que j'eus vaincu, Puisque pour lui honneur j'ai déjà trop vécu, nomme tel que moi voit sa gloire ternie Quand il tombe en péril de quelque ignominie, Et ma main auroit sçeu desya en fi, Mais sans vôtre congé mon sang nose sortir, Mme il vous appartient, vôtre adveu doit en prendre, est vous le dérober quautrement le répandre, Rome ne m point de généreux ait, Assez autres sa moi soustiendront vos lauriers, Te vôtre Majesté désormais en ie, Et si ce que yay fait vaut quelque tombe Permertez, en Roy pu de ce bras ie Ie immole ma gloire, et non pas ma sœur.
SCENE	SCÈNE
TRAGEDIE.	TRAGÉDIE.
SCENE III.	SCÈNE III.
TVLLE, VALERE, Le vieil HORACE, MONACE, SADINE, IVLIE,	TULE, VALÈRE, Le vieil HORACE, MONACE, SADINE, IVLIE,
SA BINE.	SA BINE.
Ire, eſcoutez Sabine, & voyez dans ſon ame DLes douleurs d’vne ſœur, & celles d’vne femme, Qui toute deſolée à vos ſacrez genoux Pleure pour ſa famille & craint pour ſon eſpoux.	Ire, écoutez Sabine, et voyez dans son âme DLes douleurs d'une sœur, et celles d'une femme, Qui toute désolée à vos sacrés genoux Pleure pour sa famille et craint pour son époux.
Ce n’eſt pas que ie vueille auec cét artifice Deſtober vn coupable au bras de la iuſtice, (tel, Quoy qu’il ait fait pour vous, traitez-le comme Et puniſſez en moy ce noble criminel.	Ce n'est pas que ici veuille avec cet artifice Destober un coupable au bras de la justice, (tel, Quoi qu'il ait fait pour vous, traitez-le comme Et punissez en moi ce noble criminel.
De mon ſang malheureux expiés tout ſon crime, Vous ne changerez point pour cela de victime, Ce n’en ſera point prendre vne iniuſte pitié, Mais en ſacrifier la plus chere moitié.	De mon sang malheureux expiez tout son crime, Vous ne changerez point pour cela de victime, Ce n'en sera point prendre une injuste pitié, Mais en sacrifier la plus chère moitié.
Les nœuds de l’Hymenée, & ſon amour extréme Font qu’il vit plus en moy qu’il ne vit en luy-meſme, Et ſi vous m’accordez de mourir auiourd’huy Il mourra plus en moy qu’il ne mouuroit en luy.	Les nœuds de l'Hyménée, et son amour extrême Font qu'il vit plus en moi qu'il ne vit en lui-même, Et si vous m'accordez de mourir aujourd'hui Il mourra plus en moi qu'il ne mouvrait ena luy.
La mort que ie demande & qu’il faut que i’obtienne Augmentera ſa peine, & finira la mienne.	La mort que je demande et qu'il faut que j'obtienne Augmentera sa peine, et finira la mienne.
Sire, voyez l’excez de mes triſtes ennuis Et l’effroyable eſtat où mes iours ſont reduits, Quelle horteur d’embraſſer vn hõme dont l’eſpée De toute ma famille a la trame coupée, Et quelle impieté de hair vn eſpoux Pour auoir bien ſeruy les ſiens, l’Eſtat, & vous?	Sire, voyez l'excès de mes tristes ennuis Et l'effroyable état où mes jours sont réduits, Quelle horteur d'embrasser un homme dont l'épée De toute ma famille à la trame coupée, Et quelle impiété de haïr un époux Pour avoir bien servi les siens, l'État, et vous?
Aymer un-bras ſoüillé du ſang de tous mes freres!	Aimer un-bras soüillé du sang de tous mes frères!
N’aymer pas vn mary qui finit nos miſeres!	N'aimer pas un mari qui finit nos misères!
Sire, deliurez-moy par vn heureux treſpas Des crimes de l’aymer, & de ne l’aymer pas.	Sire, délivrez-moi par un heureux trépas Des crimes de l'aimer, et de ne l'aimer pas.
*e.	*ée.
I'en nommeray l’arreſt vne faueur bien grande, Ma main peut me donner ce que ie vous demande:	J'en nommerai l'arrêt une faveur bien grande, Ma main peut me donner ce que ici vous demande:
Mais cet reſpas en fin me ſera bien plus doux Si ie puis de ſa honte affranchir mon eſpoux, Si ie puis par mon ſang appaiſer la colere Des Dieux qu’a peu faſcher ſa vertu trop ſeuere, Satisfairé en mourant aux manes de ſa ſœur.	Mais cet respas en fin me sera bien plus doux Si je puis de sa honte affranchir mon époux, Si ieordre par mon sang apaiser la colère Des Dieux qu'a pu fâcher sa vertu trop sévère, Satisfairé en mourant aux mânes de sa sœur.
Et conſerver à Rome vn ſi bon defenſeur,	Et conserve à Rome un si bon défenseur,
Le vieil HORACE, Sire, c’eſt donc à moy de reſpondre à Valere Mes enfans auec luy conſpirent contre vn pere, Tous trois veulent me perdre, & s’arment ſans raiſon Contre ſi peu de ſang qui reſte en ma maiſon.	Le vieil HORACE, Sire, c'est donc à moi de répondre à Valère Mes enfants avec lui conspirent contre un père, Tous trois veulent me perdre, et s'arment sans raison Contre si peu de sang qui reste en ma maison.
Toy qui par douleurs à tes deuoirs contraires Veux quitter vn maty pour reioindre tes freres, Va pluſtoſt conſulter leurs manes genereux:	Toi qui par douleurs à tes devoirs contraires Veux quitter un mati pour rejoindre tes frères, Va plutôt consulter leurs mânes généreux:
Ils ſont morts, mais pour Albe, & s’en tiennent heureux.	Ils sont morts, mais pour Albe, et s'en tiennent heureux.
Puiſque le Ciel vouloit qu’elle fuſt aſſeruie, Si quelque ſentiment demeure apres la vie, Ce malheur ſemble moindre, & moins rudes ſes coups Voyant que tout l’honneur en retombe ſur nous.	Puisque le Ciel voulait qu'elle fût asservie, Si quelque sentiment demeure après la vie, Ce malheur semble moindre, et moins rudes ses coups Voyant que tout l'honneur en retombe sur nous.
Tous trois deſuaduoüeront la douleur qui te touche, Les larmes de tes yeux, les ſoûpirs de ta bouche, L’horteur que tu fais voir d’vn mary vertueux Sabine, ſois leur ſœur, ſuy ton deuoir comme eux.	Tous trois desuaduoüeront la douleur qui te touche, Les larmes de tes yeux, les soupirs de ta bouche, L'horteur que tu fais voir d'un mari vertueux Sabine, sois leur sœur, suivo deuoir comme eux.
Contre ce chet eſpoux Valere en vain s’auime, Vn premier mouuement ne fut iamais vn crime, Et la loüange eſt deuë au lieu du chaſtiment Quand la vertu produit ce premier mouuement.	Contre ce chet époux Valère en vain s'auime, Un premier mouvement ne fut jamais un crime, Et la louange est du au lieu du châtiment Quand la vertu produit ce premier mouvement.
Aymer nos ennemis auec idolatrie, De rage en leur treſpas maudire la patrie,	Aimer nos ennemis homme idolâtrie, De rage en leur trépas maudire la patrie,
Souhaiter à l’Eſtat vn malheur infiny, 61 C’eſt ce qu’on nomme crime, & ce qu’il l’a puny, Le ſeul amour de Rome a ſa main animée, Il ſeroit innocent s’il l’auoit moins aymée, Qu’ay ie dit, Sire, il l’eſt, & ce bras paternel L’auroit deſia puny s’il eſtoit criminel, I’aurois ſçeu mieux vſer de l’entiere puiſſance Que me donnent ſur luy les droits de la naiſſance.	Souhaiter à l'État un malheur infini, 61 C'est ce qu'on nomme crime, et ce qu'il l'a puni, Le seul amour de Rome a sa main animée, Il serait innocent s'il l'avait moins aimée, Qu'ai ie dit, Sire, il l'est, et ce bras paternel L'aurait déjà puni s'il était criminel, J'aurais su mieux user de l'entière puissance Que me donnent sur lui es droits de la naissance.
I’ayme trop l’honneur, Sire, & ne ſuis point de rang A ſouffrir ny d’affront, ny de crime en mon ſang C’eſt dont ie ne veux point de teſmoin que Valere.	J'aime trop l'honneur, Sire, et ne suis point de rang A souffrir notre d'affront, ni de crime en mon sang C'est dont tu ne veux point de témoin que Valère.
Il a veu quel accueil luy gardoit ma colere Lors qu’ignorant encor la moitié du combat Ie croyois que ſa fuite auoit trahy l’Eſtat.	Il a vu quel accueil lui gardait ma colère Lors qu'ignorant encor la moitié du combat Je croyais que sa fuite avait trahi l'État.
Qui le fait ſe charger des ſoins de ma famille?	Qui le fait se charger des soins de ma famille?
Qui le fait malgré moy vouloir vanger ma filles Et par quelle raiſon dans ſon iuſte treſpas Prend-il vn intereſt qu’vn pere ne prend pas?	Qui le fait malgré moi vouloir venger ma filles Et par quelle raison dans son juste trépas Prend-il intérêt qu'un père ne prend pas?
On craint qu’apres ſa ſœur il n’en maltraite d’autres;	On craint qu'après sa sœur il n'en maltraite d'autres;
Sire, nous n’auons part qu’à la honte des noſtres, Et de quelque façon qu’vn autre puiſſe agir (gir.	Sire, nous n'avons part qu'à la honte des nôtres, Et de quelque façon qu'un autre puisse agir (gir.
Qui ne nous touche point ne nous fait point rouTu peux pleurer Valere, & meſme aux yeux d’Horace.	Qui ne nous touche point ne nous fait point rouTu peux pleurer Valère, et même aux yeux d'Horace.
Il ne prend intereſt qu’aux crimes de ſa race, Qui n’eſt point de fon ſang ne peut faire d’affront Aux lauriers immortels qui luy ceignent le front.	Il ne prend intérêt qu'aux crimes de sa race, Qui n'est point de son sang ne peut faire d'affront Aux lauriers immortels qui lui ceignent le front.
Lauriers, ſacrés rameaux qu’on veut reduire en poudie, Vous qui mettez ſa teſte à couuert de la foudre L’abandonnerez vous à l’infame couſteau Qui fait choir les méchants ſous la main d’vn bourreau?	Lauriers, sacrés rameaux qu'on veut réduire en poudie, Vous qui mettez sa tête à couvert de la foudre L'abandonnerez -vous à l'infâme coûteau Qui fait choir les méchants sous la main d'un bourreau?
Romains, ſouffrirez-vous qu’ou vous immole vn homme	Romains, souffrirez-vous qu'ou vous immole un homme
62 HORACE Sans qui Rome auiourd’huy ceſſeroit d’eſtre Rome, Et qu’vn Romain s’efforce à tacher le renom D’vn guerrier à qui tous doiuent vn ſi beau nom?	62 HORACE Sans qui Rome aujourd'hui cesserait d'être Rome, Et qu'un Romain s'efforce à tacher le renom D'un guerrier à qui tous doivent un si beau nom?
Dy Valere, dy nous, puiſqu’il faut qu’il periſſe, Où tu penſes choiſir vn lieu pour ſon ſupplice?	Dis Valère, dis nous, puisqu'il faut qu'il périsse, Où tu penses choisir un lieu pour son supplice?
Sera ce entre ces meurs que mille & mille voix Font reſonner encor du bruit de ſes exploits?	Sera ce entre ces meurs que mille et mille voix Font résonner encor du bruit de ses exploits?
Sera-ce hors des murs au milieu de ces places Qu’on voit fumer encor du ſang de Curiaces, Entre leurs trois tombeaux, & dans ce champ d’honneur Teſmoin de ſa vaillance, & de noſtre bonheur?	Sera-ce hors des murs au milieu de ces places Qu'on voit fumer encor du sang de Curiaces, Entre leurs trois tombeaux, et dans ce champ d'honneur Témoin de sa vaillance, et de notre bonheur?
Tu ne ſçaurois cacher ſa peine à ſa victoire, Dans les murs, hors des murs, tout parle de ſa gloire, Tout s’oppoſe à l’effort de ton iniuſte amour Qui veut d’vn ſi bon ſang ſoüiller vn ſi beau iour.	Tu ne saurais cacher sa peine à sa victoire, Dans les murs, hors des murs, tout parle de sa gloire, Tout s'oppose à l'effort de ton injuste amour Qui veut d'un si bon sang souiller un si beau jour.
Albe ne pourra pas ſouffrir vn tel ſpectacle, Et Rome auec ſes pleurs y metera trop d’obſtaele, Vous les previendrez, Sire, & par vn iuſte arreſt Vous ſçaurez embraſſer bien mieux ſon intereſt, Ce qu’il a fait pour elle il le peur encore faire, Il la peut garantir encor d’vn ſort contraire.	Albe ne pourra pas souffrir un tel spectacle, Et Rome était ses pleurs y metera trop d'obstaèle, Vous les préviendrez, Sire, et par un juste arrêt Vous saurez embrasser bien mieux son intérêt, Ce qu'il a fait pour elle il le peur encore faire, Il la peut garantir encor d'un sort contraire.
Sire, ne donnez rien à mes debiles ans, Rome auiourd’hy m’a veu pere de quatre enfans, Trois en ce meſme iour ſont moits pour ſe querelle, Il m’en reſte encor vn, conſeruez-le pour elle, N’oſtez pas à ſes murs vn ſi puiſſant appuy, Horacs, ne croy pas que le peuple ſtupide, Soit le maiſtre abſolu d’vn renom bien ſolide, Sa voix tumultueuſe aſſez ſouuent fait bruit, Mais vn moment l’eſleue, vn moment le deſtruit, Et ce qu’il contribuë à noſtre renommée Touſiours en moins de rien ſe diſſipe en fumée.	Sire, ne donnez rien à mes débiles ans, Rome aujourd'hui m'a vu père de quatre enfants, Trois en ce même jour sont moits pour se querelle, Il m'en reste encor un, conservez-le pour elle, N'ôtez pas à ses murs un si puissant appui, Horacs, ne crois pas que le peuple stupide, Soit le maître absolu d'Hom bien bien Solide, Sa voix tumultueuse assez souvent fait bruit, Mais un moment esleue, moment le détruit, Et ce qu'il contribuë à notre renommée Tousiours en moins de rien se dissipe ' humée.
C’eſt aux Rois, c’eſt aux grands, c’eſt aux eſprits bien faits A voir la vertu pleine en ſes moindres effets, Cet d’eux ſeuls qu’on reçoit la veritable gloire.	C'est aux Rois, c'est aux grands, c'est aux esprits bien faits A voir la vertu pleine en ses moindres effets, Cet d'eux seuls qu'on reçoit la véritable gloire.
Eux ſeuls des vrais Heros aſſeurent la memoire, Vy touſiours en Horace, & touſiours aupres d’eux Ton nom demeurera grand, illuſtre, fameux, Bien que l’occaſion moins haute, ou moins brillante D'vn vulgaire ignorant trompe l’iniuſte attente.	Eux seuls des vrais Héros assurent la mémoire, Vi toujours en Horace, et toujours auprès d'eux Ton nom demeurera grand, illustre, fameux, Bien que l'occasion moins haute, ou moins brillante D'un vulgaire ignorant trompe l'injuste attente.
Ne hay donc plus la vie, & du moins vy pour moy Et pour ſeruireneor ton pays & ton Roy.	Ne hai donc plus la vie, et du moins vi pour moi Et pour servirèneor ton pays et ton Roi.
Sire, i’en ay tropdit, mais l’affaire vous touche, Et Rome toute eniere à panle par lla bouche.	Sire, j'en ai tropdit, mais l'affaire vous touche, Et Rome toute enière à panle par la bouche.
VALERE.	VALÈRE.
Sire, permettez moy.	Sire, permettez -moi.
TVLLE.	TULE.
Valere c’eſt aſſez, Vos diſcours par les leurs ne ſont pas effacez.	Valère c'est assez, Vos discours par les leurs ne sont pas effacés.
I’en garde en mon eſprit les forces plus preſſantes, Et toutes vos raiſons me ſont encor preſentes.	J'en garde en mon esprit les forces plus pressantes, Et toutes vos raisons me sont encor présentes.
Cette enorme action faite preſque à nos yeux Outrage la nature, & bleſſe iuſqu’aux Dieux.	Cette énorme action faite presque à nos yeux Outrage la nature, et blesse jusqu'aux Dieux.
Vn premier mouuement qui produit vn tel crime Ne ſçauroit luy ſeruir d’excuſe legitime, Les moins ſeueres loix en ce point ſont d’accord, Et ſi nous les ſuiuons, il eſt digne de mort.	Un premier mouvement qui produit un tel crime Ne saurait avoir servir d'excuse légitime, Les moins sévères lois en ce point sont d'accord, Et si nous les suivons, il est digne de mort.
Si d’ailleurs nous voulons regarder le coupable, Ce crime quoy que grand, enorme, inexcuſable, Vient de la meſme eſpée & par du meſme bras Qui me fait auiourd’huy maiſtre de deux Eſtats.	Si d'ailleurs nous voulons regarder le coupable, Ce crime quoi que grand, énorme, inexcusable, Vient de la même épée et par du même bras Qui me fait aujourd'hui maître de deux États.
Deux ſceptres en ma main, Albe à Rome aſſeruie Parlent bien hautement en faueur de ſa vie, Sans luy i’obeyrois où ie donne la loy,	Deux sceptres en ma main, Albe à Rome asservie Parlent bien hautement en faveur de sa vie, Sans luy j'obéirais où personne donne la loi,
O4 Et ie ſerois ſuiet ou ie ſuis deux fois Roy, Aſſez de bons ſuiets dans toutes les prouinces Par des vœux impuiſſants s’acquirent vers leurs Princes.	O4 Et ie serais sujet ou tu suis deux fois Roy, Assez de bons sujets dans toutes les provinces Par des vœux impuissants s'acquirent vers leurs Princes.
Tous les peuuent aimer, mais tous ne peuuent pas Par d’illuſtres effets aſſeurer leurs Eſtats, Et l’art & le pouuoir d’affermir des Couronnes Sont des dons que le Ciel fait à peu de perſonnes:	Tous les peuvent aimer, mais tous ne peuvent pas Par d'illustres effets assurer leurs États, Et l'art et le pouvoir d'affermir des Couronnes Sont des dons que le Ciel fait à peu de personnes:
De pareils ſeruiteurs ſont les forces des Rois Et de pareils auſſi ſont au deſſus des loix.	De pareils serviteurs sont les forces des Rois Et de pareils aussi sont au dessus des lois.
Qu’elles ſe taiſent donc, que Rome diſſimule Ce que dés ſa naiſſance elle en vit en Romule, Elle peut bien ſouffrir en ſon liberateur Ce qu’elle a bien ſouffert en ſon premier autheur.	Qu'elles se taisent donc, que Rome dissimule Ce que dès sa naissance elle en vit en Romule, Elle peut bien souffrir en son libérateur Ce qu'elle a bien souffert en son premier auteur.
Vy donc Horace, vy guerrier trop magnanime, Ta vertu met ta gloire au deſſus de ton crime, Sa chaleur genereuſe a produit ton forfait, D’vne cauſe ſi belle il faut ſouffrir l’effet.	Vis donc Horace, vis guerrier trop magnanime, Ta vertu met ta gloire au dessus de ton crime, Sa chaleur généreuse à produit ton forfait, D'une cause si belle il faut souffrir l'effet.
Vy pour ſeruir l’Eſtat, vy, mais ayme Valere, Qu’il ne reſte entre vous ny haine ny colere, Et ſoit qu’il ait ſuiuy l’amour, ou le deuoir, Sans aucun ſentiment reſous-toy de le voir.	Vi pour servir l'État, vis, mais aime Valère, Qu'il ne reste entre vous avez haine esprit colère, Et soit qu'il ait suivi l'amour, ou le devoir, Sans aucun sentiment résous-toi de le voir.
Sabine, eſcoutez moins la douleur qui vous preſſe, Chaſſez de ce grand cœur ces marques de foibleſſe, C’eſt en ſechant vos pleurs que vous vous monſtrerez La veritable ſœur de ceux que vous pleurez.	Sabine, écoutez moins la douleur qui vous presse, Chassez de ce grand cœur ces marques de faiblesse, C'est en séchant vos pleurs que vous vous montrerez La véritable sœur de ceux que vous pleurez.
Mais nous deuons aux Dieux demain vn ſacrifice, Et nous aurions le Ciel à nos vœux mal propice Si nos preſtres, auant que de ſacrifier, Ne trouuoient les moyens de le purifier.	Mais nous devons aux Dieux demain sacrifice, Et nous aurions le Ciel à nos vœux mal propice Si nos prêtres, avant que de sacrifier, Ne trouvaient les moyens de le purifier.
Son pere en prendra ſoin, il luy ſera facile D’appaiſer tout d’vn temps les manes de Camille, Ie la plains, & pour rendre à ſon ſort rigoureux, Ce que peut ſouhaiter ſon eſprit amoureux, PuiſPuiſque en vn meſme iour l’ardeur d’vn meſme zele Acheue le deſtin de ſont amant & d’elle, Ie veux qu’vn meſme iour témoin de leurs deux morts En vn meſme tombeau voye enfermer leurs corps.	Son père en prendra soin, il lui sera facile D'apaiser tout d'un temps les mânes de Camille, Je la plains, et pour rendre à son sort rigoureux, Ce que peut souhaiter son esprit amoureux, PuisPuisque en un même jour l'ardeur d'à même zèle Acheve le destin de sont amant et d'elle, Je veux qu'un même jour témoin de leurs deux morts En un même tombeau voie enfermer leurs corps.
SCENE DERNIERE.	SCÈNE DERNIÈRE.
VLIE.	VLIE.
Amille, ainſi le Ciel t’auoit bien aduertie ODes tragiques ſuccés qu’il t’auoit preparés, Mais touſiours du ſecret il cache vne partie Aux eſprits les plus nets, & les mieux éclairez.	Amille, ainsi le Ciel t'avait bien avertie ODes tragiques succès qu'il t'avait préparés, Mais toujours du secret il cache une partie Aux esprits les plus nets, et les mieux éclairez.
Il ſembloit nous parler de ton proche Hymenée.	Il semblait nous parler de ton proche Hyménée.
Il ſembloit tout promettre à tes vœux innocents, Et nous cachant ainſi ta mort inopinée Sa voix n’eſt que trop vraye en trompant noſtre ſens.	Il semblait tout promettre à tes vœux innocents, Et nous cachant ainsi ta mort inopinée Sa voix n'est que trop vraie en trompant nôtre sens.
2 Albe & Rome auiourd’huy prennent vn autre face, Tes vœux ſont exaucez, elles gouſtent la paix, Et tu vas eſtre vnie auec ton Curiace Sans qu’aucun mauuuu jort t'en ſepars iamais	2 Albe et Rome aujourd'hui prennent un autre face, Tes vœux sont exaucés, elles goûtent la paix, Et tu vas était unie avec ton Curiace Sans qu'aucun mauvais jort t'en sépars jamais
FIN.	FIN.
