M.	M.
DC.	DC.
LXXIX.	LXXIX.
Avec Permiſſion.	Avec Permission.
A MONSIEUR DE ***	À MONSIEUR DE *
ONSIEUR,	ONSIEUR,
der voſtre protection, pour une piece qui a trouvé de grands obſtacles dans ſa repreſentation, & qui peut-eſtre n'en trouvera pas de moindres ſur le papier.	der votre protection, pour une pièce qui a trouvé de grands obstacles dans sa représentation, et qui peut-être n'en trouvera pas de moindres sur le papier.
La nouveauté de ſon ſujet luy a attiré bien des cenſeurs, & j’ay eſté ſurpris de voir qu’elle n’ait point plù à de certaines gens, par l’endroit même où je croyois qu’elle de voit plaire le plus.	La nouveauté de son sujet lui a attiré bien des censeurs, et j'ai été surpris de voir qu'elle n'ait point plù à de certaines gens, par l'endroit même où je croyais qu'elle de voit plaire le plus.
Ils ont dit que noſtre Hiſtoire eſtoit mal propre à nous fournir des ſujets de Tragedie, qu’il faloit mener le ſpectateur dans un Pais éloigné, remplir ſon oreille par des noms plus pompeux, luy impoſer & l’ébloüir en quelque façon.	Ils ont dit que notre Histoire était mal propre à nous fournir des sujets de Tragédie, qu'il fallait mener le spectateur dans un Pais éloigné, remplir son oreille par des noms plus pompeux, lui imposer et l'ébloüir en quelque façon.
D’autres perſonnes au contraire m’ont applaudy ſur le choix de mon ſujet.	D'autres personnes au contraire m'ont applaudi sur le choix de mon sujet.
Ils ont crù avec Horace qu'on pouvou setarier a vet nonneur des traces des anciens.	Ils ont crù avec Horace qu'on pouvou setarier a vêt nonneur des traces des anciens.
Non minimum meruere decus veſtigia græca Auſi deſerere.	Non minimum mervre déçus vêtigia græca Ausi deserere.
Ils ont dit que les Grecs eux-mêmes n’ont point emprunté des Hiſtoires étrangeres les ſujets de leur Tragedie, que les Romains ont quelquefois mis ſur leur Scene des Heros de leur nation;	Ils ont dit que les Grecs eux-mêmes n'ont point emprunté des Histoires étrangères les sujets de leur Tragédie, que les Romains ont quelquefois mis sur leur Scène des Héros de leur nation;
que nous pou vons imiter les uns & les autrts, & attatner nos ſpectateurs par une agreable nouveauté, Gratâ novitate morandus eptautor,	que nous pou vons imiter les uns et les autroits, et attatner nos spectateurs par une agréable nouveauté, Gratâ tate morandus éptautor,
Ie laiſſe voſtre jugement libre làdeſſus, MONSIEUR.	Je laisse votre jugement libre làdessus, MONSIEUR.
Ce n’eſt pas à moy à decider une queſtion où je ſuis trop intereſſé.	Ce n'est pas à moi à décider une question où je suis trop intéressé.
Ie vous diray ſeulement que je ne me repens point d’avoir fait paroiſtre Anne de Bretagne ſur noſtre Theatre.	Je vous dirai seulement que je ne me repens point d'avoir fait paraître Anne de Bretagne sur notre Théâtre.
Il eſt vray que ſi j’eſtois à le faire, je pourrois réflechir plus meurement avant que de l’entreprendre.	Il est vrai que si j'étais à le faire, je pourrais réflechir plus meurement avant que de l'entreprendre.
Ie voy trop combien il eſt dangereux d’entrer le premier en lice, & qu’on y trou ve des difficultez que l’on n’a ſouvent point pre veuës.	Je vois trop combien il est dangereux d'entrer le premier en lice, et qu'on y trou ve des difficultés que l'on n'a souvent point pré vues.
Car enfin, je vous l’avoüeray, MONSIEUR, peuteſtre, Apollon aidant, je feray à l’avenir de meilleures pieces, qui me donneront ſans doute moins de peine que celle-cy.	Car enfin, je vous l'avouerai, MONSIEUR, peutestre, Apollon aidant, je ferai à l'avenir de meilleures pièces, qui me donneront sans doute moins de peine que celle-cy.
Ie n’ay pas oſé m’éle ver trop haut, de peur d’entrer dans le grand Cothurne, & j’ay craint de deſcendre trop bas, en évitant cette éle vation que la ſimplicité de mon ſujet ne me permettoit pas.	Je n'ai pas osé m'éle ver trop haut, de peur d'entrer dans le grand Cothurne, et j'ai craint de descendre trop bas, en évitant cette éle vation que la simplicité de mon sujet ne me permettait pas.
Jl m’a falu garder un temperament & une mediocrité de ſtile qui m’a couté bien des ſoins, & m’aſſujettir aux veritables incidens de l'hiſtoire, qui pour eſtre trop connuë n’a pas laiſſé un cours libre à mon imagination, & luy a preſcrit des bornes étroites.	Il m'a fallu garder un tempérament et une médiocrité de style qui m'a couté bien des soins, et m'assujettir aux véritables incidents de l'histoire, qui pour être trop connue n'a pas laissé un cours libre à mon imagination, et lui a prescrit des bornes étroites.
Ie l’ay pourtant alterée en quelques endroits, je ne le cele pas.	Je l'ai pourtant altérée en quelques endroits, je ne le cèle pas.
Uous vous en eſtes aperceu, MONSIEUR, & vous a vez eu la bonté de me le dire.	Uous vous en êtes aperçu, MONSIEUR, et vous a vez eu la bonté de me le dire.
Ie me ſuis fait le premier toutes les objections que vous m'avez faites.	Je me suis fait le premier toutes les objections que vous m'avez faites.
Ie ne veux pas icy en inſtruire le lecteur.	Je ne veux pas ici en instruire le lecteur.
Il le verra bien ſans que je l’en avertiſſe.	Il le verra bien sans que je l'en avertisse.
Ie le prie ſeulement de me rendre un peu de juſtice ſur ce point, & de croire que je n’ay pas ignoré ce qu’il pourra me reprocher.	Je le prie seulement de me rendre un peu de justice sur ce point, et de croire que je n'ai pas ignoré ce qu'il pourra me reprocher.
Ie ſçay bien par taempre que le Seigneur d’Albret, car c’eſt ainſi que le nomme l’hiſtoire, ne fut jamais Maréchal.	Je sais bien par taempre que le Seigneur d'Albret, car c'est ainsi que le nomme l'histoire, ne fut jamais Maréchal.
Ie luy ay donné ce nom pour la commodité de l’Hemiſtiche;	Je lui ai donné ce nom pour la commodité de l'Hémistiche;
& pour le plaiſir de l’oreille.	et pour le plaisir de l'oreille.
Ie n’ay pas crû que ce nom fut au deſſous d’un homme de ſa qualité, puis qu’un des plus illuſtres Capitaines de noſtre ſiecle, & qui contoit tant de Princes dans ſa race, ne dédaigna pas de rece voir le baſton de Maréchal de France de la main de noſtre in vincible Monarque.	Je n'ai pas cru que ce nom fut au dessous d'un homme de sa qualité, puis qu'un des plus illustres Capitaines de notre siècle, et qui contait tant de Princes dans sa race, ne dédaigna pas de rece voir le bâton de Maréchal de France de la main de notre in vincible Monarque.
On pourra encore m’objecter que c’eſt à tort que je donne à cette piece le nom de Tragedie, puis qu’il n’y a point de ſang répandu.	On pourra encore m'objecter que c'est à tort que je donne à cette pièce le nom de Tragédie, puis qu'il n'y a point de sang répandu.
Ie n’ay rien à répondre à cette objection.	Je n'ai rien à répondre à cette objection.
Vn fameux Auteur y a déja répondu dans la Preface d’une de ſes Pieces.	Un fameux Auteur y a déjà répondu dans la Préface d'une de ses Pièces.
Ie n’ay pas crû faillir en marchant ſur les traces d’un ſi grand homme;	Je n'ai pas cru faillir en marchant sur les traces d'un si grand homme;
mais c’eſt aſſez me juſtifier ſur la conduite de mon ouvrage, Il ne gagnera rien ſur ce jug irrité, Qui luy fait ſon procez de pleine autorité.	mais c'est assez me justifier sur la conduite de mon ouvrage, Il ne gagnera rien sur ce jug irrité, Qui avait fait son procès de pleine autorité.
MONSIEVR,	MONSIEUR,
Voſtre tres.	Votre très.
humble & tres-obeïſſant ſerviteur, PERRIER.	humble et très-obeïssant serviteur, PERRIER.
L eſt permis d’imprimer la Traedie intitulée, Anne de Bretagne;	L est permis d'imprimer la Traédie intitulée, Anne de Bretagne;
rait le vigt-quatriéme de Decembre 1678.	rait le vigt-quatrième de Décembre 1678.
DE LA REYNIE.	DE LA REYNIE.
Noms des Acteurs.	Noms des Acteurs.
ANNE, Ducheſſe de Bretagne.	ANNE, Duchesse de Bretagne.
ISABELLE, ſœur d’Anne.	ISABELLE, sœur d'Anne.
LOUYS, Duc d’Orleans.	LOUIS, Duc d'Orleans.
LE MARECHAL D’ALBRET,	LE MARÉCHAL D'ALBRET,
LE MARE'CHAL	LE MARE'CHAL
DE RIEUX.	DE RIEUX.
Regens de la LE COMTE DE ) Ducheſſe.	Regents de la LE COMTE DE ) Duchesse.
COMINGE.	COMINGE.
CHATEAUBRIANT, Gouvernante des deux Princeſſes, La Scene eſt à Rennes dans une ſalle du Palais de la Ducheſſe.	CHATEAUBRIANT, Gouvernante des deux Princesses, La Scène est à Rennes dans une salle du Palais de la Duchesse.
ANNE DE BRETAGNE.	ANNE DE BRETAGNE.
REINE DE FRANCE.	REINE DE FRANCE.
TRAGEDIE.	TRAGÉDIE.
ACIET.	ÀCIET.
SCENE I.	SCÈNE I.
LA DUCHESSE, CHATEAUBRIANT.	LA DUCHESSE, CHATEAUBRIANT.
LA DUCHESSE.	LA DUCHESSE.
E Maréchal d’Albret me demande audiance ?	E Maréchal d'Albret me demande audience ?
CHATEAUBRIANT.	CHATEAUBRIANT.
Oüy, Madame.	Oui, Madame.
LA DUCHESSE.	LA DUCHESSE.
A regret je ſouffie ſa preſences Tu ſçais combien il m’aime, & combien je luy dois.	À regret je souffie sa présences Tu sais combien il m'aime, et combien je lui dois.
Que du feu Due mon pere il m’obtint autrefois, Mon cœur me fait pour luy quelque ſecret reproche.	Que du feu Due mon père il m'obtint autrefois, Mon cœur me fait pour lui quelque secret reproche.
CHATEAUBRIANT.	CHATEAUBRIANT.
Quoy, Madame.	Quoi, Madame.
L UCHESSE.	 UCHESSE.
Alume, je le toy qurs aproche.	Alume, je le toi qurs approche.
SCENE II.	SCÈNE II.
LA DUCHESSE, LE MARECHAL D’ALBRET, CHATEAUBRIANT.	LA DUCHESSE, LE MARÉCHAL D'ALBRET, CHATEAUBRIANT.
LE M.	LE M.
D’ALBRET.	D'ALBRET.
A Trimoüille en Bear fait voler la terreur, LMadame.	À Trimoüille en Béar fait voler la terreur, LMadame.
Mes états éprouvent ſa fureur.	Mes états éprouvent sa fureur.
Du Maréchal de Gié la valeur indomtée Menace & fait fremir la Flandre épouvantée.	Du Maréchal de Gié la valeur indomtée Menace et fait frémir la Flandre épouvantée.
Charles leur Roy, dit-on, ſuivy d’autres Guerriers Veut icy par ſes mains moiſſonner des lauriers, Et répendant de loin l’effroy qui l’accompagne Vient luy-même en perſonne attaquer la Bretagne.	Charles leur Roi, dit-on, suivi d'autres Guerriers Veut ici par ses mains moissonner des lauriers, Et répendant de loin l'effroi qui l'accompagne Vient lui-même en personne attaquer la Bretagne.
Tandis que d’un côté l’heureux Roy des Romains D’un des Chefs des François ſuſpend les grands deſſeins;	Tandis que d'un côté l'heureux Roi des Romains D'un des Chefs des Français suspend les grands desseins;
Je vay pour l’intereſt de mon peuple & du vôtre Oppoſer mes efforts aux conqueſtes de l’autre.	Je vais pour l'intérêt de mon peuple et du vôtre Opposer mes efforts aux conquêtes de l'autre.
Preſt à quitter ces lieux où je n’attens plus rien, ’oſe vous demander un ſecret entretien.	Prêt à quitter ces lieux où je n'attends plus rien, ôse vous demander un secret entretien.
Aprês cela je parts, quelque ennuy qu’il m’en coûte.	Après cela je parts, quelque ennui qu'il m'en coûte.
LA DUCHESSE.	LA DUCHESSE.
Chatcaubrlant forter:	Chatcaulant forter:
Parion, je vous écoute.	Parion, je vous écoute.
SCENE III.	SCÈNE III.
LA DUCHESSE, LE M.	LA DUCHESSE, LE M.
D’ALBRET.	D'ALBRET.
LE M.	LE M.
D’ALBRET.	D'ALBRET.
Uand Loüis Roy de France armant tam D de ſoldats Vint d’une longue guerre affliger vos états, Madame, il vous ſouvient qu’impuiſſante & timide La Bretagne creignit un torrent ſi rapide.	Uand Louis Roi de France armant tam D de soldats Vint d'une longue guerre affliger vos états, Madame, il vous souvient qu'impuissante et timide La Bretagne crémignit un torrent si rapide.
Le feu Duc vôtre pere en redoutant le cours De tous ſes Alliez implora le ſecours.	Le feu Duc votre père en redoutant le cours De tous ses Al ora le secours.
j’y volay le premier.	j'y volai le premier.
Mon bras toûjours fidelle En mille occaſions fit éclatter mon zelle.	Mon bras toujours fidèle En mille occasions fit éclater mon zèle.
Il le vit, & ſon cœur s’ouvrant entier à moy Paya de ſon eſtime & mon zele & ma foy.	Il le vit, et son cœur s'ouvrant entier à moi Paya de son estime et mon zèle et ma foi.
Il fit plus.	Il fit plus.
Quand la paix toûjours mal aſſurée Entre la France & luy fut conſtamment jurée, Pour m’honorer d’un prix que je n’attendois pas, Il voulut qu’en ces lieux je ſuiviſſe ſes pas.	Quand la paix toujours mal assurée Entre la France et tu fut constamment jurée, Pour m'honorer d'un prix que je n'attendais pas, Il voulut qu'en ces lieux je suivisse ses pas.
Je vous y vis, Madame, helas!	Je vous y vis, Madame, hélas!
c’eſt tout vous dire, De ce cœur mal-heureux je vous donnay l’empire, Et vos charmes naiſſans firent naiſtre un amour Qui depuis avec eux s’accrut de jour en jour.	c'est tout vous dire, De ce cœur malheureux je vous donnai l'empire, Et vos charmes naissants firent naître un amour Qui depuis avec eux s'accrut de jour en jour.
Le Due, de ma tendreſſe approuvant la conſtance Voulut que voſtre main en fut la recompenſe.	Le Due, de ma tendresse approuvant la constance Voulut que votre main en fut la récompense.
Quel bonheur!	Quel bonheur!
Je touchois au moment fortuné Que pour noſtre hymenée il avoit deſtiné:	Je touchais au moment fortuné Que pour notre hyménée il avait destiné:
Lors qu’on vint l’avertir que ſon peuple indocile Allumoit le flambeau de la guerre civile, Que du feu Roy Louys le Jeune ſucceſſeur Charles, par un effet des conſeils de ſa ſœur, Echauffant des mutins la fureur animée Par de puiſſans ſecours groſſiſſoit leur armée.	Lors qu'on vint l'avertir que son peuple indocile Allumait le flambeau de la guerre civile, Que du feu Roi Louis le Jeune successeur Charles, par un effet des conseils de sa sœur, Échauffant des mutins la fureur animée Par de puissants secours grossissait leur armée.
O Ciel, quel coup de foudre à mon amour trompé!	Ô Ciel, quel coup de foudre à mon amour trompé!
De ſoins plus importans le Duc trop occupé Differa noſtre hymen, & tout entier aux armes Changea ſes doux apreſts en apreſts pleins d’alarmes.	De soins plus importants le Duc trop occupé Différa notre hymen, et tout entier aux armes Changea ses doux aprests en après pleins d'alarmes.
Moy flaté du ſalaire à mon amour promis A Charles en tous lieux je fais des ennemis.	Moi flatté du salaire à mon amour promis À Charles en tous lieux je fais des ennemis.
Inutile ſecours que leur bras nous apporte!	Inutile secours que leur bras nous apporte!
Ce torrent demandoit une digue plus forte.	Ce torrent demandait une digue plus forte.
On la cherche, & d’abord pour s’oppoſer à luy De Maximilian on implore l’appuy.	On la cherche, et d'abord pour s'opposer à MAde Maximilian on implore l'appui.
Il l’accorde à nos vœux.	Il l'accorde à nos vœux.
Mais à quel prix Madame?	Mais à quel prix Madame?
Au prix de voſtre main deſtinée à ma flame.	Au prix de votre main destinée à ma flamme.
Le Duc toûjours conſtant dans ſes bontez pour moy Ne veut point d’un hymen ſi contraire à ſa foy;	Le Duc toujours constant dans ses bontés pour moi Ne veut point d'un hymen si contraire à sa foi;
Mais enfin l’intereſt & la crainte publique Font que ſa bonne foy cede à ſa politique, Il y conſent.	Mais enfin l'intérêt et la crainte publique Font que sa bonne foi cède à sa politique, Il y consent.
Et moy malgré tout mon amour Pour le bien du party j’y ſouſcris à mon tour.	Et moi malgré tout mon amour Pour le bien du parti j'y souscris à mon tour.
Mais ſur tout à mes vœux voſtre ame peu propice Determina la mienne à ce grand nermee.	Mais sur tout à mes vœux votre âme peu propice Détermina la mienne à ce grand nermée.
J’étouffay pour vous plaire un trop juſte tranſport, Et de tous mes malheurs n’accuſay que le ſort, Cependant preſt à voir l’alliance arreſtée Le Duc meurt d’une mort par ſes çhagrins hâtée.	J'étouffai pour vous plaire un trop juste transport, Et de tous mes malheurs n'accusai que le sort, Cependant prêt à voir l'alliance arrêtée Le Duc meurt d'une mort par ses çhagrins hâtée.
Vos Miniſtres zellez pour vos peuples, pour vous, Ont preſſé cet hymen ſi neceſſaire à tous:	Vos Ministres zèlez pour vos peuples, pour vous, Ont pressé cet hymen si nécessaire à tous:
Il eſt enfin conclu.	Il est enfin conclu.
La pompe eſt toute preſte, Le Comte de Naſſau doit celebrer la feſte, Et dans ce jour, des jours le plus triſte pour moy Au nom du Roy ſon Maiſtre il reçoit voſtre foy?	La pompe est toute prête, Le Comte de Nassau doit célébrer la fête, Et dans ce jour, des jours le plus triste pour moi Au nom du Roi son Maître il reçoit esprit foi?
Gemir & m’éloigner eſt tout ce qui me reſte.	Gémir et m'éloigner est tout ce qui me reste.
Je parts pour ne point voir ce ſpectacle funeſte.	Je parts pour ne point voir ce spectacle funeste.
Quoy que juſqu’à l’eſpoir tout m’ait abandonné, J’emporte tout l’amour que vous m’avez donné.	Quoi que jusqu'à l'espoir tout m'ait abandonné, J'emporte tout l'amour que vous m'avez donné.
Je vay de ce beau feu redoublé par l’abſence Contre nos ennemis toumner la vioience , Faire tomber ſur moy l’effort de leur courroux, Et pour tout dire enfin vaincre où mourir pour vous.	Je vais de ce beau feu redoublé par l'absence Contre nos ennemis toumner la vioience , Faire tomber sur moi l'effort de leur courroux, Et pour tout dire enfin vaincre où mourir pour vous.
LA DUCHESSE.	LA DUCHESSE.
Croyez-vous, Maréchal, qu’injuſte à voſtre gloire On ait de vos exploits étouffé la memoire!	Croyez-vous, Maréchal, qu'injuste à votre gloire On ait de vos exploits étouffé la mémoire!
Non, je ſçay trop combien vous doivent mes états.	Non, je sais trop combien vous doivent mes états.
Ils peuvent l’oublier, je ne l’oubliray pas.	Ils peuvent l'oublier, je ne l'oublirai pas.
J’ay mal payé les ſoins qu’on vous a vû me tendreprendre.	J'ai mal payé les soins qu'on vous a vu me tendreprendre.
Mais moins à moy qu’au ſort vous deuez vous en A vos vœux malgré moy mon cœur s’eſt refuſé, J’ay ſenty tout l’ennuy que je vous ay cauſé.	Mais moins à moi qu'au sort vous devez vous en À vos vœux malgré moi mon cœur s'est refusé, J'ai senti tout l'ennui que je vous ai causé.
Je vous en donne encore une preuve ſincere.	Je vous en donne encore une preuve sincère.
Je vous plains.	Je vous plains.
C’eſt pour vous tout ce que jr puis faire.	C'est pour vous tout ce que jr puis faire.
A iij Mais quel que ſoit le ſort dont vous ſentez les coups, Helas!	À jij Mais quel que soit le sort dont vous sentez les coups, Hélas!
je ne ſuis pas moins à plaindre que vous.	je ne suis pas moins à plaindre que vous.
LE M.	LE M.
D’ALBRET.	D'ALBRET.
Que moy!	Que moi!
vous épouſez un Prince qu’on admire, Nommé Roy des Romains, heritier de l’Empire.	vous épousez un Prince qu'on admire, Nommé Roi des Romains, héritier de l'Empire.
Vous trainez aprés vous tout un peuple content,) La foftune rouoiity uir oceptie vous attent.	Vous traînez après vous tout un peuple content,) La foftune rouiti uir oceptie vous attent.
Quel chagrin oſeroit s’approcher de voſtre ame D’où vous peut-n'venir ?	Quel chagrin oserait s'approcher de votre âme D'où vous peut-n'une ?
LA DUCHESSE.	LA DUCHESSE.
De vous.	De vous.
LE M.	LE M.
D’ALBRET.	D'ALBRET.
De moy, Madame!	De moi, Madame!
LA DUCHESSE.	LA DUCHESSE.
Oüy, de vous.	Oui, de vous.
C’eſt trop feindre.	C'est trop feindre.
Apprener mon malheur.	Apprener mon malheur.
Je vous eſtime aſſez pour vous ouvrir mon cœur.	Je vous estime assez pour vous ouvrir mon cœur.
Quand vous ſceutes ranger de noſtre intelligence Tant de peuples en vain liguez contre la France, Et que par un effort qu’on s’étoit peu promis Vous armates pour nous juſqu’à nos ennemis.	Quand vous sûtes ranger de notre intelligence Tant de peuples en vain liguez contre la France, Et que par un effort qu'on s'était peu promis Vous armâtes pour nous jusqu'à nos ennemis.
Le Comte de Dunois, le Comte d’Angouléme Vinrent combatre icy contre la France même, Et le dépit de Cour fit marcher ſur leurs pas Mille autres combatans que je ne nomme pas.	Le Comte de Dunois, le Comte d'Angoulême Vinrent combattre ici contre la France même, Et le dépit de Cour fit marcher sur leurs pas Mille autres combattants que je ne nomme pas.
On liſoit ſur leur front une mâle aſſurance, Leur air majeſtueux témoignoit leur naiſſance.	On lisait sur leur front une mâle assurance, Leur air majestueux témoignait leur naissance.
Mais parmy ces Heros, un Heros plus fameux, Louys Duc d’Orleans attira tous nos vœux.	Mais parmi ces Héros, un Héros plus fameux, Louis Duc d'Orleans attira tous nos vœux.
Son port digne des Rois de ſon auguſte race Méloit heureuſement la douceur à l’audace.	Son port digne des Rois de son auguste race Méloit heureusement la douceur à l'audace.
Mes peuples pour le voir le ſuivoient en tous lieux, Et le charme du cœur ſuivit celuy des yeux.	Mes peuples pour le voir le suivaient en tous lieux, Et le charme du cœur suivit celui des yeux.
Il me vit, il m’aima, me parla de ſa flame:	Il me vit, il m'aima, me parla de sa flamme:
Ses ſoûpirs & le temps ſceurent toucher mon ame.	Ses soupirs et le temps sceurent toucher mon âme.
Cet aveu vous ſurprend, Maréchal, je le voy, Il eſt grand.	Cet aveu vous surprend, Maréchal, je le vois, Il est grand.
C’eſt par là qu’il eſt digne de moy.	C'est par là qu'il est digne de moi.
Quelque auſtere devoir qui lie une Princeſſe, Il ne luy défent pas d’avoir de la tendreſſe, Et l’amour le plus fort n’en eſt point combatu, Ouand il doit ſa naiſſance à la ſeule vertu.	Quelque austère devoir qui lie une Princesse, Il ne porte défent pas d'avoir de la tendresse, Et l'amour le plus fort n'en est point combattu, Ouand il doit sa naissance à la seule vertu.
Oüy, tu me plûs, cher Prince, & tu peux le connaitre.	Oui, tu me plus, cher Prince, et tu peux le connaître.
Ma gloire avouë un feu qu’elle même fit naitre.	Ma gloire avoue un feu qu'elle même fit naître.
Mais qu’il paya bien cher ce bonheur foible & vain!	Mais qu'il paya bien cher ce bonheur faible et vain!
Aſſuré de mon cœur, il demanda ma main.	Assuré de mon cœur, il demanda ma main.
Mou pere qui cherchoit l’appuy d’une alliance, Sceut avec induſtrie éluder l’eſperance D’un Prince qui n’avoit que ſon bras pour appuy.	Mou père qui cherchait l'appui d'une alliance, Sut avec industrie éluder l'espérance D'un Prince qui n'avait que son bras pour appui.
Quelle douleur pour moy!	Quelle douleur pour moi!
Quel deſeſpoir pour luy !	Quel désespoir pour lui !
Dévoré d’une ardeur qu’irritoit la contrainte Il n’oſoit qu’à mes yeux ſe permettre la plainte.	Dévoré d'une ardeur qu'irritait la contrainte Il n'osait qu'à mes yeux se permettre la plainte.
En vain ſes longs regrets m’exprimoient ſes douleurs, Pour tout ſoulagemẽt il n’avoit que mes pleurs.	En vain ses longs regrets m'exprimaient ses douleurs, Pour tout soulagement il n'avait que mes pleurs.
Honteux de ſoûpirer il a recours aux armes, Il veut verſer ſon ſang las de verſer des larmes.	Honteux de soupirer il a recours aux armes, Il veut verser son sang las de verser des larmes.
Contre nos ennemis il conduit nos ſoldats, Tout le feu de ſon cœur paſſe juſqu’à ſon bras:	Contre nos ennemis il conduit nos soldats, Tout le feu de son cœur passe jusqu'à son bras:
Il donne mille morts en prodiguant ſa vie.	Il donne mille morts en prodiguant sa vie.
Mais le Ciel prent plaiſir à tromper ſon envie, Il l’arrache à la mort qu’il ſembloit défier;	Mais le Ciel prent plaisir à tromper son envie, Il l'arrache à la mort qu'il semblait défier;
Les armes à la main il eſt fait priſonnier, Vous le ſçavez.	Les armes à la main il est fait prisonnier, Vous le savez.
Deux ans de priſon & d’abſence N’ont point de ſon ardeur ébranlé la conſtance.	Deux ans de prison et d'absence N'ont point de son ardeur ébranlé la constance.
Je le préſume au moins.	Je le présume au moins.
Je le connois trop bien Pour croire ſon amour moins ferme que le mien.	Je le connais trop bien Pour croire son amour moins ferme que le mien.
Avec raiſon par moy je juge de luy-même, Puiſque je l’aime encor, je ſuis ſeure qu’il m’aime.	Avec raison par moi je juge de lui-même, Puisque je l'aime encor, je suis sûre qu'il m'aime.
Eſelave cependant d’un devoir inhumain A Maximilian je vay donner ma main.	Eselave cependant d'un devoir inhumain À Maximilian je vais donner ma main.
Oſez aprés cela nommer le ſort barbare, Comparen tos maiſeuis a ceux qu’il me prepare, Et jugez ſi mon cœur ſous ſes coups abatu N’a pas icy beſoin de toute ſa vertu.	Osez après cela nommer le sort barbare, Comparen tos maiseuis a ceux qu'il me prépare, Et jugez si mon cœur sous ses coups abattu N'a pas ici besoin de toute sa vertu.
LE M.	LE M.
D’ALBRET.	D'ALBRET.
Quel aveu venez-vous de me faire!	Quel aveu venez-vous de me faire!
ah!	ah!
Madame, Par quels nouveaux chagrins déchirez-vous mon ame.	Madame, Par quels nouveaux chagrins déchirés-vous mon âme.
N’étoit-ce pas aſſez aſtres trop rigoureux De m’avoir des mortels fait le plus mal-heureux:	N'était-ce pas assez astres trop rigoureux De m'avoir des mortels fait le plus malheureux:
Faloit-il pour combler le malheur qui m’opreſſe Que je fuſſe l’auteur des maux de ma Princeſſe?	Falait-il pour combler le malheur qui m'opresse Que je fusse l'auteur des maux de ma Princesse?
Madame, c’eſt par moy que dans ces triſtes lieux Un Prince trop aimé s’eſt offert à vos yeux.	Madame, c'est par moi que dans ces tristes lieux Un Prince trop aimé s'est offert à vos yeux.
C’eſt moy qui par un zelle innocent & coupable Vous ay porté les traits dont le ſort vous accable.	C'est moi qui par un zèle innocent et coupable Vous ai porté les traits dont le sort vous accable.
Voyez de cette ardeur moins l’objet que la fin, Et vangez-vous ſur moy d’un crime du deſtin.	Voyez de cette ardeur moins l'objet que la fin, Et vengez-vous sur moi d'un crime du destin.
Il eſt vray que déja vous eſtes bien vangée, Je paye aſſez les maux où je vous ay plongée.	Il est vrai que déjà vous êtes bien vengée, Je paie assez les maux où je vous ai plongée.
Si l’amant qu’en ces lieux attira mon malheur Vous oſte le repos, il m’oſte voſtre cœur, Et les pleurs dont vos yeux honorent ſa miſere Me puniſſent aſſez d’un crime involontaire:	Si l'amant qu'en ces lieux attira mon malheur Vous ôte le repos, il m'ôte votre cœur, Et les pleurs dont vos yeux honorent sa misère Me punissent assez d'un crime involontaire:
Il merite un pardon.	Il mérite un pardon.
Mais je veux m'en punir.	Mais je veux m'en punir.
Je me rendray par là digne de l’obtenir.	Je me rendrai par là digne de l'obtenir.
A mon mauvais deſtin moy-même je me livre.	À mon mauvais destin moi-même je me livre.
Qui trouble voſtre vie eſt indigne de vivre.	Qui trouble votre vie est indigne de vivre.
Je vay toûjours trop plein de mon amour ſecret Mourir en combatant, ou mourir de regret.	Je vais toujours trop plein de mon amour secret Mourir en combattant, ou mourir de regret.
Vous, Madame, vivez.	Vous, Madame, vivez.
Quelque jour plus propice Le Ciel à vos vertus rendra plus de juſtice, Souvent à ſon courroux il nous laiſſe échaper, Et ſouvent il menace avant que de fraper.	Quelque jour plus propice Le Ciel à vos vertus rendra plus de justice, Souvent à son courroux il nous laisse échapper, Et souvent il menace avant que de frapper.
Puiſſe t’il reparer ſes cruautez paſſées Par de longues faveurs à pleines mains verſées, Vous faire un ſort ſi doux qu’il paſſe vos deſirs, A mes peines enfin égaler vos plaiſirs.	Puisse -t-il réparer ses cruautés passées Par de longues faveurs à pleines mains versées, Vous faire un sort si doux qu'il passe vos désirs, À mes peines enfin égaler vos plaisirs.
Adieu.	Adieu.
SCENE IV.	SCÈNE IV.
LA DUCHESSE, CHATEAUBRIANT.	LA DUCHESSE, CHATEAUBRIANT.
CHATEAUBRIANT.	CHATEAUBRIANT.
’On vous attent.	On vous attent.
Cette grande journée, LMadame, éclairera voſtre heureux hymenée.	Cette grande journée, LÀ, éclairera votre heureux hyménée.
Le Comte de Naſſau hâte un moment ſi doux.	Le Comte de Nassau hâte un moment si doux.
Il vient vous prendre, au nom du Prince voſtre époux.	Il vient vous prendre, au nom du Prince votre époux.
Il eſt environnéd’une illuſtre Nobleſſe, Pour le voir de plus prés à l’envy l’on s’empreſſeVoſtre peuple oubliant tous ſes premiers malheurs Vous attent au paſſage, & le ſeme de fleurs, A l’eſpoir qui le flate il s’abandonne en proyePar mille cris confus il exprime ſa joye, Et l’encens à la main dans le temple preſſez Les Preſtres font pour vous des vœux mieux exaucez.	Il est environnéd'une illustre Noblesse, Pour le voir de plus près à l'envi l'on s'empresseVotre peuple oubliant tous ses premiers malheurs Vous attent au passage, et le seme de fleurs, A l'espoir qui le flatte il s'abandonne en proiePar mille cris confus il exprime sa joie, Et l'encens à la main dans le temple pressez Les Prêtres font pour vous des vœux mieux exaucez.
Madame, ce n’eſt plus que par voſtre preſence Que vous pouvez haſter un bonheur qui commence, Et rempliſſaut les vœux du peuple & de la Cour Aſſurer le repos que leur promet ce jour.	Madame, ce n'est plus que par votre présence Que vous pouvez hâter un bonheur qui commence, Et remplissaut les vœux du peuple et de la Cour Assurer le repos que leur promet ce jour.
LA DUCHESSE.	LA DUCHESSE.
Ne faiſons point languir l’ardeur qui les anime.	Ne faisons point languir l'ardeur qui les anime.
Le ſacrifice eſt preſt, menons leur la victime.	Le sacrifice est prêt, menons leur la victime.
LAceutons larrert qu’ont prononce les Cieux.	LAçutons larrert qu'ont prononce les Cieux.
Allons.	Allons.
Mais que me veut le Mareſchal de Rieux!	Mais que me veut le Maréchal de Rieux!
SCENE V.	SCÈNE V.
LA DUCHESSE, LE MARESCHAL D RIEUX, CHATEAUBRIANT.	LA DUCHESSE, LE MARÉCHAL D RIEUX, CHATEAUBRIANT.
LE M.	LE M.
DE RIEUX.	DE RIEUX.
Adame, retardez la pompe qu’on preparez VIContre un hymen fatal le deſtin ſe declare.	Adame, retardez la pompe qu'on préparés VIContre un hymen fatal le destin se déclare.
Quoy?	Quoi?
LA DUCHESSE.	LA DUCHESSE.
LE M.	LE M.
DE RIEUX.	DE RIEUX.
Le Roy des Romains à Bruges arreſté Eſt en proye aux fureurs d’un peuple revolté.	Le Roi des Romains à Bruges arrêté Est en proie aux fureurs d'un peuple révolté.
Ses ſujets enhardis à tant de violence En s’aſſurant de luy trouvent leur aſſurance.	Ses sujets enhardis à tant de violence En s'assurant de deux trouvent leur assurance.
Il eſt entre leurs mains, ſans apuy, ſans ſecours, Et l’on craint pour ſon Sceptre, & même poux ſes jours.	Il est entre leurs mains, sans appui, sans secours, Et l'on craint pour son Sceptre, et même poux ses jours.
Madame, là-deſſus prenez bien vos meſures, Mais ſur tout prenez-en de promptes & de ſeures.	Madame, là-dessus prenez bien vos mesures, Mais sur tout prenez-en de promptes et de sûres.
Vous avez & l’Eſtat & vous à menager, Penſez y bien, avant que de vous engager.	Vous avez et l'État et vous à ménager, Pensez y bien, avant que de vous engager.
Aprés qu’on s’eſt commis aux fureurs de l’orage On pouſſe vainement des vœux vers le rivage.	Après qu'on s'est commis aux fureurs de l'orage On pousse vainement des vœux vers le rivage.
Le conſeil peut ſervir dans un peril naiſſant, Mais quand le coup eſt fait il devient impuiſſant.	Le conseil peut servir dans un péril naissant, Mais quand le coup est fait il devient impuissant.
Songez en quel eſtat la Bretagne eſt reduite, De voſtre hymen pour elle examinez la ſuite, Voyez-en tous les maux, mais pour les prevenir, Et plus que le preſent regardez l’avenir.	Songez en quel état la Bretagne est réduite, De votre hymen pour elle examinez la suite, Voyez-en tous les maux, mais pour les prévenir, Et plus que le présent regardez l'avenir.
LA DUCHESSE.	LA DUCHESSE.
Dépuis long-temps pour moy je connoy vôtre zelle, Vous connoiſſez le mien pour mon peuple fidelle.	Dépuis longtemps pour moi je connais votre zèle, Vous connaissez le mien pour mon peuple fidèle.
Vous ſçavez qu’attachée à ſes ſeuls intereſts J’accompliſſois l’hymen que hatoient ſes ſoubaîts.	Vous savez qu'attachée à ses seuls intérêts J'accomplissais l'hymen que hâtaient ses soubaîts.
Ces mêmes intereſts demandent le contraire, Il faut le differer.	Ces mêmes intérêts demandent le contraire, Il faut le différer.
Hé bien qu’on le differe, Allez, voyez Cominge.	Hé bien qu'on le diffère, Allez, voyez Cominge.
A vec vous, avec luy Je veux ſur ce grand point conſulter aujourd’huy.	À vec vous, avec lui Je veux sur ce grand point consulter aujourd'hui.
SCENE VI.	SCÈNE VI.
LA DOCHESSE, CHATEAUBRIANT.	LA DOCHÉSSE, CHATEAUBRIANT.
LA DUCHESSE.	LA DUCHESSE.
J Ois-tu de mon deſtin le biſare caprice?	 Ois-tu de mon destin le bisare caprice?
V A-t’il jamais ſi loin pouſſé ſon injuſtice?	V A-t-il jamais si loin poussé son injustice?
Le Mareſchal d’Albret, aprés de longs adieux Triſte, deſeſperé, vient de quitter ces lieux.	Le Maréchal d'Albret, après de longs adieux Triste, désespéré, vient de quitter ces lieux.
Le Duc pour qui mon cœur endure tant de peines Par moy, pour moy gemit ſous de cruelles chaines, Et le Roy des Romains comme eux infortuń Eprouve les fureurs d’un peuple mutiné.	Le Duc pour qui mon cœur endure tant de peines Par moi, pour moi gémit sous de cruelles chaînes, Et le Roi des Romains comme eux infortu Eprouve les fureurs d'un peuple mutiné.
Le foit pourin accabler d’une douleur plus forte Repend ſur mes amans la haine qu’il me porte, Envers luy leur tendreſſe eſt un crime pour eux;	Le soit pour accabler d'une douleur plus forte Repend sur mes amants la haine qu'il me porte, Envers Seigneur leur tendresse est un crime pour eux;
Il ſuffit de m’aimer pour eſtre mal-heureux.	Il suffit de m'aimer pour être malheureux.
CHATEAUBRIANT.	CHATEAUBRIANT.
Le Duc ſemble aujourd’huy, Madame, moins à plaindre.	Le Duc semble aujourd'hui, Madame, moins à plaindre.
Le Ciel détourne un coup pour luy le plus à craindre.	Le Ciel détourne un coup pour lui le plus à craindre.
Le malheur d’un rival peu s’en faut voſtre époux Doit adoucir l’ennuy qu’il peut ſentir pour vous.	Le malheur d'un rival peu s'en faut votre époux Doit adoucir l'ennui qu'il peut sentir pour vous.
Le revers qui ſuſpend cette grande alliance Semble encore à ſes feux permertre l’eſperance.	Le revers qui suspend cette grande alliance Semble encore à ses feux permertre l'espérance.
LA DUCHESSE.	LA DUCHESSE.
Quel eſpoir à ſon cœur peut-il eſtre permis?	Quel espoir à son cœur peut-il être permis?
N’eſt-il pas au pouvoir de nos fiers ennemis?	N'est-il pas au pouvoir de nos fiers ennemis?
S’il faut qu’en ſa faveur tout mon amour éclate, Crois-tu dans mes deſſeins que mon peuple me flate?	S'il faut qu'en sa faveur tout mon amour éclate, Crois-tu dans mes desseins que mon peuple me flatte?
Attachant ſon bonheur à mon regne naiſſant, Tu ſçais qu’il me demande un époux plus puiſſant, Que du repos public victime infortunée Je ſuis de mes ſujets l’eſclave couronnée, Et que par un deſtin bizare, rigoureux En leur donnant des loix j’en reçois auſſi d’eux.	Attachant son bonheur à mon règne naissant, Tu sais qu'il me demande un époux plus puissant, Que du repos public victime infortunée Je suis de mes sujets l'esclave couronnée, Et que par un destin bizare, rigoureux En leur donnant des lois j'en reçois aussi d'eux.
Oüy le ſort, mes ſujets, tout te devient contraire.	Oui le sort, mes sujets, tout te devient contraire.
L’Amour ſeul eſt pour toy, Prince;	L'Amour seul est pour toi, Prince;
que peut-il faire?	que peut-il faire?
Ce qu’il peut faire!	Ce qu'il peut faire!
Il peut recompenſer ta foy.	Il peut récompenser ta foi.
Je m’arrachois trop toſt à l’eſpoir d’eſtre à toy, Tes malheurs finiront, le deſtin équitable A nos vœux aujourd’huy ſe rend plus favorable, Mais pourquoy me flater d’un bien mal eſperé?	Je m'attachais trop tôt à l'espoir d'être à toi, Tes malheurs finiront, le destin équitable A nos vœux aujourd'hui se rend plus favorable, Mais pourquoi me flatter d'un bien mal espéré?
L’hymen eſt il rompu pour eſtre differé?	L'hymen est il rompu pour être différé?
Mes Miniſtres ont-ils expliqué leurs penſées?	Mes Ministres ont-ils expliqué leurs pensées?
Voudront-ils retracter mes promeſſes forcées?	Voudront-ils rétracter mes promesses forcées?
Que ſçay-je, en leurs avis peut-eſtre trop conſtans Plus que je ne voudrois.	Que sais-je, en leurs avis peut-être trop constants Plus que je ne voudrais.
Mais je pers trop de temps, Va voir ma ſœur, dy luy ce qu’on vient de m’apprendre, Et qu’au conſeil bien toſt elle vienne ſe rendre.	Mais je perds trop de temps, Va voir ma sœur, dis dis ce qu'on vient de m'apprendre, Et qu'au conseil bien tôt elle vienne se rendre.
Ciel!	Ciel!
qui vois mes ennuis, fay dans ce tr iſte jour Que je puiſſe accorder ma gloire & mon amour.	qui vois mes ennuis, fais dans ce tr iste jour Que je puisse accorder ma gloire et mon amour.
Fin du premier Acte.	Fin du premier Acte.
ACIE II.	ACIE II.
SCENE I.	SCÈNE I.
ISABELLE, CHATEAUBRIANT	ISABELLE, CHATEAUBRIANT
ISABELLE.	ISABELLE.
E ce que tu me dis es-tu bien aſſurée?	E ce que tu me dis es-tu bien assurée?
DQuoy, de ce triſte hymen la pompe eſt differée, Et ma ſœur dans un trouble à mon trouble pareil Pour ſe determiner aſſemble ſon conſeil?	DQuoi, de ce triste hymen la pompe est différée, Et ma sœur dans un trouble à mon trouble pareil Pour se déterminer assemble son conseil?
CHATEAUBRIANT.	CHATEAUBRIANT.
Oüi, Madame, & bien toſt ſeurs de cette nouvelle Ses Miniſtres icy vont ſe rendre avec elle.	Oui, Madame, et bien tôt sûrs de cette nouvelle Ses Ministres ici vont se rendre avec elle.
Helas!	Hélas!
d e dl dn a da	 dûl a dîn à da
CHATEAUBRIANT.	CHATEAUBRIANT.
Pourquoy ces pleurs & ces nouveaux regrets?	Pourquoi ces pleurs et ces nouveaux regrets?
Auriez vous bien pour moy des deplaiſirs ſecrets?	Auriez -vous bien pour moi des déplaisirs secrets?
ISABELLE.	ISABELLE.
Je n’en ay point pour toy.	Je n'en ai point pour toi.
Tonlzele &ta naiſſance T’ont avec ma tendreſſe acquis ma confidence.	Tonlzèle etta naissance T'ont avec ma tendresse acquis ma confidence.
j’aime, & ce triſte jour, comimie tu peux ie von, Pour le Duc d’Orleans détruit tout mon eſpoir.	j'aime, et ce triste jour, comimie tu peux Seigneur von, Pour le Duc d'Orleans détruit tout mon espoir.
Exilé, tu le ſçais il vint en cette ville Contre ſes ennemis mandier un azile.	Exilé, tu le sais il vint en cette ville Contre ses ennemis mandier un asile.
Je le vis.	Je le vis.
Que mes yeux le trouverent charmant!	Que mes yeux le trouvèrent charmant!
Mon triſte cœur vers luy voloit à tout moment, Autantqu’il me plaiſoit j’aurois voulu luy plaire, Je ſouhaittois qu’il eut l’amitié de mon pere, qu’il vecût avec nous, qu’il y vecût heureux.	Mon triste cœur vers lui volait à tout moment, Autantqu'il me plaisait j'aurais voulu quelque plaire, Je souhaitais qu'il eut l'amitié de mon père, qu'il vecût avec nous, qu'il y vect heureux.
I’ignorois que ce ſoin fuſt un ſoin amoureux, Que plus que la pitié mon ardeur le fit naiſtre;	J'ignorais que ce soin fût un soin amoureux, Que plus que la pitié mon ardeur le fit naître;
Et je ſentis long temps l’amour ſans le connoiſtre.	Et je sentis long temps l'amour sans le connaître.
Mais que j’en goutay peu la trompeuſe douceur!	Mais que j'en goûtai peu la trompeuse douceur!
Le Duc devint ſenſible aux charmes de ma ſœur.	Le Duc devint sensible aux charmes de ma sœur.
Je m’apperceus bien-toſt de ſon ardeur naiſſante, Car qui ſçauroit tromper les regars d’une amante.	Je m'aperçus bientôt de son ardeur naissante, Car qui saurait tromper les régars d'une amante.
Je voulus n’aimer plus, je voulus.	Je voulus n'aimer plus, je voulus.
mais helas Amour!	mais hélas Amour!
on veut en vain ce que tu ne veux pas.	on veut en vain ce que tu ne veux pas.
Tu ſçais quels maux me couſte une ardeur ſi fatale, Je l’ay toûjours cachée au Prince, à ma rivale, Depuis plus de deux ans je devore mes pleurs, Et je n’oſe qu’à toy confier mes douleuts.	Tu sais quels maux me coûte une ardeur si fatale, Je l'ai toujours cachée au Prince, à ma rivale, Depuis plus de deux ans je dévore mes pleurs, Et je n'ose qu'à toi confier mes douleuts.
Mes chagrins aujourd’huy perdoient leur violence, Et l’hymen de ma ſœur me rendoit l'eſperance.	Mes chagrins aujourd'hui perdaient leur violence, Et l'hymen de ma sœur me rendait l'espérance.
Mais je le tiens rompu puiſqu’il eſt differé;	Mais je le tiens rompu puisqu'il est différé;
Rien ne conſole plus mon cœur deſeſperé.	Rien ne console plus mon cœur désespéré.
Ciel te fais-tu ſans ceſſe une joye inhi maine?	Ciel te fais-tu sans cesse une joie inhi maine?
D’inventer contre moy quelque nouvelle peine?	D'inventer contre moi quelque nouvelle peine?
Quel crime ay-je commis qui puiſſe t’animer?	Quel crime ai-je commis qui puisse t'animer?
Pour la ſeule Iſabelle eſt-ce un crime d’aimer?	Pour la seule Isabelle est-ce un crime d'aimer?
Si c’en eſt ur.	Si c'en est ur.
Toy-meſme es le premier coupable, J’aime ce que ta main a fait de plus aimable.	Toi-même es le premier coupable, J'aime ce que ta main a fait de plus aimable.
CHATEAUBRIANT.	CHATEAUBRIANT.
L’eſpoir n’eſt point encore à vos feux defendu.	L'espoir n'est point encore à vos feux défendu.
Les cieux vous enverront un bien qui vous eſt dû.	Les cieux vous enverront un bien qui vous est dû.
L’ame de la Princeſſe eſt encor balancée, Il eſt vray.	L'âme de la Princesse est encor balancée, Il est vrai.
Mais j’ay lû juſques dans ſa penſée, Madame.	Mais j'ai lu jusque dans sa pensée, Madame.
Devoüée à tous vos intereſts J’ay ſondé de ſon cœur les ſentimens ſecrets.	Devoüée à tous vos intérêts J'ai sondé de son cœur les sentiments secrets.
Je viens, n’en doutez point, d’apprendre de ſa bouche Qu’autant que ſon amour le bien public la touenes Mais enfin, ſon conſeil, quoy qu’elle ait projetté, Peut la faire reſoudre à ſuivre le traité.	Je viens, n'en doutez point, d'apprendre de sa bouche Qu'autant que son amour le bien public la touène Mais enfin, son conseil, quoi qu’elle ait projetté, Peut la faire résoudre à suivre le traité.
ISABELLE.	ISABELLE.
Non, tu flates en vain un amour trop funeſte.	Non, tu flatte en vain un amour trop funeste.
Elle aime, c’eſt aſſez, mon cœur me dit le reſte.	Elle aime, c'est assez, mon cœur me dit le reste.
Elle immolera tout à l’eſpoir trop charmant De pouvoir quelque jour poſſeder ſon amant.	Elle immolera tout à l'espoir trop charmant De pouvoir quelque jour posséder son amant.
Je counois mieux que toy ſa penſée & ſa flâme.	Je counais mieux que toi sa pensée et sa flamme.
Ignorant mon ardeur elle m’ouvre ſon ame, Et ſans rien ſoupçonner, elle vient chaque jour Me confier ſa peine ainſi que ſon amour.	Ignorant mon ardeur elle m'ouvre son âme, Et sans rien soupçonner, elle vient chaque jour Me confier sa peine ainsi que son amour.
C’eſt là de mon deſtin la derniere injuſtice.	C'est là de mon destin la dernière injustice.
Sa triſte confidence augmente mon ſupplice.	Sa triste confidence augmente mon supplice.
Pardonne, chere ſœur, je te manque de foy.	Pardonne, chère sœur, je te manque de foi.
muis bien-toit mon trépas te vangera de moy.	muis biensait mon trépas te vengera de moi.
La mort n’eſt pas un mal pour une mal-heureuſe, Hâtons nous de finir une vie odieuſe, Et m’épargnant des maux qui renaiſſent toûjours, Commençons mon repos par la fin de mes jours.	La mort n'est pas un mal pour une malheureuse, Hâtons nous de finir une vie odieuse, Et m'épargnant des maux qui renaissent toujours, Commençons mon repos par la fin de mes jours.
CHATEAUBRIANT.	CHATEAUBRIANT.
Ah!	Ah!
ne permettez pas que l’ennuy vous abatte.	ne permettez pas que l'ennui vous abatte.
C’eſt dans les grands malheurs que la conſtance éclatte.	C'est dans les grands malheurs que la constance éclatte.
7 Songez que mon deſtin dépend de voſtre fort, Que je ne pourrois pas ſurvivre à voſtre mort.	7 Songez que mon destin dépend de votre fort, Que je ne pourrais pas survivre à votre mort.
Et que dés le berceau d’une mere privée, ſe vous ay dans mes bras tendrement eſlevée.	Et que dès le berceau d'une mère privée, se vous ai dans mes bras tendrement élevée.
Vivez.	Vivez.
Si voſtre ſœur fuit le Roy des Romains, Je ſçauray tout tenter pour rompre ſes deſſeins.	Si votre sœur fuit le Roi des Romains, Je saurai tout tenter pour rompre ses desseins.
quand j’aurois moins pour vous de tendreſſe & de zele, L'intereſt de l’Eſtat m’armeroit ſeul contr’elle.	quand j'aurais moins pour vous de tendresse et de zèle, L'intérêt de l'État m'armerait seul contr'elle.
Oüi, pour faireuronter an coup qui le detruit, Je puis.	Oui, pour faireuronter an coup qui le détruit, Je puis.
Mais elle vient, & ſon Conſeil la ſuit, Cachez voſtre douleur.	Mais elle vient, et son Conseil la suit, Cachez votre douleur.
SCENE II.	SCÈNE II.
LA DUCHESSE, ISABELLE, LE MARESCHAL DE RIEUX, LE COMTE DE COMINGE, CHATEAUBRIANT.	LA DUCHESSE, ISABELLE, LE MARÉCHAL DE RIEUX, LE COMTE DE COMINGE, CHATEAUBRIANT.
QUE chacun prenne place.	QUE chacun prenne place.
Vous ſçavez nos malheurs ſans que je les retrace.	Vous savez nos malheurs sans que je les retrace.
Vous ſçavez que jamais un Eſtat accablé Ne fut plus que le mien ni plus ſouvent troublé, que la guerre étrangere & la guerre inteſtine L’ont cent fois menacé d’une en tiere ruine.	Vous savez que jamais un État accablé Ne fut plus que le mien ni plus souvent troublé, que la guerre étrangère et la guerre intestine L'ont cent fois menacé d'une en tirer ruine.
La fortune aujourd’huy mieux d’accord aveo nous Sembloit nous regarder avec des yeux plus doux, Et du Roy des Romains l’alliance prochaine Eſtoit de ſes faveurs une preuve certaine.	La fortune aujourd'hui mieux d'accord aveo nous Semblait nous regarder avec des yeux plus doux, Et du Roi des Romains l'alliance prochaine Était de ses faveurs une preuve certaine.
Par ſes propres ſujets ce Prince eſt arreſté.	Par ses propres sujets ce Prince est arrêté.
Faut-il executer ou rompre le traité?	Faut-il exécuter ou rompre le traité?
Vous qu’un pere mourant ſeur de voſtre prudence Me donna pour appuy d’une foible puiſſance, Qui par l’ardeur d’un zele éprouvé tant de fois Avez ſi bien rempli l’équité de ſon choix:	Vous qu'un père mourant sûr de votre prudence Me donna pour appui d'une faible puissance, Qui par l'ardeur d'un zèle éprouvé tant de fois Avez si bien rempli l'équité de son choix:
Voyez ce qu’il faut faire en ce peril extreme, Faites icy pour moy ce qu’il feroit luy-meſme, De vos neureux avis preſtez moy le Iecours, Ee ſoyez tels enfin que vous futes toûjours.	Voyez ce qu'il faut faire en ce péril extrême, Faites ici pour moi ce qu'il ferait quelque-même, De vos neureux avis prêtés moi le Jecours, Ée soyez tels enfin que vous futes toujours.
LE MARESCHAL DE RIEUX.	LE MARÉCHAL DE RIEUX.
Puiſque vous l’ordonnez, je vay parler, Madame, Ma bouche n’eſt jamais infidelle à mon ame.	Puisque vous l'ordonnez, je vais parler, Madame, Ma bouche n'est jamais infidèle à mon âme.
Ainſi bruſlant d’un zele à ma franchiſe égal, J’oſe me declarer contre un hymen fatal.	Ainsi brûlant d'un zèle à ma franchise égal, J'ose me déclarer contre un hymen fatal.
D'un Prince ſans pouvoir que pouvez-vous attendre?	D'un Prince sans pouvoir que pouvez-vous attendre?
Opprimé, dans les fers', viendra-t’il vous defendre?	Opprimé, dans les fers, viendra-t-il vous défendre?
L’Eſtat par voſtre hymen veut ſe faire un apuy.	L'État par votre hymen veut se faire un appui.
N’eſt-ce pas l’en priver que vous donner à luy!	N'est-ce pas l'en priver que vous donner à lui!
Et courant au devant du coup qui nous menace Juſqu’en ces lieux peut -être attirer ſa diſgrace?	Et courant au devant du coup qui nous menace Jusqu'en ces lieux peut -être attirer sa disgrâce?
Voſtre pere, il eſt vray, luy promit voſtre foy.	Votre père, il est vrai, Seigneur promit votre foi.
Mais la neceſſité preſcrit une autre loy, Diſpenſe de tenir la foy qu’on a promiſe, Et tout devient permis quand elle l’autoriſe.	Mais la nécessité prescrit une autre loi, Dispense de tenir la foi qu'on a promise, Et tout devient permis quand elle l'autorise.
Hé pourquoy vous gêner d’un ſcrupule ſi vain?	Hé pourquoi vous gêner d'un scrupule si vain?
A manquer de parole il vous ouvre un chemin.	À manquer de parole il vous ouvre un chemin.
A-t’il tenu la ſienne la com rufohammee Venir encourager la Bretagne allarmée?	A-t-il tenu la sienne la com rufohamène Venir encourager la Bretagne alarmée?
Où ſont ces grands ſecours qu’il nous avoit promis?	Où sont ces grands secours qu'il nous avait promis?
Permettez-vous icy ce qu’il s’eſt bien permis.	Permettez-vous ici ce qu'il s'est bien permis.
Sa lenteur outrageante à peine eſt excuſable.	Sa lenteur outrageante à peine est excusable.
Voſtre refus, Madame, eſt juſte & raiſonnableIl faut dés ce jourd’huy le luy faire annoncer, A ſes droits de luy-meſme il pourra renoncer, Dans ſon malheur peut.	Votre refus, Madame, est juste et raisonnableIl faut dès ce jourd'hui le lui faire annoncer, À ses droits de lui-même il pourrait renoncer, Dans son malheur peut.
eſtre il ſe fera juſtice:	Ah il se fera justice:
Quoy qu’il en ſoit, l’Eſtat veut ce grand ſacrifice.	Quoi qu'il en soit, l'État veut ce grand sacrifice.
Il vaut mieux encourir ſon impuiſſant couroux, Que le courroux du Ciel preſt à tomber ſur nous, Et la paix en ces lieux ſi long-temps ſouhaitée Par ſon inimitié n’eſt pas trop achetée.	Il vaut mieux encourir son impuissant courroux, Que le courroux du Ciel prêt à tomber sur nous, Et la paix en ces lieux si longtemps souhaitée Par son inimitié n'est pas trop achetée.
LA DUCHESSE.	LA DUCHESSE.
Parlez Cominge.	Parlez Cominge.
LE COMTE DE COMINGE.	LE COMTE DE COMINGE.
En vain on demande ma voix, Madame, en les formant le Ciel inſtruit les Rois.	En vain on demande ma voix, Madame, en les formant le Ciel instruit les Rois.
Ils naiſſent éclairez, juſtes, prudens, & ſages, Sont du Dieu qui ſçait tout les vivantes Images, Se donnent les avis qu’on voudroit leur donner, Et qui gouverne tout peut ſeul ſe gouverner.	Ils naissent éclairez, justes, prudents, et sages, Sont du Dieu qui sait tout les vivantes Images, Se donnent les avis qu'on voudrait leur donner, Et qui gouverne tout peut seul se gouverner.
Toutefois puiſqu’il faut dire ce que je penſe De Maximilian je prendray la defenſe.	Toutefois puisqu'il faut dire ce que je pense De Maximilian je prendrai la défense.
Quels ſecours, vous dit-on, nous a-t-il envoyez?	Quels secours, vous dit-on, nous a-t-il envoyez?
Il nous a ſecourus mieux que vous ne croyez.	Il nous a secourus mieux que vous ne croyez.
Le ſeul bruit de ſon nom & de ſon alliance A ſuſpendu le cours des armes de la France.	Le seul bruit de son nom et de son alliance A suspendu le cours des armes de la France.
Chlarieo cruignant toûjours que le fer à la main Ce Prince en ſes Eſtats ne s’ouvrit un chemin, Pour prevenir l'effet de ſes ardeurs guerrieres, A par des corps d’armée aſſuré ſes frontieres.	Chlarieo cruignant toujours que le fer à la main Ce Prince en ses États ne s'ouvrit un chemin, Pour prévenir l'effet de ses ardeurs guerrières, A par des corps d'armée assuré ses frontières.
A in ſi diminuant ſon pouvoir diviſé;	À in si diminuant son pouvoir divisé;
Il n’apporte en ces lieux qu’un courroux épuiſé.	Il n'apporte en ces lieux qu'un courroux épuisé.
Mais le traité rompu diſſipe ſes alarmes, Il va tourner ſur nous tout l’effort de ſes armes;	Mais le traité rompu dissipe ses alarmes, Il va tourner sur nous tout l'effort de ses armes;
Bien-toſt de toutes parts aſſemblant ſes ſoldats Il viendra furieux fondre ſur vos Eſtats.	Bientôt de toutes parts assemblant ses soldats Il viendra furieux fondre sur vos États.
Déja trop affoiblis par nos guerres paſſées Pourrons-nous ſoûtenir ſes forces ramaſſées?	Déjà trop affaiblis par nos guerres passées Pourrons-nous soutenir ses forces ramassées?
Mais le Roy des Romains, dit-on, eſt arrêté.	Mais le Roi des Romains, dit-on, est arrêté.
Vain pretexte pour rompre un ſi ferme traité.	Vain prétexte pour rompre un si ferme traité.
Il luy reſte, Madame, aſſez de bras fidelles, Pour l’arracher des mains d’un tas d’hommes rebelles, Et l’Empereur ſon pere alarmé pour ſes jours Fera bien-toſt voler l’Empire à ſon ſecours.	Il lui reste, Madame, assez de bras fidèles, Pour l'arracher des mains d'un tas d'hommes rebelles, Et l'Empereur son père alarmé pour ses jours Fera bientôt voler l'Empire à son secours.
C’en eſt trop, ſon nom ſeul ſuſfit pour le defendre.	C'en est trop, son nom seul susfit pour le défendre.
Qui ſecoüa le joug viendra bien le reprendre.	Qui secoursa le joug viendra bien le reprendre.
Dans la rebellion rarement obſtiné Le peuple n’a qu’un feu mort auſſi-toſt que né, A peine a-t il failli qu’il reconnoit ſon crime, Et revient de luy-même à ſon Roy legitime.	Dans la rébellion rarement obstiné Le peuple n'a qu'un feu mort aussitôt que né, À peine a-t il failli qu'il reconnaît son crime, Et revient de lui-même à son Roi légitime.
Peſez ce qu’un refus peut tiainer aprés ſoy.	Pesez ce qu'un refus peut tiainer après soi.
Au Marêchal d’Albret on a manqué de foy.	Au Maréchal d'Albret on a manqué de foi.
Que diront nos voiſins?	Que diront nos voisins?
la terre toute entiere, Si cette perfidic eſt jointe à la premiere?	la terre toute entière, Si cette perfidic est jointe à la première?
A vec nous deſormais qui voudra s’allier?	À vec nous désormais qui voudra s'allier?
A nous, à nos traitez qui voudra ſe fier?	À nous, à nos traités qui voudra se fier?
Voyez d’un tel refus la honte inſeparable.	Voyez d'un tel refus la honte inséparable.
La parole des Rois doit eſtre inviolable.	La parole des Rois doit être inviolable.
Il faut qu’elle leur ſoit ce qu’à nous un ſerment, Que l’équitable foy regle leur ſentiment.	Il faut qu'elle leur soit ce qu'à nous un serment, Que l'équitable foi règle leur sentiment.
Si du commerce humain elle eſtoit exilée, Il faudroit que par eux elle y fut rapellée, Que par eux ſur la terre elle reprit ſes droits, Et qu’on la retrouva dans les ames des Rois.	Si du commerce humain elle était exilée, Il faudrait que par eux elle y fut rappelée, Que par eux sur la terre elle reprit ses droits, Et qu'on la retrouva dans les âmes des Rois.
LE MARESCHAL DE RIEUX.	LE MARÉCHAL DE RIEUX.
Le Comte de Cominge eſt prudent, équitable, Il craint pour voſtre gloire, & ſa crainte eſt loüable.	Le Comte de Cominge est prudent, équitable, Il craint pour notre gloire, et sa crainte est louable.
Mais, s’il faut l’avoüer, la ſevere équité Ne peut avoir icy qu’un pouvoir limité, Madame.	Mais, s'il faut l'avouer, la sévère équité Ne peut avoir ici qu'un pouvoir limité, Madame.
Un mal preſſant demande un prompe remede.	Un mal pressant demande un prompe remède.
La neceſſité parle, il faut que tout luy cede.	La nécessité parle, il faut que tout belle cède.
Sous le poids de ſes maux l’Eſtat va ſuccomber, Si quelqu’un ne l’apuye, il eſt preſt à tomber.	Sous le poids de ses maux l'État va succomber, Si quelqu'un ne l'appuie, il est prêt à tomber.
Nos Alliez laſſez d’une guerre infertile De leur premiere ardeur n’ont qu’un reſte inutile.	Nos Alliés lassez d'une guerre infertile De leur première ardeur n'ont qu'un reste inutile.
Les uns plus refroidis, par des complots ſecrets Vont mandier en France une honteuſe paix, Et les autres chargez & d’ennuis & de chaines D’une longue priſon y reſſentent les peines.	Les uns plus refroidis, par des complots secrets Vont mandier en France une honteuse paix, Et les autres chargés et d'ennuis et de chaines D'une longue prison y ressent les peines.
Il vous faut un époux dont le puiſſant ſecours De nos mauvais deſtins interrompe le cours.	Il vous faut un époux dont le puissant secours De nos mauvais destins interrompe le cours.
Alphonſe, que l’on conte entre les plus grands Princes Qui de Naples en paix gouverne les Provinces, Pour époux, pour vangeur vous offre un de ſes fils.	Alphonse, que l'on conte entre les plus grands Princes Qui de Naples en paix gouverne les Provinces, Pour époux, pour vengeur vous offre un de ses fils.
Ses intereſts, Madame, aux voſtres ſont unis.	Ses intérêts, Madame, aux vôtres sont unis.
Il a ſçû par le bruit que l’Europe publie, Que Charles de ſon joug menace l’Italie, Que voyant à ſes loix tous ſes voiſins ſoumis, Il veut delà les Monts chercher des ennemis, Franchir de l’Appennin la barriere impuiſſante, S’ouvrir juſques à Rome une route ſanglante, Et de tout l’univers devenant la terreur Se faire d’Orient proclamer Empereur.	Il a su par le bruit que l'Europe publie, Que Charles de son joug menace l'Italie, Que voyant à ses lois tous ses voisins soumis, Il veut delà les Monts chercher des ennemis, Franchir de l'Apennin la barrière impuissante, S'ouvrir jusqu' à Rome une route sanglante, Et de tout l'univers devenant la terreur Se faire d'Orient proclamer Empereur.
Chaque jour alarmé du bruit de ſes conqueſtes, Il tient auprés de luy des troupes toutes preſtes.	Chaque jour alarmé du bruit de ses conquêtes, Il tient auprès de même des troupes toutes prêtes.
Vous n’avez qu’à parler.	Vous n'avez qu'à parler.
Suivi de ſes ſoldats Son fils viendra bien-toſt defendre vos Eſlats, Et trouvant une voye ouverte à ſa vangeance, Sceler du ſang François voſtre heureuſe alliance.	Suivi de ses soldats Son fils viendra bientôt défendre vos Élats, Et trouvant une voie ouverte à sa vengeance, Sceler du sang Français votre heureuse alliance.
Prononcez pour ce Prince, & ſans plus differer A Maximilian oſez le préferer.	Prononcez pour ce Prince, et sans plus différer À Maximilian osez le préférer.
Ne vous tourmentez plus d’un ſcrupule frivole.	Ne vous tourmentez plus d'un scrupule frivole.
On peut ſans l’outrager luy manquer de parole.	On peut sans l'outrager ton manquer de parole.
L’intereſt de l’Eſtat vous fit promettre à luy, Et ce même intereſt vous dégage aujourd’huy.	L'intérêt de l'État vous fit promettre à lui, Et ce même intérêt vous dégage aujourd'hui.
Voſtre gloire par là ne peut eſtre ternie, La Bretagne le veut, elle vous juſtifie.	Votre gloire par là ne peut être ternie, La Bretagne le veut, elle vous justifie.
LE COMTE DE COMINGE.	LE COMTE DE COMINGE.
On veut delà les Monts vous chercher un époux!	On veut delà les Monts vous chercher un époux!
D’un ſi foible Allié que nous promettons nous, Madame?	D'un si faible Allié que nous promettons nous, Madame?
Ce n’eſt plus cette antique Italie Des dépoüilles du monde autrefois annoblie, Qui fit craindre en tous lieux ſes armes & ſes loix, Triompha vaillamment de nos premiers Gaulois, Qui dans Rome tonnant du haut du Capitole, Etonnoit tous les Rois d’une ſeule parole.	Ce n'est plus cette antique Italie Des dépouilles du monde autrefois annoblie, Qui fit craindre en tous lieux ses armes et ses lois, Triompha vaillamment de nos premiers Gaulois, Qui dans Rome tonnant du haut du Capitole, Etonnoit tous les Rois d'une seule parole.
On ne voit plus ſes Chefs par la gloire animez S’armer pour le ſecours des peuples opprimez, Et fiers perſecuteurs des Tyrans & des crimes Remettre en leurs Eſtats les Princes legitimes.	On ne voit plus ses Chefs par la gloire animés S'armer pour le secours des peuples opprimés, Et fiers persécuteurs des Tyrans et des crimes Remettre en leurs États les Princes légitimes.
Ainſi n’eſperez point que l’époux pretendu Vous amene un ſecours vainement attendu.	Ainsi n'espérez point que l'époux prétendu Vous amène un secours vainement attendu.
Croyons moins une ardeur qui tâche à nous ſeduire, En penſant nous ſauver n'allons point nous détruire, Et tombant d’un peril dans un plus grand danger;	Croyons moins une ardeur qui tâche à nous séduire, En pensant nous sauver n'allons point nous détruire, Et tombant d'un péril dans un plus grand danger;
Soumettre la Bretagne au joug d’un étranger.	Soumettre la Bretagne au joug d'un étranger.
Ah!	Ah!
s’il nous faut ſervir, ſervons-nos premiers Maîtres, Subiſſons l’heureux joug qu’ont ſubi nos Anceſtres.	s'il nous faut servir, servirons-nos premiers Maîtres, Subissons l'heureux joug qu'ont sujet nos Ancêtres.
Allons offrir nos cœurs au Monarque François, Allons luy demander & la paix & des loix.	Allons offrir nos cœurs au Monarque Français, Allons vertu demander et la paix et des lois.
Ce Roy dont la clemence égale le courage Pour nous tendre la main n’attend que noſtre hommage.	Ce Roi dont la clémence égale le courage Pour nous tendre la main n'attend que notre hommage.
Jamais dans ſon courroux il ne fut affermi.	Jamais dans son courroux il ne fut affermi.
L’ennemi ſuppliant n’eſt plus ſon ennemi, Pour fruit de ſes exploits il ne veut que la gloire, Au ſeul honneur de vaincre il borne ſa victoire.	L'ennemi suppliant n'est plus son ennemi, Pour fruit de ses exploits il ne veut que la gloire, Au seul honneur de vaincre il borne sa victoire.
Allons nous rendre à luy, tout nous ſera rendu, Et nous gagnerons plus que nous n’avons perdu.	Allons nous rendre à Dieu, tout nous sera rendu, Et nous gagnerons plus que nous n'avons perdu.
LA DUCHESSE.	LA DUCHESSE.
Oüi, c’eſt par cette voye & plus noble & plus ſeure Qu’entre la France & nous la paix ſe peut conclure, Que du Duc d’Orleans on peut briſer les fers, Et voir finir des maux depuis long-temps ſoufferts.	Oui, c'est par cette voie et plus noble et plus sûre Qu'entre la France et nous la paix se peut conclure, Que du Duc d'Orleans on peut briser les fers, Et voir finir des maux depuis longtemps soufferts.
LE HARESCHAL DE RIEUX.	LE HARÊCHAL DE RIEUX.
Madame, c’eſt plûtoſt redoubler ſa miſere.	Madame, c'est plutôt redoubler sa misère.
Ce moyen produiroit un effet tout contraire.	Ce moyen produirait un effet tout contraire.
Charles ingenieux à trouver des raiſons Sur luy plus que jamais étendroit ſes ſoupçons.	Charles ingénieux à trouver des raisons Suriblé plus que jamais étendrait ses soupçons.
Il craindroit que toûjours preſt à tout entreprendre Le Duc à voſtre hymen n’oſaſt encor pretendre, Que ſuivant la chaleur d’un courage trop prompt Contre luy de ſa chaine il ne vangea l’affront.	Il craindrait que toujours prêt à tout entreprendre Le Duc à votre hymen n'osât encor prétendre, Que suivant la chaleur d'un courage trop prompt Contre lui de sa chaine il ne vengea l'affront.
Pour prevenir ce coup, ſa prudence cruelle Joindroit à ſa priſon une gêne nouvelle, Et nous verrions pour luy nos efforts ſuperflus Loin de briſer ſes fers les ſerrer encor plus.	Pour prévenir ce coup, sa prudence cruelle Joindrait à sa prison une gêne nouvelle, Et nous verrions pour lui nos efforts superflus Loin de briser ses fers les serrer encor plus.
Non, ne nous flatons point d’une vaine eſperance.	Non, ne nous flattons point d'une vaine espérance.
On ne peut le ſauver que par la violence.	On ne peut le sauver que par la violence.
Allons le fer en main l’arracher de priſon.	Allons le fer en main l'arracher de prison.
La force eſt des vrais Rois la derniere raiſon.	La force est des vrais Rois la dernière raison.
Celuy que pour époux mon zele vous propoſe, Peut de ſes longs malheurs faire ceſſer la cauſe.	Celui que pour époux mon zèle vous propose, Peut de ses longs malheurs faire cesser la cause.
Que ſon peuple ſoit tel qu’on l’oſe publier, C’eſt à l’évenement de le juſtifier.	Que son peuple soit tel qu'on l'ose publier, C'est à l'évenement de le justifier.
On craint de ſe ſoumettre à des loix étrangeres, Vaine crainte.	On craint de se soumettre à des lois étrangères, Vaine crainte.
Ces loix ſont au moins volontaires, Oüi, s’il nous faut flêchir devant un Souverain, Faiſons, faiſons, qu’il ſoit l’œuvre de noſtre main.	Ces lois sont au moins volontaires, Oui, s'il nous faut flamchir devant un Souverain, Faisons, faisons, qu'il soit l'œuvre de notre main.
Quand la force l’impoſe on hait la ſervitude, avais un joug lbre perd ce qu’un joug a de rude, Et de ſon propre choix un peuple ſatisfait Obe le lahoimmmuit uumnaitie qu'irs eit fait.	Quand la force l'impose on hait la servitude, avais un joug lougre perd ce qu'un joug a de rude, Et de son propre choix un peuple satisfait Obe le lahoimuit umnaitie qu'irs eit fait.
SCENEIII.	SCENEII.
LA DUCHESSE, LE MARESCHAL DE RIEUX, LE COMTE DE COMINGE, LE MARESCHAL D’ALBRET.	LA DUCHESSE, LE MARÉCHAL DE RIEUX, LE COMTE DE COMINGE, LE MARÉCHAL D'ALBRET.
LE MARESCHAL D’ALBRET.	LE MARÉCHAL D'ALBRET.
MAdame.	MAdame.
LA DUCHESSE.	LA DUCHESSE.
D’où vous vient cette ardeur empreſſée Maréchal ?	D'où vous vient cette ardeur empressée Maréchal ?
LE MARECHAL D’ALBRET.	LE MARÉCHAL D'ALBRET.
Aujourd’huy vous eſtes exaucée, Le Duc d’Orleans.	Aujourd'hui vous êtes exaucée, Le Duc d'Orleans.
LA DucnEsSE.	LA DucEsSE.
Quoy?	Quoi?
LE MARECHAL D'ALBRET.	LE MARÉCHAL D'ALBRET.
Va paroître à vos yeux.	Va paraître à vos yeux.
LA DUCHESSE.	LA DUCHESSE.
Le Duc eſtarrivé.	Le Duc estarrivé.
7	7
ISABELLE bas.	ISABELLE bas.
Ciel !	Ciel !
IE MARECHAL D’ALBRET.	JE MARÉCHAL D'ALBRET.
Il eſt en ces lieux.	Il est en ces lieux.
Je marchois, & déja les montagnes prochaines Cachoient à mes regars les murailles de Rennes, D’un gros de cavaliers le Prince environné S’eſt offert tout d’un coup à mon œil étonné.	Je marchais, et déjà les montagnes prochaines Cachaient à mes régars les murailles de Rennes, D'un gros de cavaliers le Prince environné S'est offert tout d'un coup à mon œil étonné.
Je l’aborde, & de tout deſirant de m’inſtruire Juſqu’au pied des rempars je viens de le cond duire.	Je l'aborde, et de tout désirant de m'instruire Jusqu'au pied des rempars je viens de le cond uire.
Lholo det muis il uecemd;	Lholo de muis il ècemd;
u tos orureo rolimis, Que par vous de ces lieux l’accez luy ſoit permis.	u tos orureo rolimis, Que par vous de ces lieux l'accès lui soit permis.
l’ay devancé ſes pas, & toûjours plein de zele J’ay couru vous porter cette heureuſe nouvelle?	l'ai devancé ses pas, et toujours plein de zèle J'ai couru vous porter cette heureuse nouvelle?
̀	
LA DUCHESSE.	LA DUCHESSE.
Ah!	Ah!
qu’au devant de luy l’on ſe hâte d’aller, Si vous avez du zele il le faut ſignaler.	qu'au devant de belle l'on se hâte d'aller, Si vous avez du zèle il le faut signaler.
Ne perdez point de temps en aprets ordinaires, Dans un pareil deſordre ils ſont peu neceſſaires.	Ne perdez point de temps en aprets ordinaires, Dans un pareil désordre ils sont peu nécessaires.
Si ſans bruit, ſi ſans pompe on le fait recevoir, Ine l’imputera qu’à l’ardeur de le voir	Si sans bruit, si sans pompe on le fait recevoir, Ine l'imputera qu'à l'ardeur de le voir
Le Maréchal d’Albret ſort, Vous dont le bien public fait l’étude & la peine Ne precipitez rien.	Le Maréchal d'Albret sort, Vous dont le bien public fait l'étude et la peine Ne précipitez rien.
Voyons ce qui l’ameine, ninez, & pour naer monenoix lul un epoux Attendons que le Prince ait paru devant nous.	Voyons ce qui l'amène, ninez, et pour na monenoix lul un époux Attendons que le Prince ait paru devant nous.
Les Miniſtres ſortent.	Les Ministres sortent.
Nous, ma ſœur, pour acroître une joye imprevûë Hâtons-nous de joüir d’une ſi chere veuë, D’auſſi loin qu’il ſe peut allons le découvrir.	Nous, ma sœur, pour acroître une joie imprévue Hâtons-nous de jouir d'une si chère vue, D'aussi loin qu'il se peut allons le découvrir.
ISABELLE en s’en allant.	ISABELLE en s'en allant.
Que cette veue helas!	Que cette vue hélas!
me va faire ſouffrir.	me va faire souffrir.
Fin du ſecond Acte.	Fin du second Acte.
ACTE III.	ACTE III.
SCENE I.	SCÈNE I.
ISABELLE, CHATEAUBRIANT,	ISABELLE, CHATEAUBRIANT,
ISABELLE.	ISABELLE.
On je ne verray point un ſi triſte ſpectacle.	On je ne verrai point un si triste spectacle.
NTon zele à ma retraitte oppoſe un vain obſtacle.	NTon zèle à ma retraite oppose un vain obstacle.
Je ne ſçaurois cacher le trouble où je me voy, Mes ſoûpirs, mes regards parleroient malgré moy, Et ce cœur malheureux trop plein de la tendreſſe, Laiſſeroit à leurs yeux échapper ſa foibleſſe.	Je ne saurais cacher le trouble où je me vois, Mes soupirs, mes regards parleraient malgré moi, Et ce cœur malheureux trop plein de la tendresse, Laisserait à leurs yeux échapper sa faiblesse.
Je ne le verray point, & loin de m’arrêter Pour mon honneur, à fuïr tu devrois m’inciter.	Je ne le verrai point, et loin de m'arrêter Pour mon honneur, à fuir tu devrais m'inciter.
CHATEAUBRIANT.	CHATEAUBRIANT.
Hé!	Hé!
Madame, voyez que la fuite au contraire Va trahir un ſecret que vous voulez leur taire.	Madame, voyez que la fuite au contraire Va trahir un secret que vous voulez leur taire.
Elle donne matiere à de juſtes ſoupçons.	Elle donne matière à de justes soupçons.
Ie clanis qu'on n’en penetre aiſément les raiſons:	Je clanis qu'on n'en pénètre aisément les raisons:
ISABELLE.	ISABELLE.
Que veux-tu que je faſſe en ce deſordre extrême Cruelle!	Que veux-tu que je fasse en ce désordre extrême Cruelle!
ſuis-je icy maîtreſſe de moy-méme?	suis-je ici maîtresse de moi-même?
Ce cher Prince approchoit.	Ce cher Prince approchait.
Le peuple par des cris A des tranſports de joye excitoit les eſprits.	Le peuple par des cris À des transports de joie excitait les esprits.
Sur le front de ma ſœur elle eſtoit répanduë, La douleur s’emparoit de mon ame éperduë.	Sur le front de ma sœur elle était répandue, La douleur s'emparait de mon âme éperdue.
L’approche d’un Heros trop tendrement aimé Redoubloit les ardeurs de mon cœur alarmé.	L'approche d'un Héros trop tendrement aimé Rédoublait les ardeurs de mon cœur alarmé.
Mon amour dans mes yeux commençoit à ſe peindre, Mon deſordre croiſſoit, je ne pouvois plus feindre, Ma tendreſſe emportoit mon de voir combatu, Je cedois, & la fuite a ſauvé ma vertu.	Mon amour dans mes yeux commençait à se peindre, Mon désordre croissait, je ne pouvais plus feindre, Ma tendresse emportait mon de voir combattu, Je cédais, et la fuite a sauvé ma vertu.
CHATEAUBRIANT.	CHATEAUBRIANT.
Domez moms a l'emroy dont vous eſtes atteinte:	Domez moments à l'emroi dont vous êtes atteinte:
Car quel eſt aprés tout l’objet de voſtre crainte?	Car quel est après tout l'objet de votre crainte?
ISABELLE.	ISABELLE.
Que ſçay-je.	Que sais-je.
Tout confond mes eſprits incertains, crains.	Tout confond mes esprits incertains, crains.
Je crains tout, & ne ſçay pourtant ce que je De mouvemens divers mon ame eſt agitée, De mille affreux ſoucis elle eſt inquietée, Je ſens l’amour, la crainte, y regner tour à tour;	Je crains tout, et ne sais pourtant ce que je De mouvements divers mon âme est agitée, De mille affreux soucis elle est inquiétée, Je sens l'amour, la crainte, y régner tour tour;
Et cette crainte même augmente mon amour.	Et cette crainte même augmente mon amour.
CHATEAUBRIANT.	CHATEAUBRIANT.
Ne vous alarmez point, voſtre peur ſera vaine, Vous même n’allez pas prevenir voſtre peine.	Ne vous alarmez point, votre peur sera vaine, Vous -même n'allez pas prévenir votre peine.
Son amant, il eſt vray, va paroiſtre à ſes yeux, Mais ſçait-on le deſſein qui l’ameine en ces lieux?	Son amant, il est vrai, va paraître à ses yeux, Mais sais-on le dessein qui l'amène en ces lieux?
Quand même il y viendroit pour couronner ſa flame Devriez vous chaſſer tout eſpoir de voſtre ame, Croyez-vous, que l’état tout preſt à trébucher 'iſqu’à flater leurs vœux onitie lelacher.	Quand même il y viendrait pour couronner sa flamme Devriez -vous chasser tout espoir de votre âme, Croyez-vous, que l'état tout prêt à trébucher 'isqu’à flatter leurs vœux onitie lelacher.
A-t’il moins de raiſon de leur eſtre contraire Que n’en eut autrefois le feu Duc voſtre pere, L' voſtre ſœur enfin voudroit-elle aujourd’huy Perdre & ſon propre peuple & ſa gloire pour luy?	A-t-il moins de raison de leur être contraire Que n'en eut autrefois le feu Duc votre père, L' être sœur enfin voudrait-elle aujourd'hui Perdre et son propre peuple et sa gloire pour lui?
ISABELLE.	ISABELLE.
Foibles raiſons d’état, helas!	Faibles raisons d'état, hélas!
que tu m’apportes, L’amour a ſes raiſons, elle ſont les plus fortes, Il parle, c’eſt aſſez.	que tu m'apportes, L'amour a ses raisons, elle sont les plus fortes, Il parle, c'est assez.
On n’écoûte plus rien, A l’intereſt public on prefere le ſien, Ma ſœur n’a point d’époux, un refus la dégaElle aime, elle peut tout, que veux-tu davantage.	On n'écoute plus rien, A l'intérêt public on préfère le sien, Ma sœur n'a point d'époux, un refus la dégaElle aime, elle peut tout, que veux-tu davantage.
CHATEAUBRIANT.	CHATEAUBRIANT.
Elle ſe reſoudroit à recevoir la foy D’un Prince abandonné du ſort & de ſon Roy?	Elle se résoudrait à recevoir la foi D'un Prince abandonné du sort et de son Roi?
Par elle nous verrions la Bretagne affligée, En de nouveaux malheurs pour jamais engagée?	Par elle nous verrions la Bretagne affligée, En de nouveaux malheurs pour jamais engagée?
Ah!	Ah!
prevenons un coup funeſte à ſes Eſtats.	prévenons un coup funeste à ses États.
C’eſt la trahir icy que ne la trahir pas.	C'est la trahir ici que ne la trahir pas.
Empeſchons un nyinen nonteux à ſa memoire, Et malgré qu’elle en ait conſervons luy ſa gloire.	Empêchons un nyinen nonteux à sa mémoire, Et malgré qu'elle en ait conservons toujours sa gloire.
Cet ouvrage important n’eſt qu’à vous reſervé	Cet ouvrage important n'est qu'à vous réservé
A moy ?	À moi ?
ISABELLE.	ISABELLE.
CHATEAADEIIAT.	CHATEADEIIAT.
Veüillez me croire, & l’Eſtat eſt ſauvẽ Broüillez ces deux amans quand tout ſemble leur rire, Et par la jalouſie.	Veüillez me croire, et l'État est sauvẽ Brouillez ces deux amants quand tout semble leur rire, Et par la jalousie.
ISABELLE.	ISABELLE.
Ah qu’oſes-tu me dire?	Ah qu'oses-tu me dire?
Par quels lâches moyens veux-tu me ſecourir?	Par quels lâches moyens veux-tu me secourir?
Contre ma propre ſœur j’y pourrois recourir?	Contre ma propre sœur j'y pourrais recourir?
C iij Traverſer ſon ardeur pour établir la mienne, Perdre ma gloire, afin de conſerver la ſienne, Et par des trahiſons dont la honte eſt le fruit Pourſuivre vainement un bonheur qui me fuit?	Ç Cijà Traverser son ardeur pour établir la mienne, Perdre ma gloire, afin de conserver la sienne, Et par des trahisons dont la honte est le fruit Poursuivre vainement un bonheur qui me fuit?
Non, modere pour moy ce zele illegitime, A mes cruels malheurs n’ajoûtons point le crime.	Non, modère pour moi ce zèle illégitime, À mes cruels malheurs n'ajoutons point le crime.
Je ſens que mes chagrins m’approchant du tombeau Vont bien-toſt de ma vie éteindre le flambeau, Souffre qu’avec honneur je perde la lumiere, Q ie j’emporte au cercüeil ma vertu toute entiere, Et qu’un jour nos neveux apprenant mon trépas r ieignent mon infortune, & ne m’abhorrent pas.	Je sens que mes chagrins m'approchant du tombeau Vont bientôt de ma vie éteindre le flambeau, Souffre qu'avec honneur je perde la lumière, Q ie j'emporte au cercueil ma vertu toute entière, Et qu'un jour nos neveux apprenant mon trépas r ieignent mon infortune, et ne m'abhorrent pas.
Mais ma ſœur vient icy.	Mais ma sœur vient ici.
SCENE II.	SCÈNE II.
LA DUCHESSE, ISABELLE, CHATEAUBRIANT.	LA DUCHESSE, ISABELLE, CHATEAUBRIANT.
LA DUCHESSE.	LA DUCHESSE.
Oene taute mpreveue Ma ſœur, vous a ſi-toſt derobée à ma veuë?	Oène taute méprevue Ma sœur, vous a si-tôt derobée à ma vue?
Pourquoy fair, quand le Ciel ſe declare pour nous ?	Pourquoi fair, quand le Ciel se déclare pour nous ?
Au bonheur de ce jour vous refuſeriez-vous?	Au bonheur de ce jour vous refuseriez-vous?
ISABELLE.	ISABELLE.
Non ma ſœur, le retour d’un Prince qui vous aime Allemne, Ne me touche pas moins qu’il vous touche vous Mais depuis quelque temps un long chagrin me ſuit, Loin du bruit il s’appaiſe, il s’accroit dans le bruit.	Non ma sœur, le retour d'un Prince qui vous aime Allemène, Ne me touche pas moins qu'il vous touche vous Mais depuis quelque temps un long chagrin me suit, Loin du bruit il s'apaise, il s'accroît dans le bruit.
Ces cris qu’un peuple pouſſe & redouble ſans ceſſe De mon ame inquiete irritoient la triſteſſe, ay crû qne mes ſoûpirs dans ce Palais perdus Ne vous troubleroient point n’eſtant point entendus.	Ces cris qu'un peuple pousse et redouble sans cesse De mon âme inquiète irritaient la tristesse, ai cru q mes soupirs dans ce Palais perdus Ne vous troubleraient point n'étant point entendus.
LA DUCHESSE.	LA DUCHESSE.
Ah!	Ah!
faut il qu’aujourd’huy vous y ſoyez en proye?	faut -il qu'aujourd'hui vous y soyez en proie?
Mon cœur vous ſouhaitoit pour témoin de ſa joye, Et le ſpectacle heureux dont je viens de joüir Loin d’aigrir voſtre ennuy l’eut fait évanoüir.	Mon cœur vous souhait pour témoin de sa joie, Et le spectacle heureux dont je viens de jouir Loin d'aigrir votre ennui l'eut fait évanoüir.
’ay vû le Duc.	ais vu le Duc.
Il eſt plus que jamais aimableToûjours charmant, toûjours à luy-même ſemblable.	Il est plus que jamais aimableToûjours charmant, toujours à lui-même semblable.
Un œil moins que le mien de ſes traits prevenu Dans la foule à ſon air l’eut d’abord reconnu, 2aouo rariens ton ma lœul.	Un œil moins que le mien de ses traits prévenu Dans la foule à son air l'eut d'abord reconnu, 2aou rariens ton ma lœul.
SCEAVD III.	SCEUD III.
LA DUCHESSE, ISABELLE, CHATEAUBRIANT.	LA DUCHESSE, ISABELLE, CHATEAUBRIANT.
CHATEAUBRIANT.	CHATEAUBRIANT.
LE Duc eſt là Madame.	LE Duc est là Madame.
C iiij	Ç Cijà
LA DUCHESSE.	LA DUCHESSE.
Qu’il entre.	Qu'il entre.
CHATEAUBRIANT.	CHATEAUBRIANT.
Il vient.	Il vient.
ISABELLE bas.	ISABELLE bas.
O Ciel, que de trouble en mon ame.	Ô Ciel, que de trouble en mon âme.
SCENE IV.	SCÈNE IV.
LA DUCHESSE, LE DUC, ISABELLE, LE MARE'CHAL D’ALBRET, LE MARÉCHAL DE RIEUX, LE COMTE DE COMINGE, CHATEAUBRIANT.	LA DUCHESSE, LE DUC, ISABELLE, LE MARECHAL MAREALBRET, LE MARCHAL DE RIEUX, LE COMTE DE COMINGE, CHATEAUBRIANT.
LE DUC.	LE DUC.
E vous revois, Madame, & le deſtin plus doux Me permet aujourd’huy de m’approcher de vous, Enfin il a finy contre mon eſperance Les maux de ma priſon, & ceux de mon abſence, Quand je n’attendois plus qu’un trépas ſouhaité, Le Ciel moins inhumain m’a mis en liberté.	E vous revois, Madame, et le destin plus doux Me permet aujourd'hui de m'approcher de vous, Enfin il a fini contre mon espérance Les maux de ma prison, et ceux de mon absence, Quand je n'attendais plus qu'un trépas souhaité, Le Ciel moins inhumain m'a mis en liberté.
Pour la rendre à mon cœur plus aimable & plus chere, A vous, à vos Eſtats, il la rend ſalutaire, Il veut que je vous porte ui bien qu'enle plouuit, Et que voſtre repos en ſoit le premier fruit.	Pour la rendre à mon cœur plus aimable et plus chère, À vous, à vos États, il la rend salutaire, Il veut que je vous porte ui bien qu'enle plouit, Et que votre repos en soit le premier fruit.
LA DUCHESSE.	LA DUCHESSE.
Prince, nous le goûtons.	Prince, nous le goûtons.
Cet heureux jour repare Les maux où nous plongea voſtre priſon barbare.	Cet heureux jour répare Les maux où nous plongea votre prison barbare.
Il ne nous ſouvient plus de nos chagrins paſſez, Vous eſtes de retour, on vous voit, c’eſt aſſez.	Il ne nous souvient plus de nos chagrins passés, Vous êtes de retour, on vous voit, c'est assez.
Ah!	Ah!
Duc, que ces chagrins ont eu de violence, Sans ceſſe nous tournions nos regards vers la France.	Duc, que ces chagrins ont eu de violence, Sans cesse nous tournions nos regards vers la France.
Nous nous ſommes cent fois reproché vos malheurs, Ne pouvant rien de plus, nous vous donnions des pleurs.	Nous nous sommes cent fois reproché vos malheurs, Ne pouvant rien de plus, nous vous donnions des pleurs.
Quelque dure que fut la rigueur de vos chaînes Nos craintes groſſiſſoient l’image de vos peines, Et nos cœurs agitez par de cruels combats Sentoient pour vous des maux que vous ne ſentiez pas.	Quelque dure que fut la rigueur de vos chaînes Nos craintes grossissaient l'image de vos peines, Et nos cœurs agités par de cruels combats Sentaient pour vous des maux que vous ne sentiez pas.
Mais, Prince, ſe peut-il qu’enfin je vous revoye?	Mais, Prince, se peut-il qu'enfin je vous revoie?
Sur la foy de mes yeux faut-il que je le croye?	Sur la foi de mes yeux faut-il que je le croie?
A qui doit-on un bien ſi long-temps attendu, Et par quel coup du Ciel nous eſtes vous rendu?	À qui doit-on un bien si longtemps attendu, Et par quel coup du Ciel nous êtes vous rendu?
LE DUC.	LE DUC.
Je dois au Roy, Madame, un ſi grand avantage De ſa ſeule bonté mon retour eſt l’ouvrage.	Je dois au Roi, Madame, un si grand avantage De sa seule bonté mon retour est l'ouvrage.
Sa clemence s’étend juſqu’à ſes ennemis, Il veut gagner les cœurs que ſon bras a ſoũmis.	Sa clémence s'étend jusqu'à ses ennemis, Il veut gagner les cœurs que son bras a soumis.
Quand tout flate, tout craint ſa valeur triomphante, Il voit avec pitié l’Europe gemiſſante, Et luy-même bornant le coure de ſes hauts faits A ceux qu’il a vaincus il preſente la paix.	Quand tout flatte, tout craint sa valeur triomphante, Il voit avec pitié l'Europe gémissante, Et lui-même bornant le coure de ses hauts faits A ceux qu'il a vaincus il présente la paix.
LA DUCHESSE.	LA DUCHESSE.
Quoy, c’eſt peu qu’aujourd’huy voſtre heureuſe preſence Ait de nos plus chers vœux remply l’impatienEt comme s’il eſtoit un plus grand bien pour nous, Vous apportez encor la paix ave que vous.	Quoi, c'est peu qu'aujourd'hui votre heureuse présence Ait de nos plus chers vœux rempli l'impatienEt comme s'il était un plus grand bien pour nous, Vous apportez encor la paix ave que vous.
Quel bonheur!	Quel bonheur!
qui l’eut crû.	qui l'eût cru.
Mais quel Dieu tutelaire A pû d’un Roy vainqueur deſarmer la colere?	Mais quel Dieu tutélaire A pu d'un Roi vainqueur désarmer la colère?
Quel but dans ſes deſſeins peut-il ſe propoſer, Et quel joug, quelles loix nous veut-il impoſer,	Quel but dans ses desseins peut-il se proposer, Et quel joug, quelles lois nous veut-il imposer,
LE DUC.	LE DUC.
Loin de vous en donner il veut ſubir les vôtres, Ce Conquerant, Madame, eſt different des autres, Soûmis, reſpectueux, plus amant que vainqueur, Il vous offre par moy ſa couronne & ſon cœur.	Loin de vous en donner il veut subir les vôtres, Ce Onquérant, Madame, est différent des autres, Soumis, respectueux, plus amant que vainqueur, Il vous offre par moi sa couronne et son cœur.
Il veut qu’en étoufant une guerre cruelle, Voſtre hymen ſoit le nœu d’une paix éternelle.	Il veut qu'en étouffant une guerre cruelle, Votre hymen soit le nœu d'une paix éternelle.
Parmy tant de Heros qui groſſiſſent ſa Cour, C’eſt moy qu’il a choiſi pour ſervir ſon amour.	Parmi tant de Héros qui grossissent sa Cour, C'est moi qu'il a choisi pour servir son amour.
C’eſt moy, qui par le ſoin de vos grandeurs futures Viens d’une heureuſe paix faire les ouvertures, Et preſſer, en faveur d’un Roy victorieux Un aveu, dont un ſceptre eſt le prix glorieux.	C'est moi, qui par le soin de vos grandeurs futures Viens d'une heureuse paix faire les ouvertures, Et presser, en faveur d'un Roi victorieux Un aveu, dont un sceptre est le prix glorieux.
ISABELLE bas.	ISABELLE bas.
Ciel!	Ciel!
qu’entens-je?	qu'entends-je?
LE DUC.	LE DUC.
Oüy, Madame, arbitre de la terre Vous pouvez luy donner ou la paix ou la guerre.	Oui, Madame, arbitre de la terre Vous pouvez lui donner ou la paix ou la guerre.
L’une & l’autre aujourd’huy ne dépend que de vous.	L'une et l'autre aujourd'hui ne dépend que de vous.
Le Ciel entre vos mains met le bonheur de tous, Et de voſtre refus ou de voſtre hymenée Tout l’Univers tremblant attend ſa deſtinée.	Le Ciel entre vos mains met le bonheur de tous, Et de votre refus ou de votre hyménée Tout l'Univers tremblant attend sa destinée.
Que d’honneur cet hymen va traîner aprés ſoy!	Que d'honneur cet hymen va traîner après soi!
Un grand peuple à l’envy recevra voſtre loy.	Un grand peuple à l'envi recevra votre loi.
Et quel peuple Madame?	Et quel peuple Madame?
un peuple doux, affable, Intrepide par tout, & par tout redoutable.	un peuple doux, affable, Intrépide par tout, et par tout able.
L’exemple du plus ſage & du plus grand des Rois Fait autant de Heros que l’on voit de François.	L'exemple du plus sage et du plus grand des Rois Fait autant de Héros que l'on voit de Français.
C’eſt ce Roy, dont le nom remplit la terre & l’onde, A qui le Ciel promet la conqueſte du monde, Dont la gloire & les ans ont eu même progrés;	C'est ce Roi, dont le nom remplit la terre et l'onde, A qui le Ciel promet la conquête du monde, Dont la gloire et les ans ont eu même progrès;
Et qui comte par eux le nombre de ſes faits.	Et qui compte par eux le nombre de ses faits.
Tout l’Univers le craint, toute la France l’aime.	Tout l'Univers le craint, toute la France l'aime.
Tous ſes ſujets en luy ne cherchent que luy-même.	Tous ses sujets en lui ne cherchent que lui-même.
Il charmeégalement & les cœurs & les yeux.	Il charmeégalement et les cœurs et les yeux.
Tels Athenes & Rome ont peint leurs demydieux.	Tels Athènes et Rome ont peint leurs demydieux.
Leur douce Majeſté brille ſur ſon viſage, Il en a tous les traits, il en a le courage.	Leur douce Majesté brille sur son visage, Il en a tous les traits, il en a le courage.
Ce Roy ſi vertueux, ſi grand, ſi fortuné Madame, c’eſt l’époux qui vous eſt deſtiné.	Ce Roi si vertueux, si grand, si fortuné Madame, c'est l'époux qui vous est destiné.
LA DUCHESSE.	LA DUCHESSE.
Cette grande nouvelle a de quoy me ſurprendre, Prince, je m’eſtois peu prepar ée à l’entendre.	Cette grande nouvelle a de quoi me surprendre, Prince, je m'étais peu prépar ée à l'entendre.
Voſtre zele pour nous ne peut aller plus loin.	Votre zèle pour nous ne peut aller plus loin.
Je ſuis trop redevable à ce genereux ſoin.	Je suis trop redevable à ce généreux soin.
Mais comme cette affaire eſt de grande importance, Avant que de répondre il eſt bon qu’on y penſe.	Mais comme cette affaire est de grande importance, Avant que de répondre il est bon qu'on y pense.
Je vay ſur vos raiſons refléchir meurement, Et vous ſçaurez aprés quel eit mon fentiment.	Je vais sur vos raisons refléchir meurement, Et vous saurez après quel éit mon sentiment.
Elle ſort avec toute ſa ſuite.	Elle sort avec toute sa suite.
SCENE V.	SCÈNE V.
DDUO, ISADELLE, CHATEAUBRIANT.	DDUO, ISADELE, CHATEAUBRIANT.
ISABELLE.	ISABELLE.
Rince qu’avez-vous dit, & que viens-je T d’entendre?	Rince qu'avez-vous dit, et que viens-je T T'entendre?
Quel ſoin avez-vous pris, & qui vous l’a fait prendre ?	Quel soin avez-vous pris, et qui vous l'a fait prendre ?
Quel employ?	Quel emploi?
quel diſcours?	quel discours?
qu’en dois-je preſumer?	qu'en dois-je présumer?
Ce cœur qui l’aima tant ceſſe-t’il de l’aimer?	Ce cœur qui l'aima tant cesse-t-il de l'aimer?
LE DIC.	LE DIC.
Si je ne l’aime plus!	Si je ne l'aime plus!
Ah!	Ah!
mon ame enflamée Eſt de ſes chers appas plus que jamais charmée, Madame, cet employ qui cauſe mon retour Mieux que mes ſoins paſſez luy prouve mon amour.	mon âme enflamée Est de ses chers appas plus que jamais charmée, Madame, cet emploi qui cause mon retour Mieux que mes soins passez lui prouve mon amour.
Au courroux du vainqueur je la voyois en bute, Ses Etats menacez d’une infaillible chute:	Au courroux du vainqueur je la voyais en bute, Ses Etats menacés d'une infaillible chute:
J’ay dû ſacrifier mon intereſt au ſien, Acheter ſon repos par la perte du mien,	J'ai dû sacrifier mon intérêt au sien, Acheter son repos par la perte du mien,
Du Ciel ſur ſes Etats écarter les menaces Et la faire joüir du fruit de mes diſgraces.	Du Ciel sur ses États écarter les menaces Et la faire jouir du fruit de mes disgrâces.
Auprés d’elle pour moy qu’avois-je à menager?	Auprès d'elle pour moi qu'avais-je à ménager?
A Maximilian elle alloit s’engager.	A Maximilian elle allait s'engager.
Je le ſçavois.	Je le savais.
J’ay crû ma douleur moins cruelle Si la perdant, au moins je vivois auprés d’elle.	J'ai cru ma douleur moins cruelle Si la perdant, au moins je vivais auprès d'elle.
Heureux dans mes malheurs de voir qu’un ſi grand Roy, Si je tiens tout de luy tienne auſſi tout de moy.	Heureux dans mes malheurs de voir qu'un si grand Roi, Si je tiens tout de lui terre aussi tout de moi.
De l’honneur qu’il m’a fait je n’ay pû me défendre.	De l'honneur qu'il m'a fait je n'ai pu me défendre.
Juſques dans ma priſon il a daigné deſcendre.	Jusque dans ma prison il a daigné descendre.
Prince, a-t’il dit, d’un air charmant, plein de bonté, Je vous rends & vos biens & voſtre liberté, Je ne vous retiens plus.	Prince, a-t-il dit, d'un air charmant, plein de bonté, Je vous rends et vos biens et votre liberté, Je ne vous retiens plus.
Allez voir la Ducheſſe, Allez luy preſenter la paix & ma tendreſſe.	Allez voir la Duchesse, Allez Rome présenter la paix et ma tendresse.
Si je puis par vos ſoins devenir ſon époux, Vous ferez plus pour moy que je ne fais pour vous.	Si je puis par vos soins devenir son époux, Vous ferez plus pour moi que je ne fais pour vous.
Ces mots qui meritoient tout l’éclat de ma haine De ſa bouche ſortis ne m’ont déplû qu’à peine.	Ces mots qui méritaient tout l'éclat de ma haine De sa bouche sortis ne m'ont déplu qu'à peine.
Même en m’aſſaſſinant il a ſceu me flater, J’ay ſoûpiré tout bas ſans pouvoir m’irriter, Et loin qu’un fier dépit ait armé mon couraS’il eut plus exigé j’euſſe fait davantage.	Même en m'assassinant il a su me flatter, J'ai soupiré tout bas sans pouvoir m'irriter, Et loin qu'un fier dépit ait armé mon couraS’il eut plus exigé j'eusse fait davantage.
Sa douceur, ſon abord charme un cœur genereux, Laiſſe de ſes diſcours un ſouvenir heureux, Et de tant de chaleur cette idée eſt ſuivie, Que pour luy l’on eſt preſt à prodiguer ſa vie.	Sa douceur, son abord charme un cœur généreux, Laisse de ses discours un souvenir heureux, Et de tant de chaleur cette idée est suivie, Que pour lui l'on est prêt à prodiguer sa vie.
Mon ame à tant d’attraits n’a pû ſe refuſer.	Mon âme à tant d'attraits n'a pu se refuser.
Vous devriez me plaindre au lieu de m’accuſer.	Vous devriez me plaindre au lieu de m'accuser.
Le ſort n’en veut qu’à moy, c’eſt moy ſeul qu’il opprime.	Le sort n'en veut qu'à moi, c'est moi seul qu'il opprime.
J’apporte icy la paix, & j’en ſuis la victime.	J'apporte ici la paix, et j'en suis la victime.
J’adore voſtre ſœur.	J'adore votre sœur.
Mon employ, mon devoir, Tout enfin en ſecret me défend de la voir.	Mon emploi, mon devoir, Tout enfin en secret me défend de la voir.
Je la crains, je me crains.	Je la crains, je me crains.
Helas!	Hélas!
lors que l’on aime, Un cœur ne prent conſeil que de ſon amour même.	lors que l'on aime, Un cœur ne prent conseil que de son amour même.
Un terrible combat s’appréteroit pour moy, Et je pourrois trahir mon devoir & mon Roy.	Un terrible combat s'apprêterait pour moi, Et je pourrais trahir mon devoir et mon Roi.
Epargnez-moy, Madame, un combat ſi funeſte, Je ne fonde qu’en vous tout l’eſpoir qui me reſte.	Épargnez-moi, Madame, un combat si funeste, Je ne fonde qu'en vous tout l'espoir qui me reste.
vaus pouvez auouei la ligueur de mon fort, Je mets entre vos mains & ma vie & ma mort, Vous pouyez.	vaus pouvez avouei la ligueur de mon fort, Je mets entre vos mains et ma vie et ma mort, Vous pouïez.
ISABELLE.	ISABELLE.
Quoy?	Quoi?
parlez Prince?	parlez Prince?
Que puis-je faire?	Que puis-je faire?
En quoy puis je aujouid nuy yous eſtre neceſſaire?	En quoi puis je aujouid nui yous être nécessaire?
Ah ſi je le ſçavois!	Ah si je le savais!
prompte à vous ſecourir Au devant de vos vœux vous me verriez courir.	prompte à vous secourir Au devant de vos vœux vous me verriez courir.
LE DUC.	LE DUC.
Puiſque dans mes malheurs voſtre cœur s’intereſſe, Pour les diminuer parlez à la Princeſſe, Pour me juſtifier, Madame, dites luy Et quel eſt mon amour, & quel eſt mon ennuy, Que pour ſes intereſts je cours à ma ruine, Que pour elle j’ay pris un ſoin qui m’aſſaſſine.	Puisque dans mes malheurs votre cœur s'intéresse, Pour les diminuer parlez à la Princesse, Pour me justifier, Madame, dites auAit quel est mon amour, et quel est mon ennui, Que pour ses intérêts je cours à ma ruine, Que pour elle j'ai pris un soin qui m'assassine.
Peignez luy les combats que mon cœur a rendus, Les pleurs que je répenis, ceux que j’ay lefene dus.	Peignez Seigneur les combats que mon cœur a rendus, Les pleurs que je répenis, ceux que j'ai lefene dus.
Dites luy qu’à ma perte obligé de ſouſcrire, Je luy viens à regret preſenter un Empire, Que mes pleurs & ma vie auront un même cours, Que je l’aime, & qu’enfin je l’aimeray toûjours.	Dites -moi qu'à ma perte obligé de souscrire, Je vou liens à regret présenter un Empire, Que mes pleurs et ma vie auront un même cours, Que je l'aime, et qu'enfin je l'aimerai toujours.
ISAAELLE.	ISAELLE.
Moy, que j’aille à ma ſœur porter cette nouvelle!	Moi, que j'aille à ma sœur porter cette nouvelle!
Luy dire que toû jours vous ſoûpirez pour elle!	Lui dire que tou jours vous soupirez pour elle!
D’un amour trop fatal reſſerrer le lien!	D'un amour trop fatal resserrer le lien!
Moy-même contre moy.	Moi-même contre moi.
Non, je n’en feray rien Prince.	Non, je n'en ferai rien Prince.
J’aime ma ſœur, ſi vous l’aimez encore Son repos & le mien veulent qu’elle l’ignore.	J'aime ma sœur, si vous l'aimez encore Son repos et le mien veulent qu'elle l'ignore.
J’irois luy découvrir vos ſentimens ſecrets, Pour l’enhardir peut-eſtre à refuſer la paix?	J'irais autre découvrir vos sentiments secrets, Pour l'enhardir peut-être à refuser la paix?
Lors que pour ſes Etats le deſtin ſe declare, Moy-même détourner les biens qu’il leur prepare ?	Lors que pour ses États le destin se déclare, Moi-même détourner les biens qu'il leur prépare ?
Et la Bretagne un jour pourroit me reprocher D’avoir cauſé ſa perte au lieu de l’empeſcher?	Et la Bretagne un jour pourrait me reprocher D'avoir causé sa perte au lieu de l'empêcher?
Ah!	Ah!
vous penetrez mal dans le fond de mon ame Si vous me croyez propre à ſervir voſtre flame.	vous pénétrerez mal dans le fond de mon âme Si vous me croyez propre à servir votre flamme.
Pour voir remplir vos vœux, chargez moy d’un employ Plus heureux pour ma ſœur, moins funeſte pour moy.	Pour voir remplir vos vœux, chargez moi d'un emploi Plus heureux pour ma sœur, moins funeste pour moi.
Noſtre intereſt combat voſtre injuſte priere.	Notre intérêt combat votre injuste prière.
N’exigez pas de moy plus que je ne puis faire.	N'exigez pas de moi plus que je ne puis faire.
LE DUC.	LE DUC.
De mon ſort, je le voy, la longue inimitié, Madame, me ravit juſqu’à voſtre pitié.	De mon sort, je le vois, la longue inimitié, Madame, me ravit jusqu'à votre pitié.
Il veut par ce malheur aigrir mon infortune.	Il veut par ce malheur aigrir mon infortune.
Je ne vous feray plus de priere importune.	Je ne vous ferai plus de prière importune.
Je vay, ſans accuſer ce ſilence inhumain, Pour me juſtifier prendre un autre chemin.	Je vais, sans accuser ce silence inhumain, Pour me justifier prendre un autre chemin.
D ij	D ij
SCENE VI.	SCÈNE VI.
ISADELLE, CHATEAUDRIANT.	ISADELE, CHATEAUDRIANT.
ISABELLE.	ISABELLE.
S-tu vû le cruel?	Stu vu le cruel?
a-t’il daigné connaiſtre AI L’amour infortuné que j’ay trop fait paraître?	a-t-il daigné connaître AI L'amour infortuné que j'ai trop fait paraître?
Mes ſoûpirs, mes regards, mon trouble, ma langueur, Ma bouche mille fois preſte à trahir mon cœur, Ce cœur par tant d’endroits cherchant à ſe répendre, Tout parloit de mes feux s’il eut voulut l’entendre.	Mes soupirs, mes regards, mon trouble, ma langueur, Ma bouche mille fois prête à trahir mon cœur, Ce cœur par tant d'endroits cherchant à se répendre, Tout parlait de mes feux s'il eut voulut l'entendre.
Hé n’aurois-tu pas crû, ſeduite comme moy, Qu’il m’alloit preſentet l’hommage de ſa foy, Que pour faire une paix plus longue & plus certaine Ses vœux s’alloient tourner vers la ſœur de ſa Reine.	Hé n'aurais-tu pas cru, séduite comme moi, Qu'il m'allait presentet l'hommage de sa foi, Que pour faire une paix plus longue et plus certaine Ses vœux s'allaient tourner vers la sœur de sa Reine.
Douce erreur, qu’un moment a fait évanoüir, Il m’a même envié le bonheur d’en joüir.	Douce erreur, qu'un moment a fait évanouir, Il m'a même envié le bonheur d'en jouir.
Il a parlé l’ingrat, & ſa bouche cruelle M’a renduë aux tranſports de ma douleur morcene .	Il a parlé l'ingrat, et sa bouche cruelle M'a rendue aux transports de ma douleur morcène .
L’eſpoir precipité que j’en avois conceu A redoublé l’ardeur de mon amour deceuC’en eſt fait, vangeons nous.	L'espoir précipité que j'en avais conçu A redoublé l'ardeur de mon amour deceuC’en est fait, vengeons nous.
Mais quelle eſt ſos offence?	Mais quelle est sos offense?
Il aime la Princeſſe avec trop de conſtance, Eſt-ce un crime?	Il aime la Princesse avec trop de constance, Est-ce un crime?
oüy ſes feux outragent trop les miens, Il fait tous mes malheurs, je veux faire les ſiens, Tla verter une hame à la mienne contraire, Et le punir enfin d’avoir trop ſceu me plaire.	oui ses feux outragent trop les miens, Il fait tous mes malheurs, je veux faire les siens, Tla verter une hame à la mienne contraire, Et le punir enfin d'avoir trop su me plaire.
CHATEAUBRIANT.	CHATEAUBRIANT.
Le chemin eſt ouvert à ce reſſentiment, Broûillez, vous dis-je encor, l’amante avec l’amant.	Le chemin est ouvert à ce ressentiment, Brouillez, vous dis-je encor, l'amante avec l'amant.
Mais ſur tout haſtez-vous:	Mais sur tout hâtez-vous:
le Duc toûjours fidelle Pourroit voir voſtre ſœur, s’éclaircir avec elle.	le Duc toûjours fidelle Pourroit voir le Du, éclaircir avec elle.
Cet éclairciſſement pourroit les réünir, Il vous perdroit, Madame, il faut le prevenir.	Cet éclaircissement pourrait les réunir, Il vous perdrait, Madame, il faut le prévenir.
Ne vous alarmez point d’un crime ima ginaiIl ceſſe d’eſtre tel quand l’amour le ſuggere, On excuſe aiſement quiconque l’a commis, Les crimes amoureux ſont des crimes permis.	Ne vous alarmez point d'un crime ima ginaiIl cesse d'être tel quand l'amour le sugère, On excuse aisément quiconque l'a commis, Les crimes amoureux sont des crimes permis.
ISABELLE.	ISABELLE.
Mais dy moy, n’eſt-ce pas montrer trop de foibleſſe?	Mais dis -moi, n'est-ce pas montrer trop de faiblesse?
A cette trahiſon veux-tu que je m’abaiſſe?	À cette trahison veux-tu que je m'abaisse?
Quand même à tous les yeux je pourrois la cacher, Ne me la dois-je pas ſans ceſſe reprocher?	Quand même à tous les yeux je pourrais la cacher, Ne me la dois-je pas sans cesse reprocher?
Le Ciel, Ie juite Cier ne lert point l’injuitice.	Le Ciel, Je juite Cier ne lert point l'injuitice.
Quel fruit dois-je eſperer d’un ſi lâche artifice?	Quel fruit dois-je espérer d'un si lâche artifice?
Je crains de n’en avoir que la vaine douceur D’inquieter le Prince, & de nuire à ma ſœur	Je crains de n'en avoir que la vaine douceur D'inquiéter le Prince, et de nuire à ma sœur
CHATEAUBRIANT.	CHATEAUBRIANT.
De nuire à voſtre ſœur!	De nuire à votre sœur!
Ah!	Ah!
c’eſt plûroſt, Mas dame La tirer de l’abyſme ou l’a jette ſa flame.	c'est plûrost, Mas dame La tirer de l'abîme ou l'a jette sa flamme.
D iij Quelle infortune, ô Ciel!	 Dij Quelle infortune, ô Ciel!
& pour elle & pour nous, S’il faut qu’elle refuſe un vainqueur pour époux.	et pour elle et pour nous, S'il faut qu'elle refuse un vainqueur pour époux.
Détournons les malheurs ou la Bretagne touche.	Détournons les malheurs ou la Bretagne touche.
Tout l’état deſolé vous parle par ma bouche.	Tout l'état désolé vous parle par ma bouche.
Car enfin, on le voit, elle aime tendrement, L’éclat d’un ſceptre offert la tante vainement.	Car enfin, on le voit, elle aime tendrement, L'éclat d'un sceptre offert la tante vainement.
L’ambition eſt foible ou l’amour eſt ſi forte, Sur l’ardeur de regner une autre ardeur l’emporte, Et le trône qui flate un eſprit detaché, Ne touche point un cœur que l’amour a touché.	L'ambition est faible ou l'amour est si forte, Sur l'ardeur de régner une autre ardeur l'emporte, Et le trône qui flatte un esprit détaché, Ne touche point un cœur que l'amour a touché.
Ainſi n’eſperez pas que le ſien ſe demente Par dépit à l’hymen il faut qu’elle conſente.	Ainsi n'espérez pas que le sien se démente Par dépit à l'hymen il faut qu'elle consente.
Son courroux ſera plus que toute ſa raiſon, Elle devra le trône à voſtre trahiſon.	Son courroux sera plus que toute sa raison, Elle devra le trône à votre trahison.
Le Prince alors privé d’un reſte d’eſperance Ne ſe piquera plus d’une vaine conſtance, D’un œil moins prevenu verra tous vos appas, A ſe donner à vous ne barancera pas, Et s’ouvrant aux douceurs d’une flame nouvelI Il ſentira pour vous ce qu’il ſentoit pour elle.	Le Prince alors privé d'un reste d'espérance Ne se piquera plus d'une vaine constance, D'un œil moins prévenu verra tous vos appas, À se donner à vous ne barancera pas, Et s'ouvrant aux douceurs d'une flamme nouvelI Il sentira pour vous ce qu'il sentait pour elle.
ISABELLE.	ISABELLE.
mais comment, & par ou peut-on executer Ce que pour mon repos tu viens de projetter?	mais comment, et par ou peut-on exécuter Ce que pour mon repos tu viens de projetter?
Faut il du temps, des ſoins, ay-je beaucoup à craindre?	Faut -il du temps, des soins, ai-je beaucoup à craindre?
Que faut-il faire enfin, parle?	Que faut-il faire enfin, parle?
CHATEAUBRIANT.	CHATEAUBRIANT.
Il ne faut que feindre.	Il ne faut que feindre.
Faites venir le Prince en voſtre appartement, Montrez à le ſervir un tendre empreſſement, Et pour le retenir feignez avec adreſſe De vouloir l’excuſer auprés de la Princeſſe:	Faites venir le Prince en votre appartement, Montrez à le servir un tendre empressement, Et pour le retenir feignez avec adresse De vouloir l'excuser auprès de la Princesse:
C’eſt tout Repoſez-vous du reſte ſur mes ſoins, Pour un ſi grand bonheur pouvez-vous faire moins?	C'est tout Reposez-vous du reste sur mes soins, Pour un si grand bonheur pouvez-vous faire moins?
SABELLE.	SABELLE.
Hé bien, à tes avis je me laiſſe conduire, De tes deſſeins pour moy je ne veux point m’inſtruire, De mon cruel deſtin il faut ſubir la loy, Fais ce que tu voudras, je me livre à ta foy.	Hé bien, à tes avis je me laisse conduire, De tes desseins pour moi je ne veux point m'instruire, De mon cruel destin il faut subir la loi, Fais ce que tu voudras, je me livre à ta foi.
Fin du troiſiéme Acte.	Fin du troisième Acte.
RCTET	RCTET
SCENE I.	SCÈNE I.
LiT DUCHESSE, LE MARE'CHAL DALBRET.	LiT DUCHESSE, LE MARE'CHAL DALBRET.
LA DUCHESSE.	LA DUCHESSE.
Ui l’eut dit, Maréchal, que le Duc infidelle Eteindroit une ardeur qu’on croyoit immortelle?	Oui l'eut dit, Maréchal, que le Duc infidèle Éteindrait une ardeur qu'on croyait immortelle?
Quel le vis je autrefois, quel viens-je de le voir, Un ſi grand changement ſe peut-il concevoir?	Quel le vis je autrefois, quel viens-je de le voir, Un si grand changement se peut-il concevoir?
Aprés les maux ſi longs, ſi pleins de violenQu'ont coûtez à mon cœur ſa priſon, ſon abſence, Ouand le Ciel à mes vœux accorde ſon retour, Devois-je bien m’attendre à le voir ſans amour?	Après les maux si longs, si pleins de violenglu'ont côtés à mon cœur sa prison, son absence, Ouand le Ciel à mes vœux accorde son retour, Devais-je bien m'attendre à le voir sans amour?
Eſt-ce donc là le prix des comouts de mon ame?	Est-ce donc là le prix des comouts de mon âme?
Du refus de deux Rois immolez à ſa flame?	Du refus de deux Rois immolés à sa flamme?
Aprés tant de ſoûpirs, tant de pleurs, tant d’ennuy.	Après tant de soupirs, tant de pleurs, tant d'ennui.
Meritoit il l’ingrat ce qu’on a fait pour luy?	Méritait -il l'ingrat ce qu'on a fait pour cet?
LE M.	LE M.
D’ALBRET.	D'ALBRET.
Ma ſurpriſe, Madame, à la voſtre eſt égale.	Ma surprise, Madame, à la vôtre est égale.
Je plains une tendreſſe à vous, à moy fatale.	Je plains une tendresse à vous, à moi fatale.
De voſtre amour pour luy tantoſt inſtruit par vous, Des plus vives douleurs j’ay ſenty tous les coups, Plus touché de vos maux que de mon infortune J’évitois, je fuyois une pompe importune, J’allois loin de vos yeux me plaindre en liberté.	De votre amour pour lui tantôt instruit par vous, Des plus vives douleurs j'ai senti tous les coups, Plus touché de vos maux que de mon infortune J'évitais, je fuyais une pompe importune, J'allais loin de vos yeux me plaindre en liberté.
Lors qu’aux miens prés d’icy le Duc s’eſt preſenté.	Lors qu'aux miens prés d'ici le Duc s'est présenté.
Quelques chagrins qu’encor me promit ſa preſence, Rien n’a pû s’oppoſer à mon impatience.	Quelques chagrins qu'encor me promit sa présence, Rien n'a pu s'opposer à mon impatience.
Malgré tout mon amour, fidelle à mon devoir, J’ay couru preparer voſtre cœur à le voir.	Malgré tout mon amour, fidèle à mon devoir, J'ai couru préparer votre cœur à le voir.
Je ne prevoyois pas aveugle dans mon zele, Que tant d’ennuy dûſt ſuivre une heureuſe nouvelle, Qu’au gré de vos deſirs dans ce Palais conduit, De ſon retour luy-mêtne il vous ôta le fruit, Rappellant auſſi-toſt ma tendreſſe paſſée, Une maligne joye en mon cœur s’eſt gliſſée.	Je ne prévois pas aveugle dans mon zèle, Que tant d'ennui dût suivre une heureuse nouvelle, Qu'au gré de vos désirs dans ce Palais conduit, De son retour lui-mêtne il vous ôta le fruit, Rappelant aussitôt ma tendresse passée, Une maligne joie en mon cœur s'est glissée.
Pardonnez-la, Madame, aux malheurs d’un amant, Mais ce triſte plaiſir n’a duré qu’un moment.	Pardonnez-la, Madame, aux malheurs d'un amant, Mais ce triste plaisir n'a duré qu'un moment.
Voſtre trouble d’abord l’a bien fait diſparaiſtre, L’amour a fait mourir ce qu’il avoit fait naiſtre, Et mon cœur tous entier s’ouvrant à vos douleurs N’a pû goûter un bien qui vous coûtoit des pleurs.	Votre trouble d'abord l'a bien fait disparaître, L'amour a fait mourir ce qu'il avait fait naître, Et mon cœur tous entier s'ouvrant à vos douleurs N'a pu goûter un bien qui vous coûtait des pleurs.
LA DUCHESSE.	LA DUCHESSE.
Hé dites moy, quelle ame à ſe vaincre occupée D’un coup ſi ſurprenant n’eut pas eſté frapée?	Hé dites -moi, quelle âme à se vaincre occupée D'un coup si surprenant n'eut pas été frappée?
Croyois-te qu’il me dûſt trahir avec éclat?	Crois-te qu'il me dût trahir avec éclat?
Que mes bontez pour luy ne feroient qu’un ingrat, Que demantant enfin tant de vertus ſinceres, Il ſuivroit les erreurs des amans ordinaires?	Que mes bontés pour venir ne feraient qu'un ingrat, Que devant enfin tant de vertus sincères, Il suivrait les erreurs des amants ordinaires?
Je penſois qu’un Heros fidelle dans ſon choix, Aimoit juſqu’à la mort s’il aimoit une fois.	Je pensais qu'un Héros fidèle dans son choix, Aimait jusqu'à la mort s'il aimait une fois.
Mais helas !	Mais hélas !
en amour ces cœurs crus magnanimes Des pius ſmples mortels adoptent les maximes, Dans un oubly honteux ils cherchent leur repos, Et dés qu’ils ſont amans ils ne ſonit prus Heros.	en amour ces cœurs crus magnanimes Des pius simples mortels adoptent les maximes, Dans un oubli honteux ils cherchent leur repos, Et dès qu'ils sont amants ils ne sonit présus Héros.
LE M.	LE M.
D’ALBRET.	D'ALBRET.
Mais ſi toûjours pour vous même ardeur le devore?	Mais si toujours pour vous -même ardeur le dévore?
LA DUCHESSE.	LA DUCHESSE.
Hé de ſon changement puis-je douter encore?	Hé de son changement puis-je douter encore?
LE M.	LE M.
D’ALBRET.	D'ALBRET.
Quoy que vous en croyiez, c’eſt un coup bien fatal Madame, de trouver ſon Roy dans ſon rival.	Quoi que vous en croyiez, c'est un coup bien fatal Madame, de trouver son Roi dans son rival.
Sans craindre de paſſer ou pour lâche, ou pour traiſtre, Un ſujet peut ceder ſa maiſtreſſe à ſon maiſtre.	Sans craindre de passer ou pour lâche, ou pour traître, Un sujet peut céder sa maîtresse à son maître.
En commettant le crime on eſt juſtifié, On brûle d’un amour qu’on a ſacrifié, Et ſans qu’il ſoit beſoin d’un plus rude ſupplice, On n’eſt que trop puny par un tel ſacrifice.	En commettant le crime on est justifié, On brûle d'un amour qu'on a sacrifié, Et sans qu'il soit besoin d'un plus rude supplice, On n'est que trop puni par un tel sacrifice.
Le Duc peut eſtre éprouve un ſort ſi rigoureux, Il ſemble ingrat, peut-eſtre il n’eſt que malheureux.	Le Duc peut être éprouve un sort si rigoureux, Il semble ingrat, peut-être il n'est que malheureux.
Gien loin que contre luy mon amour vous aigriſſe, bu iu le contraint à luy rendre juſtice.	Gien loin que contre Rome mon amour vous aigrisse, bu ju le contraint à vertu rendre justice.
Mais faites-le parler.	Mais faites-le parler.
LA DUCHESSE.	LA DUCHESSE.
Je m'en garderay bien, Puis qu’il fait ſon devoir je veux faire le mien.	Je m'en garderai bien, Puis qu'il fait son devoir je veux faire le mien.
Aprés l’affront mortel que m’a fait l’infidelle, J’irois m’en attirer une injure nouvelle, Si l’amour juſques-là me ravaloit pour luy, Mon rang contre l’amour me ſerviroit d’appuy.	Après l'affront mortel que m'a fait l'infidèle, J'irais m'en attirer une injure nouvelle, Si l'amour jusques-là me ravalait pour venir, Mon rang contre l'amour me servirait d'appui.
Je veux le fuir, je veux éviter ſes approches, Ne le pas honorer même de mes reproches, Montrer qu’ainſi que luy je ſçay me ſurmonter, Et qu’on dompte l’amour quand on veut le dompter.	Je veux le fuir, je veux éviter ses approches, Ne le pas honorer même de mes reproches, Montrer qu'ainsi que luians sais me surmonter, Et qu'on dompte l'amour quand on veut le dompter.
LE M.	LE M.
D’ALBRET.	D'ALBRET.
Hé bien puis qu’on ne peut fléchir voſtre courage, Il faut pour vous ſervir mettre tout en uſage.	Hé bien puis qu'on ne peut fléchir votre courage, Il faut pour vous servir mettre tout en usage.
Tantoſt, je m’en ſouviens, vous m’avez reproché Les maux, dont pour le Duc voſtre cœur eſt touché.	Tantôt, je m'en souviens, vous m'avez reproché Les maux, dont pour le Duc quelque cœur est touché.
Je vay, ne conſultant que l’ardeur qui m’anime Vous rendre le repos, & reparer mon crime.	Je vais, ne consultant que l'ardeur qui m'anime Vous rendre le repos, et réparer mon crime.
SCENE II.	SCÈNE II.
LA DUCHESSE, CHATEAUBRIANT.	LA DUCHESSE, CHATEAUBRIANT.
LA DUCHESSE.	LA DUCHESSE.
Cedieem Quoy poune d’un depit amoureux, Veut-il contre le Prince.	Cédiem Quoi poune d'un dépit amoureux, Veut-il contre le Prince.
CHATEAUBRIANT.	CHATEAUBRIANT.
Il eſt trop genereux, Et ſçait trop reſpecter la douleur d’une amante.	Il est trop généreux, Et sais trop respecter la douleur d'une amante.
Mais qui fait naiſtre en vous cette crainte obligcante, Madame?	Mais qui fait naître en vous cette crainte obligcante, Madame?
l’on n’eſt pas ſi prompte à s’alarmer Pour un Prince qu’on fuit, qu’on ne veut plus aimer.	l'on n'est pas si prompte à s'alarmer Pour un Prince qu'on fuit, qu'on ne veut plus aimer.
LA DUCHHESSE.	LA DUCHHÉSSE.
Ah!	Ah!
que ne puis-je icy te cacher ma foibleſſe.	que ne puis-je ici te cacher ma faiblesse.
Tout coupable qu’il eſt, pour luy je m’intereſſe, Ma gloire, mon dépit, ne font qu’un vain effort, Malgré moy mon amour eſt toûjours le plus fort.	Tout coupable qu'il est, pour venir je m'intéresse, Ma gloire, mon dépit, ne font qu'un vain effort, Malgré moi mon amour est toujours le plus fort.
Par cent chemins ouverts il entre dans mon ame, Latrouve toute preſte a recevoir ſa flame, Tous mes ſens ſoûlevez luy preſtent leur appuy, Et mon cœur par des vœux vole au devant de luy.	Par cent chemins ouverts il entre dans mon âme, Latrouve toute prête a recevoir sa flamme, Tous mes sens soulevez Seigneur prêtent leur appui, Et mon cœur par des vœux vole au devant de force.
Ah!	Ah!
devois je t’aimer Prince ingrat & parjure?	devais -je t'aimer Prince ingrat et parjure?
Mais pouvois-je prévoir les peines que j’endure?	Mais pouvais-je prévoir les peines que j'endure?
Je ne voyois en luy qu’un Prince genereux.	Je ne voyais en peine qu'un Prince généreux.
13 Jeune, vaillant, aimable, & ſur tout amoureux.	13 Jeune, vaillant, aimable, et sur tout amoureux.
S’il eut joint à ces noms le nom d’amant fidelle Aurois-je du rougir d’une flame ſi belle?	S'il eut joint à ces noms le nom d'amant fidèle Aurais-je du rougir d'une flamme si belle?
CHATEAUBRIANT.	CHATEAUBRIANT.
Que vouliez-vous que fit ce Prince infortuné?	Que vouliez-vous que fit ce Prince infortuné?
Captif, chargé de fers, de tous abandonné, Coupable envers ſon maiſtre, en proye à ſa colere, Pour rompre ſes liens que pouvoit-il moins faire?	Captif, chargé de fers, de tous abandonné, Coupable envers son maître, en proie à sa colère, Pour rompre ses liens que pouvait-il moins faire?
Peut-eſtre des raiſons qu’il derobe à nos yeux Plus que tout ce qu’on croit l’ont conduit en ces lieux.	Peut-être des raisons qu'il derobe à nos yeux Plus que tout ce qu'on croit l'ont conduit en ces lieux.
Que ſçait-on, quelqueiois l'amant le plas fidelle.	Que pourrait-on, quelqueiais l'amant le plas fidèle.
De ces raiſons peut-eſtre il inſtruit Iſabelle, Il doit luy decouvrir les ſecrets de mon cœur.	De ces raisons peut-être il instruit Isabelle, Il doit lui découvrir les secrets de mon cœur.
LA DUCHESSE.	LA DUCHESSE.
Que dis-tu?	Que dis-tu?
Quoy le Prince eſt-f'avec me ſœur?	Quoi le Prince est-s'avec me sœur?
CHATEAUBRIANT.	CHATEAUBRIANT.
quie dne neuſe & plus, Madame, ils ſont enſemble.	quie dne neuse et plus, Madame, ils sont ensemble.
LA DUCHESSE.	LA DUCHESSE.
Qu’entens-je!	Qu'entends-je?
mais dy moy qu’eſt ce qui les aſſemble?	mais dis -moi qu'est ce qui les assemble?
CHATEAUBRIANT.	CHATEAUBRIANT.
Hé quoy leur entreveuë eſt ce dil fecret pour vous?	Hé quoi leur entrevue est -ce dil secret pour vous?
J’ay crû que par voſtre ordie ils parloient loin de nous.	J'ai cru que par votre ordie ils parlaient loin de nous.
A peine de ces lieux eſtiez-vous écartée, Qu'Iſabelle avec luy s’eſt long-temps arreſtée.	À peine de ces lieux étiez-vous écartée, Qu'Isabelle avec notre s'est longtemps arrêtée.
Enſuite elle eſt ſortie, & pour l’entretenir, Dans ſon appartement elle la fait venir.	Ensuite elle est sortie, et pour l'entretenir, Dans son appartement elle la fait venir.
Il y vole.	Il y vole.
Chacun par reſpect ſe retire.	Chacun par respect se retire.
1 Ils parlent.	1 Ils parlent.
On ne ſçait ce qu’ils ont à ſe dire;	On ne sait ce qu'ils ont à se dire;
Mais on connoiſt aſſez, quoy qu’on n’entende Hen, Qu’un intereſt ſecret échauffe l’entretien.	Mais on connaît assez, quoi qu'on n'entende Hen, Qu'un intérêt secret échauffe l'entretien.
LA DUCHESSE.	LA DUCHESSE.
Dans quels cruels ſoupçons me jette ce langage?	Dans quels cruels soupçons me jette ce langage?
Le Duc cherche ma ſœur à l’inſtant qu’il m’outrage, En ſecret, ſans témoin ils parlent ſi long-temps, Ils paroiſſent, dis-tu, l’un de l’autre contens.	Le Duc cherche ma sœur à l'instant qu'il m'outrage, En secret, sans témoin ils parlent si longtemps, Ils paraissent, dis-tu, l'un de l'autre contents.
Ils s’aiment.	Ils s'aiment.
Ah!	Ah!
voilà ce qu’ils ont à ſe dire.	voilà ce qu'ils ont à se dire.
Des vœux d’un infidelle elle m'ôte l’empire.	Des vœux d'un infidèle elle m'ôte l'empire.
Trop aveugle, ay-je pû tarder juſqu’aujourd’huy A connoiſtre l’amour qu’Iſabelle a pour luy?	Trop aveugle, ai-je pu tarder jusqu'aujourd'hui A connaître l'amour qu'Isabelle a pour mieux?
Cette fauſſe langueur, témoin de ſa conſtance, Indubitable effet des ennuis de l’abſence, Ces pleurs, ce peu de ſoin de ſes triſtes attraits, Son trouble quand le Prince approchoit du Palais, Ses diſcours ambigus, ſon deſordre, ſa fuite, Tout de ſes feux ſecrets devoit m’avoir inſtruite.	Cette fausse langueur, Soin de sa constance, Indubitable effet des ennuis de l'absence, Ces pleurs, ce peu de soin de ses tristes attraits, Son trouble quand le Prince approchait du Palais, Ses discours ambigus, son désordre, sa fuite, Tout de ses feux secrets devait m'avoir instruite.
vains!	vains!
Ciel ſeroit-il poſſible.	Ciel serait-il possible.
Ah mes doutes ſont J’ay de leur trahiſon des ſignes trop certains.	Ah mes doutes sont J'ai de leur trahison des signes trop certains.
Ils me feront raiſon de cette perfidie.	Ils me feront raison de cette perfidie.
Non, ils ne m’auront pas impunement trahie.	Non, ils ne m'auront pas impunément trahie.
Je vangeray ſur eux l’affront que je reçoy, Cette ardeur leur ſera plus funeſte qu’à moy.	Je vengerai sur eux l'affront que je reçois, Cette ardeur leur sera plus funeste qu'à moi.
Je ſuis amante & femme, & je vais eſtre Reines Ils verront à quel point l’amour porte la haine, Et qu’on n’a rien à craindre, & rien à menager, Quand on a ſa tendreſſe & ſa gloire à vanger.	Je suis amante et femme, et je vais être Reines Ils verront à quel point l'amour porte la haine, Et qu'on n'a rien à craindre, et rien à ménager, Quand on a sa tendresse et sa gloire à venger.
SCENE III.	SCÈNE III.
LA DUCHESSE LE MARE'ORAD DHEDRET, CHATEAUBRIANT.	LA DUCHESSE LE MARE'ORAD DHÉDRET, CHATEAUBRIANT.
LE M.	LE M.
D’ALBRET.	D'ALBRET.
Adame, en vous quittant trop plein de M vos alarmes, Meditant un effort qui peut tarir vos larmes, Toûjours pour vous en vain ardent à m’immoler, J’allois chercher le Duc pour le faire parler, Et tirant de ſon cœur le ſecret veritable, Vous épargner l’ennuy de le croire coupable.	Adame, en vous quittant trop plein de M vos alarmes, Méditant un effort qui peut tarir vos larmes, Toujours pour vous en vain dent à m'immoler, J'allais chercher le Duc pour le faire parler, Et toujours de son cœur le secret véritable, Vous épargner l'ennui de le croire coupable.
L’ayant cherché par tout ſans l’avoir rencontré, Chez la Princeſſe enfin j’apprens qu’il eſt entré, y cours.	L'ayant cherché par tout sans l'avoir rencontré, Chez la Princesse enfin j'apprends qu'il est entré, y cours.
Je l’apperçoy parlant ſeul avec elle, La peur de les troubler a retenu mon zelle.	Je l'aperçois parlant seul avec elle, La peur de les troubler a retenu mon zèle.
J’attendois un moment propre à m’en approcher, Quand tous deux vers ces lieux je les ay vû marcher.	J'attendais un moment propre à m'en approcher, Quand tous deux vers ces lieux je les ai vu marcher.
Ferez-vous.	Ferez-vous.
LA DUCHESSE.	LA DUCHESSE.
Il ſuffit.	Il suffit.
Je ſçay ce qu’il faut faire;	Je sais ce qu'il faut faire;
Ma ſœur vient.	Ma sœur vient.
Demeurez, vous m’eſtes neceſfaire.	Demeurez, vous m'êtes nécessaire.
SCENE IV.	SCÈNE IV.
LA DUCHESSE, ISABELIE, LE MARE'CHAL D’ALBRET, CHATEAUBRIANT.	LA DUCHESSE, ISABELIE, LE MARE'CHAL D'ALBRET, CHATEAUBRIANT.
ISABELLE.	ISABELLE.
Adame, j’ay laiſſé le Duc prés de ces M lieux, Il n’oſe entrer, il craint de paroiſtre à vos yeux.	Adame, j'ai laissé le Duc près de ces M lieux, Il n'ose entrer, il craint de paraître à vos yeux.
Inquiet, & chargé d’un ſecret qui vous touche, pour vous en Informer il emprunte ma bouche.	Inquiet, et chargé d'un secret qui vous touche, pour vous en Informer il emprunte ma bouche.
Il voudroit.	Il voudrait.
LA DUCHESSE.	LA DUCHESSE.
C’eſt aſſez, ma ſœur je vbus entens.	C'est assez, ma sœur je vbus entends.
Faites venir le Duc.	Faites venir le Duc.
Ne perdons point de temps.	Ne perdons point de temps.
Je ſçay ce que pour luy voſtre cœur vous inſpire, Je m’en figure plus que vous n’en pourriez dire.	Je sais ce que pour lui votre cœur vous inspire, Je m'en figure plus que vous n'en pourriez dire.
SCENE V.	SCÈNE V.
LA DUCHESSE, LE DUC, ISABELLE, LE MARE'CHAL D’ALBRET, CHATEAUBRIANT.	LA DUCHESSE, LE DUC, ISABELLE, LE MARECHAL MAREALBRET, CHATEAUBRIANT.
LA DUCHESSE.	LA DUCHESSE.
JRince approchez.	JRince approchez.
Je viens de penſer au grand 1 choix Que m’explique par vous le plus puiſſant des Rois.	Je viens de penser au grand 1 choix Que m'explique par vous le plus puissant des Rois.
J’ay vû combien d’honneurs ſuivroient cet hymenée, Quelle foule de biens y doit eſtre enchainée.	J'ai vu combien d'honneurs suivraient cet hyménée, Quelle foule de biens y doit être enchaînée.
y ſouſcris.	y souscris.
J’ay regret d’avoir mis un moment Entre l’offre du Prince & mon conſentement.	J'ai regret d'avoir mis un moment Entre l'offre du Prince et mon consentement.
D’un choix ſi glorieux mon ame ſatisfaite Va luy faire annoncer un aveu qu’il ſouhaite, Albret, je vous deſtine à cet illuſtre employ.	D'un choix si glorieux mon âme satisfaite Vaires faire annoncer un aveu qu'il souhaite, Albret, je vous destine à cet illustre emploi.
Redoublez aujourd’huy voſtre zele pour moy, Que rien ne vous arreſte, allez en diligence L’aſſurer d’une aveugle & prompte obeïſſance, Luy diie qu’avec joye on accepte la paix, Et que ma gratitude égale ſes bien-faits Partez.	Redoublez aujourd'hui votre zèle pour moi, Que rien ne vous arrête, allez en diligence L'assurer d'une aveugle et prompte obéissance, Lui diie qu'avec joie on accepte la paix, Et que ma gratitude égale ses bien-faits Partez.
à Chateaubriant.	à Châteaubriant.
Toy va chercher mes Miniſtres fidelles, Je leur veux en ſecret apprendre ces nouvelles.	Toi va chercher mes Ministres fidèles, Je leur veux en secret apprendre ces nouvelles.
Vous Duc, dans un moment venez au nom du Roy neebeven a P'hdtere ma mam & ma foy.	Vous Duc, dans un moment venez au nom du Roi neebeven a P'hdtère ma mam et ma foi.
SCENE VI.	SCÈNE VI.
LE DUC, ISABELLE,	LE DUC, ISABELLE,
ISABELLE.	ISABELLE.
E voy l’étonnement ou ce diſcours vous jette, JPrince, j’en ay pour vous une douleur ſecrette.	E vois l'étonnement ou ce discours vous jette, JPrince, j'en ai pour vous une douleur secrète.
Que n’avez-vous pâ voir, avec quelle chaleur J’allois juſtifier voſtre conſtante ardeur?	Que n'avez-vous pâ voir, avec quelle chaleur J'allais justifier votre constante ardeur?
J’allois parler pour vous Ma ſœur impatiente Duno imu bouenc acoupe ma parolſe naiſſante.	J'allais parler pour vous Ma sœur impatiente Duno imu bouenc acoupe ma parole naissante.
Contre vous, contre moy trop prompte à s’irriter, Elle n’a pas daigné ſeulement m’écoûter.	Contre vous, contre moi trop prompte à s'irriter, Elle n'a pas daigné seulement m'écouter.
LE DUC.	LE DUC.
C’eſt un coup du deſtin qui me pourſuit ſans ceſſe.	C'est un coup du destin qui me poursuit sans cesse.
Il me rend criminel auprés de la Princeſſe, Madame, & me ravit le vain ſoulagement De pouvoir d’elle icy me plaindre juſtement.	Il me rend criminel auprès de la Princesse, Madame, et me ravit le vain soulagement De pouvoir d'elle ici me plaindre justement.
Car enfin, elle a fait ce qu’elle de voit laife, Son devoir a parlé, c’eſt à moy de me taire.	Car enfin, elle a fait ce qu'elle de voit laife, Son devoir a parlé, c'est à moi de me taire.
Loin de voir à regret la ſplendeur de ſon rang, Pour l’y faire monter j’aurois donné mon ſang, Et ſi l’amour pour moy l’en avoit refroidie, Moy-même à cet aven je l’aurois enhardie:	Loin de voir à regret la splendeur de son rang, Pour l'y faire monter j'aurais donné mon sang, Et si l'amour pour moi l'en avait refroidie, Moi-même à cet aven je l'aurais enhardie:
Je n’en murmure point.	Je n'en murmure point.
Mais j’aurois ſouhaité Qu’il eut eſté moins rude & moins precipité, Qu’à monter ſur le trône elle eut eu quelque peine, Qu’au moins elle eut paru plus long-temps incertaine, Qu’à tant d’amour éteint elle eut eu quelque égard, Et que ce qu’elle a fait elle l’eut fait plus tard.	Mais j'aurais souhaité Qu'il eut été moins rude et moins précipité, Qu'à monter sur le trône elle eut eu quelque peine, Qu'au moins elle eut paru plus longtemps incertaine, Qu'à tant d'amour éteint elle eut eu quelque égard, Et que ce qu'elle a fait elle eut fait plus tard.
Qui l’eûr crû que ſi-toſt au mépris de ma flame.	Qui l'eûr cru que sitôt au mépris de ma flamme.
Mais helas!	Mais hélas!
la couronne a ſceu fraper ſon ame.	la couronne a su frapper son âme.
Sa vaſte ambition ſacrifie en ce jour Aux douceurs de regner les douceurs de l’amour.	Sa vaste ambition sacrifie en ce jour Aux douceurs de régner les douceurs de l'amour.
Luy qui peut tout ailleurs pert icy ſa puiſſance, A l’épreuve d’un trône il n’eſt point de conIcance;	Lui qui peut tout ailleurs pert ici sa puissance, À l'épreuve d'un trône il n'est point de conIcance;
Et pour le don d'un ſceptre on oſe abandonner Un mal-heureux, qui n’a que ſon cœur à donner.	Et pour le don d'un sceptre on ose abandonner Un malheureux, qui n'a que son cœur à donner.
ISABELLE.	ISABELLE.
Ah!	Ah!
Prince pour mon ſexe ayez moins d’injuſtice, Toutes nous n’avons pas ce biſare caprice.	Prince pour mon sexe ayez moins d'injustice, Toutes nous n'avons pas ce biare caprice.
Il en eſt dont le cœur, ferme en ſon premier choix Pour un amant ſujet mépriſeroit des Rois.	Il en est dont le cœur, ferme en son premier choix Pour un amant sujet mépriserait des Rois.
Mais icy vainement pour vous on s’inquiete, Vous ne m’écoûtez point.	Mais ici vainement pour vous on s'inquiète, Vous ne m'écoutez point.
Voſtre veuë eſt diſtraite.	Votre vue est distraite.
Ma ſœur, je le voy bien, occupe tous vos ſens.	Ma sœur, je le vois bien, occupe tous vos sens.
Tout voſtre cœur eſt plein de ſes charmes abſens.	Tout votre cœur est plein de ses charmes absents.
Rien ne peut.	Rien ne peut.
Oüy je ſuis pour vous contre elle-même, La Princeſſe jamais ne ſceut comme l’onaime, E iiij	Oui je suis pour vous contre elle-même, La Princesse jamais ne suut comme l'onaime, EJÀ iiij
LE DUC.	LE DUC.
Vous dites vray, Madame, elle m’a confirmé Que je me flatay trop quand je m’en crus aimé.	Vous dites vrai, Madame, elle m'a confirmé Que je me flattai trop quand je m'en crus aimé.
L’inconſtance eſt moins fiere, & n’eſt pas ſi ſoudaine.	L'inconstance est moins fière, et n'est pas si soudaine.
Avant que de la rompre il faut trainer ſa chaine.	Avant que de la rompre il faut trainer sa chaîne.
C’eſt par degré qu’on voit croitre & mourir l’amour, Sa fin eſt rarement l’ouvrage d’un ſeul jour.	C'est par degré qu'on voit croître et mourir l'amour, Sa fin est rarement l'ouvrage d'un seul jour.
Je voy par cet éclat de ſon indifference Qu’elle n’en a jamais éprouvé la puiſſance.	Je vois par cet éclat de son indifférence Qu'elle n'en a jamais éprouvé la puissance.
C’eſt-là ce qui me tuë, & mon cœur amoureux, S’il l’ignoroit encor ſeroit moins mal-heureux.	C'est-là ce qui me tue, et mon cœur amoureux, S'il l'ignorait encor serait moins malheureux.
Mon erreur me flattoit, elle l’a diſſipée, Mon ame a le chagrin de ſe voir detrompée, La plus vive douleur dont je ſente les traits, C’eſt d’eſtre convaincu qu’on ne m’aima jamais.	Mon erreur me flattait, elle l'a dissipée, Mon âme à le chagrin de se voir détrompée, La plus vive douleur dont je sente les traits, C'est d'être convaincu qu'on ne m'aima jamais.
ISABELLE.	ISABELLE.
Pleignez moins les malheurs ou l’amour vous expoſe.	Pleignez moins les malheurs ou l'amour vous expose.
Il peut faire ceſſer les tourmens qu’il vous cauſe.	Il peut faire cesser les tourments qu'il vous cause.
Hé ne pourriez-vous pas pour tarir tant de pleurs Entre les bras d’une autre oublier vos douleurs?	Hé ne pourriez-vous pas pour tarir tant de pleurs Entre les bras d'une autre oublier vos douleurs?
LE DUC.	LE DUC.
Helas!	Hélas!
aprés ce coup croit-on qu’il ſoit poſſible Que pour un autre objet je devienne ſenſible.	après ce coup croit-on qu'il soit possible Que pour un autre objet je devienne sensible.
Non, non, de ſes appas toûjours trop occupé Ce cœur d’un autre amour ne peut eſtre frapé.	Non, non, de ses appas toujours trop occupé Ce cœur d'un autre amour ne peut être frappé.
De mes premiers ſoûpirs elle receut l’homage, Pour elle ſeulement j’en connoiſtray l’uſage.	De mes premiers soupirs elle reçut l'hommage, Pour elle seulement j'en connaîtrai l'usage.
Mes pleurs pour elle ſeule aprirent à couler, Ils iront conſtamment où je les fis aller.	Mes pleurs pour elle seule apirent à couler, Ils iront constamment où je les fis aller.
Toûjours également mal-heureux & fidelle, Je nourriray le feu dont je brûle pour elle, Et puis qu’à tant de maux elle m’a condamné, Je conſens pour luy plaire à vivre infortuné.	Toujours également malheureux et fidèle, Je nourrirai le feu dont je brûle pour elle, Et puis qu'à tant de maux elle m'a condamné, Je consens pour M plaire à vivre infortuné.
SCENE VII.	SCÈNE VII.
LE DUC, ISADELLE, CHATEAUBRIANT.	LE DUC, ISADELLE, CHATEAUBRIANT.
CHATEAUBRIANT.	CHATEAUBRIANT.
N vous attent, Seigneur.	N vous attent, Seigneur.
La Princeſſe empreſſée De vos retardemens ſemble preique onenſée.	La Princesse empressée De vos retardements semble préique onensée.
Son ame impatiente accuſe une lenteur Qui de quelques momens recule ſon bonheur.	Son âme impatiente accuse une lenteur Qui de quelques moments recule son bonheur.
Elle vous mande.	Elle vous mande.
LE DUC.	LE DUC.
Allons, puis qu’elle nous l’ordonne, Satisfaire à l’ardeur qu’elle a pour la couronne.	Allons, puis qu'elle nous l'ordonne, Satisfaire à l'ardeur qu'elle a pour la couronne.
Madame, je vous laiſſe, & plein de ma douleur Je vay me confirmer un éternel malheur.	Madame, je vous laisse, et plein de ma douleur Je vais me confirmer un éternel malheur.
Je n’ay trouvé que vous ſenſible à ma miſere, Vous m’avez ſeul aidé quand tout m’eſtoit contraire.	Je n'ai trouvé que vous sensible à ma misère, Vous m'avez seul aidé quand tout m'était contraire.
Je ne puis m’acquitter de ce que je vous doy;	Je ne puis m'acquitter de ce que je vous dois;
Mais ſenſible aux bontez que vous avez pour moy, Madame, quelque jour je pourray reconnaiſtre encicar	Mais sensible aux bontés que vous avez pour moi, Madame, quelque jour je pourrai reconnaître encicar
SCENE VIII.	SCÈNE VIII.
ISABELLE, CHATEAUBRIANT.	ISABELLE, CHATEAUBRIANT.
CHATEAUBRIANT.	CHATEAUBRIANT.
Adaiie, ne bien que dit-il?	Adaiie, ne bien que dit-il?
& quel fruit IVICet entretien pour vous peut-il avoir produit?	et quel fruit IVICet entretien pour vous peut-il avoir produit?
ISABELLE.	ISABELLE.
Quel fruit, un long remors, une honte éternelle.	Quel fruit, un long remors, une honte éternelle.
CHATEAUBRIANT.	CHATEAUBRIANT.
Que dites-vous?	Que dites-vous?
ISABELLE.	ISABELLE.
Le Prince eſt toûjours plus fidelle.	Le Prince est toujours plus fidèle.
Des charmes de ma ſœur plus que jamais épris Pour moy, pour mon amour il n’a que du mépris.	Des charmes de ma sœur plus que jamais épris Pour moi, pour mon amour il n'a que du mépris.
Quand je parlois pour moy ſourd, muet, immobile, Il me laiſſoit pouſſer une plainte inutile.	Quand je parlais pour moi sourd, muet, immobile, Il me laissait pousser une plainte inutile.
Il ſembloit qu’inſenſible aux offres de ma foy En ma preſence même il fut abſent de moy.	Il semblait qu'insensible aux offres de ma foi En ma présence même il fut absent de moi.
Mais helas!	Mais hélas!
au ſeul nom d’une ſœur trop cherie, L’ingrat interrompoit ſa longue réverie, Ce n’eſtoient à mes yeux que tranſports ſur tranſports.	au seul nom d'une sœur trop chérie, L'ingrat interrompait sa longue réverie, Ce n'étaient à mes yeux que transports sur transports.
Tout ſon amour caché ſe répendoit dehors, Il m’a juré cent fois de n’aimer jamais qu’elle, Chaque mot me portoit une atteinte nouvelle, Et mon amour confus eſtoit le ſpectateur Du triomphe cruel de celuy de ma ſœur.	Tout son amour caché se répendoit dehors, Il m'a juré cent fois de n'aimer jamais qu'elle, Chaque mot me portait une atteinte nouvelle, Et mon amour confus était le spectateur Du triomphe cruel de celui de ma sœur.
CHATEAUBRIANT.	CHATEAUBRIANT.
Pourquoy vous arracher ſi toſt à l’eſperance.	Pourquoi vous arracher si tôt à l'espérance.
Accordez quelques jours à ſa perſeverance, Laiſſez un libre cours à ſon nouvel ennuy.	Accordez quelques jours à sa persévérance, Laissez un libre cours à son nouvel ennui.
Il ſera peu de temps tel qu’il eſt aujourd’huy.	Il sera peu de temps tel qu'il est aujourd'hui.
Quel que ſoit, croyez-moy, le feu qui le tranſporte, L’amour meurt aiſement quand l’eſperance eſt morte.	Quel que soit, croyez-moi, le feu qui le transporte, L'amour meurt aisément quand l'espérance est morte.
ISABELLE.	ISABELLE.
Non, ſur moy tes conſeils ont eu trop de pouvoir.	Non, sur moi tes conseils ont eu trop de pouvoir.
Toute mon eſperance eſt de n’en plus avoir.	Toute mon espérance est de n'en plus avoir.
Pourquoy m’as-tu flatée?	Pourquoi m'as-tu flattée?
ou pourquoy t’ay-je cruë, Tu m’as ravy le jour quand tu m’as ſecouruë.	ou pourquoi t'ai-je crue, Tu m'as ravi le jour quand tu m'as secourue.
Ne m’offre plus icy ton funeſte ſecours, La mort eſt deſormais mon unique recours.	Ne m'offre plus ici ton funeste secours, La mort est désormais mon unique recours.
De grace laiſſe-moy.	De grâce laisse-moi.
Dans ce deſordre extréme Je ſuis ainſi qu’au Prince odieuſe à moy-même.	Dans ce désordre extrême Je suis ainsi qu'au Prince odieuse à moi-même.
Tout m’importune, & tout irrite mes douleurs, Souffre que loin de toy j’aille verſer des pleurs.	Tout m'importune, et tout irrite mes douleurs, Souffre que loin de toi j'aille verser des pleurs.
Fin du quatriéme Acte.	Fin du quatrième Acte.
HCTE 4	HCTE 4
SCENE I.	SCÈNE I.
DA DOCHESSE, CHATEAUBRIANT.	DA DOCHÉSSE, CHATEAUBRIANT.
LA DUCHEt CM.	LA DUCHÉt CM.
t’on pour mon départ preparé toute choA ſe?	t'on pour mon départ préparé toute choA se?
CHATEAUBRIANT.	CHATEAUBRIANT.
Par voſtre ordre avec ſoin, Madame, on s’y diſpoſe, Tout s’empreſſe, & bien-toſt vous quitterez ces lieux Pour un ſejour plus doux, & plus chery det Cieux.	Par votre ordre avec soin, Madame, on s'y dispose, Tout s'empresse, et bientôt vous quitterez ces lieux Pour un séjour plus doux, et plus chéri de Cieux.
Bien-toſt juſques en France en triomphe menée Vous irez prendre un rang qui ſuit voſtre hymenée, Voir à vos pieds un peuple amoureux de vos loix, Et faire le bonheur du plus puiſſant des Rois.	Bientôt jusques en France en triomphe menée Vous irez prendre un rang qui suit votre hyménée, Voir à vos pieds un peuple amoureux de vos lois, Et faire le bonheur du plus puissant des Rois.
Mais, Madame, mes yeux vous trouvent bien changée.	Mais, Madame, mes yeux vous trouvent bien changée.
Hier dans les tranſports d'une amante outragée, Vous Vous vous abandonniez à tous vos mouvemens, Vous ſembliez tout promettre à vos reſſeutimens.	Hier dans les transports d'une amante outragée, Vous Vous vous abandonniez à tous vos mouvements, Vous sembliez tout promettre à vos resseutiments.
Aujourd’huy je vous vois un tranquile viſage, Et le plein calme regne où regnoit tant d’orage.	Aujourd'hui je vous vois un tranquille visage, Et le plein calme règne où régnait tant d'orage.
Mis jui lanoi elalnacer de nocite, Vous demander d’où vient cette tranquilité?	Mis jui lanoi élalnacer de nocite, Vous demander d'où vient cette tranquillité?
LA DUCHESSE.	LA DUCHESSE.
La nuit & la raiſon m’ont renduë à moy-même.	La nuit et la raison m'ont rendue à moi-même.
Je haiſſois, j’aimois.	Je haïssais, j'aimais.
Je ne hay, ny je n’aime.	Je ne hai, Seigneur je n'aime.
D’un autre œil j’enviſage & le Prince & ma ſœur.	D'un autre œil j'envisage et le Prince et ma sœur.
Le changement de rang a fait changer mon cœur.	Le changement de rang a fait changer mon cœur.
Il n’eſt plus le joüet d’une vaine tendreſſe, Je regne, & ſuis enfin de moy-méme maiſtreſſe.	Il n'est plus le jet d'une vaine tendresse, Je règne, et suis enfin de moi-même maîtresse.
Hier, je l’avoüeray, dans mes tranſports jaloux Je preparois contre-eux un immortel courroux, Au trône par dépit je me laiſſay conduire, Pour pouvoir à loiſir me vanger & leur nuire.	Hier, je l'avouerai, dans mes transports jaloux Je préparais contre-eux un immortel courroux, Au trône par dépit je me laissai conduire, Pour pouvoir à loisir me venger et leur nuire.
Toute attentive au ſoin de tramer leur malheur, Je crus que mon hymen ſeroit l’écüeil du leur, Que j’en romprois les neuds quand je ſerois leur Reine, Et que leur triſte amour dépendroit de ma haine, Mon cœur trop irrité contr’elle, contre luy, Se faiſoit un plaiſir de leur futur ennuy, Et dans les mouvemens de mon impatience, Je preſſay mon hymen pour haſter ma vangeance.	Toute attentive au soin de tramer leur malheur, Je crus que mon hymen serait l'écueil du leur, Que j'en romprais les neuds quand je serais leur Reine, Et que leur triste amour dépendrait de ma haine, Mon cœur trop irrité contr'elle, contre lu, Se faisait un plaisir de leur futur ennui, Et dans les mouvements de mon impatience, Je pressai mon hymen pour hâter ma vengeance.
Voilà ce qu’à mon ame inſpiroient mes tranſports.	Voilà ce qu'à mon âme inspiraient mes transports.
Mais cette ame n’eſt plus ce qu’elle eſtoit alors.	Mais cette âme n'est plus ce qu'elle était alors.
D’une plus noble ardeur cette ardeur eſt ſuivie.	D'une plus noble ardeur cette ardeur est suivie.
Quand je puis me vanger j’en pers juſqu’à l’envie.	Quand je puis me venger j'en pers 'à l'envie.
Je conſulte mon rang, il me conſeille mieux.	Je consulte mon rang, il me conseille mieux.
Sa nouvelle ſplendeur m’a deſſillé les yeux.	Sa nouvelle splendeur m'a dessillé les yeux.
J’ay vû qu’un tel courroux tourneroit à ma honte, Qu’avec moy ſur le trône il ne faut pas qu’il monte, Que je dois y porter un eſprit détaché, Ny d’amour prevenu, ny de haine touché, Et prendre, en condamnant ma foibleſſe paſſée, Un cœur digne du rang où je me voy placée.	J'ai vu qu'un tel courroux tournerait à ma honte, Qu'avec moi sur le trône il ne faut pas qu'il monte, Que je dois y porter un esprit détaché, Ni d'amour prévenu, ni de haine touché, Et prendre, en condamnant ma faiblesse passée, Un cœur digne du rang où je me vois placée.
CMAIEAUBRIANT.	CMAIEAUBRIANT.
Ainſi donc oubliant voſtre premier courroux, Vous avez triomphé de l’amour & de vous?	Ainsi donc oubliant votre premier courroux, Vous avez triomphé de l'amour et de vous?
LA DUCHESSE.	LA DUCHESSE.
Sans doute, & pour te faire entiere confidence, de vellois leul nyien avee ſuierence.	Sans doute, et pour te faire entière confidence, de vellois leul avien ave suivérence.
Du trône à la tendreſſe il n’eſt point de retour, Et ma gloire à iamais me répond de l’amour.	Du trône à la tendresse il n'est point de retour, Et ma gloire à jamais me répond de l'amour.
CHATEAUBRIANT.	CHATEAUBRIANT.
Je n’attendois pas moins de voſtre grand courage.	Je n'attendais pas moins de votre grand courage.
Nous avez beaucoup lait, Mais Iaites davantage.	Nous avez beaucoup lait, Mais Jaites davantage.
Donnez un libre cours à vos bontez pour eux, Et preſſez un hymen qui peut les rendre heureux.	Donnez un libre cours à vos bontés pour eux, Et pressez un hymen qui peut les rendre heureux.
LA DUCHESSE.	LA DUCHESSE.
C’en eſt trop.	C'en est trop.
Il ſuffit d’oublier leur offenſe.	Il suffit d'oublier leur offense.
Jt puis bien juſques-là pouſſer ma complaiſance.	It puis bien jusque-là pousser ma complaisance.
Mais je ne me ſens pas aſſez de fermeté, Pour leur faire un bonheur qu’ils n’ont point merité.	Mais je ne me sens pas assez de fermeté, Pour leur faire un bonheur qu'ils n'ont point mérité.
CHATEAUBRIANT.	CHATEAUBRIANT.
Je voy le Duc.	Je vois le Duc.
LA DUCHESSE.	LA DUCHESSE.
Trop ſeur de l’aveu d’Iſabelle, Sans doute il vient briguer mon fuffrage pour elle.	Trop sûr de l'aveu d'Isabelle, Sans doute il vient briguer mon suffrage pour elle.
Retire toy.	Retire toi.
CHATEAUBRIANT.	CHATEAUBRIANT.
Quoy dont, Madaine, toulez-vous.	Quoi dont, Madaine, toulez-vous.
LA DUCHESSE.	LA DUCHESSE.
Je veux l’entendre.	Je veux l'entendre.
Sors.	Sors.
Il s’avance vers nous.	Il s'avance vers nous.
e lllM A la LA DUCHESSE, LE DUC.	Je lllM À la LA DUCHESSE, LE DUC.
LE PUC.	LE PUC.
Adame, inſtruit des vœux dont me charM gea la France, Je vous viens de ſa joye aſſurer par avance, Vous dire quel bonheur elle attend de vos loix, Et combien voſtre hymen charme tous les François.	Adame, instruit des vœux dont me charge géa la France, Je vous viens de sa joie assurer par avance, Vous dire quel bonheur elle attend de vos lois, Et combien votre hymen charme tous les Français.
Madame, je prens part à ces grands avantages, Je viens comme ſujet vous rendre mes homages, Le premier à vos loix je viens m’aſſujettir, Et recevoir de vous les ordres pour partir.	Madame, je prends part à ces grands avantages, Je viens comme sujet vous rendre mes hommages, Le premier à vos lois je viens m'assujettir, Et recevoir de vous les ordres pour partir.
LA DUCHESSE.	LA DUCHESSE.
Ils ſont donnez.	Ils sont donnés.
J’ay ſceu vous épargner ces peines Prince, le jour naiſſant nous va voir hors de Rennes.	J'ai su vous épargner ces peines Prince, le jour naissant nous va voir hors de Rennes.
Pour l’homage qu’icy vous me venez offrir, Il m’eſt trop glorieux pour ne le pas ſouffrir.	Pour l'homage qu'ici vous me venez offrir, Il m'est trop glorieux pour ne le pas souffrir.
Hé puis, dois-je oublier que par voſtre entremiſe J’ay monté ſur le trône où l’on me voit aſſiſe, Que j’aurois moins d’honneurs ſi vous aviez fait moins, Et que toute ma gloire eſt l’effet de vos ſoins?	Hé puis, dois-je oublier que par votre entremise J'ai monté sur le trône où l'on me voit assise, Que j'aurais moins d'honneurs si vous aviez fait moins, Et que toute ma gloire est l'effet de vos soins?
Attendez tout auſſi de ma reconnoiſſance, Rien ne la bornera que ma propre puiſſance.	Attendez tout aussi de ma reconnaissance, Rien ne la bornera que ma propre puissance.
Je m’offre à vous ſervir prés du Roy mon époux, Prince, demandez tout, j’obtiendray tout pour vous.	Je m'offre à vous servirez près du Roi mon époux, Prince, demandez tout, j'obtiendrai tout pour vous.
LE DUC.	LE DUC.
Madame, je n’ay fait que ce que j’ay dû faire, A de moindres faveurs je borne mon ſalaire.	Madame, je n'ai fait que ce que j'ai dû faire, À de moindres faveurs je borne mon salaire.
Mon cœur, mon triſte cœur ſouhaitte ſeulement Que vous daigniez icy m’écoûter un moment.	Mon cœur, mon triste cœur souhaite seulement Que vous daigniez ici m'écouter un moment.
Je n’oſe qu’en tremblant demander cette graCe3 Voſtre auſtere vertu m’épouvante, & me glace.	Je n'ose qu'en tremblant demander cette graCe3 Votre austère vertu m'épouvante, et me glace.
Je crains que le diſcours où je vay m’engager, Malgré tout mon reſpect, ne puiſſe l’outrager.	Je crains que le discours où je vais m'engager, Malgré tout mon respect, ne puisse l'outrager.
LA DUCHESSE.	LA DUCHESSE.
Craignant de l’outrager vous luy faites outragen Prince, pour eſtre auſtere enſe n'eſt pas lauvage.	Craignant de l'outrager vous lui faites outragen Prince, pour être austère ense n'est pas lauvage.
La vertu veritable eſt lente à s’irriter, Plus elle eſt grande, & moins on doit la redouter.	La vertu véritable est lente à s'irriter, Plus elle est grande, et moins on doit la redouter.
Je porte à vos diſcours une ame preparée, La voſtre par les miens doit eſtre raſſurée.	Je porte à vos discours une âme préparée, La vôtre par les miens doit être rassurée.
Men ne m’onehela, ne craignez fien, parlez.	Men ne m'onehela, ne craignez sien, parlez.
LE DUC.	LE DUC.
Hé bien je vay parler, puis que vous le voulez.	Hé bien je vais parler, puis que vous le voulez.
Je vous aimay, Madame.	Je vous aimai, Madame.
Il vous ſouvient peutétre Qu’autrefois en ces lieux ma flame oſa paroiſtre, Qu’épris de vos appas, que percé de vos coups, J’appris à ſoûpirer en ſoûpirant pour vous.	Il vous souvient peutétre Qu'autrefois en ces lieux ma flamme osa paraître, Qu'épris de vos appas, que percé de vos coups, J'appris à soupirer en soupirant pour vous.
Je dis plus, pardonnez un aveu temeraire, Je me flatay du bien de ne vous point déplaire.	Je dis plus, pardonnez un aveu téméraire, Je me flattai du bien de ne vous point déplaire.
Mon cœur trop ſatisfait de gemir à vos yeux D’aucune autte faveur n’importuna les Cieux.	Mon cœur trop satisfait de gémir à vos yeux D'aucune autte faveur n'importuna les Cieux.
Cette felicité me fut bien-toſt ravie.	Cette félicité me fut bientôt ravie.
O Ciel, qu’en me l’ôtant ne m’ôtas-tu la vie?	Ô Ciel, qu'en me l'ôtant ne m'as-tu la vie?
Voſtre pere à mes vœux oppoſa ſon pouvoir, Lors que j’eſperois tout m’interdit tout eſpoir.	Votre père à mes vœux opposa son pouvoir, Lors que j'espérais tout m'interdit tout espoir.
Mais quoy que tous mes pleurs ne puſſent rien pretendre, Sans ceſſe auprés de vous vous m’en vites reprendre, Et loin de vos appas, les Cieux me ſont témoins Madame, que pour vous je n’en verſay pas moins.	Mais quoi que tous mes pleurs ne pussent rien prétendre, Sans cesse auprès de vous vous m'en vîtes reprendre, Et loin de vos appas, les Cieux me sont témoins Madame, que pour vous je n'en versai pas moins.
Voſtre ſeul intereſt trop puiſſant ſur mon ame En faveur d’un rival m’a fait trahir ma ffame.	Votre seul intérêt trop puissant sur mon âme En faveur d'un rival m'a fait trahir ma ffâme.
Je vis que voſtre hymen ſi funeſte pour moy, A vos états ſauvez joignoit ceux d’un grand Roy.	Je vis que votre hymen si funeste pour moi, À vos états sauvez joignait ceux d'un grand Roi.
Fnj	Fnj
Je me flatay, malgré mon ardeur amoureuſe.	Je me flattai, malgré mon ardeur amoureuse.
D’eſtre moins mal-heureux ſi vous eſtiez heureuſe.	D'être moins malheureux si vous étiez heureuse.
Vous l’eſtes, & le ſort a remply mes deſirs.	Vous l'êtes, et le sort a rempli mes désirs.
Vos jours vont à jamais couler dans les plaiſirs.	Vos jours vont à jamais couler dans les plaisirs.
Mais, Madame, aujourd'huy que vous eſtes ma Reine, Que loin de mon deſtin voſtre hymen vous entraine, Qu’on ne peut m’accuſer de trahir voſtre époux, Souffrez que je me pleigne, & me pleigne de vous.	Mais, Madame, aujourd'hui que vous êtes ma Reine, Que loin de mon destin te hymen vous entraine, Qu'on ne peut m'accuser de trahir votre époux, Souffrez que je me pleins, et me plein de vous.
A peine des François vous ay-je offert l’Empire, Qu’à l’hymen propoſé je vous ay vû ſouſcrire.	À peine des Français vous ai-je offert l'Empire, Qu'à l'hymen proposé je vous ai vu souscrire.
Sans pitié pour un Prince autrefois voſtre amant, Vous n’avez pour répondre attendu qu’un moment.	Sans pitié pour un Prince autrefois votre amant, Vous n'avez pour répondre attendu qu'un moment.
Aux volontez du ſort voſtre ame aſſujettie De ce retardement s’eſt même repentie, Elle s’eſt à mes yeux reproché cet effort, Et d’a voir d’un moment pû differer ma mort.	Aux volontés du sort votre âme assujettie De ce retardement s'est même repentie, Elle s'est à mes yeux reproché cet effort, Et d'a voir d'un moment pu différer ma mort.
Ce que j’ay fait pour vous, mon amour, ma conſtance Devoient bien quelque temps vous tenir en balance.	Ce que j'ai fait pour vous, mon amour, ma constance Devaient bien quelque temps vous tenir en balance.
Du moins pour amoindrir l’excez de mon malheur, Vous pouviez affecter quelque feinte douleur.	Du moins pour amoindrir l'excès de mon malheur, Vous pouviez affecter quelque feinte douleur.
Avec plaiſir par là ma tendreſſe abuſée Loin de vous accuſer vous auroit excuſée.	Avec plaisir par là ma tendresse abusée Loin de vous accuser vous aurait excusée.
Voſtre rigueur suroit le ſuccez qu’elle attent.	Votre rigueur suroît le succès qu'elle attent.
Je n’en mourrois pas momio , mais je modriois content.	Je n'en mourrais pas momio , mais je modrais content.
LA DUCHESSE.	LA DUCHESSE.
Prince, je l’avoüeray, ces reproches m’étonnent.	Prince, je l'avouerai, ces reproches m'étonnent.
Je pardonne aux tranſports ou vos ſens s’abandonnentt Si j’en croyois l’orgueil par mon rang inſpiré J’entendrois ſans replique un diſcours preparé:	Je pardonne aux transports ou vos sens s'abandonnentt Si j'en croyais l'orgueil par mon rang inspiré J'entendrais sans replique un discours préparé:
Mais pour vous je l’oublie, & je veux vous répondre Bien moins pour m’excuſer qu’afin de vous confondre.	Mais pour vous je l'oublie, et je veux vous répondre Bien moins pour m'excuser qu'afin de vous confondre.
Voſtre cœur n’a-t’il pas quelques remors ſecrets :	Votre cœur n'a-t-il pas quelques remors secrets :
A-t’il la dureté de vous laiſſer en paix?	A-t-il la dureté de vous laisser en paix?
Ce cœur diſſimulé ne doit-il pas vous dire, Qu’il faut à des ingrats preferer un empire, Ne garder avec eux aucun ménagement, Y uiii par l'inconitance un infidelle amant:	Ce cœur dissimulé ne doit-il pas vous dire, Qu'il faut à des ingrats préférer un empire, Ne garder avec eux aucun ménagement, Y uiii par l'inconitance un infidèle amant:
Sur tout lors qu’outrageant une amante fidelle , Il oſe à ſes yeux même en faire une nouvelle.	Sur tout lors qu'outrageant une amante fidèle , Il ose à ses yeux même en faire une nouvelle.
LE DUC.	LE DUC.
Madame croiriez-vous.	Madame croiriez-vous.
LA DUCHESSE.	LA DUCHESSE.
Parlons à cœur ouvert;	Parlons à cœur ouvert;
Il n’eſt rien par le temps qui ne ſoit découvert.	Il n'est rien par le temps qui ne soit découvert.
Plus que vous ne croyez voſtre ame m’eſt connuë, Et nous ſçavons ramour dont enle eit plevenuë.	Plus que vous ne croyez votre âme m'est connue, Et nous sçavons ramour dont enle eit pleenue.
LE DUC.	LE DUC.
C’eſt peu de m’avoir fait un malheur éternel Madame, on veut encor me rendre er minel, Et vous-même inſultant à mon ame confuſe, Vous oſez m’accuſer lors que je vous accuſe.	C'est peu de m'avoir fait un malheur éternel Madame, on veut encor me rendre er minel, Et vous-même insultant à mon âme confuse, Vous osez m'accuser lors que je vous accuse.
On me quitte, on m’outrage, & pour comble de maux, Pour couvrir un vraycrime on m’en impoſe un faux.	On me quitte, on m'outrage, et pour comble de maux, Pour couvrir un vraicrime on m'en impose un faux.
Moy charger!	Moi charger!
plût au Ciel que je fuſſe coupable.	plût au Ciel que je fusse coupable.
Je ne ſentirois pas la douleur qui m’accable.	Je ne sentirais pas la douleur qui m'accable.
Mon cœur d’un vain remors peu de temps agité Trouveroit ſon repos dans l’infidelité.	Mon cœur d'un vain remors peu de temps agité Trouverait son repos dans l'infidélité.
La peine meritée à moms de violence.	La peine méritée à moments de violence.
Mon plus rude tourment vient de mon innocence.	Mon plus rude tourment vient de mon innocence.
LA DUCHESSE.	LA DUCHESSE.
Juſqu’icy mes bontez ont ſouffert vos diſcours, Elles ſe promettoient de les ſouffrir toûjours.	Jusqu'ici mes bontés ont souffert vos discours, Elles se promettaient de les souffrir toujours.
Je ſçay à quoy mon rang & ma vertu m’attachent, Mais à tous ces devoirs vos reproches m’arrachent.	Je sais à quoi mon rang et ma vertu m'attachent, Mais à tous ces devoirs vos reproches m'arrachent.
Perfide, c’eſt eſt fait, il eſt temps d’éclater, D’une fauſſe innocence oſes-tu te vanter?	Perfide, c'est est fait, il est temps d'éclater, D'une fausse innocence oses-tu te vanter?
Pretens tu m’abuſer par cette audace feinte Qu’inſpire aux criminels ou la honte ou la crainte?	Prétends tu m'abuser par cette audace feinte Qu'inspire aux criminels ou la honte ou la crainte?
Tes crimes ſont trop clairs.	Tes crimes sont trop clairs.
Ton retour, ton employ, Ton trouble, tout enfin me parle contre toy.	Ton retour, ton emploi, Ton trouble, tout enfin me parle contre toi.
J’en croy tous ces témoins, & non pas tes paroles.	J'en crois tous ces témoins, et non pas tes paroles.
A ma perfide ſœur, perfide, tu m’immoles.	À ma perfide sœur, perfide, tu m'immoles.
Ne fay point le ſurpris.	Ne fais point le surpris.
Oüy, tu l’aimes ingrat, Tu couures ton amour du ſoin de mon état.	Oui, tu l'aimes ingrat, Tu couvres ton amour du soin de mon état.
Déja tout occupé de ton ardeur nouvelle, Tu m’évites, me fuis pour courir aprés elle.	Déjà tout occupé de ton ardeur nouvelle, Tu m'évites, me fuis pour courir après elle.
En ſecret, ſans témoins, dans ſon appartement Tu viens de t’applaudir d’un honteux changement, 2 Tu viens de luy jurer une immortelle flame, Et d’avoir effacé mon portrait de ton ame:	En secret, sans témoins, dans son appartement Tu viens de t'applaudir d'un honteux changement, 2 Tu viens de lui jurer une immortelle flamme, Et d'avoir effacé mon portrait de ton âme:
Va, porte à cette ſœur un cœur double & ſans foy.	Va, porte à cette sœur un cœur double et sans foi.
Infidelle elle-même elle eſt digne de toy.	Infidèle elle-même elle st digne de toi.
LE DUC.	LE DUC.
Qui, moy, je l’aimerois!	Qui, moi, je l'aimerais!
quelle bouche perfide A noircy prés de vous ma tendreſſe timide?	quelle bouche perfide À noirci près de vous ma tendresse timide?
Avec elle, il eſt vrày, j’eus un long entretien, Ou mon cœur tout entier ſe découvrit au ſien.	Avec elle, il est vrài, j'eus un long entretien, Ou mon cœur tout entier se découvrit au sien.
N’oſant pas de vos yeux ſoûtenir la preſence, Je fis aux ſiens pour vous éclater ma conſtance, Luy montray mes douleurs, & j’oſay la prier De le chaiger du lon de me futcifier.	N'osant pas de vos yeux soutenir la présence, Je fis aux siens pour vous éclater ma constance, Lui montrai mes douleurs, et j'osai la prier De le chaiger du lon de me futcifier.
Je ſouhaitois qu’au moins vous appriſſiez par enc Que j’eſtois mal-heureux, & non pas infidelle.	Je souhait qu'au moins vous apprissiez par enc Que j'étais malheureux, et non pas infidèle.
LA DUCHESSE.	LA DUCHESSE.
Prince que dites vous?	Prince que dites -vous?
LE DUC.	LE DUC.
Que juſques à ce jour Vous ſeule avez eſté l’objet de mon amour.	Que jusques à ce jour Vous seule avez été l'objet de mon amour.
C’eſt ce que la Princeſſe auroit pû vous apprendre, Si moins prompte, un moment on eut daigné l’entendre.	C'est ce que la Princesse aurait pu vous apprendre, Si moins prompte, un moment on eut daigné l'entendre.
SCENE III.	SCÈNE III.
LA DUCHESSE, LE DUC, CHATENOBRIANT.	LA DUCHESSE, LE DUC, CHATENOBRIANT.
CHATEAUBRIANT.	CHATEAUBRIANT.
H!	H!
Madame, venez, ou je crains qu’auA jourd'huy La Princeſſe à mes yeux n’expire enfin d’ennuy.	Madame, venez, ou je crains qu'auA jourd'hui La Princesse à mes yeux n'expire enfin d'ennui.
De pleurs toute trempée, interdite, abatuë, Ne pouvant plus ſouffrir le remors qui la tuë, Ma honte, a t’elle dit, ainſi que ma douleur Ne me permettent pas d’approcher de ma ſœur.	De pleurs toute trempée, interdite, abattue, Ne pouvant plus souffrir le remors qui la tue, Ma honte, a t'elle dit, ainsi que ma douleur Ne me permettent pas d'approcher de ma sœur.
Va, cours juſtifier l’innocence auprés d’elle.	Va, cours justifier l'innocence auprès d'elle.
Dy luy que ſon amant luy fut toûjours fidelle, Que ſon cœur pour le Duc brûla moins que le mien, Et que mon triſte amour m’a fait trahir le ſien.	Dy Roi que son amant te tendre toujours fidèle, Que son cœur pour le Duc brûla moins que le mien, Et que mon triste amour m'a fait trahir le sien.
Pardonnez-luy, ſon cimme oit momdre que ſa peine, Elle eſt plus digne, helas!	Pardonnez-lui, son cimme oit momdre que sa peine, Elle est plus digne, hélas!
de pitié que de haine.	de pitié que de haine.
Ne pouſſez pas plus loin voſtre juſte courroux, Ses remors, ſes douleurs la puniſſent pour vous.	Ne poussez pas plus loin votre juste courroux, Ses remors, ses douleurs la punissent pour vous.
LA DUCHESSE.	LA DUCHESSE.
Ah, ma ſœur qu’as-tu fait!	Ah, ma sœur qu'as-tu fait!
faut-il que ton offenſe.	faut-il que ton offense.
Allez de ſes douleurs calmer la violence Ne l’abandonnez point.	Allez de ses douleurs calmer la violence Ne l'abandonnés point.
Je vay ſuivre vos pas.	Je vais suivre vos pas.
SCENE DERNIER.	SCÈNE DERNIER.
LA DUCHESSE, LE DUC.	LA DUCHESSE, LE DUC.
LA DUCHESSE.	LA DUCHESSE.
Lle vous aime, Prince, & vous ne l’aiddlen pao.	Lle vous aime, Prince, et vous ne l'aidlen pao.
Ah Ciel.	Ah Ciel.
Que je te plains mal-heureuſe Iſabelle!	Que je te plains malheureuse Isabelle!
LE DUC.	LE DUC.
Suis-ie moins mal-heureux & moins à plaindre qu’elle, Madame?	Suis-je moins malheureux et moins à plaindre qu'elle, Madame?
cet amour ſi tendre, ſi puiſſant.	cet amour si tendre, si puissant.
LA DUCHESSE.	LA DUCHESSE.
Prince n’en parlons plus, vous eſtes innocent?	Prince n'en parlons plus, vous êtes innocent?
Je le ſçais, il ſuffit.	Je le sais, il suffit.
Je ſuis Reine de France.	Je suis Reine de France.
Ce nom ſeul vous preſcrit un éternel ſilence.	Ce nom seul vous prescrit un éternel silence.
Ne perdez plus pour moy d’injurieux ſoûpirs.	Ne perdez plus pour moi d'injurieux soupirs.
Ma vertu vous défend de former des deſirs.	Ma vertu vous défend de former dés désirs.
Remportez ſur vous même une pleine victoire Et ceſſez de m’aimer ſi vous aimez ma gloire.	Remportez sur vous -même une pleine victoire Et cessez de m'aimer si vous aimez ma gloire.
LE DUC.	LE DUC.
J’obeïray, Madame, à ces cruelles loix.	J'obéirai, Madame, à ces cruelles lois.
Vous voyez mon amour pour la dermere idis.	Vous voyez mon amour pour la dermère idis.
Si je ne puis le vaincre, en étouffer la flame, Je ſçauray le cacher dans le fond de mon ame.	Si je ne puis le vaincre, en étouffer la flamme, Je craurai le cacher dans le fond de mon âme.
Jamais ſon triſte éclat n’offenſera vos yeux, Il n’aura pour témoins que mon cœur & les Cieux.	Jamais son triste éclat n'offensera vos yeux, Il n'aura pour témoins que mon cœur et les Cieux.
Et pour mieux vous prouver à quel point je vous aime, Je voudrois le cacher aux Cieur, i hion cœur même.	Et pour mieux vous prouver à quel point je vous aime, Je voudrais le cacher aux Cieur, j' ici cœur même.
LA DUCHESSE.	LA DUCHESSE.
Faites plus.	Faites plus.
En effet oubliez vos malheurs, Prince, reſervez-vous à des deſtins meilleurs.	En effet oubliez vos malheurs, Prince, réservez-vous à des destins meilleurs.
Rappellez de ce cœur la vertu non commune, Dont la perſeverance a laſſé la fortune.	Rappelez de ce cœur la vertu non commune, Dont la persévérance a lassé la fortune.
Oüy, pour voſtre repos ne penſez plus à moy.	Oui, pour votre repos ne pensez plus à moi.
Voyons ma ſœur, & puis allons trouver le Roy,	Voyons ma sœur, et puis allons trouver le Roi,
Fin du dernier Acte.	Fin du dernier Acte.
Et pour mieux vous prouver à quel point je vous aime, Je voudrois le cacher aux Cieur, i hion cœur même.	Et pour mieux vous prouver à quel point je vous aime, Je voudrais le cacher aux Cieur, j' ici cœur même.
LA DUCHESSE.	LA DUCHESSE.
Faites plus.	Faites plus.
En effet oubliez vos malheurs, Prince, reſervez-vous à des deſtins meilleurs.	En effet oubliez vos malheurs, Prince, réservez-vous à des destins meilleurs.
Rappellez de ce cœur la vertu non commune, Dont la perſeverance a laſſé la fortune.	Rappelez de ce cœur la vertu non commune, Dont la persévérance a lassé la fortune.
Oüy, pour voſtre repos ne penſez plus à moy.	Oui, pour votre repos ne pensez plus à moi.
Voyons ma ſœur, & puis allons trouver le Roy,	Voyons ma sœur, et puis allons trouver le Roi,
Fin du dernier Acte.	Fin du dernier Acte.
