A MONSEIGNEVR MESSIRE HENRY LOVIS HABERT,	À MONSEIGNEUR MESSIRE HENRY LOUIS HABERT,
CHEVALIER, COMTE du Meſny Habert, Seigneur de Monmort, la Broſſe, le Peray, le Fargis, & autres tous ſes Conſeils, & Maiſtre des Requeſtes ordinaire de ſon Hoſtel, &c.	CHEVALIER, COMTE du Mêni Habert, Seigneur de Monmort, la Brosse, le Peray, le Fargis, et autres tous ses Conseils, et Maître des Requestes ordinaire de son Hôtel, etc.
ZONSEIGNEVR,	ZONSEIGNEUR,
Ie n’étaleray point Meß icy la grandeur de voſire Naiſſance, ny les ſeruices tonſiderables que vous auez rendus, & que vous rendez tous les iours à l’Eſtat.	Je n'étalerai point Messi ici la grandeur de vosire Naissance, ni les services tonsidérables que vous avez rendus, et que vous rendez tous les jours à l'État.
Je ne diray point que quelque éclat dont vous ſoyez enuironné, & que quelques Illuſtres que ſoient vos Charges, elles en tirent plus de vous, qu’elle ne vous en donnent.	Je ne dirai point que quelque éclat dont vous soyez environné, et que quelques Illustres que soient vos Charges, elles en tirent plus de vous, qu'elle ne vous en donnent.
Ce n’eſt pas à mey d’entreprendre vn Panegerique, où le merite ſurpaſſe de bien loin la plus haute Idée que l’on j’en puiſſe former:	Ce n'est pas à mei d'entreprendre un Panégerique, où le mérite surpasse de bien loin la plus haute Idée que l'on j'en puisse former:
Vous vox deuez à vous-meſme toute voſtre gioire, & il vous appartient ſouli de faire auelque choſe à voſtre auantage, & pour moy, bien que i’aye aſſez d’ardeur pour ſcuhaitter de dire quelque choſe à veſtre loüanje, ie n’ay pas aſſez de temerité pour l’entreprendre:	Vous vox devez à vous-même toute votre gioire, et il vous appartient souli de faire avelque chose à votre avantage, et pour moi, bien que j'aie assez d'ardeur pour scuhaiter de dire quelque chose à votre loüanje, quelque n'ai pas assez de témérité pour l'entreprendre:
ie ſeray tropheureux ſi ie puis contribuër quelque choſe à voſtre diuertiſſement, & ſi la leflure de ces Vraies Pretieuſes, que ie vous offre peut vous délaſſer, vn moment de vos penibles & contiuuelles occupations.	Ne serai tropheureux si on puis contribuer quelque chose à votre divertissement, et si la leflure de ces Vraies Pretieuses, que je vous offre peut vous délasser, un moment de vos pénibles et contivelles occupations.
Ie	Je
ſtay bien qu'à conſiderer cet Oæurage ſortant de mes mains, il perd quelque choſe de ſon prix, & que le nem de ſen Auiheur pourroit, par la reſuiation qu’il s’eſt acquiſe, vous le rendre plus conſiderable;	stai bien qu'à considérer cet Oæurage sortant de mes mains, il perd quelque chose de son prix, et que le nem de sen Avieur pourrait, par la résuiation qu'il s'est acquise, vous le rendre plus considérable;
Mais ie ne veux rien deuoir à autruy, où il s’agit de vous eſtre obligé:	Mais ici ne veux rien devoir à autrui, où il s'agit de vous être obligé:
Ouy, MONSEIGNEVR, ie prejere l’honneur de vous eſtre redeuable à vous ſeul de la protection que ie veus demande pour cette Cimedie, a tous les auantages que ie pourrois auoir de vous offrir vn Liure qui meriteroit & par luy, & par le nom de celuy qui l’uuroit fait, l’aueu d’vne perſonne Illuſtre, comme vous;	Oui, MONSEIGNEUR, je préjère l'honneur de vous être redevable à vous seul de la protection que je veux demande pour cette Cimédie, a tous les avantages que sans pourrais avoir de vous offrir un Livre qui mériterait et parfois, et par le nom de celui qui l'une fait,l’aueu Yl avait Fait, comme vous;
car au moins, vous iugerez qu’vn zele tout pur m’a fait oſer ce que i’entrepends, & que qui cherche à vous diuertir, cherchera touſiours auecque tout l’impreſſement poſſiE.	car au moins, vous jugerez qu'un zèle tout pur m'a fait oser ce que j'entrepends, et que qui cherche à vous divertir, cherchera toujours auecque tout l'impressement possiE.
ble les moyens de meriter la qualité qu’il prend auec voſtre permiſſion,	blé les moyens de mériter la qualité qu'il prend avec votre permission,
MONSEIGNEVR,	MONSEIGNEUR,
De voſtre tres-humble, tres, obeïſſant, & tres-fidelle ruiteur IrAN RIBOV.	De votre très-humble, très, obéissant, et très-fidelle ruiteur IrAN RIBOU.
Dpuis que la modeſtie, & l’inſolence ſont deux contraires, on ne les a iamais veuës mieux vnies qu’a fait dans la Preface l’Autheur pretendu des Pretieuſes Ridicules:	Dpuis que la modestie, et l'insolence sont deux contraires, on ne les a jamais vues mieux Tries qu'a fait dans la Préface l'Auteur prétendu des Pretieuses Ridicules:
Car ſi nous examinons ſes paroles, il ſemble qu’il ſoit aſſez mõdeſte pour craindre de faire meſtre ſon nom ſous la preſſe, cependant il cache ſous cette fauſſe vertu tout ce que l’inſolence a de plus effronté, & m'eſt.	Car si nous examinons ses paroles, il semble qu'il soit assez modeste pour craindre de faire mestre son nom sous la presse, cependant il cache sous cette fausse vertu tout ce que l'insolence a de plus effronté, et m'est.
ſur le theatre vne Satyre, qui quoy que ſous des images croteſques ne laiſſe pas de blaiſſer tous ceux qu’il a voulu accuſer;	sur le théâtre une Satire, qui quoi que sous des images crotesques ne laisse pas de blaisser tous ceux qu'il a voulu accuser;
il fait plus de Critique, il s’erige en luge, & condamne à la berne les Singes, ſans voir qu’il prononce vn Arreſt contre luy en le prononçant contre eux, puis qu’il eſt certain qu’il eſt Singe en tout ce qu’il fait, & que non ſeulement il a copié les Pretieuſes de Monſieur l’Abbé de Pure, ioüées par les ltaliens;	il fait plus de Critique, il s'erige en luge, et condamne à la berne les Singes, sans voir qu'il prononce un Arrêt contre lui en le prononçant contre eux, puis qu'il est certain qu'il est Singe en tout ce qu'il fait, et que non seulement il a copié les Pretieuses de Monsieur l'Abé de Pure, ioüées par les ltaliens;
Mais encore qu’il a imité par vne ſingerie, dont il eſt ſeul ca L able le Medecin volant, & pluſieurs autres pieces des meſmes Italiens qu’il n’imite pas ſeulement en ce qu’ils ont ioüé ſur leur theatre;	Mais encore qu'il a imité par une singerie, dont il est seul ca able le Médecin volant, et plusieurs autres pièces des mêmes Italiens qu'il n'imite pas seulement en ce qu'ils ont joué sur leur théâtre;
mais encor en leurs poſtures, cõtrefaiſant ſãs ceſſe ſurle ſien & Triuelin & Scaramoucheimais qu’atendre d’vn homme qui tire toute ſa gloire des Mémoires de Gillot-Gorgeu, qu’il a acheptez de ſa veufue, & dent il s’adopte tous les Ouurages.	mais encor en leurs postures, cõtrefaisant sans cesse surle sien et Trivelin et Scaramoucheimais qu'atendre d' Homme qui tire toute sa gloire des Moires de Gillot-Gorgeu, qu'il a cheptez de sa veuve, et dent il s'adopte tous les Ouvrages.
Mais c’eſt aſſez parler des Pretieuſes Ridicules, il eſt temps de dire vn mot des Vrayes, & tout ce quet'en diray, c’eſt ſeulement que ie leurs ay donné ce Nom, parce qu’elles parlent veritablement le langage qu’on attribuë aux Pretieuſes, & que ie n’ay pas pretendu par ce titre parler de ces perſonnes Illuſtres qui ſont trop au deſſus de la Satyre pour faire ſoupçonner que l’on ait deſſein de les y inſerer l’ay encore eu d’autres raiſons de les nommer ainſi;	Mais c'est assez parler des Pretieuses Ridicules, il est temps de dire int mot des Vraies, et tout ce quet-en dirai, c'est seulement que je leurs ai donné ce Nom, parce qu'elles parlent véritablement le langage qu'on attribue aux Prétieuses, et que je n'ai pas prétendu par ce titre parler de ces personnes Illustres qui sont trop au dessus de la Satyre pour faire soupçonner que l'on ait dessein de les y insérer l'ai encore eu d'autres raisons de les nommer ainsi;
qui n’eſtant connuës de pelſonne ne ſçauroient eſſie condamnées, que ſi l’on m’accuſe de condamner la Satyre, & pourtant d’en compoſer ie ne m’en defenderay pas icy, puis qu'elle eſt touſiours permiſe contre ceux qui font profeſſion de l’expoſer en public.	qui n'étant connues de pelsonne ne sauraient essie condamnées, que si l'on m'accuse de condamner la Satyre, et pourtant d'en composer Seigneur ne m'en défenderai pas ici, puis qu'elle est toujours permise contre ceux qui font profession de l'exposer en public.
Il ne peut plus reſter qu’vn ſcrupule dans l’eſprit du Lecteur:	Il ne peut plus rester qu'un scrupule dans l'esprit du Lecteur:
Sçauoir, pourquoy ie fais que mes Acteurs parlent tantoſt en inſencez, & tantoſt en gens tout à fait raiſonnables;	Savoir, pourquoi ainsi fais que mes Acteurs parlent tantôt en insencez, et tantôt en gens tout à fait raisonnables;
Mais qui examinera bien les Perſonnages qu’ils repreſentent, diſcernera’ aiſement que ce qu’ils diſent de juſte, c’eſt ſeulement par oüy dire, & qu’en ce qu’ils diſent d’eux-meſmes ls ne démentent point leurs caracters.	Mais qui examinera bien les Personnages qu'ils représentent, discernera aisément que ce qu'ils disent de juste, c'est seulement par ouï dire, et qu'en ce qu'ils disent d'eux-mêmes ls ne démentent point leurs caracters.
PERSONNAGES.	PERSONNAGES.
ARTEMISE.	ARTEMISE.
JPretieuſes.	JPretieuses.
ISCARIE.	ISCARIE.
LE BARON.	LE BARON.
de la Taupiniere.	de la Taupinière.
BEATRIX.	BEATRIX.
ſuiuante d’Artemiſe	suivante d'Artemise
ISABELLE.	ISABELLE.
ſuiuante d’Iſcarie.	suivante d'Iscarie.
FLANQVIN.	FLANQUIN.
valet de la raupiniere	valet de la ravpinière
PICOTIN.	PICOTIN.
Poëte.	Poète.
MONSIEVR.	MONSIEUR.
Greual Bourgeois voiſin d’Iſcarie.	Greubal Bourgeois voisin d'Iscarie.
La Scene eſt à Paris.	La Scène est à Paris.
LES VERITABLES PRETIEVSES COMEDIE	LES VÉRITABLES PRETIEUSES COMÉDIE
SCENE PREMIERE.	SCÈNE PREMIÈRE.
ISCARIE, ISABELLE,	ISCARIE, ISABELLE,
106 VE l’attente d’Artemiſe me cauſe de chagrin, ie ſuis la perſonne du monde la plus impatiente.	106 VE l'attente d'Artemise me cause de chagrin, ie suis la personne du monde la plus impatiente.
Allez luy dire que ie ſuis dans le dernier emportement de ne la point voir.	Allez lui dire que sans suis dans le dernier emportement de ne la point voir.
ISABELE.	ISABELE.
ie vais vous obeïr Madame, mais la voicy qui vient.	Ne vais vous obéir Madame, mais la voici qui vient.
SCENE II.	SCÈNE II.
ISCARIE, ARTEMISE.	ISCARIE, ARTEMISE.
BEATRIX, ISABELLE.	BEATRIX, ISABELLE.
ISCARIE.	ISCARIE.
I Rayment ma chere ie ſuis en numeur de pouſſer le dernier rude?	I Raiment ma chère ici suis en numeur de pousser le dernier rude?
contre vous.	contre vous.
13 vous n’auez guere d’exatitude meutre et dans vos promeſſes, le temps colere.	13 vous n'avez guère d'exatitude meutre et dans vos promesses, le temps colère.
a desja marqué deux pas?	a déjà marqué deux pas?
de.	de.
b Deux puis que ie vous attends.	 Beux puis que je vous attends.
ARTEMISE.	ARTEMISE.
Ah!	Ah!
ma chere il faut que vous ſçachiez qu’vn certain Marquis, m’eſt venu voir.	ma chère il faut que vous sachiez qu'un certain Marquis, m'est venu voir.
16	16
ISCARIE.	ISCARIE.
1 He!	1 He!
comment s’appelle-til A I ce Marquis	comment s'appelle-til A I ce Marquis
ARTEMISE.	ARTEMISE.
il s’appelle le Marquis de Mazarcantara, il ſçait tout à fait l’air de la ruëlle, c’eſt vn Galand de plein pied* qui s'explicque ſans aud Heſiter cune incertitude, a & ie n’ay iamais veu d’homme qui diſe les choſes plus congrüment.	il s'appelle le Marquis de Mazarcantara, il sait tout à fait l'air de la ruëlle, c'est un Galand de plein ied* qui s'explicque sans au Hésiter cune incertitude, à et un n'ai jamais vu d'homme qui dise les choses plus congrument.
I’ay pourtant remarqué vn deffaut en luy qui m’a penſé faie Rire.	J'ai pourtant remarqué un défaut en lui qui m'a pensé faye Rire.
re perdre mon ſerieux.	re perdre mon sérieux.
He quel!	He quel!
ISCARIE.	ISCARIE.
ARTEMISE.	ARTEMISE.
Il ne peut s’empeſcher de faire la reuerence en point d’Hongrie.	Il ne peut s'empêcher de faire la révérence en point d'Hongrie.
ISCARIE.	ISCARIE.
Ah!	Ah!
ma chere, il reſſemble donc au Marquis de Maſcarille,	ma chère, il ressemble donc au Marquis de Mascarille,
ARTEMISE.	ARTEMISE.
1G 4O SOR ce que vous dites, eſt vne verité toute purẽ.	1G 4O SOR ce que vous dites, est une vérité toute purence.
ISCARIE.	ISCARIE.
Ie croy que vous auez deſſein de faire bien des aſſauts d’appas, tie vous trouue dans voſtre bel aymable, 88 Bellel’inuinſible n’a pas encore gaſté l’æconomie de voſtre teſte, h vous ne fuſtes iamais n’a point mieux ſous les armes que vous desfriſé eſtes, que vos taſches aduantageuſes ſont bien placées, * i Habillee que vos graces donnent deſclat à voſtre col!	Je crois que vous avez dessein de faire bien des assauts d'appas, tye vous trouve dans votre bel aimable, 88 Belle inuinsible n'a pas encore gâté l'æconomie de votre tête, h vous ne fûtes jamais n'a point mieux sous les armes que vous défrisé êtes, que vos tâches avantageuses sont bien placées, * j' Abille que vos grâces donnent déclat à votre col!
& que les te m Coiffes nebres " qui enuironnent voſtre teſte releuent bien la blancheur de ce beau tout.	et que les te m Coiffes nébres " qui environnent votre tête relèvent bien la blancheur de ce beau tout.
ARTEMISE.	ARTEMISE.
Ah rma chere, vous faites trop de deſpence en beau diſcours* pour me dauber ſerieubelles cho:	Ah rama chère, vous faites trop de dépense en beau discours* pour me dauber serieubelles cho:
ſement;	sèment;
mais n’importe tout vous eſt licite & l’empire que me railler que vous auez ſur mon eſprit fait que ie n’excite pas mon fier contre vous.	mais n'importe tout vous est licite et l'empire que me railler que vous avez sur mon esprit fait que ie éexcite pas mon fier contre vous.
de me mets pas en colere.	de me mets pas en colère.
4 ISCARIE.	4 ISCARIE.
Ce que vous me dites-là eſt du dernier obligeant;	Ce que vous me dites-là est du dernier obligeant;
mais) ſi vous voulez que ie vous donne vn quart d’heure de diuertiſſement, entrons dans mon cabinet ie 4 Poulet.	mais) si vous voulez que ici vous donne un quart d'heure de divertissement, entrons dans mon cabinet jour 4 Poulet.
vous feray voir vn innocent?	vous ferai voir un innocent?
que l’on m’a enuoyé;	que l'on m'a envoyé;
dont l’encombrement du ſtil, eſt capable de faire changer l’aſſiette de voſtre ame.	dont l'encombrement du stil, est capable de faire changer l'assiette de votre âme.
11	11
T142I	T142I
SCENE III.	SCÈNE III.
BEATRIX, ISABELLE.	BEATRIX, ISABELLE.
BEATRIX.	BEATRIX.
ITES moy donc;	ITES -moi donc;
quelle langue eſt-ce que parlent nos Maiſtreſſes;	quelle langue est-ce que parlent nos Maîtresses;
ma foy ie n’entends point ce iargon & s’il faut qu’elles continuënt à parler de la ſorte, elles ſeront contraintes de nous donner vn Maiſtre pour apprendre ce langage & de nous remettre à labe.	ma foi ie n'entends point ce jargon et s'il faut qu'elles continuënt à parler de la sorte, elles seront contraintes de nous donner un Maître pour apprendre ce langage et de nous remettre à labe.
ISABELE.	ISABELE.
Que vous auez peu de lumiere & que voſtre eſprit eſt opaque.	Que vous avez peu de lumière et que votre esprit est opaque.
Eſt.	Est.
il poſſible !	il possible !
que vous ayez demeuré ſi long-temps chez vne Pretieuſe & que vous n’ayez pas encore pris aucune teinture de l’elegance de leur ſtile.	que vous ayez demeuré si longtemps chez une Pretieuse et que vous n'ayez pas encore pris aucune teinture de l'élégance de leur style.
BEATRIX.	BEATRIX.
Vous eſtes donc auſſi folles quelles à ce que ie voy, & vous affectez auſſi de dire des maux à longue queuë.	Vous êtes donc aussi folles quelles à ce que je vois, et vous affectez aussi de dire des maux à longue queue.
ISABELE.	ISABELE.
Ah!	Ah!
pleuſt à Dieu que ie puſſe eſtre l’inuentrice, comme ie ne ſuis que l’echo de ces maux graues & empoullez qui par vn ſens miſterieux eſtallent la vraye & pure ſignification des choſes.	pleut à Dieu que je pusse être l'inventrice, comme je ne suis que l'écho de ces maux graves et empoullez qui par un sens mystérieux estallent la vraie et pure signification des choses.
BEATRIX.	BEATRIX.
He:	He:
bien puiſque vous auez cetre penſée I’enuie me prend de diſputer contre vous:	bien puisque vous avez cetre pensée J'envie me prend de disputer contre vous:
auſſi bien puiſque ce langage n’eſt inuenté que par la fantaiſie de certaines femmes, vne femme peut bien diſputer contre ſans que cela paroiſſe extraordinaire, & pour vous monſtrer qu’il n’y a 4 rien de plus extrauagant que cette façon de parler, ie m’en vais vous dire de certains mots que i’ay retenus qui choquent tout à fait noſtre langue naturelle.	aussi bien puisque ce langage n'est inventé que par la fantaisie de certaines femmes, une femme peut bien disputer contre sans que cela paraisse extraordinaire, et pour vous montrer qu'il n'y a 4 rien de plus extravagant que cette façon de parler, sans m'en vais vous dire de certains mots que j'ai retenus qui choquent tout à fait quelque langue naturelle.
ISABELE.	ISABELE.
Voſtre engagement eſt inconſideré;	Votre engagement est inconsidéré;
mais i’ay aſſez d’indulgence pour vous tirer de l’erreur ou vous a precipité l’eſpaiſſeur de voſtre eſprit.	mais j'ai assez d'indulgence pour vous tirer de l'erreur ou vous a précipité l'épaisseur de votre esprit.
BEATRIX.	BEATRIX.
Bon, ie ſuis rauie que vous ayés des indulgences chés vous, i’auais fait deſſein d’en aller querir à Rome;	Bon, Seigneur suis ravie que vous ayez des indulgences chez -vous, j'avais fait dessein d'en aller quérir à Rome;
mais vous m’eſpargnez cette peine.	mais vous m'épargnez cette peine.
ISABELE.	ISABELE.
Voila vne ſuperfluité dite à contre-temps, ve nez à voſtre diſpute & n’alambiquez Ipoint mon eſprit de fadaiſes.	Voilà votre superfluité dite à contretemps, us à votre dispute et n'alambiquez Ipoint mon esprit de fadaises.
24 BEATRIX.	24 BEATRIX.
Sça dites moy!	Sa dites -moi!
sil y a rien de plus ridicule que de nommer vn lauement le boüillon desdeux ſœurs.	sil y a rien de plus ridicule que de nommer un lavement le boüillon dédeux sœurs.
Aton iamais ouy dire qu’vn Medecin eſt vn Baſtard d’Hypocrate:	Atton jamais ouï dire qu'une Médecin est un Bâtard d'Hypocrate:
Voyla bien honorer la Medecine ma foy & c’eſt là le moyen d’encourager ces Meſſieurs les Medecins à nous tirer des bras du vieil reſueur ou pluſtoſt de l’Empire de Morphée, ou pour mieux m’expliquer du lict, à qui vos ſçauantes ont donné ces noms.	Voilà bien honorer la Médecine ma foi et c'est là le moyen d'encourager ces Messieurs les Médecins à nous tirer des bras du vieil rêveur ou plutôt de l'Empire de Morphée, ou pour mieux m'expliquer du lit, à qui vos Savantes ont donné ces noms.
C’eſt encore aſſez bien debutter que de nommer les pieds, les chers ſouffrans, le boire le cher neceſſaire & d’appeller le potagé l’vnion des deux Elemens, A quoy bon i toutes ces obſcuritez, & pourquoy dire en quatre mots ce que nous diſons en deux.	C'est encore assez bien débutter que de nommer les pieds, les chers souffrants, le boire le cher nécessaire et d'appeler le potagé l'union des deux Éléments, A quoi bon j' toutes ces obscurités, et pourquoi dire en quatre mots ce que nous disons en deux.
Eſt-ce qu’il ne ſeroit pas mieux dit, ſoufflez ce feu?	Est-ce qu'il ne serait pas mieux dit, soufflez ce feu?
que, excitez cet Element combuſtible?	que, excitez cet Élément combustible?
donnez moy du pain que, apportez le ſoutien de la vie, voyla vne maiſon que, de dire voyla vne garde neceſſaire, & ſeriez vous bien aſſez opiniaſtre pour me vouloir ſouſtenir que le pot de chambre que vous nommez lurinal virginal, l’eſt encorre, quand les filles & les garçons ont donné dans l’amour permis, qui eſt ſelon le langage de vos Pretieuſes le mariage.	donnez -moi du pain que, apportez le soutien de la vie, voilà été maison que, de dire voilà une garde nécessaire, et seriez vous bien assez opiniâtre pour me vouloir soutenir que le pot de chambre que vous nommez lurinal virginal, l'est encor, quand les filles et les garçons ont donné dans l'amour permis, qui est selon le langage de vos Plieuses le mariage.
61	61
ISABELLE.	ISABELLE.
En verité voſtre deſor.	En vérité votre désor.
dre eſt terrible & me jette dans vne ſouffrance inconceuable.	dre est terrible et me jette dans une souffrance inconcable.
BEATRIX.	BEATRIX.
Il n’eſt pas encorre temps de m’interompre & ie n’ay pas encorre finy.	Il n'est pas encorre temps de m'intérompre et ici n'ai pas encorre fini.
ISABELLE.	ISABELLE.
Pourſuiuez done & rendez viſte voſtre diſcours complet.	Poursuivez donce et rendez vite votre discours complet.
BEATRIX.	BEATRIX.
Ie vous dis encor, que quoy que vous puiſſiez dire, qu’il n’y à rien de plus inſupportable que de nommer les dents vn ameublement de bouche & de dire, pour faire voir que l’on a long-temps balancé à faire vne choſe, qu’il eſt monté des incertitudes à la gorge.	Je vous dis encor, que quoi que vous puissiez dire, qu'il n'y a rien de plus insupportable que de nommer les dents un ameublement de bouche et de dire, pour faire voir que l'on a longtemps balancé à faire une chose, qu'il est monté des incertitudes à la gorge.
Dîtes moy!	Dîtes -moi!
vn peu, y a-t’il aucun ſens à cela, non plus que de dire qu’vne femme a des abſences de raiſon pour explicquer quelle eſt jeune, & dites moy enfin s’il y a rien de plus extrauagant que d’appeller des traiſtres, les Parauants, le Miroir vn Peintre de la dernierre fidellité, vn Eſuantail vn Zephir, & vne Porte la fidelle gardienne.	un peu, y a-t-il aucun sens à cela, non plus que de dire qu'une femme a des absences de raison pour explicquer quelle est jeune, et dites moi enfin il y a rien de plus extravagant que d'appeler des traîtres, les Paravants, le Miroir un Peintre de la dernierre fidélité, un Esuantail é Zephir, et une Porte la fidèle gardienne.
Si par hazard vn Ialoux qui auroit fermé vne porte ſus ſa femme & en auroit la clef eſtoit trompé par vn Galand qui en auroit vne fauſſe, doitil!	Si par hasard un Jaloux qui aurait fermé une porte sus sa femme et en aurait la clef était trompé par un Galant qui en aurait une fausse, doitil!
venant à ſçauoir la choſe appeller encorre la porte la fidelle gardienne.	venant à savoir la chose appeler encor la porte la fidèle gardienne.
Ie pourois vous en dire encor quantité;	Je pourrais vous en dire encor quantité;
mais ie meſpriſe ſi fort cette façon de parler que ie ne m’en ſçaurois donner la peine.	mais été méprise si fort cette façon de parler que je ne m'en saurais donner la peine.
ISABELLE.	ISABELLE.
Ah!	Ah!
ie vais bien vous monſtrer mais voicy Flanquin, le Pretieux.	On vais bien vous montrer mais voici Flanquin, le Prétieux.
BEATRIX.	BEATRIX.
le va let du Baron de la Taupiniere ui vous fait les doux yeux eſt donc auſſi de ce nombre.	le va let du Baron de la Taupinière ui vous fait les doux yeux est donc aussi de ce nombre.
Vraiment il merite qu’on l’eſooute & c’eſt vne choſe aſſez diuertiſſante à mon auis, que d’entendre vn valet parler pre.	Vraiment il mérite qu'on l'éooute et c'est une chose assez divertissante à mon avis, que d'entendre un valet parler pré.
tieux.	tieux.
SCENE ISABELLE, BEATRIX FLANQVIN,	SCÈNE ISABELLE, BEATRIX FLANQUIN,
FLANQVIN.	FLANQUIN.
H!	H!
ma chere, ma toute Y aymable, que ie ſuis heureux de vous voir.	ma chère, ma toute Y aimable, que tu suis heureux de vous voir.
ISABELLE.	ISABELLE.
Qui t’ameine icy.	Qui t'amène ici.
FLAN 10 Ie viens ſçauoir ſi voſtre Maiſtreſſe eſt en pouuoir de receuoir viſite.	FLAN 10 Je viens savoir si votre Maîtresse est en pouvoir de recevoir visite.
B iii	 Biji
ISABELLE.	ISABELLE.
Ie m’en vais m’en inſtruire & dans peu m’a, reſponce deſembaraſſera ton ame de cette affaire.	Je m'en vais m'en instruire et dans peu m'a, réponce désembarrassera ton âme de cette affaire.
elle ſort.	elle sort.
FLANQVIN.	FLANQUIN.
Il faut auoüer, que la methode de s’exprimer dont on le ſert maintenant eſt vne choſe qui ſert merueilleuſement à nous diſtinguer du commun, & eſt tout à fait deſgagée de la matierre, & à dire le vray, c’eſt quelque choſe de bien ſatisfaiſant de pouuoir fendre la preſſe, & de faire quelque nombre parmy les gens canoniſez dans les ruëlles.	Il faut auoüer, que la méthode de s'exprimer dont on le sert maintenant est une chose qui sert merveilleusement à nous distinguer du commun, et est tout à fait dégagée de la matierre, et à dire le vrai, c'est quelque chose de bien satisfaisant de pouvoir fendre la presse, et de faire quelque nombre mi les gens canonisez dans les ruëlles.
BEATRIX.	BEATRIX.
Tirez moy d’erreur, ce que vous me venez de dire, n’eſt-ce point vn compliment que voſtre maiſtre a compoſé pour dire en quelque ruëlle & dont vous auez leu le broüillon.	Tirez moi d'erreur, ce que vous me venez de dire, n'est-ce point un compliment que votre maître a composé pour dire en quelque ruelle et dont vous avez le le brouillon.
FIARQVIN.	FIARQUIN.
Ie vois bièujuorous neſtes pas encorre inſtruitte de ce que ie vaux, & que la pauureté de mes habits vous fait juger à mon deſauentage de celle de mes penſées;	Je vois bièujuorous nêtes pas encor instruite de ce que je vaux, et que la pauvreté de mes habits vous fait juger à mon désaventage de celle de mes pensées;
Iſabelle rentre, mais ie vous deperſuaderay vne autre fois.	Isabelle rentre, mais ainsi vous dépersuaderai une autre fois.
Voicy l’anthouſiaſme de mes yeux, l’aymant de mon Cœur, en vn mot mon vnique;	Voici l'anthousiasme de mes yeux, l'aimant de mon Cœur, en un mot mon unique;
il faut que ie luy faſſe connoiſtre qu’elle m’encapuci-.	il faut que ie cy fasse connaître qu'elle m'encapuci-.
Quelle ne l’ame & qu’elle m’en cen- m’enfadre le Cœur.	Quelle ne l'âme et qu'elle m'en cen- c'enfadre le Cœur.
ISABELLE.	ISABELLE.
Ton maiſtre viendra quand il luy plaira.	Ton maître viendra quand il lui plaira.
FLANQVIN.	FLANQUIN.
Ah mon ange ;	Ah mon ange ;
que vous auez bien fait de rapporter en ce lieu le merite qui s’en eſtoit eſloigné, que nous auions beſoin dans l’opacité de cette ſalle, que vos yeux vinſſent ſeruir de ſupplement au Soleil:	que vous avez bien fait de rapporter en ce lieu le mérite qui s'en était éloigné, que nous avions besoin dans l'opacité de cette salle, que vos yeux vinssent servir de supplément au Soleil:
non que leurs chaleurs ne reduiſent mon corps à vne ſechereſſe qui m’apprend qu’vn bain interieur me ſeroit fort vtille.	non que leurs chaleurs ne réduisent mon corps à une sécheresse qui m'apprend qu'un bain intérieur me serait fort utille.
BEATRIX.	BEATRIX.
La pla ſante façon de demander à boi re.	La pla santé façon de demander à boy re.
0 2	0 2
FLANQVIN.	FLANQUIN.
Ouy, vn bain interieur ou l’agrement donné entre les deux ſœurs,:	Oui, un bain intérieur ou l'agrément donné entre les deux sœurs,:
peuuent maintenant empeſcher la metempſicoſe de mon ame, qui va bientoſt s’emanciper de ſa demeure, ſi l’on ne la ſecoure par l’vn de ſes remedes, ou ſi vous ne ſouffrez que ie gouſte auec vous la volupté de l’amour permis.	peuvent maintenant empêcher la métempsycose de mon âme, qui va bientôt s'émanciper de sa demeure, si l'on ne la secoure par l'un de ses remèdes, ou si vous ne souffrez que je goûte avec vous la volupté de l'amour permis.
ISABELLE.	ISABELLE.
Voyez!	Voyez!
ma compagne, qu’il a bien ſuccé tout ce que la Carte de Cocquetterie luy a pû d’ogmatiſer de tendreſſe.	ma compagne, qu'il a bien succé tout ce que la Carte de Cocquetterie toujours a pu d'ogmatiser de tendresse.
FLANQVIN.	FLANQUIN.
oy;	oi;
point quartier ny de treuue, touſiours, cette iuppe modeſte m’empeſchera de contempl 8 Cete la friponne.	point quartier rien de trouve, toujours, cette juppe modeste m'empêchera de contempl 8 Cette la friponne.
v.	v.
BEATRIX Ce n’eſt pas vne petite io de deſſous de voir vn valet pretieux fa l’amour.	BEATRIX Ce n'est pas une petite jo de dessous de voir un valet prétieux fa l'amour.
101	101
ISABELLE.	ISABELLE.
Vraiment ve eſtes aujourd’huy ſas voſ grand fecond.	Vraiment ve êtes aujourd'hui sas vos grand fécond.
FLANQVIN.	FLANQUIN.
Il eſt vray, n’en fineſſeray point auec vous, mõn eſtime eſt trop ſuperlatiue à voſtre eſgard pour ne pas tranſiger auec vous d’vne verité conſtante, qui eſt, que mon cœur eſt en frangé ( troubles, mouuemens.	Il est vrai, n'en finesserai point avec vous, mõn estime est trop superlative à votre égard pour ne pas transiger avec vous d'une vérité constante, qui est, que mon cœur est en frangé ( troubles, mouvements.
FLANQVIN.	FLANQUIN.
Il faut tomber d’accord, qu l’amour a terriblement delfriché y voſtre cœur.	Il faut tomber d'accord, qu 'amour a terriblement delfriché y votre cœur.
ISABELE.	ISABELE.
O O 100163 n’auroit il point deffriché le voſtre, mais que i’aplique la reflexion de ma bouche ſur cette belle mouuante.	Ô Ô 100163 n'aurait il point défriché le vôtre, mais que j'applique la réflexion de ma bouche sur cette belle mouvante.
* Ah Dieu, faut-il 12 Main qu’vn gand du dernier fendu me faſſe vn ſi outrageant ob- & Couppé ſtacle.	* Ah Dieu, faut-il 12 Main qu'Han nand du dernier fendu me fasse un si outrageant ob- et Coupé stacle.
Ouffe vne de vos ſenſuës ma picqué extremement peu.	Ouffe une de vos sensues ma piqué extrêmement peu.
VOu.	VOu.
BEATRIX.	BEATRIX.
La droſle de ſenſue qu’vne épingle.	La drôle de sensue qu'une épingle.
FLANQUIN.	FLANQUIN.
Mais ie m’oublie à l’oppoſite de vos appas que la lenteur de mes chers ſouffrans, peut faire boüillonner le benin cerueau de mon Maiſtre.	Mais ici m'oublie à l'opposite de vos appas que la lenteur de mes chers souffrants, peut faire bouillonner le bénin cerveau de mon Maître.
Ie m’en vais donc faire faire diette à mes yeux de leurs aſtres careraires.	Je m'en vais donc faire faire diette à mes yeux de leurs astres careraires.
ISABELLE.	ISABELLE.
Ie partiray beaucoup par le contrecoup de ce quittement.	Je partirai beaucoup par le contrecoup de ce quittement.
BEATRIX.	BEATRIX.
Adieu beau Pretieux.	Adieu beau Pretieux.
FLANQVIN.	FLANQUIN.
Adieu l’hetheroclite du beau langage.	Adieu l'héthéroclite du beau langage.
SCENE V.	SCÈNE V.
ARTEMISE, ISCARIE, BEATRIX, ISABELLE.	ARTEMISE, ISCARIE, BEATRIX, ISABELLE.
Anlerlhrone tenant vn papier à la main.	Anlerléone tenant un papier à la main.
Velle!	Velle!
pauureté ma chere, il n’y a pas vne choſe raiſonnable la dedans.	pauvreté ma chère, il n'y a pas une chose raisonnable la dedans.
ISCARIE.	ISCARIE.
Ah!	Ah!
pour moy, c’eſt l’effroy des effrois, & il faut que ie vous auoüe que les b Que bras m’en tombent.	pour moi, c'est l'effroi des effrois, et il faut que je vous auoüe que les b Que bras m'en tombent.
* Quoy Scander cinq ou ſix Stances ſans y trouuër vn mot de pompeuſe meſure.	* Quoi Scander cinq ou six Stances sans y trouver un mot de pompeuse mesure.
ARTEMISE.	ARTEMISE.
Il eſt vray que cela n’eſt point digerable, & ſus tout la penultieſme ou auant derniere Stance de cet inſuportable portrait ne fournit rien à l’oreille qui puiſſe exercer ſon auidité.	Il est vrai que cela n'est point digérable, et sus tout la penultiesme ou avant dernière Stance de cet insuportable portrait ne fournit rien à l'oreille qui puisse exercer son avidité.
Voyez plutoſt encore vne foisſi cela n’eſt pas du dernier inintelligible.	Voyez plutôt encore une foissy cela n'est pas du dernier inintelligible.
ISCARIE.	ISCARIE.
prenant le papier.	prenant le papier.
ARTEMISE.	ARTEMISE.
Liſez donc.	Lisez donc.
SCARIE.	SACRIE.
lit.	lit.
Puis lors que ton pinceau d'vne legere touche Aura tracé ſes yeux, tu traceras ſa bouche;	Puis lors que ton pinceau d'une légère touche Aura tracé ses yeux, tu traceras sa bouche;
Là d’vn doux coloris, l’agreable rougeur Par ſa viuacité dementira la roſe, & s’il y manque quelque choſe Pouren peindre l’eſclat tu prendras mon ardeur.	Là d'un doux coloris, l'agréable rougeur Par sa vivacité démentira la rose, et s'il y manque quelque chose Pouren peindre l'éclat tu prendras mon ardeur.
Elle pourfuit.	Elle poursuit.
Peut-on voir des vers plus indigeſtes, & ne connoiſt on pãs bien à les voir que la ſeuerité des capables n’y a pas paſſé, & que ce petit vers qui menace de la fin pourre ſeul gaſter le plus bel ouur ge, Ahi ne m’auouërez voi pas que ceux.	Peut-on voir des vers plus indigestes, et ne connaît on pans bien à les voir que la sévérité des capables n'y a pas passé, et que ce petit vers qui menace de la fin pourre seul gâter le plus bel ouvr gé, Ahi ne m'avouerez pas que ceux.
cy qui dépeigne le langage des beaux yeux d’v belle, ont toute vne au pompe.	cy qui dépeigne le langage des beaux yeux d'une, ont toute une au pompe.
Elle lit.	Elle lit.
Par vne auidité qui tient de diuine, Ele chante par tout qu’elle eſt origine;	Par une auidité qui tient de divine, Éle chante par tout qu'elle est origine;
Son langage pourtant, n’a rien !	Son langage pourtant, n'a rien !
de muët, Ses ſourcilleux ardens font tout ſes Harangues, Elle brane auecque eux les plus na pides langues, Et leurs ſeuls branſlemens compe ſent ſon caguet.	de muet, Ses sourcilleux ardents font tout ses Harangues, Elle brane auecque eux les plus na pides langues, Et leurs seuls branslemens compe sent son caguet.
Pour moy, ie ſuis pour o ſortes de vers qui s’eſloignent du vulgaire;	Pour moi, Seigneur suis pour ô sortes de vers qui s'éloignent du vulgaire;
mais nous contemplerons le reſte à loiſir:	mais nous contemplerons le reste à loisir:
car voicy Monſieur le Baron.	car voici Monsieur le Baron.
SCENE VI.	SCÈNE VI.
LE BARON DE LA TAV PINIERE, ISCARIE.	LE BARON DE LA TAU PINIÈRE, ISCARIE.
ARTEMISE, ISABELLE, BEATRIX.	ARTEMISE, ISABELLE, BEATRIX.
LE BARON les ſalüant.	LE BARON les salant.
JOus aurez ſujet, mes Dames, de trouuer mon pro cedé audacieux;	JOus aurez sujet, mes Dames, de trouver mon pro cédé audacieux;
mais il eſt bien difficile de ne pas viſiter ſouuent l’extrait de l’eſprit hu main.	mais il est bien difficile de ne pas visiter souvent l'extrait de l'esprit hu main.
ISCARIE.	ISCARIE.
Al Monſieur, c’eſt nous mett trop auant dans le rang fauo.	Al Monsieur, c'est nous mett trop avant dans le rang favo.
de voſtre penſée, & nous ſon mes trop ſenſibles à la gratitude de vos termes de ruelles.	de votre pensée, et nous son mes trop sensibles à la gratitude de vos termes de ruelles.
LE BARON.	LE BARON.
Ce n’eſt pas d’auiourd’huy que ie ſçais que vous faites les enoſes iuſtes aimablement, * que vous poſſedez entierement le vent du Bufeau, & que deuait vous les plus beaux eſprits ne ſçauroient faire feu.	Ce n'est pas d'aujourd'hui que sans sçais que vous faites les enoses justes aimablement, * que vous possédez entièrement le vent du Bufeau, et que devait vous les plus beaux esprits ne sauraient faire feu.
2	2
ARTEMISE.	ARTEMISE.
Voſtre loüange ſe diſtancie trop de noſtre merite, pour hazarder le paquet ſerieuxs con-f lescstre vous	Votre louange se distancie trop de notre mérite, pour hasarder le paquet serieuxs conf lescstre vous
ISCARIE.	ISCARIE.
Ma commune,	Ma commune,
ISABELE.	ISABELE.
plaiſt-il, Madame	plaît-il, Madame
ISABELE.	ISABELE.
Fourniſſez nous icy les thre nes de la ruelle.	Fournissez nous ici les thre nés de la ruelle.
Iſabelle aporte des fauteüils.	Isabelle apporte des fauteüils.
ARTEMISE.	ARTEMISE.
I aciſez- Monſieur, prenez figure!	I acisez- Monsieur, prenez figure!
vons.	vons.
vous plaiſt.	vous plaît.
Ils s’aßiſent tous.	Ils s'assent tous.
LE BARON.	LE BARON.
Aue vous grande foule d’Alcoui ſtes * chez vous!	Ave -vous grande foule d'Alcoui sites * chez vous!
qui preſide qui eſt de quartier:	qui préside qui est de quartier:
ISABELE.	ISABELE.
EMG No en auons pluſieurs, & de m Galan-vieille roche, meſme des fem.	ÉMG No en avons plusieurs, et de m Galan-vieille roche, même des sem.
mes de la petite yertu;	mes de la petite yertu;
„ & que que nous ayons quelques diſeuſes de pas vray, nous n’auons point de ces diſeuſes d’inutilitez ,?	 et et que nous ayons quelques diseuses de pas vrai, nous n'avons point de ces diseuses d'inutilité ,?
qui ignorent la force des mots le friand du gouſt.	qui ignorent la force des mots le friand du goût.
LE DHRON.	LE DHRON.
Sans doute quantité de celles qui vous viennent voir, vous ſer-p Sont uent uomnouene;	Sans doute quantité de celles qui vous viennent voir, vous ser-p Sont uent uomnouene;
& l’on y en pourroit trouuer auſſi dont la vous.	et l'on y en pourrait trouver aussi dont la vous.
neige du viſage ſe fond.	neige du visage se fond.
ARTEMISES.	ARTEMISES.
Il eſt vray que l’on y en pourroit trouuer qui luſtrent leur viſage;	Il est vrai que l'on y en pourrait trouver qui lustrent leur visage;
mais outre que cel.	mais outre que cel.
Qui ſe les-là ſont graues par leur anti- fardent.	Qui se les-là sont graves par leur anti- fardent.
quité, les trouppes auxiliaires de leur eſprit ſoûtiennent aſſez leurs ambiguitez d’appas.	quité, les troupes auxiliaires de leur esprit soutiennent assez leurs ambiguïté d'appas.
LE BARON.	LE BARON.
Il faut auoüer, mes Dames, qu’il y a grand p ſir à faire figure dans le me f A eſtre de!	Il faut auoüer, mes Dames, qu'il y a grand p sir à faire figure dans le me f Ames de!
atune.	atune.
ISCARIE.	ISCARIE.
Vous l’y faite ſans doute bien auantageu ment, puis que vous auez mil liures de rente en fonds d' prit, qu’aucun creancier ne pe ſaiſir ny arreſter.	Vous l'y faite sans doute bien avantageu ment, puis que vous avez mil livres de rente en fonds d' prit, qu'aucun créancier ne pe saisir ainsi arrêter.
11	11
LE BARON.	LE BARON.
ILITET De grace arreſtér-là ce diſcours ot geant:	ILITET De grâce arrêter-là ce discours ot géant:
car ie.	car On.
mẽ verrois rẽdu dans l’incapacité de vous l pondre;	mien verrais rẽdu dans l'incapacité de vous l' pondre;
mais i’oubliois à ve dire qu’vn de mes amis m amené ce matin vn certain Pe te nouueau qui fait dés ve ſcientifiquement bien, & com me il auoit deux pieces à me e, ie luy ay promis de l’écouer, apres auoir donné à nature es neceſſitez meridionnalles.	mais j'oubliais à ve dire qu'un de mes amis m amené ce matin un certain e te nouveau qui fait dès ve scientifiquement bien, et com me il avait deux pièces à me eût, ie tu ai promis de l'écouer, après avoir donné à nature es nécessités méridionnalles.
lanquin le doit conduire icy es qu’il ſera venu, afin que ious prenions enſemble les exaſiens diuertiſſemens de cette ecture.	lanquin le doit conduire ici es qu'il sera venu, afin que jous prenions ensemble les exasiens divertissements de cette ecture.
ISCARIE.	ISCARIE.
Ma chere, & moy, aimons demeſurement les Poëſmes Dramatiques, que nous ne trouuons point de paroles aſſez energiques pour vous rendre les graces conformes à vne obligation qui eſt dans vn degré mperlatif.	Ma chère, et moi, aimons démesurément les Poèmes Dramatiques, que nous ne trouvons point de paroles assez énergiques pour vous rendre les grâces conformes à une obligation qui est dans un degré mperlatif.
naun en 1	naun en 1
LE BARON.	LE BARON.
Ce diſcours contiuë à me faire voir la magnifiue éleuation de voſtre eſprit.	Ce discours contive à me faire voir la magnifive élévation de votre esprit.
Mais à propos, ie fus il y a que que temps chez Madame que dites-vous d’elle!	Mais à propos, Seigneur fus il y a que que temps chez Madame que dites-vous d'elle!
ARTEMISE.	ARTEMISE.
C’eſt vne perſonne qui a des lumieres eſloignées.	C'est assez personne qui a des lumières éloignées.
ISGARIE.	ISGARIE.
Pour moyie tiens qu’elle a l’ame mal deQu'elle meurée.	Pour moyie tiens qu'elle a l'âme mal deQuelle meurée.
LE BARON.	LE BARON.
Et moy ie n ſçay qu’en croire, il y a quai tité de gens qui tiennent qu' le a vn œuf caché ſous la ce ſont partialiſez là deſſus vous deuez au moins auouër qu’elle a les miroirs de l’ame fort doux,* la bouche bien façonnee, *qu’elle eſt d’vne vertu a Belleſeuere, & qu’elle articule nen ſa voix.	Et moi quelque grande né qu'en croire, il y a quai tité de gens qui tiennent qu' elle a un œuf caché sous la ce sont partialisez là dessus vous devez au moins avouer qu'elle a les miroirs de l'âme fort doux,* la bouche bien façonnée, *quelle est d'une vertu a Belleseuere, et qu'elle articule nen sa voix.
ISCARIE.	ISCARIE.
Mais, ce qui eſt de plus faſcheux c’eſt qu’elle eſt vnie à vn inquiet,?	Mais, ce qui est de plus fâcheux c'est qu'elle est unie à un inquiet,?
& qu’el- me d’afle eſt de la petite portion.	et qu'ell- me d'affle est de la petite portion.
e	Je
LE BABON!	LE BABON!
Ie voudrois bien la voir icy;	Je voudrais bien la voir ici;
car ie ne l’ay iamais veuë qu’auec l’inſtrument de la curioſité ſur le viſage.	car ie ne l'ai jamais vue qu'avec l'instrument de la curiosité sur le visage.
ISCARIE.	ISCARIE.
LL C’eſt vne choſe qui eſt de la derniere impoſſibilité, car elle reſſent à preſent les contrecoups de la vo8 Ea cou.	LL C'est assez chose qui est de la dernière impossibilité, car elle ressent à présent les contrecoups de la vo8 Éa cou.
lupté permiſes.	lupté permises.
8	8
LE BARON.	LE BARON.
Mais, il me ſemble que noſtre Poëte deuroit eſtre icy, puis que i’ay ordonné qu’on l’amena dans mes quatres corniches tirée par deux de mes pluches.	Mais, il me semble que notre Poète devrait être ici, puis que j'ai ordonné qu'on l'amena dans mes quatres corniches tirée par deux de mes pluches.
ARTEMISE.	ARTEMISE.
Vous n’auez pas mal fait, car le troiſieſme Elementi qui tombe ſur l’eminen* Les pa-deſgrés, * l’auroit fait d’vn illuſtre vn Poëte crotté.	Vous n'avez pas mal fait, car le troisième Élémenti qui tombe sur l'eminen* Les pa-desgrés, * l'aurait fait d'un illustre un Poète crotté.
ISCARIE.	ISCARIE.
Ce Poëte n’eſt donc pas Normand puis qu’il n’a point de Caroſſe.	Ce Poète n'est donc pas Normand puis qu'il n'a point de Carosse.
LE BARON.	LE BARON.
on fait parler le muet, ſans doute le voycy.	on fait parler le muet, sans doute le voici.
lOn heurOuy c’eſt luy meſme que Flanquin ameine.	LOn heurOui c'est lui même que Flanquin âme.
SCENEVII.	SCENEVII.
LE BARON DE LA TAV PINIERE, ISCARIE, ARTEMISE.	LE BARON DE LA TAU PINIÈRE, ISCARIE, ARTEMISE.
ISABELLE, BEATRIX, FLANQVIN LE POETE.	ISABELLE, BEATRIX, FLANQUIN LE POTE.
LE POETE.	LE POTE.
Hi vrayment Monſieur, ie feray chanter à ma Callioppe en vers bien montez, & d’vne veine bien guindée, les remerciemens que ie vous dois de l’heureuſe & ineſperée connoiſſance que vous me prò curez de ces deux diuinitez charmereſſes dont les beaux yeux vont eſclairer mon eſprit & embraſer mon vranie, d’vn feu plus deuorant, que n’eſt celuy de ce mont ſi renommé dans la Sicile, où le vieux Boiteux tenoit iadis ſa forge, & bien plus en doctrinant que celuy qu’Appollon inſpire aux neuf ſœurs.	Hi vraiment Monsieur, je ferai chanter à ma Calioppe en vers bien montez, et d'une veine bien guindée, les remerciements que je vous dois de l'heureuse et inespérée connaissance que vous me près curez de ces deux divinités charmeresses dont les beaux yeux vont éclairer mon esprit et embraser mon vranie, d'un feu plus dévorant, que n'est celui de ce mont si renommé dans la Sicile, où le vieux Boit tenoit jadis sa forge, et bien plus en doctrinant que celui qu'Apollon inspire aux neuf sœurs.
ISCARIE.	ISCARIE.
On connoiſt bien !	On connaît bien !
Monſieur, que vous auez à commandement l’eau d’Hhypocrenne, & que vous eſtes le frere aiſné des neuf ſœurs.	Monsieur, que vous avez à commandement l'eau d'Hypocrenne, et que vous êtes le frère aisné des neuf sœurs.
ARTEMISE.	ARTEMISE.
Ie vous l’auoüeray, ie n’ay iamais ouy de ſtile plus pompeux & qui faſſe plus de	Je vous l'auoüeray, Seigneur n'ai jamais oui de style plus pompeux et qui fasse plus de
4 tour dans l’oreille que le voſtre.	4 tour dans l'oreille que le vôtre.
LE POETE.	LE POTE.
Ie ſçais parler emphibologetiquement:	Je sais parler emphibologétiquement:
le langagé des Dieux m’eſt ordinaire, & ie ne me plains point quand on me dit que l’on ne m’entends pas;	le langagé des Dieux m'est ordinaire, et un ne me plains point quand on me dit que l'on ne m'entends pas;
car c’eſt ſigne que ie parle en oracle.	car c'est signe que ici parle en oracle.
Ils s’aſſiſſent FLANQVIN.	Ils s'assissent FLANQUIN.
ſe mettant en vn coin.	se mettant en un coin.
Moy, ie m’en vais me mettre icy pour faire inuentaire des grands mots qui ſe diront.	Moi, Seigneur m'en vais me mettre ici pour faire inventaire des grands mots qui se diront.
Sça, n’en laiſſons point paſſer qu’ils ne ſoient enregiſtrez ſut nos Tablettes & ioüons bien noſtre rolle.	Sa, n'en laissons point passer qu'ils ne soient enregistrez sut nos Tablettes et jouons bien notre rolle.
LE BARON.	LE BARON.
Dites nous donc vn peu !	Dites nous donc un peu !
Monſieur au net, voſtre ſentiment ſur les pieces qui ſe ſont joüées depuis peu de temps;	Monsieur au net, votre sentiment sur les pièces qui se sont jouées depuis peu de temps;
car i’en ay fort peu veu :	car j'en ai fort peu vu :
meſme ie fus l’autre iour aux Pretieuſes de Bourbon;	même autres fus l'autre jour aux Prétieuses de Bourbon;
mais ie ne les pûs entendre parce que ie ne pouuois reigler aucune poſtu10.	mais ici ne les pu entendre parce que je ne pouvais rigler aucune postu10.
n	n
FLANQVIN.	FLANQUIN.
Bon, en voyla vn.	Bon, en voilà un.
LE BARGN.	LE BARGN.
Pour ce qui eſt des Pretieuſes, comme ce n’eſt qu’vn Ouurage en Proſe, ie vous en diray mon ſentiment en peu de mots.	Pour ce qui est des Prétieuses, comme ce n'est qu'un Ouvrage en Prose, toujours vous en dirai mon sentiment en peu de mots.
Premierement il faut que vous ſçachiez qu’elle eſt plus aagée de trois ans que l’on ne penſe, & que des ce temps.	Premièrement il faut que vous sachiez qu'elle est plus aagée de trois ans que l'on ne pense, et que des ce temps.
là les Comediens Italiens, y gagnerent dix mil eſcus, & cela ſans faire courre le billet, comme les Bourbonnois en ont amené la couſtume.	là les Comédients Italiens, y gagnèrent dix mil écus, et cela sans faire courre le billet, comme les Bourbonnais en ont amené la coutume.
LA BARON.	LA BARON.
Le bruit commun m’a deſia dõné quelque legere connoiſſance de cela;	Le bruit commun m'a déjà donneré quelque légère connaissance de cela;
mais Maſcarille pourtant ſoûtient n’auoir imité en rien celle des Iraliens.	mais Mascarille pourtant soutient n'avoir imité en rien celle des Jraliens.
LE POETE.	LE POTE.
Ah!	Ah!
que dites-vous là, c’eſt la meſme choſe, ſe ſont deux valets tout de meſme qui ſe deguiſent pour plaire à deux fẽmes, &que leurs Maiſtres battent à la fin:	que dites-vous là, c'est la même chose, se sont deux valets tout de même qui se déguisent pour plaire à deux femmes, etque leurs Maîtres battent à la fin:
il y a ſeulement cette petite difference, que dans la premiere les valets le font à l’inceu de leurs Maiſtres, & que dans la derniere, ſe ſont eux qui leurs font faire.	il y a seulement cette petite différence, que dans la première les valets le font à l'inçu de leurs Maîtres, et que dans la dernière, se sont eux qui leurs font faire.
Ie ne pûs m’empeſcher de luy en dire mon ſentiment chez vn Marquis de mes amis, qui loge au quartier du Louure où il la leut auec ſon Dom Garcie, auant que l’on la joüât.	Je ne pus m'empêcher de Seigneur en dire mon sentiment chez un Marquis de mes amis, qui loge au quartier du Louvre où il la lut île son Dom Garcie, avant que l'on la joüât.
ISCARIE.	ISCARIE.
Ce que vous nous dites eſt furieuſement incroyable;	Ce que vous nous dites est furieusement incroyable;
car il me ſouuient bien que dans ces Pretieuſes, il improuue ceux qui liſent leurs pieces auant qu’on les repreſentent, & par là vous me diriez qu’il s’eſt tourné luymeſme en ridicule.	car il me souvient bien que dans ces Pretieuses, il improuvé ceux qui lisent leurs pièces avant qu'on les représentent, et par là vous me diriez qu'il s'est tourné luymesme en ridicule.
LE POETE.	LE POTE.
Il eſt vray que n’aurois pas penſé qu’il e brigué comme il fait;	Il est vrai que n'aurais pas pensé qu'il eût brigué comme il fait;
mais ſçay de bonne part qu’il a ti des Limbes ſon deſpit amo reux à force de coups de cha deux piſtolles.	mais sais de bonne part qu'il a ty des Limbes son dépit amo reux à force de coups de cha deux pistoles.
LE BARON.	LE BARON.
C’eſt aſſez parler de ſa methode, & puis que vous auez oüy lire ſon Dom Garcie, dites-nous vn peu ce que c’eſt!	C'est assez parler de sa méthode, et puis que vous avez oui lire son Dom Garcie, dites-nous un peu ce que c'est!
LE PORTE.	LE PORTE.
Ma foy ſi nous conſultons ſon deſſein il a pretendu faire vne piece ſerieuſe;	Ma foi si nous consultons son dessein il a prétendu faire un pièce sérieuse;
mais ſi nous en conſul tons le ſens commun, c’el vne fort meſchante Comedie;	mais si nous en consul tons le sens commun, c'el une fort méchante Comédie;
car l’on y conte plus d’incidens que dans ſon Eſtourdy.	car l'on y compte plus d'incidents que dans son Étourdi.
LE BARON.	LE BARON.
Mais, Monſieur,.	Mais, Monsieur,.
ARATEMISE.	ARATEMISE.
Ah;	Ah;
c’eſt trop d'mmteiruptions, brifons là nos interrogations, & ſçachons au long de Monſieur, ſon ſentiment ſur toutes les pieces que lon a joüées cethyuer.	c'est trop d'moiteiruptions, brisons là nos interrogations, et sachons au long de Monsieur, son sentiment sur toutes les pièces que lon a jouées cethiver.
LE BARON.	LE BARON.
Volontiers.	Volontiers.
1 ANQUIN.	1 1NQUIN.
Ademybάs.	Ademybάs.
Nous aurons antoſt dequoy faire vne autre fetieuſe,	Nous aurons antôt dequoy faire une autre fétieuse,
LE POETE.	LE POTE.
Ie veux bien mes Dames, vous obeïr en cette rencontre, & malgré cette animoſité que le deſtin du Parnaſſe a ſemé entre les Poëtes, ie les vois trop au deſſous de moy pour apprehender aucunement de vous eſtre ſuſpect en parlant d’eux.	Je veux bien mes Dames, vous obéir en cette rencontre, et malgré cette animosité que le destin du Parnasse a semé entre les Poètes, je les vois trop au dessous de moi pour appréhender aucunement de vous être suspect en parlant d'eux.
Ie vous diray donc en quel ordre il les faut mettre & le cas qu’il en faut fairc.	Je vous dirai donc en quel ordre il les faut mettre et le cas qu'il en faut fairc.
Il y en a de certains qui ne meritent pas d’eſtre mentionnez dans le Catalogue des Illuſtres, pour n’eſtre venus au mondei qu’incognito, n’y auoir paru qu’en paſſant, & auoir fait naufrage auant que d’auoir eſte en pleine mer.	Il y en a de certains qui ne méritent pas d'être mentionnés dans le Catalogue des Illustres, pour n'être venus au mondei qu'incognito, n'y avoir paru qu'en passant, et avoir fait naufrage avant que d'avoir este en pleine mer.
Il y en a d’autre auſſi dont la voix pubique par le aſſez ſans que i’en diſe mot & parmy les Dramatiques dont eſt queſtion, Corneille, l’aiſné tient ſeul cette place.	Il y en a d'autre aussi dont la voix pubique par le assez sans que j'en dise mot et parmi les Dramatiques dont est question, Corneille, l'aîné tient seul cette place.
Il n’en va pas tout à fait de meſme de ſon cadet, & quoy que ſe ſoit vne Diuinité parmy les Comediens, les encens qu’on luy donne ne ſont pas ſi generaux que ceux de ſon frere:	Il n'en va pas tout à fait de même de son cadet, et quoi que se soit une Divinité parmi les Comédients, les encens qu'on lui donne ne sont pas si généraux que ceux de son frère:
ne croyez pourtant pas que i’en vueille dire du mal, au contraire, ie riens que c’eſt celuy de tous les Autheurs qui penſe plus profondement, & ſans doute l’enuie auouëra elle-meſme que ſon Stilicon eſt tout à fait beau.	ne croyez pourtant pas que j'en veuille dire du mal, au contraire, tu riens que c'est celui de tous les Auteurs qui pense plus profondément, et sans doute l'envie avouera elle-même que son Stilicon est tout à fait beau.
Nous auons encor veu cet hyuer le Federic qui a fort reüſſi, & c’eſt ſans doute auec quelque raiſon, puis qu’il ne part rien de la veine de ſon Autheur, qui ne ſoit plein de feu, témoin ſa Clotilde, où la boutade eſt bien exprimée.	Nous avons encor vu cet hiver le Fedéric qui a fort réussi, et c'est sans doute auec quelque raison, puis qu'il ne part rien de la veine de son Auteur, qui ne soit plein de feu, témoin sa Clotilde, où la boutade est bien exprimée.
Ces deux pieces ont eſté accõpagnéesde la Stratonice dont le ſtile eſt tout differẽt l’Autheur de cette piece ne s’attachant qu’à faire des vers tendres, où il reüſſit fort bien quoy que ie ne me ſois engãge qu’à vous parler des Autheurs dont l’on a ioüé les pieces cet hyuer;	Ces deux pièces ont été accõpagnéesde la Stratonice dont le style est tout differẽt l'Auteur de cette pièce ne s'attachant qu'à faire des vers tendres, où il réussit fort bien quoi que je ne me sois engange qu'à vous parler des Auteurs dont l'on a ioüé les pièces cet hiver;
Ie ne me puis empeſcher de vous dire que le theatre à perdu l’illuſtre Abbé de BoisRobert, qui par generoſité s’en eſt retiré luy-meſme, de peur que ces pieces n’étouffaſſent celles des fameux Autheurs qui ſe ſont remis au Theatre depuis peu.	Je ne me puis empêcher de vous dire que le théâtre à perdu l'illustre Abé de BoisRobert, qui par générosité s'en est retiré quelque-même, de peur que ces pièces n'étouffassent celles des fameux Auteurs qui se sont remis au Théâtre depuis peu.
Il y en à encor vn dont ie n’ay point parlé, qui joint l’eſpée à la plume;	Il y en à encor un dont personne n'ai point parlé, qui joint l'épée à la plume;
il ſçait faire des vers mieux qu’Homere, & ſe bat auſſi bien qu’Ale xandre.	il sait faire des vers mieux qu'Homère, et se bat aussi bien qu'Ale xandre.
On a joüé cet hyuer au Petit Bourbon vne piece de luy nommee Lenobie,	On a joué cet hiver au Petit Bourbon une pièce de notre nommée Lénobie,
ARTEMISE.	ARTEMISE.
il eſt vray que i’ay oüy dire qu’il y auoit de foit deuun vers.	il est vrai que j'ai ouï dire qu'il y avait de soit devun vers.
LE POETE.	LE POTE.
Comment de beaux vers!	Comment de beaux vers!
Nos plus grands Autheurs en metteroient moins dans vne douzaine qu’il n’y en a dans celle.	Nos plus grands Auteurs en metteraient moins dans une douzaine qu'il n'y en a dans celle.
là.	là.
On y remarquoit pourtant vn grand deffaut.	On y remarquait pourtant un grand défaut.
ISCARIE.	ISCARIE.
He!	He!
quel deffaut!	quel défaut!
LE BARON.	LE BARON.
Ah.	Ah.
ie ſçay quel eſt ce deffaut mieux que perſonne, & vn de mes amis le dit plaiſamment à ſon Autheur, il fut iuſques chez luy le trouuer, luy ne le connoiſſant point, luy demanda ce qu’il ſouhaittoit;	ie sçay quel est ce défaut mieux que personne, et un de mes amis le dit plaisamment à son Auteur, il fut jusques chez lui le trouver, lui ne le connaissant point, lui lea ce qu'il souhaitait;
mais il fut bien ſurpris quand il entendit qu’on auoit trouué vn grand deffaut dans ſa piece, qui n’eſtoit inconnu à perſonne.	mais il fut bien surpris quand il entendit qu'on avait trouvé un grand défaut dans sa pièce, qui n'était inconnu à personne.
ISCARIE.	ISCARIE.
Ah!	Ah!
ne nous tenez plus en langueur, dites le nous viſte.	ne nous tenez plus en langueur, dites le nous vite.
LE BARON.	LE BARON.
Ce deffaut eſt en vn mot, que les Comediens ne joüoient rien qui vaille, & qu' ils ne ſont bons à rien qu’à joüer la farce.	Ce défaut est en un mot, que les Comédients ne jouaient rien qui vaille, et qu' ils ne sont bons à rien qu'à joüer la farce.
LE POETE.	LE POTE.
Il eſt tout vray que ſi l’Hoſtel de Bourgogne eût joüé cette pièce, elle euſt extremement reüſſi;	Il est tout vrai que si l'Hôtel de Bourgogne eût joüé cette pièce, elle eût extrêmement réussi;
car c’eſt vn merueilleux aſſaiſonnement à vne piece que les bons Comediens, & tels malgré toute la fortune de leur nom, tels malgré la force de leur brigue ne reuſſiroient pas comme ils font, ſi l’on jouoit leurs pieces à Bourbon.	car c'est un merveilleux assaisonnement à une pièce que les bons Comédients, et tels malgré toute la fortune de leur nom, tels malgré la force de leur brigue ne réussiraient pas comme ils font, si l'on jouait leurs pièces à Bourbon.
ARTEMISE.	ARTEMISE.
y!	y!
Monſieur, il ne brigue dont point du tout.	Monsieur, il ne brigue dont point du tout.
LE POETE.	LE POTE.
Point du tout, & il n’a iamais leu ſa piece qu’à deux de ſes amis, encor!	Point du tout, et il n'a jamais lu sa pièce qu'à deux de ses amis, encor!
les y a t’il fait	les y a -t-il fait
E ii entrer pour rien.	E ji entrer pour rien.
LE BARON.	LE BARON.
Mais, Monſieur, c’eſt aſſez parler des autres, & ie croy que ces Dames ſont dans vne furieuſe impatience d’entendre la lecture de vos pieces, & qu’elles ſont deſia aſſez perſuadées de voſtre merite, pour vous promettre auec moy;	Mais, Monsieur, c'est assez parler des autres, et un crois que ces Dames sont dans une furieuse impatience d'entendre la lecture de vos pièces, et qu'elles sont déjà assez persuadées de votre mérite, pour vous promettre avec moi;
meſme ſans les entendre, d’y applaudir de la belle maniere, quand on les repreſentera.	On sans les entendre, d'y applaudir de la belle manière, quand on les représentera.
ISCARIE.	ISCARIE.
Sans doute.	Sans doute.
LE POETE.	LE POTE.
Ie vous diray donc pour entrer d’abord en matier.	Je vous dirai donc pour entrer d'abord en matier.
re que i’ay fait deux pieces de ſtile differend, car l’vne eſt vne Tragedie nommée, la Mort de LVSSE-TV-CRV.	re que j'ai fait deux pièces de style différend, car l'une est une Tragédie nommée, la Mort de LUZE-TVUCRV.
ARTEMISE.	ARTEMISE.
eſt bien du temps.	est bien du temps.
Le ſujet	Le sujet
ISCARIE.	ISCARIE.
Mais qu’elle en eſt la Cataſtrophe, car c’eſt là la pierre d’achoppement des Tragedies.	Mais qu'elle en est la Catastrophe, car c'est là la pierre d'achoppement des Tragédies.
LE POETE.	LE POTE.
Ie le fais lapider par les femmes.	Je le fais lapider par les femmes.
LE BARON.	LE BARON.
Ah!	Ah!
mes Dames qu’il a bien rencontré, qu’elle eſt bien imaginée!	mes Dames qu'il a bien rencontré, qu'elle est bien imaginée!
qu’il s’eſt bien deuulgariſé!	qu'il s'est bien deuulgarisé!
Ah!	Ah!
cela me met dans la dernierre demangeſon de ſçauoir le nom e voſtre Comedie.	cela me met dans la dernierre demangeson de savoir le nom e vôtre Comédie.
LE POETE.	LE POTE.
Ie l’intitulle, les Nopces de PANTAGRVEL.	Je l'intitulle, les Noces de PANTAGRUEL.
LE BARON.	LE BARON.
Il ne s’eſt point deſmenty, ce titre eſt incomparable.	Il ne s'est point démenti, ce titre est incomparable.
ISABELE.	ISABELE.
mon ame.	mon âme.
Cela ſtupeficie	Cela stupeficie
ARTEMISE.	ARTEMISE.
Pour moy, cela m’enleue iuſques au troiſieſme Ciel	Pour moi, cela m'enlève jusques au troisième Ciel
LE POETE.	LE POTE.
Ie m’en vai donc commancer.	Je m'en vay donc commencer.
LA OT 9 E & LVSSE.	LA OT 9 É et LUSSE.
TV-CRV LATIDE TAR LES Femmes.	TVUCRV LATIDE -THAR LES Femmes.
ACTE f.	ACTE f.
SCENE PREMIERE.	SCÈNE PREMIÈRE.
LVSSE-TV.	LUZE-TU.
CRV.	CRV.
ſeul ouure le Theatre.	seul ouvre le Théâtre.
LVSSE-TV-CRV.	LUZE-TU-CRU.
Amais l'hidre fecond en mille & I mille teſtes, N’excita tant de bruit ny de telles tempeſtes.	Amais l'hydre fécond en mille et I mille têtes, N'excita tant de bruit ni ue telles tempêtes.
pue cauſe de douleurs en mi Luſſe tu-cru, La femme acariaſtre, & gueuſe vertu, Par ſa langue maudite, & tot jours empeſtée, A me perſecuter on la voit à heus tée, Ie l’ay voulu changer;	pue cause de douleurs en mi Lusse tu-cru, La femme acariâtre, et gueuse vertu, Par sa langue maudite, et tôt jours empestée, À me persécuter on la voit à heus tée, Je l'ai voulu changer;
mais, O grands Dieux, helas!	mais, Ô grands Dieux, hélas!
Bien loin d’en retirer profit, lo, ou ſoullas, La mauuaiſe me ſuit de tauer en tauerne, Me frappe, m’injurie, eſgratigne & me berue, I'en ay par tout la fievre, & ne ſçais pas où, Pour pouuoir me fourer ie pi trouuer vn trou.	Bien loin d'en retirer profit, lo, ou soullas, La mauvaise me suit de taver en taverne, Me frappe, m'injurie, égratigne et me berve, J'en ai par tout la fièvre, et ne sais pas où, Pour pouvoir me fourer ici pi trouver un trouver.
LE BARON.	LE BARON.
Ah!	Ah!
Monſieur, arreſte:	Monsieur, arrête:
& donnez-nous le loiſir de nous extaſier ſur la magnifi.	et donnez-nous le loisir de nous extasier sur la magnifi.
cence de vos ſignifiantes ex.	cence de vos signifiantes ex.
preſſions.	pressions.
ISCARIE.	ISCARIE.
Il faut auouër quelces vers tonnent delicatement bien.	Il faut avouer quelces vers tonnent délicatement bien.
LE POETE.	LE POTE.
Ils parlent vn peu contre le ſexe, mais dans mon Pantagruel, ie le juſtifie comme il faut.	Ils parlent un peu contre le sexe, mais dans mon Pantagruel, Seigneur le justifie comme il faut.
ARTEMISE.	ARTEMISE.
Ah!	Ah!
que i’ay d’empreſſement d’oüir ce qui fait pour nous,	que j'ai d'empressement d'ouï ce qui fait pour nous,
LE BARON.	LE BARON.
Ie croy que vous auez raiſon;	Je crois que vous avez raison;
car auſſi bien faut auoir plus de temps pe lire vne piece ſerieuſe.	car aussi bien faut avoir plus de temps pe lire notre pièce sérieuse.
LE POETE.	LE POTE.
He!	He!
bien, ie com mence ſans façonner.	bien, Seigneur com menée sans façonner.
Panta gruel, entre auec vn confide & dit, Ou ſont les violons.	Panta gruel, entre prendre un confide et dit, Ou sont les violons.
As-tu v Dulcinée, Pour qui mon ame eſt, fuſt ſera calcinée,	As-tu v Dulcinée, Pour qui mon âme est, fut sera calcinée,
LE BARON.	LE BARON.
Calcinée, que ce me eſt emphatique.	Calcinée, que ce me est emphatique.
LE CONFIDENT.	LE CONFIDENT.
Les violons ſont preſts, & voi allez dans peu Oeillader comme il faut l’objet voſtre feu.	Les violons sont prêts, et voi allez dans peu Œillader comme il faut l'objet votre feu.
PAN	PAN
PANTAGRVEL.	PANTAGRUEL.
Ah!	Ah!
que de tourbillons, excitent dans mon ame La boüillonnante ardeur de ma flotante flame.	que de tourbillons, excitent dans mon âme La bouillonnante ardeur de ma flotante flamme.
Ah!	Ah!
ie ſens que l’amour, ce fretillant nabot, Driſle dedans mon cœur, comme les pois en pot, Il viruolte, il ſe tourne, il y fait la patroüille, Sautille comme en l’eau feroit vne grenouille, Il reiimbe, il s’oſend comme vn cheual fougeux, Qui prend le mors aux dents, & bondit ſurieux, Il va, monte, & deſcend dans la chambre & le bouge;	Ne sens que l'amour, ce frétillant nabot, Dridèle dedans mon cœur, comme les pois en pot, Il viruolte, il se tourne, il y fait la patroüille, Sautille comme en l'eau ferait une grenouille, Il rejet, Il rosend comme un cheval fougeux, Qui prend le mors aux dents, et bondit surieux, Il va, monte, et descend dans la chambre et le bouge;
Il furte tous les coins, & ſi iamais ne bouge.	Il furte tous les coins, et si jamais ne bouge.
ISCARIE.	ISCARIE.
Ah!	Ah!
laiſſez moy admi rer ces ſimilitudes, ie trouu ces vers là tout à fait eſpais.	laissez moi admi rer ces similitudes, Elle trouve ces vers là tout à fait épais.
LE POETE.	LE POTE.
He!	He!
de grace ne m’interrompez point;	de grâce ne m'interrompez point;
ſes ſortes de choſes veulent de laiges polmons, & pour les faire paroiſtre il ne faut pas s’arr ſter au milieu.	ses sortes de choses veulent de laiges polmons, et pour les faire paraître il ne faut pas s'arr ster au milieu.
ARATEMISE.	ARATEMISE.
Ah!	Ah!
vous les liſs à pleine?	vous les liss à pleine?
bouche.	bouche.
LE POETE.	LE POTE.
Sans mon eſcoulemet de nez r’ie les aurois leus d’ ton bien plus fortifié.	Sans mon écoulemet de nez r'ie les aurais lus d' ton bien plus fortifié.
TLANQVIN.	TLANQUIN.
Elles donnent dans le panee	Elles donnent dans le pane
SCENE.	SCÈNE.
E BARON DE LA TAV PIN IERE, ISCARIE.	E BARON DE LA TAU PIN JERE, ISCARIE.
IRTEMISE, BEATRIX ISABELLE, FLANQVIN, LE POETE, MONSIEVR, GREVAL.	JRTEMISE, BEATRIX ISABELLE, FLANQUIN, LE POTE, MONSIEUR, GREUAL.
I SABELLE.	I SABELLE.
Adame, voila Monſieur CVTde Greual qui vient.	Adame, voilà Monsieur CUTde Greval qui vient.
ISCARIE.	ISCARIE.
Il peut entrer.	Il peut entrer.
propos empeſcher mon Apologie d’éclatter:	propos empêcher mon Apologie d'éclatter:
car i’en ſuis à cet endroit.	car j'en suis à cet endroit.
ISCARIE.	ISCARIE.
Monſieur, vous pourrez pourſuiure, bien que ſe ſoit vn Bourgeois, il n’eſt point façonnier, & ce n’eſt point vn eſprit de Marguillier.	Monsieur, vous pourrez poursuivre, bien que se soit un Bourgeois, il n'est point façonnier, et ce n'est point un esprit de Marguillier.
AR TEMISE.	AR TEMISE.
C’eſt vne ame du premier ordre.	C'est une âme du premier ordre.
FLANQUIN.	FLANQUIN.
à part.	à part.
Ie n’oublieray pas ceux cy	Je n'oublierai pas ceux cy
T Ne vous en allez pas.	 Ne vous en allez pas.
ISCARIE.	ISCARIE.
à ſa ſuiuante.	à sa suivante.
Ne vous éloignez pa de la portée de ma voix	Ne vous éloignez pa de la portée de ma voix
GREVAL.	GREUAL.
les ayant ſalluées, & ſe tournant deuers le Poëte.	les ayant salluées, et se tournant devers le Poète.
Mes Dames que faites rous donc de cet honneſte homme icy.	Mes Dames que faites rous donc de cet honnête homme ici.
LE POETE.	LE POTE.
à part.	à part.
Tout eſt gaſté.	Tout est gâté.
FLANQVIN.	FLANQUIN.
à part.	à part.
La meſche eſt découuerte	La mèche est découverte
ISCARIE.	ISCARIE.
monſtrant le Baron.	montrant le Baron.
C’eſt vn grand Poëte, que Monſieur nous a amené, & qui nous a charmé des beaux vers qu’il nous a recitez.	C'est un grand Poète, que Monsieur nous a amené, et qui nous a charmé des beaux vers qu'il nous a récitez.
GREVAL.	GREUAL.
Vous voulez m’en donner, c’eſt le valet de feu Monſieur Durier, ie l’ay veu cent fois chez luy.	Vous voulez m'en donner, c'est le valet de feu Monsieur Durier, Elle l'ai vu cent fois chez lui.
F i	F y
LE POETE.	LE POTE.
Ma foy, puis que vous me connoiſſez ſi bien, ie vais vous dire la verité de la choſe mon Maiſtre eſtant mort, ie me trouué fort embaraſſé de ma perſonne, parce que ie me trouuois fort gueux, & que ie n’auois gagné à ſon ſeruice que la methode de faire des vers cocy, cocy, le ſieur de la Force dit, Gilles le Niais, voyant que ie ne ſçauois où donner de la teſte, & que ie luy pouuois eſtre vtil dans ſa troupe, me pria d’y entrer:	Ma foi, puis que vous me connaissez si bien, je vais vous dire la vérité de la chose mon Maître étant mort, Seigneur me trouvé fort embarrassé de ma personne, parce que je me trouvais fort gueux, et que tu n'avais gagné à son service que la méthode de faire des vers coci, coci, le sieur si le Force dit, Gilles le Niais, voyant que je ne sçauois où donner de la tête, et que je lui pouuois être il dans sa troupe, me pria d'y entrer:
i’y reſiſtay d’abord ne voulant point paſſer pour vn Farceur;	j'y résistai d'abord ne voulant point passer pour un Farceur;
mais il me repreſenta que toutes les perſonnes les plus illuſtres de l’aris, alloient tous les iours voir la farce au Petit Bourbon, & me perſuada ſi bien, que les ſiennes eſtoient auſſi honneſtes que pluſieurs de celles que Maſcarille a faites, que ie me laiſſay vaincre, & que i’entray dans ſa troupe.	mais il me représenta que toutes les personnes les plus illustres de l'aris, allaient tous les jours voir la farce au Petit Bourbon, et me persuada si bien, que les siennes étaient aussi honnêtes que plusieurs de celles que Mascarille a faites, que je me laissai vaincre, et que j'entrai dans sa troupe.
Quelque temps âpres voyant que Bourbon, nous oſtoit tous nos chalans, il fit deſſein de jouër dans vn lieu fermé, de me faire compoſer quelques Comedies, de mettre de bonnes Farces au bout, & d’y prendre de l’argent de meſme que les autres, & comme il ſçauoit que le ſuccez des Pieces ne dépendoit pas tant de leur bonté, que de la brigues de leurs Autheurs;	Quelque temps âpres voyant que Bourbon, nous ôtait tous nos chalants, il fit dessein de jouer dans un lieu fermé, de me faire composer quelques Comédies, de mettre de bonnes Farces au bout, et d'y prendre de l'argent de même que les autres, et comme il savait que le succès des Pièces ne dépendait pas tant de leur bonté, que de la brigues de leurs Auteurs;
il a trouué le moyen de m’introduire dans les Compagnies, & il y a deſia plus de deux cens perſonnes qui ſont infatuez de	il a trouvé le moyen de m'introduire dans les Compagnies, et il y a déjà plus de deux cens personnes qui sont infatués de
ISCARIE.	ISCARIE.
Et quoy!	Et quoi!
Monſieur.	Monsieur.
ſouffrez-vous ſans l’aſſommer qu’vn coquin vous jouë de la ſorte;	souffrez-vous sans l'assommer qu'un coquin vous joue de la sorte;
car enfin c’eſt vous qui auez eſté le premier duppé.	car enfin c'est vous qui avez été le premier dupé.
LE BARON.	LE BARON.
Dites, dites, pluſtoſt qu’il n’y a que uous ſeulles, & pour vous le perſuader appre nez que ie ſuis la Force, dit Gilles le Niais en mon nom de theatre, que ie vous ay rendu trois ou quatre viſites pour connoiſtre voſtre humeur, & qu' ayant veu que vous eſtiez fa ciles à deceuoir, nous nou ſommes enquis mon camaradt & moy, de la reputation de tou les Autheurs, de leurs piect nouuelles.	Dites, dites, plutôt qu'il n'y a que us seulles, et pour vous le persuader apprè nez que je suis la Force, dit Gilles le Niais en mon nom de théâtre, que je vous ai rendu trois ou quatre visites pour connaître votre humeur, et qu' ayant vu que vous étiez fa ciles à décevoir, nous nouv sommes enquis mon camaradt et moi, de la réputation de tou leurs Autheurs, de leurs piect nouvelles.
Nous auons appr quelques mots pretieux, & nous ſommes apres demeurez d’accord qu’il viendroit icy quand ie ſerois auec vous, qu’il liroit ſes pieces, & que i’admi.	Nous avons apprès quelques mots prétieux, et nous sommes après demeurez d'accord qu'il viendrait ici quand je serais encore vous, qu'il lirait ses pièces, et que j'admi.
rerois tout, pour vous faire donnet dans le panneau.	rerois tout, pour vous faire donnet dans le panneau.
Flanquin, que voila auecque moy, & qui eſt de noſtre troupe a bien joué auſſi ſon rolle, & en contrefaiſant le pretieux a bien ſceu dupper la ſuiuante.	Flanquin, que voilà apprenez -moi, et qui est de notre troupe a bien joué aussi son rolle, et en contrefaisant le prétieux a bien su duper la suivante.
ARTEMISE.	ARTEMISE.
Ie demeure muëtte d’eſtonnement.	Je demeure muette d'étonnement.
GREVAL.	GREUAL.
Ce trait eſt hardy, & s’il eſtoit arriué à quelques autres qu’à vous i’en rirois de bon cœur.	Ce trait est hardi, et s'il était arrivé à quelques autres qu'à vous j'en rirais de bon cœur.
Is CARIE.	Is CARIE.
Vn Farceur thez moy, Ahi ſi vous ne nyez.	Un Farceur thé moi, Ahi si vous ne niez.
LE BARON.	LE BARON.
Nous craignons peu vos menaces, & nous ſommes tous trois bien reſolus de nous defendre ſi l’on nous attaque, ſçachez donc auant que ie ſorte, que puis que Maſcarille vous rend viſite, vous deuez bien me ſouffrir, que s’il s’eſt acquis par ſes Farces la reputatiõ d’auoir de l’eſprit, que i’en fais auſſi bieu que luy ſans l’ai de des Italiens, & qu’enfin ſi l veufue de Guilotgorju, mon Maiſtre & le ſien, ne luy euſt vendu les Memoires de ſon mary, ces Farces ne luy euſſent	Nous craignons peu vos menaces, et nous sommes tous trois bien résolus de nous défendre si l'on nous attaque, sachez donc avant que je sorte, que puis que Mascarille vous rend visite, vous devez bien me souffrir, que s'il s'est acquis par ses Farces la réputation d'avoir de l'esprit, que j'en fais aussi bieu que lui sans l'ai de des Italiens, et qu'enfin si l veufue de Guilotgorju, mon Maître et le sien, ne lui eût vendu les Mémoires de son mar, ces Es de son eussent
Ahi ie me ISCARIE.	Ahi grande me ISCARIE.
laſſe de vous entendre, & !	lasse de vous entendre, et !
vous ne ſortez i’enuoyera querir vn mauuais ange de criminels.	vous ne sortez j'envoyera quérir un mauvais ange de criminels.
LE BARON.	LE BARON.
Puis que mon rolle eſt acheué, il faut bien que ie ſorte.	Puis que mon rolle est achevé, il faut bien que iesorte.
Allons mes compagnons.	Allons mes compagnons.
Adieu, mes Dames.	Adieu, mes Dames.
FLANQVIN.	FLANQUIN.
à part en tirant Iſabelle.	à part en tirant Isabelle.
hrbun reun dans noſtre Troupe, nous gagnerons bien de l’argent;	hrbun reun dans notre Troupe, nous gagnerons bien de l'argent;
car nous allons jouër les trois Docteurs & les Pretieuſes Ridicules.	car nous allons jouer les trois Docteurs et les Prétieuses Ridicules.
FIN »	FIN "
Extrait du Priuilege du Roy.	Extrait du Privilège du Roi.
ARgrace & Priuilege du Roy, I donné à Paris le 12 Ianuier 1660.	ARgrace et Privilège du Roi, I donné à Paris le 12 Janvier 1660.
Signé, par le Roy en ſon Conſeil, RENOVARD Il eſt permis à lEAN RIBOY Marchand Libraire à Paris, d’imprimer ou faire imprimer vne Comedie intitulée Les Veritables Pretieuſes, pendant le temps & eſpace de ſept ans entiers à compter du iour qu'elle ſera imprimée:	Signé, par le Roi en son Conseil, RENOUARD Il est permis à lEAN RIBOY Marchand Libraire à Paris, d'imprimer ou faire imprimer une Comédie intitulée Les Véritables Pretieuses, pendant le temps et espace de sept ans entiers compter du jour qu'elle sera imprimée:
Et defenſes à tous autres de l’imprimer ſans la permiſſion dudir RIBOV.	Et défenses à tous autres de l'imprimer sans la permission dudir RIBOU.
ſur les peines portées par leſdites Lettres, qui ſont en ver u du preſent Extrait tenuës pour bien & deuëment ſignifiées.	sur les peines portées par lesdites Lettres, qui sont en ver ès du présent Extrait tenues pour bien et duement signifiées.
Acheuée d’imprimer le ſeptiéme Ianuier 1640.	Achevée d'imprimer le septiême Janvier 1640.
Les Ex emplaires ont eſté fournis.	Les Ex emplaires ont été fournis.
