Couvertures superleure et inferleure mancuontes	Couvertures superleure et inferleure mancuontes
France, & CHARLES CLOUZIER.	France, et CHARLES CLOUZIÈR.
Jà la Croix d’or.	Jà la Croix d'or.
M.	M.
DC.	DC.
XCIV.	XCIV.
Avec Permiſſion.	Avec Permission.
Y.	Y.
h66	h6
Mad.	Mad.
JEROSME, Marchande de Caſſe.	JÉRÔME, Marchande de Casse.
COOISONS la Fhlce	COOISONS la Fhlce
DORANTE, Amant de Louiſon.	DORANTE, Amant de Louison.
LE CHEVALIER.	LE CHEVALIER.
CORONIS Gaſcon.	CORONIS Gascon.
CANODAS Pctes	CANODAS Ptes
LA TLE CHE, Valet de Dorante.	LA TLE CHE, Valet de Dorante.
DEUX JOUEURS de dames.	DEUX JOUEURS de dames.
La Scene eſt dans une Salle de Caſſé.	La Scène est dans une Salle de Cassé.
TEEEL COMEDIE.	TEL COMÉDIE.
SCENE PREMIERE.	SCÈNE PREMIÈRE.
Le Theatre repreſente une Salle de Caſfé où ſont trois Tables.	Le Théâtre représente une Salle de Casfé où sont trois Tables.
Le Poëte réve d’un coſté auprés des Joüeurs de Dames.	Le Poète rève d'un côté auprès des Joueurs de Dames.
L’Abbé dort dans le fonds, & de l’autre coſté Coronis & la Sourdiere diſputent enſemble.	L'Abé dort dans le fonds, et de l'autre côte Coris et la Sourdière disputent ensemble.
ETODOReDIERD, SORONTS, CARONDAS, L’ABBE', DEUX JOUEURS.	ETODOReDIERD, SORONTS, CARONDAS, L'ABE', DEUX JOURS.
LA SOURDIERE.	LA SOURDIERE.
Parbleu je vous ſoutiens que ſi.	Parbleu je vous soutiens que si.
CORONIS.	CORONIS.
Et moy, mordy, jé vous ſoutiens que non, & jé mets cent piitoles que noun’aurons rien cette année en Hongrie.	Et moi, mordi, jé vous soutiens que non, et jets cent cent piitoles que noun'aurons rien cette année en Hongrie.
LA SOURDIERE.	LA SOURDIERE.
Vous me feriez enrager Monſieur Coronis, vous voulez ſçavoir cela mieux que moy, qui vois tous les jours aux Thuilleries un homme qui reçoit toutes les ſemaines la Gazette de Conſtantinople.	Vous me feriez enrager Monsieur Coronis, vous voulez sçavoir cela mieux que moi, qui vois tous les jours aux Thuilleries un homme qui reçoit toutes les semaines la Gazette de Constantinople.
CORONIS.	CORONIS.
Quand ce ſeroit celle de Babilone.	Quand ce serait celle de Babilone.
LA SOURDIERE.	LA SOURDIERE.
C’eſt eſtre bien teſtu.	C'est assez bien têtu.
Et moy je vous dis que je vis hier entre ſes mains une lettre de l’Aumoſniet d’un des principaux Baches qui marque expreſſement que le Grand Viſir eſt en marche a vec deux cent mille hommes, & qu’il va droit a Belgrade pour l’aſſieger par mer & par terre.	Et moi je vous dis que je vis hier entre ses mains une lettre de l'Aumôniet d'un des principaux Baches qui marque expressément que le Grand Visir est en marche a vec deux cent mille hommes, et qu'il va droit a Belgrade pour l'assiéger par mer et par terre.
CORONIS.	CORONIS.
beſgrade parmer & par terre!	besgrade parmer et par terre!
où avezvous appris la Geographie, s’il vous plaiſt?	où avezvous appris la Géographie, s'il vous plaît?
LA SOURDIERE.	LA SOURDIERE.
Comment, Belgrade n’eſt pas un port de mmer*	Comment, Belgrade n'est pas un port de mér*
CORONIS.	CORONIS.
Non pas que jé ſçache, ou bien c’eſt depuis fort peu de temps.	Non pas que jé sache, ou bien c'est depuis fort peu de temps.
LA SOURDIERE.	LA SOURDIERE.
Morbleu je ſçay la carte, & j’ay voyagé.	Morbleu je sais la carte, et j'ai voyagé.
Je parie que Monſieur Carondas ſera de mon avis.	Je parie que Monsieur Carondas sera de mon avis.
Monſieur hola, Monſieur dlolade tevenncee vodos	Monsieur holà, Monsieur dlolàde tevennée vodos
CARONDAS.	CARONDAS.
Ah morbleu, que la peſte ſoit fait de voſtre babil!	Ah morbleu, que la peste soit fait de votre babil!
Eſt-il poſſible qu’on ne puiſſe faire icy quatre vers en repos, & que les plus belles penſées du monde y ſeront ſans ceſſe immolées à dpetuiunee loquacité du premier importun?	Est-il possible qu'on ne puisse faire ici quatre vers en repos, et que les plus belles pensées du monde y seront sans cesse immolées à detuiuneée loquacité du premier importun?
CORONIS.	CORONIS.
Quoy!	Quoi!
vous faites des vers au Caffé;	vous faites des vers au Caffé;
Voila un fort plaiſant Parnaſſe.	Voilà un fort plaisant Parnasse.
CARONDAS.	CARONDAS.
Je rêvois à l’epithalame de Monſieur Jobelin le Notaire, & de la fille du logis.	Je rêvais à l'épithalame de Monsieur Jobelin le Notaire, et de la fille du logis.
Ils attendent qu’elle ſoit faite pour ſe marier, & j’ay bien voulu y donner un de ces quarts d'heure precieux que j’employe à chanter les loüanges des Dieux, & des Heros.	Ils attendent qu'elle soit faite pour se marier, et j'ai bien voulu y donner un de ces quarts d'heure précieux que j'emploie à chanter les langes des Dieux, et des Héros.
CORONIS.	CORONIS.
Comment, la petite Louiſon ſe marie:	Comment, la petite Louison se marie:
& que deviendra le pauvre Dorante?	et que deviendra le pauvre Dorante?
LA SOURDIERE.	LA SOURDIERE.
Il prendra la peine de s’en paſſer.	Il prendra la peine de s'en passer.
Mouſieur Jobelin eſt mon ancien amy, & je dois prendre part à tout ce qui regarde ce mariage.	Mousieur Jobelin est mon ancien ami, et je dois prendre part à tout ce qui regarde ce mariage.
Monſieur Carondas peut-on voir voſtre epithalame?	Monsieur Carondas peut-on voir votre épithalame?
2	2
A:	A:
CARONDAS.	CARONDAS.
Je n’en ay fait encore que la premiere ſtrophe.	Je n'en ai fait encore que la première strophe.
La voicy.	La voici.
Himen ie ô himenée!	Hymen ie ô hyménée!
Celebrons la douce journée!	Célébrons la douce journée!
Ou deux amas heureux s’uniſſẽt pour toujours;	Ou deux amas heureux s'unissence pour toujours;
VeneZ tendres amours combler la deſtinée De sette épouſe fortunée, Que de ſes flancs fecõds puiſſe dãs peu de jours Sortir une heureuſe lignée, Himen io o bimence.	VeneZ tendres amours combler la destinée De tte épouse fortunée, Que de ses flancs fecõds puisse dans personne de jours Sortir une heureuse lignée, Hymen jo ô bimence.
LA SOURDIERE.	LA SOURDIERE.
Diable, voila du ſublime, & cela s’appelle un debut iagiſnedez	Diable, voilà du sublime, et cela s'appelle un début jagisnedez
CORONIS.	CORONIS.
Et tres-avantageux pour le futur époux.	Et très-avantageux pour le futur époux.
CARONDAS.	CARONDAS.
Vous verrez bien autre choſe, ſi je puis obtenir des Libraires qu’ils impriment mon incomparable traduction de la Batracomiomachie d’Homere;	Vous verrez bien autre chose, si je puis obtenir des Libraires qu'ils impriment mon incomparable traduction de la Batracomiomachie d'Homère;
car j'excelle dans les Traductions des anciens Autheurs, & je travaille maintenant à mettre en vers Grecs l'Eneïde de Virgile, pour l'intelligence de ceux qui n'entendent point la langue Larine.	car j'excelle dans les Traductions des anciens Auteurs, et je travaille maintenant à mettre en vers Grecs l'Eneïde de Virgile, pour l'intelligence de ceux qui n'entendent point la langue Larine.
Mais laiſſez-moy ſonger à ma ſeconde ſtrophe.	Mais laissez-moi songer à ma seconde strophe.
LA SOURDIERE.	LA SOURDIERE.
C'eſt bien dit, auſſi bien noſtre Caffé rerrolan.	C'est bien dit, aussi bien notre Caffé rerolan.
CARONDAS.	CARONDAS.
Du fambeau de T’hymen.	Du fambeau de T'hymen.
I.	I.
JOUEUR de Dames.	JOUEUR de Dames.
Je vous ſoufle.	Je vous souffle.
II.	II.
JOUEUR.	JOUEUR.
aittendez Monneur.	aittendez Monneur.
Ce nent pas cela, vous dérangez le jeu.	Ce nent pas cela, vous dérangez le jeu.
I.	I.
JOUEUR.	JOUEUR.
Pardonnez-moy :	Pardonnez-moi :
J’ay joüé là Vous avez joüé icy.	J'ai joué là Vous avez joué ici.
Je vous ay donné à prendre, vous avez mis dans le coin, & je vous ſoufle.	Je vous ai donné à prendre, vous avez mis dans le coin, et je vous souffle.
TI.	TY.
OUEUR.	OÙEUR.
Ah ventrebleu, on n’a jamais joüé du malheur dont je jouë.	Ah ventrebleu, on n'a jamais joué du malheur dont je joue.
CARONDAS.	CARONDAS.
Eh quoy, toujours du bruit?	Eh quoi, toujours du bruit?
A iij Sou France	À jij Ou France
SCENE II.	SCÈNE II.
LE CHEVALIER, CORONIS, LA SOURDIEGSTEGCE, CARONDAS, LES JOUEURS.	LE CHEVALIER, CORONIS, LA SOURDIEGSTEGCE, CARONDAS, LES JOUEURS.
LE CHEVALIER entrant en chantant & danſant.	LE CHEVALIER entrant en chantant et dansant.
A, la, la, la, ra re.	À, la, la, la, ra re.
Allons hé du 1 Caſfé	Allons hé du 1 Casfé
CARONDAS.	CARONDAS.
Encore?	Encore?
de tous coſtez.	de tous côtés.
LE CHEVALIER chante.	LE CHEVALIER chante.
Quand je me réveille, Et que ma Catin Vient me verſer du vin, Je me ris des coups du deſtin, Vive la bouteille, Beuvons chers anis, Le bon vin & Cloris Réveillent nos ſens endormis, Quand je me réveilte Et que ma Catin Vient me verſer du vin Je me ris des coups du deſtin,	Quand je me rèveille, Et que ma Catin Vient me verser du vin, Je me ris des coups du destin, Vive la bouteille, Beuvons chers anis, Le bon vin et Cloris Réveillent nos sens endormis, Quand je me réveilte Et que ma Catin Vient me verser du vin Je me ris des coups du destin,
CARONDAS.	CARONDAS.
Ah je n’y puis plus tenir.	Ah je n'y puis plus tenir.
Sortons, ſdvons;	Sortons, sédvons;
Qiira vaut vmatus fagere mne libet	Qiira vaut vatus fagère mêne libet
LE CHEVALIER.	LE CHEVALIER.
aCerenis.	aCérénis.
Adieu donc Monſieur Carondas.	Adieu donc Monsieur Carondas.
Bon jour à la Sourdiere.	Bon jour à la Sourdiere.
mon amy.	mon ami.
Et te voila vieux pecheur.	Et te voilà vieux pécheur.
i mioii jonvouiuum ovuuiſſaut Ahi ouf!	y jioi jonvouiuum ovuuissaut Ahi ouf!
fort haut.	fort haut.
LE CHEVALIER.	LE CHEVALIER.
Ah parbleu petit Abbé, mon mignon, je ne vous voyois pas.	Ah parbleu petit Abé, mon mignon, je ne vous voyais pas.
Comment te portes-tu?	Comment te portes-tu?
L’ABBE'.	L'ABBE'.
Quelle hẽure eſt-il?	Quelle hombre est-il?
LE CMIEVAEIER vrouuim le jeuAh, ah, Meſſieurs, vous joüez aux Dames.	LE CMIEUAEIÈR vroum le jeuAh, ah, Messieurs, vous jouez aux Dames.
I.	I.
JOUEUR.	JOUEUR.
Morbleu, Monſieur, cela ne ſe fait point, vous avez tort.	Morbleu, Monsieur, cela ne se fait point, vous avez tort.
Attendez, Monſieur, j’avois gagné.	Attendez, Monsieur, j'avais gagné.
Vous me devez une taſſe de caſſé au moins.	Vous me devez une tasse de cassé au moins.
II.	II.
JOUEUR.	JOUEUR.
Ouy Tarare.	Oui Tarare.
SCENE III.	SCÈNE III.
L'ABBE', LE CHEVALIER, CORONIS, EA DOORoleRM	L'ABBE', LE CHEVALIER, CORONIS, EA DORoleRM
L’ABBE'.	L'ABBE'.
Ites-moy un peu, mes enfans, DoI rante n’eſt-il point venu icy pendant que je dormois?	Ites-moi un peu, mes enfants, DoI rante n'est-il point venu ici pendant que je dormais?
en cas qu’il vienne, je vous prie, Monſieur Coronis, de luy dire que je me luis Moidie de lon Monſieur Jobelin, & que je ſuis inſtruit à fonds de tout ce qui regarde cet homme là.	en cas qu'il vienne, je vous prie, Monsieur Coris, de lui dire que je me luis Moidie de lon Monsieur Jobelin, et que je suis instruit à fond de tout ce qui regarde cet homme -là.
LA SOURDIERE à part.	LA SOURDIERE à part.
Dun yary pomy plu uuuumomumanes.	Dun yari pomy plu uuuumomumanes.
Malepeſte cecy ne vaut pas le diable.	Malepeste ceci ne vaut pas le diable.
Allons l’avertir de ce qui ſe paſſe.	Allons l'avertir de ce qui se passe.
Il lea va.	Il lea va.
LADDE	LADE
Pour moy j’ay rendez-vous chez Forel, il eſt tard, & j’ay peur qu’on ne ſoupe ſans moy.	Pour moi j'ai rendez-vous chez Forel, il est tard, et j'ai peur qu'on ne soupe sans moi.
Je n’ay point dîné.	Je n'ai point dîné.
CORONIS.	CORONIS.
Comment Monſieur l'Abbé, à dix heure du ſoir n’avoir point dîné, & eſtre 1e iuous eediction!	Comment Monsieur l'Abé, à dix heure du soir n'avoir point dîné, et été 1e juous édiction!
L’ABBE’.	L'ABBE'.
Je me ſuis mis à table ce matin entre ſept & huit, & nous avons déjeuné juſqu'a lheure qu’il eſt.	Je me suis mis à table ce matin entre sept et huit, et nous avons déjeuné jusqu'a lèvre qu'il est.
LE CHEVALIER.	LE CHEVALIER.
Voila un pauvre garçon qui me fait pitié.	Voilà un pauvre garçon qui me fait pitié.
L’ABBE'.	L'ABBE'.
Nous n’avons beu qu’environ vingt-cinq bouteilles de vin à quatre.	Nous n'avons bu qu'environ vingt-cinq bouteilles de vin à quatre.
J’ay laiſſé les trois autres ſous la table, & je ſuis venu icy boire deux bouteilles de Rataſia pour Anmiei les lumece du vin, j’ay fait un petit ſomme, me voila preſt à recommencer.	J'ai laissé les trois autres sous la table, et je suis venu ici boire deux bouteilles de Ratasia pour Anmie les lume du vin, j'ai fait un petit somme, me voilà prêt à recommencer.
CURONTS.	CURONTS.
Quel heureux naturel!	Quel heureux naturel!
quel temperament!	quel tempérament!
L’ABBE'.	L'ABBE'.
Pour vingt cinq bouteilles s’enyvrer!	Pour vingt cinq bouteilles s'enivrer!
quelle honte eſt-ce là?	quelle honte est-ce là?
Il n’y a plus d’hommes mes amis, & le monde va toujours en diminuant.	Il n'y a plus d'hommes mes amis, et le monde va toujours en diminuant.
Je ſoutiens encore un peu nobleſſe;	Je soutiens encore un peu noblesse;
mais je m’en iray comme les autres.	mais je m'en irai comme les autres.
Bon ſoir Meſſieurs, je m'en vay boire à voſtre ſanté.	Bon soir Messieurs, je m'en vais boire à votre santé.
SCENE IV.	SCÈNE IV.
CORCSIO NECVALIER.	CORCSIO NECUALIER.
LE CHEVAEIER.	LE CHÉVAEIÈR.
U’eſt donc devenu la Sourdiere?	OÙ est donc devenu la Sourdiere?
CORONIS.	CORONIS.
A propos je n’y ſongeois pas:	À propos je n'y songeais pas:
Il ſera ſans doute allé avertir ſon amy le Notaire de ce que l’Abbé vient de dire.	Il sera sans doute allé avertir son ami le Notaire de ce que l'Abé vient de dire.
LE CHEVALIER.	LE CHEVALIER.
Je ne ſçay quel diable de commerce ils ont enſemole, mais depuis quelque cemt3 ils ne ſe quittent non plus que l'ombre & le corps.	Je ne sais quel diable de commerce ils ont ensemole, mais depuis quelque cemt3 ils ne se quittent non plus que l'ombre et le corps.
CORONIS.	CORONIS.
Je le crois bien.	Je le crois bien.
La Sourdiere eſt un homme qui paſſe toute ſa vie à fureter, & s’il y a quelqu'un qui ait des meubles à engager, ou quelque enfant de famille qui ait beſoin d’argent cil en eſt d’abord informé.	La Sourdière est un homme qui passe toute sa vie à fureter, et s'il y a quelqu'un qui ait des meubles à engager, ou quelque enfant de famille qui ait besoin d'argent cil en est d'abord informé.
Ces ſortes de gens ſont au Notaire, ce que le chien couchant eſt au chaſſeur.	Ces sortes de gens sont au Notaire, ce que le chien couchant est au chasseur.
Ils déterrent le gibier, les autres de tirent.	Ils déterrent le gibier, les autres de tirent.
SCENE V.	SCÈNE V.
CORONIS, LE CHEVALIER;	CORONIS, LE CHEVALIER;
donnn TE	donnn TE
CORONIS.	CORONIS.
H voicy Dorante.	H voici Dorante.
L’Abbé te cherIAchoit tout-à-l'heure.	L'Abé te chérIAchait tout-à-l'heure.
Il a des nou velles à t’aprendre.	Il a des nou velles à t'apprendre.
DORANTE.	DORANTE.
Où eſt-il allé?	Où est-il allé?
CORUNTJ.	CORUNTJ.
Il ſort dé ſortir.	Il sort dé sortir.
Tu le trouveras chez Forel.	Tu le trouveras chez Forel.
DORANTE, Il faut neceſſairement que je luy parle aa lalne.	DORANTE, Il faut nécessairement que je Vous parle à lalène.
LE CHEVALIER.	LE CHEVALIER.
Qu’eſt-ce mon amy, on dit que tu n’épouſes plus en ce pays cy.	Qu'est-ce mon ami, on dit que tu n'épouses plus en ce pays cy.
DORANTE.	DORANTE.
Ma foy cela m’intrigue un peu franchement.	Ma foi cela m'intrigue un peu franchement.
CORONIS.	CORONIS.
Souiment tu ſerois amoureus, ỳ le fat;	Souiment tu serais amoureus, le fat;
DORANTE.	DORANTE.
Amoureux ou non.	Amoureux ou non.
Je t’aſſure que la petite eſt fort aimable, & ſa beauté à part, elle a vingt mille écus.	Je t'assure que la petite est fort aimable, et sa beauté à part, elle a vingt mille écus.
Cela ne meſſieroit point à un Cadet qui n’a que la cape & l'épée.	Cela ne messiérait point à un Cadet qui n'a que la cape et l'épée.
LE CHEVALIER.	LE CHEVALIER.
Tu n’es pas riche, nous le ſȩavons;	Tu n'es pas riche, nous le sȩavons;
mais un Gentilhomme vouloir épouſer une Chocoſatiere, il y a de la folie ma foy.	mais un Gentilhomme vouloir épouser une Chocosatière, il y a de la folie ma foi.
il y a de la folie.	il y a de la folie.
DORANTE.	DORANTE.
De la folie!	De la folie!
va, va, mon pauvre Chevalier, l'intereſt a raproché les conditions, & hous voyons olen des Genciisſommes qui vivroient en roturiers, s’ils n’avoient epouſé des roturieres.	va, va, mon pauvre Chevalier, l'intérêt a raproché les conditions, et hous voyons olen des Génciissommes qui vivraient en roturiers, s'ils n'avaient épousé des roturières.
CORONIS.	CORONIS.
Sans doute & la delicateſſe ſut la meſalliance ne ſubſiſte plus guere que chez les Allemans.	Sans doute et la délicatesse sut la mésalliance ne subsiste plus guère que chez les Allemans.
DORANTE.	DORANTE.
Au bout du compte qu’eſt-ce que je riſque?	Au bout du compte qu'est-ce que je risque?
le ſuis Gentilhomme & gueux.	le suis Gentilhomme et gueux.
Elle eſt roturiere & riche, j'auray de l’argent pour ma Nobleſſe, la compenſation ne m’eſt pas deſavantageuſe, vous eſtes tous deux deux mes amis, je ne deſeſpere pas encone;	Elle est roturière et riche, j'aurai de l'argent pour ma Noblesse, la compensation ne m'est pas désavantageuse, vous êtes tous deux deux mes amis, je ne désespère pas encone;
& ſi vous voulez me ſeconder, avant qu’il ſoit peu nous ferons bien tourner la medaille.	et si vous voulez me seconder, avant qu'il soit peu nous ferons bien tourner la médaille.
LE CHEVALIER.	LE CHEVALIER.
Ouy da, dequoy s’agit-il?	Oui da, dequoy s'agit-il?
Tu ſçais que je ſuis à toy, à vendre & à engager.	Tu sais que je suis à toi, à vendre et à engager.
CORONIS.	CORONIS.
Tu ſçais combien je t’aime, & avec quelle mente nous avons toujours partagé les emolumens du Lanſquenet.	Tu sais combien je t'aime, et avec quelle mente nous avons toujours partagé les émoluments du Lansquenet.
DORANTE.	DORANTE.
Voicy ce que je veux faire.	Voici ce que je veux faire.
Vous ſçavez que noſtre Notaire eſt joüeur, & que la confiance qu’il a en ſon habileté fait qu’il s’embarque le plus aiſément du monde.	Vous savez que notre Notaire est joueur, et que la confiance qu'il a en son habileté fait qu'il s'embarque le plus aisément du monde.
Or j’ay un valet qui aſſurément eſt un des plus adroits fripons qu’il y ait à vingt lieuës à la tonde.	Or j'ai un valet qui assurément est un des plus adroits fripons qu'il y ait à vingt lieues à la tonde.
I'ay concerté avec luy qu’il engageroit mon homme au jeu, & que pendant que vous amuſeriez ce vieux renard de la Sourdiere, qui ne le quitte jamais.	J'ai concerté avec lui qu'il engagerait mon homme au jeu, et que pendant que vous amuseriez ce vieux renard de la Sourdiere, qui ne le quitte jamais.
Mais voicy mon valet.	Mais voici mon valet.
SCENE VI.	SCÈNE VI.
LA FLE'CHE, DEIARIT, LE CHEVLLIER, COROd,	LA FLE'CHE, DEIARIT, LE CHÉVLLIER, COROd,
LA FLECHE.	LA FLÈCHE.
Onſieur, je n’ay pû trouver voſtre T' Egros Abbé, & ſi j’ay eſté dans tous les Cabarets de la Ville.	Onsieur, je n'ai pu trouver votre T' Égros Abé, et si j'ai été dans tous les Cabarets de la Ville.
DORANTE.	DORANTE.
je icais ou neit, n’ſumt.	je icais ou neit, n'sumt.
va-ten étudier ton perſonnage, & revien quand il ſera temps.	va-ten étudier ton personnage, et reviens quand il sera temps.
LA FLECHE, Etudier-, dites-vous!	LA FLÈCHE, Étudier-, dites-vous!
Vrayment voila bien dequoy, & j’en ay bien fait d’antres.	Vraiment voilà bien dequoy, et j'en ai bien fait d'antres.
Il n'y a que huit jours que j’ay l’honneur de vous ſervir;	Il n'y a que huit jours que j'ai l'honneur de vous servir;
mais quand nous nous connoiſtrons mieux, vous verrez qu'en fait de fourberie perſonne, Dieu mercy, n'eſt capable de me faire la leçon.	mais quand nous nous connaîtrons mieux, vous verrez qu'en fait de fourberie personne, Dieu merci, n'est capable de me faire la leçon.
S’agit-il de déniailer quelque étranger nouvellement débarqué, de faire mordre un jeune homme à l’hameçon d’une coquette, ou de maquignonner un mariage impromptu, c’eſt moy qu’on vient chercher, j’excelle, je triomphe.	S'agit-il de déniailer quelque étranger nouvellement débarqué, de faire mordre un jeune homme à l'hameçon d'une coquette, ou de maquignonner un mariage impromptu, c'est moi qu'on vient chercher, j'excelle, je triomphe.
Mais ſur tout pour en filer une dupe à quelque jeu que ce ſoit, & luy tirer par cent moyens ingenieux tout l’argent de ſa bourſe, je ſuis le garçon de France le plus en reputation.	Mais sur tout pour en filer une dupe à quelque jeu que ce soit, et lui tirer par cent moyens ingénieux tout l'argent de sa bourse, je suis le garçon de France le plus en réputation.
138Siravds Vertubleu voila un joly garçon!	138Sirauds Vertubleu voilà un joli garçon!
DONANTE.	DONANTE.
A propos, n’es-tu jamais venu icy?	À propos, n'es-tu jamais venu ici?
LA FLE'CHE.	LA FLE'CHE.
Oh vrayment, Monſieur, pardonnezmoy.	Oh vraiment, Monsieur, pardonnezmoi.
J’ay eſté autrefois un des principaux Marguilliers du Caſſé, & j’avois droit de ſeance à ce banc redoutable d’où il part tous les jours tant d’arreſts contre la reputation des femmes, où les miſteres du gouvernement ſont ſi bien dévelopez, & les intereſts des Princes de l’Europe ſi ſçavamment approfondis;	J'ai été autrefois un des principaux Marguilliers du Cassé, et j'avais droit de séance à ce banc redoutable d'où il part tous les jours tant d'arrêts contre la réputation des femmes, où les misères du gouvernement sont si bien développez, et les intérêts des Princes de l'Europe si savamment approfondis;
Vous moquezvous, je ſuis plus connu dans les Caffez, que Pilot Bouſſi dans les Cabarets.	Vous moquezvous, je suis plus connu dans les Caffez, que Pilot Boussi dans les Cabarets.
CORONIS.	CORONIS.
Je gagerois à l’entendre, qu’il eſt de quelque Province au delà de la Loire, Il n’eſt pas permis d’avoir tant d’eſprit autrement.	Je gagerais à l'entendre, qu'il est de quelque Province au delà de la Loire, Il n'est pas permis d'avoir tant d'esprit autrement.
LA FLECHE.	LA FLÈCHE.
Je ſuis de Dauphiné à vous rendre mes ſexvices.	Je suis de Dauphiné à vous rendre mes sexvices.
CORONIS.	CORONIS.
Malepeſte joly pays.	Malepeste joli pays.
De l’argent peu à la verité, mais de l’eſprit beaucoup.	De l'argent peu à la vérité, mais de l'esprit beaucoup.
C’eſt l’apanage de la Nation.	C'est l'apanage de la Nation.
*	*
DONANILe Mais on te reconnoiſtra.	DONANILe Mais on te reconnaîtra.
LA FLECHE.	LA FLÈCHE.
Point du tout Monſieur.	Point du tout Monsieur.
C’eſt mon fort que le déguiſement, & je ſuis un perit Prothée.	C'est mon fort que le déguisement, et je suis un périt Prothée.
Eſt-il queſtion de repreſenter un Partiſan, par exemple, j’ay des ſecrets pour me noircir la barbe, épaiſſir ma taille, me rendre l'œil hagard, & groſſir mon ton de voix.	Est-il question de représenter un Partisan, par exemple, j'ai des secrets pour me noircir la barbe, épaissir ma taille, me rendre l'œil hagard, et grossir mon ton de voix.
Faut-il faire un jeune Abbé, qui ſçait mieux que moy faire la petite bouche, rire des épaules, marmoter une chanfon, faire la main potelée, prendre un viſage gay & un ton radoucy ?	Faut-il faire un jeune Abbé, qui sait mieux que moi faire la petite bouche, rire des épaules, marmoter une chanson, faire la main potelée, prendre un visage gai et un ton radouci ?
Par cent petites mietaniorplloie, de cette nature javois amaſſé quelque argent, & je ſerois à mon aile ſans un revers de fortune qui m’a coulé à fonds,	Par cent petites miétaniorplloie, de cette nature javais amassé quelque argent, et je serais à mon aile sans un revers de fortune qui m'a coulé à fond,
DORANTE.	DORANTE.
Comment?	Comment?
un revers de fortune.	un revers de fortune.
LA FLE'CHE.	LA FLE'CHE.
Ouy un fils de Marchand à qui j’avois gagné un ſoir mil écus au jeu, s’aviſa déplucher ma conduite dans un procez qu’il me fit.	Oui un fils de Marchand à qui j'avais gagné un soir mil écus au jeu, s'avisa déplucher ma conduite dans un procès qu'il me fit.
La Juſtice donna une mauvaiſe interpretation à la choſe, & cela m’a ruiné.	La Justice donna une mauvaise interprétation à la chose, et cela m'a ruiné.
l’ay eſté obligé de revenir a la livrée.	l'ai été obligé de revenir a la livrée.
DORANTE.	DORANTE.
Fort bien.	Fort bien.
Mais voicy Monſieur Jobelin.	Mais voici Monsieur Jobelin.
Meſiiestoy, ee val pleparer.	Mesiiestoy, ce val plearer.
SCENE VII.	SCÈNE VII.
MT JOBELIN, LE CHEVALIER, CORONIS, DORANTE.	MT JOBELIN, LE CHEVALIER, CORONIS, DORANTE.
Mr JOBELIN à part.	Mr JOBELIN à part.
L me ſemble que je ſuis aſſez propre, & A qu’en cet état je puis aller faire le galant auprés d’une Maîtreſſe.	L me semble que je suis assez propre, et A qu'en cet état je puis aller faire le galant auprès d'une Maîtresse.
LE CHEVALIER à Dorante.	LE CHEVALIER à Dorante.
Comme le voila beau!	Comme le voilà beau!
Il vient icy pour coqueter je m’aſſure.	Il vient ici pour coqueter je m'assure.
Oh parbleu je m’en vais bien déranger l’economie de ſa parure.	Oh parbleu je m'en vais bien déranger l'économie de sa parure.
bon ſoir Monſieur Jobeiin.	bon soir Monsieur Jobéiin.
Vous ne ſaites pas ſemblant de nous voir.	Vous ne saites pas semblant de nous voir.
JOBELIN.	JOBELIN.
Serviteur, je n’ay pas le temps de m’amuier.	Serviteur, je n'ai pas le temps de m'amuyer.
mathias, luy chifonne ſon rabat, le deboutene, & le met en deſordreEh que diable ne ſçavroit-on vous dire un mot?	mathias, An chifonne son rabat, le déboutène, et le met en désordreEh que diable ne saurait-on vous dire un mot?
je ſuis bien aiſe de vous faire compliment ſur vos nopces.	je suis bien aise de vous faire compliment sur vos noces.
En verité cette nouvelle là m’a fait le plus grand plaiſir du monde, & je ſuis ravy que voſtre mariage ait tant de rapport avec les conſequences de la choſe.	En vérité cette nouvelle là m'a fait le plus grand plaisir du monde, et je suis ravi que votre mariage ait tant de rapport avec les conséquences de la chose.
Car enfin il ſeroit bien extraordinaire que dans un Caſfé il ne ſe trouvaſt pas une fille dont l’eſprit pût entrer en concurrence avec les circumbilivaginations de voſtre indifference.	Car enfin il serait bien extraordinaire que dans un Casfé il ne se trouvât pas une fille dont l'esprit pût entrer en concurrence avec les circumilivaginations de votre indifférence.
Vous me direz que quand il s’agit de ſe marier, il y a peu de conformité entre les incongruitez de voſtre inconſtance, & la conſideration de vos ſentimens;	Vous me direz que quand il s'agit de se marier, il y a pu de conformité entre les incongruités de votre inconstance, et la considération de vos sentiments;
mais auſſi vous m’avod̂rez que quand on veut ſe retirer dans ſon ménage, la Comedie, le Bal & les promenades ſont des choſes qui divertiſſent beaueaquMommdequiulmono pera, comme e vous dis, je n’aime guere à aller aux Thuilleries, & je trouve tour compté,tout rabattu, que c’eſt fort bien fait à vous de	mais aussi vous m'avodrez que quand on veut se retirer dans son ménage, la Comédie, le Bal et les promenades sont des choses qui divertissent beaueaquMommdequiulmono pera, comme e vous dis, je n'aime guère à aller aux Thuilleries, et je trouve tour compté,tout rabattu, que c'est fort bien fait à vous de
OBELIN.	ÔBELIN.
Que diantre me dit-il là?	Que diantre me dit-il là?
J'écoute de toutes mes oreilles, & je n’y comprens Aci	J'écoute de toutes mes oreilles, et je n'y comprends Aci
LE CHEVALIER.	LE CHEVALIER.
Vous entendez bien:	Vous entendez bien:
Cela eſt clair comme le jour.	Cela est clair comme le jour.
Or pour revenir à la mala die de Madame voſtre tante, il eſt certain que Ceü eſt le premier homme que nous ayons pour les Tabatieres;	Or pour revenir à la mala die de Madame votre tante, il est certain que Ce que le premier homme que nous ayons pour les Tabatières;
mais à l’égard de vôtre cha peau, je vous conſeille de conſerver voſtre perruque, car elle eſt parfaitement belle, & vous devez compter que perſonne n’eſt moins que moy veritablement voſtre tres-obeïſſant ſerviteur.	mais à l'égard de votre cha peau, je vous conseille de conserver votre perruque, car elle est parfaitement belle, et vous devez compter que personne n'est moins que moi véritablement votre très-obeïssant serviteur.
JOBELIN.	JOBELIN.
Quel galimathias eſt-ce cy, mais a quoyeſt-ce que je m’amuſe?	Quel galimathias est-ce cy, mais à quoyest-ce que je m'amuse?
AM {.	AMeM.
LOGISON, DORANTE, LECHE VALIER, CORONIS, JOBELIN.	LOGISON, DORANTE, LÈCHE VALIER, CORONIS, JOBELIN.
OBELIN.	ÔBELIN.
H voicy ma Maîtreſſe:	H voici ma Maîtresse:
Il faut la ſaA luer.	Il faut la sa luer.
Mademoiſelle.	Mademoiselle.
LOUISON, & tous les autres, 22ss2, cles ones ensems	LOUISON, et tous les autres, 22ss2, clés ones ensems
OBELIN.	ÔBELIN.
Qu'eſt-ce donc que vous avez à rire;	Qu'est-ce donc que vous avez à rire;
mais que vois-ie ?	mais que vois-je ?
comme me yoila débraillé.	comme me yoilà débraillé.
Ah!	Ah!
j’enrage de paroiſtre comme cela.	j'enrage de paraître comme cela.
Morbleu, Meſſieurs, je vous envoiray au Diable avec vos ſotriſes.	Morbleu, Messieurs, je vous envoirai au Diable avec vos sotrises.
DORANTE.	DORANTE.
Laiſſez moy ſeul mes enfans, & allez m’attendre chez Principe, je vay vous y joindre, & je vous acheveray ce que j’ay à vous dire.	Laissez moi seul mes enfants, et allez m'attendre chez Principe, je vais vous y joindre, et je vous achèverai ce que j'ai à vous dire.
SCENE IX.	SCÈNE IX.
DORANTE, LOUISON.	DORANTE, LOUISON.
DORANTE.	DORANTE.
E vien Louuon, vou ailez eitre IImariée, je perds toute eſperance d'eſtre à vous, & vous avez conſenty à un mariage qui me fera mourir.	E viens Louvon, vou lez eitre IImariée, je perds toute espérance d'être à vous, et vous avez consenti à un mariage qui me fera mourir.
.	.
.	.
2:	2:
LOUISON.	LOUISON.
Mon Dieu pourquoy me querellezvous, eſt-ce ma faute à moy ?	Mon Dieu pourquoi me querellezvous, est-ce ma faute à moi ?
ma mere m’a menacée de me renvoyer dans le Couvent, ſi je n’épouſois Monſieur Jobelin le ſerois bien aiſe d’eſtre mariée avec vous, mais je ne veux point retourner au Couvent.	ma mère m'a menacée de me renvoyer dans le Couvent, si je n'épousais Monsieur Jobelin le serais bien aise d'être mariée avec vous, mais je ne veux point retourner au Couvent.
DORANTE.	DORANTE.
Quoy vous verrez vos attraits en proye à un homme haïſſable, & qui n’en connoiſtra jamais le prix;	Quoi vous verrez vos attraits en proie à un homme haïssable, et qui n'en connaîtra jamais le prix;
& moy il faudra me reſoudre à vous perdre, à ne vous jamais voit?	et moi il faudra me résoudre à vous perdre, à ne vous jamais voit?
Ah Louilon je le voy bien, vous ne m’aimez plus.	Ah Louilon je le vois bien, vous ne m'aimez plus.
LOUISON Allez, allez, laiſſez faire ma mere, puiſqu’elle veut que je me marie.	LOUISON Allez, allez, laissez faire ma mère, puisqu'elle veut que je me marie.
Quand je ne leray plus fous la conduite, nous nous verrons, & nous nous aimerons tant qu’il vous plaira.	Quand je ne lerai plus fous la conduite, nous nous verrons, et nous nous aimerons tant qu'il vous plaira.
DORANTE.	DORANTE.
Non, ce n’eſt pas là dequoy me contenter;	Non, ce n'est pas là dequoy me contenter;
ce je ne igaurois Nounti que voitte perſonne & voſtre cœur ſoient partagez.	ce je ne igaurais Nounti que voitte personne et votre cœur soient partagez.
Conſentiriez-vous que je ſiſſe en ſorte d’empeſcher voſtre mariage?	Consentiriez-vous que je sisse en sorte d'empêcher votre mariage?
LOUISON.	LOUISON.
Ouy, pourveu que ma mere ne ſceuſt pas que je vous l’ay conſeillé, car elle mequerelleroit bien fort.	Oui, pourvu que ma mère ne sût pas que je vous l'ai conseillé, car elle mequerellerait bien fort.
DORANTE.	DORANTE.
Elle n’en ſoaura rien.	Elle n'en saura rien.
Aimez-moy toujours, c’eſt tout ce que ma tendreſſe exige de vous,	Aimez-moi toujours, c'est tout ce que ma tendresse exige de vous,
LOUISON.	LOUISON.
Voyez-vous, elle m'a toujours tenu dans la dépeudance, & elle ne veut pas ſeulement que je parle aux Meſſieurs qui viennent icy, parce qu’elle dit que leurs miitonis ront vemr de reipiit au jcunca ſilles, Elle ne veut pas que j’en aye.	Voyez-vous, elle m'a toujours tenu dans la dépeudance, et elle ne veut pas seulement que je parle aux Messieurs qui viennent ici, parce qu'elle dit que leurs miitonis ront vemr de reipiit au junca silles, Elle ne veut pas que j'en aie.
DORANTÉ.	DORANTE.
Mais Louiſon, a ce que je medite alloit manquer, que feriez-vous?	Mais Louison, à ce que je médite allait manquer, que feriez-vous?
LOUISON.	LOUISON.
Ce que je ferois?	Ce que je ferais?
Dame je vous l’ay déut, je ne veux pol iscouner au Couvent.	Dame je vous l'ai décut, je ne veux pol iscouner au Couvent.
Ah voila ma mere, ne luy dites pas que je vous aime au moins.	Ah voilà ma mère, ne lui dites pas que je vous aime au moins.
DORANTE.	DORANTE.
Je vay raheſubier les gens dont j’uy beſoin pour mon entrepriſe.	Je vais rahésubier les gens dont j'hui besoin pour mon entreprise.
SCENE X.	SCÈNE X.
dumdi quieoomu, MooN.	dumi quieoomu, MoN.
Mad.	Mad.
JEROSME.	JÉRÔME.
U’eſt-ce donc petite fille, vous parZlez à des hommes quand je n’y ſuis pas?	U’est-ce donc petite fille, vous parlez à des hommes quand je n'y suis pas?
Td Je vous demande pardon ma mere, c’eſt tuy qui de paliolt,	Téd On vous demande pardon ma mère, c'est tui qui de palitiolt,
Mad.	Mad.
JEROSME.	JÉRÔME.
Monſieur Jobelin eſt-il icy?	Monsieur Jobelin est-il ici?
LOUISON.	LOUISON.
Ouy, il m’a penſé faire mourir de rire de la figure donc il eſtoit baſty.	Oui, il m'a pensé faire mourir de rire de la figure donc il était bâti.
Apparemment il eſt allé ſe racommoder, & Dieu mercy il ne m'a point parlé.	Apparemment il est allé se racommoder, et Dieu merci il ne m'a point parlé.
Mad.	Mad.
JEROSME.	JÉRÔME.
Qu'eſt-ce à dire?	Qu'est-ce à dire?
eſt-ee ainſi qu’il faut parler d’un homme que vous allez é pouſer?	est-ce ainsi qu'il faut parler d'un homme que vous allez é pouser?
Il faut dire ma mere, il ne m’a point parlé, j'en ſuis bien ſâchée.	Il faut dire ma mère, il ne m'a point parlé, j'en suis bien sâchée.
LOUISON.	LOUISON.
Moy ſâchée de cela?	Moi sâchée de cela?
Je n’aime point à mientir.	Je n'aime point à mientir.
Mad.	Mad.
JEROSME.	JÉRÔME.
Quais, qu’eſt-ce que tout cecy?	Quais, qu'est-ce que tout ceci?
vous ne l'aimez donc pas à ce que je voy.	vous ne l'aimez donc pas à ce que je vois.
LOUISON.	LOUISON.
Moy, ma mere?	Moi, ma mère?
helas, non	hélas, non
Non?	Non?
Bhade LEROOHE	Bhade LEROHÉ
LOUISON.	LOUISON.
Non.	Non.
Vous m’avez dit qu’il ne falloit point qu’une fille aimaſt les-hommes, je fais ce que vous m’avez dit.	Vous m'avez dit qu'il ne fallait point qu'une fille aimât les-hommes, je fais ce que vous m'avez dit.
desesss qe e d e la ds Mais il faut aimer celuy-là, puiſqu’il ſera voſtre mary.	desesss qe e e la eû Mais il faut aimer celui-là, puisqu'il sera votre mari.
LOUISON.	LOUISON.
C’eſt donc une neceſſité qu’il faille aimer ſon mary?	C'est donc une nécessité qu'il faille aimer son mari?
ſi cela eſt, donnez-m'en un autre je vous prie.	si cela est, donnez-m'en un autre je vous prie.
Mad.	Mad.
JEROSME.	JÉRÔME.
Comment dites-vous?	Comment dites-vous?
ah, ah petite impertinente, vous eſtes enteſtée à ce que je vois, & quelque coliſichet de blondin vous aura donné dans la veuë.	ah, ah petite impertinente, vous êtes entêtée à ce que je vois, et quelque colisichet de blondin vous aura donné dans la vue.
N’eſt ce point Narciſſe, ce perit fat, qui depuis le matin juſqu’au ſoir ſe fait l’amour à luymeſme?	N'est ce point Narcisse, ce périt fat, qui depuis le matin jusqu'au soir se fait l'amour à luymesme?
qui paſſe ſtoute la journée à ſe mirer mirer dans ſa perruque, ajuſter ſa ſteinquerque, & ſe faire les yeux doux dans un mitois.	qui passe stoute la journée à se mirer mirer dans sa perruque, ajuster sa steinquerque, et se faire les yeux doux dans un mitais.
LOUISON.	LOUISON.
Oh fy, ma mere, j’aimerois autant aimer une femme.	Oh fi, ma mère, j'aimerais autant aimer une femme.
Mad.	Mad.
JEROSME.	JÉRÔME.
Je parie que c’eſt ce jeune Conſeiller qui vient icytous les lous en epee & en chapeau bordé.	Je parie que c'est ce jeune Conseiller qui vient ici les lous en épée et en chapeau bordé.
LOUISON.	LOUISON.
Qui, cet homme qui parle toujours de ſon équipage, de ſes terres, & de ſes alliances?	Qui, cet homme qui parle toujours de son équipage, de ses terres, et de ses alliances?
Mon Dieu il a mille deffauts que je ne ſçaurois ſouffrir.	Mon Dieu il a mille défauts que je ne saurais souffrir.
Mad.	Mad.
JEROSME.	JÉRÔME.
Si bien donc que c’eſt Dorante qui vous tient au cœur?	Si bien donc que c'est Dorante qui vous tient au cœur?
orante?	orante?
LOUISON.	LOUISON.
Mad.	Mad.
JEROSME.	JÉRÔME.
Eh bien Duante?	Eh bien Duante?
vous ne luy trouvez point de denaut à ceſuy-ia.	vous ne lui trouvez point de denaut à cesui-jà.
LOUISON.	LOUISON.
Pourquoy voulez-vous que je luy en trouve?	Pourquoi voulez-vous que je lui en trouve?
Mad.	Mad.
JEROSME.	JÉRÔME.
Jé ne m’embaraſſe pas que vous luy en trouviez, je ſçay qu’il eſt aſſez honneſte	Jé ne m'embarrasse pas que vous lui en trouviez, je sais qu'il est assez honnête
C Source gallica.	Ç Source galica.
bnf fr 1B homme;	bnf fr 1B homme;
mais Mr Jobelin a une bonne Charge ſur le corps, & c’eſt mieux voſtre fait qu’un jeune homme qui n’a rien que ſon eſprit & ſa bonne mine.	mais Mr Jobelin a une bonne Charge sur le corps, et c'est mieux vôtre fait qu'un jeune homme qui n'a rien que son esprit et sa bonne mine.
En un mot c’eſt luy que je veux qui ſoit voſtre époux;	En un mot c'est lui que je veux qui soit votre époux;
le voicy, qu’on luy faſſe civilité, & qu’on réponde coinme il faut à tout ce qu’il Eiie	le voici, qu'on lui fasse civilité, et qu'on de coinme il faut à tout ce qu'il Éiie
SCENE XI.	SCÈNE XI.
JUDEEAN, MAGJERUSME, LOUISON.	JUDEAN, MAGERUSME, LOUISON.
Mad.	Mad.
JEROSME.	JÉRÔME.
Onſieur, voila ma flle qui eſt raE Avie de vous voir, & qui ſe diſpoſe le plus agreablement du monde à vous epomes.	Onsieur, voilà ma flle qui est razE Avie de vous voir, et qui se dispose le plus agréablement du monde à vous épomes.
LOUISON.	LOUISON.
Ouy, voila un boau Magot pour eſtre ravie de l’épouſer.	Oui, voilà un boau Magot pour être ravie de l'épouser.
OBElen.	ÔBÉlen.
Mademoiſelle zout ainſi qu’és Pays dl grumiers, le vaſſal eſt ienn de preſter ſerment de foy & hommage lige entre les mains de ſon Seigneur feodal,avant qu’entrer en poſſeſſion des terres acquiſes dans ſa mouvance;	Mademoiselle zout ainsi qu'avez Pays d' grumiers, le vassal est ienn de prêter serment de foi et hommage lige entre les mains de son Seigneur féodal,avant qu'entrer en possession des terres acquises dans sa mouvance;
De meſme viens-je en qualité de voſtre vaſſal indigne vous promettre foy & loyauté perpetuelle avant qu’entrer en poſſeſſion du fief Seigneurial de vos beautez a moy acquis par la ceſſion de Madame voſtre mere, & le Contract qui lera inceſſamment pane pardevant les Notaires au Chaſtelet de Paris.	De même viens-je en qualité de votre vassal indigne vous promettre foi et loyauté perpétuelle avant qu'entrer en possession du fief Let de vos beautés a moi acquis par la cession de Madame votre mère, et le Contract qui lera incessamment pane pardevant les Notaires au Châtelet de Paris.
Mad.	Mad.
ILROSME.	ILROSME.
Allons petite fille répondez.	Allons petite fille répondez.
d d e duvo Moy je ne ſçay ce qu’il me veut dire, qu’il le réponde luy-meſme s’il s’entend.	d' il le réponde Moi je ne sais ce qu'il me veut dire, qu'il le réponde lui-même s'il s'entend.
Mad.	Mad.
JÉROSME.	JÉRÔME.
Impertinente?	Impertinente?
Elle dit Monſieur qu'elle vous eſt fort obligée, & que le don de voſtre cœur lui eſt extremement cher.	Elle dit Monsieur qu'elle vous est fort obligée, et que le don de votre cœur lui est extrêmement cher.
JOBELIN.	JOBELIN.
dhon cœur, Mauemoneie, eſt un immeuble qui vous appartient, & ſur lequel vous avez hipotheque depuis que j’ay eu l'honneur de vous voir.	dhon cœur, Mavémoneie, est un immeuble qui vous appartient, et sur lequel vous avez hypothèque depuis que j'ai eu l'honneur de vous voir.
Mad.	Mad.
JEROSME.	JÉRÔME.
Eh bien vous voila muette.	Eh bien vous voilà muette.
LOUISON.	LOUISON.
l’ay bien affaire de ſon hipotheque, il L n’a qu’à la gaider, je ne l’aime pas.	l'ai bien affaire de son hypothèque, il n'a qu'à la gagner, je ne l'aime pas.
Mad.	Mad.
JEROSME.	JÉRÔME.
Ahi.	Ahi.
Monſieur il faut l’excuſer ſi elle ne répond pas aux choſes que vous dites, elle eſt un peu honteuſe.	Monsieur il faut l'excuser si elle ne répond pas aux choses que vous dites, elle est un peu honteuse.
Le mariage l’enhardira, & demain à l’heure qu’il vous plaira nous ferons dreſſer le Contract.	Le mariage l'enhardira, et demain à l'heure qu'il vous plaira nous ferons dresser le Contrat.
anccontes Maoncde Mrole vume pou ſoir.	anccontes Maoncde Mrole vume pou soir.
IOBELIN Apres auir ſalut Lauſqui dúiourus la ieſte.	JOBELIN Après avir salut Lausqui dúiourus la ieste.
Voila les affaires en bon train.	Voilà les affaires en bon train.
La mere prevenuë, la fille charmée de moy, le mariage preſt à conclure, & vingt mille écus qui vont me ſauter au colet, oh parbleu je ne craindray plus la perſecution de mes Creanciers, & j’auray enſin dequoy payer ma Charge.	La mère prévenue, la fille charmée de moi, le mariage prêt à conclure, et vingt mille écus qui vont me sauter au collet, oh parbleu je ne craindrai plus la persécution de mes Créanciers, et j'aurai ensin dequoy payer ma Charge.
Ma foy les habiles gens ſe tirent toujours d’intrigue, & l’eſprit eſt le vray paſſe-par-tout de la fortune.	Ma foi les habiles gens se tirent toujours d'intrigue, et l'esprit est le vrai passe-partout de la fortune.
SCENE XII.	SCÈNE XII.
EAOSORDIERE,DVIN.	EAYSORDIÈRE,DVIN.
LA SOURDIERE.	LA SOURDIERE.
H vous voila à la fin, il y a deux TAheures que je vous cherche.	H vous voilà à la fin, il y a deux TAheures que je vous cherche.
OBELIN.	ÔBELIN.
Ah ſerviteur, je ſuis bien aiſe de vons LeMconclere	Ah serviteur, je suis bien aise de vons LeMconclere
LA SOURDIERE.	LA SOURDIERE.
ay bien des choſes à vous dire.	ai bien des choses à vous dire.
OBELIN.	ÔBELIN.
J’ay de bonnes nouvelles à vous apprenAlot	J'ai de bonnes nouvelles à vous apprenAlot
LA SOURDIERE.	LA SOURDIERE.
La mine eſt éventée, & Dorante eſt alſtruns dctoutes vos aſaires.	La mine est éventée, et Dorante est alstruns doutes vos asaires.
OBELIN.	ÔBELIN.
La beccaſſe eſt bridée, & demain le mariage doit eſtre conclu.	La beccasse est bridée, et demain le mariage doit être conclu.
LA SOUI DIERE.	LA SOUI DIERE.
Je vous dis encore une fois de prendre garde à vous, & qu’on ſonge à vous T de eco	Je vous dis encore une fois de prendre garde à vous, et qu'on songe à vous T de éco
OBELIN.	ÔBELIN.
Un mauvais tour, à moy?	Un mauvais tour, à moi?
Et qui cela, aTvous plaiRt 2	Et qui cela, aTvous plaiRt 2
LA SOURDIERE.	LA SOURDIERE.
Dorante.	Dorante.
OBELIN.	ÔBELIN.
Dorante!	Dorante!
ah vrayment ouy, c’eſt bien d’un novice comme luy que ie m’embaraſſe.	ah vraiment oui, c'est bien d'un novice comme tu que ie j'embarrasse.
Allez, allez Monſieur de la Sourdiere, nous ſommes un peu grecs, & on ne prend pas de chats comme nous ſans mitaines, j’ay mis bon ordre à tout, & vous n’avez qu’à avoir l’eſprit en repos.	Allez, allez Monsieur de la Sourdiere, nous sommes un peu grecs, et on ne prend pas de chats comme nous sans mitaines, j'ai mis bon ordre à tout, et vous n'avez qu'à avoir l'esprit en repos.
LA SOURDIERE.	LA SOURDIERE.
Vous me faites mourir avec voſtre conſance imprudente, &.	Vous me faites mourir avec votre consance imprudente, et.
Mais quelle figure eſt,ce cy.	Mais quelle figure est,ce cy.
SCENE XIII.	SCÈNE XIII.
OBELIN, LA SOURDIERE, LA FLE'CHE déguiſe & comrejauant t'yvre.	ÔBELIN, LA SOURDIERE, LA FLÉCHE déguise et comrejauant t'ivre.
LA FLE'CHE à part.	LA FLE'CHE à part.
Oicy mes gens.	Oici mes gens.
Joüons bien noſtre yrole, & faiſons les donner dans le panneau.	Jouons bien notre yrole, et faisons les donner dans le panneau.
Ah Meſſieurs ſerviteur, j'intertomipa vonte contehation, peuteclere, mais tout coup vaille.	Ah Messieurs serviteur, j'intertomipa vonte contehation, peutecle, mais tout coup vaille.
On m’a dit que vous eſtiez Monſieur Jobelin, eſt-il vray?	On m'a dit que vous étiez Monsieur Jobelin, est-il vrai?
OBELIN.	ÔBELIN.
Ouy, c’eſt moy.	Oui, c'est moi.
Que me veut cet yvrogne là?	Que me veut cet ivrogne là?
LA FLECHE.	LA FLÈCHE.
Je vous en ſçais bon gré, car j’ay beſoin de vous, je vous ay zantoſt eſté chercher dans voſtre étude;	Je vous en sais bon gré, car j'ai besoin de vous, je vous ai zantôt été chercher dans votre étude;
mais comme vous n’y eſtiez pas, je ne vous y ay point trouvé, & je ſuis allé delà à l’Alliance prendre un peu de nourriture, moderément pour tane.	mais comme vous n'y étiez pas, je ne vous y ai point trouvé, et je suis allé delà à l'Alliance prendre un peu de nourriture, moderément pour tane.
OBELIN.	ÔBELIN.
18 vay Cile	18 vais Cile
LA FLE'CHE.	LA FLE'CHE.
La tuoderation eit une belle choſe.	La tuodération eit une belle chose.
JOBELIN.	JOBELIN.
Dequoy s’agit-il?	Dequoy s'agit-il?
LA FLECHE.	LA FLÈCHE.
Attendez que je rapelle mes idées.	Attendez que je rappelle mes idées.
Ah mu’y voicy.	Ah mu’y voici.
Je voudrois que vous me fiſſiez un petit plaiſir.	Je voudrais que vous me fissiez un petit plaisir.
Je vous demande pardon Monſieur, ii je parſe de mes affaires devant vous, vous le voulez bien.	Je vous demande pardon Monsieur, ji je parse de mes affaires devant vous, vous le voulez bien.
LA SOURDIERE.	LA SOURDIERE.
Ah, Monſieur, de tout mon çœur.	Ah, Monsieur, de tout mon çœur.
LA FLE'CHE.	LA FLE'CHE.
De tout mon cœur :	De tout mon cœur :
Fort bien.	Fort bien.
Vous eſtes uhorave nomme.	Vous êtes horave nomme.
Or coune vous icavez, ou que vous ne ſçavez pas;	Or coune vous icavez, ou que vous ne savez pas;
je ſuis Capitaine dans le Regiment de Limoges.	je suis Capitaine dans le Regiment de Limoges.
IOBELIN.	JOBELIN.
Vous eſtes Capitaine?	Vous êtes Capitaine?
Et que faites-vous à Paris pendant que tout le monde eſt en campagne?	Et que faites-vous à Paris pendant que tout le monde est en campagne?
LA FLE'CHE.	LA FLE'CHE.
y ſuis venu pour faire une recruë, & en attendant je paſſe le temps au Cabaret à faire mes obſervations ſur la guerre prefente.	y suis venue pour faire une recrue, et en attendant je passe le temps au Cabaret à faire mes observations sur la guerre présente.
IOBELIN.	JOBELIN.
voua des coerracons d un grand ſccouis a la Repdonques	voua des coerracons d un grand scouis à la Répédonques
LA FLECHE.	LA FLÈCHE.
D'un grand ſecours?	D'un grand secours?
Je me donne au Diable, ſi j'eſtois General d’armée, & qu’on me laiſſaſt faire, j’ay un plan dans ma teſte pour conquerir tout l’Europe en une campagne.	Je me donne au Diable, si j'étais Général d'armée, et qu'on me laissât faire, j'ai un plan dans ma tête pour conquérir tout l'Europe en une campagne.
Ecoutez bien ce raiſonnement cy.	Écoutez bien ce raisonnement cy.
Ie voudrois avoir deux armées, l'une au Midy, & l’autre au SeptentrionAvec celle-cy je marche en Allemagne, & je commence par m’emparer de toutes les vignes qui bordent le Rhin.	Je voudrais avoir deux armées, l'une au Midi, et l'autre au SeptentrionAvec celle-cy je marche en Allemagne, et je commence par m'emparer de toutes les vignes qui bordent le Rhin.
Les Allemans n’ayant plus de vin, il faut qu’ils crévent, la mortalité ſe met dans leur armée, & par conſequent me voila maiſtre de tout ce pays-là.	Les Allemans n'ayant plus de vin, il faut qu'ils crèvent, la mortalité se met dans leur armée, et par conséquent me voilà maître de tout ce pays-là.
I'y fais rafraîchir mon armée, & de là je paſſe en Hollande.	J'y fais rafraîchir mon armée, et de là je passe en Hollande.
Allons me voiIa en Hollande, qui m’aime me ſuive.	Allons me voiIa en Hollande, qui m'aime me suive.
Je vay d’abord.	Je vais d'abord.
Attendez, je crois que nous ferions mieux de conquerir auparavant la Turquie.	Attendez, je crois que nous ferions mieux de conquérir auparavant la Turquie.
Qu’en croyez-vous?	Qu'en croyez-vous?
Ouy, c’eſt bien dit.	Oui, c'est bien dit.
Allons enfans ne nous reburons point Nous arriverous bien-toſt.	Allons enfants ne nous reburons point Nous arriverous bientôt.
Nous voicy déja dans la Gréce.	Nous voici déjà dans la Grèce.
Ah le beau païs.	Ah le beau pays.
Dieu ſç uit comme nous allons ſouſſer de ce bon vin Grec.	Dieu tem uit comme nous allons sousser de ce bon vin Grec.
Mais, Meſſieurs, ne vous enyvrez pas au moins.	Mais, Messieurs, ne vous enivrez pas au moins.
Tu Dieu nons avons beſoin de voſtre cervelle.	Tu Dieu nons avons besoin de votre cervelle.
Buvons ſeulement chacun bouteille en chantant une petite Chanſon:	Buvons seulement chacun bouteille en chant une petite Chanson:
Brin bronbrac, Monmecemoy uis l'uune bis veveroo.	Brin bronbrac, Monmecemoi uis l'une bis veveroo.
LELIN.	LELIN.
Voila un pauvre diable qui eſt bien yvre.	Voilà un pauvre diable qui est bien ivre.
LA SOURDIERE.	LA SOURDIERE.
Plenez nalcme Momeur, vous avez	Plenez nalcme Momeur, vous avez
LA FLECHE.	LA FLÈCHE.
Voila ce qu’on appelle faire la guerre cela, & aller viſte en beſogne.	Voilà ce qu'on appelle faire la guerre cela, et aller vite en besogne.
JOBELIN.	JOBELIN.
Ouy, mais voila bien du pays battu, & pour faire tout ce chemin là, il faut que vous donniez des chevaux de poſte à toute voſtre armée.	Oui, mais voilà bien du pays battu, et pour faire tout ce chemin là, il faut que vous donniez des chevaux de poste à toute votre armée.
Revenons à voſtre affaire s’il vous plaiſt.	Revenons à votre affaire s'il vous plaît.
Que ſouhaitez-vous de moy?	Que souhaitez-vous de moi?
LA FLE'CHE.	LA FLE'CHE.
Je m’en vay vous le dire.	Je m'en vais vous le dire.
J’ay quinze hommes à refaire à ma compagnie avant de retourner à noſtre garniſon, & comme je n’ay point d’argent, voila un diamant de cinq cens écus que je vous prie de me faire mettre en gage pour deux ou trois cens piſtoles.	J'ai quinze hommes à refaire à ma compagnie avant de retourner à notre garnison, et comme je n'ai point d'argent, voilà un diamant de cinq cents écus que je vous prie de me faire mettre en gage pour deux ou trois cens pistoles.
JOBELIN.	JOBELIN.
Pour deux ou trois cens piſtoles?	Pour deux ou trois cens pistoles?
vous voulez dne deux où trois cens ccus.	vous voulez dune deux où trois cens ccus.
LA FLE'CHE.	LA FLE'CHE.
Eh ouy, quelque choſe comme cela.	Eh oui, quelque chose comme cela.
OBELIN à part.	ÔBELIN à part.
Peſte, voila un fort beau diamant.	Peste, voilà un fort beau diamant.
Ce ſeroit un vray preſent à faire à ma maîtreſſe:	Ce serait un vrai présent à faire à ma maîtresse:
Taſchons d’empaumer cet yvrogne la.	Tâchons d'empaumer cet ivrogne la.
Momneur vous ne tronverez guere que quatre cens francs là deſſus.	Momneur vous ne tronverez guère que quatre cens francs là -dessus.
LA FLE'CHE, Quatre cens francs.	LA FLE'CHE, Quatre cens francs.
J’aimerois mieux que le diamant fut au fin fonds de la mer Meeicerunee, Alnons je uen vay le jouer au piquet pour cent piſtoles contre le premier venu.	J'aimerais mieux que le diamant fut au fin fond de la mer Meicerunée, Alons je ôuv le jouer au piquet pour cent pistoles contre le premier venu.
Je n’aime point à lanterner moy.	Je n'aime point à lanterner moi.
OBELIN à part.	ÔBELIN à part.
Parbleu il ne faut pas manquer l’occaſion.	Parbleu il ne faut pas manquer l'occasion.
Il eſt ſou comme une grive.	Il est sou comme une grive.
Embarquons-le dans le jeu.	Embarquons-le dans le jeu.
Monſieur ſi vous eſtes homme à joüer, je vous feray voſtre affaire.	Monsieur si vous êtes homme à jouer, je vous ferai votre affaire.
LA FLE'CHE.	LA FLE'CHE.
Ouy?	Oui?
parbleu j’aime les gens d’accommodement:	parbleu j'aime les gens d'accommodement:
Touchez-là.	Touchez-là.
Je veux vous procurer la pratique du Regiment pour tous les Contracts de mariage & d’acquiſition de rente que feront nos Officiers.	Je veux vous procurer la pratique du Regiment pour tous les Contracts de mariage et d'acquisition de rente que feront nos Officiers.
JOBELIN.	JOBELIN.
Je vous remercie.	Je vous remercie.
Je croy que les acquiſitions, auſſi bien que les mariages de ces Meſſieurs là, ſe font ordinairement ſans Contract.	Je crois que les acquisitions, aussi bien que les mariages de ces Messieurs là, se font ordinairement sans Contrat.
LA FLECHE.	LA FLÈCHE.
Allons nous-en la dedans boire une bouteille de Perſico.	Allons nous-en la dedans boire une bouteille de Persico.
JOBELIN.	JOBELIN.
à part.	à part.
Volontiers.	Volontiers.
Je tiens I’aſne par la bride, & le diamant eſt bien avanturé.	Je tiens J'âne par la bride, et le diamant est bien aventuré.
LA FLE'CHE à part.	LA FLE'CHE à part.
Le poiſſon eſt dans mes filets, & nous allons voir beau jeu.	Le poisson est dans mes filets, et nous allons voir beau jeu.
Allons mon amy :	Allons mon ami :
La ralera lera.	La râlera lera.
LA SOURDIERE.	LA SOURDIERE.
Il faut que je conduiſe cecy de l’œil.	Il faut que je conduise ceci de l'œil.
Je ſeray bien aiſe de luy aider à gagner le diamant, afin d’eſtre de moitié.	Je serai bien aise de même aider à gagner le diamant, afin d'être de moitié.
SCENE	SCÈNE
Sourcé que nationale de France	Sourcé que nationale de France
SCENE XIV.	SCÈNE XIV.
LE CHEVALIER, CORONIS, LA SOURDIERE.	LE CHEVALIER, CORONIS, LA SOURDIERE.
LE CHEVALIER & CORONIS.	LE CHEVALIER et CORONIS.
ZXH, ah, ah, ak, ah, ah!	ZXH, ah, ah, aabk, ah, ah!
LGE ABER.	LGE ABER.
Parbleu c’eſt trop plaiſant, ah, ah, ah.	Parbleu c'est trop plaisant, ah, ah, ah.
En con foir la Sobrdlete, ou vasstde	En con soir la Sobrdlete, ou vasstède
LA SOURDIERE.	LA SOURDIERE.
Laiſſe-moy aller:	Laisse-moi aller:
J’ay affaire.	J'ai affaire.
LE CHEVALIER.	LE CHEVALIER.
ul toi lerviteur.	ul toi lerviteur.
Tu ne t’en iras pas que je ne t’aye conté ce qui vient de nous dariver, cela dieite oien ton attention.	Tu ne t'en iras pas que je ne t'aie conté ce qui vient de nous dariver, cela dite oien ton attention.
Nous eſtions chez Principe.	Nous étions chez Principe.
LA SOURDIERE.	LA SOURDIERE.
Je n’ay pas le temps de t’entendre.	Je n'ai pas le temps de t'entendre.
CORONIS.	CORONIS.
Oh cadedis vous nous écouterez, ou nous aurons du bruit.	Oh cadedis vous nous écouterez, ou nous aurons du bruit.
D	D
LE CHEVACIER.	LE CHÉVACIÈR.
Un de nos amis qui ſe deſennuyoit à caſſer des vitres & des lanternes dans la ruë ſaint Honoré, a eſté pourſuivy par une Compâgnie de Guet à pied.	Un de nos amis qui se désennuyait à casser des vitres et des lanternes dans la rue saint Honoré, a été poursuivi par une Compagnie de Guet à pied.
Les Archers ont paſſé pardevant la Boutique, nous les avons arreſtez en leur preſentant du roſſoly & de l’eau de vie.	Les Archers ont passé pardevant la Boutique, nous les avons arrêtés en leur présentant du rossoly et de l'eau de vie.
Ils y ont pris gouſt, & pendant qu’ils beuvoient, nous leur avons eſcamorté leurs armes.	Ils y ont pris goût, et pendant qu'ils buvaient, nous leur avons escamorté leurs armes.
Ils s’en ſont apperçeus, recours à la razade.	Ils s'en sont aperçus, recours à la rasade.
Ils ont voulu ſe fâcher, autre razade;	Ils ont voulu se fâcher, autre rasade;
ſi bien que de razade en razade, nous les avons tellement enyvrez, qu’ils ont pris querelle entre-eux, & ſe ſont donnez je ne ſçay combien de coups de poing.	si bien que de rasade en rasade, nous les avons tellement enivrez, qu'ils ont pris querelle entre-eux, et se sont donnez je ne sais combien de coups de poing.
Le Sergent plus yvre qu’eux, les a tous menez au Châtelet comme perturbateurs du repos public.	Le Sergent plus ivre qu'eux, les a tous menez au Châtelet comme perturbateurs du repos public.
Ne trouves-tu pas cela plaiſant?	Ne trouves-tu pas cela plaisant?
LA SOURDIERE.	LA SOURDIERE.
Ouy fort plaiſant.	Oui fort plaisant.
Vous joüez à vous ſaire de jolies affaires.	Vous jouez à vous zaïre de jolies affaires.
Boire le jour, couiir ſa nuit, caſſer des vittes, arracher des enſeignes, enyvrer le Guet, voila le ſecret d’attraper un jour quelque bon coup de mouſquet par les oreilles.	Boire le jour, couiir sa nuit, casser des vittes, arracher des enseignes, enivrer le Guet, voilà le secret d'attraper un jour quelque bon coup de mousquet par les oreilles.
LE CHEVREIER.	LE CHÉVREIÈR.
Oh vous voila Monſieur le Caton, qui parlez par Sentences.	Oh vous voilà Monsieur le Caton, qui parlez par Sentences.
Parbleu vous ne le prenez pas mal.	Parbleu vous ne le prenez pas mal.
Sçais-tu bien qu’il n’y a rien de meilleur pour la ſanté que de berner de temps en temps les gens qui nous déplaiſent, demande aux Medecins, cela éclaircit les humeurs, cela rafraîchit le ſang, & cela aide à la digeſtion.	Sais-tu bien qu'il n'y a rien de meilleur pour la santé que de berner de temps en temps les gens qui nous déplaisent, demande aux Médecins, cela éclaircit les humeurs, cela rafraîchit le sang, et cela aide à la digestion.
CORONIS.	CORONIS.
Sans doute.	Sans doute.
Comment mordy des coquins s’erigeront en perturbateurs des diVertiſemens de Lune, & nous ne refosmerions pas cet abus?	Comment mordi des coquins s'érigeront en perturbateurs des diVertisements de Lune, et nous ne refosmerions pas cet abus?
LA SOURDIERE.	LA SOURDIERE.
Ma foy ce ſont vos affaires.	Ma foi ce sont vos affaires.
Serviteur.	Serviteur.
2 Que diantre tu es bien preſſé.	2 Que diantre tu es bien pressé.
Parlons un moment.	Parlons un moment.
As-tu veu le nouvel Opera?	As-tu vu le nouvel Opéra?
LA SOURDIERE.	LA SOURDIERE.
Non, je ne le vois jamais que dans l’Affiche.	Non, je ne le vois jamais que dans l'Affiche.
LE CHEVALIER.	LE CHEVALIER.
Et toy l’as-tu vû?	Et toi l'as-tu vu?
CORONIS.	CORONIS.
Soy celtes le lay vus.	Soi celtes le lai vu.
LE CHEVALIER.	LE CHEVALIER.
Hé bien, dy-nous un peu, comment le trouves-tu ?	Hé bien, dis-nous un peu, comment le trouves-tu ?
CORONIS.	CORONIS.
Cadedis comment je le trouve!	Cadedis comment je le trouve!
raviſſant, merveilleux.	ravissant, merveilleux.
Tout ce qui s’apelle D i Opera, voyez-vous, ne peut-eſtre que bon & agreable;	Tout ce qui s'appelle Dle Opéra, voyez-vous, ne peut-être que bon et agréable;
& la raiſon la voicy.	et la raison la voici.
C'eſt que dans un Opera vous trouvez de tout:	C'est que dans un Opéra vous trouvez de tout:
Vers, Muſique, Ballet, Machines, Simphonies, c’eſt une varieré ſurprenante, il y a dequoy contenter tout le' monde.	Vers, Musique, Ballet, Machines, Simphonies, c'est une varieré surprenante, il y a dequoy contenter tout le monde.
Voulez-vous du grand, du Tragique, du Pathetique?	Voulez-vous du grand, du Tragique, du Pathétique?
Le perfide Renaud me fuit, Tout perfide qu’il eſt mon lâche cœur le ſuit.	Le perfide Renaud me fuit, Tout perfide qu'il est mon lâche cœur le suit.
Aymez vous le tendre, le doux, le paſſionné, Non je ne pourrois pas encor Quitter mon Berger pour Medor.	Aimez -vous le tendre, le doux, le passionné, Non je ne pourrais pas encor Quitter mon Berger pour Médor.
Voulez-vous du burleſque?	Voulez-vous du burlesque?
Mes pauvres compagnons helas!	Mes pauvres compagnons hélas!
Le dragon n’en a fait qu’un fort leger repas.	Le dragon n'en a fait qu'un fort léger repas.
Voulez-vous de la Morale?	Voulez-vous de la Morale?
Les Dieux puniſſent la fierté, Il n’eſt point de grandeur que le Ciel Prité N'abaiſſe, quand il veut, & ne reduiſe en poudre;	Les Dieux punissent la fierté, Il n'est point de grandeur que le Ciel Prité N'abaisse, quand il veut, et ne réduise en poudre;
Et le reſte.	Et le reste.
Ou y trouve juſqu’à des Vaudevilles, & des imitations naïves des airs du Pont-neuf, ſi vous voulez.	Ou y trouve jusqu'à des Vaudevilles, et des imitations naïves des airs du Pont-neuf, si vous voulez.
Les Roſſi gnols dés que le jour cemmence Chantent l’amour qui les anime tous.	Les Rossi gnols dès que le jour cémence Chantent l'amour qui les anime tous.
.	.
En un mot, c’eſt un enchantement, & ce ſeroit une choſe accomplie, ſi l’on pouvoit faire en ſorte que le chant fut fait Pour les vels, ce les vers pour le cnont.	En un mot, c'est un enchantement, et ce serait une chose accomplie, si l'on pouvait faire en sorte que le chant fut fait Pour les vels, ce les vers pour le cont.
LE CHEVALIER.	LE CHEVALIER.
Pour moy je ne me divertis point à l’Opera, & je n’y vais jamais que pour folatrer dans les couliſſes avec quelque danſeuſe.	Pour moi je ne me divertis point à l'Opéra, et je n'y vais jamais que pour folâtrer dans les coulisses avec quelque danseuse.
CORONIS.	CORONIS.
Il eſt vray que bien des gens y vont preſentement pour tout autre plaiſir que celuy des oreilles.	Il est vrai que bien des gens y vont présentement pour tout autre plaisir que celui des oreilles.
SCENE XV.	SCÈNE XV.
Mad.	Mad.
JEROSME, LE CHEVALIER, CORONIS, LA SOURDIERE.	JÉRÔME, LE CHEVALIER, CORONIS, LA SOURDIERE.
Mad.	Mad.
juleobnu.	juleobhu.
Eineuis, n’eit miun tomne, faites- T'A moy la grace de vous retirer.	Einvis, n'éit miun tomne, faites- T'-A moi la grâce de vous retirer.
LA SOURDIERE.	LA SOURDIERE.
Volontiers.	Volontiers.
LE CHEVALIER.	LE CHEVALIER.
Attens, attens.	Attends, attends.
Et par quelle raiſon nous aetirer Madame Jeroſme?	Et par quelle raison nous aétirer Madame Jérôme?
Mad- JEROSME.	Mad- JÉRÔME.
Par la raiſon, Monſieur, que voicy l’heur re que les femmes viennent icy, & que puiſqu’elle;	Par la raison, Monsieur, que voici l'heur re que les femmes viennent ici, et que puisqu'elle;
ne viennent pas vous incommoder le jour, il eſt bien juſte que vous leur laiſſiez la nuir, chacun le ſien n’eſt pas trop.	ne viennent pas vous incommoder le jour, il est bien juste que vous leur laissiez la nuir, chacun le sien n'est pas trop.
LE CHEVALIER.	LE CHEVALIER.
vous cices poul les icescucions loccuſnes Madame Jeroſme.	vous cices poul les icescucions loccusnes Madame Jérôme.
Mad.	Mad.
JEROSME.	JÉRÔME.
Oh vrayment ſi on n'avoit d'autres rentes que la dépenſe qui ſe fait icy de jour, & ſans le caſuel de la nuit, on courroit rilque d’avoir les dents bien longues.	Oh vraiment si on n'avait d'autres rentes que la dépense qui se fait ici de jour, et sans le casuel de la nuit, on courrait rilque d'avoir les dents bien longues.
Vous eſtes cinq ou ſix, qui pourveu que vous ſoyez toute une apreſdînée icy à chanter des Chanſons, dire des fadaiſes, conter une hiſtoire de celuy-cy, une avanture de celle-là, & faire la cronique ſcandaleuſe du genre humain, ne vous embaraſſez pas du reſte.	Vous êtes cinq ou six, qui pourvu que vous soyez toute une apresdînée ici à chanter des Chansons, dire des fadaises, conter une histoire de celui-cy, une aventure de celle-là, et faire la cronique scandaleuse du genre humain, ne vous embarrassez pas du reste.
Cependant ce n’eſt pas là mon compte, & je ne dîne pas de vos converlations, vous vonla dron par cxemple qui me devez de l’argent depuis long-temps, & qui ne parlez non plus de payer, que ſi vous eſtiez icy logez par étape.	Cependant ce n'est pas là mon compte, et je ne dîne pas de vos convérlations, vous vonla dron par cxemple qui me devez de l'argent depuis longtemps, et qui ne parlez non plus de payer, que si vous étiez ici logez par étape.
CORONIS.	CORONIS.
Quant à moy, Madame Jeroſme, je vous dois, je penſe, trois écus, mais j’attens ſbim lauune de cunge	Quant à moi, Madame Jérôme, je vous dois, je pense, trois écus, mais j'attends s' une de cunge
LE CHEVALIER.	LE CHEVALIER.
Pour moy je ſuis broüillé avec ma petite Marchande de galon, & je ne ſçaurois vous payer qu’aprés la paix.	Pour moi je suis brouillé avec ma petite Marchande de galon, et je ne saurais vous payer qu'après la paix.
LA SOURDIERE.	LA SOURDIERE.
Et moy' je vous proteſte que le premier agent que je gagnelay aux trois dez ſera pour vous.	Et moi' je vous proteste que le premier agent que je gagnelai aux trois dé sera pour vous.
Mad.	Mad.
JEROSME.	JÉRÔME.
Voila des detres bien aſſurées.	Voilà des détres bien assurées.
SCENE XVI.	SCÈNE XVI.
OBELIN, LA FLE'CHE,M.	OBELIN, LA FLÉCHE,M.
JEROSME, CORONIS, LE CHEVALIER, LA SOURDIERE.	JÉRÔME, CORONIS, LE CHEVALIER, LA SOURDIERE.
CMRONS di ebc ouster, JOicy nos gens.	CMRONS di ébc ooûter, JOici nos gens.
Songeons à ce que y nous a recommandé Dorante.	Songeons à ce que y nous a recommandé Dorante.
LA FLE'CHE.	LA FLE'CHE.
Vous me devez ſix-vingts piſtoles payez-moy, je ne joüe plus.	Vous me devez six-vingts pistoles payez-moi, je ne joue plus.
OBELIN.	ÔBELIN.
Comment, vous ne me donnez pas ma sevancne3.	Comment, vous ne me donnez pas ma sévancne3.
LA FLECHE.	LA FLÈCHE.
Dequoy vous plaignez-vous Je vous ay gagné au piquet, vous me demandez voſtre revanche au pair & non, je vous la donne, je ne vous gagne que douze cens livres, & j’ay hazardé mon diamant qui en vaut quinze cens, c’eſt cent écus que je pers clairement;	Dequoy vous plaignez-vous Et vous ai gagné au piquet, vous me demandez votre revanche au pair et non, je vous la donne, je ne vous gagne que douze cens livres, et j'ai hasardé mon diamant qui en vaut quinze cens, c'est cent écus que je perds clairement;
il me ſemble que je fais aſſez bien les choſes.	il me semble que je fais assez bien les choses.
OBELIN.	ÔBELIN.
2e Dieu voas ayeu la parole cien lorc, pour un homme qui eſtoit yvre il n’y a qu’un moment.	2e Dieu vœux aïeu la parole cien lorc, pour un homme qui était ivre il n'y a qu'un moment.
LA FLECHE.	LA FLÈCHE.
C’eſt que je me ſuis deſenyvré en gagnant voſtre argent.	C'est que je me suis désenivré en gagnant votre argent.
Allons, les bons comptes font les bons amis, payez-moy coat a rneute, oajo voue pane mon cpcc au travers du corps.	Allons, les bons comptes font les bons amis, payez-moi coût a rute, ojo ute pane mon cpc au travers du corps.
OBELIN.	ÔBELIN.
Meſſieurs ſeparez-nous, je vous prie.	Messieurs séparés-nous, je vous prie.
LE CHEVALIER.	LE CHEVALIER.
3 Comment morbleu, on inſulte Monſieur Jobelin ?	3 Comment morbleu, on insulte Monsieur Jobelin ?
CORONIS.	CORONIS.
Allons ſandis coupons les oreilles à ce Maraut.	Allons sandis coupons les oreilles à ce Maraut.
LA SOURDIERE.	LA SOURDIERE.
Des épees tirées !	Des épees tirées !
allons-nous-en d’icy.	allons-nous-en d'ici.
Mad.	Mad.
JEROSME.	JÉRÔME.
Meſſieurs!	Messieurs!
quel deſordre!	quel désordre!
je ſuis perduë.	je suis perdue.
LA FLECHE.	LA FLÈCHE.
Comment canailles?	Comment canailles?
deux contr’un?	deux contr'un?
ah ay le corps peſce, je ſuis mort:	ah ai le corps pesée, je suis mort:
On Chirurgien.	On Chirurgien.
Mad.	Mad.
JEROSME.	JÉRÔME.
Miſericorde!	Miséricorde!
un homme tué dans me maiſon.	un homme tué dans me maison.
Me voila ruinée.	Me voilà ruinée.
CORanTs.	CORanTs.
Sauvons-nous Meſſieurs.	Sauvons-nous Messieurs.
SCENE XVII.	SCÈNE XVII.
DORANTE, L’ABBE' Mad.	DORANTE, L'ABBE' Mad.
JEROSME, JOBELIN, LA FLE’CHE.	JÉRÔME, JOBELIN, LA FLE'CHE.
DORANTE.	DORANTE.
Uel bruit ay-je entendu?	Oùel bruit ai-je entendu?
mais que vois-je?	mais que vois-je?
ah Ciel, Monſieur de Boiſclair qui vous a mis en cet état?	ah Ciel, Monsieur de Boisclair qui vous a mis en cet état?
LA FLECHE.	LA FLÈCHE.
Ah mon couſin je me meurs, trois coquins viennent de m'aſſaſſiner, & c’eſt ce ſcelerat de Notaire qui les a fait agir.	Ah mon cousin je me meurs, trois coquins viennent de m'assassiner, et c'est ce scélérat de Notaire qui les a fait agir.
Eh de grace qu’on me faſſe venir le Suceur du Regiment.	Eh de grâce qu'on me fasse venir le Suceur du Regiment.
SCENE XVIII.	SCÈNE XVIII.
DORANTE, JOBELIN, M.	DORANTE, JOBELIN, M.
JEROSME.	JÉRÔME.
DORANTE.	DORANTE.
N de mes parens aſſaſſiné!	N de mes parents assassiné!
ah je Ovous aprenaray à qui vous vous joüez.	ah je Ovous apprenarai à qui vous vous jouez.
Hola laquais qu’on maille querir un Commiſſaire.	Holà laquais qu'on maille quérir un Commissaire.
JOBELIN.	JOBELIN.
Ah je tremble, & je voudrois eſtre bien loin.	Ah je tremble, et je voudrais être bien loin.
LADDE.	LADE.
Vous voila dans un vilain cas Madame Jeroſme, & j’en ſuis fâché pour l’amour de vous.	Vous voilà dans un vilain cas Madame Jérôme, et j'en suis fâché pour l'amour de vous.
Mad.	Mad.
JEROSME.	JÉRÔME.
Monſieur Dorante ne me perdez pas, je vous conjure.	Monsieur Dorante ne me perdez pas, je vous conjure.
DORANTE.	DORANTE.
Non, non, cela ne paſſera pas ainſic’eſt mon couſin germain, on l’a aſſaſſiné chez vous, c’eſt à vous à m’en répondre, & je veux que la juſtice ſoit faite.	Non, non, cela ne passera pas ainsic'est mon cousin germain, on l'a assassiné chez vous, c'est à vous à m'en répondre, et je veux que la justice soit faite.
Mad.	Mad.
JEROSME.	JÉRÔME.
Hé Monſieur voudriez-vous me ruiner?	Hé Monsieur voudriez-vous me ruiner?
DORANTE.	DORANTE.
Vous n’en ſerez pas quitte à ſi bon marche, & je veux vous raite punir corporellement.	Vous n'en serez pas quitte à si bon marche, et je veux vous raite punir corporellement.
L'ABBE'.	L'ABBE'.
Corporellement!	Corporellement!
cela ne vaut pas le diable Madame Jeroſme.	cela ne vaut pas le diable Madame Jérôme.
SCENE DERNIERE.	SCÈNE DERNIÈRE.
DORANTE, L’ABBE', Mad JEROSME.	DORANTE, L'ABBE', Mad JÉRÔME.
JOBELIN, LA FLE'CHE en Commiſſaire	JOBELIN, LA FLE'CHE en Commissaire
DORANTE.	DORANTE.
Oicy fort à propos Monſieur le  Commiſſaire.	Oici fort à propos Monsieur le Commissaire.
Monſieur on vient de tuer icy un Officier qui eſt de mes parens.	Monsieur on vient de tuer ici un Officier qui est de mes parents.
Je vous prie de faire voſtre charge.	Je vous prie de faire votre charge.
LA FLE'CHE controfaiſant ſa voix.	LA FLÉCHE controfaisant sa voix.
Voſtre laquais m'a informé de la choſe& j'ameine des Archers pour conduire les delnquans au Chaſeiec.	Votre laquais m'a informé de la choseet j'amène des Archers pour conduire les delnquans au Chaseiec.
Mad.	Mad.
JEROSME.	JÉRÔME.
Au Châteler!	Au Châteler!
JOBELIN.	JOBELIN.
Rerdinuoue juaamneoeminonee jeises Conſeiller du Roy.	Rerdinue juaamneoeminonee jeises Conseiller du Roi.
LA FLECHE.	LA FLÈCHE.
N’importe le delit eſt flagrant, il y a mort d’homme, & vous viendrez au Châtelet.	N'importe le délit est flagrant, il y a mort d'homme, et vous viendrez au Châtelet.
Mad.	Mad.
JEROSME.	JÉRÔME.
nla jeidis au celcip ois aronneurlAbbe, faites en ſorte que je n’aille point au Châtelet.	nla jeidis au celcip ois aronneurlAbe, faites en sorte que je n'aille point au Châtelet.
L'ABBE'.	L'ABBE'.
Attendez, je viens de trouver un moyen d'ajuſter cecy.	Attendez, je viens de trouver un moyen d'ajuster ceci.
Dorante, il faut accommodet cette affaire là mon enfant.	Dorante, il faut accommodet cette affaire là mon enfant.
Il ne tient uul yuoe mamer Mmaume eroune, mais en ſeras-tu mieux?	Il ne tient ul yvoe mamer Mmaume eroune, mais en seras-tu mieux?
Elle a une jeune fille, il faut qu’elle te la donne en mariage, & qu’il ne ſoit plus parlé de rien	Elle a une jeune fille, il faut qu'elle te la donne en mariage, et qu'il ne soit plus parlé de rien
DORANTE.	DORANTE.
Non, non, Madame la promiſe à Monſieur Jobelin, il faut la laiſſer faire, elle le croit riche, & je vois bien.	Non, non, Madame la promise à Monsieur Jobelin, il faut la laisser faire, elle le croit riche, et je vois bien.
L'ABBE'.	L'ABBE'.
L'ABHE’.	L'ABHÉE.
Luy riche!	Lui riche!
Il n’a point d’autre patrimoine que ſon induſtrie, & il y a actuellement une Sentence par corps contre luy pour le payement de ſa Charge;	Il n'a point d'autre patrimoine que son industrie, et il y a actuellement une Sentence par corps contre grands contre le paiement de sa Charge;
n’eſt-il pas vray Monſieur Jobelin?	n'est-il pas vrai Monsieur Jobelin?
OBELIN.	ÔBELIN.
Ah tout eſt découvert, i'enrage.	Ah tout est découvert, j'enrage.
Mad.	Mad.
JEROSME.	JÉRÔME.
Qu'entens-je?	Qu'entends-je?
vous devez voſtre Charge Monſieur?	vous devez votre Charge Monsieur?
Vrayment un jour plus tard ’allois faire un joly marché.	Vraiment un jour plus tard 'allais faire un joli marché.
L’ABBE’.	L'ABBE'.
Hé bien, Madame, eſtes-vous dans le gouſt de ma propoſition?	Hé bien, Madame, êtes-vous dans le goût de ma proposition?
Mad.	Mad.
JEROSME.	JÉRÔME.
Ouy, Monſieur, puiſque je ſuis détrompée, je ſeray ravie de donner ma fille à Monſieur Dorante, pourveu qu’il appaiſe l’affaire qui vient d’arriver.	Oui, Monsieur, puisque je suis détrompée, je serai ravie de donner ma fille à Monsieur Dorante, pourvu qu'il apaise l'affaire qui vient d'arriver.
L’ABBE'.	L'ABBE'.
On pour cela, Mlauame, il en eſt le maiſtre, je vous aſſure.	On pour cela, Mlavme, il en est le maître, je vous assure.
C’a il n’y a qu’à dreſſet le Contract tout à Tneure, Monfieur Jobelin ſe trouve icy fort à propos.	C'a il n'y a qu'à dresset le Contrat tout à Tanneure, Monfieur Jobelin se trouve ici fort à propos.
OBELIN.	ÔBELIN.
Moy dreſſer le Contract!	Moi dresser le Contrat!
DORANTE.	DORANTE.
Tout beau ne vous faites pas tirer l'e	Tout beau ne vous faites pas tirer l'e
LE CAFFE' COMEDIE.	LE CAFFE' COMÉDIE.
rtille, où je vay faire entrer les Archers.	rtille, où je vais faire entrer les Archers.
LA FLE'CHE.	LA FLE'CHE.
Et Yon vous Mencia dd Cuacciete	Et Yon vous Méncia dd Cuacciète
OBELIN.	ÔBELIN.
Quoy j’auray encore la mortification de faire le Contract de mariage de mon Rival?	Quoi j'aurai encore la mortification de faire le Contrat de mariage de mon Rival?
ah maudit pair & non	ah maudit pair et non
DORANTE.	DORANTE.
Allons Monſieur l’Abbé & Monſieur le Commiſſaire, venez ſervir de témoins & ſigner au Contract que nous allons paſſer tout-à-l'heute.	Allons Monsieur l'Abbé et Monsieur le Commissaire, venez servir de témoins et signer au Contrat que nous allons passer tout-à-l'hute.
A FLECHE.	À FLÈCHE.
Ma foy voila de Caffe.	Ma foi voilà de Caffe.
B rerirable avanture	 Brirable aventure
FIN.	FIN.
