LA TRAGEDIE DE PRYAM,ROY.	LA TRAGÉDIE DE PRIAM,ROY.
DE TROYE.	DE TROYE.
Madame de la Loue	Madame de la Loue
ADAME, ayant apris par vo& ſtre propre bouche, que vous prenſez vn extreme contentement à la lecture des Tragedies Lpour y voir les deſplaiſirs d’autruy, & y prendre les moyens de conſtãment ſupporter les noſtres.	ADAME, ayant appris par voù être propre bouche, que vous prensez extrême extrême contentement à la lecture des Tragédies Lpour y voir les déplaisirs d'autrui, et y prendre les moyens de constãment supporter les nôtres.
Ie n’ay voulu manquer à ce quẽ mon deuoir me demandoit, & voſtre merite me commandoit:	Je n'ai voulu manquer à ce quẽ mon devoir me demandait, et votre mérite me commandait:
puiſque le temps ma ouuert le pas pour frãchir la barriere du ſeruice que ie vous doibs, & vous faire voir par ce petit preſent (au front duquel cõme pour vn ſauf conduict i’ay ciſelé les caracteres de voſtre nom) que ie ne me ſuis pas ſoucié d’écourir la reputation d’vn ignorãt audacieux, pourueu que vous ayez mon offre pour agre.	puisque le temps ma ouvert le pas pour frãchir la barrière du service que ie vous doibs, et vous faire voir par ce petit présent (au front duquel cõme pour un sauf conduit j'ai ciselé les caractères de votre nom) que je ne me suis pas soucié d'écourir la réputation d'un ignorant audacieux, pourvu que vous ayez mon offre pour agré.
able, & me faciez l’honneur de me tenir,	able, et me fassiez l'honneur de me tenir,
Voſtre treſ-bumble & trer-fdelle feruiteur de LERTRAND.	Votre très-bumble et trer-fdelle serviteur de LERTRAND.
ANAGRAMME DV SIEVR DE BERTHRANP.	ANAGRAMME DU SIEUR DE BERTHRANP.
François Berthrand.	Français Berthrand.
Ronſard bien franc.	Ronsard bien franc.
QVATRAIN A L’AVTHEVR	QUATRAIN À L'AUTHÉVR
Ouſard mort on te voit de ſa cendre renaiſtre, N comme vn Phænix nouueau, bonneur des bons eſprits, Recognoiſſant auſſi ton nom & tes eſcripts Tour vn RONSARD BTIN FRANC ie veux retognoiſtre.	Ousard mort on te voit de sa cendre renaître, N comme un Phænix nouveau, bonneur des bons esprits, Reconnaissant aussi ton nom et tes écripts Tour un RONSARD BTIN FRANCHum veux retognoistre.
F.	F.
GALLAND Lyonnois,	GALLAND Lyonnais,
Calchas deuin.	Calchas devin.
Hector.	Hector.
LA TRAGEDIE DE PRYAM ROY DE TROVE.	LA TRAGÉDIE DE PRIAM ROY DE -TROUE.
ACTE I.	ACTE I.
ſunon.	sunon.
Panlas.	Panlas.
Venus.	Venus.
Paris.	Paris.
le E ce grand Ciel brillant où les ſoudres ſe ſorgent, Et d’où cent mille eſclairs icy bas ſe deſgorgent, Nous debarrons la porte, enfant de ce grand Roy Qui fait trembler l'Aſie & ployer ſous ſa loy.	le E ce grand Ciel brillant où les soudres se sorgent, Et d'où cent mille éclairs ici bas se dégorgent, Nous débarrons la porte, enfant de ce grand Roi Qui fait trembler l'Asie et ployer sous sa loi.
C’eſt un braue ſuiet qui vers toy nous ameine, 23 Car les Dieux pour un peu ne prẽnẽt tãt de peins C’eſt vn braue ſuiect qui nous bauſſe le cœur, Doncques que l’équité ſurmonte la faueur, Et non ſeduit des biens qui ſeduiſent vn Iuge, Mais ſelon tes beaux yeux iuge nous, & adiuge La Pomme à celle-là qui l’aur a merité, Et qui aura paßé ſa compagne en beauté, Jupiter t’enuoya par ſon enſant Mercure 2	C'est un brave sujet qui vers toi nous ameine, 23 Car les Dieux pour un peu ne prenez tant de peins C'est un brave sujet qui nous bausse le cœur, Doncques que l'équité surmonte la faveur, Et non séduit des biens qui séduisent un Juge, Mais selon tes beaux yeux juge nous, et ajuge La Pomme à celle-là qui l'aur a mérité, Et qui aura passé sa compagne en beauté, Jupiter t'envoya par son ensant Mercure 2
Fils de luy & de Marie alantide la cure Zng petit globe d’or aſin d'en houorer.	Fils de Seigneur et de Marie alantide la cure Zng petit globe d'or asin d'en houorer.
Cille dont les beaux yeux te feront admirer, Et qui ſeule pour eſtre d'nulle autre ſeconde, Parangonne en beauté les plus belles du moude.	Cille dont les beaux yeux te feront admirer, Et qui seule pour être d'nulle autre seconde, Parangonne en beauté les plus belles du moude.
Si tu veux de bien pres contempler les portraicts De mon viſage vni, les attraits, & les traits Qui volent de mes yeux, comme vne ſlamme viue, Qui rendent l’ame morte, & puis la rendent viue, Les graces de ma grace & ficber les rayons a jeune claitte, ſur mon front ſans ſillons, Polly comme la mer que le vent ne tourmenie, Ains qui dort dans ſon lict comme vne languiſſante Ie croy que plein d’amour, & remply d’equite, Tu me douras ce don égal à ma beauté.	Si tu veux de bien pres contempler les portraits De mon visage uni, les attraits, et les traits Qui volent de mes yeux, comme une slamme vive, Qui rendent l'âme morte, et puis la rendent vive, Les grâces de ma grâce et ficber les rayons a jeune claite, sur mon front sans sillons, Polly comme la mer que le vent ne tourménie, Ains qui dort dans son lit comme une languissante Je crois que plein d'amour, et rempli d'une, Tu me douras ' on égal à ma beauté.
Puis couſidere encor' la beaute de l’eſclair, Et la beauté des corps qui ſe forment en l’air, contemple la comette, admire la couronne Qui bien ſouueni la Lune en un cercle enuironne, Quelque ſois le ſoleil, quand ſa lente chaleur Ne bruſle la großiere & terreſtre vapeur.	Puis cousidere encor la beauté de l'éclair, Et la beauté des corps qui se forment en l'air, contemple la compette, admire la couronne Qui bien souveni la Lune en un cercle environne, Quelque sois le soleil, quand sa lente chaleur Ne brûle la grossiere et terrestre vapeur.
Hau ſe les yeux au ciel, & la contemple encores Parmy le ſeu leger, parmy les metheores, Iris ma meſſagere are en ciel qui de pleurs, Tire au clel ſans couleuns mille belles couleurs, Deaut z qui ſont Paris ſeulement les parcelles Des beautez que tu vois en mes yeux, eternelles.	Hau se les yeux au ciel, et la contemple encor Parmi le seu léger, parmi les méthéores, Iris ma message are en ciel qui de pleurs, Tire au clel sans couleuns mille belles couleurs, Deaut z qui sont Paris seulement les parcelles Des beautés que tu vois en mes yeux, éternelles.
Donne-moy, donc la Pomme, & iuge moy ainſi	Donne-moi, donc la Pomme, et juge moi ainsi
Regarde de Pallau le regaid ordinaire:	Regarde de Pallau le raid ordinaire:
Contemple de Venus la lub ique lumiere, L’vn eſt verd, & le verd eſt plein de cruauté, L’autre eſt noit, & le noir plein de lubricité.	Contemple de Venus la lub ique lumière, L'un est verd, et le verd est plein de cruauté, L'autre est noit, et le noir plein de lubricité.
Mais mon œil n’eſt pas verd, ni uoir, ains il aſſemble Diuinemeut en ſoy ces deux couleurs enſemble, Plus belle qu’Artemis & que Cypris außi, Tu ſeras le plus riche, & le plus grand du monde, Le ciel te cherira, les airs, les vents, & l’onde Flechiront ſous ta voix, & malgré Phlegeton, Tu iouyras beureux des threſors de Pluton.	Mais mon œil n'est pas verd, ni uoir, ains il assemble Divinemeut en soi ces deux couleurs ensemble, Plus belle qu'Artemis et que Cypris aussi, Tu seras le plus riche, et le plus grand du monde, Le ciel te chérira, les airs, les vents, et l'onde Fléchiront sous ta voix, et malgré Phlégeton, Tu ouiras beureux des trésors de Pluton.
Paris.	Paris.
2, Les Auaricieux ont ſoing de l’auarice, „ Les vitieux außi ſe plaiſent en leur vice, Mais moy qui ſuu Berger gentil & gracieux, Ie ne ſuis vitieux n’y auaricieux:	2, Les Avaricieux ont soin de l'avarice, „ Les vitieux aussi se plaisent en leur vice, Mais moi qui su Berger gentil et gracieux, Je ne suis vitieux n'y avaricieux:
Ie ne me ſoucy' pas des grandeurs de ce monde, I’ayme mieux les foreſts ou le ſoucy n’abonde, Et franc de paßion puiſer l’eau dans la main, Que d’auoir à ſoubait tout le threſor bumain:	Je ne me souci pas des grandeurs de ce monde, J'aime mieux les forêts ou le souci n'abonde, Et franc de passion puiser l'eau dans la main, Que d'avoir à soubait tout le trésor bumain:
Martomtenl dimorajer ma doucement ſelonne, Q'es combats courtiſer la guerr iere Belonne.	Martomtenl dimorajer ma doucement selonne, QU'es combats courtiser la guerr Le Bélonne.
3 Miſerable eſt celuy en qui l’ambition, », La grandeur & le cœur ſait renaiſtre Ixion, »5 El qui ſur ces deſirs comme ſur vne rouë » Ores bai ores baut douteuſement ſe roüe Garde Iunon ces biens pour ceux qui les voudront, Deſireux de porter leurs ennuis ſur leur front, Ie n’en ſuis enuieux, car toute mon enuie, Eſt d’aymer le ſoleil qui reluit a ma vie.	3 Misérable est celui en qui l'ambition, ", La grandeur et le cœur sait renaître Jxion, »5 Él qui sur ces désirs comme sur une roue " Ores bai ores baut douteusement se roue Garde Junon ces biens pour ceux qui les voudront, Désireux de porter leurs ennuis sur leur front, Je n'en suis envieux, car toute mon envie, Est d'aimer le soleil qui reluit à ma vie.
Pallas.	Pallas.
Paris Prince des bois außi bien que d’honneurs Ame gentille & belle & digne d’vn bon-beur, Eſcoute ma parole, & nourris ta poictrine D’vne ſi ambroſine & cœleſte doſtrine Qui te rendra diuin, & pour Dieu n’entend pas Ces diſcours pleins d’appas, & remplis de treſpas, Fuy-les ſi tu es ſage ainſi que fit Vlyſſe.	Paris Prince des bois aussi bien que d'honneurs Âme gentille et belle et digne d'un bonbeur, Escoute ma parole, et nourris ta poitrine D'une si ambrosine et cœleste dostrine Qui te rendra divin, et pour Dieu n'entend pas Ces discours pleins d'appas, et remplis de trépas, Fuis-les si tu es age ainsi que fit Vlysse.
Qui trompa par l’oreille, & le treſpas, & Cires Meſchante Euc hantereſſe hoſteſſe de la mez	Qui trompa par l'oreille, et le trépas, et Cires Mêchante Euc hanteresse hôtesse de la mis
Qui n’auoit le ſoucy que d’aymer & charmer, Uoy race de Deyam des yeux de la prudence, Contemple de l’eſprit, & de l’œil, l'excellence Du beau, qui b.	Qui n'avait le souci que d'aimer et charmer, Uoi race de Dyam des yeux de la prudence, Contemple de l'esprit, et de l'œil, l'excellence Du beau, qui b.
ille en moy & combien ſont heureux Seux qui de mes vertus ſe rendent amoureux.	ille en moi et combien sont heureux Seux qui de mes vertus se rendent amoureux.
Min œil eſt de l’honneur l’honorable lumiere, La chaſte té s’enferme en ma chaſte piupiere, Et comme clairs ſlambeaux de mon eſſence ſont La vertu dans mon cœur la bonte ſus mon front, Honte qui doit garder aux champs & a la ville L’honueur ineſtimable, & ſacre d’vne ſille.	Min œil est de l'honneur l'honorable lumière, La chaste té s'enferme en ma chaste piupière, Et comme clairs sambeaux de mon essence sont La vertu dans mon cœur la bonté sus mon front, Honte qui doit garder aux champs et à la ville L'honveur inestimable, et sacre d'une sille.
Puis i’ay dedans la teſte vn bien qui ne craint paNy les foudres d’en baut, ny les fureurs d’en bas, Foit contre les ſaiſons, les temps & les annees, Qui deſpite du ciel les fortes deſtinces, J’ay vn entendement qui monſtre comme il ſaut Enfermer dans du bois les ſpheres de la haut, Celle du premier ciel, celles des ſept Planettes Celle du ciel buictieme, & leurs cauſis ſecrettes, Il ſçait de la nature enſeigner les effaits, Let cauſes de l’Eclypſe, il cognoit d’où ſes ſaits Tant de iouvs & de nuicts, & bien que creature, Il diſcourt par raiſou de toute la nature, I’ay vne volonté qui ne deſire rien Que les arts, les vertus, la ſageſſe, & le bien Serue de la raiſon qui ne ſait point la terre, Mais qui tend vers le ciel aſin de le conquerre, Fuyant ſage & diuin tout ce qui eſt mortel Suyuant ſage & diuin oe qui eſt immortel.	Puis j'ai dedans la tête un bien qui ne craint paNi les foudres d'en baut, ni les fureurs d'en bas, Fait contre les saisons, les temps et les années, Qui dépite du ciel les fortes destinées, J'ai un entendement qui montre comme il saut Enfermer dans du bois les sphères de la haut, Celle du premier ciel, celles des sept Planettes Celle du ciel buitième, et leurs causs secrètes, Il sait de la nature enseigner les effaits, Let causes de l'Eclypse, il cognoit d'où ses saits Tant de iouvs et de nuicts, et bien que créature, Il discourt par raisou de toute la nature, ay volonté qui ne de rien Que les arts, les vertus, la sa, et le bien Serue de la raison qui ne sait point la terre, Mais qui tend vers le ciel asin de le conquerre, Fuyant g et diuin tout ce , et mortel Suyuant sage et diuin e qui est immortel.
Pres du petit cerueau reſide la memoire, Qui procede des deux, qui donne de la gloire A celuy qui l’bonore, & qui eſt anobly Per ſa propre vertu qui ne tombe en oubly:	Pres du petit cerveau réside la mémoire, Qui procède des deux, qui donne de la gloire A celui qui l'bonore, et qui est anobli Per sa propre vertu qui ne tombe en oubli:
Outre ies trois, threſore, admirable richeſſe, Miou pere m’a donne la force & la ſageſſe, Lorſque Vulcan ouurãt ſon front d’va grand coutean Me ſiſt comme vn gendarme yſſir de ſou cerueau:	Outre jes trois, trésore, admirable richesse, Miou ère m'a donne la force et la sagesse, Lorsque Vulcan ouvrant son front d'une grand coutean Me zist comme un gendarme yssir de sou cerveau:
Iuge donc bien Paris comme Iuge équitable Des yeux du lugement ma beaute perdurable, Beaute tbreſor de faict, & non tbreſor de nom, Non ſubiecte au deſtin comme celle a Iunon, Qui en ſume ta veue ainſi qu’vne ſumee, Ou coume vne vapeur en va rien conſumee:	Juge donc bien Paris comme Juge équitable Des yeux du lugement ma beauté perdurable, Beaute tbresor de fait, et non tbresor de nom, Non sujet au destin comme celle a Junon, Qui ens même ta vue ainsi qu'une sujet, Ou coume une vapeur en va rien consumée:
Et ſi mes yeux ſont verds iuge par equité Que c’eſt la chaſtelé, & non la cruauté:	Et si mes yeux sont verts juge par équité Que c'est la chastelé, et non la cruauté:
Or ſi en ma ſaueur tu donnes la ſentence, Tu ſeras docte & ſort & plein dec ſapience, Fauory de Python, & trainant apres toy, Les rochers ſous ta volx, les hommes ſous ta loy, Alairants ton eſprit, donne moy donc la Pomme, Vn bieu ie te feray au lieu que tu es homme.	Or si en ma saveur tu donnes la sentence, Tu seras docte et sort et plein déc sapience, Favori de Python, et traînant après toi, Les rochers sous ta volx, les hommes sous ta loi, Alairants ton esprit, donne moi donc la Pomme, Un bieu ie te ferai au lieu que tu es homme.
Paris.	Paris.
Le ſçauoir eſt pour ceux qui veulent ſans ramer Ny le mondecourir luſtrer toute la mer Par leurs doctes eſcrits & ſans bouger de terre, Cheminer parmy l'air en deſpit du tonnerre, Ou qui craiguent la ſaim, & la force eſt pour ceux Qi ſuiuent d’un Mauorsle dr appeau trop douteux, Moy qui ſuis vn Berger n’ay pas beaucoup de cure.	Le sçauoir est pour ceux qui veulent sans ramer Ni le mondecourir lustrer toute la mer Par leurs doctes écrits et sans bouger de terre, Cheminer parmi l'air en dépit du tonnerre, Ou qui craiguent la saim, et la force est pour ceux Qi suivent d'un Mavorle dr appeau trop douteux, Moi qui suis un Berger n'ai pas beaucoup de cure.
D’apprendre les meſtiers ou preſide Mercure, N’y d’eſtre ſi puiſſant, ſi ie ſuis aſſez ſort Pour combatre l’amour & ſurmonter la mors,	D'apprendre les métiers ou preside Mercure, N'y d'être si puissant, si belle suis assez sort Pour combattre l'amour et surmonter la mors,
Venus.	Venus.
Mon mignon, mon Parue, mon tout & ma parcelle Voy image d’amour, combien ma face eſt belle, Et coutemple des yeux de tes affections, Qe tes affections ſont mes perſections:	Mon mignon, mon Parue, mon tout et ma parcelle Vois image d'amour, combien ma face est belle, Et coule des yeux de tes affections, Qe tes affections sont mes perséctions:
Tor ſuc mou frout brunet tout le ciel qui s’aſſem ble	Tor su mou frout brunet tout le ciel qui s'assem blé
Voy dant mon œil veſper, & les aſtres euſemble Ciel dont l'eſclair eſt brun remply d’humitité Roncomme ment lunon, plein d’impudicité.	Vois dant mon œil vesper, et les astres eusemble Ciel dont l'éclair est brun rempli d'humitité Roncomme ment lunon, plein d'impudicité.
Ce grand ſlembeau du ciel qui des choſes diſpoſe A mon œit eſt ſemblable en vne ſeule choſe, L’vn deßide les yeux des hommes par les iours, Et l’autre ouure les cœurs des mortels par amours, Contemple mon poil d’or ou les amours ſe nouent, Mon beau ſein ou les ieux ſolaſtrement ſe iouent:	Ce grand slembeau du ciel qui des choses dispose A mon œit est semblable en une seule chose, L' desside les yeux des hommes par les jours, Et l'autre ouvre les cœurs des mortels par amours, Contemple mon poil d'or ou les amours se nouent, Mon beau sein ou les jeux solâtrement se jouent:
Deux fortes deitez qui dontent tout ſous eux, Pleſſant celuy qui n’ayme & tuant l’amoureux, Voy nerger les beautez s’eſçayer ſur ma ſace Voy Paris s'embellir les graces ſur ma grace, Ma face peut donter le plus audacieux, Et ma grace peut rendre vn hautain gracieux Hars en ſoit le teſmoin qui deueſtant ſes armes Veſtit ſon cœur d’amours, ſon viſage de l’armes.	Deux fortes déité qui dontent tout sous eux, Plessant celui qui n'aime et tuant l'amoureux, Vois nerger les beautés s'esçayer sur ma sace Rois Paris s'embellir les grâces sur ma grâce, Ma face peut donter le plus audacieux, Et ma grâce peut rendre un hautain gracieux Hars en soit le témoin qui devant ses armes Vestit son cœur d'amours, son visage de l'armes.
Que ie ſecuent tes biens que te promet Iunon, Ce ſont maux en eſſect que ces grands biens de nom, Que te ſert le ſçauoir toy qui ſçais toute choſe, Que te ſert la ſageſſe, & puis qu’amour diſpoſe De tes ſages conſeils, & ſi d’en peu de te nps Tu verras en Hyuer ſe changer ton Printemps, Et ſe reduire en rien ta ſageſſe & ta vie, Et ces ſils de la terre auortons de l’enuie, R itte moy tout cela, & conſume tes iours A fuir tant de malheurs, & ſuyure tant d’amours, Ei apres auoir bien regarde mon viſage veu dedaus ton amour, tes ſens, & ton image, Admiré les vertus qui te ſont admicer, Adore les beautez qui te font adorer Les beautez de ta Vymphe, & veu dedans ma veüe, La ſorce ſeulement aux amoureux cognuë, Ta veux bien enſeigné pay ton ſage Demon Preſerer ma beaute à celle de tunon, Acelle de Pallas ſuperbe en ſon Egide, Et m’adiuger auſſi le preſent beſperide, Je ne te feray pas ny riche, ny ſçauant, Ie ne te repaiſtray de baye ny de vent, De grandeurs, de threſors, d'honneur, ny de ſumee, Mais bien d’vne beaute des Anges eſtimee, Scrute l’heur de la terre, & l’ornement des cieux, Que le moriel reuere, & deſicent les dieux, Beauté race du ciel que l’on appelle Heleine, Tu auras de l’amour, & non pas de la peine, Car malgré les eſſorts nous iouyrons un iour, Moy de ce petit monde, & toy de ton amour.	Que était secuentche biens que te promet Junon, Ce sont maux en esssect que ces grands biens de nom, Que te sert le savoir toi qui sais toute chose, Que te sert la sagesse, et puis qu'amour dispose De tes sages conseils, et si d'en peu de te nus Tu verras en Hiver se changer ton Printemps, Et se réduire en rien ta sagesse et ta vie, Et ces sils de la terre avons de l'envie, R itte moi tout cela, et consume tes jours A fuir tant de malheurs, et savoir tant d'une, Et apres avoir bien regarde mon visage dedaus ton amour, tes sens, et ton re, mles vertus qui te sont admicer, Adore les beauté qui te font re Les beautéde ta Vymphe, et dedans m veüe, La ô seulement aux amoureux cognuë, Ta veux bien enseigné a ton sage De Preserer ma beauté celle de tunon, Acelle de Pallas superbe en son Egide, Et adiuger aussi le présent besperide, Je ne te ferai pas ni riche, ni sçauant, Ie ne te repaîtrai de baye ni de vent, De grandeurs, de thresors, 'honneur, ni de sumee, Mais bien beauté des Anges estimée, Scrute lheur de la terre, et lornement des cieux, Que le moriel reuere, et et les dieux, Beauté race du ciel que on appelle Heleine, Tu auras de amour, et non sa de la peine, Car malgré les ô nous iouyrons un iour, de ce petit m, et toi de ton amour.
Prend Paris mon Ceſton dont la puiſſance eſt forte Tu pourras des Enſers briſer froiſſer la porte, Ouurir le ciel bacle, & par luy alumer, Ou le cœur d’vne roche, ou le ſein de la mæ.	Prend Paris mon Ceston dont la puissance est forte Tu pourras des Ensers briser froisser la porte, Ouvrir le ciel bacle, et par lui alumer, Ou le cœur d'une roche, ou le sein de la mæ.
Iuuon s’en eſt ſerui pour deceuoir ſon frere, Arreſtaut ſes deſirs & ſon ame legere.	Juon s'en est servi pour décevoir son frère, Arrêt ses désirs et son âme légère.
Paris.	Paris.
dieux Bons dieux que i’ay d’amours, amours que i’ay de Daus le cœur, dans les os, dans le ſin, dãt les yeux, Dieux i’appelle vne ſorte à mes ſens incognue, Qui ſans m’oſter les yeux me deſrobe la veue Qui ſaus chaſſer mon ame hors ſu freſle priſon Chaſſe de moy mon cœur, mon ame & ma raiſon, Et qui a ſans violence à i’a deſia rauie, Par vn eſſort ſans forte & mes ſens & ma vie.	dieux Bons dieux que j'ai d'amours, amours que j'ai de Daus le cœur, dans les os, dans le sin, dans les yeux, Dieux j'appelle avait sorte à mes sens inconnue, Qui sans m'ôter les yeux me dérobe la vue Qui sa chasser mon âme hors su frêle prison Chasse de moi mon cœur, mon âme et ma raison, Et qui a sans violence à j'a desya ravie, Par un essort sans forte et mes sens et ma vie.
Bõs dieux que i’ay d’amour, au moins ſi ceſt aymer Que de gouſter du miel entre-meſle d'amer, Junon du grand lupin & la ſœur & la ſimme Tu es ſi belle au ciel que ta beaute enſlamme Le cœur de ton mary, & par ſes viſs eſclairs Allume mille ſeux aux regions des airs.	Bons dieux que j'ai d'amour, au moins si cest aimer Que de goûter du miel entre-mêle d'amer, Junon du grand lupin et la sœur et la sime Tu es si belle au ciel que ta beauté enslamme Le cœur de ton mari, et par ses viss éclairs Allume mille seux aux régions des airs.
Tu ls fort belle auſi Ariemis, & te iure Que i’ayme mieux mourir que de te ſaire iniure Toy qu’aux bois ie reuere, & honore, & pour moj Je ſuiurois bien ton traia ſi i’aymois bien ta loy, Mais une ſolle erreur qui va iuſqu’à l’extreme, Qui ſans ſortir de moy me rend bors de moy-meſme, Eſgare ma raiſou, & ie ne ſçay plus rien, Tant ie ſuis eſperdu, ſoit de mal ou de bien, Tu produis ces effects amoureuſe Deeſſe Ou ſoit qu’il ſoit aiuſi, ou ſoit vne traiſtreſſe Imagination, ſeduiſe mon penſer, Tu produis ces effects afiu de m’oſſencer, Prend donc mere d'amour ceſte ſatale Pomme Un amant te la donne, & non pas vn vray bomme.	Tu l fort belle ausi Ariemis, et te jure Que j'aime mieux mourir que de te zaïre injure Toi qu'aux bois sens révère, et honore, et pour mo Je suivrais bien ton traia si j'aimais bien ta loi, Mais une solle erreur qui va jusqu'à l'extrême, Qui sans sortir de moi me rend bors de moi-même, Esgare ma raisoume, et ie ne serai plus rien, Tant ie suis rdv, soit de mal ou de bien, Tu Taillis ces effets amoureuse Deesse Ou soit qu'il soit aiusi' il soit été traîtresse Imagination, séduise monpenser,Ion , se re afiu de mon, Pen donc mere d'aiceste anse m Un amant te adonne, et non pas vrai bomme.
LE CHOEVR.	LE CHOEUR.
Ve iaoperçoy de maux, de morts, & de turie Qu’amour braſſe aux Troyẽs, va Troyen aux Simo cœur ſe ſubmerge au ſãg de leur furie (amours Mes yeux dedans leurs pleurs offuſque leurs beaux Dix ans de cruautez ſeront les recompenſes (iours Que le d ſtin promet à ces rauiſſimens, Le ciel plore pour nous cognoiſſant nos ſouffrances, Paris ce rit de nous iguoraut nos tourmens N'eſtais-tu pas contant d’vne ſeule maiſtreſſe Sans te maaſtrer perfide & voleur en vn iour:	Ve iaoperçoy de maux, de morts, et de turie Qu'amour brasse aux Troyens, va Troyen aux Simo cœur se submerge au sãg de leur furie (amours Mes yeux dedans leurs pleurs offusque leurs beaux Dix ans de cruautés seront les récompenses (jours Le dès le stin et à ces ravissiments, Le ciel plore pour nous connaissant nos souffrances, Paris ce rit de nous iguoraut Le tourments N'étais-tu pas contant d'une seule maîtresse Ma te maîtreperfide et voleur en iour:
As-tu le ſrint ſi ſeint, & l'ame ſi traiſtreſſe, De nous laiſſer la baine, & receuois l’amour?	As-tu le srint si seint, et l'âme si traîtresse, De nous laisser la baine, et recevais l'amour?
Aymes-tu tant Paris ceſte amoureuſe haine Subiect de nos trauaux, obiect de tou ſoucy?	Aymes-tu tant Paris cette amoureuse haine Subiect de nos travaux, objet de tou cy?
Qe iu nous vuellles ſaite va Ocean de peine Pour y plonger ta ſlamme & te, deſies auſſix Malheur ſur noſtre cheſ troupe trop miſerable Malheur puis qu’vn enfant nous ourdit ce malheur I faut pour le plorer vne voix deplorable, I pour le ſupporter on tæyr remply de cœur.	Qe ju nous vuellles saite va Océan de peine Pour y plonger ta splamme et te, desies aussix Malheur sur notre chez troupe trop misérable Malheur puis qu'un enfant nous ourdit ce malheur I faut pour le plorer une fort déplorable, I pour le supporter on tyr rempli de cœur.
Helas!	Hélas!
pauure llion, & pauute Roy infame tauure peuple ſçauant aux beaux meſtiers de Mars oy ton fils qui te bruſte au milieu de ſa ſlamme t amour qui ſe tue au milieu de ſes dards.	pauvre lion, et pauvre Roi infâme tauvre peuple savant aux beaux métiers de Mars oi ton fils qui te bruste au milieu de sa slamme t amour qui se tue au milieu de ses dards.
Paris.	Paris.
Mours venez à moy, & quittez voſtre mere, IA Quittez les ieux miguards inuentez daus yAbandonnez ce lieu, & vous venez loger (there, Peliiseapans mp (iuimonde eſtranger, En mon cœur, en mes os, en ma playe proſonde, Car ainſi que l’on dit l’homme eſt vn petit monde.	Mours venez à moi, et quittez votre mère, IA Quittez les jeux miguards inventés daus yAbandonnés ce lieu, et vous venez loger (thère, Peliiseapans m' (juimonde étranger, En mon cœur, en mes os, en ma plaie prosonde, Car ainsi que l'on dit l'homme est un petit monde.
Venez, volez, hachez auec vos auirous Les regions de l’air, & puis nous volerons, Uous de nature iſnels, moy leger par ma ſlamme Ou mon eſpoir s’auiue, ou treſpaſſe mon ame, Du mon penſer m’emporte & le cœur & les yeux, comme l’Aigle emporta le Troyen dans les Cieux ſar l’Aigle & le penſer ont cela de nature Deſtie prompts & legers ſur toute creature.	Venez, volez, hachez avec vos avirous Les régions de l'air, et puis nous volerons, Uous de nature isnels, moi léger par ma samme Ou mon espoir s'auive, ou trépasse mon âme, Du mon penser m'emporte et le cœur et les yeux, comme l'Aigle emporta le Troyen dans les Cieux sar l'Aigle et le penser ont cela de nature Destie prompts et légers sur toute créature.
Ve ſuis-ie pas heureux d’auoir en meſme iour Deſpoüille la fortune en me veſtant d’amour, Dieu qui me ſauoriſe, & me donne aſſeur auce D’un bien, dont ie mourois pour la ſeule eſperance, Ie ſuis-ie pas heureux d’auair en un matiu Perdu ſi peu de choſe, & ſait vu tel butiu?	Ve suis-je pas heureux d'avoir en même jour Despouille la fortune en me vêtant d'amour, Dieu qui me savorise, et me donne assur auce D'un bien, dont ie mourais pour la seule espérance, Je suis-je pas heureux d'avair en un matiu Perdu si peu de chose, et sait vu tel butiv?
Le bon-heur de laſou, le bon-beur de Theſee Dout la fille de Cete à tort ſeut abuſee, Ie ſont que vrais malbeurs, au prix de mõ bon-beur	Le bonheur de lasou, le bon-beur de Thesee Dout la fille de Cette à tort seut abuse, Je sont que vrais malbeurs, au prix de mon bon-beur
Leur bẽ beur malbeureux oien beureux mõ malhes Jaſon dedans Argos accompagué de Princes.	Leur bonne beur malbeureux oien beureux mon malhes Jason dedans Argos accompagué de Princes.
Trauerſa mille mers, paſſa mille Prouinces, Aſſubiectit ſa vie aux rauines des eaux, Endura des douleurs, des langueues des trauaux, Supporta du grand ciel l’iuiure & l’inconſtance, Souſfrir de ſer ſlambeaux la fatale i flience, Courut mille treſpas, courut mille dangers Où tombent ceux qui vont aux pays eſt angers, Et arriue au Phare ou bruſloit ſon cauie, Par l’amour par la mort cuida perdre la vie:	Traversa mille mers, passa mille Provinces, Assubiectit sa vie aux ravines des eaux, Endura des douleurs, des langues des travaux, Supporta du grand ciel l'ivre et l'inconstance, Sousfir de ser slambeaux la fatale y jience, Courut mille trépas, courut mille dangers Où tombent ceux qui vont aux pays est angers, Et arrive au Phare ou brûlait son cavie, Par l'amour par la mort cuida perdre la vie:
Mais ſa dame amoureuſe en traiuant ſon mal-beur Et ſe tuaut d’amour ſiſt naiſtre le bon-haur De cet amant perfile, a qui elle ſe ſie, Pour qui elle ſe trompe & ſi ne s’en deſie, Qui pour eſtic offenece en ſa vir ginité, S’arma d’vn ſier derdain, luy d’vne laſcheté.	Mais sa dame amoureuse en traivant son malheur Et se tuaut d'amour zist naître le bonhaur De cet amant perfile, à qui elle se siète, Pour qui elle se trompe et si ne s'en désie, Qui pour étic offenece en sa vir ginité, S'arma d'une sier derdain, Seigneur d'une lâcheté.
Ce graud guerrier Tueſe qui ſit trembler la terre Vn Mauors au combats, vn ſoudre de la gueire:	Ce graud guerrier Tuèse qui sit trembler la terre Un Mavors au combats, un soudre de la guère:
N’auoit de ſa maraſtre eſchappé les appus, Que le ſort qui ſembloit courir à ſon treſpas, L’emporta pour le perdre au mouſtre de Dedale, Luy qui ſuit de ſes iours la carr iere ſatale court à ſa propre perte aueuglé de valeurs, Et mal-beureux qu’il eſt ne voit pas ſes mal-heurs, Ny l’extreme danger, ou le ſort le conuie, Que ſi l’amour vainqueur n’euſt arrathé ſa vie Des miius de la mort meſme, il euſt en meſme iour Honteux perdu ſa vie en perdaut ſon amour:	N'avait de sa marâtre échappé les appus, Que le sort qui semblait courir à son trépas, L'emporta pour le perdre au moutre de Dédale, Lui qui suit de ses jours la carr ère satale court à sa propre perte aveuglé de valeurs, Et malheure qu'il est ne voit pas ses malheurs, Ni l'extrême danger, ou le sort le convie, Que si l'amour vainqueur n'eût arrathé sa vie Dés mius de la mort même, il eût en même jour Honteux perdu sa vie en perdaut son amour:
M ais moy ſans entoirir tant de mortelles peines, Qui courent par les os qui gliſſent par les veines De ceux qui eſgarez dans vne ſolle erreur, võt cerchans leur amour & trouuent leur mal-heur, I’auray de mes deſirs parfaite iouyſſance,	M Mais -moi sans entoirir tant de mortelles peines, Qui courent par les os qui glissent par les veines De ceux qui égarés dans une solle erreur, võt cerchans leur amour et trouuent leur mal-heur, auray de mes désirs parfaite iouyssance,
Ies Dieux ne mentent pas, i’en ay bonne aſſeurance De leur diuinité.	Jes Dieux ne ment pas, j'en ai bonne assurance De leur divinité.
Venus me la iuré Par le cheſ de ſon ſis & par ſon arc doré Et pour mettre a ſon point cette belle entrepriſe, Cypris de ſes attraits mes appas ſauoriſe, Amour loge en mes yeux les traits de ſes amours, Pyibon ſorme en ma bouche vn fleuue de diſcours.	Venus me la juré Par le chez de son sis et par son arc oré Et pour mettre a son point cette belle entreprise, Cypris de ses attraits mes appas savorise, Amour loge en mes yeux les traits de ses amours, Pyibon sorme en ma bouche un fleuve de discours.
Que ſi pour conquerir vne ſi riche proye, Qui vaut cent ſois ma vic & cent treſpas de Troye;	Que si pour conquérir ainsi si riche proie, Qui vaut cent sois ma vic et cent trépas de Troie;
Jl ſaut abandouner mon pays, & ramer Et cingler brauement ſur le dos de la mer, D’ilion en la Grece ou l’on adore Helcine, », Faut pour beaucoup de choſe auoir vn peu de peine n Et ne craindre du mal pour receuoir du bien, " Car l’amoureux craintif ne reçoit iamais rien.	Il saut abandouner mon pays, et ramer Et cingler bravement sur le dos de la mer, D'ilion en la Grèce ou l'on adore Helcine, ", Faut pour beaucoup de chose avoir un peu de peine n Et ne craindre du mal pour recevoir du bien, " Car l'amoureux craintif ne reçoit jamais rien.
Si pour ce cher butin qui vaut bien tout le monde, Ie mets m’amour ma vie & ma neſ deſſus l’onde, 11 Le haz ard n’eſt qu’hõneſte & le mourir que beaïs, » Lo ſque l'hõme & l’amour ont vn meſme tõbeau:	Si pour ce cher butin qui vaut bien tout le monde, Je mets m'amour ma vie et ma nés dessus l'onde, 11 Le has ard n'est qu'honneur et le mourir que beaïs, " Lo soient l'homme et l'amour ont un homme tombeau:
Mais mes diſcours ſot vais, l’amour qui me trã ſporMe porte a ces diſcours que le vẽt nous ewporte, (le Ie ne crain point les veus, ny la mort ny la mer, Si ie les puis moy-meſme en mes ſeux alumer.	Mais mes discours sot vais, l'amour qui me trans sporMe porte à ces discours que le vendre nous éporte, (le Je ne crain point les veux, ni la mort ni la mer: Si tu les puis moi-même en mes seux alumer.
Mais quoy que tardes tu amoureuſe penſee, D’amour & d’vn bel œil ſi doucement bleſſee, Que tardes iu Paris ſi longuement icy De deſit & d’abſence outrage ſans mercy:	Mais quoi que tardes tu amoureuse pensée, D'amour et d'un bel œil si doucement blessée, Que tardes ju Paris si longuement ici De désit et d'absence outrage sans merci:
Que ſais-tu, Pareſſeux, eſloigué de taDDame, Ainçois que ſais-tu mort eſloigné de ton ame, Que tu ne monte en mer aſia de la r’auois?	Que sais-tu, Paresseux, esloigué de taDame, Ainçois que sais-tu mort éloigné de ton âme, Que tu ne monte en mer asia de la reauois?
Voir ce que l’ame voit, & le corps ne peut voir, Voir ce ſubiect diuin miracle de nature, Voir la beauté changee en cette creature, Voir la tecre en ſon corps, voir lescieux en ſes ytux, Et le ſacheux obiect de mon mal gracieux, Que it porte dans l’œil que ie porte en la teſte, Quoy craindrai-ie les bancs, les vents, & la tẽpe Et de peur de mourir dans les ſlots de la mer Mouray-ie malbeureux dans les flames d’aymer.	Voir ce que l'âme voit, et le corps ne peut voir, Voir ce sujet divin miracle de nature, Voir la beauté change en cette créature, Voir la tecre en son corps, voir lescieux en ses ytux, Et le sacheux objet de mon mal gracieux, Que it porte dans l'œil que ie porte en la tête, Quoi craindrai-je les bancs, les vents, et la tẽpe Et de peur de mourir dans les slots de la mer Mourai-je malbeureux dans les flammes d'aimer.
A chattes.	À chattes.
Paris.	Paris.
Achattes.	Achattes.
velle rage vous poind quelle ſureur vo'bleſſe Q Quelleeſtrage mauie eſtrãgemẽt vous preſſe vous pourſuit, vous tallõne, & vous ſait ſans raiſe Errer dans tant d’erreurs priué de la raiſon, Eſtes-vous incenſe, eſt-ce point quelque image Qui vous imprime tant de ſureur & de rage:	velle rage vous poind quelle sûreur voblesse Q Quelleestrage mavie estrãgemẽt vous presse vous poursuit, vous tallõne, et vous sait sans raise Errer dans tant d'erreurs privé de la raison, Êtes-vous incense, est-ce point quelque image Qui vous prime tant de sûreur et de rage:
Eſtes-vous eſperdu?	Êtes-vous éperdu?
ou ne l'eſtes-vous point, Qi eſt ce qui vous pique eſt-ce vn mal qui vo' poind Eſt-te vue deite qui vous rend ſi mauſſade, Agité de ſurie ainſi qu’une menade, Qui ſent les eſguillons de ſon Dieu qu’elle ſuit:	ou ne l'êtes-vous point, Qi est ce qui vous pique est-ce un mal qui vo' poind Est-te vue de qui vous rend si maussade, Agité de surie ainsi qu'une ménade, Qui sent les éguillons de son Dieu qu'elle suit:
Pourſuiuez vous vn rie eſt-ce vn rien qui vous ſuit;	Poursuivez vous un rie est-ce un rien qui vous suit;
Quoy ne parlez-vous plus:	Quoi ne parlez-vous plus:
le mal qui vous affole Vous remplit-il la bouche au lieu de la parole, Pour ſçauoir voſtre mal Paris parlez à moy:	le mal qui vous affole Vous remplit-il la bouche au lieu de la parole, Pour savoir votre mal Paris parlez à moi:
Au lieu de ſentiment eſtes-vous plein d’e moy, Plein d’éauy, plein d’amour ſas voix, ni ſas haleine, Reprenez viſtre haleine, & quittez voſtie Heleine, Fuyez d’vn tel ſabiect l’eſclandicux ſouuenir, „5 Prenez le temps preſent, preuoyez l’aduenir.	Au lieu de sentiment êtes-vous plein d'e moi, Plein d'avi, plein d'amour sas voix, ni sale haleine, Reprenez vite haleine, et quittez vostie Hèleine, Fuyez d' tel sabiect l'éclandicux souvenir, „5 Prenez le temps présent, prévoyez l'avenir.
Paris.	Paris.
Quoy que ie quitte aiuſi la beaute la plus belle, Que iamais la nature ourdit ſur le modelle De ſa perſection, modelle qu’en d-ſpit De la terre & du tiel la nature rompis	Quoi que ici quitte aiusi la beauté la plus belle, Que jamais la nature ourdit sur le modèle De sa perséction, modèle qu'en dèspit De la terre et du tiel la nature rompis
Pour ſaire ſon ouurage vniq' en ſes merueilles, Eſmerueiller nos yeux, eſtouner nos aureilles, C’eſt ceſte beaute la qui me ruine d’eſmoy, Qui ſans rauiſſement me deſrobe de moy, Qui ſe rue en mon cœur plus viſte que la foudre, Plus viſte qu’vn eſclair qui ſe reduit en poudre, Que te diray ie plus ceſt la perfection, c’eſt la diuinite de mon aſſection, C’eſt moy, ce n’eſt pas moy, c’eſt vne belle imagé Qui eſſencie en ſoy mon ame & mon courage, Tout ainſi que le feu en bruſlant peu à peu Transſorine ce qu’il bruſle en ſon eſtre de ſeu.	Pour zaïre son ouvrage uniq en ses merveilles, Esmerueiller nos yeux, étouner nos oreilles, C'est cette beauté la qui me ruine d'émoi, Qui sans ravissement me dérobe de moi, Qui se rue en mon cœur plus vite que la foudre, Plus te qu'un éclair qui se réduit en poudre, Que te dira ie plus taît la perfection, c'est la divinité de mon assection, C'est moi, ce n'est pas moi, c'est une belle imagé Qui esscie en soi mon âme et mon courage, Tout ainsi que le feu en brûlant peu à peu Transsorine à peu à peu en ce être de so.
C’eſt image eſt le vent qui reſpire à ma vie, Elle n’a point d’enuie, & ſi c’eſt mon enuie, C’eſt mon contentement & ſi ce ne l’eſt pas, Elle eſt pleine de vie & pleine de treſpas, Elle eſt mon bien, mon mal, & ſi ie ne deſire, Pour eſtre biẽ-heureux qu’vn malheureux marty'e, C’eſt ce martyre-la qui me rend eſperdu Et peuſant le trouuer las!	C'est image est le vent qui respire à ma vie, Elle n'a point d'envie, et si c'est mon envie, C'est mon contentement et si ce ne l'est pas, Elle est pleine de vie et pleine de trépas, Elle est mon bien, m al, et si tu ne désire, Pour être qu'heureux qu'un malheureux marty, MARTY a ce martyre-la qui me rend éperdu Et pusant le trouver las!
ie me ſuis perda Eſgaé de ſureur, eſgaré de penſes.	Ne me suis perda Esgaé de fureur, égaré de penses.
Penſee de deſirs & d’abſence offencee, Quoy que ie quitte, Acbatte, vn ſedoux ſouuenir, Le preſeut eſt certain, baſardous l’aduenir.	Pensée de désirs et d'absence offensée, Quoi que je quitte, Acatte, un sedoux souvenir, Le presut est certain, basardous l'avenir.
Achattes.	Achattes.
Oextréme fureur qui lei cœurs enſorcelle, O mortelle douleur, ô douleur immortelle O un peu de douceur auec beaucoup d’amer O ſoucy des ſoucis que l’on aopelle aymer, O ſier contentement entre meſle d’enuic O mort que l’on ſurnomme vne ſeconde vie?	Oextréme fureur qui lei cœurs ensorcelle, Ô mortelle douleur, douleur immortelle Ô un peu de douceur auec beaucoup amer Ô soucy des soucis que on aopelle aimer, Ô Ô contentement entre mêle enuic Ô mort qui lon surnomme en seconde vie,
Mais las par quels moyẽs vous pourroit-on guerir.	Mais las par quels moie vous pourroit-on guérir.
Paris.	Paris.
Amour me peut guerir ou me faire mour ir.	Amour me peut guérir ou me faire mour ir.
Achattes.	Achattes.
fortur Voſtre amour ceſt Heleine Paris.	fortur Votre amour cet Hèleine Paris.
Il ſaut courit Sur la mer de l’amour ſur la mer de Neptune Pour voir ceſte Deeſſe ou giſt tout mon confort, Et preſerant hardy mon amour à ma mort, Doucement la rauir par vne douce priſe, Veuus mere d’amour conduit noſtre entrepriſe.	Il saut courit Sur la mer de l'amour sur la mer de Neptune Pour voir cette Déesse ou gît tout mon confort, Et preserant hardi mon amour à ma mort, Doucement la ravir par une douce prise, Veu mere d'amour conduit après entreprise.
Achattes.	Achattes.
Il faut donc amoureux & valeureux Paris Surmonté d’vn bel æil ſurmonter les peris.	Il faut donc amoureux et valeureux Paris Surmonté d'amour bel æil surmonter les péris.
Paris.	Paris.
I'ay le cœur aſſez braue, Aehatte ie t’en iure, Pour ſorcer les dangers, le ciel, & la nature, Et me promcis cela qu’vn amant ſe promet Quand amour iuſqu’à l’os ſa ſagette luy met, Il ſaut baſtir des Naus pour l’œaure que i’attéte Et tourmenter les ſlots comme amour me tourmẽte, va, vole, cours, Aehatte, arrache des ſapins Et d’vne grand cognce, aterremoy des pins.	J'ai le cœur assez brave, Aéhatte apprête t'en jure, Pour sorcer les dangers, le ciel, et la nature, Et me promis cela qu'un amant se promet Quand amour jusqu'à l'os sa sagette lui met, Il saut bâtir des Naus pour l'œaure que j'attête Et tourmenter les sots comme amour me tourmẽte, va, vole, cours, Aehatte, arrache des sapins Et d'une grand connée, aterremoi des pins.
Que le coup ſace bruit, comme on voit en autonpę L’eſclair goouder en l’air tout le ciel en reſonnt, Tourne les Pins en Naus, & qu’on voye ramer Sauter, bondir, vauguer lus Pius deſſus la mer, Pour rauir, & ne rendre ainſi que fit Theſce, Cetie beauté celeſte en mon ame embraſee, Calfeutre les vaiſſeaux, & n’y eſpargne rien.	Que le coup sa bruit, comme on voit en autonpirer L'éclair gouder en l'air tout le ciel en résonnut, Tourne les Pins en Naus, et qu'on voie ramer Sauter, bondir, vauguer lus Pius dessus la mer, Pour ravir, et ne rendre ainsi que fit Thésce, Cetie beauté celles en mon âme embrase, Calfeutre les vaisseaux, et n'y épargne rien.
» Ne faut rien eſparguer pour receuoir du bien	» Ne faut rien éparguer pour recevoir du bien
Achattes.	Achattes.
Gentil ſoldat d’amour la Nauire eſt gliſſee, Pour demarer du port, dedans l’onde perſee, Voyez l’air noir de poudre, & regardez la mer Sous la neſ boüillonner, & la riue fumir.	Gentil soldat d'amour la Navire est glissée, Pour demarer du port, dedans l'onde persé, Voyez l'air noir de poudre, et regardez la mer Sous la nés boüillonner, et la rive fumir.
Deſguainez voſtre eſpee, & d’vne ſorce graude Coupez ſans plus tarder d’vn reuers la commande, 25 Le temps ſe peut ebager, & la ſemme eſt touſiours », Legere en toute choſe, & ſur tout en amours.	Déguainez votre espée, et d'une sorce gravde Coupez sans plus tarder d'un revers la commande, 25 Le temps se peut ébager, et la semme est toujours ", Légère en toute chose, et sur tout en amours.
Paris.	Paris.
Deïtez de la mer ſoyez-moy ſauorables, Si Dieu eſt fauorable aux bommes miſerables, Ne tourmentez ma nef de ſlots impetueux, Et vous Sye thes auſſi aux recours fluctueux Sous vn eſcueil marin ou l’onde ſe reuire Ne froiſſez en cent parts les flancs de mon nauire I’immole en voſtre bonneur à la riue de l’eau, Pour ſecõder mes vœus, le grãd corps d’vn Taureau, Et toy grande Venus Deeſſe gracieuſe.	Deïtez de la mer soyez-moi savorables, Si Dieu est favorable aux bommes misérables, Ne tourmentez ma nef de slots impétueux, Et vous Sye très aussi aux recours fluctueux Sous un écueil marin ou l'onde se révire Ré froissez en cent parts les flancs de mon navire J'immole en votre bonneur à la rive de l'eau, Pour secéder mes vœus, le grand corps d'un Taureau, Et toi grande Venus Déesse grâces.
Guide ma Veſ qui ſlotte, & mon ame amoureuſe, Tu vois bien mon deſſein brauement aduancé entuon de daminm tognarſant le paſſe.	Guide ma Ves qui slotte, et mon âme amoureuse, Tu vois bien mon dessein bravement avancé entuon de daminm onnarsant le passe.
LE CHOEVR.	LE CHOEUR.
V'amour eſt vne douleur viue, Qraiſant mourir la choſe viue Pour puis apres la r’animer:	V'amour est une douleur vive, Qraisant mourir la chose vive Pour puis après la ranimer:
Qu’amour eſt vne choſe eſtrange Faiſant d’vn Chaos de Meſlange Vne beaute qu’on nomme aymer Qu’amour a ſur nous de puiſſance Nous aſſeurant d’vne inconſtance, Et nous guidont dans des erreurs Il trompe comme de couſtums Preſentant beaucoup d’amertume, Et donnant bien peu de douceurs.	Qu'amour est assez chose étrange Faisant d'un Chaos de Mêlange Vaine beauté qu'on nomme aimer Qu'amour a sur nous de puissance Nous assurant d'une inconstance, Et nous guidont dans des erreurs Il trompe comme de coutums Prentant beaucoup d'amertume, Et donnant bien peu de douceurs.
Depuis que ceſte folle rage Se rend maiſtreſſe du courage Elle l’eſclaue en ſa priſon, Et pour mieux ſeduire noſtre ame, Elle remplit noſtre œil de ſtlamme, Et obſeurcit noſtre raiſon.	Depuis que cette folle rage Se rend maîtresse du courage Elle l'esclave en sa prison, Et pour mieux séduire notre âme, Elle remplit notre œil de stlamme, Et obseurcit notre raison.
La pauure femme de Sichee En amour toute deſſechee Eſtoui-ce qu’elle n’eſtoit pas, Car apres qu’icelle euſt perduë Par l’amour l’eſprit & la veuë Perdit l’ame par le treſpas.	La pauvre femme de Siche En amour toute desséchée Étoui-ce qu'elle n'était pas, Car après qu'icelle eût perdue Par l'amour l'esprit et la vue Perdit l'âme par le trépas.
N’allons cercher noſtre miſere Dedans vne cendre eſtrangere, Parĩ nous ſournit d’argument, Il va tramant noſtre deſtreſſe, Et pour vn comble de triſteſſe Nous fait voir ſon aueuglement.	N'allons cercher votre misère Dedans une cendre étrangère, Par1 nous sournit d'argument, Il va tramant notre détresse, Et pour un comble de tristesse Nous fait voir son aveuglement.
Helas!	Hélas!
me ſemble que i’augure Sa ſaute & noſtre mort ſuture Dure & triſte prediction, D’horreur i’ay l’ame toute pleine, Nous voyant auoir tant de prine, D'auoir ſi peu d’aſſection.	me semble que j'augure Sa saute et notre mort suture Dure et triste prédiction, D'horreur j'ai l'âme toute pleine, Nous voyant avoir tant de prine, D'avoir si peu d'assection.
Quelle bameur cruelle & ſentre Te tait ourdir contre ton pere Tant de maux enſant ſans pitié, Que ſi tu as dedans ton ame Pour toy vne amoureuſe ſlamme, Ayés pour luy de l’amitié.	Quelle bameur cruelle et sentre Te ait ourdir contre ton père Tant de maux ensant sans pitié, Que si tu as dedans ton âme Pour toi était amoureuse slamme, Ayez pour lui de l'amitié.
O deſtin doux & pitoyable, Secourez ce Roy miſcrable, Qu’amour veut reudre malheureux.	Ô destin doux et pitoyable, Secourez ce Roi miscrable, Qu'amour veut revdre malheureux.
Et deſtournez voſtre colere, Et comblez le ſits de miſere, Rendant le perebien-beureux.	Et détournez votre colère, Et comblés le sits de misère, Rendant le pèrebience.
ACTE III.	ACTE III.
Paris.	Paris.
Heleine.	Hèleine.
Paris.	Paris.
’Ay vogué ſur les eaux d’amour & de Neptune, TTourmenté de Junon, battu de la ſortune, I'ay couru les dangers des Cieux & de la mer, Et i’ay cerchant l’aymer, trouué beaucoup d’amer, Forcé de ta beaute i’ay ſorce la Nature, Mon Dieu que peut ſur nous la belle creature, Car l’ire de la mer, & la fureur des Cieux N’ont peu ſlechir mon cœur amoureux de ies yeux, Neptun bouſſant en l’ame orageoit mon Nauire, L’onde, ſtot deſſus flot ſe roule & ſe reuire, Rompt les ais de ma nef, comme vn canon plantô Breſche de grand' ſureur les murs d’vne Cité.	Ay vogué sur les eaux d'amour et de Neptune, TTourmenté ne Junon, battu de la sortune, J'ai couru les dangers des Cieux et de la mer, Et j'ai cerchant l'aimer, trouvé beaucoup d'amer, Forcé de ta beauté j'ai sorce la Nature, Mon Dieu que peut sur nous la belle créature, Car l'ire de la mer, et la fureur des Cieux N'ont peu sléchir mon cœur amoureux de jes yeux, Neptun boussant en l'âme orageait mon Nauire, LAvire, L' dessus flot s' elle et se roule, Et se ais ré ma nef, comme un can plantô Bresche de grand' sureur les murs Cité.
Iunon par vn deſpit de la pomme perduë Pour ne perdre en la mer pendoit deſſus la nuë Forgeoit des traicts de feu, les lancoit de ſes mains, Mes nauſs bruſloyent de ſeu & elle de deſdains Les vens d’autre coſlé d’vne gorge beante Siſſtant & magiſſant augmentoyent la tourmenté, Brouilloyent tout l’Ocean, & les flois irritez Se guidoyent peſle meſle aux aſtres deſpitez Mais moy braue de cœur ie roidis la poitrine Contre les cruautez de l’ondeuſe marine, Demeurant roide & ſerme ainſi que ſait ſouuent Vn rocher au riuage, aux orages du vent.	Junon par un dépités de la pomme perdue Pour ne perdre en la mer pendait dessus la nue Forgeait des traits de feu, les lançait de ses mains, Mes nauss brûlaient de seu et elle dé dédains Les vents d'autre coslé d'une gorge béante Sisstant et magissant augments la tourmenté, Brouillaient tout l'Océan, et les flamme irrités Se guidaient pèle mêle aux astres dépitez Mais moi brave de cœur ie roidis la poitrine Contre les cruautés de l'ondeuse marine, Demeurant rude et serme ainsi que sait souuent ré au riuage, aux orages du vent.
Mais moy dy-ie ie ſuis inuicible en courage Surgi au port d’amour où reluit ion image, Phare de ma ſor tune, & ſuis venu icy.	Mais moi dis-ieois suis inuicible en courage Surgi au port d'amour où reluit ion image, Phare de ma sor tune, et suis venu ici.
Viur e ſous la beaute ou ie meurs de ſoucy?	Vivr e sous la te ou ainsi meurs de souci?
Reauté des Dieux aymee, & des Rois eſlimé, Plus b'lle par mes yeux, que par la renommee.	Reauté des Dieux aimée, et des Rois élimé, Plus b'lle par mes yeux, que par la renommée.
Heleine.	Hèleine.
Auour qu’ay-ie dûs l’ame, o Dieu que i’ay d'amox Qui me bat l’eſtomach, autugle mon beau iour, Boul’uerſe ma raiſon, me rend la fate bleſme, Comment en vn moment ne ſuis-ie plus moy-meſme Quelle poiſou ſecrette entre dedans mes os, Quel ſoin doux & cuiſant me volle le repos, Et quel eſclair ſi prompt eſclaire dans mon ameEt quel extréme froid ſi chaudement m'enſlame Quel deſtin m’acompaigne, & las!	Auour qu'ai-je dus l'âme, ô Dieu que j'ai d'amox Qui me bat l'estomac, autugle mon beau jour, Boul'uerse ma raison, me rend la fate blême, Comment en un moment ne suis-je plus moi-même Quelle poisou secrète entre dedans mes os, Quel soin doux et cuisant me volle le repos, Et quel éclair si prompt éclaire dans mon âme quel âme froid si chaudement m'enslame Quel destin m'acompagne, et las!
d’où viẽt ce ſont Que ie voy daus tes yeux les Démons de ma mort.	d'où vien ce sont Que ainsi vois daus tes yeux les Démons de ma mort.
Paris.	Paris.
Tu ne vois dant mes yeux obiect de mon enuie, Les Demons de ta mort, mais ceux la de ta vie Démõs rẽplis d’amour, qui pour nous rẽdre beureux En l'Auril de nos iours nous rendent amoureux.	Tu ne vois dant mes yeux objet de mon envie, Les Demons de ta mort, mais ceux la de ta vie Démons Remplis d'amour, qui pour nous rendre beureux En l'Ouril de nos jours nous rendent amoureux.
Si tu es eſperdue en ia propre penſee, Si tu es de mes yeux doucement offencee, Helas croy Tyudaride Heleine que pour toy, Amour rauit mon ame, & m’anime d’eſmoy, Et tant le ſens de mal de ton œil qui m’aſſolle, Qu’il faut ver ſer des pleurs, & fiuir la parole.	Si tu es éperdue en ja propre pensée, Si tu es de mes yeux doucement offense, Hélas crois Tyudaride Hèleine que pour toi, Amour ravit mon âme, et m'anime d'émoi, Et tant le sens de mal de ton œil qui m'assolle, Qu'il faut ver des pleurs, et fivir la parole.
Heleine.	Hèleine.
Mais qui es-tu qui parle, & d’où es-tu venu De quels parenses-tu, car tu mes incognu, Quel pays ta nourry en ta prcmiere enfance Et quel nom te donna le ciel à ta naiſſance Ie ue te cognois point, & mon cœur eſt lié, Ie ne ſçoy qui tu es, ou ie t’ay oublié, Serois-tu bien Theſee, ou quelqu’vn de ſa race, Lequel eſtant raui des appas de ma grace, Me rauit par amour, puis apres me rendit, Et par armes iamais ſot ne me defendit, Sot quine deuoit pas ceſle audace entreprendre, S’il ne vouloit auſſi par armes me deſendre, Non tu n’es p as Theſee ou i’ay le ſens perdu, Quoy voudrois-tu r’auoir ce que tu as rendu, Dy moy donc qui tu es, & ne me laiſſe en peine, Pour moy ie ſuis Deeſſe, & ie m’appelle Heleine.	Mais qui es-tu qui parle, et d'où es-tu venu De quels parentses-tu, car tu mes inconnue, Quel pays ta nourri en ta près enfance Et quel nom te donna le ciel à ta naissance Je ue te cognais point, et mon cœur est lié, Je ne sais qui tu es, ou ieit, oublié, Serais-tu bien Thesee, ou quelqu'un de sa race, Lequel étant raui des appas de ma grâce, Me ravit par amour, puis après me rendit, Et par armes jamais sot ne me défendit, Sot quine deuoit pas cèle audace entreprendre, 'il ne voulait aussi par le me desendre, Non tu es a Thesee ou ay le sens perdu, Quoy rais-tu pas ce que tu a rendu, m donc qui tu es, et ne me laisse en peine, Sor moiait suis Deesse, et ie pa Heleine.
Paris.	Paris.
Princeſſe de merite & de perſection, Ne penſe que ie ſois Gregeois de nation, Natif comme Theſee de Corynthe ou d’Athenes:	Princesse de mérite et de perséction, Ne pense que votre sois Grégeois de nation, Natif comme Thesee de Cornthe ou d'Athenes:
12 Mais croy que ta beauté, le gouſſre de mes peines, Ma ſait tourir la mer, ardant de voir les yeux, Furieux a bleſſer, à guerir gratieux, Ie ne ſuis pas ce Grec, ny ne voudrois pas l’eſtre Qui pour te faire, omant, ſa ſiamme recognoiſtre, Ourdit vn beau deſſcin, & ne l’acheua pas, Soit qu’il manquaſt d’amour, ou craigniſt le treſpas.	12 Mais crois que ta beauté, le goussre de mes peines, Ma sait tourir la mer, ardant de voir les yeux, Furieux a blesser, à guérir gratieux, Je ne suis pas ce Grec, ni ne voudrais pas l'être Qui pour te faire, omant, sa siamme reconnaître, Ourdit un beau desscin, et ne l'acheva pas, Soit qu'il manquât d'amour, ou craignît le trépas.
Ou bien s’il euſt pour toy quelque amour au viſage, Il n’euſt iamais pour toy d’honneur ny de courage, Ie ne ſuis pas ce Grec, ny ne le ſus iamais, Qui fit guerre à l’amour, à fin d’auoir la paix, Auec les freres tiens, ame par trop craintiue, Qui s’allumoit le cœur d’vne ſlamme trop viue.	Ou bien s'il eût pour toi quelque amour au visage, Il n'eût jamais pour toi d'honneur seule de courage, Je ne suis pas ce Grec, ni ne le sus jamais, Qui fit guerre à l'amour, à fin d'avoir la paix, Avec les frères tiens, âme par trop craintive, Qui s'allumait le cœur d'une slamme trop vive.
O amoureux Theſet, â Prince ſans amours, Tu commis en amour deux erreurs en deux iours, Erreurs qu’õ ne pourroit te pardõner ſans craindre, De violer d’amour les loys, & les enfreindre, Apres auoir rauy une telle beauté Tu la rends, ô courage amy de laſcheté, Craignant la mort que donne vne lame pointue, Et ne craignant la mort que nous donne la veue D'vn œil cruel & doux, œil doux qui fait perir Les cœurs des amoureux, & ne les fait mourir.	Ô amoureux Théset, â Prince sans amoureux, Tu commis en amour deux erreurs en deux jours, Erreurs qu'on ne pourrait te pardonner sans craindre, De violer d'amour les lois, et les enfreindre, Apres avoir ravi une telle beauté Tu la rends, ô courage ami de lâcheté, Craignant la mort que donne une lame pointue, Et ne craignant la mort que nous donne la vue D'un œil cruel et doux, œil doux qui doux qui Fait périr des amoureux, et ne les fait mourir.
Ne te ſouuient-il pas braue amoureux Theſee, (ſec Qu'Ariadne en ſes beaux yeux i’auoit l’ame tmbraEt que t’ayant donne le beau ſil de tes iours, Et rendu ton voyage beüreux par ſes amours, Que toy pour recompenſe at tainct de perfidie, L’abaudounas ſeulleite au riuage de Die:	Ne te souvient-il pas brave amoureux Thesee, (sec Qu'Ariadne en ses beaux yeux j'avait l'âme tmbraEt que t'ayant donne le beau sil de tes jours, Et rendu ton voyage béunreux par ses amours, Que toi pour récompense at taint de perfidie, L'abaudoune seulleite au rivage de Die:
Que ie ſois ce coüard, ce pipeur ce mocqueur, Pluſtoſt mille treſpas ſe logent en mon cœur?	Que homme sois ce coüard, ce pipeur ce moqueur, Plutôt mille trépas se logent en mon cœur?
Ie ſuis, rare Deeſſe, iſſu de noble race, Vn grãd Roy ma faict naiſtre, on le voit en ma face En ma garbe de Prince, & ie ſuis frere encor Du prophete Helenin & du vaillant Hector:	Je suis, rare Deesse, issu de noble race, Un grand Roi ma fait naître, on le voit en ma face En ma garbe de Prince, et et quefrère encor Du prophète Hélenin et du vaillant Hector:
Ilion eſt le lieu ou i’ay pris ma naiſſance, Et Venus a ſur moy verſe ſon iuſtuence, Ie me nomme Paris Alexandre, & Amour Ma faict perdre la veue aux rayons de ton iour.	Ilion est le lieu ou j'ai pris ma naissance, Et Venus a sur moi verse son justuence, Je me nomme Paris Alexandre, et Amour Ma fait perdre la vue aux rayons de ton jour.
Heleine.	Hèleine.
O tout le cœur me bat, vne telle merueille Eſtourdit ma raiſon, eſſourdit mon aureille, Me rend toute amoureuſe, & braue ſils de Roy, Me ſaict trembler de ioye & de crainte pour toy, Et ſi tu as ſouffert tant de maux ſur les ondes, Moa cœur ſouffre pour toy uilles douleurs proſõdes Helas qu’un braue Prince a ſur nous de pouuoir.	Ô tout le cœur me bat, une telle merveille Étourdit ma raison, essourdit mon oreille, Me rend toute amoureuse, et brave sils de Roi, Me sait trembler de joie et de crainte pour toi, Et si tu as souffert tant de maux sur les ondes, Moa cœur souffre pour toi y douleurs prosõdes Helas un braue Prince a sur nous de pouuoir.
De nous pouuoir lier auſſi toſt que nous voir:	De nous pouvoir lier aussi tôt que nous voir:
Helas gentil Paris que i’ay pour toy de flame.	Hélas gentil Paris que j'ai pour toi de flamme.
Paris.	Paris.
Helas que i’ay pour vous d’amour ma belle Dame.	Hélas que j'ai pour vous d'amour ma belle Dame.
Heleine.	Hèleine.
Amy que i’ay pour toy de vie & de treſpas Qui preſſent mes deſirs, & tallonnent mes pas.	Ami que j'ai pour toi de vie et de trépas Qui pressent mes désirs, et tallonnent mes pas.
Achattes.	Achattes.
Ne tardons plus icy amoureuſe brigade Le ſeiour ny vaut rien, la nef eſt a la rade:	Ne tardons plus ici amoureuse brigade Le seiour ni vaut rien, la nef est à la rade:
Camour vous y attend, ſus ſus gaignons le port:	Camour vous y attend, sus sus gagnons le port:
Et ſuyuons nos plaiſus, & ſuions noſtre mort, „ La fortune eſt muable, inconſtante & legere, „ Tournant le bien en mal, le bon-heur en miſere, Montons donc ſur la mer, & loin de ce ſeiour Je ſeray loin de peur, vous preſts de voſtre amour.	Et suivons nos plaisus, et suivons notre mort, „ La fortune est muable, inconstante et légère, „ Tournant le bien en mal, le bonheur en misère, Montons donc sur la mer, et loin de ce séjour Je serai loin de peur, vous prêts de votre amour.
Caſſandre.	Cassandre.
Quel preſage m’aſſaut, qu’elle eſtrãge aduenture Me fait groſſir le cœur par deſſus ma nature:	Quel présage m'assaut, qu'elle étrange aventure Me fait grossir le cœur par -dessus ma nature:
Quel ſigne redoutable, & quel deſtin trompeur, Me rauit l’aſſeurance & me donne la peur:	Quel signe redoutable, et quel destin trompeur, Me ravit l'assurance et me donne la peur:
Quel changement ſoudain, quelle metamorphoſe, Qui me monſtrant du bieu me promet autre choſe.	Quel changement soudain, quelle métamorphose, Qui me montreant du bieu me promet autre chose.
Qu'ay-ie a fremir ainſi dou vient ce tremblemẽt Qui m’oſte la parole auec le iugement, Et me faict augurer en moy meſme confuſe, Mille malheurs couuerts ſous vne ſotte ruze.	Qu'ai-je a frémir ainsi dou vient ce tremblement Qui m'ôte la parole avec le jugement, Et me fait augurer en moi -même confuse, Mille malheurs couverts sous une sotte ruze.
Qu’ay-ie plus a douter, contẽplez-bien mes yeux Briller en plaine mer ce ſeu preſagieux, Feu Gregeois qui ne peut s’eſteindre dedans l’onde:	Qu'ai-je plus a douter, contẽplezbien mes yeux Briller en plaine mer ce seu présagieux, Feu Grègeais qui ne peut s'éteindre dedans l'onde:
Mais qui doibt embrazer le plus grãd Roy du mõde:	Mais qui doibt embraser le plus grands Roi du momme:
Voyez voyez mes yeux comme il va prendre port Et planter ſur les murs l’arreſt de noſtre mort, Que ie preuoy de morts, de douleurs e d’eſclandre, Que ie voy de matheurs, & de deſtins deſcendre Sur la teſte de Troye, & que ie voy par toy Miſerable Paris tomber de maux lur moy.	Voyez voyez mes yeux comme il va prendre port Et planter sur les murs l'arrêt de notre mort, Que Hé vois de morts, de douleurs e eût esclandre, Elle ie vois de mateurs, et de destins descendre Sur la tête de Troie, et que je vois par toi Misérable Paris tomber de maux lur moi.
Mais qu’as-tu faict Paris amoureux miſerable, Qu’as tu ſaict contre nous Amour impitoyable, Contre nous qui ſans ceſſe honorons tes autels, T’eſtimans le plus grand de tous les immortels.	Mais qu'as-tu fait Paris amoureux misérable, Qu'as tu sais contre nous Amour impitoyable, Contre nous qui sans cesse honorons tes autels, T'estimants le plus grand de tous les immortels.
Toy & ce ſol Paris égaré de penſee,	Toi et ce sol Paris égaré de pensée,
Pour rendre la nature a bon droit oſſencee?	Pour rendre la nature a bon droit ossencee?
Auez tue Pryam, Polyxene & Hecior, Maſſacre l’innocent & ieune Polydor, Offençant lupiter qui aux boſtes preſide, Et les boſtes punit, qui en laſihant la bride A leur deſir auart & au ſoing d’amaſſer, Vont les dieux oſſencer, & les loix renuerſer, Comme Polymneſtor ce traiſtre Roy de Thrace, Qui en perdra l’honneur, & les yeux de la ſace, » Car Dieu dont le pouuoir eſt par tout in fiuy » Ne delaiſſe ſur terre un ſor faict impuny.	Avez tue Prym, Polyxène et Hécior, Massacre l'innocent et jeune Polydor, Offençant lupiter qui aux bostes préside, Et les bôtes punit, qui en lasihant la bride A leur désir auart et au soin d'amasser, Vont les dieux ossencer, et les lois renverser, Comme Polymnestor ce traître Roi de Thrace, Qui en perdra l'honneur, et les yeux de la sace, " Car Dieu dont le pouvoir est par tout in fiuy » Ne delaisse sur terre un jo faict y.
Malheur ſur Ilion, puis que le malheur meſme Se bande contre nous d’vne rigueur extreme, Mais qu’il ſeroit heureux, ſi demarant du port Paris euſt eu la mort, pour l’eſtoille du nort, Englouti dans un gouffre aux voyes tortueuſes.	Malheur sur Ilion, puis que le malheur même Se bande contre nous d'une rigueur extrême, Mais qu'il serait heureux, si demarant du port Paris eût eu la mort, pour l'étoille du nort, Englouti dans un gouffre aux voies tortueuses.
Pour eſleindre en la mer ſes flames amoureuſes, Et le feu que ſongeoit noſtre mere enſanter, Et vainere les deſtins qui nous veulent donter, Enſants de l’air eſmeu, vous p ſtillons d’Aeole, De Caſſandre eſploree eſcoutez la parole, Que n’auez-vous eſteind & rué dans la mer, Ce grand flambeau d’amour qui nous vient cõſumer, Donnans au flot batu d’vne ondeuſe tempeſte, Et au deſtin fatal pour beaucoup vne ſeſte.	Pour éleindre en la mer ses flammes amoureuses, Et le feu que songeait notre mère ensanter, Et vainere les destins qui nous veulent donter, Ensants de l'air ému, vous p ûtillons d'Aeole, De Cassandre esploree écoutez la parole, Que n'avez-vous éteind et rué dans la mer, Ce grand flambeau d'amour qui nous vient cõsumer, Donnants au flot batu d'une ondeuse tempête, Et au destin fatal pour beaucoup une tempête.
Iunon vous a ſeduis de quelque mot mocqueur, En la langue ruſee auſſi bien comme au cœur, Iurant a voſtre maiſtre en ſerment de Deiſſe.	Junon vous a séduis de quelque mot moqueur, En la langue ruse aussi bien comme au cœur, Jurant a votre maître en serment de Déisse.
De luy donner a ſemme vne belle maiſtreße, S’il permet que Paris ſans mal ny ſans danger, voiſe la moit daus Troye & ſa flamme loger, Fait mourir voſtre ioye, & naiſtre voſtre ennuy, Vng iour le ciel perdit des rauines de l’onde Le monde trop enclin aux delices du monde, Et nous verrons ſortis des gouffres de l’enſer, Amour pour perdre Troye en la flamme & au fer, Le regret que i’en ay me faict naiſtre l’enuye De perdre auant l’honneur:	De puis donner a semme une belle maître, S'il permet que Paris sans mal ni sans danger, voise la moit daus Troie et sa flamme loger, Fait mourir votre joie, et naître votre ennui, Ung jour le ciel perdit des ravines de l'onde Le monde trop enclin aux délices du monde, Et nous verrons sortis des gouffres de l'enser, Amour pour perdre Troie en la flamme et au fer, Le regret que j'en ame faict naître l'envie De perdre avant l'honneur:
mon eſprit & ma vie, Honneur qu’ex violant Aiax me volera, Quand la fureur du ſeu les corps deuorera:	mon esprit et ma vie, Honneur qu'ex violant Ajàx me volera, Quand la fureur du seu les corps dévorera:
Incredules Troyens qui ne vouliez pas croire, Qu’auec vos propres yeux, voſtre propre miſere, Contemplez voſtre perte, & comme en verité Iadis ie vous predy voſtre calamité, Croyez le maintenant, & ſelon l’apparence:	Incredules Troyens qui ne vouliez pas croire, Qu'avec vos propres yeux, votre propre misère, Contemplez votre perte, et comme en vérité Jadis ie vous prédi votre calamité, Croyez le maintenant, et selon l'apparence:
Condemnez vos erreurs plorans voſtre ſouffrance.	Condemnez vos erreurs plorants votre souffrance.
LE CHOEVR.	LE CHOEUR.
NOut cela qui prend vie au deſſoubs de la Lune I Souuent chãge & rechage au gré de la fortune Le Soleil ex ſon cours change bien de maiſons, De ces effets diuers s'entretient la Nature, Et comme la mort vit de noſtre pourriture:	NOut cela qui prend vie au dessoubs de la Lune I Jouvent chãge et rechage au gré de la fortune Le Soleil ex son cours change bien de maisons, De ces effets divers s'entretient la Nature, Et comme la mort vit de se pourriture:
Le Soleil ſe nourrit de diuerſes ſaiſons:	Le Soleil se nourrit de diverses saisons:
Le ciel eſt eternel le monde ne demeure, Et ſi l’homme ne meurt il faut que Platon meurs:	Le ciel est éternel le monde ne demeure, Et si l'homme ne meurt il faut que Platon meurs:
Pour auoir vne ſin ayant commencement, Et en ce monde icy toute choſe a vn terme, Car ſi le ciel ſe plaiſt en ſon eſſence ſerme, Le monde en ſa nature ayme le changement:	Pour avoir une sin ayant commencement, Et en ce monde ici toute chose a un terme, Car si le ciel se plaît en son essence serme, Le monde en sa nature aime le changement:
Pauure race affligee obiect de toute peine, Humaine creature en la terre inhumaine, Le but de tout ſoucy, le blanc de tout eſmoy, En plorant mes trauaux ie plore voſtre eſſence,	Pauvre race afflige objet de toute peine, Humaine créature en la terre inhumaine, Le but de tout souci, le blanc de tout émoi, En plorant mes travaux était plore votre essence,
Et puis conſiderant noſtre freſle naiſſance, Ie lamente pour vous en me plaignant pour moy.	Et puis considérant notre frêle naissance, Je lamente pour vous en me plaignant pour moi.
Le heurt de la fortune & meſchante & peruerſa Pardonne au ſimple peuple, & les Princes renuerſe, En cela reſemblant la nature du vent Qui bautain de courage, affronte, abat, attaque Pluſtoſt vn gros vaiſſeau, qu’vne legere barque, La virant, la pouſſant du ponant au leuant.	Le heurt de la fortune et méchante et perversa Pardonne au simple peuple, et les Princes renverse, En cela résemblant la nature du vent Qui bautain de courage, affronte, abat, attaque Plutôt un gros vaisseau, qu'une légère barque, La virant, la poussant du pendant au luant.
Fatal regne de Troye, o miſerable ville Sentant les coups du ſort, & les bras d’vn Acbille, Tu ſentiras ſur toy les deſtius coniurez.	Fatal règne de Troie, ô misérable ville Sentant les coups du sort, et les bras d'un Acbille, Tu sentiras sur toi les destius conjurés.
La Grece auec amour conſpirent a ta perte, Le ſeul eſpoir de ceux dout la mort eſt ouuerte C’eſt de leur propre vie eſtre de ſeſperez.	La Grèce était amour conspirent a ta perte, Le seul espoir de ceux dout la mort est ouverte C'est de leur propre vie être de sespérez.
Royaume ſloriſſant & en paix & en guerre Royaume la terreur & l’appuy de la terre, Deux femmes ſeulement abatient ta grandeur, Elles changent ta gloire eſclaitente en lumiere, Mais elles vont ainſi enuyans ton honneur Coguoiſſans ne pouuoir obſeurſir ta memoire.	Royaume slorissant et en paix et en guerre Royaume la terreur et l'appui de la terre, Deux femmes seulement abatient ta grandeur, Elles changent ta gloire esclaitente en lumière, Mais elles vont ainsi envuyants ton honneur Coguaissants ne pouvoir obseurs ta mémoire.
ACTE IIII.	ACTE IIII.
Menelaus.	Menelaus.
Agamemnon.	Agamemnon.
Calchas.	Calchas.
Menelaus.	Menelaus.
Bons dieux éternels qui gouuernez les Cieux, O Qui voyez deça bas les forſaicts vicieux, Et qui contre l’erreur du meſchant Epicure Guidez d’vn ſoing diuin le ciel & la nature, O bõs dieux ſouffaez vous qu’vn Troyen eſtrãgen Vn pipeur, vn larron courre tant de danger, Dleſſant vos Deitez, & que braue en malice, Da beau uous du vertu il bonore ſon vice, Et toy grande Minerue ardante de courroux, N’aſſouuiras-tu point ton courage ialoux Contre ce ſi r brigand qui ne ſait point de conte De t’auoir oſſencee & payé d’vne honte, Pourquoy veux-tu d’Aiax les ſautes rechercher, Et froiſſer ſon vaiſſeau en mer conire vn rother:	Bons dieux éternels qui gouvernez les Cieux, Ô Qui voyez deça bas les forsaicts vicieux, Et qui contre l'erreur du méchant Epicure Guidez d'un soin diuin le ciel et la nature, AIS bons dieux souffaez vous qu'un Troyen estrãgen Un pipeur, un larron courre tant de danger, Dlessant vos Deitez, et que brave en malice, Da beau -vous du vertu il bonore son vice, Et toi grande Minerue ardante de courroux, assouuiras-tu point ton courage ialoux Contre ce si brigand qui ne sait point de conte De auoir ossencee et payé honte, Pourquoy veux-tu Aiax les sautes rechercher, Et froisser son vaisseau en mer conire rother:
Et laiſſer impuny:	Et laisser impuni:
un acte ſi barbare, Qui fait bleſmir le More, & rougir les Tartares, Ne vois-tu pas Deeſſe, ou ne dois-tu pas voir Qu’en me faiſant iniure il blaſme ton pouuoir, Quoy demeuray-ie veuſ, & de ſemme & de vie, Auray-ie de l’amour?	un acte si barbare, Qui fait blêmir le More, et rougir les Tartares, Ne vois-tu pas Déesse, ou ne dois-tu pas voir Qu'en me faisant injure il blâme ton pouvoir, Quoi demeurai-je vus, et de semme et de vie, Aurai-je de l'amour?
n’auray-ie de l’enuie De ſuyure le voleur qui honnit mon renom, Et meſpriſant ma force éterniſe ſon nom?	n'aurai-je de l'envie De suivre le voleur qui honnit mon renom, Et méprisant ma force éternise son nom?
Permettray-ie bons dieux que ce Troyen infame, Me laiſſe plein de glace & s’allume en ma ſlamme, Sans punir ſon oſſence, & vengeur conſumer Son impudique ſtime au milieu de la mer, Pluſtoſt dedans les ſlots Neptun m’enſeueliſſe, Et dans ſon large ſein la terre m’engloutiſſe.	Permettrai-je bons dieux que ce Troyen infâme, Me laisse plein de glace et s'allume en ma slamme, Sans punir son ossence, et vengeur consumer Son impudique stime au milieu de la mer, Plutôt dedans les sots Neptun m'enseuvelisse, Et dans son large sein la terre m'engloutisse.
Agamemnon.	Agamemnon.
Quelle ardente ſurie, & cuiſante douteur Te fait ouurir la bouche, & reſerrer le cœur?	Quelle ardente surie, et cuisante douteur Te fait ouvrir la bouche, et réserrer le cœur?
D’ou ſortent tant de cris, d’ou ſourdẽt tãt de larmes Qui couleat ſur ta ſace, & roulent ſur tes armees Faut-il braue Monarque en ſimme ſouſpirer.	D'ou sortent tant de cris, d'ou sourd' tãt de larmes Qui couleat sur ta sace, et roulent sur tes armées Faut-il brave Monarque en simme soupirer.
Faiſant ſaſeber ton frere, & la Grece admirer.	Faisant saseber ton frère, et la Grèce admirer.
Menelaus.	Menelaus.
Je ſuiuray le meſchant iuſqu’au bout de la terre, Ie luy ſeray a craindre autant que le tonnerre, P eſſant ſa conſcience ainſi que les fureurs Pourſuyuoyent Oreſles de craintes & d’horreurs, Quaud mon ame ſera aux Enfers deſcenduë, I’apparoiſtray vn ombre effroyable a ſa veue, E iiij Troublant d’illuſions ſon ſomne & ſon repos, Comme il trouble ma vie au beau milieu des ſiots, Et bien que ie ſois veuf de ſemme & d’eſperance, Les dieux ne rendront veuf mon eſprit de vẽgeance,	Je suivrai le méchant jusqu'au bout de la terre, Je vou lai a craindre autant que le tonnerre, P essant sa conscience ainsi que les fureurs Poursuivaient Ores de craintes et d'horreurs, Quaud mon âme sera aux Enfers descendue, J'apparaîtrai un ombre effroyable à sa vue, E jij Troublant d'illusions son somne et son repos, Comme il trouble ma vie au beau milieu des siots, Et bien que sans sois veuf de semme et d'espérance, Les dieux ne rendront veuf mon esprit de vue,
Agamemnon.	Agamemnon.
Ne trouble ton eſprit d’vn ſi ſaſcheux diſcours.	Ne trouble ton esprit d'un si sâcheux discours.
Menelaus.	Menelaus.
Las mon eſprit ſe trouble en perdant mes amours,	Las mon esprit se trouble en perdant mes amours,
Agamemnon.	Agamemnon.
Quelles amours Heleine.	Quelles amours Hèleine.
Me.	Me.
Heleine i’ay perdue Heleine que Theſee à ſon frere a rendue:	Hèleine j'ai perdue Hèleine que Thesee à son frère a rendue:
Un cruel eſtranger vn corſaire ſans nom, Au meſpris de ma gloire augmente ſon renom, Et emporte par mer celle qu’il m’a rauie, Et me doune la mort iouyſſant de mavie:	Un cruel étranger un corsaire sans nom, Au mépris de ma gloire augmente son renom, Et emporte par mer celle qu'il m'a ravie, Et me doune la mort jouissant de mavie:
La parole me faut, & non pas le deſir De payer de cent morts un ſi laſche plaiſir.	La parole me faut, et non pas le désir De payer de cent morts un si lâche plaisir.
Agamemnon.	Agamemnon.
Quoy ce braue voleur ſuyuant ceux de ſa race Juit craignant le danger, & ne craint la menaſſe Qui tallonne ſa faute, & le malheureux tour De violer ta ſemme & voler ton amour.	Quoi ce brave voleur suivant ceux de sa race Juit craignant le danger, et ne craint la menace Qui tallonne sa faute, et le malheureux tour De violer ta semme et voler ton amour.
Mais Prince de courage, appaiſe tes complaintes, Oſte tant de douleurs & de pertes empreintes Au milieu de ton ame, vn Roy plein de valeurs, » Ne doit comme vne ſemme eſpandre tant de pleurs » Ains ſorcer ſa nature, & bautain de courage " Supporter du deſtin le malheur & l’orage.	Mais Prince de courage, apaise tes complaintes, Oste tant de douleurs et de pertes empreintes Au milieu de ton âme, un Roi plein de valeurs, " Ne doit comme une semme épandre tant de pleurs " Ins sorcer sa nature, et bautain de courage " Supporter du destin le malheur et l'orage.
Menelaus.	Menelaus.
Larrons Dardaniens race de bringandage Qi n’auez pour valeur que la fraude au courage, Eanemis de nature, & ennemis auſſi De la ſocieté qui aous ſait viure icy courtois & en repos, & non comme les beſtes	Larrons Dardaniens race de bringandage Qi n'avez pour valeur que la fraude au courage, Eanémis de nature, et ennemis aussi De la société qui aous sait vivre ici courtois et en repos, et non comme les bêtes
Foudroyer inbumains nos glaiues ſur nos teſles.	Foudroyer inbumains nos glaiues sur nos témles.
Quoy vous mocquerez -vous Dardaniens de noui Quoy nous volerez-vous, ſaus nous vanger de vous Quoy nous volerez-vous remplis de ſales ſlammes Iuſques dans nos maiſons nos ſilles & nos ſemmes, Demeuraus impunis, & ſans ſentir nos coups Sertz vous pleius d’amour, & no' pleins de courroux Que ſais-tu lupiter grand Seigneur de la ierre, Que te ſert dans le ciel ton ſoudroyant tonnerre, Que te ſert d’eſtre Dieu tout-puiſſant & tout-bon, Si ces voleurs Troyens ſans crainte de ton nom, Et ſans auoir frayeur de l’horreur de ton ire Au deshonneur des Grecs honorent leur Empire, Que dira-l’on de toy?	Quoi vous moquerez -vous Dardaniens de nouvi Quoi nous volez-vous, saus nous venger de vous Quoi nous volez-vous remplis de sales slammes Jusque dans nos maisons nos silles et nos semmes, Demeuraus impunis, et sans sentir nos coups Serts vous pleius d'amour, et n' pleins de courroux Que sais-tu lupiter grand Seigneur de la jerre, Que te sert dans le ciel ton soudroyant tonnerre, Que te sert d'être Dieu tout-puissant et tout-bon, Si ces voleurs Troyens sans crainte de ton nom, Et sans avoir frayeur de l'horreur de ton ire Au déshonneur de Ton honorent des Empire, Que diraon des toi?
que tu es ſans ſoucy Omuuubenurmpdnis, & les ſouſfres ainſi.	que tu es sans souci Omuuubenurmpdnis, et les sousfres ainsi.
Ie ne m’eſtonne pas dequoy le flot eſcume De vos deſloyautez, car c’eſt voſtre couſtume, Je ne m’eſtonne pas dequoy contre raiſon Vous enleuez ainſi les ſilles de maiſon, Et de mes outrageux bautains dans vos Prouinces Vous oſſencez les dieux, & outragez les vrinces.	Je ne m'étonne pas dequoy le flot écume De vos déloyautés, car c'est votre coutume, Je ne m'étonne pas dequoy contre raison Vous enlevez ainsi les silles de maison, Et de mes outrageux bautains dans vos Provinces Vous ossencez les dieux, et outragez les vrinces.
Et toy petit mignon tu as rompu la loy Et rauiſſant H leine, & tu briſes ta foy, Delaiſſant Pegaſis, & contre la nature Volant & violant, tu nous a faict iniure, Et cuides pauure ſot encores ne ſentir Tant tu és incenſe que vaut vn repentir.	Et toi petit mignon tu as rompu la loi Et ravissant H ine, et tu brises ta foi, Daissant Pégasis, et contre la nature Volant et violant, tu nous a fait injure, Et cuides pauvre sot es ne sentir Tant tu es censé que vaut un repentir.
Tu n’as eſte content abuſe de Dione D’abuſer du lict chaſte à la gentille Oenone Deeſſe ſoreſtiere, il te falloit encor Pour monſtrer que tu es de la race d’Hector Calfeutrer des vaiſſeaux, agiter la morine Autant qu’vn ſol deſir agitoit ta poictrine, Surgir au portde Sparte, & d’vn propos mocq	Tu n'as este content abuse de Dione D'abuser du lit chaste à la gentille Oenone Deesse sorestière, il te fallait encor Pour montrer que tu es de la race d'Hector Calfeutrer des vaisseaux, agiter la morine Autant qu'un sol désir agitait ta poictrine, Surgir au portde Sparte, et d' propos moeurs
Diſſimulant ta langue auſſ bien que ton cœur, Miſerable ſeduire vne ſimple ſemelle, Qui uit bien ton viſage, & non pas ta cautelle, Contre le droit humain en terre la voler, Et contre le diuin en mer la violer:	Dissimulant ta langue aussi bien que ton cœur, Misérable séduire une simple semelle, Qui uit bien ton visage, et non pas ta cautelle, Contre le droit humain en terre la voler, Et contre le divin en mer la violer:
Que le Gregeois l’endure affronteur miſerable, Et ne condamne à mort ton erreur puniſſable, Pluſtoſt les cieux brillans ſe plongent dans les eaux, Et la terre pluſtoſt s’allume de flambeaux Quelle valeur as-tu pour garder ton Heltine.	Que le Grègeais l'endure affronteur misérable, Et ne condamne à mort ton erreur punissable, Plutôt les cieux brillants se plongent dans les eaux, Et la terre plutôt s'allume de flambeaux Quelle valeur as-tu pour garder ton Heltine.
Que le vaillant Theſee indontable à la peine A ſes freres rendit, bies qu’il aye donté Le monſtre du Dedale, & la bas aſronté L’effroyable Cerbere, & d’une main ſubite Eſte vainqueur vaincu de la belle Hypolite, Femme braue & guerriere, & ſurmonté Creon, Rompu vcinin, Procuſte, & le brigand Schiron, Auras-tu bien le cœur de deffendre par armes Celle que tu as priſe ê le feint de tes larmes, Tu as trop peu d’audace, & ie iuge à te voir Que tu as de la fraude & non pas du pouuoir.	Que le vaillant Thesee indontable à la peine A ses frères rendit, bies qu'il aie donté Le montre du Dédale, et la bas asronté L'effroyable Cerbère, et d'une main subite Este vainqueur vaincu de la belle Hypolite, Femme brave et guerrière, et surmonté Creon, Rompu vinin, Procuste, et le brigand Sciron, Auras-tu bien le cœur dé fendre par armes Celle que tu as prise ê le feint de tes larmes, Tu as trop peu d'audace, et ie et é té voir Que tu as de la fraude et non pas du pendant.
Ie creue de deſpit, i’ay le ſens plein de rage, I’ay la menaſſe en bouche, & le meurtre au couragt La vengeance en la main, & ie ſens dodans moy Ie ne ſp̧ay quelle borreur vengereſſe de toy.	Je crève dé dépit, j'ai le sens plein de rage, J'ai la menace en bouche, et le meurtre au couragt La vengeance en la main, et quelque sens dodants moi Je ne sais quelle borreur vengeresse de toi.
Affronteur penſes-tu que ta ſolle manie, Que ton audace ſotte ainſi viue impunie?	Affronteur penses-tu que ta solle manie, Que ton audace sotte ainsi vive impunie?
Si tu le croy ie croy que tu es bien trompé Pauure ſot de ne voir mon g’aiue ia trempé Dans ton ſaag impudic, & les troupes Atrides, Rompre, briſer froiſſer les bandes Dardanides:	Si tu le cro ie croy que tu es bien trompé Pauvre sot de ne voir mon g'aive ja trempé Dans ton saag impudic, et les troupes Atrides, Rompre, briser froisser les bandes Dardanides:
Ny le Palladium Troyenne Deïté Contre vlyſſe ne peut defendre ta cité Quelle ne ſoit perduë, & de cent Philoctetes, Si tant y en auoit, les farales ſagettes	Ni le Palladium Troyenne Dé Contre vlysse ne peut défendre ta cité Quelle ne soit perdue, et de cent Philoctetes, Si tant y en avait, les farales sagettes
Ne feront que bien toſt tes murs ne ſoyent ruez Par la fureur Gregeoiſe, & tes peuples tuez, Ny U nus qui de ſeux i’en flamme la poitrine, Qui flitte les Troyens, & cauſe leur ruine, Ne te pourra ſauuer quand les arreſts du ſort Plaindrõt les maux de Troye, & t’aprẽdrõt ta mors, Et qu’aiax ſurieux & de meurtre & de rage Turaineraia ere nu milieu du carnage.	Ne feront que bien tôt tes murs ne soient rués Par la fureur Grégeoise, et tes peuples tuez, Ni V nus qui de seux j'en flamme la poitrine, Qui flitte les Troyens, et cause leur ruine, Ne te pourra sauver quand les arrêts du sort Plaindront les maux de Troie, et t'aprẽdrõt ta mors, Et qu'aix surieux et de meurtre et de rage Turaineraia ère nu milieu du carnage.
Ny la valeur d’Hector ployant ſous le butin Ne te pourra deſendre à l’aſſaut du deſtin Mourant pour ſon pays par la lance d’Acbille, Et mort ſera traine alentour de ſa ville, Bourbeux, ſangeux, hydeux, & non comme il eſtoit Quand luy ſeul au combat nos ſoldars affrontoit.	Ni la valeur d'Hector ployant sous le butin Ne te pourra désendre à l'assaut du destin Mourant pour son pays par la lance d'Acbille, Et mort sera traine alentour de sa ville, Bourbeux, sangeux, hideux, et non comme il était Quand lui seul au combat nos soldars affrontait.
Ny l’image à lupin ſainctement vencrable Qu’embraſſe ardentement ce vieillard miſerable Ce Roy mal-encontreux ne deſtournera pas Qu’apres ſon cher Polyte il ne tombe au treſpas, Par Pyrebe qui conceut iuſtement ſa colere, Lors que par le tallon tu fis mourir ſon pere:	Ni l'image à lupin sainte vencrable Qu'embrasse ardentement ce vieillard misérable Ce Roi mal-encontreux ne détournera pas Qu'après son cher Polyte il ne tombe au trépas, Par Pryrebe qui conçut iustement sa colère, Lors que par le tallon tu fis mourir son père:
Ainſi Roy tu payras la faute de ton fils, Et ton chef patira du mal que lu me fis.	Ainsi Roi tu paieras la faute de ton fils, Et ton chef pâtira du mal que lu me fis.
Menelaus, Agamemnon.	Menelaus, Agamemnon.
Calchas.	Calchas.
Menelaus.	Menelaus.
Nfin donc ie mouray remply de doleance.	Nfin donc tu mourai rempli de doléance.
Enfix par les froyens, les Gregeois ſont honnis, Et ne ſont les Troyens par les Gregeois punis, Roy ſoible de puiſſance, & puiſſant de courage, Arme-toy pour ton ayde & d’horreur & de rage, De ſureur, de terreur, de haines & de feux, Et fais que le ffets reſpondent a les vœux:	Enfix par les froyens, les Grège sont honnis, Et ne sont les Troyens par les Grégeois punis, Roy oible de puissance, et puissant de courage, Arme-toi pour ton aide et d'horreur et de rage, De fureur, de terreur, de haines et de feux, Et fais que le sets répondent à les vœux:
Appelle a iou ſetours les fieres Humenides	Appelle a jou setours les fières Humenides
Que leurs ſoüets, leurs ſerpẽs, leurs ſlabeauxſoiet tes Et t’allument le cœur afin de te vanger De ce brigand Troyen co cruel eſtranger, (guides Qui ta tolly ta ſemme, ainçois qui ta rauie Ta ioye, ton repos, ton eſpoir & ta vie, Outré d’un fiur deſdain pour ton dernier recours, D’vne voix forte & haute appelle a ton ſecours, A ton ayde, a la mort, a ta peine augmentee, Cette Rhamuſienne & Deeſſe Adraſtee, Qui de malheurs ſecrets & de glaiues trancbans, Punit ſans pardonner les actes des meſchans:	Que leurs soüets, leurs serpense, leurs slabeauxsoie tesRe t'allument le cœur afin de te venger De ce brigand Troyen co cruel étranger, (guides Qui ta tolly ta semme, ainçois qui ta ravie Ta joie, ton repos, ton espoir et ta vie, Outré d'un fiur dédain pour ton dernier recours, D'une voix forte et haute appelle a ton secours, A ton ide, à la mort, à ta peine augmente, Cette Rhamusienne et De Adrastee, Qui de malheurs secrets et de glaiues trancbans, Punit sans pardonner les actes des m:
Mais comment pauure Prince eſperdu de miſere, Denſes-tu penetrer de ton humble priere Le centre de la terre, & la voix faire entrer Ou cent coups de belier ne pourroyent penetrer.	Mais comment pauvre Prince éperdu de misère, Denses-tu pénétrer de ton humble prière Le centre de la terre, et la voix faire entrer Ou cent coups de bélier ne pourraient pénétrer.
Qui cuides-tu encores eſmouuoir la poictrine De teſte inexorable & ſourde Proſerpine, Et tirer à pitié, où ſon mary Pluton:	Qui cuides-tu encore émouvoir la poitrine De tête inexorable et sourde Proserpine, Et tirer à pitié, où son mari Pluton:
Ou ces legers Eſprits boſtes de Eblegethon:	Ou ces légers Esprits bôtes de Eblegethon:
Quand le ſils de la Muſe eſplore de ſa ſemme Ne peut preſque flechir les rochers de leur ame?	Quand le sils de la Muse éploré de sa semme Ne peut presque fléchir les rochers de leur âme?
Non non reuiens a toy, & repren tes eſprits, Ne iette plus de pleurs, n’eſlance plus de cris, Et ne mets ta fiance a vne bande morte, Qui ne te peut guerir d’vne langueur ſi forte.	Non non reviens a toi, et repren tes esprits, Ne jette plus de pleurs, n'élance plus de cris, Et ne mets ta fiance a une bande morte, Qui ne te peut guérir d'une langueur si forte.
Laiſſe la tous ces morts & leue vers les cieux Les mains, ton cœur, ta perte, & tes pleurs, tesiyeux Et noyé de ſouſpirs, de larmes & de peine, Inuoque a ton ſecours les deux freres d’Heleine offencez comme toy:	Laisse la tous ces morts et lève vers les cieux Les mains, ton cœur, ta perte, et tes pleurs, tesiyeux Et noyé de soupirs, de larmes et de peine, Inuoque a ton secours les deux frères d'Hèle offensez comme toi:
appelle par leur nom Et la Grecque Minerue, & la grande Iunon, Que ce meſchant larron ce ſaux garçon de Troye?	appelle par leur nom Et la Grecque Minerve, et la grande Junon, Que ce méchant larron ce saux garçon de Troie?
D’une bonte paya pour ioüir de ſa proye.	D'une bonté paya pour jouir de sa proie.
Calchas.	Calchas.
Vng Prince comme toy puiſſant & valeureux, Doibt auoir dedans l’ame vn deſir genereux De vanger ſon iniure & arroſer ſes armes Du ſang de l’ennemy, non de ſes propres larmes, Car ce n’eſt pas outrage, ou iniure ou forſaict, (ſait, Quand nous vangeous le tort qu’vn eſtranger nous Veu que le droict permet liſſant la ſimple eſcorce, De chaſſer viuement la force par la ſorce, Mais bien c’eſt vn forfaict quand le deſir d’auoix Nous ſait par vne ſaute oublier le deuoir, Que la raiſon nous monſtre, & contre la nature Offencer nos voiſins de lar cins & d’iniure:	Un Prince comme toi puissant et valeureux, Doibt avoir dedans l'âme un désir généreux De venger son injure et arroser ses armes Du sang de l'ennemi, non de ses propres larmes, Car ce n'est pas outrage, ou injure ou forsaict, (sait, Quand nous vengeous le tort qu'un étranger nous Veu que le droit permet lissant la simple écorce, De chasser vivement la force par la sorce, Mais bien c'est un forfaict quand le désir d'avoix Nous sait par une saute oublier le devoir, Que la raison nous montre, et contre la nature Offenser nos voisins de cins et iniure:
Tout braue cœur ne peut ſouſſrir qu’vn eſtranger vaant vonnn faratt, e ſa gloire outrager.	Tout brave cœur ne peut soussir qu'un étranger vaant vonnn farat, e sa gloire outrager.
Agamemnon.	Agamemnon.
courage Nous n’aurions point de cœur d’honneur, ni de O prophete Calchas, ſi vn tel brigandage Demeuroit impuni & i’il eſtoit permis D’eudurer les excez que font nos Enncmis, A la ſu contre nous nous verrons les Pygmees Embaſtonnez de dards arranger leurs armees, Si nous ſouffrons vn coup qu’vn voleur ſans valeur Auctoriſe ſon rapt au prix de noſtre honneur:	courage Nous n'aurions point de cœur d'honneur, ni de Ô prophète Calchas, si un tel brigandage Demeurait impuni et j'il était permis D'eudurer les excès que font nos Enncis, A la su contre nous nous verrons les Pygées Embastonnés de dards arranger leurs armées, Si nous souffrons un coup qu'un voleur sans valeur Auctorise son rapt au prix de notre honneur:
Doncques i’aſſembleray & i’en ſeray le guide, Tous les vaillans Gregeois au riuage d’Aulide Achille, Aiax, Patrocte, vlyſſe, & ce guerrier Qui doibt bleſſer le Myrthe, & gaigner le Laurier Et les ſeray iurer de ne quitter l’empriſe, Et de ne retourner que Troye ne ſoit priſe, Perduë, ſacagee & ſes penples tuez Par le glaiue, & ſes murs par la flamme ruez:	Donc j'assemblerai et j'en serai le guide, Tous les vaillants Grégeois au rivage d'Aulide Achille, Ajàx, Patrocte, vlysse, et ce guerrier Qui doib blesser le Myrte, et gaigner le Laurier Et les serai jurer de ne quitter l'emprise, Et de ne retourner que Tro ne soit prise, Perdue, sacage et ses pénèles tuez Par le glaiue, et ses murs par la flamme ruez:
Et feuſſent-ils dix am dans le port de Sigee, Tenant le Roy Pryam, & ſa ville aſiegee,	Et feussent-ils dix am dans le port de Sige, Tenant le Roi Pryam, et sa ville asiegee,
Calchas.	Calchas.
Voy paſleur de l’armee & Prince valeureux, Noſtre entrepriſe vaine, & les vens malbeureux, Arreſtant nos deſſeius, & nos barques profondes Fautes de bourſouffler, & de groſſir les ondes.	Vois pâleur de l'armée et Prince valeureux, Notre entreprise vaine, et les vends malbeureux, Arrêtant nos desseius, et nos barques profondes Fautes de boursouffler, et de grossir les ondes.
Nos combats ſout en l’air ſi les ſlots agitez Ne pouſſent nos vaiſſeaux, & nos cupidit.	Nos combats sout en l'air si les slots agités Ne poussent nos vaisseaux, et nos cupidit.
z Iuſqu’au port d'llion, inutile eſt la rame, Pour faire vn lõg voyage en mer quãd elle eſt calme Jl faut prier les veus & les deſtins amis Et par un ſacrifice appaiſer Artemis Que tu as courrouces alors que ſans malice Tu maſſacras un cerſ, & ne commis un vice.	ils Jusqu'au port d'llion, inutile est la rame, Pour faire un lõg voyage en mer quand elle est calme Jl faut prenant les veus et les destins amis Et par un sacrifice apaiser Artemis Que tu as courrouces alors que sans malice Tu massacras un cers, et ne commis un vice.
Agamemnon.	Agamemnon.
Que ſacrifirons nous Cal.	Que sacrifirons nous Cal.
Le ſouuenir me poinct	Le souvenir me point
Agamemnon.	Agamemnon.
Hardiment dis le moy calchas, & ne trains point.	Hardiment dis le moi calchâ, et ne trains point.
Calchas.	Calchas.
Il faut ſacrißer la belle Iphigenie, Et rendre en la tuant à ton frere la vie.	Il faut sacrisser la belle Iphigénie, Et rendre en la tuant à ton frère la vie.
LE CHOEVR.	LE CHOEUR.
NES Gregeois ſont ſi pleins de ſlamme C De ſureur & d’ire en agez D’auoir pour vne ſimple ſimmne Tant d’hommes de guerre, arrengez Nous monſtrans qu’ils ont plus de rage, Dedans le cœur, que de courage Dedans Aulide en trope eſpeſſe Ils ont iuré d’vn grand ſerment De ne retourner en la Grece Qu’ils n’ayent couuert d’vn monument Troye & nous, ayants plus d’enuie	NÉS Grègeais sont si pleins de slamme Ç De sûreur et d'ire en âgé D'avoir pour une simple simne Tant d'hommes de guerre, arrengez Nous montrants qu'ils ont plus de rage, Dans le cœur, que de courage Dans Aulide en trop épesse Ils ont juré d'un grand serment De ne retourner en la Grèce Qu'ils n'aient couvert d'un monument Troie et nous, ayant plus d'envie
Que de pltie de noſtre vie, Ils pourroyent biences fols gendarmes Prophetiſans leur verité, Tomber ſous le ſaix de nos armes, En trompant leur fœlicité, - Et froſſez par noſtre proueße Ne retourner iamais en Grece.	Que de plaîtie de notre vie, Ils pourraient biences fols gendarmes Prophétisans leur vérité, Tomber sous le saix de nos armes, En trompant leur fœlicité, - Et frossez par nôtre prouesse Ne retourner iamais en Grece.
Ou bien i’il arriue peut eſtre Que Troye tombe de leur main, Leurs actes ſeront recognoiſtre Qu’il ont le courege inhumain.	Ou bien j'il arrive peut être Que Troie tombe de leur main, Leurs actes seront reconnaître Qu'il ont le courege inhumain.
Et qu’ils nous prendront par les l’armes De ſinon & non par leurs armes.	Et qu'ils nous prendront par les l'armes De sinon et non par leurs armes.
Les Gregrois ſont pleins de malite, Se ſeruants de fraude en tout lieu, Et ſols eſliment que leur vice Leur ſoit donné de quelque Dieu Ou par force ou par tromperie.	Les Gregrois sont pleins de malite, Se servants de fraude en tout lieu, Et sols éliment que leur vice Leur soit donné de quelque Dieu Ou par force ou par tromperie.
Encor' ces Grecs ont le carnage Si bien empreint dedans le cœur Que perdant ton bumain courage Il veſtent leurs corps de fureur, Et pour accomplir leur manis, Sacriſiront iphigenie.	Encor' ces Grecs ont le carnage Si bien empreint dedans le cœur Que perdant ton bumain courage Il vêtent leurs corps de fureur, Et pour accomplir leur manis, Sacriront iphigénie.
Ne croyez que la tromperie, La fraude dont ils ſont amis Perde l'Empire de l’Aſie, Ce ſont les deſlins ennemis Qui coniurent forcenez d’ire A la perte d’vn tel Empire.	Ne croyez que la tromperie, La fraude dont ils sont amis Perde l'Empire de l'Asie, Ce sont les délins ennemis Qui conjurent forcené d'ire À la perte d'un tel Empire.
Helas que l’homme eſt miſerable De viure priſonnier du ſort, Subiect d’vn vſtre impitoyable Comme toy Troye de la mort:	Hélas que l'homme est misérable De vivre prisonnier du sort, Subiect d' Hôtre impitoyable Comme toi Troie de la mort:
Mais ne pouuant chaſſer ta peine Je plore ta perte ſoudaine.	Mais ne pouvant chasser ta peine Je plore ta perte soudaine.
ACTE V Agamemnon.	ACTE V Agamemnon.
Calchas.	Calchas.
Agamemnon.	Agamemnon.
Viſque ie ſuis force par la neceſſité I Dgcommettre vn forfait plein d’inbumanité:	Visque ie suis force par la nécessité I Dégommettre un forfait plein d'inbumanité:
Et qu’il faut ô ma main que mon cœur lu trauerſe.	Et qu'il faut ô ma main que mon cœur lu traverse.
Pour accoiſer les vens, calmer les ondes perſes Et augmenter ma haine appaiſant Arthemis, Qui veut que ie me vange au ſang des Ennemis.	Pour accoiser les vents, calmer les ondes perses Et augmenter ma haine apaisant Arthémis, Qui veut que personne me venge au sang des Ennemis.
Me vengeant ſur moy-meſme, & faiſant ſacrifice De mon cœur pour la rendre à la Grece propice, Puiſque i’y ſuis ſorcé, il faut que malgré-moy I’obeiſſe au deſtin qui cauſe mon eſmoy.	Me vengeant sur moi-même, et faisant sacrifice De mon cœur pour la rendre à la Grèce propice, Puisque j'y suis sorcé, il faut que malgré-moi J'obéisse au destin qui cause mon émoi.
Et que i’arme mon cœur de ſureur & de rage, Et prepare ma main à ce ſatal carnage, Et que bien que ie ſois & Gregeois & humain, Ie me monſtre à ma race vn meurtr ier inhumain Un carnacier d’enſant plus cruel qu’une fert, Vn pere helas!	Et que j'arme mon cœur de fureur et de rage, Et prépare ma main à ce satal carnage, Et que bien que je sois et Grégeois et humain, Je me montre à ma race un meurtr jer inhumain Un carnacier d'ensant plus cruel qu'une sert, Un père hélas!
du tout indigne d’eſtre pere, Que la terre abomine & les hommes auſſi Quand ie turay ma ſille & n’en auray mercy Y a il ô Calchas dans la voûte ætheree Des dieux comme l’on dit d’éternelle duree, Qui ſe plaiſent au meurtre & veulent ſans raiſon Qu’un pere s’enſanglante au ſang de ſa maiſon, Certes ceſt vn abus que ie ne puis pas croire, (gloirt Les dieux de nos malheurs n’augmentent pas leut Ou il uy en a point ou s’il y a des dieux, Jl necommandent pas ces autes odieux Eſtants de leur nature aux hommes pitoyables, Aux bommes que le monde a rendu miſerables.	du tout indigne d'être père, Que la terre abomine et les hommes aussi Quand s' ai ma sille et n'en aurai merci Y a il ô Calchas dans la voûte æthère Des dieux comme l'on dit d'éternelle dure, Qui se plaisent au meurtre et veulent sans raison Qu'un père s'ensanglante au sang de sa maison, Certes cest un abus que je ne puis pas croire, (glait Les dieux de nos malheurs n'augmentent pas lut Ou il ui en a point ou s'il y a des dieux, Jl écommandent pas ces autes odieux Estant de leur nature aux hommes pitoyables, Aux bommes que , monde a rendu érables,
Calchas.	Calchas.
Garde bien d’irriter encontre toy les dieux, Et te rendre ennemy de la terre & des cieux, Par tes propos remplis de colere & de bayne, Diminuant leur grace & augmentant ta peine, „ Il ſaut parler fort peu, car iamais on a veu „ Arriuer aux mortels du mal pour parler peu, " Au contraire on a veu aux nations eſtranges, " Sourdre pour trop parler des fortunes eſtranges.	Garde bien d'irriter encontre toi les dieux, Et te rendre ennemi de la terre et des cieux, Par tes propos remplis de colère et de baine, Diminuant leur grâce et augmentant ta peine, „ Il saut parler fort peu, car jamais on a vu „ Arriver aux mortels du mal pour parler peu, " Au contraire on a vu aux nations étranges, " Sourdre pour trop parler des fortunes étranges.
Agamemnon.	Agamemnon.
Mais quoy couuer au cœur tant d’ameres douleurs Fnſanter det courroux, auorter des malheur.	Mais quoi couver au cœur tant d'amères douleurs Fnsanter dét courroux, auorter des malheur.
Et au ventre ſouſfrir tant de ſortes tranchees, Voir mes os, & mes nerfs, & mes veines trãchees, Et au partir de la ne dire ſeulement Un mot pour me reſouldre entre tant de tourmens.	Et au ventre sousfrir tant de sortes tranches, Voir mes os, et mes nerfs, et mes veines tranches, Et au partir de la ne dire seulement Un mot pour me résoudre entre tant de tourments.
Calchas.	Calchas.
Il n’eſt pas deſendu au milieu des alarmes De verſer de vos yeux, & du ſang & des larmes Accuſant vos deſtins:	Il n'est pas desendu au milieu des alarmes De verser de vos yeux, et du sang et des larmes Accusant vos destins:
mais il eſt di ſendu De blaſpbemer les dieux pour vn enſant perdu, Car pour ſaire ceſſer l’orageuſe tempeſtt, Et pour nous ſaiuer tous il faut perdre vne teſte Faut-il pour vne fille ainſi vous irriter " Dieu vous l’auoit donnee il vous la veut oſler.	mais il est di endu De blaspbemer les dieux pour un sant perdu, Car pour zaïre cesser l'orageuse tempestt, Et pour nous saiuer tous il faut perdre une tête Faut-il pour une fille ainsi vous irriter " Dieu vous l'avait donnée il vous la veut ôler.
Agamemnon.	Agamemnon.
O frere Menelas voy mon amour extréme Pour venger ton voleur ie me vole a moy-meſme Et pour me monſtrer frere & courtois & humain Ie me declare pere à moy-meſme inhumain, Pren courage mon cœur arue toy d’aſſeurancs	Ô frère Ménélas vois mon amour extrême Pour venger ton voleur je me vole à moi-même Et pour me montrer frère et courtois et humain Je me déclare père à moi-même inhumain, Pren courage mon cœur arue toi d'assurancs
C'eſt le faict d’vn grand Roy d’auoir de la tonſia Et aux beurts de fortune oppoſer ſa vertu, Et a batre ſa roue au lieu d’eſtre abbatu:	C'est le fait d'un grand Roi d'avoir de la tonsia Et aux beurts de fortune opposer sa vertu, Et a battre sa roue au lieu d'être abattu:
Les Grecs la larme a l’œil dreſſerent vne pille, Mais cette belle, rare & admirable fille:	Les Grecs la larme a l'œil dressèrent une pille, Mais cette belle, rare et admirable fille:
Auoit au lieu de pleurs aux yeux vne clarté:	Avait au lieu de pleurs aux yeux une clarté:
Le pas libre & le front baußé de maieſté, Le cheſ bien releué, & la face aſſeures.	Le pas libre et le front baussé de maiesté, Le chez bien relevé, et la face assures.
Ainſi que ſi ſa mort n’eſtoit pas prepares, Seduite des propos d’Ulyce le trompeur, Qui pour haſter ſes pas & derrober la peur, Que ſa mere euſt conceu d’une acte ſi ſeuere, Tiompa d’vn faux Hymen & la fille, & la mere:	Ainsi que si sa mort n'était pas prépares, Séduite des propos d'Ulyce le trompeur, Qui pour hâter ses pas et derrober la peur, Que sa mère eût conçu d'une acte si sévère, Tiompa d'un faux Hymen et la fille, et la mère:
Quand le pere la vit il troubla ſon eſprit Et luy oſtant la voix par le poil il la prit, Et en bauſſaut le bras agité de ſurie, Vouloit de ſon eſpé luy dé ober la vie:	Quand le père la vit il troubla son esprit Et lui ôtant la voix par le poil il la prit, Et en baussaut le bras agité de surie, Voulait de son espé lui de ober la vie:
Qand par vn grand miracle on vit ſoudainement Les yeux de tout le monde en vn aueuglement Et au lieu de la ſille vne beſte appreſtee, Qi appaiſe en ſa mort la Deeſſe irritee, Soudain le vent s’accoiſe & ſaict l’onde calmer Com' ſi les Alcions vouloyent pondre en la mer:	Quand par un grand miracle on vit soudainement Les yeux de tout le monde en un aveuglement Et au lieu de la sille une bête apprêtée, Qi apaise en sa mort la Deesse irritée, Soudain le vent s'accoise et sait l'onde calmer Com si les Alcions voulaient pondre en la mer:
Les Grecs ne perdent temps ardans a la vergeant Il vont ſendant les ſlois romplis d’impatience, Et en fort peu d’eſpace ils ſur ciſſent au port Et plantent leurs drappeaux, ou eſt peinte la mort Ils retranchent leur champ daus le por de Sigee Et tiennent la Pryam & ſa ville aſſi(gee.	Les Grecs ne perdent temps ardans à la vergeant Il vont sendant les slois romplis d'impatience, Et en fort peu d'espace ils sur cissent au port Et plantent leurs drapeaux, ou est peinte la mort Ils retranchent leur champ daus le por de Sige Et tiennent la Prami et sa ville assio(gee.
Hector.	Hector.
Moy le ſils de Pryam & d’Hecube ſa femme, Que l’amour ſous la terre & la valeur enflamme.	Moi le sils de Pryam et d'Hecebe sa femme, Que l'amour sous la terre et la valeur enflamme.
Qi viuant de mon bras enuoyois ſous mes loyx Et doutois les plus forts & plus vaillans Gregeois,	Qi vivant de mon bras envoyais sous mes lois Et doutais les plus forts et plus vaillants Grégeois,
Qui ſuyoient deuant moy comme dedans la plaine S’enfuit deuant le Loup le troupeau porte-laine:	Qui suivaient devant moi comme dedans la plaine S'enfuit devant le Loup le troupeau porte-laine:
Moy diſ-ie plein d’horreur, plein d’eſfroy plein de Tout haus, delaiſſant le tencbreux manoir, (noix Ou rigne le diſcord, la noiſe & le ſilence:	Moi dis-je plein d'horreur, plein d'efroi plein de Tout haus, délaissant le tencbreux manoir, (noix Ou rigne le discord, la noise et le silence:
Ou du Soleil ne luit la lumiere brillante, Ou Pluton tient ſon ſiege autour de ſes eſprits, Ie viens ſur ce Theatre & de colere eſpris.	Ou du Soleil ne luit la lumière brillante, Ou Pluton tient son siège autour de ses esprits, Je viens sur ce Théâtre et de colère épris.
Et frappé de regret, & d’amour & de haine:	Et frappé de regret, et d'amour et de haine:
Pour les ſautes d’autruy i’endure de la peine, Force par le deſtin de voir encore icy, Les meux de mon pays & conter mon ſoucy.	Pour les sautes d'autrui j'endure de la peine, Force par le destin de voir encore ici, Les meux de mon pays et conter mon souci.
Helas que des grands dieux proſonde & la ſcience, Les conſeils inſinis haute la prouidence, Let eſfets incognus doubleux & incertains Qui par ſont leurs deſſeins par la main des deſtins Qui ne nous ſont cogaus à nous autres qui ſommes Animaux ignorants qu’on appelle des bommes.	Hélas que des grands dieux prosonde et la science, Les conseils insinis haute la providence, Let sets inconnus doubleux et incertains Qui par sont leurs desseins par la main des destins Qui ne nous sont cogaus à nous autres qui sommes Animaux ignorants qu'on appelle des bommes.
Bien ſouuent l’ig vorance a faict que nos maieurs Outoſfence les dieux en ſouffrant leurs malheurs, D’vn cœur impatient & d’une ame effrenee, Accuſants de leurs iours la ſiere deſlinee, Ne voyans que les dieux obſeurs en leurs deſirs, Leurs donnoyent peu d’ẽnuys & beaucoup de plaiſirs Que ſçauent les Troyens pour quoy ce grand Empire Court ſi jort à ſafin & tout à coup s’empire, Qui eſtoit ſous pryam & ſous les autres Roys, Redoute pour ſa ſorce & garde par ces loix.	Bien souvent l'ig vorance a fait que nos maïeurs Outosfense les dieux en souffrant leurs malheurs, D'un cœur impatient et d'une âme effrénée, Accus de leurs jours la sommes deslinee, Ne voyant que les dieux obseurs en leurs désirs, Leurs donnaient peu d'ennui et beaucoup de plaisirs Que savent les Troyens pour quoi ce grand Empire Court si jort à safin et tout à coup s'empire, Qui était sous priam et sous les autres Autres, Redoute pour sa sorce et garde par ces lois.
Pourroyent ils penetrer ſi auant & entendre La tauſe d’vn ſi triſte & pitoyable eſclandre, Et des dieux droictu-iers rechercher le conſeil Quand ils peuuent a peine œillader le Soleil:	Pourraient ils pénétrer si avant et entendre La tausse d'un si triste et pitoyable esclandre, Et des dieux droitu-iliers rechercher le conseil Quand ils peuvent à peine œillader le Soleil:
Tout lemal vient de nous, nos fautes nous produiſent Taut de deſtius cruels, nos pechez nous ſeduiſent	Tout lemal vient de nous, nos fautes nous produisent Taut de détius cruels, nos péchés nous séduisent
Et dardent ſur nos cheſs les fleches du treſpas Et quand nous les ſentons nous ne les voyons pas Tant nous ſommes pipez d’une vaine apparence Qi nous tient aueuglez dedans noſtre ignorance, Ie ne delaiſſe pas pauure Roy, de ſentir, On dit que le bon ſang ne peut iamais mentir, La mort qui te tallonne, & plaindre pitoyable, Et ton Empire heureux & ta ſin miſerable.	Et dardent sur nos chessés les flèches du trépas Et quand nous les sentons nous ne les voyons pas Tant nous sommes pipés d'une vaine apparence Qi nous tient aveuglez dedans notre ignorance, Je ne délaisse pas pauvre Roi, de sentir, On dit que le bon sang ne peut jamais mentir, La mort qui te tallonne, et plaindre pitoyable, Et ton Empire heureux et ta sin misérable.
Et voir tant de guerriers aux combats valeureux Vomir deſſus la terre & leur ſang genereux, Et leur ame & leur vie, & voir encore Troye, Tes biens & ton honneur aux ennemis en proye » Les choſes ont leurs temps, la ſeule deïte 2 Meſure ſes ſaiſons de ſon eternité, " Mais le monde eſt enclos des bornes de nature " Finy, mixtionné & qui touſiours ne dure.	Et voir tant de guerriers aux combats valeureux Vomir dessus la terre et leur sang généreux, Et leur âme et leur vie, et voir encore Troie, Tes biens et ton honneur aux ennemis en proie " Les choses ont leurs temps, la seule déité 2 Mesure ses saisons de son éternité, " Mais le monde est enclos des bornes de nature " Finy, mixtionné et qui toujours ne dure.
De la vient que ſouuent les Princes & les Ro Les Royaumes collez par le ciment des loix Qui en proſperité ont veſcu tant d’annees, En vn petit moment ſentent leurs deſtinees, Et comme gens âgez ſe rangent à leur ſin Et quittent leur Demon qui guidoit leur deſtin, Les Troyens maintenant ſentent leur fin ſupré me Les Gregeois quelque iour la ſentiront de meſme.	De la vient que souvent les Princes et les Ro Les Royaumes collés par le ciment des lois Qui en prospérité ont vécu tant d'années, En un petit moment sentent leurs destinées, Et comme gens âgé se rangent à leur sin Et quittent leur Démon qui guidait leur destin, Les Troyens maintenant sentent leur fin supré me Les Grègeais quelque jour la sentiront de même.
Car tous deux ont ſailly l’vn d’auoir ſans raiſon Outragé vn mary iuſques dans ſa maiſon, L’autre d’auoir perdu vne ſi belle ville Et preſque des Troyens aboli la famille, 9 Heureux l'homme qui ſuit les pas de la verta 21 Aulieu des beaux habits d’innocence veſtu, " Qui ne faict tort aux ſiens, tourmenté d’auart „ Mais reluit de ſimpleſſe & reiette le vice, " Qui meurt ſans deſplaiſir & va dedans les Cie " Marger de l’Ambroſie à la table des dieux,	Car tous deux ont sailly l'un d'avoir sans raison Outragé un mari jusques dans sa maison, L'autre d'avoir perdu une si belle ville Et presque des Troyens aboli la famille, 9 Heureux l'homme qui suit les pas de la verta 21 Aulieu des beaux habits d'innocence vêtu, " Qui ne fait tort aux siens, tourmenté d'avart „ Mais reluit de simplesse et rejet le vice, " Qui meurt sans déplaisir et va dedans les Cie " Marger de l'Ambrosie à la table des dieux,
Pryam.	Priam.
Pyrrhus.	Pyrrhus.
Pryam.	Priam.
Ve de ſang reſpandu, que de ſeux allumez Voy-ie autour de mes yeux, que de corps cο̃ar ie ſeu par le ſer:	Ve de sang répandu, que de seux allumés Vois-je autour de mes yeux, que de corps carque r par le ser:
ceſt eſtrage carnage (ſommez Eſtonne ma vieilleſſe, & trouble mon courage, Et bien que les vieillards ſouuent ne craignent riẽs, ay grand peur de ma vie & du ſalut des miens.	cest étrage carnage (sommez Étonne ma vieillesse, et trouble mon courage, Et bien que les vieillards souvent ne craignent riẽs, ai grand peur de ma vie et du salut des miens.
Quãd ie voy ces grãds ſeux en pointes ondoyãtes Emb aſer les maiſons & les terres beantes, Et iuſqu’aux ſondemens les murailles raſer, Et ſe grimper en l’air à fin de l’enbraſer, le pure oun in puue iammnine ronde, Qui doit perir par ſeu comme elle a fait par l’onde Puis i’ay au lieu de mes premieres actions lu cœur & en l’eſprit de ſortes paſſions uai m’oſtant la raiſon, l’eſboir, & le courage uand ie voy du treſpas le foudroyant viſage Lrſanglanté de meurtre, & quand ie voy auſſi Ces bourre aux çar naciers nous tuer ſans mercy Jmmoler noſtre vic a Pluton pour victime, Et aſſouuir leur cœu que la vengeance anime, Mais o grand Jupiter comment tay-ie offencé Pour eſtre ſi tres ſort contre moy courroucé, Et me ſaire ſouffrir las!	Quant ie voy ces grands savoir en pointes ondoyãtes Emb aser les maisons et les terres béantes, Et jusqu'aux sondements les murailles raser, Et se grimper en l'air à fin de l'enbraser, le pure oun in puve jamnine ronde, Qui doit périr par seu comme le a fait par l'onde Puis j'ai au lieu de mes premières actions lu cœur et en l'esprit de sortes passions ôtant la raison, esboir, et le courage uand ie du trépas le foudroyant visage Lrsanglanté de meurtre, et quand ie aussi Ces bourre aux çar naciers nous tuer sans mercy Jmmoler nôtre vic a Pluton pour victime, Et assouuir leur que la vengeance anime, Mais ô grand Jupiter comment tai-ie offencé Pour être si très sort contre moi courroucé, Et me zaïre souffrir las!
apres tant d’annces Qe i’ay regné en palx, ces dures deſtinees, Qimi ſroiſſent la teſte & renuerſent à bas Tant de nobles citez qui baiſeroyent tes pas, Adoreroyeat ta ſace, & aux peuples eſt anges Doigneux, enuoyeroyent tes diuines loüanges Lar ceux qui ſont la bas enuironnez d'horreur vni garde de cbanter l’hymne de ton bonneur	après tant d'années Qe j'ai régné en palx, ces dures destinées, Qimi sroissent la tête et renversent à bas Tant de nobles cités qui baiseraient tes pas, Adoreroieat ta sace, et aux peuples est anges Doigneux, enuoyeroyent tes divines louanges Lar ceux qui sont la bas environnés d'horreur uni garde de cobanter l'hymne de ton bonneur
Si ceſt toy Iupiter qui prends les Roys en garde Comme images de toy, ie te ſapply regarde L’eſtat de ma ſortune, & qu'apres taut d’enſants Tant de bieas taut d’bonneurs, iuſlement triompha De ceux la dont le tort a fait perdre la vie Ie me voy accable d’vne peine in fiuie, Bien que i’aye touſiours eat e tous les mortels Reuere tus grandeurs frequenté tes autels.	Si cest toi Jupiter qui prends les Rois en garde Comme images de toi, ie te sapply regarde L'état de ma sortune, et qu'après taut d'ensants Tant de bieas taut d'bonneurs, iuslement triompha De ceux la dont le tort a fait perdre la vie Je me vois accable d'une peine in fivie, Bien que j'aie toujours ébat éle tous les mortels Revère tus grandeurs frequenté tes autels.
Helas!	Hélas!
quel fier deſtin, quelle eſtrange aduãtur Sur la ſia de mon aage attaque ma nature, Las quand il a ſalla que plein d'ans & d’humeuri Qui corrompent mes ſeus & alterent mes mœurs De mes yeux chaſſieux ie viſſe en ma preſence Mourir mon ſits Hector l’eſpoir de ma deſence, Violer ma caſſandrt, & violer encor Le ſainct droit d’hoiellage à fin d’auoir de l’or, Et viſſe au Periode extreme de ma vie, Un acte helai!	quel fier destin, quelle étrange aduãtur Sur la zia de mon âge attaque ma nature, Las quand il a salla que plein d'ans et d'humeuri Qui corrompent mes zeus et altèrent mes mœurs De mes yeux chassieux ie visse en ma présence Mourir mon sits Hector l'espoir de ma désence, Violer ma cassandrt, et violer encor Le saint droit 'hoilage à fin d'avoir de l'or, Et visse au Periode extrême de ma vie, Un acte hélai!
remply de haine & de ſurie, Qui me groſſit le cœur emtombe de ſoucy, Et ne pardonne aux pleurs ny au courroux auſſi:	rempli de haine et de surie, Qui me grossit le cœur emtombe de souci, Et ne pardonne aux pleurs ici au courroux aussi:
Bons dieux pour vn tel meurtre accõply par malia Reçoiue ce meſchant de vos mains le ſupplice, Egal à ſon forfait, ſi encor daus les cieux Regne quelque pitie dedans le cœur des dieux, Et puis qu’il m’a faict voir de mon fils le carnage, Et de ſa mort cruelle enlaidy mon viſage D’Aibiles dont a tort tu te dis eſtre yſſu Ie n’ay iamais viuant tant d’iniures reçeu, Que de toy homicide, aius d’un cœur ſans cautelle Il c’eſt touſiours monſtre droicturier & fidelle Gardant ſa ſoy Premiſe alors qu’il me rendit La charongne d’Hector que ſa main me perdit.	Bons dieux pour un tel meurtre accõply par malia Reçoive ce méchant de vos mains le supplice, Égal à son forfait, si encor daus les cieux Regne quelque pitié dedans le cœur des dieux, Et puis qu'il m'a fait voir de mon fils le carnage, Et de sa mort cruelle enlaidi mon visage D'Aibiles dont a tort tu te dis même issu Ie n'ai jamais vivant tant d'injures reçu, Que de toi homicide, aius d'un cœur sans cautelle Il c'est toujours monstre roiturier et fidèle Gardant sa soi Premise alors qu'il me rendit La charongne Hector que sa main me perdit.
Pyrrhus.	Pyrrhus.
Ta radottes vieillard:	Ta radottes vieillard:
tant de voix eſtanceer	tant de voix étanceer
Et de toy-meſme auſſi, car quoy qu’vn pere ſace Il porteſur ſon dos les fautes de ſa race.	Et de toi-même aussi, car quoi qu'un père sace Il portesur son dos les fautes de sa race.
Tu as beau prendre au col l’idole a lupiter Idole ſans pouuoir qui ne tep ut oſter Du danger qui te preſſe, bel pauure creature Peuſes-tu que les dieux ayent ſoing de la nature Ny de te qui ſe faict entre nous icy bas De celuy que l’on tue ou que l’on ne tue pas?	Tu as beau prendre au col l'idole a lupiter Idole sans pouvoir qui ne tep ut ôter Du danger qui te presse, bel pauvre créature Pût-tu que les dieux aient soin de la nature Ni de te qui se fait entre nous ici bas De celui que l'on tue ou que l'on ne tue pas?
Va miſerable Roy raconter à mon Pere Labas dans les Enfers ou ne luit la lumiere Du Soleil rayonnant, les torts que ie i’ay ſaicts auinit iaj mijaitis, nin veux mes forfaicts Comme Neptoleme en vangeant ſon iniure, Fo ligne de ſa bonne & courtoiſe nature, El comme lu es mort auecques tes enſans En laiſſant les oregeois des Troyens triomphants.	Va misérable Roi raconter à mon Père Labas dans les Enfers ou ne luit la lumière Du Soleil rayonnant, les torts que personne j'ai saits auinit iaj mijaitis, nin veux mes forfaits Comme Neptoleme en vengeant son injure, Fo ligne de sa bonne et courtoise nature, Él comme lu es mort avec tes ensants En laissant les oregeais des Troyens triomphants.
Fin de la Tragedie de Pryam.	Fin de la Tragédie de Pryam.
