LES AMOVRS D’ANGELIQVE M ET DE ED OR TRAGI-COMEDIE.	LES AMOURS D'ANGELIQUE M ET DE ED OR TRAGICOMÉDIE.
ParMMſonſieur GILBERT.	ParMsonsieur GILBERT.
C 2 1 edeu Yt 30 I	Ç 2 1 édev Yt 30 I
A PARIS, Chez GABRIEL QVINET, au Palais» dans la Gallerie des Priſonniers, à l’Ange Gabriel.	À PARIS, Chez GABRIEL QUINET, au Palais " dans la Gallerie des Prisonniers, à l'Ange Gabriel.
A R IRE, I Cet Ouurage de Theatre eſt le ſeizieſie que i’ay donné au public, & le plus digne de ceux que i'ay fais, 2 LITOINL.	À R RE, I Cet Ouvrage de Théâtre est le seizies que j'ai donné au public, et le plus digne de ceux que j'ai fais, 2 LITOINL.
d’eſtre mis ſous la protection de V.	d'être mis sous la protection de V.
M.	M.
les Amours d’Angelique & de Medor, ſont le ſujet de ce Poëme, & ie ne pouuois pas eſcrire leurs auantures ſans parler de Charlemagne le plus auguſte de vos Predeceſſeurs:	les Amours d'Angélique et de Médor, sont le sujet de ce Poème, et quelque ne pouvais pas écrire leurs aventures sans parler de Charlemagne le plus auguste de vos Prédécesseurs:
Ie dirois le plus grand des Rois, ſi V.	Je dirais le plus grand des Rois, si V.
M.	M.
n'auoit pas ſuccedé à ſes Vertus & à ſa Puiſſance.	n'avait pas succédé à ses Vertus et à sa Puissance.
Ce Monarque a ſceu accorder des qualitez qui ſe trouuent rarement en.	Ce Monarque a su accorder des qualités qui se trouvent rarement en.
ſemble;	semble;
il fut Pieux & Galand, Vaillant & Iuſte;	il fut Pieux et Galant, Vaillant et Juste;
& fit fleurir durant ſà vie & les Lettres & les Armes.	et fit fleurir durant sans vie et les Lettres et les Armes.
Si ſon Regne a eſté éclattant, celuy de Voſtre Majeſté ne le ſera pas moins;	Si son Reine a été éclattant, celui de Votre Majesté ne le sera pas moins;
ſon ſiecle eſt ſi remply de grands euenemens, que ſi quelque excellente plume auoit pris le ſoin d’eſcrire ſes belles actions & les vies des grands Capitaines & des ſages Politiques qui ont eſté en Europe depuis que V.	son siècle est si rempli de grands événements, que si quelque excellente plume avait pris le soin d'écrire ses belles actions et les vies des grands Capitaines et des sages Politiques qui ont été en Europe depuis que V.
M.	M.
eſt ſur le Trône;	est sur le Trône;
comme on a eſcrit celles des Grecs & des Romains;	comme on a écrit celles des Grecs et des Romains;
l’Antiquité n’auroit rien à nous reprocher, & noſtre âge ſeroit comparable aux Temps heroiques.	l'Antiquité n'aurait rien à nous reprocher, et notre âge serait comparable aux Temps héroïques.
Les fameux Exploits des Chreſtiens qui ont répandu par tout le bruit de leur renommée, ont donné de la jalouſie aux Nations les plus barbares, & ſemblent auoir excité les Turcs à leur declarer la guerre, moins pour leur rauir leurs biens & leur liberté, que pour rendre leur nom celebre, & taſcher de s’acquerir de la gloire Mais leur temerité ſera juſtement punie;	Les fameux Exploits des Chrétiens qui ont répandu par tout le bruit de leur renommée, ont donné de la jalousie aux Nations les plus barbares, et semblent avoir excité les Turcs à leur déclarer la guerre, moins pour leur ravir leurs biens et leur liberté, que pour rendre leur nom célèbre, et tâcher de s'acquérir de la gloire Mais leur témérité sera justement punie;
Tout le monde ſçait ce que les Propheties ont dit ſur ce ſujet, & que c'eſt à la Francs à qui EIIATREY le Ciel a reſerué cet honneur.	Tout le monde sait ce que les Prophéties ont dit sur ce sujet, et que c'est à la Francs à qui EIATREY le Ciel a réservé cet honneur.
Puiſque V.	Puisque V.
M.	M.
eſt aujourd’huy l’arbitre de la Chreſtienté, Elle peut bien auſſi en eſtre le defenſeur;	est aujourd'hui l'arbitre de la Chrétienté, Elle peut bien aussi en être le défenseur;
ſes juſtes & grands deſſeins éclateront en leur ſaiſon.	ses justes et grands desseins éclateront en leur saison.
Déja la plus ardente jeuneſſe de cette Cour eſt allée par ſon Ordre ſur les Riues du Danube, poir faire briller la valeur des François, comme des Auant coureurs de V.	Déjà la plus ardente jeunesse de cette Cour est allée par son Ordre sur les Rives du Danube, poir faire briller la valeur des Français, comme des Avant coureurs de V.
M.	M.
en attendant qu’vn tour Elle aille ellemeſnie accomplir les-predictions, & mettre la terreur dans le camp des Othomans.	en attendant qu'un tour Elle aille ellemesnie accomplir les-prédictions, et mettre la terreur dans le camp des Othomans.
Lors, comme un nouueau Soleil, Elle effacera le Croiſſant, & ſun bras victorieux ira planter la Croix & les Lys ſur les deux bords de la Mer Noire.	Lors, comme un nouveau Soleil, Elle effacera le Croissant, et sun bras victorieux ira planter la Croix et les Lys sur les deux bords de la Mer Noire.
Le Roy TresChreſtien rendra les Chreſtiens triom.	Le Roi TresChrestien rendra les Chrétiens triom.
phans, la France heureuſe & éleuera ſes Vertus dans le plus haut degré de la gloire.	phants, la France heureuse et éleuera ses Vertus dans le plus haut degré de la gloire.
Ce ſont les vœux que ſait,	Ce sont les vœux que sait,
POVR VOSTRE MAIESTE,	POUR VÔTRE MAIESTE,
Sou trechamble, tres-obeiſſane & tres-ndele Seruiteur & Sujet, GILBERT.	Sou trechamble, très-obeissane et très fidèle Serviteur et Sujet, GILBERT.
PRIVILEGE du Myy.	PRIVILÈGE du Mi.
OVIS par la grace de Dieu, L Roy de France & de Nauarre.	OUÏS par la grâce de Dieu, L Roi de France et de Navarre.
A nos amez & feaux Conſeillers, les Gens tenans nos Cours de Parlement, Maiſtre des Requeſtes ordinaires de noſtre Hoſtel, Baillifs, Seneſchaux, Preuoſts, leurs Lieutenans & tous autres nos Officiers & Iuſticiers qu’il appartiendra, SALVT.	À nos âmez et féaux Conseillers, les Gens tenants nos Cours de Parlement, Maître des Requêtes ordinaires de notre Hôtel, Baillifs, Sénéchaux, Preuosts, leurs Lieutenants et tous autres nos Officiers et Justiciers qu'il appartiendra, SALUT.
Gabriel Quinet, Marchand Libraire de noſtre bonne Ville de Paris, Nous a fait remontrer qu’il auroit depuis peu recouuré vne Piece de Theatre, intitulée Les Amours d’Angelique & de Medor, S’il nous plaiſoit luy vouloir accorder nos Lettres de Priuilege à ce neceſſaires.	Gabriel Quinet, Marchand Libraire de notre bonne Ville de Paris, Nous a fait remontrer qu'il aurait depuis peu recouuré vne Nécessaires de Théâtre, intitulée Les Amours d'Angélique et de Médor, S'il nous plaisait a voir accorder nos Lettres de Privilège à ce nécessaires.
A CES CAVSES voulant gratifier l’Expoſant, Nous luy auons de noſtre Grace ſpeciale, pleine puiſſance & Authorité Royale, permis & permettons par ces preſentes de faire imprimer leſdits deux Ouurages en tels Volumes & Caracteres, & autant de fois que bon luy ſemblera, pendant le temps & eſpace de cinq années entiers & accomplis, à compter du iour quelle ſera acheuée d’imprimer pour la premiere fois;	À CES CAUSES voulant gratifier l'Exposant, Nous lui avons de notre Grâce spéciale, pleine puissance et Autorité Royale, permis et permettons par ces présentes de faire imprimer lesdits deux Ouvrages en tels Volumes et Caractères, et autant de fois que bon lui semblera, pendant le temps et espace de cinq années entiers et accomplis, à compter du jour quelle sera achevée d'imprimer pour la première fois;
Faiſans defences à toutes autres perſonnes de faire imprimer, pendant ledit temps, vendre ny debiter ledit Liure, ſans le conſentement dudit Expoſant, ou de ceux qui auront droit de luy, à peine de confiſcation des Exemplaires contrefaits, de cinq cent liures d’amende, & de tous deſpens, dommages & intereſts en sl’Expoſant;	Faisans défenses à toutes autres personnes de faire imprimer, pendant ledit temps, vendre quelque débiter ledit Livre, sans le consentement dudit Exposant, ou de ceux qui auront droit de lui, à peine de confiscation des Exemplaires contrefaits, de cinq cent livres d'amende, et de tous dépens, dommages et intérêts en sl'Exposant;
à la charge de mettre par iceluy, deux Exemplaires dudit liure en noſtre Bibliotheque publique, vn en celle de noſtre Chaſteau duLouure, & vn en cellede noſtre tres-Cher & Feal Cheualier, le Sieur Seguier, Chancelier de France, auant que de l’expoſer en vente;	à la charge de mettre par icelui, deux Exemplaires dudit livre en notre Bibliothèque publique, un en celle de notre Château duLouvre, et un en cellede notre très -Cher et Fal Chevalier, le Sieur Séguier, Chancelier de France, avant que de l'exposer en vente;
& à faute de rapporter és mains de noſtre Amé & Feal Conſeiller en nos Conſeils, grand Audiancier de France en quartier, vn recepiſſé de noſtre Bibliotequaire, & du Sieur Cramoiſy, commis par noſtredit Chancelier de la deliurance actuelle deſdits Exemplaires;	et à faute de rapporter ès mains de notre Amé et Fal Conseiller en nos Conseils, grand Audiancier de France en quartier, un recepissé de notre Bibliotequaire, et du Sieur Cramoisy, commis par notre Chancelier de la délivrance actuelle dédits Exemplaires;
Nous auons dés a preſent declaré ladite permiſſion d’imprimer, nulle, enjoignant au Scyndic des Libraires de faire ſaiſir tous les Exemplaires, qui auront eſté imprimez, lans auoir ſatisfait aux clauſes portées par ceſdites preſentes;	Nous avons dès à présent déclaré ladite permission d'imprimer, nulle, enjoignant au Scyndic des Libraires de faire saisir tous les Exemplaires, qui auront été imprimés, lans avoir satisfait aux cluses portées par cesdites présentes;
du contenu deſquelles vous Mandons faire jouyr l’Expoſant ou ceux qui auront droit de luy, & au premier noſtre Huiſſier ou Sergent ſur ce requis, faire pour leur exccutiou, tous Exploits, Saiſies & Actes neceſſaires, ſans demander autre congé ne pareatis, nonobſtant Clameur de Haro, Chartres Normande, Priſes à Parties, & autres Lettres à ce contraires:	du contenu desquelles vous Mandons faire jouir l'Exposant ou ceux qui auront droit de jours, et au premier notre Huissier ou Sergent sur ce requis, faire pour leur excutiou, tous Exploits, Saisies et Actes nécessaires, sans demander autre congé ne paretis, nonobstant Clameur de Haro, Chartres Normande, Prises à Parties, et autres Lettres à ce contraires:
CAR tel eſt noſtre plaiſir.	CAR tel est notre plaisir.
DONNE' à Paris le 14.	DONNE' à Paris le 14.
iour de Mars l’an de grace 1664.	jour de Mars l'an de grâce 1664.
Et de noſtre Regne le vingt-vniéme.	Et de notre Reine le vingt-vniéme.
par le Roy en ſon Conſeil.	par le Roi en son Conseil.
vigne, LE ROY.	vigne, LE ROY.
me avuit dieux eouveme ucuomdtoule de ſou Priuilege à GVILLAVME DE LVYIIE, & a aſſocié auec luy pour l’autre moitié les ſieurs THOMAS	me avit dieux épouveme ucuomdtoule de sou Privilège à GVILLAVME DE LUYIE, et a associé avec lui pour 'autre moitié les sieurs THOMAS
IOLY & FRANCQIS MAVGER.	JOLI et FRANCEIS MAUGER.
Acbeue d’imprimer pur la premiere ſoit le 5.	Acbeue d'imprimer pur la première soit le 5.
May ice4.	Mais ice4.
Les Exemplaïres ont eſté fournis,	Les Exemplaïres ont été fournis,
Regiſtrt ſur le Llure de la Communaute des Marchardt Libraires & Imprimeurs de cette Ville de Farit le eT.	Registr sur le Llure de la Communaute des Marchard Libraires et Imprimeurs de cette Ville de Farit le eT.
Avril isc4.	Avril isc4.
Signt, MARTIN, Scyndic.	Signt, MARTIN, Scydic.
AGTEVRS.	AGTEURS.
ANGELIQVE, Fille d’vn Roy d’Orient.	ANGELIQUE, Fille d' Roy d'Orient.
Ln1e, Amant d’Angelique.	Lnace, Amant d'Angélique.
RENAVD, Fils d’Avmon, Paladin,	RENAUD, Fils d'Avmon, Paladin,
Reo only durtenta,uomamuue d aiugelique,	Réo onli durtenta,uomamuue d aiugelique,
MARPHISE, Sœur de Roger & Amante de Renaud.	MARPHISE, Sœur de Roger et Amante de Renaud.
La Scene eſt à Paris dant le Palait du Roy.	La Scène est à Paris dant le Palait du Roi.
LES AMOVRS D ANGELIO ETDE MEDOR E	LES AMOURS D NGELIO ETDE MEDOR E
AVTE I.	AUTE I.
SCENE TREMTERE.	SCÈNE TREMTERE.
ALIDOR, ARIMANT.	ÀLIDOR, ARIMANT.
ALIDOR.	ÀLIDOR.
V'APRES deux ans entiers, Seigneur, le vous rcuoye, Ie ne puis exprimer la grandeur de ma ioye.	V'ÂPRES deux ans entiers, Seigneur, le vous rcuoye, Je ne puis exprimer la grandeur de ma joie.
MEDOR ſout le nom d’Ariment.	MEDOR sout le nom d'Ariment.
Mais, mon cher Alidor, tire moy de ſoucr:	Mais, mon cher Alidor, tire moi de souscr:
Qui ca peà conſeiller de me chercher icy?	Qui ca peà conseiller de me chercher ici?
1B	1B
ALILOE.	ÀLILOE.
Aprés l’affreux combat fait aux monis Pyrenntes, Qui de tant de guerriers trencha les deſtinées, Ne vous ayant point veu daus le nombre des morts, Ie fis pour veus trouuer d’inutils efforts, Ie trauerſay l’Eſpagne, & fus iuſqu’au rluage, Où l’on baſtit jadis les hauts murs de Carthage:	Après l'affreux combat fait aux monis Pyrenntes, Qui de tant de guerriers trencha les destinées, Ne vous ayant point vu daus le nombre des morts, Je fis pour veux trouver d'inutils efforts, Je traversai l'Espagne, et fus jusqu'au ruage, Où l'on bâtit jadis les hauts murs de Carthage:
Ià j’appris d'vn Couriel, que de fameux Tournoi, Attiroient tout le monde à la Cour des François, Et je vins vous chercher ſur les bord, de la Seins, Où le Ciel fauorable à mis ſin à mà peine.	Jà j'appris d'Han Couriel, que de fameux Tournoi, Atiraient tout le monde à la Cour des Français, Et je vins vous chercher sur les bord, de la Seins, Où le Ciel favorable à mis sin à mà peine.
Mais quel demon, Seigneur, vous mene en cette Cour?	Mais quel démon, Seigneur, vous mène en cette Cour?
ARIMANT.	ARIMANT.
Le plus puiſſant de tous, AuEDUR Qu’el eſt-il?	Le plus puissant de tous, AvÉDUR Qu'elle est-il?
ARIMANT.	ARIMANT.
C’eſt l'amonr.	C'est l'amonr.
ALIDOR.	ÀLIDOR.
Pour qui ſoſſpirez vous?	Pour qui sosspirez -vous?
ARIMANT.	ARIMANT.
Pour I illuſtre Angelique, Cette rare beauté, dont la gloire eſt publique, Qui conte les vainqueurs au rang de ſes vaincus, Agramant ce grand Roy, Gradaſle, & Petragusi;	Pour I illustre Angélique, Cette rare beauté, dont la gloire est publique, Qui conte les vainqueurs au rang de ses vaincus, Agramant ce grand Roi, Gradâle, et Pétragusi;
Qui meſpriſe Roland, qui ſoûpire pour elle, Et s’eſt toujours fait, voir auſſi fiere que bellę.	Qui méprise Roland, qui soupire pour elle, Et s'est toujours fait, voir aussi fière que bellise.
ADIDOR.	ADIDOR.
Quoy!	Quoi!
c’eſt cette Princeſſe?	c'est cette Princesse?
ARIMANI.	ARIMANI.
Oüy, c’eſt cette beanté, Qui m’oſte le repos auec la liberté.	Oui, c'est cette beanté, Qui m'ôte le repos avec la liberté.
ALIDOR.	ÀLIDOR.
En eſtes vour aymé?	En êtes vour aimé?
ARIMANT.	ARIMANT.
Non ç’eſt Medor qu’elle ayme,	Non ç'est Médor qu'elle aime,
C’eſt done vous.	C'est donce vous.
ALIDOR.	ÀLIDOR.
ARIMANT.	ARIMANT.
Ah!	Ah!
je ſuis le riual de moy-méme.	je suis le rival de moi-même.
ALIDOR.	ÀLIDOR.
Quel ſujet auez vous d’ainſi diſſimuler?	Quel sujet avez -vous d'ainsi dissimuler?
ARIMANT.	ARIMANT.
Aprés le grand combat dont tu viens de parler, Des Sarrazins vainqueurs pourſuiuant la victoire, I’entre auec les fuyars dans vne foreſt noire, Ie mégare parmy les pins & les cyprez;	Après le grand combat dont tu viens de parler, Des Sarrasins vainqueurs poursuivant la victoire, J'entre avec les fuyars dans une forêt noire, Je mégare parmi les pins et les cyprez;
Et ſcul dans vn valon delitieux & frais, Ie vois vne Amazone au bord d’vne fontaine, La viſiere leuće & qui prenoit haleine:	Et scul dans un valon délitieux et frais, Je vois été Amazone au bord d'une fontaine, La visière leuve et qui prenait haleine:
Comme je contemplois ſes diuines beautez, 2 Qui rendent de plaiſir tous mes ſens enchantez, De quelque antre prochain ſort vne Ourſe ctuelle, Qui ſurprend la Guerriere & ſe jette ſur elle, Tranſporté de fureur je vais à ſon ſecours.	Comme je contemplais ses divines beautés, 2 Qui rendent de plaisir tous mes sens enchantez, De quelque antre prochain sort vne Ourse cuelle, Qui surprend la Guerrière et se jette sur elle, Transporté de fureur je vais à son secours.
De ce monſtre, d’vn dard je termine les jours:	De ce monstre, d'Han nard je termine les jours:
D’vn peril impreucu la belle encore émeüe Sur ſon liberateur jette en tremblant la veüe, Lorſque j’entends vn bruit & d’armes & de voix, Ie voy des eſcadrons & l'étendart Francois:	D'un péril improuvcu la belle encore émue Sur son libérateur jette en tremblant la vue, Lorsque j'entends un bruit et d'armes et de voix, Je vois des escadrons et l'étendard Francais:
L’ame tout à la fois & triſte & ſatisfaite, Ie fais auec regret vne prompte retraitte;	L'âme tout à la fois et triste et satisfaite, Je fais auec regret une prompte retraite;
ne cede iedes Vauieus plus neureux qu'vn vainqueur, Et laiſſe dans les bois, Angelique & mon cœur.	ne cède imdes Vavieus plus neureux qu'un vainqueur, Et laisse dans les bois, Angélique et mon cœur.
ALIBOR.	ÀLIBOR.
C’eſt pour vn coup d’eſlay faire vn acte heroique, Mais comment ſçauez vous que c’eſtoit Angelique?	C'est pour un coup d'élai faire un acte héroïque, Mais comment comment vous que c'était Angélique?
ARIMANT.	ARIMANT.
Ie l’appris dans le camp d’vn priſonnier françois, De cet objet charmant je luy parlay cent fois;	Je l'appris dans le camp d'un prisonnier français, De cet objet charmant je lui parlai cent fois;
Et comme il connoiſloit cette belle Heroine A ij Il m’apprit ſes malheurs auce ſon origine, Qu'vn Tyran de ſon Pere auoit borne le ſort, Et s’eſtoit empaté du thrône aprés ſa mort.	Et comme il connaislait cette belle Héroïne A j Il m'apprit ses malheurs auce son origine, Qu' Tyran de son Père avait borne le sort, Et s'était empaté du trône après sa mort.
Sa naiſlince augmentant mon reſpect & monzele, Ie veux auant la voir me montrer digne d'elie;	Sa naislince augmentant mon respect et monzèle, Je veux avant la voir m montrer digne d'élie;
Ma flîme m’inſpirant vn deſſcin noble & grand, Ie fais vœu de me perdre ou perdre ſon tyran.	Ma flamme m'inspirant un desscin noble et grand, Je fais vœu de me perdre ou perdre son tyran.
Cette bęauté que j’ayme aucc idolatrie Me fait tout mépriſer & quitter ma patrie, Et pour guide prenant l’eſperance & l’amour, Ie vais juſqu’aux climars où s’allume le jour;	Cette bęauté que j'aime aucc idolatrie Me fait tout mépriser et quitter ma patrie, Et pour guide prenant l'espérance et l'amour, Je vais jusqu'aux climars où s'allume le jour;
Felgnant que de ſa part ję viens dans ſon Empirs, Auec les plus zelez en ſecret je conſplre, I'attaque le tyran au milieu d vn feſtin, Et fuis ſon repus, ſon regne & ſon deſtin.	Felgnant que de sa part juis son des son Empirs, Avec les plus zélé en secret je consplère, J'attaque le tyran au milieu d un festin, Et fuis son repus, son règne et son destin.
De ce coup ſurprenant on fremit, on s’étonne, mamed de le tangeriaguoe l’aomcoune, Et ſans trop raiſonner penſe dans ſon effroy, Que tout le pcuple armé conſpire auec moy.	De ce coup surprenant on frémit, on s'étonne, maméd de le tangeriaguoe l'aomcoune, Et sans trop raisonner pense dans son effroi, Que tout le puple armé conspire avec moi.
ALIDOR, L'entrepriſe étoit belle, autant que perilleuſe.	ÀLIDOR, L'entreprise était belle, autant que périlleuse.
ARIMANT.	ARIMANT.
Elle eut vn prompt ſuccez & fut infructueuſe.	Elle eut un prompt succès et fut infructueuse.
A peine ce Tyran étoit dans le tombeau, Que i’en vis ſur le throne éleuer vn nouuȩau.	À peine ce Tyran était dans le tombeau, Que j'en vis sur le throne élever un nouverau.
Son frete plein d eſpoir, de richeſſe & d’audace, Coltomphſesjoidaes, Celemeniapise, Et le peuple effrayé ne me ſecond int pas, Ie fus bien-tôt contraint de quitter ſes Etats:	Son frère plein d' avoir, de richesse et d'audace, Coltomphsesjoidaes, Clémeniapise, Et le peuple effrayé ne me second int pas, Je fus bientôt contraint de quitter ses États:
Et ſans auoir rien fait pour l’illuſtre Angelique, Ie retournay du Gange au riuage d’Afrique.	Et sans avoir rien fait pour l'illustre Angélique, Je retournai du Gange au rivage d'Afrique.
ALIDOR.	ÀLIDOR.
Que ce deſſein pour elle étoit bien commencé, Si ce nouie au Tyran ne l’oſlt point traucreé,	Que ce dessein pour elle était bien commencé, Si ce nouvie au Tyran ne l'oslt point traucreé,
ARIMANT.	ARIMANT.
De la voir au retour brûlant d'impatience, Sçacltant que la Princeſſe étoit toujours en France, Oà je ne pouuois pas me rendre ſeurement, I'y vins, cher Alidor, ſous le nom d’Arimant, Fils du braue Aquilant, ce Paladin illuſtre e Qui mourut glorieux dans fon quinzieſme luſtre Dans ce fameux combat que ie viens de conterEt!	De la voir au retour brûlant d'impatience, Sacltant que la Princesse était toujours en France, à je ne pouvais pas me rendre sûrement, J'y vins, cher Alidor, sous le nom d'Arimant, Fils du brave Aquillant, ce Paladin illustre e Qui mourut glorieux dans son quinzième lustre Dans ce fameux combat que ie viens de contérE!
fier Arimant le voulant imiter, Pour montrer qu’il eſtoit d’vne race vaillante, Bleſſe d'vn coup mortel fut porté dans ma tente;	fier Arimant le voulant imiter, Pour montrer qu'il était d'une race vaillante, Blesse d'un coup mortel fut porté dans ma tente;
Ie ſçeus de luy ſon nom vn peu deuant ſa mort;	Je sus de lui son nom un peu devant sa mort;
Nous eſtions de meſmeâge, il me reſſembloit fort?	Nous étions de mesmeâge, il me ressemblait fort?
De ſorte qu’au retour des climats de l'Autore- Du deſtià d’Arimant me ſouuenant encore, Sçachant qu’on ignoroit ſa mort en tette Cour, Ie formay ce deiſcin inſpiré par l’amour, D'y venir ſous ſon nom, d’y paſſer pour luy-méme;	De sorte qu'au retour des climats de l'Autore- Du destià d'Arimant me souvenant encore, Sachant qu'on ignorait sa mort en tette Cour, Je formai ce déciscin inspiré par l'amour, D'y venir sous son nom, d'y passer pour lui-même;
Et ie fus en ſix mois par vn bon-heur extréme, Confident d’Angelique, & bien auprés du Roy?	Et deux fus en six mois par un bonheur extrême, Confident d'Angélique, et bien auprès du Roy?
L’vn & l’autre m’eſtime, & prend conſeil de moyPour me fiite cherir d’elle & de Chrlemagne, I’ay faitvoir ma valeur aux guerres d’Allemagne, Et ie ſers la Princeſſe & le Roy tour à tour, Pour eſtre ſeulemenr fauory de l’amour.	L'autre et l'autre m'estime, et prend conseil de moiPour me fiite chérir d'elle et de Chrlemagne, J'ai faitvoir ma valeur aux guerres d'Allemagne, Et ainsi sers la Princesse et le Roy tour à tour, Pour être seule favori de l'amour.
ALTDOR.	ÀLTDOR.
Pous meriter ſon cœur auec ſa ſoüange.	Pous mériter son cœur toujours sa sourange.
Sçait-ene que Meuoriut amt Ries du Ginger	Sait-ene que Muoriut amout Ries du Ginger
ARIMANT.	ARIMANT.
Elle ſçait que Medor pour vanger ſes Parens, A de ſa propre main tué l’vn des Tyrans, Et que cette mort cauſe vne guerre ciuile.	Elle sait que Médor pour venger ses Parents, À de sa propre main tué l'un des Tyrans, Et que cette mort cause une guerre civile.
ALIDOR.	ÀLIDOR.
Ce ſeruice eſt bien grand.	Ce service est bien grand.
42 1	42 1
ARIMANT.	ARIMANT.
Mais il eſt inueile, Puiſque deſſus le thrône i' ne la remet pas, Ie luy contc pour rien tout ce qu’a fait mon bras,	Mais il est inécile, Puisque dessus le trône j' ne la remet pas, Je Le contc pour rien tout ce qu'a fait mon bras,
ALIDOR.	ÀLIDOR.
Cette illuſtre Princeſſe ignore-t'elle encore Que vous eſtes Medor?	Cette illustre Princesse ignore-t'-elle encore Que vous êtes Médor?
ARIMANT.	ARIMANT.
Helas!	Hélas!
elle l'ignore Lors que dans la foreſt on nous vint ſeparer, Elle n’eut pas le temps de me conſiderer:	elle l'ignore Lors que dans la forêt on nous vint séparer, Elle n'eut pas le temps de me considérer:
Depuis i’ay touſiours craint que ma belle Princeſſe N’accusât mon amour de trop de hardieſle;	Depuis j'ai toujours craint que ma belle Princesse N'accusât mon amour de trop de hardièle;
Ie crains de faire voir trop de temerité, Ie ſçay que ſon courage égale ſa beanté:	Je crains de faire voir trop de témérité, Je sais que son courage égale sa beanté:
Connoiſſant donc qu elle eſt auſſi fiere que belle, Pour fléchir ſon orgueil, pour eſtre digne d’elle, Pour pouuoir meriter ſon eſtime & ſon cœur, Dans ce pompeux Tournois je veux eſtre vainqueur.	Connaissant donc qu elle est aussi fière que belle, Pour fléchir son orgueil, pour être digne d'elle, Pour pouvoir mériter son estime et son cœur, Dans ce pompeux Tournais je veux été vainqueur.
On doit l'ouurir demain ſur les bords de la Seyne Pour honorer icy l ambaſſade d’Irene, Quimitonm auRoyr Empne dOccidens, Et reſerue à ſon Fils les Sceptres d’Orient.	On doit l'ouvrir demain sur les bords de la Seyne Pour honorer ici l ambassade d'Irène, Quimitonmit auRaient Empne dOccidents, Et réserve à son Fils les Sceptres d'Orient.
ALIDOR.	ÀLIDOR.
Ses deux Ambaſſadeurs ont eu ieut audiance.	Ses deux Ambassadeurs ont eu jeut audience.
ARIMANT.	ARIMANT.
On a tenu depuis vn conſeil d’impottance, Pour l’ordre qu’on doit ſulure en ces fumeux Tournois, Où diſputent les prix des Heros & des Rois.	On a tenu depuis un conseil d'impottance, Pour l'ordre qu'on doit sulure en ces fumeux Tournois, Où disputent les prix des Héros et des Rois.
Ie prends grand intereſt l la feſte publique, Qui fera mon deſtin & celuy d’Angelique, Mais ie l’y veux ſaruir & de tout mon pouuoirs Dans vn moment d’icy ie la viendray reuoir;	Je prends grand intérêt l' y le publique, Qui fera mon destin et celui d'Angélique, Mais de touy mon paruir et de tout mon pouvoirs Dans un moment d'ici nous la viendrai revoir;
De ce qui s’eſt paſſé ie dois luy rendre conte:	De ce qui s'est passé après dois Seigneur rendre conte:
Pour adoucir vn peu l’ennuy qui me ſurmonte, Va voir cette Princeſſe, & feins chet Alidor, Que tu viens dans ces lieux de la part de Medor, Qu’il atrlue demain, pour prendre ſa deffenſe:	Pour adoucir un peu l'ennui qui me surmonte, Va voir cette Princesse, et feins chet Alidor, Que tu viens dans ces lieux de la part de Médor, Qu'il atrue demain, pour prendre sa défense:
Partant de mon amonr, vante luy ma conſtance;	Partant de mon amonr, vante luy ma constance;
Elle eſt dans ce Pilais, & ces objet charmant Prés celuy de la Reyne a ſon appartement:	Elle est dans ce Pilais, et ces objet charmant Près celui de la Reine à son appartement:
A ſon diuin éclat tu la pourras connoiſtre;	À son divin éclat tu la pourras connaître;
Car elle brille aſſez;	Car elle brille assez;
mais, ie la voy paroiſtre, Tu peux l’entretenir auec liberté;	mais, Seigneur la vois paraître, Tu peux l'entretenir avec liberté;
A Dieu, ie l’apperçoy qui vient de ce coſté, Elle ſort à propos de cecte Gallerie.	À Dieu, Seigneur l'aperçois qui vient de ce côté, Elle sort à propos de cecte Gallerie.
SCENE II.	SCÈNE II.
ANGELIQVE, ALIDOR.	ANGELIQUE, ALIDOR.
ANGELIQVE.	ANGELIQUE.
Ve i'entretieus long-temps ma douce réuerie!	Ve j'entretieus longtemps ma douce réuerie!
Et qu’on a de plaiſr, alors qu’on reue ainſi!	Et qu'on a de plaisr, alors qu'on réve ainsi!
Mais il faut l’interrompre, & quelqu’vn vient icy;	Mais il faut l'interrompre, et quelqu'vn vient ici;
Ie rougis ſans ſojet, qui peut lire en mon ame?	Je rougis sans soujet, qui peut lire en mon âme?
Voullez-vous me parler?	Voullez-vous me parler?
22 l nMaMe Ie viens exprés.	22 l nMaMe Je viens exprès.
Madame;	Madame;
De la part de Medor, pour auoi cet hohneur.	De la part de Médor, pour avoi cet hoheur.
O juſte Ciel!	Ô juste Ciel!
ANGELIQVE.	ANGELIQUE.
ALIDOR.	ÀLIDOR.
Son tein a changé de couleur.	Son tein a changé de couleur.
ANGELIQVE.	ANGELIQUE.
De la part de Medor qu’anex-tous à me dire?	De la part de Médor qu'anex-tous à me dire?
H.	H.
Iij	Jij
ALIDOR.	ÀLIDOR.
Ce Prince glorieux qui vit ſous voſtre empire, Et ne reconnoiſt point d’autres felicitez, Que celles d’adorer vos diuines beautez, Vient des riues d’Afrique aux riues de la Seyne, Pour combattre pour vous, & couronner ſa peine;	Ce Prince glorieux qui vit sous votre empire, Et ne reconnaît point d'autres félicités, Que celles d'adorer vos divines beautés, Vient des rives d'Afrique aux rives de la Seyne, Pour combattre pour vous, et couronner sa peine;
de prean duelamaun ausceemomneul .	de préan duelamaun ausceemomneul .
Si vous n’auez fait choix d'vn autre defenſeur.	Si vous n'avez fait choix d'un autre défenseur.
ANGELIQVE.	ANGELIQUE.
Ie ne ſuis point changcante, & i’ay toute l’eſtime, Que m’oblige d’auoir ce Peince magnanime.	Je ne suis point changcante, et j'ai toute l'estime, Que m'oblige d'avoir ce Peince magnanime.
En quel endroit eſt-il?	En quel endroit est-il?
ALIDOR.	ÀLIDOR.
Madame, il n’eſt pas loin, Et d’eſtre auprés de vous il prend aſſez de ſoin;	Madame, il n'est pas loin, Et d'être auprès de vous il prend assez de soin;
Il ſe rendra ſans doute auec diligence.	Il se rendra sans doute auec diligence.
ANGELIQVE.	ANGELIQUE.
Ah, i’ay de le reuoir beaucoup d’impztience:	Ah, j'ai de le revoir beaucoup d'impztience:
Mais comme il a le cœur & genereux d grand r eeru duaniion ls lupeibe Manr Et quil vangea la mort de mon auguſte Pere, A quoy s’eſt occupé vne ame li guerriere, Qu i fait depuis vn an ce courageux Heros ?	Mais comme il a le cœur et généreux d grand r erv duaniion l upéibe Manr Et quil vengea la mort de mon auguste Père, À quoi s'est occupé une âme li verrière, Qu i fait depuis un an ce courageux Héros ?
ALIDOR.	ÀLIDOR.
Ce Prince qui vous aime auoit peu de repos;	Ce Prince qui vous aime avait peu de repos;
Mais lors qu’il vous parloit ſa flame eſtoit contante:	Mais lors qu'il vous parlait sa flamme était contante:
ANGELIQVE.	ANGELIQUE.
Pouuoit-il me parler, puiſque i'eſtois abſente.	Pouvait-il me parler, puisque j'étais absente.
ALIDOR.	ÀLIDOR.
Ah, Madame, l'amour eſt bien ingenieuxs Les montagnes, les mers, la diſtance des lieux, Qui vous ont ſepatez, ny l’immortelle haine Qu’ont pour les Sarraſins les peuples de la Scyne, Ne I'ont pouit empeſché de vous voit chaque iout, De vous repreſenter l’excés de ſon amour, ut vous monder ies coups dont ion auie eſt bleſſée.	Ah, Madame, l'amour est bien ingénieuxs Les montagnes, les mers, la distance des lieux, Qui vous ont sepattez, ni l'immortelle haine Qu'ont pour les Sarrasins les peuples de la Scyne, Ne J'ont pouit empêché de vous voit chaque jout, De vous représenter l'excès de son amour, ut vous monder jes coups dont ion avie est blessée.
ANGELIQVE.	ANGELIQUE.
Medor me voyoit donc des yeux de la penſée;	Médor me voyait donc des yeux de la pensée;
Pouuoit-il autrement auoir mon entretien	Pouvait-il autrement avoir mon entretien
ALIDOR.	ÀLIDOR.
Toute choſe eſt poſſible alors qu'on aime bien	Toute chose est possible alors qu'on aime bien
ANGELIQVE.	ANGELIQUE.
Ie ſuis fort obligée à ſa grande conſtance, Aux ſoins qu’il me rendoit iuſques dans mon abſence s.	Je suis fort obligée à sa grande constance, Aux soins qu'il me rendait jusques dans mon absence s.
Cette vertu parfaite eſt rare dans ce temps, Où meſme en ſa preſence on fait des inconſtans:	Cette vertu parfaite est rare dans ce temps, Où même en sa présence on fait des inconstants:
Mais l’illuſtre Arimant, cet amy ſi fidelle?	Mais l'illustre Arimant, cet ami si fidèle?
Sçait-il ſon arriuée?	Sait-il son arrivée?
ALIDOR.	ÀLIDOR.
Il ſçait cette nouuelle;	Il naît cette nouvelle;
Mon ordre eſtoit d’aller d’abord chez Arimant, C’eſt luy qui m’aconduit en voſtre appartement.	Mon ordre était d'aller d'abord chez Arimant, C'est deux qui m'aconduit en votre appartement.
ANGELIQVE.	ANGELIQUE.
Droncancnmodoelommoinen atreme.	Droncancnmodoelommoinen me.
ALIDOR.	ÀLIDOR.
Genc ion pius grand ij, dent vmaude laj-meſmes Mais ie dois retourner au deuant de Medor.	Gension pius grand ij, dent vaude lajmes Mais ie dois retourner au devant de Médor.
ANGELIQVE.	ANGELIQUE.
Partez-vous ſur le champ.	Partez-vous sur le champ.
ALIDOR.	ÀLIDOR.
Ie ne parts pas encor, Ie vais chez Arimant, qui taſche de vous plaire, Prendre l’ordre de luy de ce que ie dois faire.	Je ne parts pas encor, Je vais chez Arimant, qui tâche de vous plaire, Prendre l'ordre de lui de ce que venir dois faire.
ANGELIQVE.	ANGELIQUE.
Arant que de partit vous me viendrez reuoir.	Arant que de partit vous me viendrez revoir.
ALIDOR.	ÀLIDOR.
Ie n’y manqueray pas, & ſçay trop mon deuoir.	Je n'y manquerai pas, et sais trop mon devoir.
SCENE III.	SCÈNE III.
ANGELIQVE ſiule.	ANGELIQUE siule.
Inſte Ciel!	Inste Ciel!
que i'ay de graces à te rendre O Du bon-heur qui m’arriue, & que ie viens d’apprendre!	que j'ai de grâces à te rendre Ô Du bonheur qui m'arrive, et que ie viens d'apprendre!
I’ay de ſçauoir encore vn deſit nompareil, Ce qu’on a reſolu dans le dernier Conſeil.	J'ai de savoir encore un des nompareil, Ce qu'on a résolu dans le dernier Conseil.
Mon ſort eſt dans les mains du diuin Charlemagne, Ce Roy que la Sageile en tous lieux accompagne Doit faire en ma faueur briller ſon cquité:	Mon sort est dans les mains du divin Charlemagne, Ce Roi que la Sage en tous lieux accompagne Doit faire en ma faveur briller son cquité:
De crainte toutesfois mon cœur eſt agité, Ie me vois dependante, & deurois eſtre Reyne;	De crainte toutefois mon cœur est agité, Je me vois dépendante, et devrais être Reine;
Mais Arimant paroiſt pour me tirer de prine.	Mais Arimant paraît pour me tirer de prine.
A vo ANGELIQVE, ARIMANT.	À vo ANGELIQUE, ARIMANT.
ANGELIOE.	ANGELIOE.
T bien, dans le Conſeil qu’a reſolu le Roy?	T bien, dans le Conseil qu'a résolu le Roi?
A RIMANT La Cour n’eſt rien qu’intrigue & chacun penſe à ſoy:	À RIMANT La Cour n'est rien qu'intrigue et chacun pense à soi:
Aymon, de qui le ſang eſt glucé dans les veines, Et qui pour voitre ſexe a de ſecrettes haines, Vouloit vous empeſcher de paroiſtre aux Tournois, De peur que vos attraits nous impoſent des Loix:	Aimon, de qui le sang est glucé dans les veines, Et qui pour voitre sexe a de secrètes haines, Voulait vous empêcher de paraître aux Tournais, De peur que vos attraits nous imposent des Lois:
Vous qui deuez vn iour, a-t’il dit à ce Prince, Fairc du Monde entier vne ſeule Prouince, Qui partagez deſia l’Empire des humains;	Vous qui devez un jour, a-t-il dit à ce Prince, Fairc du Monde entier une seule Province, Qui partagez déjà l'Empire des humains;
Pour faire reüſſir vos gloricux deſſeins;	Pour faire réussir vos gloricux desseins;
Si les Grecs ſons l’objet de ces Pompes publiques, Imitez donc les Grecs dans les jeux Olympiques, Qui par vn beau deſir de l’immortalité, Auoient pour but l'honneur, & non pas la beauté:	Si les Grecs sons l'objet de ces Pompes publiques, Imités donc les Grecs dans les jeux Olympiques, Qui par un beau désir de l'immortalité, Avaient pour but l'honneur, et non pas la beauté:
Faites que les François pleins de cœur & d’adreſſe, Combattent pour la Gloire & non pour leur Maiſtreſſe, Que tous vos Paladins parroiſſans en champ clos, Au lieu d’Amans, Seigneur, faſſent voir des Heros.	Faites que les Français pleins de cœur et d'adresse, Combattent pour la Gloire et non pour leur Maîtresse, Que tous vos Paladins parraissants en champ clos, Au lieu d'Amands, Seigneur, fassent voir des Héros.
ANGELIQVE.	ANGELIQUE.
Aymon, qui pour mon ſexe, eut d’amoureuſes flâmes;	Aimon, qui pour mon sexe, eut d'amoureuses flammes;
A-t’it quelque ſujet pour inſulter aux Dames?	A-t-it quelque sujet pour insulter aux Dames?
ARIMANT.	ARIMANT.
C'eſt pour ſon intereſt qu’il ouure cet aduis;	C'est pour son intérêt qu'il ouvre cet avis;
Le deplorable eſtat où vous mettez ſes fils, Qui deuiennent tous quatre ennemis pour vous plaire, Met tent au deſeſpois vn ſi mal-heureux Pere.	Le déplorable état où vous mettez ses fils, Qui deviennent tous quatre ennemis pour vous plaire, Met tent au désespois un si malheureux Père.
arienemanis ede Roraud ordie du mieme amour, Il craint que ſa fureur leur ſoit funeſte vn jour.	arienemanis éde Roraud ordie du même amour, Il craint que sa fureur leur soit funeste un jour.
ANGELIQVE.	ANGELIQUE.
Mais vous, qu’auez-vous dit?	Mais vous, qu'avez-vous dit?
ARIMANT.	ARIMANT.
I'ay pris voſtre defenſe.	J'ai pris votre défense.
L'aduis d’Aymon, Scigneur, eſt, diſ-je, hors d’apparence;	L'avis d'Aimon, Scigneur, est, dis-je, hors d'apparence;
Si pour l’auguſte Irene on diſpute les prix, Ce ſcroit témoigner vn viſible meſpris, Que d’oublier ſon ſexe, & de bannit les belles D vn ſpectacle pompeux qui n’eſt fait que pout elles, Et les Grecs trouueroient ce Tournoy peu charmant, Si ce ſexe qui plaiſt n’eſtoit ſon ornement?	Si pour l'auguste Irene on dispute les prix, Ce scroit témoigner un visible mépris, Que d'oublier son sexe, et de bannit les belles DOMmes spectacle pompeux qui n'est fait que pout elles, Et les Grecs trouveraient ce Tournoi peu charmant, Si ce sexe qui plaît n'était son ornement?
Il faut qu’à la beauté la force rende hommige;	Il faut qu'à la beauté la force rende hommige;
f Car c’eſt d’elle que naiſt la grandeur du courage;	f Car c'est d'elle que naît la grandeur du courage;
Les Dames inſpirant de nobles ſentimens, Elles font dea Heros en faiſant des Amans.	Les Dames inspirant de nobles sentiments, Elles font dea Héros en faisant des Amants.
Chacun dans la campagne, ardent, pleide vaillance, Dans le quartier d’huer atter:	Chacun dans la campagne, ardent, pleide vaillance, Dans le quartier d'huer atter:
d ſa recompenſe;	d sa récompense;
Et nos fameux Guerriers veulent à leur retour Voir couronner leurs fronts par les mains de l’amoun.	Et nos fameux Guerriers veulent à leur retour Voir couronner leurs fronts par les mains de l'amoun.
Si vous pouulcz, Seigneur, compoſer vne armée, Qui ne fût que d’Amans des belles animée, Vous pourriez ſans pareil voir cent climats diuers, Et vous ſcriez bien-toſt Maiſtre de l'Vniuers, Voità ce que i’ay dit pour l’intereſt des Dames, Dont l'empire s’eſtend ſar les plus belles ames;	Si vous pouulciez, Seigneur, composer une armée, Qui ne fût que d'Amant des belles animée, Vous pourriez sans pareil voir cent climats divers, Et vous scriez bientôt Maître de l'Univers, Voità ce que j'ai dit pour l'intérêt des Dames, Dont l'empire s'étend sar les plus belles âmes;
li:	li:
ce Prince galand qui uous donne des Loix, ne iuiuy lhouconten qui dort paane aua Pinuçois.	ce Prince galant qui -vous donne des Lois, ne juivi lhouconten qui dort paye ava Pinuçois.
ANGELIQVB Cet équitable Roy me rendra t’il juſtice?	ANGELIQUB Cet équitable Roi me rendra t'il justice?
ARLMANT.	ARLMANT.
Il vat que des demæn l'on entre dans la Lice,.	Il vat que des demæn l'on entre dans la Lice,.
Que tou;	Que tou;
les Cheualiers de differents climats Teſmoignens leur valeur dans ces nobles combats;	les Chevaliers de différents climats Témoignens leur valeur dans ces nobles combats;
Que chacun à l’enuie faſſe voir ſon adreſle A deſſendre l’honneur de ſa belle Maiſtreſſe;	Que chacun à l'envie fasse voir son adresle A dessendre l'honneur de sa belle Maîtresse;
Gu’aux braues Sarrazins, bien que ſes Ennemis, Ainſi qu’à ſes ſuiets.	Gu'aux braves Sarrasins, bien que ses Ennemis, Ainsi qu'à ses sujets.
le combat ſoit permis;	le combat soit permis;
Qu'entin touz le;	Qu'entin touz le;
Amaris de l’illuſtre Angelique Aſſutent ſeurement à la feſte.	Amaris de l'illustre Angélique Assutent sûrement à la fête.
publique;	publique;
Il veur que vos beautez ſoient le prix du vainqueun;	Il veut que vos beautés soient le prix du vainqueun;
Mais il vous a laiſté le choix du defenſeur;	Mais il vous a laisté le choix du défendeur;
C'eſt à vous de choiſir quelque Guerrier inſigne.	C'est à vous de choisir quelque Guerrier insigne.
ANG-ELIQVE.	ANG-ELIQUE.
C’eff mon hiberateur que i'en-croy le plos digne:	C'eff mon hibérateur que j'en-crois le plos digne:
Et quui m’a garanty du monſtre furieux, Fourroit bien aux.	Et quui m'a garanti du monstre furieux, Fourrait bien aux.
Tournois eſtre victorieux:	Tournais être victorieux:
Lregne daus mon cour;	Lregne daus mon cour;
ita ſcul eette gloire, Tout autre vainement obtiendroit la victoire:	ita scul cette gloire, Tout autre vainement obtiendrait la victoire:
F'ay bien oſé tenir ce diſcours deuant vous;	S'ai bien osé tenir ce discours devant vous;
vous eite loit any.	vous éite loit ani.
ARIMANT.	ARIMANT.
Ie n’en ſuis point jaloux, Vous connoiſſez trop bien la grandeur de mon zele, Tay du reſpect pour voux, & ie luy ſuis fidele;	Je n'en suis point jaloux, Vous connaissez trop bien la grandeur de mon zèle, Tais du respect pour voux, et de lui suis fidèle;
En Eſpagne il me dit ſes glorieux trauaux ;	En Espagne il me dit ses glorieux travaux ;
Lors qu’on me fit Captif aux champs de Ronceuaux, le iscus tous les ſecrets de ce Mnar amabie, Et d’eſtre auprés de vous ie luy ſuis redeuable.	Lors qu'on me fit Captif aux champs de Ronceuaux, le iscus tous les secrets de ce Mnar amie, Et d'être auprès de vous ie lui suis redeuable.
ANGELIQVE.	ANGELIQUE.
Vous ſçauez qu’vn des ſiens eſt venu de ſa part;	Vous savez qu'un des siens est venu de sa part;
Mais i'apprchende, helas!	Mais j'apprchende, hélas!
qu’il n’arriue trop tard:	qu'il n'arrive trop tard:
ARIMANT.	ARIMANT.
Medor a tant d’amour qu'il tiendra ſã promeſſe;	Medor a tant d'amour qu'il tiendra sans promesse;
Sil arrfuc trop tard, adorable Princeſſe, Pour montrer mes reſpects, ie vous iure aujour d'huy, Que ie prendray ta place, & combattray pour luys	Sil arrêts trop tard, adorable Princesse, Pour montrer mes respects, Seigneur vous jure aujour d'hui, Que ie prendrai ta place, et combattrai pour mours
ACTE II.	ACTE II.
SCENE PREMIERE.	SCÈNE PREMIÈRE.
ANGELIQVE, MELINDE.	ANGELIQUE, MELINDE.
ANGELIQVE.	ANGELIQUE.
VAND tu me voſs languir ſur cette eſtrange riue.	VAND tu me voss languir sur cette étrange rive.
Ne t’en eſtonne pas, ie ſuis comme Captiue;	Ne t'en étonne pas, je suis comme Captive;
Tu ſgait tous mes mal-heurs.	Tu sait tous mes malheurs.
MELINDE.	MELINDE.
Oüy le n’ignore pas, Que le ſort vous ranit vn Pere & vos Eſtats;	Oui le n'ignore pas, Que le sort vous ranit un Père et vos États;
Que de l’heureux ellmal, od le Joleil ſe leue.	Que de l'heureux élmal, od le Joleil se lève.
Le Deſtin vous conduli où ſa courſe s’acheue;	Le Destin vous conduli où sa course s'achève;
Que pour fuir le courroux d’vn laſche vſurpateur, Roland fut voſtre Guide & voſtre Protecteur:	Que pour fuir le courroux d'un lâche usurpateur, Roland fut votre Guide et votre Protecteur:
nauvcuceeſcou aqvoejeieqavuselde Ce Cheualier Erranl, Fautmy du repos, Pour vous en garantir ſuruint fort à propos, Et vous ſit dans ces lieux trouuer vn ſeur azyle.	nauvcucezécou aqvoejeieqavuselde Ce Chalier Eranl, Fautmi du repos, Pour vous en garantir survint fort à propos, Et vous sit dans ces lieux trouver un sûr azyle.
ANGELIQVE.	ANGELIQUE.
Iaurois dans ma diſgrace eu l’ame aſſez tranquile, Si mon peu de beruté dans cet heureux ſelour, N'eut troublé mon repos & toute cette Cour, Voulant de mes Amans cmpeſcher la pourſuitte, A changer de climat ie me trouuiy reduite:	Jaurais dans ma disgrâce eu l'âme assez tranquille, Si mon peu de beruté dans cet heureux sel, N'eut troublé mon repos et toute cette Cour, Voulant de mes Amants cmpêcher la poursuite, A changer de climat endre me trouvi réduite:
Ie voulus me ſauuer chez les peuples voilins, Mais Charles me reprit au camp des Sartaſins, Où l'amour conſpicont auec la fortune, Ie vis encore d’Amans vne foule iuiportune:	Je voulus me sauver chez les peuples voiins, Mais Charles me reprit au camp des Sartins, Où l'amour conspicont avec la fortune, Je vis encore d'Amands une foule juiportune:
Et Gradaſſe, Roger, Petragus, Agramant, Roul me pateeuter, mlc comtortue ieur tousment;	Et Gradasse, Roger, Pétragus, Agramant, Roul me pateinter, ml comtortue jeur tousment;
Le Deſtin tous les jours renouuelle ma peine.	Le Destin tous les jours renouvelle ma peine.
MELINDE.	MELINDE.
Le Ciel montre pour vous plus d’amour que de haine:	Le Ciel montre pour vous plus d'amour que de haine:
Puiſque lors qu’il vous oſte vn thrône floriilant, A vos rares beautez il en fait oifrir cent:	Puisque lors qu'il vous ôte un trône floriant, À vos rares beautés il en fait oifrir cent:
Les Heros de l’Afrique, & les Rois de l’Aſie, Sont pour vous poſſedet remplic de jalouie:	Les Héros de l'Afrique, et les Rois de l'Asie, Sont pour vous possédet remplic de jalouie:
Et vos charmans appas dans cete auguſte Cour Des Vainqueurs triomphans font des captif, d’amour, I es plus fiers Paladins qul par d’illuſtce iarques Ont égalé leur gloire à celle des Monarques Sont vos adorateurs & ſoſſpirent pour vous:	Et vos charmants appas dans cete auguste Cour Des Vainqueurs triomphants font des captif, d'amour, I ès plus fiers Paladins qu par 'illustce jarques Ont égalé leur gloire à celle des Monarques Sont vos adorateurs et sosspirent pour vous:
Si c’eſt là voitre ſort, vos mal-heuts ſont bien doux.	Si c'est là voitre sort, vos malheuts sont bien doux.
AROIEIQIE.	AROIEIQIE.
Mais l'amour s’eſt vangé.	Mais l'amour s'est vengé.
AELINDE.	ÀELINDE.
Helas!	Hélas!
eſt-il poſſible?	est-il possible?
ANGELIQVE.	ANGELIQUE.
Ah!	Ah!
pout eſtre Princeſſe, on n’eſt pas inſenſible.	pout être Princesse, on n'est pas insensible.
Di della d M.	Dis della d M.
Qui pourrlez-vous aymer qui fût digne de vous?	Qui pourriez-vous aimer qui fût digne de vous?
Aymeriez-vous Roland, le plus yaillant de tous?	Aimeriez-vous Roland, le plus yaillant de tous?
Ah nullement!	Ah nullement!
ANGELIQYE.	ANGELIQYE.
MELINDE.	MELINDE.
Apres ce Heros maguanime, Pour vn fils d’Aymon auriez-vous de l’eſtime, Renaul vous plaitoit-il	Après ce Héros maguanime, Pour un fils d'Aimon auriez-vous de l'estime, Renaul vous plaît-il
ANGELIQVE.	ANGELIQUE.
Renaud?	Renaud?
noit.	noit.
MELINDE.	MELINDE.
Et Roger ?	Et Roger ?
Encore moins.	Encore moins.
MCQVE.	MCUE.
MELFIVME.	MELFIVME.
Et qui donc?	Et qui donc?
ANGELLQVE.	ANGELQUE.
C’eſt l'illuſtre Eſtranger, Dont l'audaee heroïque, & l’ame genereuſe Ont garanty mes jours d’vnc Ourſe furieuſc.	C'est l'illustre Étranger, Dont l'audace héroïque, et l'âme généreuse Ont garanti mes jours d'unc Ourse furieusc.
DILOSNDD.	DILOSNDD.
Quoy?	Quoi?
l’illuſtte inconnu qui s’expoſa pour vous, Qui dans le camp l'rançois a fait tant de jaloux?	l'illuste inconnu qui s'exposa pour vous, Qui dans le camp l'rançois a fait tant de jaloux?
ANGREFQVR.	ANGREFQUR.
Oüy, l'amourcux Medor, qul ſur l'eſcorſe tendre A graué nos deux noms.	Oui, l'amourcux Médor, qul sur l'écorse tendre A gravé nos deux noms.
MELINDE Ce cœur s’eſt l’aiſſé prendre:	MELINDE Ce cœur s'est l'aissé prendre:
ANGELEQVE.	ANGELÊQUE.
Medor eſt de naiſſance & du ſang d’Agramant, De mon Liberateur.	Medor est de naissance et du sang d'Agramant, De mon Libérateur.
l’amour fit mon Amant Tu ſçais que dans ce temps, l’auguſte Charlemagne Auoit porté la guerre aux frontieres d’Eſpagne;	l'amour fit mon Amant Tu sais que dans ce temps, l'auguste Charlemagne Avait porté la guerre aux frontières d'Espagne;
Deſia Renaud, Roland, biſloient pour moy d'amour?	Déjà Renaud, Roland, bislaient pour moi d'amour?
Le Roy pour appaiſer les troubles de ſa Cour, Me mit entce les mains d’vn Chef ſur la ftontiere, Qui dans ſes pauillons me tenoit priſonnicre La Bataille ſe donne au pled des Monts affreux.	Le Roi pour apaiser les troubles de sa Cour, Me mit entée les mains d'un Chef sur la ftontière, Qui dans ses pavillons me tenait prisonnicre La Bataille se donne au pled des Monts affreux.
Où les Roys Sartazins furent Victoricux;	Où les Rois Sartazins furent Victoricux;
Et ce Chef eſtant mort dans le ſor:	Et ce Chef étant mort dans le sot:
des alarmes Ie prens pour me ſauuer vn cheual & des armes:	des alarmes Je prends pour me sauver un cheval et des armes:
Eſtant couuerte ainſi d’vn ſupeibe hamois, Ie veux me derober à la faueur du bois;	Étant couverte ainsi d'âme supeibe hamais, Je veux me dérober à la faveur du bois;
Mait trouuant à mes vœux la fortune contraire, Vne ſeconde fois ie deuins priſonniere:	Mait trouvant à mes vœux la fortune contraire, Une seconde fois ie devins prisonnière:
Medor me fit paſler dans ce funeſte iour, De la priſon de Mars en celle de l’Amour.	Medor me fit pasler dans ce funeste jour, De la prison de Mars en celle de l'Amour.
MELINDE.	MELINDE.
L'auez vouz vu depuis qu'il vous ſauua la vle?	L'avez vouz vu depuis qu'il vous sauva la veule?
Non, d deosndb	Non, d deosndb
MALIND D.	MALIND D.
Quel cruel Demon s’oppofe à voſtre enuis,	Quel cruel Démon s'oppofe à votre envis,
ANGELIQVE.	ANGELIQUE.
La grande inimitié de deux peuples voilins, Les genereux François, & les fiers Sartaains, Ces pcuples belliqueux qul ſont tolljours en guerte, Sont les plus renommea qui viuent ſir la terte, Ils font feuiſr tous deux les armes & les arts, Et vont planter par tout leurs fameux eltendars?	La grande inimitié de deux peuples voilins, Les généreux Français, et les fiers Sartaains, Ces puples belliqueux qul sont tolly en guerte, Sont les plus renommea qui vivent sir la terte, Ils font feuis tous deux les armes et les arts, Et vont planter par tout leurs fameux éltendards?
Parmy les Sartaiins Medor a pris naislance.	Parmi les Sartaiins Médor a pris naislance.
MELINDE.	MELINDE.
Vous deſeſptrez donc de le rcuoir en France?	Vous désespérez donc de le rcevoir en France?
ANGELIQVE.	ANGELIQUE.
De venir au Tournois il luy ſera peimis ?	De venir au Tournais il lui sera péimis ?
Dans les Comibats d’Amout il n’eſt plus d’Enncmie.	Dans les Comibats d'Amout il n'est plus d'Encie.
Ce cher Liberateur par vn courier Edele M’a fait en diligence auettir de ſon zele, Et pour exccater ce genereux deiſcin, Il doit en certe Cour arriuer dés demain.	Ce cher Libérateur par un courier Édele M'a fait en diligence autir de son zèle, Et pour excater ce généreux deiscin, Il doit en certe Cour arriver dès demain.
ME LINDE.	ME LYNDE.
Le reconoiſtrez vous aprés deux ans d’abſence?	Le reconoistrez -vous après deux ans d'absence?
ANGELIQVE.	ANGELIQUE.
Ah!	Ah!
ie ne penſe pas qu’il ſoit en ma puiſſance, Car le lour que du Monſtre il fut Victorieux, Medor comme vn éclair diſpanit à mes ycux:	Les ne pense pas qu'il soit en ma puissance, Car le lour que du Monstre il fut Victorieux, Médor comme un éclair dispanit à mes ycux:
Il me ſouuient pourtant qu’il eſt beau de viſage, Le i’en garde dans l’ame vne confuſe image, Arimant ſon amy, qui ſrait comme il eſt fait, Peut deuant le Tournois m'en faire le portrait, C’eſt luy depuls vn an, qui pir des ſoins fidelles Sert à noſtte commerce, & m’en dit des nouuelles.	Il me souvient pourtant qu'il est beau de visage, Le j'en garde dans l'âme une confuse image, Arimant son ami, qui srait comme il est fait, Peut devant le Tournais m'en faire le portrait, C'est ainsi dépuls un an, qui pir des soins fidèles Sert à nostte commerce, et m'en dit des nouvelles.
MELINDE.	MELINDE.
ANGELIQVE.	ANGELIQUE.
S’il a beaucoup d’amour, il a plus de reſpect;	S'il a beaucoup d'amour, il a plus de respect;
Il me rend à la Cour tous les lours quelque office, A mon bon-heur luy meſme il s’offre en ſacriñce, Il n'a pouuoir, valeur, credit, ny volonté, Que pour contribuer à ma felicité:	Il me rend à la Cour tous les lours quelque office, À mon bonheur lui reste il s'offre en sacriñce, Il n'a pouvoir, valeur, crédit, ni volonté, Que pour contribuer à ma félicité:
Mais il ſert ſon Rual auec tant de grace, Que ie crains quelque fois de l’aymer en ſa place:	Mais il sert son Rualal après tant de grâce, Que tu crains quelque fois de l'aimer en sa place:
Si ie priſe ſur tout mon genereux amant, I’eſtime auſſi beaucoup la valeur d’Arimant;	Si grande prise sur tout mon généreux amant, J'estime aussi beaucoup la valeur d'Arimant;
Cet Heros glorieux par ſes vertus guerrleres A de ce grand Eſtat reculé les froutieres:	Cet Héros glorieux par ses vertus guerrères A de ce grand État reculé les froutières:
Le Danube & le Põ par de ſanglans combats L’ont veu de Charlemagne accroiſtre les Eſtatt?	Le Danube et le Pomme par de sanglants combats L'ont vu de Charlemagne accroître les Estatt?
Il a ſçeu meriter par plus d’vne victoire, La faueur de ſon Prince, & place en ma memolre, Et ſi Medor n'eſtoit le Maiſtre de mon cœur, Arimant pourroit ſeul en eſtre le Valuqueur:	Il a che ver par plus d'une victoire, La faveur de son Prince, et place en ma mémolre, Et si Médor n'était le Maître de mon cœur, Arimant pourrait seul en chang le Valuqueur:
Il a tant de Vertus qu’il a plus d’vne Amante, Iſabelle, Marphiſe, auec Bradamante Connoiſſans le grand foin qu’il prend de me ſenur;	Il a tant de Vertus qu'il a plus d'une Amante, Isabelle, Marphise, avec Bradamante Connaissants le grand foin qu'il prend de me senur;
Pal vnemiciaoux vemen me le raur, De leur propre merite elles ſont enchantées, En raillant chez la Reyne;	Pal vnemiciaoux vemen me le raur, De leur propre mérite elles sont enchantées, En raillant chez la Reine;
elles ſe ſont vantées, Qu’il m’abandonneroit pour viure ſous leurs loix, Et prendroit leur party dans les fameux Tournois.	elles se sont vantées, Qu'il m'abandonnerait pour vivre sous leurs lois, Et prendrait leur parti dans les fameux Tournois.
MELINDE.	MELINDE.
Il faut le conſeruer, puiſqu’il vous eſt vtile, En faucur de Medor.	Il faut le conserver, puisqu'il vous est utile, En faucur de Médor.
ANGRLIQVE.	ANGRLIQUE.
Il me ſera facile:	Il me sera facile:
Mais le les apperçois qui vlennent dans ces lieux:	Mais le les aperçois qui vlennent dans ces lieux:
Il faut diſſimulct, pour les abuſer mieux.	Il faut dissimulct, pour les abuser mieux.
SCENE II.	SCÈNE II.
ANGELIQVE, MELINDE, BRADAMANTE, MARPHISE, ISABELLE.	ANGELIQUE, MELINDE, BRADAMANTE, MARPHISE, ISABELLE.
MARPHISE.	MARPHISE.
Ous venons declder noſtre illuſtre querelle,  Arimant vient auſli qui ſuuoit Iſabelle.	Ous venons décléder notre illustre querelle, Arimant vient ausli qui suait Isabelle.
ANGELIQVE.	ANGELIQUE.
Quoy?	Quoi?
ſeule contre trois vous diſpuier vn cœur?	seule contre trois vous dispuyer un cœur?
ſianda iuecomber dais ce conbat à nomncur.	sianda juecomber dais ce conbat à nomncur.
BRADAMANTE.	BRADAMANTE.
De toutes les beautez ſi vous eſtes l'élite, Nous voulons par le nombre égaler le merke.	De toutes les beautés si vous êtes l'élite, Nous voulons par le nombre égaler le merke.
ANGELIQVE.	ANGELIQUE.
Mais chacune de vous en fait voir pluſque moy, A l'heureux Arlmant vous donnerez la loy, Auce tande cou aſe e dntde iauome Chacune de vous trols eſt ſeurc d’eſtre aymée.	Mais chacune de vous en fait voir plusque moi, A l'heureux Arlant vous donnerez la loi, Auce tande cou se eût dntde jauome Chacune de vous trols est seurc d'être aimée.
ISABELLE.	ISABELLE.
Quand l’amour veut d’vn cœur eſtre vlctorieux, La force doit ceder à la douecur des yeux.	Quand l'amour veut d'amour cœur être vlctorieux, La force doit céder à la douecur des yeux.
ANGELIQVE.	ANGELIQUE.
Ie vous cede en douceur, & me crois moins vaillante Que ces fieres beautez, Marphlſe & Bradamante	Je vous cède en douceur, et me crois moins vaillante Que ces fières beautés, Marphlse et Bradamante
BRADAMANTE.	BRADAMANTE.
vouiecaſe couage lucelreau.	vouiecase couage lucelreau.
ANGELIQVE.	ANGELIQUE.
Vous voulez me donner beaucoup de vanite.	Vous voulez me donner beaucoup de vanité.
MARPHISE.	MARPHISE.
Nous ſçuuons à quel polnct Arimant vous reſpecte.	Nous suivons à quel polnct Arimant vous respecte.
ANGELIQVE.	ANGELIQUE.
Ie l’apperçoy qui vient, pour n’eſtre pas ſuſpecte, Ie vous laiſſe auoc luy, vous pourcez l’eſprouuer, Ie dépeche vn Courler, & viens vous retrouuer.	Je l'aperçois qui vient, pour n'être pas suspecte, Je vous laisse avoc lui, vous pourcez l'éprouver, Je dépeche un Courler, et viens vous retrouver.
SCENE III.	SCÈNE III.
ISABELLE, MARTHISE, BRADAMANTE, ARIMANT.	ISABELLE, MARTHISE, BRADAMANTE, ARIMANT.
ISABELLE.	ISABELLE.
Ourquoy paroiſſez vous l'air ſi melancholi que, Eſt-ce de ne voir pas en ce lieux Angellquer Elle viendra bien-toſt, vous luy pourrez parler, Tandis ces deux beautez vous pourront conſoler i Vous deuca eſtimer Marpliſe d Bradamame dou ſeuilnes velas	Ourquoy paraissez -vous l'air si mélancoli que, Est-ce de ne voir pas en ce lieux Angelquer Elle viendra bientôt, vous lui pourrez parler, Tandis ces deux beautés vous pourront consoler y Vous deva estimer Marplise d' Bradamame dou iles vêlas
ARIMANT.	ARIMANT.
L'vne & l'autre eſt eharmante.	L'une et l'autre est eharmante.
Ie ſçay que tout le monde admlre leurs appas:	Je sais que tout le monde admlre leurs appas:
Mais l’aymable Iſabelle auſſi n’en marque pas,	Mais l'aimable Isabelle aussi n'en marque pas,
BRADAMANTE.	BRADAMANTE.
Parlez-vous tout de bon?	Parlez-vous tout de bon?
AREMANT.	AREMANT.
Oüy, ie vous rends luſtice.	Oui, Seigneur vous rends lustice.
MARPHISE.	MARPHISE.
Arimant prend plai'ir à reudre vn bon office, Arimant au Conſcil nous a donne la voix.	Arimant prend plai'ir à revdre un bon office, Arimant au Conscil nous a donne la voix.
ISABELLE.	ISABELLE.
Pesl:	Pêl:
s Cheualiers il eſt le plus courtois:	 Cheualiers il est le plus courtois:
Parler bien de mon ſexe eit ſon noble exercice.	Parler bien de mon sexe eit son noble exercice.
1a aa ld dl aso Vous voulez me flattet.	1a a léd dl aso Vous voulez me flattet.
MARTRTSE.	MARTRTSE.
Nous vous rendous Iuſtlee.	Nous vous rendous Justlée.
2 ARIMANT.	2 ARIMANT.
BRADAMANTE.	BRADAMANTE.
1tdι tαυοrιι oη la doit demander,	1tdix tirer oη la doit demander,
ARTMANT.	ARTMANT.
C’eſt à moy d’obeïr, à vous de commandec.	C'est à moi d'obéir, à vous de commandec.
FRADAMANTE.	FRADAMANTE.
Mais nous ne voulons pas qu'Arimant nous refuſe.	Mais nous ne voulons pas qu'Arimant nous refuse.
Cclles de noſtre rang ne ſouffrent point d’excuſe.	Cclles de notre rang ne souffrent point d'excuse.
Parlez, ARIMANT.	Parlez, ARIMANT.
MARPHISEOans les Toumois qu’on vient de publier, Nous voulons vous choilit pour noitre Cheualier:	MARPHISEOants les Toumais qu'on vient de publier, Nous voulons vous choilit pour naître Chévalier:
Comme vous aucz l’ame & genereuſe & belle, Nous voulons que vous ſeul preniez noſtre querelle.	Comme vous aucz l'âme et généreuse et belle, Nous voulons que vous seul preniez notre querelle.
ARIMANT.	ARIMANT.
De cet excez d’honneur ie dois eſtre confus,	De cet excès d'honneur était dois être confus,
PSNARELE.	PSNARELE.
Ah!	Ah!
ne pretendex pas nous payer d'vn tefus, Ny par vn faux reſpect penſer d’en eſtre quite?	ne prétendex pas nous payer d'un tefus, Ni par un faux respect penser d'en être quite?
Angelique auec nous diſpute du merite, Nous voulons l’emporter ſur elle iuſtement.	Angélique avec nous dispute du mérite, Nous voulons l'emporter sur elle justement.
BRADAMANTE.	BRADAMANTE.
Nous ſçauons qu'Angellque a quelque attuit chirmants Mais nous ſçauons auſſi qu’elle eſt ingrate & vaine, Qu'on pecd à la ſcruir & ſon temps & ſa peine:	Nous savons qu'Angellque a quelque attuit chirmants Mais nous savons aussi qu'elle est ingrate et vaine, Qu'on pecd à la scruir et son temps et sa peine:
Pour vous oiter l’eſpoir, le bruit s’eſpand encot Qu’elle s’eſt declarée en faucur de Medor.	Pour vous oiter l'espoir, le bruit s'épand encot Qu'elle s'est déclarée en faucur de Médor.
Comme elle vient de loin cette raine Eitrangere Dit qu’elle eſt Souueraine, & peut-eſtre eſt hergere?	Comme elle vient de loin cette raine Éitrangère Dit qu'elle est Souveraine, et peut-être est hergère?
Elle court l’Vnluers pour donner de l’amour Et voudroit nous brauer iuſques dans cette Cour:	Elle court l'Unuers pour donner de l'amour Et voudrait nous braver jusques dans cette Cour:
2eus paſulcatale seemoluear avaspance, Nous voulons qu’vn Prançois prenne noſtre defenſe.	2eus pasulcatale seemoluear avaspance, Nous voulons qu'un Prançois prenne notre défense.
ARIMANT.	ARIMANT.
Mals vn ſeul Cheualier n'en peut defendre trois, Et-fait iniure à deux en ne faiſant qu’vn chois.	Mals un seul Chevalier n'en peut défendre trois, Et-fait injure à deux en ne faisant qu'un chois.
ISABELLE.	ISABELLE.
Nous ne reſſemblons pas à ces beautez cruelles, De qui l’inluſte orgueil veut que l’on n’ayme qu’elles, Et qui pour contenter leurs foles vanlteVoudroient volr dans leurs fers tous les cœurs arreſtez vou, pouuso ſato tt cuoii vortee ſncuie, Sans cauſer entre nous aucune jaloufic.	Nous ne ressemblons pas à ces beautés cruelles, De qui l'ingluste orgueil veut que l'on n'aime qu'elles, Et qui pour contenter leurs soles vanlteVoudroient volr dans leurs fers tous les cœurs arrêtés vou, pouléso satoût cuoi vortee ie, Sans causer entre nous aucune jalouffic.
DRADAMANTE.	DRADAMANTE.
Offrez vous à Marphiſe elle a beaucoup d’attraits.	Offrez -vous à Marphise elle a beaucoup d'attraits.
ARIMANT.	ARIMANT.
Mais Renaud mon amy le trouueroit mauuals.	Mais Renaud mon ami le trouverait mauvals.
MARPHISE.	MARPHISE.
Et bieitexpuquen touseituueut d’Iſabelle.	Et bieitexpuquen touseitueut d'Isabelle.
ARIMANT.	ARIMANT.
Muis Ectoin Telt.	Muis Ectoin Telt.
audt, quiioupite pour enos	audt, quiioupite pour enos
LSABELLE.	LSABELLE.
A Bradamante donc il faut vous engager.	À Bradamante donc il faut vous engager.
ARIMANT.	ARIMANT.
Helas!	Hélas!
le ſuis encor des amis de Roger.	le suis encor des amis de Roger.
MARRHISE.	MARRHISE.
Tous trols ſont vos amis, ô Dicu, l’eſtrange choſc!	Tous trols sont vos amis, ô Dicu, l'étrange chos!
ARIMANT.	ARIMANT.
L’aaulie par milneur a de bead cnoix soppoſe.	L'aaulie par milneur a de bead cnoix soppose.
BRADAMANTE.	BRADAMANTE.
Le plaiſant procedé que celuy d’Arimant.	Le plaisant procédé que celui d'Arimant.
MARPHISE.	MARPHISE.
Il eſt ſeul à la Cour d’vn pareil ſentiment.	Il est seul à la Cour d'un pareil sentiment.
Car tous les Courtiſans qui ſont pleins de finelles, Souuent niont point d’amis, mais ont pluiicus malſtreſſes:	Car tous les Courtisans qui sont pleins de finelles, Souvent niont point d'amis, mais ont pluius malstresses:
Mais luy, dont la Iroideur rend les ſens endormis:	Mais quelque, dont la Iroideur rend les sens endormis:
N’a pas vne maiſtreſle, & n’a que des amis.	N'a pas une maîtresle, et n'a que des amis.
ISABELLE.	ISABELLE.
ouit quueſmouigeupey comuoue top belle.	ouit quuémouigeupei comvoue top belle.
ARTMANT.	ARTMANT.
hucc toulę la Cous i'’ay da ſeipcet pous elle.	hucc toula la Cous j'ai da seipet pous elle.
BRADAMANTE.	BRADAMANTE.
Ce n’eſt, parlant ainli, s’expliquer qu’A demy.	Ce n'est, parlant ainli, s'expliquer qu'A demi.
MARFHISE.	MARFHISE.
Vous verrez que Medor eſt auſſi ſon amy.	Vous verrez que Médor est aussi son ami.
32 33.	32 33.
4.	4.
8e de Il n’en faut point douter.	8e de Il n'en faut point douter.
ASADDEES.	ASADES.
Mais Angelique l’ayme.	Mais Angélique l'aime.
ARIMANT.	ARIMANT.
I’en ſuls auſſi content que ſi c’eſtoit moy meſme.	J'en suls aussi content que si c'était moi -même.
BRADAMANTE.	BRADAMANTE.
elt aucaalel eou ao duiasaraauetotel Que de ſe croire heureux lors que ſon Riul l’eſt.	>t aucaalel élou a duiasaraauetotel Que de se croire heureux lors que son Riul l'est.
ARIMANT.	ARIMANT.
Le feu n’eſt pas moins grand, lors qu’il eſt inuitible, Et pour eſtre diſcret, on n’eſt pas inſentible,	Le feu n'est pas moins grand, lors qu'il est invitible, Et pour être discret, on n'est pas insentible,
MARPHISE.	MARPHISE.
Mais lors qu’une maiſtreile à de charmans appes, On taſche de luy plaire, on ne la cede pis.	Mais lors qu'une maîtreile à de charmants appes, On tâche de lui plaire, on ne la cède pis.
SCENE IV.	SCÈNE IV.
ALCANDRE, ARIMANT, ISABELLE, MARTIIISE, DRADAMANTE,	ÀLCANDRE, ARIMANT, ISABELLE, MARTIISE, DRADAMANTE,
AECANDRE.	AECANDRE.
ERoy veut vous parler pour choſe d’importance.	ERois veut vous parler pour chose d'importance.
ARIMANT.	ARIMANT.
Ie m’en vais le irouuer avec diligence.	Je m'en vais le irouver avec diligence.
a o Aa ludana do Adieu diſcret amant, dont les feux ſont ſectets, Quelqu’autre Choualler prendra nos intereſts.	à ô Aa ludana do Adieu discret amant, dont les feux sont sectets, Quelqu'autre Choualler prendra nos intérêts.
ARIMANT.	ARIMANT.
Vous n’en manquerez pas, mais c’eſt trop, ce me ſemble, Pour vn ſeul Cheualier que trois Dames enſemble;	Vous n'en manquerez pas, mais c'est trop, ce me semble, Pour un seul Chevalier que trois Dames ensemble;
elle ſeerassdome Piauſſton uneut.	elle seerassdome Piauston uneut.
MARPHISE.	MARPHISE.
Nous ne faiſions pas vn diſcours ſerieux:	Nous ne faisions pas un discours sérieux:
Nous voulions nous tailler.	Nous voulions nous tailler.
ARTMANT à part Que cette heureux meſſage D'in S grand embarras à propos me degigel	ARTMANT à part Que cette heureux message D'in S grand embarras à propos me dégel
SCENEV.	SCENEU.
SCENE V.	SCÈNE V.
ANGELIQVE, BRADAMANTE, MARPHISE, ISABELLE.	ANGELIQUE, BRADAMANTE, MARPHISE, ISABELLE.
BRADAMANTE.	BRADAMANTE.
Non, il fait le cruel,	Non, il fait le cruel,
ANGELIQVE.	ANGELIQUE.
ſta fit.	sita fit.
Arimant a grand tort.	Arimant a grand tort.
Peut eſtre qu’à ſes yeux vous ſerſez plus aymable:	Peut être qu'à ses yeux vous sersez plus aimable:
Pour rendre cet amant à vos yeux fauorable Vous pouuez l’en prier.	Pour rendre cet amant à vos yeux favorable Vous pouvez l'en prier.
ANGELIQVE.	ANGELIQUE.
Moy, prier Arimant, Ie ſçay la bien-ſeance, & j’agis autrement.	Moi, prier Arimant, Je sais la bienséance, et j'agis autrement.
ISABRLLE.	ISABRLLE.
Vous-voulez donc laiſſer la diſpute imparfaite.	Vous-voulez donc laisser la dispute imparfaite.
ANGELIQVE.	ANGELIQUE.
Quand ie fais mon deuoir, ic ſuis fort ſatisfaite?	Quand ici fais mon devoir, ic suis fort satisfaite?
Ie croy qu’il vaut bien mieux eſtre ſans Cheulier, Que d’eſtre l’âchement reduite à ſuplier.	Je crois qu'il vaut bien mieux mieux sans Cheulier, Que d'être l'âchement réduite à suplier.
Si malgté la pudeur dans le ſiecle où nous ſommes Quelque Dame s'oublie & fait la cour aux hommes.	Si malgté la pudeur dans le siècle où nous sommes Quelque Dame s'oublie et fait la cour aux hommes.
Ce honteux procedé qui ne peut s’excuſer, Eſt nuiſible à mon ſexe & le fait mépriſer, Il faut vn noble orgueil, vne vertu ſeuere, C’eſt la mon ſentiment.	Ce honteux procédé qui ne peut s'excuser, Est nuisible à mon sexe et le fait mépriser, Il faut un noble orgueil, une vertu sévère, C'est la mon sentiment.
BRADAMANTE.	BRADAMANTE.
Qui ditotne, dit fiete	Qui ditotne, dit fiète
ANGELIQVE.	ANGELIQUE.
A la lile ꝗ vn Roy on dbit que que relpect.	À la lile ô un Roi on dit que que relpect.
MARPHISE.	MARPHISE.
A qui veut plaire à tout, cout doit eſtre ſuſpec	À qui veut plaire à tout, coût doit être suspec
ANGELIQVE.	ANGELIQUE.
Pour vous qui poſſedez des qulitez diuines, Et que la valeur met au rang des heroïnes, Vous pouuez bien parler aux hommes librement, Et ne rougitez pas pour vn mot ſeulement;	Pour vous qui possédez des qulités divines, Et que la valeur met au rang des héroïnes, Vous pouvez bien parler aux hommes librement, Et ne rougitez pas pour un mot seulement;
Vous aymez les perils, & n’eſtes point timides.	Vous aimez les périls, et n'êtes point timides.
MARPHISE, Vos yeux ſont plus à craindre, & ſont plus homicides,	MARPHISE, Vos yeux sont plus à craindre, et sont plus homicides,
BRADAMANTE.	BRADAMANTE.
La guerre qui pour nous à de charmans appas, Rend Teiprit moins galit, lesteints moins dellcatsi.	La guerre qui pour nous à de charmant appas, Rend Téiprit moins galit, lesteints moins dellcatsi.
Dans vn meſtier ſi dur nous trouions des delices;	Dans un métier si dur nous trouions des délices;
Mais pour vous, vous aymez de plus doux exerciecs.	Mais pour vous, vous aimez de plus doux exerciecs.
.	.
1 12	1 12
ANGELIQVE.	ANGELIQUE.
22 2.	22 2.
Gen.	Gen.
Ce meurtreuue vl aurrclais Paraiſtre dans la lice en de fameux Tournois.	Ce meurtreue veul aurclais Paraître dans la lice en de fameux Tournois.
MARPITIJE.	MARPITIJE.
Dans ces combats galans vous faiſiez des merueilles.	Dans ces combats galants vous faisiez des merveilles.
ANGELIVL.	ANGELIVL.
Ie diſputois les prix auce mes pareilles:	Je disputais les prix auce mes pareilles:
BRADAMANTE.	BRADAMANTE.
Vous faiſiez admirer voſtre rare valeur.	Vous faisiez admirer votre rare valeur.
ANGELIQVE.	ANGELIQUE.
Oüy.	Oui.
Je la faiſois voir ſans bleſſer nion honneurt Mais pour faire du bruit chez les races futures, - En Cheualiers errans chercher des auantures, Ainſi qu’aſſes ſouuent vous faites toutes deux, Ie toiie ce deſſein vn peu itop hazardeux:	Je la faisais voir sans blesser nion honneurt Mais pour faire du bruit chez les races futures, - En Cheualiers errans chercher des auantures, Ainsi asses souuent vous faites toutes deux, Ie toiie ce dessein peu itop hazardeux:
Eſtre vaillante ainſi, c’eſt eſtre temeraire, Car on peut éprouer la fortune contraire;	Être vaillante ainsi, c'est être téméraire, Car on peut éprouer la fortune contraire;
L'on peur eſtre vainciie;	L'on peur être vainciie;
encor qu’on ait du cœur;	encor qu'on ait du cœur;
Se voir à la mercy d’vn indiſcret vainqueur, Reduite en ſon pouuoir, qul ſçait ce qui ſe paſe Mais de s’en euquerir on a nauuaite grace.	Se voir à la merci d'Hommes indiscret vainqueur, Réduite en son pouvoir, qul sait ce qui se pase Mais de s'en euquérir on a nauvaite grâce.
BRADAMANTE.	BRADAMANTE.
Contre vn pareil malheur, le remede eſt fort pront, Qui m’eſpriſe la mort ne craint pas vn atfront.	Contre un pareil malheur, le remède est fort prompt, Qui m'éprise la mort ne craint pas un atfront.
ISABELLE.	ISABELLE.
Angelique qui preſche icy la bien-ſeance, Fut ercante elle melme auant que d’eſtre en France, Elle court tout le monde, & ſe croit tout permit.	Angélique qui prêche ici la bienséance, Fut ercante elle melme avant que d'être en France, Elle court tout le monde, et se croit tout permit.
MARPHISE.	MARPHISE.
Elle a beaucoup d’amans, & n’a point d’ennemis.	Elle a beaucoup d'amants, et n'a point d'ennemis.
Roland qui l’eſcorta d’vn des bouts de la tetre, Durant tout le chemin ne luy fit point la guerre;	Roland qui l'escorta d'un des bouts de la tetre, Durant tout le chemin neeste fit point la guerre;
Hs ont bica traucre des forcits Ians telmoins;	Hs ont bica traucre des forcits Ians telmoins;
Ce Cheualier courtols pour elle eut de grands ſoins, L’ou ſçait qu’il l’ajmoit fort, l’on ignore le reſte.	Ce Chevalier courtols pour elle eut de grands soins, Lou ait qu'il l'ajmait fort, l'on ignore le reste.
ANGELIQVE.	ANGELIQUE.
Lors que Roland ſe plaint, qu’il murmure, qu’il peſte, Que ſouuent de fureur il paroiit embraté, Il fait voir à quel point il fut fauoriſé:	Lors que Roland se plaint, qu'il murmure, qu'il peste, Que souvent de fureur il paroyit embraté, Il fait voir à quel point il fut favorisé:
Pour vous, voſtre vertu vliblemient eclate, Lors que vous ſoupçonnez qu’on ne peut eſtre ingrate, Et ſi l’occaſion rend heureux nos amans, Vous découurez par là quels ſont vos ſertimens.	Pour vous, vôtre vertu vliblemient eclate, Lors que vous soupçonnez on ne peut être ingrate, Et si occasion rend Pour vous amans, Vous découurez ver tu sont vos sertimens.
BRABAMANTE.	BRABAMANTE.
Nous n’auons point d’amans nous les laitſons aux belles, Qu lont de vonte numeur, & gardent tout pour eucs;	Nous n'avons point d'amants nous les laitsons aux belles, Qu lont de vonte numeur, et gardent tout pour eucs;
Car dans toutes les Cours vous en auez aſlẽs:	Car dans toutes les Cours vous en avez aslends:
Tous nos fiers Paladins par vos yeux ſont bledez;	Tous nos fiers Paladins par vos yeux sont bledés;
La France, l’Angleterre & l’Eſpagne, & l’Afrique, Fourniſſent des amans à la belle Angelique.	La France, l'Angleterre et l'Espagne, et l'Afrique, Fournissent des amants à la belle Angélique.
ISABELLE.	ISABELLE.
Ah ne vous montrez pas de ti grande amitie!	Ah ne vous montrez pas de ty grande amitié!
L'aiſlez nous en au moins queiques vns par pitlś.	L'ailé nous en au moins queiques uns par pitlum.
B ij	B ij
ANGELIQVE.	ANGELIQUE.
Pour rendre à l'aduenir voſtre haine adoucie, le vous les laiile tout, & ie les liçentie	Pour rendre à l'avenir votre haine adoucie, le vous les laiile tout, et apprendre les liçentie
MARPHISE.	MARPHISE.
Vous nous le pomettez, mais vous n'en ferez rient	Vous nous le pomettez, mais vous n'en ferez rient
DNAEAEEAHIPI N'oubliez pas Medor.	DNAEAEEAHIPI N'oubliez pas Médor.
ANGELIQVE.	ANGELIQUE.
Ie m’en ſouuiendray bien.	Je m'en souviendrai bien.
SCENE VI.	SCÈNE VI.
TSABELLE, MARTHISE BRADAMANTE.	TSABELLE, MARTHISE BRADAMANTE.
ISABELLE.	ISABELLE.
ETTE ſuperbe humeur n’eut jamais ſon égale.	ETTTE superbe humeur n'eût jamais son gale.
MARPHISE.	MARPHISE.
Cilaeune de heur den taut ien cette rimles Lors qu’au froid Arimant nous auons fait la cour, Nous penſions à la gloire, & n’on pas à l’amour;	Cilaeune de heur den taut yen cette rimles Lors qu'au froid Arimant nous avons fait la cour, Nous pensions à la gloire, et n'on pas à l'amour;
Et quiconque, apres tout, aura l’ame heroïque, Prendra nos intereſts contre ceux d’Angelique,	Et quiconque, après tout, aura l'âme héroïque, Prendra nos intérêts contre ceux d'Angélique,
BRADAMANTE.	BRADAMANTE.
Ne nous abuſons pas par des diſcours flateurs.	Ne nous abusons pas par des discours flatteurs.
Sa beauté nous rauit tous nos admirateurs:	Sa beauté nous ravit tous nos admirateurs:
Zerbin pour la ſeruir peut laiſſer Iſabelle, Ręnaud auſſi l’adore & vous quitte pour elle;	Zerbin pour la servir peut laisser Isabelle, Rinaud aussi l'adore et vous quitte pour elle;
Ie n’en ſuis pas exempte, elle m’oſte Roger, Enfin elle triomphe.	Je n'en suis pas exempte, elle m'ôte Roger, Enfin elle triomphe.
ISABELLE.	ISABELLE.
Il faut nous en vanger.	Il faut nous en venger.
BRADAMANTE.	BRADAMANTE.
Par qu'elle inuention?	Par qu'elle invention?
MARPHISE.	MARPHISE.
On en peut trouuer mille, Et j'en imaglne vne, & fort ſeure, & facile:	On en peut trouver mille, Et j'en imaglne une, et fort sûre, et facile:
Faiſons courit le bruit que Medor eſt icy, Afin de la combler de hontt.	Faisons courit le bruit que Médor est ici, Afin de la combler de hontt.
& de ſoucy:	et de souci:
Elle croira qu’il fait iniure à ſon merite, S'il eſt dans cette Cour ſans luy rendre viſite r Et ne pouuant ſouffrir cet indigne meſpris, Dimour cois dep nuouoreroneles elprits;	Elle croira qu'il fait injure à son mérite, S'il est dans cette Cour sans lui reste visite r Et ne pouvant souffrir cet indigne mépris, Dimour cois dép ouoreroneles elprits;
Par vn trait ſi ſubtil Angelique abuſée serun a dans la Cour de rable & dè riſée.	Par un trait si subtil Angélique abusée sérun a dans la Cour de rable et dète risée.
ISABELLE.	ISABELLE.
La choſe eſt bien penſée, il faut l’executer.	La chose est bien pensée, il faut l'exécuter.
MARPHISE.	MARPHISE.
Il faut pour reüſlir ne rien précipiter	Il faut pour reüslir ne rien précipiter
B iij	 Bijà
ACTEIII.	ACTEIII.
SCENE PREMIERE.	SCÈNE PREMIÈRE.
ROLAND, RENAVD, ROGER, ARIMANT.	ROLAND, RENAUD, ROGER, ARIMANT.
RENAVD.	RENAUD.
RIMANT eſt-il bien dans l'eſprit d’Angellque?	RIMANT est-il bien dans l'esprit d'Angelque?
ARIMANT.	ARIMANT.
Pourquoy iur ce ſujet faut-il que ie m’explique?	Pourquoi jur ce sujet faut-il que Seigneur m'explique?
ROLAND.	ROLAND.
Parce qu’ales amis on parle franchement, Eſtre diſcret n’eſt pas la vertu d’vn amant:	Parce qu'ales amis on parle franchement, Être discret n'est pas la vertu d'un amant:
Les Gens reſpectueux ne ſont plus à la mode, Et dans ce ſiecle heureux l’amour deuient commode.	Les Gens respectueux ne sont plus à la mode, Et dans ce siècle heureux l'amour devient commode.
IIMINT.	IIMINT.
Le parfait art d’aymer n’eſt pas fait pour Roland, Il eſt plus grand guerrier quIn’a l’eſprit galand.	Le parfait art d'aimer n'est pas fait pour Roland, Il est plus grand guerrier quIn'a l'esprit galant.
ROLAND.	ROLAND.
Et le braue Renaud ſçait-il bien comme on ayme?	Et le brave Renaud sais-il bien comme on aime?
ARIMANT.	ARIMANT.
I eſt de voſtre humcur.	I est de votre humcur.
ROLANE.	ROLANE.
Et Roger?	Et Roger?
ARIMANT.	ARIMANT.
Tout de meſme;	Tout de même;
Du Dieu qui fait aymer qui veut ſuiure les pas, Ifaut qu’il ſoit diſctet, ou ne senmenle pas.	Du Dieu qui fait aimer qui veut suivre les pas, Ifaut qu'il soit disctet, ou ne senmenle pas.
ROGER.	ROGER.
Eſtre dans vne Cour où l'on voit cent coquettes, On ſe rit d’vn amant qui s’arreſte aux fleurettes;	Être dans une Cour où l'on voit cent coquettes, On se rit d'un amant qui s'arrête aux fleurettes;
O cit iuon peuu cipii de ne rien demander A celles dont l’humeur nous veut tout accorder.	Ô cit yvon peuv cipi de ne rien demander A celles dont l'humeur nous veut tout accorder.
ARIMANT.	ARIMANT.
Tout paroiſt vicieux, lors qu’à la Cour de France On ne veut eſtre inſtruit que par la mediſance;	Tout paraît vicieux, lors qu'à la Cour de France On ne veut être instruit que par la médisance;
Telle qu’on croit coquette eſt ſ.	Telle qu'on croit coquette est s.
ge fort ſouuent, Et qui croit tout auoir, n’en a rien que du vent.	ge fort souvent, Et qui croit tout avoir, n'en a rien que du vent.
ROGER.	ROGER.
Et telle qu'on croit prude & d’vne humeur ſeuere.	Et telle qu'on croit prude et d'une humeur sévère.
Teſte à teſte par fois fait voir tout le contraire;	Tête à tête par fois fait voir tout le contraire;
Toutés les Dames ont le meſme ſentiment, Mais leur humcur diuerſe apit diferemment:	Toutez les Dames ont le même sentiment, Mais leur humcur diverse apit diferemment:
Dans ce ſiecle agreable on voit peu de cruelles, Et nos meilleurs amis eu ſçauent des nouuelles.	Dans ce siècle agréable on voit peu de cruelles, Et nos meilleurs amis eu bravent des nouvelles.
ARIMANT.	ARIMANT.
Chacim ſe peut vanter d’eſtre heureux en amour, Il eſt des eſprits vains vn graud nombre à la Court L’vn met ſon char la nuit prés du logis des belles, Pour nous perſuader qu’il la paiſe auec elles;	Chacim se peut vanter d'être heureux en amour, Il est des esprits vains un graud nombre à la Court L' met son char la nuit prés du logis des belles, Pour nous persuader qu'il la paise avec elles;
L’autre en ſort le matin en habit déguifé Pour faire ſoupçonner qu’il eſt fauoriſé, Mais tous ces grand vanteurs, gens à bonne fortune, Amir qu’EndimnoniontTamou 2 la Lunc, Ils ſont iuſtement la terreur des maris, On ſçait bien en quels lieux ils ſont les fauoris.	L'autre en sort le matin en habit déguisé Pour faire soupçonner qu'il est favorisé, Mais tous ces grand vanteurs, gens à bonne fortune, Amir qu'EndimnoniontTamou 2 la Lunc, Ils sont justement la terreur des maris, On sait bien en quels lieux ils sont les favoris.
ROLAND.	ROLAND.
Pour qui fait Arimant ces plaiſantes peintures?	Pour qui fait Arimant ces plaisantes peintures?
ARIMANT.	ARIMANT.
Pour ceux qui font en lair de belles auantures,	Pour ceux qui font en lair de belles aventures,
RENAVD.	RENAUD.
Ces timides amans qui font les doucereux, Ne le vantent de rien n’eſtant jamaii heurcux.	Ces timides amants qui font les doucereux, Ne le vantent de rien n'étant jamaii heurcux.
ROGER.	ROGER.
Ie ne vois que deux biens aux beautez qu’on admire t L’vn de s’en faire aymer, & l’autre de le dire.	Je ne vois que deux biens aux beautés qu'on admire t 'un de s'en faire aimer, et l'autre de le dire.
ARIMANT.	ARIMANT.
Vn pareil procedé me ſemble dangereux, Loin de cauſer deux biens il fait deux mal-heureux, Lois que d'vne raucur vn indiſcret ſe vante, Se perd il pas luy mefme en perdant ſon amante?	Un pareil procédé me semble dangereux, Loin de causer deux biens il fait deux malheureux, Lois que d'une ravcur un indiscret se vante, Se perd il pas lui -même en perdant son amante?
ROGER, Qui vante leurs faueurs, c’eſt qu’il en fait eſtat.	ROGER, Qui vante leurs faveurs, c'est qu'il en fait état.
ARIMANT.	ARIMANT.
Celuy qui les publie eſt pire qu’vn ingrat, On deuroit épargner les Dames dauantage, Et ne les pas aymer pour leur faire vn outrage:	Celui qui les publie est pire qu'un ingrat, On devrait épargner les Dames davantage, Et ne les pas aimer pour leur faire un outrage:
Qui fait ainſi l’amour eſt iuſtement blîmé Et ſe rend à iamais indigne d’eſtre aymé.	Qui fait ainsi l'amour est justement blîmé Et se rend à jamais indigne d'être aimé.
ROLAND.	ROLAND.
Il faut vaincre leut gloire, & les rendre faciles.	Il faut vaincre lut gloire, et les rendre faciles.
ARIMANT.	ARIMANT.
L'on ne rtend pas les cœurs, comme l’on prend les villes.	L'on ne rétend pas les cœurs, comme l'on prend les villes.
ROGER.	ROGER.
L'amant & le ſoldat ne ſont point differens, L'amour ainſi que Mars fait voir des conquerans, Ec comme on ne vortpuocepuoceuajMſbles, Les plus fieres beautez deuiennent ſociables, Il faut les radoucir & les accouſtumer A ſouffrir qu’on les ayme, & meſme à nous aymet;	L'amant et le soldat ne sont point différents, L'amour ainsi que Mars fait voir des conquérants, Ec our on ne vortpuocepuoceuajMsbles, Les plus fières beauté deuiennent sociables, Il faut les radoucir et les accoutumer A souffrir qu'on les aime, et même à nous aimet;
Il faut tout entreprendre, enfin l’on s’authoriſe.	Il faut tout entreprendre, enfin l'on s'autorise.
ARIMANT.	ARIMANT.
C’eſt ainſi qu’on agit dans vne ville priſe, Mais où regne la paix, dans vne auguſte Cour, C’eſt ſe faire haïr, de faire ainſi l’amour.	C'est ainsi qu'on agit dans une ville prise, Mais où règne la paix, dans une auguste Cour, C'est se faire haïr, de faire ainsi l'amour.
ROLAND.	ROLAND.
L’on pourroir rencontrer quelque humeur peu docile, Mais ſi Ton eh faſche vne on fait plailir à mille.	L'on pourroir rencontrer quelque humeur peu docile, Mais si Ton eh fâche une on fait plailir à mille.
ARIMANT.	ARIMANT.
Pour ce que l’on mépriſe on n’a point de deſir, Qui bannit le teſpect, il bannit le plaiſir.	Pour ce que l'on méprise on n'a point de désir, Qui bannit le tespect, il bannit le plaisir.
BGE RI.	BGE RI.
Pour nous la plus facde a le ſecret de plaire.	Pour nous la plus facde a le secret de plaire.
ARIMANT.	ARIMANT.
Tout trois par voſtre exemple enſeignez le coutraire, La diuinc Angelique auec ſes froids mépris:	Tout trois par votre exemple enseignez le coutraire, La divinc Angélique avec ses froids mépris:
D'vne amour violente embraſe vos eſprits, Quand Renaud l’eſprouuoit vn peu plus fauorable, Cette amante à ſes yeux n'auoit rien d’admirable, Auprés de cette belle il languiſſoit d’ennuy;	D'une amour violente embrase vos esprits, Quand Renaud l'éprouvait un peu plus favorable, Cette amante à ses yeux n'avait rien d'admirable, Auprès de cette belle il languissait d'ennui;
Et l'amoureux Roland qui l’adorc auiourd’huy, De l'Inde iuſqu’icy fut pour elle inſenſible, Lors qu'elle le dédaigne, il tente l’impoſſible:	Et l'amoureux Roland qui l'adorc aujourd'hui, De l'Inde jusqu'ici fut pour elle insensible, Lors qu'elle le dédaigne, il tente l'impossible:
Et l’inconſtant Roger qui la ſert à ſon tour, Malgré tous ſes meſpris luy fait voir ſon amour, Et pour gagner le cœur de cette fiere amante, Reguge laconquene, d quitte Drauamamtes	Et l'inconstant Roger qui la sert à son tour, Malgré tous ses mépris lui fait voir son amour, Et pour gagner le cœur de cette fête amante, Règuge laconquène, d quitte Drauamamtes
RENAVD.	RENAUD.
Angelique au deilus des vulgaires beautez Tient auec tous les ſens les eſprits enchantez.	Angélique au deilus des vulgaires beautés Tient auec tous les sens les esprits enchantez.
ARIMANT.	ARIMANT.
On que mmun pune umtue mmeuuto de il ayme,	On que mémun pune umtue mémeuuto de il aime,
ROLAND.	ROLAND.
Ene don queique lou porter le uiadéme, Son merite & ſon rang imprime du reſpect, Et les plus fiers amans tremblent à ſon aſpect.	Une don queique lou porter le uiadème, Son mérite et son rang imprime du respect, Et les plus fiers amants tremblent à son aspect.
ARIMANT.	ARIMANT.
Mais Roland quelque fois s’eſt emporté contr'elle.	Mais Roland quelque fois s'est emporté contr'elle.
ROLAND.	ROLAND.
Pour pouuoir adoucir cette beauté cruelle, Nous allons nous offrir de combattre aux Tournoïs:	Pour pouvoir adoucir cette beauté cruelle, Nous allons nous offrir de combattre aux Tournoïs:
Et de trois defenſeurs nous luy laiſſons le chois, Arimant dont l'amour rend ſouuent l'humeur ſombre, Ne I’ajmeroit Il point, veut il eſtré du nombre?	Et de trois défenseurs nous lui laissons le chois, Arimant dont l'amour rend souvent l'humeur sombre, Ne J'ajmerait Il point, veut il estré du nombre?
ARIMANT.	ARIMANT.
Oüy, ie l’ayme ardemment, c’eſt vous parler ſans fard;	Oui, Seigneur l'aime ardemment, c'est vous parler sans fard;
Mais ie veux m’offrir ſeul, & fais mes vœux à part.	Mais deux veux m'offrir seul, et fais mes vœux à part.
le OOn N.	le OOn N.
Le Fauory d’vn Roy merite vne Princeſſe.	Le Favori d'un Roi mérite une Princesse.
ARIMANT.	ARIMANT.
Chacun dans les Tournois feta voir ſon adreſſe:	Chacun dans les Tournois fêta voir son adresse:
Ie vais faire ma Cout, & ie reuiens icy, Pour ſçauoir qui de vous aura mieux reüily.	Je vais faire ma Cout, et Seigneur reviens ici, Pour sçauoir qui de vous aura mieux reüily.
SCENE II.	SCÈNE II.
ANGELIQVE, MELINDE, ROLAND, RENAVD, ROGER.	ANGELIQUE, MELINDE, ROLAND, RENAUD, ROGER.
RENAVD.	RENAUD.
Ngelique paroiſt auec ſa Confideme;	Nélique paraît avec sa Confide;
Allons donc nous offrir à cette illuſtre amante,	Allons donc nous offrir à cette illustre amante,
ANGELIQVE.	ANGELIQUE.
Que dit-on chez la Reyne, en venez vous tous trois?	Que dit-on chez la Reine, en venez vous tous trois?
RODAND.	RODAND.
On dit que dés demain on ouure les Tournois.	On dit que dès demain on ouvre les Tournois.
ANGELIQVE.	ANGELIQUE.
Le Roy veut que chacun paroiſſe dans la lice, Pour honnorer des Grecs l’illuſtre Imperatrice	Le Roi veut que chacun paraisse dans la lice, Pour honorer des Grecs l'illustre Impératrice
ROLAND.	ROLAND.
Vn plus puiſſant que luy nous impoſe la loy.	Un plus puissant que Seigneur nous impose la loi.
ANGELIQVE.	ANGELIQUE.
Eſt il vn ſouuerain égal à ce grand Roy?	Est il un souverain égal à ce grand Roi?
ROLAND.	ROLAND.
Vn ſuperbe Tyran que la gloire accompagne, C'eſt l’amour qui nous force à nous offrir à vous :	Un superbe Tyran que la gloire accompagne, C'est l'amour qui nous force à nous offrir à vous :
Mais voſtre illuſtre choix fara bien des ialoux:	Mais votre illustre choix fara bien des jaloux:
ANGELIQVE.	ANGELIQUE.
Ie ne viens pas icy d’vn des bouts de l’Aſie, Pour caſer du deſordre & de la ialouſie:	Je ne viens pas ici d'Hommes des bouts de l'Asie, Pour caser du désordre et de la jalousie:
Vos iniuſtes deſirs pluſtoſt que mes attraits De ces tranquiles lieux ont ſeuls troublé la pair:	Vos injustes désirs plutôt que mes attraits De ces tranquiles lieux ont seuls troublé la pair:
Quittez vos paſſions & ſoyez raiſonnables.	Quittez vos passions et soyez raisonnables.
RÓGER boumiez que ron tousmme, ou cenez deitre aimable?	RGGER boumiez que ron tousmme, ou cenez deit aimable?
Faittes que l’équité regne dans voſtre cœur, Pour vos adorateurs ayez moins de rigueur.	Faites que l'équité règne dans votre cœur, Pour vos adorateurs ayez moins de rigueur.
ANGELIQVE.	ANGELIQUE.
Outre que dans mon choix ie pourrois eſtre iniuſte, Il eſt tant de beautez dans cette Cour auguſte, Bradamante & Marphiſe ont de quoy vous charmer, Qui les ayma iadis, les doit encore aymer, Iſabelle eſt auſi de mille attraits pourucuë.	Outre que dans mon choix ie pourrais être injuste, Il est tant de beautés dans cette Cour auguste, Bradamante et Marphise ont de quoi vous charmer, Qui les aima jadis, les doit encore aimer, Isabelle est ausi de mille attraits pourvue.
RANAVD.	RANAND.
Leur charme diſparoiſt ſitoſt qu’on vous a verẽ;	Leur charme disparaît sitôt qu'on vous a vien;
D elles comme de nous vos yeux ſont les vainqueurs, Seule vous auez droit de regner ſur les cœurs.	 Des comme de nous vos yeux sont les vainqueurs, Seule vous avez droit de régner sur les cœurs.
ANGELIQVE.	ANGELIQUE.
Non, non, ie ne veux point faire tort à ces belles, Ny rendre par mon choix leurs amans imidelies:	Non, non, Madame ne veux point faire tort à ces belles, Ny rendre par mon choix leurs amants imidélies:
Vous me ferez plaiſir de ne m'en parler plus.	Vous me ferez plaisir de ne m'en parler plus.
ROLAND.	ROLAND.
Ah!	Ah!
nous connoiſſons trop d’où naiſſent vos refus, Vn plus heureux que nous cauſe cette diſprace, Et voſtre cœur pour luy n’eſt pas vn cœur de glace.	nous connaissons trop d'où naissent vos refus, Un plus heureux que nous cause cette disprâce, Et votre cœur pour lui n'est pas un cœur de glace.
ANGELIQVE.	ANGELIQUE.
Parſez pus cmement, cuimexpiiquez vou.	Parsez pus cmement, cuimexpiquez vou.
ROLAND.	ROLAND.
C’eſt de l’heureux Medor dont nous ſommes ialoux.	C'est de l'heureux Médor dont nous sommes jaloux.
ANGELIQVE.	ANGELIQUE.
Si i’ay choiſi Medor, Medor en eſtoit digne,	Si j'ai choisi Médor, Médor en était digne,
duur d d nas.	duur dur d nas.
Cette rougeur pourtant n’en eſt pas vn bon ſigne.	Cette rougeur pourtant n'en est pas un bon signe.
ANGELIQVE.	ANGELIQUE.
Ie n'ay rien fait pour liry qu’il n’aſt bien merité.	Je n'ai rien fait pour liry qu'il n'ât bien mérité.
Et la pudeur s’accorde auec l'honneſteté.	Et la pudeur s'accorde avec l'honnêteté.
RENAVD.	RENAUD.
La diuine Angelique ayme & veut eſtre aymée in Mrnonmle lans vululjamla magre seuommée, Ah, cet indigne amant peut il nous conteſter, Ce que tout l’vniuers ne nous peut diſputer?	La divine Angélique aime et veut être aimée in Mrnonmle lans vuljamla magre seuommée, Ah, cet indigne amant peut il nous contester, Ce que tout l'vniuers ne nous peut disputer?
ANGELIQVE.	ANGELIQUE.
Si i'eſtime Medor le plus digne de plaire, Par de bonnes raiſons faittes voir le contraire, Auec ſes vertus comparez vos hauts faits, Ie veux deſſus ce point vous rendre ſatisfaits;	Si j'estime Médor le plus digne de plaire, Par de bonnes raisons faites voir le contraire, Avec ses vertus comparez vos hauts faits, Je veux dessus ce point vous rendre satisfaits;
La raiſon me gouierne, & non pas le caprice, Montrez moy qu’il vous cede, & ie vous fais iuſtice:	La raison me gouierne, et non pas le caprice, Montrez moi qu'il vous cede, et et vous fais justice:
Et bien que ie ſois libre en mes affections, Ie veux ceſſer de l'eſtre à ces conditions.	Et bien que je sois libre en mes affections, Je veux cesser de l'être à ces conditions.
ROLAND.	ROLAND.
Encor qu’ilortracne citemt trnone place, A ſe loüer ſoy-meſme on n’a pas bonne grace,	Encor qu'ilortracne citemt traînone place, À se louer soi-même on n'a pas bonne grâce,
ROGER.	ROGER.
Qui vante ſes hauts faits, ſi gencroſité, Au lieu de ſa valeur fait voir ſa vanité.	Qui vante ses hauts faits, si gencrosité, Au lieu de sa valeur fait voir sa vanité.
RENAVD.	RENAUD.
Le cœur par les diſcours ne ſe fait pas connoiſtre, Qui ſe dit vercueux ceſſe à l’inſtant de l’eſtre.	Le cœur par les discours ne se fait pas connaître, Qui se dit vercueux cesse à l'instant de l'être.
ANGELIQVE.	ANGELIQUE.
Vous eſtes obliges de dire vos exploits, Puiſque c’eſt le moyen de meriter mon choix;	Vous êtes obliges de dire vos exploits, Puisque c'est le moyen de mériter mon choix;
Renaud eut commencer auec bien ſeance, Où le merite éclatte, il faut peu d'eloquence.	Renaud eut commencer avec bien séance, Où le mérite éclatte, il faut peu d'éloquence.
RENAVD.	RENAUD.
Toutes mes actions parlent aiſes pour moy, I'ay touſiours eu pour but de bien ſeruir mon Roy, Dans les plus grands perils i' ſuiuy Charlemagne, Que comme vn Dicu par tout la victoire accompagne, I’ay prodigu:	Toutes mes actions parlent aises pour moi, J'ai toujours eu pour but de bien servir mon Roi, Dans les plus grands périls j' suivi Charlemagne, Que comme un Dicu par tout la victoire accompagne, J'ai prodigu:
mon ſang pour ranger ſous ſes loix Les Saxons, les Lombards, & les ficrs Bauarois:	mon sang pour ranger sous ses lois Les Saxons, les Lombards, et les ficrs Bavarois:
Si qui ſert bien ſon Roy doit plaire à ſa maiſtreiſe, de don euia elumico emnula lMrcene.	Si qui sert bien son Roi doit plaire à sa maîtreise, de don euia elleumico emnula lMrcène.
ANGELIQVE.	ANGELIQUE.
Et le vaillant Roger?	Et le vaillant Roger?
ROGER.	ROGER.
Par mes heureux exploits Ie me ſuis fait connoiſtre ennemy des François;	Par mes heureux exploits Je me suis fait connaître ennemi des Français;
Au Camp des Sarizins l’Eſpagne m’a veu naiſtre D'vn aſſés noble ſang pour n’auoir point de maiſtre, T’ay ietuy mon pays comme tes vielix Romains, Dont le nom eſt ce lebre entre tous les humains:	Au Camp des Sarisins l'Espagne m'a vu naître D'un assez noble sang pour n'avoir point de maître, T'ai jetui mon pays comme tes viel Romains, Dont le nom est ce lébre entre tous les humains:
Si ſemuir la Patrie eſt d’vne ame heroique, I'en prens vn Dieu pour luge & I illuſtre Angelique.	Si semuir la Patrie est d'une âme héroïque, J'en prends un Dieu pour luge et I illustre Angélique.
MELINDE.	MELINDE.
C'eſt au braue Roland à parler à ſon tour.	C'est au brave Roland à parler à son tour.
ROLAND.	ROLAND.
I’ay fait pour vos beautez, que Mars cede à l’amour, I’ay par tout auec moy fait marcher la victoire, Et pour vnique obiet ie n’ay rien que la gloire, C’eit elle qui par tout m’a fait eſtre vainqueur, Elle eſt voſtre Riuale & partage mon cœur:	J'ai fait pour vos beautés, que Mars cède à l'amour, J'ai par tout avec moi fait marcher la victoire, Et pour unique objet ie ay rien que la gloire, C'eit -elle qui par tout m'a fait être vainqueur, Elle est votre Rivale et partage mon cœur:
Madame voyez donc aptés vn tel partage, Si vous pouués encor reçcuoir mon hommage.	Madame voyez donc aptez un tel partage, Si vous pouués encor recevoir mon hommage.
ANGELIQVE.	ANGELIQUE.
Ces belles actions, ces illuſtres combats, Qui vous font renommer, ne me regardent pas, Que chacun de vous trois tire ſa recompenſe De ceux qui ſont l’obiet de ſa rare vaillance, Roger de ſa Patrie, & Renand de ſon Roy, Roland aymant l’honneur n’a rien fait que pour ſoy:	Ces belles actions, ces illustres combats, Qui vous font renommer, ne me regardent pas, Que chacun de vous trois tire sa récompense De ceux qui sont l'objet de sa rare vaillance, Roger de sa Patrie, et Renand de son Roi, Roland aimant l'honneur n'a rien fait que pour soi:
Mais ſi le ſeul Medor fut vaillant pour me plaire.	Mais si le seul Médor fut vaillant pour me plaire.
C'eſt de moy ſcul auſſi qu’il attend ſon ſalaire, Et ſi quelque cquité regue lur vos elprits, Ayant tout fait pour moy, ie dois eſtre fon prix.	C'est de moi scul aussi qu'il attend son salaire, Et si quelque cité règue lur vos élprits, Ayant tout fait pour moi, je dois être son prix.
ROLAND.	ROLAND.
A toutes vos raiſons nous pourrions bien reſpondre, Par voſtre paſſion vous croyes nous confondre, Mais cette heugle ciieul qui vous trompe auiourd’huy, Nous fait voir trop d’eſtime, & trop d’amour pour luy	À toutes vos raisons nous pourrions bien répondre, Par votre passion vous croyez nous confondre, Mais cette heugle ciieul qui vous trompe aujourd'hui, Nous fait voir trop d'estime, et trop d'amour pour lui
RENAVD.	RENAUD.
Le charme des Heros, l'adorable Angelique, Aymcroit vn amant qui n’a rien d'heroique?	Le charme des Héros, l'adorable Angélique, Aymcroit un amant qui n'a rien d'héroïque?
Se citont Aimta taleux das les Coinbats, Vn ſi glorieux choix ne nous piqueroit pas;	Se citont Aimta taleux das les Coinbats, Un si glorieux choix ne nous piquerait pas;
Mais preferer Medor aux Paladins de France, C’eſt pour luy faire grace outrager la vaillance.	Mais préférer Médor aux Paladins de France, C'est pour lui faire grâce outrager la vaillance.
ROGER.	ROGER.
Medor eſt inconnu chez les Peuples voiſins, Son nom méme eſt obſcur parmy les Sarrazins.	Medor est inconnu chez les Peuples voisins, Son nom même est obscur parmi les Sarrasins.
MNOBENTVH.	MNOBENTUH.
Les Riuaux enuieux dont l’amour m’importune, Le font paſſer icy pour Soldat de fortunc, Mais ie ſçay le contraire, & cet illuſtre amant Eſt de haute maiſſance & du fang d’Agramant.	Les Rivaux envieux dont l'amour m'importune, Le font passer ici pour Soldat de fortunc, Mais apprendre sais le contraire, et cet illustre amant Est de haute maissance et du sang d'Agramant.
ROGER.	ROGER.
Qui ne fait pas paroiſtre vne valeur diuine, Et ſort du ſang des Roys dement ſon origine.	Qui ne fait pas paraître une valeur divine, Et sort du sang des Rois dément son origine.
ANGELIQVE.	ANGELIQUE.
Si vous obſerués bien & le temps & le licu, Mcdor à mon ſecours eſt venu comme vn Dieu.	Si vous observez bien et le temps et le licu, Mcdor à mon secours est venu comme un Dieu.
RENAVD.	RENAUD.
La Fortune elle ſeulle a fait ce grand ouurage, Et le moindre de nous en eut fait dauantage.	La Fortune elle seulle a fait ce grand ouvrage, Et le moindre de nous en eut fait davantage.
ANGELIQVE.	ANGELIQUE.
s'il eſt beau qu’vn amant m’ait conſerué le iour, Il a plus fait encor pour montrer ſon amour;	s'il est beau qu'un amant m'ait conservé le jour, Il a plus fait encor pour montrer son amour;
Et ſiTon connoiiloit le reſte de la vie, Ceux qui l’oſent blàmer luy porteroient enuie?	Et siTon connoiiloit le reste de la vie, Ceux qui l'osent blàmer mort porteraient envie?
ROGER.	ROGER.
C’eſt vn guerrier timide ou c’eſt vn froid amant;	C'est un guerrier timide ou c'est un froid amant;
Vn Cheualier parfait agiroit autrement;	Un Chevalier parfait agirait autrement;
Pour en pouuon enomr quelqu auuc à meilleur titre, Ne nous en croyez pas, mais preuez vn atbitte, Qui ſur nos diſferens donne ſon jugement.	Pour en pouvon enomr quelqu auuc à meilleur titre, Ne nous en croyez pas, mais prévez un atbitte, Qui sur nos disférents donne son jugement.
ANGELIQVE.	ANGELIQUE.
ly conſens volontiers, & choiſis Arimant.	li consens volontiers, et choisis Arimant.
R G niironu lununa & RogirElle nomme celuy que j’aurois pris moy-meſme.	R G ironu luna et RogirElle nomme celui que j'aurais pris moi-même.
RENAVD.	RENAUD.
Il doit hair Medor, puilqu'Angelique l’ayme.	Il doit haïr Médor, puqu'Angélique l'aime.
RÔLAND.	RÔLAND.
Et bien nous l’acceptons, pour nous mettre en repos;	Et bien nous l'acceptons, pour nous mettre en repos;
Mais ie le voy paroiſtre.	Mais ie le vois paraître.
ANGELIQVE, Il vient tout à propos.	ANGELIQUE, Il vient tout à propos.
SCENE III.	SCÈNE III.
ANGELIQVE, ARIMANT, ROLAND, RENAVD, ROGER, MELINDE.	ANGELIQUE, ARIMANT, ROLAND, RENAUD, ROGER, MELINDE.
ANGELIQVE à Arimant.	ANGELIQUE à Arimant.
JOus pouuez d’vn ſeul mot accorder nos querelles, ARIMANT.	JOus pouvez d'Hommes seul mot accorder nos querelles, ARIMANT.
adids Peur en canton Mhe ciaite nuec les belles	adids Peur en canton Mhe ciaite nuec les belles
ROLAND.	ROLAND.
i iunou ce non ta haine on tant dos differents,	y junou ce non ta haine on tant dos différents,
ARIMANT.	ARIMANT.
Si Mſadame les caule, ils doiient eſtre grands,	Si Msadame les caule, ils doiient être grands,
RENAVD.	RENAUD.
Contre ſes cruautez nous cherchons vn refuge.	Contre ses cruautés nous cherchons un refuge.
ROGER.	ROGER.
La Princeſſe & nous trois vous choiſiſſons pour Iuge,	La Princesse et nous trois vous choisissons pour Juge,
ARIMANT.	ARIMANT.
Moy ſon luge!	Moi son luge!
Ah, pluſtoſt elle ſeroit le mien.	Ah, plutôt elle serait le mien.
ANGELIQVE.	ANGELIQUE.
Voſtre ciuilité ne ſert icy de rien;	Votre civilité ne sert ici de rien;
A voſtre iugement nous voulons nous ſoumettre:	À votre jugement nous voulons nous soumettre:
D'vn eſprit ſi diſcret on ſe doit tout promeure;	D'un esprit si discret on se doit tout promeure;
Enfin nous le voulons.	Enfin nous le voulons.
AR IMANT.	AR IMANT.
Vous pouuez commander;	Vous pouvez commander;
Mais ſur quels differens peut-on vous accorder?	Mais sur quels différents peut-on vous accorder?
ROLAND.	ROLAND.
La Princeſſe, pour nous iniuſte autant que belle, Nous ſouſtient que Medor eſt luy ſeul digne d’elle, Et nous voulons tous trois auec grande équité, Luy diſputet vn cœur qu’il n’a point merité, Prenint pour nous iuger vne iuſte balance, Iuu plus parsald anant domez la prereſence.	La Princesse, pour nous injuste autant que belle, Nous soutient que Médor est autre seul digne d'elle, Et nous voulons tous trois auté grande équité, Lui disputet un cœur qu'il n'a point mérité, Prenint pour nous juger une juste balance, Ju plus parsald anant domez la preresence.
ARIMANT.	ARIMANT.
Pour pouuoir iuſtement couronner le vainqueur, Hiut duparauant auoir ſondé ſon cœur, Pour ces trois Cheualiers auez-vous de l'eſtime?	Pour pouvoir justement couronner le vainqueur, Hiut duparavant avoir sondé son cœur, Pour ces trois Chevaliers auez-vous de l'estime?
AIVOMIEAV H.	AIVOMIEAU H.
Ie croy qu’ils ont tous trois l’ame fort magnanime.	Je crois qu'ils ont tous trois l'âme fort magnanime.
ARIMANT Et pour Medor auſſi qu’elle eſtime auez-vous?	ARIMANT Et pour Médor aussi qu'elle estime avez-vous?
ANGELIOVE.	ANGELIOUE.
Qui m’a ſauué la vie eſt preferable à tous, Et ce Vainqueur m'eſt cher.	Qui m'a sauvé la vie est préférable à tous, Et ce Vainqueur m'est cher.
ARIMANT.	ARIMANT.
Auant que la Princeſſe, En faueur de Medor m'euſt fat voir ſa tendreſſe, A parler franchement i'en faiſois peu d’eſtat, Et cet amant obſcur viuoit ſans nul eſclat, Mais d’elle ſon merite emprunte tant de luſtre du'ende teus icommiins cnont rendiaide rRien ne peut l’eſgaler, & ce glorieux choix Met Medor au delus des Heros & des Rois:	Avant que la Princesse, En faveur de Médor m'eût fat voir sa tendresse, A parler franchement j'en faisais peu d'état, Et cet amant obscur vivait sans nul éclat, Mais d'elle son mérite emprunte tant de lustre du Rende teus icommiins cnont rendide rRien ne peut l'égaler, et ce glorieux choix Met Médor au deluz des Héros et des Rois:
Ie prononce pour luy, puiſque Madame l’ayme.	Je prononce pour lui, puisque Madame l'aime.
ROLAND.	ROLAND.
Quoy l'iniuſte Atimant parle contre luy-meſme.	Quoi l'injuste Atimant parle contre M-même.
RENAVD.	RENAUD.
mliaruo, nicerents ce les nensionconciek.	mliaruo, nicèrents ce les nensionconcie.
ROGHR.	ROGHR.
Hhous perd & le nunt,	Hous perd et le nunt,
ARIMANT.	ARIMANT.
Pas tant que vous penſen.	Pas tant que vous pensen.
ROLAND.	ROLAND.
Parler pour vn Riual, voſtre erreur eſt extréme.	Parler pour un Rival, votre erreur est extrême.
ARIMANT.	ARIMANT.
En parlant poor Medor, ie parle pour moy-meſme, Pronon-ant pour cel.	En parlant poor Médor, on parle pour moi-même, Pronon-tant pour cel.
ny qui regne dans ſon cæur, En melmne temps fou moy J’adoucis la ngueur.	Qui qui règne dans son cæur, En melmne temps fou moi J'adoucis la négueur.
RENAVD.	RENAUD.
Eſtant luge enure nous, & cette amante Auguſte, Chercher voſtre intereſt c’eit ſe montrer injuſte.	Étant luge enure nous, et cette amante Auguste, Chercher votre intérêt c'éit se montrer injuste.
ARIMANT.	ARIMANT.
vouuspamies monmuour, vous tçauiez mon reſped;	voupamies monmuour, vous tçauiez mon respéd;
Pourquoy m’auoir choiſi, ſi ie vous ſuis ſuſpect;	Pourquoi m'avoir choisi, si je vous suis suspect;
ANGELIOVA.	ANGELIOUA.
Pour le deſtoüer, il eſt trop raiſonnable.	Pour le destouer, il est trop raisonnable.
ROLAND.	ROLAND.
L'amour ſera mon juge, il tie prurt quitable.	L'amour sera mon juge, il tye prurt quitable.
ANGELIQVE.	ANGELIQUE.
cacuor vom ctauuton pea deuaint ion diouual	cacuor vom ctavuton pea devaint ion diouual
RENAVD.	RENAUD.
8I venost aux Toutnois ſe luy ſcrois facal.	8I venôt aux Toutnais se lui crais facal.
ARIMANT.	ARIMANT.
En quelque lieu qu’il ſoit, ie croy qu’il s’y diſpoſe.	En quelque lieu qu'il soit, je crois qu'il s'y dispose.
BeIete6e3.	BeIette6e3.
Et bien, nous l'attendons, qu’il y vienne, s’il oſe.	Et bien, nous l'attendons, qu'il y vienne, s'il ose.
Aa R PſI M.	Aa R PsI M.
I I.	I I.
Il vous rendra tous crois des demain ſacisfaits.	Il vous rendra tous crois des demain sacisfaits.
ROGER.	ROGER.
Vous nous le promettez.	Vous nous le promettez.
ARIMANT.	ARIMANT.
Oüy ie vous ſe promets,	Oui ici vous se promets,
ACTE IV.	ACTE IV.
SCENE PREMIERE.	SCÈNE PREMIÈRE.
MARPHISE, ANGELIQVE, MELINDE.	MARPHISE, ANGELIQUE, MELINDE.
Ma du Rl llToUs E vous viens anoncer vne heurcuſe nouuelle Qui doit faire ma pair,	Ma du Rl llToUs ES vous viens anoncer une heurcuse nouvelle Qui doit faire ma pair,
Nous n'auons pas querelle	Nous n'avons pas querelle
MARPHISE.	MARPHISE.
Nous auons eu pourtant de petits dilſerends.	Nous avons eu pourtant de petits dilsérends.
ANGELIQVE.	ANGELIQUE.
Vous en parlea fort blen, car ils n’eſtoient pas grands, Quelle nouuelle enfin auca-vous à me dire?	Vous en parlea fort blen, car ils n'étaient pas grands, Quelle nouvelle enfin auca-vous à me dire?
MARPHISE.	MARPHISE.
Vnc qui peût cmauier toue cœur qui tompne.	Unc qui put clavier toue cœur qui tompne.
ANGELIQVE.	ANGELIQUE.
le ne ſoupirc pas.	le ne soupirc pas.
MARPHISE.	MARPHISE.
Quelque-fois	Quelquefois
ANGELIQVE.	ANGELIQUE.
Raremeut.	Raremut.
MARPHISE.	MARPHISE.
Ie ne vlens pas icy vous parler d’Arimant;	Je ne vlends pas ici vous parler d'Arimant;
nay iſmoreMVSELIQVE Mrais d’on qu'vous mpne mſeumment plus tendre.	né ismoreMUSELIQUE Mraîne d'on qu'vous me nseument plus tendre.
ANGELIQVE.	ANGELIQUE.
Ce diſcours eſt ooſcur, ſe ne puis vous entendre:	Ce discours est ooscur, se ne puis vous entendre:
C’eſt ne me dire rlen.	C'est ne me dire rène.
MARPHISE.	MARPHISE.
Pour m’expliquer donc mieux?	Pour m'expliquer donc mieux?
Et pour vous dire tout, Mſedor eſt duns ces licux,	Et pour vous dire tout, Médor est duns ces licux,
Medor.	Médor.
ANGELIQVE.	ANGELIQUE.
MARPHISE.	MARPHISE.
Oüy, ce Heros de voſtre cholx ſi digne, Mais vous en rougiſſez, ce n’eſt pas mauuis ſigne Pour ce liberatcur, pour ce fidel amant Il ne vos deplaiſt pas, à parler franchement.	Oui, ce Héros de votre chols si digne, Mais vous en rougissez, ce n'est pas mauvis signe Pour ce libératcur, pour ce fidel amant Il ne vos déplaît pas, à parler franchement.
ANGELIQVE.	ANGELIQUE.
npits qu’a ma it von vemcur ul magninſme Ie ne m’en deffeuds point, i’ay pour luy de l’eſtime;	nits qu'a ma it von vécur ul magnins Je ne m'en défeuds point, j'ai pour venir de l'estime;
Maſs comment lcuiez vous qu’il eſt dan ceue Cour.	Mass comment lucuiez -vous qu'il est dan ceue Cour.
MARPHISE.	MARPHISE.
Ce bruit dans ce Palais a couru tout le jour.	Ce bruit dans ce Palais a couru tout le jour.
ANGELIQVE.	ANGELIQUE.
Ce n’eſt done rien qu'vn bruit.	Ce n'est donc rien qu'un bruit.
MARPHISE La choſe eſt fort certalne, Et I'on l’a dit tout haut au cerele chez la Reine, On dit meſme qu'il vient pour combattre pour vous;	MARPHISE La chose est fort certalne, Et J'on l'a dit tout haut au orele chez la Reine, On dit même qu'il vient pour combattre pour vous;
Cet heureux Cheualier fera bien des ialoux, S’il peut en ſa faueur decider la querelle:	Cet heureux Chalier fera bien des jaloux, S'il peut en sa faveur décider la querelle:
Ie vous anonce donc vne beureuſe nouuelle.	Je vous anonce donc une beureuse nouvelle.
ANGELIQVE Vous m’oolgez bcaucoup.	ANGELIQUE Vous m'ogez bcaucoup.
MARPHISE.	MARPHISE.
Pour le moins, ie le croy;	Pour le moins, Seigneur le crois;
Vous la ſçauez deſia, peut-eſtre, mieux que moy;	Vous la sçauez déjà, peut-être, mieux que moi;
Et m'a naiueté vous doit paroiſtre extrême Vous diſant ce qu’il faut apprendre de vous meſme.	Et m'a naiueté vous doit paraître extrême Vous disant ce qu'il faut apprendre de vous rendre.
ANGELIQVE.	ANGELIQUE.
Medor aſſûrement ne m’eſt point venu voir.	Medor assurément ne m'est point venu voir.
MARPEISE.	MARPEISE.
Il n’y manquera pas, & ſçay trop ſon deuoit:	Il n'y manquera pas, et sais trop son devait:
Si ie n’en apprens pas la premicre nouuelle, Pat ma vilite au moins, ie vous fait voir mon zele.	Si personne n'en apprends pas la premicre nouvelle, Pat ma vilite au moins, je vous fait voir mon zèle.
ANGELIQVE.	ANGELIQUE.
couune vous Mentc purſemmle avamour, Ie vous rendray bien-toit la pareille à mon toi t.	couune vous Mentc pursemle avamour, Je vous rendrai bien-toit la pareille à mon toi t.
MARPHISE.	MARPHISE.
Ie n'en ſçaurois douter, vous eſtes trop cluile;	Je n'en saurais douter, vous êtes trop cluile;
Si l’illuſtre Arimant vous deuient inutile, Et qu’il cede la place au nouueau Cheualier, Vous poutrez ayſément vous reconcilier Atule Mamuiie des aquaule naoane,	Si l'illustre Arimant vous devient inutile, Et qu'il cède la place au nouveau Chevalier, Vous poutrez aisément vous réconcilier Atule Mamuiie des aquaule naoane,
ANGELIQVE.	ANGELIQUE.
Conſeruez-le pour vous, la conqueſte en eſt belle.	Conservre-le pour vous, la conquête en est belle.
MARPHISE.	MARPHISE.
Mimmoron voydeautes poul le pouson duamera Pour moy, ic ne ſuis pas ſçauante en l’art d’aymer.	Mimmoron voydeautes poul le pouson duamera Pour moi, ic ne suis pas savante en l'art d'aimer.
nabclle paront auec Bradamante.	nabclle paront auec Bradamante.
SCLNE II.	SCLNE II.
ISABELLE, ANGELIQVE, MARPHISE, BRADAMANTE, MELINDE.	ISABELLE, ANGELIQUE, MARPHISE, BRADAMTE, MELINDE.
ISABELLE.	ISABELLE.
Ous venons prendie pat au bon-heur d’vne Amante;	Ous venons prendie pat au bonheur d'une Amante;
Car nous auons appris que Medor eſt icy.	Car nous avons appris que Médor est ici.
ANGELIQVE.	ANGELIQUE.
Vous prenez trop pour moy de peine & de ſoucy.	Vous prenez trop pour moi de peine et de souci.
BRADAMANTE.	BRADAMANTE.
S'il vient dans le Tournois pour montrer ſa vaillance, Hvient tout à propos prendre voſtre defenſe.	S'il vient dans le Tournois pour montrer sa vaillance, Hvient tout à propos prendre votre défense.
MARPHISE.	MARPHISE.
Nous faiſons toutes trois des vœux pour ce Vainqueur.	Nous faisons toutes trois des vœux pour ce Vainqueur.
ANGELIQVE.	ANGELIQUE.
I'en fait auſſi de meſme en ſecret dans mon cœur Prepscouel cuvuuuy, deuieanchetome, Prendra vos intereſts dans la feite publique.	J'en fait aussi de même en secret dans mon cœur Prépscouel cuvuuuy, deuieanchetome, Prendra vos intérêts dans la féite publique.
MARPHISE.	MARPHISE.
Zetbin pour Iſabelle aura ce noble ſoin;	Zetbin pour Isabelle aura ce noble soin;
Mais Bradamante & moy n’en auoms pas beſoin, Et nous ſçauons fort bien de l’humeur dont nous ſommes, n ſuerir de l’honneur, ſans le ſecours des homincs.	Mais Bradamante et moi n'en auoms pas besoin, Et nous savons fort bien de l'humeur dont nous sommes, n suérir de l'honneur, sans le secours des homincs.
ANGELIQVE.	ANGELIQUE.
Vous vouuez toutefois ſaire choix d’Arimant.	Vous vouez toutefois zaïre choix d'Arimant.
DAAD AM AIS I Es Ah, c’eſtoit ſeulement par diuertidement;	DAD AM AIS I Es Ah, c'était seulement par divertidement;
Nous Luſons les galans aux Princeues galantes.	Nous Lusons les galants aux Prinçues galantes.
ANGELIQVE.	ANGELIQUE.
Quand on perd ſes Amans, ont fuit les noms d’amantet,	Quand on perd ses Amants, ont fuit les noms d'amantet,
MARPHISE.	MARPHISE.
Employez l’artifice, & vos yeux ſeducteurs, Pour enchaiſner Medor, & mille adorateurs, Pour donner de l’amour, mettez tout en vſage;	Employez l'artifice, et vos yeux séducteurs, Pour enchaîner Médor, et mille adorateurs, Pour donner de l'amour, mettez tout en usage;
Nous, nous ferons briller, u vertu, le courage, Nos yeux étincellans dans l'horreur des Combats, Nous ferons aux Heros admirer nos appas, Et remportant ſur eux vne illuſtre victoire, Nous leur enſcignerons le chemin de la gloire;	Nous, nous ferons briller, eux, le courage, Nos yeux étincellans dans l'horreur des Combats, Nous ferons aux Héros admirer nos appas, Et remportant sur eux illustre victoire, Nous leur enscignerons le chemin de la gloire;
Nous nous ferons par force adorer des vainqueurs,	Nous nous ferons par force adorer des vainqueurs,
ANGELIQVE.	ANGELIQUE.
Par la force iamais on ne gagne le cœurs.	Par la force jamais on ne gagne le cœurs.
Pour donner de l’amour, verſer le ſang des hommes, C’eſt vn art fort nouueau dans le ſieclę où nous ſommes, Et vous effarouchez les plus ciuili ez.	Pour donner de l'amour, verser le sang des hommes, C'est un art fort nouveau dans le sieclę où nous sommes, Et vous effarouchez les plus civili .
FRADAMANTE.	FRADAMANTE.
Vous ſaites le contraire, & les appriuoiſcz;	Vous saites le contraire, et les appriuoiscz;
Vous ſçauez bien vſer du pouuoit de vos charmes, Pour vaincre vos amaus, vos attraits ſont vos armes, Peniant triompher d’eux ils triomphent de vous	Vous savez bien user du pouvait de vos charmes, Pour vaincre vos amaus, vos attraits sont vos armes, Péniant triompher d'eux ils triomphent de vous
ANGELIQVE.	ANGELIQUE.
Les faueuis que ie fais ne font point de ialoux.	Les faveuis que ici fais ne font point de jaloux.
d242, 33, 2.	d242, 33, 2.
or, ds.	or, ds.
A Renaud toutefois vous n'ettiez point cruelle.	À Renaud toutefois vous n'étiez point cruelle.
DRRDAMANTE.	DRDAMANTE.
Pour Roger, il vous croit auſſi douce que belle.	Pour Roger, il vous croit aussi douce que belle.
ANGELIQVE.	ANGELIQUE.
Et Renaud & Roger vous tiennent fort au œurs L’vn & l’autre pourtant eprouient ma rigueur	Et Renaud et Roger vous tiennent fort au œurs L'un et l'autre pourtant éprouient ma rigueur
de a l llalo Ds Nous pourrions nous vanter ſans faire trop les vaines, Que tous deux quelque iour rentrerunt dans nos cluiſnes,	de a l' élalo Ds Nous pourrions nous vanter sans faire trop les vaines, Que tous deux quelque jour rentrerunt dans nos cluisnes,
DIIYD IA AV EV IE.	DIIIYD IA AU EU IE.
Vous croyez qu’en vous ſcule on trouue des appas, D'autres en ont encot qui ne vous cedent pas.	Vous croyez qu'en vous scule on trouve des appas, D'autres en ont encot qui ne vous cèdent pas.
ISABELLE.	ISABELLE.
Ason, angeuque cront qu'enc eut inçomparable, Et que dans cette Cour elle eit ſçule adorable, Qu'en vettus, en naiſlance, eu rares qualitcz, Elle doit l'emporter lur toutes les beautez.	Ason, angeuque cront qu'enc eut inomparable, Et que dans cette Cour elle eit sçule adorable, Qu'en vettus, en naislance, eu rares qualcitcès, Elle doit l'emporter lur toutes les beautés.
OE.	ÔE.
Ie leur cede en merite, & non pas en naiilince, On peut garder ſon rang auec bien-ſeance.	Je leur cède en mérite, et non pas en naiilince, On peut garder son rang avec bienséance.
BRABAMANTE.	BRABAMANTE.
Mlaia Yous deucz ceacr à la ſe du Roy.	Mlaia Yous décès ceacr à la se du Roi.
ANGELIQVB.	ANGELIQUB.
Elle ne pretend pus eſtre au deſlus de moy, Elle n’herite pas du ſceptre dę ſon Pere:	Elle ne prétend pus être au délus de moi, Elle n'hérite pas du sceptre d son Père:
Le mien en portoit vn, dont ie ſuis heritiere.	Le mien en portait un, dont ici suis héritière.
ISABELLE.	ISABELLE.
A vantęr voſtre rang, vous prenez vn grand ſoin.	À vantęr votre rang, vous prenez un grand soin.
ANGELIQVE.	ANGELIQUE.
De tout ce quel’aydit, i’ay Rolnq pour temoin.	De tout ce quel'aidit, j'ai Rolnq pour témoin.
MARPHISE.	MARPHISE.
Demain ſus ce ſuict, on vous fera iuſtice:	Demain sus ce suct, on vous fera justice:
Aucc le beau Medor nous paroiſtrons en lice, Et Bradamante & moy dans ce celebre iour, Ferons tout pour la glolre, & vous tout pour l’amour.	Aucc le beau Médor nous paraîtrons en lice, Et Bradamante et moi dans ce célèbre jour, Ferons tout pour la glolère, et vous tout pour l'amour.
Adicu iuſqu’à demain.	Adicu jusqu'à demain.
ANGELIQVE, MELINDE.	ANGELIQUE, MELINDE.
ANGELIQVE.	ANGELIQUE.
CEs ſuperbes Riules Comcidm comdemoydaendisiamegess	CEs superbes Rivles Comcidm comdemoidaendisiamegess
MELINDE.	MELINDE.
Leur ialouſie eſt grande, & leur fait imenter Cent choſes chaque iour, pour vous perſecuter.	Leur jalousie est grande, et leur fait imenter Cent choses chaque jour, pour vous persécuter.
ANGELIQVE.	ANGELIQUE.
I'aurois à leur diſcours donné peu de creance, Si l’aduis de Medor eſtoit hors d’apparence:	J'aurais à leur discours donné peu de créance, Si l'avis de Médor était hors d'apparence:
Mais i'attens en ces lieux le fidel Arimant, Qui m’en pourra donner tout l’éclairciſlement, Vne autre choſe encore, & de grande importance:	Mais j'attends en ces lieux le fidel Arimant, Qui m'en pourra donner tout l'éclaircislement, Une autre chose encore, et de grande importance:
Redouble mes ſoucis & mon impatience?	Redouble mes soucis et mon impatience?
Contre l’vſurpateur qui regne en mes Eſtats Mes genereux ſuiets ont cu diuers combats;	Contre l'usurpateur qui règne en mes États Mes généreux sujets ont cv diers combats;
Tout mon peuple pour moy brûlant d’vn zele extrémei Veut reuoir ſur mon front le Royal diadéme, I'en reçois des couriers icy de temps en temps, La mon de ce Tyran rendra mes yœux contens, Orcan Orean eſt ſur les lieux, il me ſera fidele.	Tout mon peuple pour moi brûlant d'ils zèle extrêmei Veut revoir sur mon front le Royal diadème, J'en reçois des couriers ici de temps en temps, La mon de ce Tyran rendra mes yœux contents, Orancan Oréan est sur les lieux, il me sera fidèle.
Et m’en apportera la premiere nouuelle:	Et m'en apportera la première nouvelle:
Ainſi Mſelinde, ainſi la fortune & l’amour, Pour troublet mon repos, l’agitent tour à tout:	Ainsi Mselinde, ainsi la fortune et l'amour, Pour troublet mon repos, l'agitent tour à tout:
Et pour iouit du calme apres vn grand orage, I'artends que l’vn & l’autre acheue ſon ouurage.	Et pour jouit du calme après un grand orage, J'artends que l'un et l'autre achève son ouvrage.
an ela a Ds Rentrer dans vos eſtats eſt le plus important.	an elle a Ds Rentrer dans vos états est le plus important.
ANGELIQVE.	ANGELIQUE.
Mais Medor toute-fois me touche bien autant:	Mais Médor toute-fois me touche bien autant:
Il eſt plus d’vne gloire, & d'ene renommée s’il eſt beau d’eſtre Reyne, il eſt beau d’eſtre aymée Quand on eſt ſur le throſne on ſait bien des ialoux;	Il est plus d'une gloire, et d'ene renommée s'il est beau d'être Reine, il est beau d'être aimée Quand on est sur le trône on sait bien des jaloux;
Mais regner ſur vn cœur eſt vn regne blen doux.	Mais régner sur un cœur est un règne blen doux.
De tcuoir Arimant ie meurs d’impatience:	De tcuoir Arimant apprendre meurs d'impatience:
Que l’on l’aille chercher, Melinde;	Que l'on l'aille chercher, Melinde;
en diligence.	en diligence.
O Ciel!	Ô Ciel!
te l’apperçoy.	te l'aperçois.
SCENE IV.	SCÈNE IV.
ANGELIQVE, ARIMANT,	ANGELIQUE, ARIMANT,
TIrez moy de ſoncy;	TIrez -moi de sonci;
ARIMANT.	ARIMANT.
:	:
Qui vous peut auoir dit cette grande nouuelle?	Qui vous peut avoir dit cette grande nouvelle?
ANGELIQVE.	ANGELIQUE.
C'eſt Marphiſe.	C'est Marphise.
ARIMANT.	ARIMANT.
Marphiſe;	Marphise;
& comment la ſçait elle?	et comment la sait elle?
Ah, que ie ſuis ſurpris!	Ah, que Que suis surpris!
par vn zele in diſcret, Icoraodeco Mon iceret,	par un zèle in discret, Icoraodeco Mon iceret,
ANGELIQVE.	ANGELIQUE.
Que dittes vous tout bas?	Que dites -vous tout bas?
ARIMANT.	ARIMANT.
Ie ne dis rien, Madamet	Je ne dis rien, Madamet
ANGELIQVE.	ANGELIQUE.
D'où pourtoit naiſtre donc le trouble de voſtre àme?	D'où pourrait naître donc le trouble de votre âme?
rous chagez de comeur, d'od vient ce chingement.	rous chagez de comeur, d'od vient ce chingement.
Ne me déguiſce rien, mais parlez franchement.	Ne me déguisce rien, mais parlez franchement.
ARIMANT.	ARIMANT.
Ah, ſi par vn mal-heur la choſe eſt découuerte!	Ah, si par un malheur la chose est découverte!
Sçachons ſes ſentimens pour quitoi uiu peite.	Sachons ses sentiments pour quitoi uiv péite.
Oüy, le conſtant Medor brûlant pour vous d’amour prpuis paus ot m iois eut dedans cette Cour.	Oui, le constant Médor brûlant pour vous d'amour prpuis payus ot m ois eut dedans cette Cour.
ANGELIQVE.	ANGELIQUE.
Depuis plus de lix mois Medor ſeroit en France?	Depuis plus de lix mois Médor serait en France?
ARIMANT.	ARIMANT.
Mais, c’eſt ſecrettement.	Mais, c'est secrètement.
ANGELIQVE.	ANGELIQUE.
Par qu’ene iuiference, Ou par quel accident ne me vient il point voir?	Par qu'ène juiférence, Ou par quel accident ne me vient il point voir?
ARIMANT.	ARIMANT.
Il vous craint fort.	Il vous craint fort.
ANGELIQVE.	ANGELIQUE.
Craint-on de faire ſon deuoir?	Craint-on de faire son devoir?
Vn Heros, vn vainqueut, peut il eſtre timide?	Un Héros, un vainqueut, peut -il être timide?
Craindroit-il vne Amante, ayant l’amour pour guide?	Craindrait-il une Amante, ayant l'amour pour guide?
Aprés ce qu’il a fait, il doit tout eſperer;	Après ce qu'il a fait, il doit tout espérer;
Et puisque ie l’eſtime, il doit ſe r’aſſeurer.	Et puisque ici l'estime, il doit se rassurer.
ARIMANT.	ARIMANT.
Vous eſtes redoutable auec tant de charmes, Et qui ſçait bien aymer n’eſt iamais ſans alarmes;	Vous êtes redoutable avec tant de charmes, Et qui sait bien aimer n'est jamais sans alarmes;
Il craint pour ſes deffauts, lors qu’il voit vos beautez!	Il craint pour ses défauts, lors qu'il voit vos beautés!
Et doit apprehender malgré tant de bontez, Qu'vne amante qui doit porter vne Couronne, Priſe ce qu’il a fait ſans aymer ſa perſonne;	Et doit appréhender malgré tant de bontés, Qu'une amante qui doit porter une Couronne, Prise ce qu'il a fait sans aimer sa personne;
Et d’vn ſi grand amour ſon cœur eſt enflamé, Qu'il m’outroit de regret s’il n’eſtoit pas aymé;	Et d'un si grand amour son cœur est enflammé, Qu'il m'outrait de regret s'il n'était pas aimé;
vous n’auez pas ſuiet de vous mettre en colete, Puiſque par ſes reſpect;	vous n'avez pas sujet de vous mettre en colette, Puisque par ses respect;
Medor tâche à vous plaire:	Medor tâche à vous plaire:
ANGELIQVE.	ANGELIQUE.
Comment me plaira-t’il, ſi ie ne le voy paz?	Comment me plaira-t-il, si personne ne le vois pays?
Ec ti loin de mes yeux;	Éc ty loin de mes yeux;
il détourne ſes pas:	il détourne ses pas:
Où ne peut m’éblouir par vn reſpect extreme:	Où ne peut m'éblouir par un respect extrême:
Alors qu’on ayme bien, on veut voir ce qu’on aymie, Dans cette illuſtre Cour fatale aux libertez, Ou l’inconſtance regne & cent rares beautez, De leurs ſubtils appas on ne ſe peut defendre;	Alors qu'on aime bien, on veut voir ce qu'on aimie, Dans cette illustre Cour fatale aux libertés, Ou l'inconstance règne et cent rares beautés, De leurs subtils appas on ne se peut défendre;
Medor acpuis ſlx mons à peu le Iuner plendle;	Medor acpuis slx mons à peu le Junér plendle;
Et celles qui vouloient engager Arimant, Par leur nuſe ont blen pd̂ me rauir mon amant.	Et celles qui voulaient engager Arimant, Par leur nuse ont blen pendant me ravir mon amant.
ARIMANT.	ARIMANT.
Ie reſponds pour Medor ainſi que pour moy-meſme.	Je réponds pour Médor ainsi que pour moi-même.
AvoBelQvB.	AvoBelQuB.
Reſpondez pour vous ſcul.	Respondez pour vous scul.
ARIRAN T.	ARIRAN T.
Ie ſçay trop qu’il vous ayme.	Je sais trop qu'il vous aime.
ANGELIQVE.	ANGELIQUE.
Que ne me vicat il voir?	Que ne me vicat il voir?
ARIMANT.	ARIMANT.
Peut eſtre eſt-il venu, Et qu’il vous ait parlé ſans qu’il vous ſoit connu?	Peut être est-il venu, Et qu'il vous ait parlé sans qu'il vous soit connu?
Depuis cet heureux iour, qui fait toute ſa gloire, Que Medor ſur vn monſtre emporta la vietoire, Ne vous ſouuien-t’il point d’auoir veu dans ces lieux Quelqu’vn qui luy reſſemble?	Depuis cet heureux jour, qui fait toute sa gloire, Que Médor sur un monstre emporta la viétoire, Ne vous souvien-t-il point d'avoir vu dans ces lieux Quelqu'être qui tu ressemble?
ou pour m’expliquer mieux, N'en remarquez vous point les traits ſur mon viſage, Nous auons le meſme air, nous ſommes de meſme âge, C ii.	ou pour m'expliquer mieux, N'en remarquez vous point les traits sur mon visage, Nous avons le même air, nous sommes de même âge, Ç y.
ANGELIQVE.	ANGELIQUE.
Ie peuſc qu’aucc luy vous auez du rapport:	Je pusc qu'aucc lui vous avez du rapport:
Sſiis ie n’ay de Medor qu’vne contute image.	Ssiis Seigneur n'ai de Médor qu'une contute image.
ARIMANT.	ARIMANT.
Sous cette reſſemblance il vous rend ſon hommige	Sous cette ressemblance il vous rend son hommige
ANGELIQVE.	ANGELIQUE.
Dans cette occaſion qui s’aileure en autruy.	Dans cette occasion qui s'aileure en autrui.
Merite qu’vn Riual ſoit plus heureux que luy:	Mérite qu'un Rival soit plus heureux que Ne:
Si vous auez gagne le caur de Chiilemagne Vous m’eſtes chęr auiſi, helas!	Si vous avez gagne le caur de Chiilemagne Vous m'êtes chęr avisi, hélas!
ARIMANT.	ARIMANT.
Si l’Allemagne Auec l'Italie a tremblé ſous mes coups, Puy comoauu pout luy, utas Iay valucu pour vous,	Si l'Allemagne Avec l'Italie a tremblé sous mes coups, Puy comoauu pout ra, utas Jay valucu pour vous,
ANGELIQVE.	ANGELIQUE.
Vos vettus qu'elque iour ieccuront leur ſalalre,	Vos vertus qu'elleque jour iùccuront leur salalre,
ARIMANT.	ARIMANT.
Pour Medor ſculement ie m’efforce à vous plalre.	Pour Médor sculement femme m'efforce à vous plalère.
dB.	dB.
On voit peu de Riuaux & d’amis ſi parfaits,	On voit peu de Rivaux et d'amis si parfaits,
ARIMAN I.	ARIMAN I.
Contentez ſes deſirs, les miens ſont ſatis-faits.	Contentez ses désirs, les miens sont satî-faits.
ANGELIQVE.	ANGELIQUE.
Si cet Amant me fuit, comment le ſatisfaire.	Si cet Amant me fuit, comment le satisfaire.
ARIMANT Moy, qui m’oſe montrer, ſuis-ie point temeraire.	ARIMANT Moi, qui m'ose montrer, suis-je point téméraire.
Mais i’ay tant de reſpect.	Mais j'ai tant de respect.
ANGELIQVE Et voſtre procedé me plaiſt plus que le ſien:	ANGELIQUE Et votre procédé me plaît plus que le sien:
Vous auez de l’eſprit vous auęz du courage:	Vous avez de l'esprit vous avez du courage:
Mais Medor a ſur vous vn ſenſible auantage;	Mais Médor a sur vous un sensible avantage;
Al'avant ſauué la vie & tué le Tyran, Ie ne dois plus auoir vn cœur indifferent, L'honneur veut que ie l’ayme, & ce cœut qui ſouſpire, Aprés l’auoir promis, ne s’en ſça iroit dédire:	Al'avant sauvé la vie et tué le Tyran, Je ne dois plus avoir un cœur indifférent, L'honneur veut que sans l'aime, et ce cœut qui soupire, Après l'avoir promis, ne s'en sou iroit dédire:
Mais d’ailleurs Arimant eſt ſi reſpectueux, Si diſcret, ſi conſtant, que i’accuſe les Cieux, Mon eſprit en ſecret contre l’amour s’irrite, De ce qu’il a voulu ſeparer leur merite:	Mais d'ailleurs Arimant est si respectueux, Si discret, si constant, que j'accuse les Cieux, Mon esprit en secret contre l'amour s'irrite, De ce qu'il a voulu séparer leur mérite:
Pourquoy faut il qu’à l’vn le doiue la clarté, Et que l’autre m’ait pleu par ſa fidelité?	Pourquoi faut -il qu'à l'un le doive la clarté, Et que l'autre m'ait pleu par sa fidélité?
Que mon Libefateur n’eſt-il auſſi fidellel Iniurieux amour:	Que mon Libefateur n'est-il aussi fidèle Injurieux amour:
Ah, fortune cruelle!	Ah, fortune cruelle!
Que ne paroiſſiez vous à mes yeux moins charmant, Ou que Medor n’a t’il les vertus d’Arimant!	Que ne paraissiez -vous à mes yeux moins charmant, Ou que Médor n'a t'il les vertus d'Arimant!
ARIMANT.	ARIMANT.
O Ciel pourols-le auoir aſſez d’heur pour vous plaire?	Ô Ciel pourol-le avoir assez d'heur pour vous plaire?
Vous puis-je adjouſter toy, ſans eſtre temeraire?	Vous puis-je ajouter toi, sans être téméraire?
Sans auoir trop d’orgueil & trop de vanité?	Sans avoir trop d'orgueil et trop de vanité?
Pourrois-je me flatter de cette verité.	Pourrais-je me flatter de cette vérité.
ANGELIQVE.	ANGELIQUE.
Oüy, ie trouue dans vous vn chatme qui m’attire, Ie crains d’en dire trop, & n'en puis aſſez dire:	Oui, Seigneur trouve dans vous un chatme qui m'attire, Je crains d'en dire trop, et n'en puis assez dire:
Vous partagez mon cœur auec voſtre Riual, C’eſt luy ſcul qui vous nuit, liy ſeul vous eſt fatal, Aprè;	Vous partagez mon cœur avec votre Rival, C'est main scul qui vous nuit, li seul vous est fatal, Aprète;
ce qu’il a fait, le ſort veut que le l’ayme:	ce qu'il a fait, le sort veut que le l'aime:
Mais m’arrachant à vous ie m’arrache à moy-meſme, eeut iate mer ciiai ce mon cruertoufment, Que n’eſtes vous Medor!	Mais m'arrachant à vous rien m'arrache à moi-même, eut jate mer ciai ce mon cruertoufment, Que n'êtes -vous Médor!
ARILANI.	ARILANI.
Il vaut mieux qu’Arimant:	Il vaut mieux qu'Arimant:
Quoy que vous puiſſiez dire il a de la couſtance.	Quoi que vous puissiez dire il a de la coûtance.
ANGHLIQVE.	ANGHLIQUE.
Quel ſuiet luy fait donc cuiter ma preſence?	Quel sujet avait fait donc cuiter ma présence?
ARIMANT.	ARIMANT.
Medor, pour meriter place dans voſtre cœur, Ne veut deuant vos yeux paroiſtre que vainqueur?	Medor, pour mériter place dans votre cœur, Ne veut devant vos yeux paraître que vainqueur?
Aprés auoir fait choix d’vne amante ſi belle, E uj il veut dais les Toumnois le monitier digue d’elle.	Après avoir fait choix d'une amante si belle, E uj il veut dais les Toumnois le monitier digue d'elle.
ANGELIQVE.	ANGELIQUE.
Entre tous ſes Riuaux Roland eſt dangereux, Et ne poutra ſouttrir que Medor ſoit heureux?	Entre tous ses Rivaux Roland est dangereux, Et ne poutra soutir que Médor soit heureux?
Mais le voicy qui vient plein d’orgueil & d’audace, uoterogredtatteumteuiptie ntoncuur de glice, N’auroit-il point appris que Medor eſt icy?	Mais le voici qui vient plein d'orgueil et d'audace, uoterogredtatteumteuiptie ur de glice, N'aurait-il point appris que Médor est ici?
ARTMANT.	ARTMANT.
Et quand il le ſçauroit n’en ayez nul ſoucy.	Et quand il le saurait n'en ayez nul souci.
CNE IV.	CNE IV.
ROLAND, ANGELIQVE, ARIMANT,	ROLAND, ANGELIQUE, ARIMANT,
ROLAND.	ROLAND.
H vous cherche Arimant pour me tirer de pelne:	H vous cherche Arimant pour me tirer de pelne:
v’onn aunt que ſieuor ent aux iiues de seinc.	v'onn aunt que sieuor ent aux jives de seinc.
Et dans toute la Cour ce bruit eſt répandu.	Et dans toute la Cour ce bruit est répandu.
ANGELIQVE.	ANGELIQUE.
s’il rencontre Medor, helas!	s'il rencontre Médor, hélas!
tout eſt perdu	tout est perdu
ARIMANT.	ARIMANT.
Quoy qu’il puiſſe arriuer ne craignez rien, Madame,	Quo qu’il puisse arriver ne craignez rien, Madame,
ROLAND.	ROLAND.
Vous découurez d'ou maſt ie uouone de vontis aine, Le ſeul nom de Medor agite vos eſprits, Vous deuriez pour luy témoigner du meſpris, Où peut-on le trouuer, pour le couurir de honte:	Vous découvrez d'ou mât Seigneur ouvone de vontis aine, Le seul nom de Médor agite vos esprits, Vous devriez pour lui témoigner du mépris, Où peut-on le trouver, pour le couvrir de honte:
Dittes,	Dittes,
ARIMANT.	ARIMANT.
Suis-je obligé de vous en rendre conte?	Suis-je obligé de vous en rendre conte?
ROLAND.	ROLAND.
Puiſque vous le ſcruez auec tant de chaleur, Comme amy de Mcdor, pour ſauuer ſon honneur, Vous deuez l’aduertir, que dans la Cour de France, C’eſt peu d’eſtre galant, qu’il faut de la vaillance, Et qu’vn homme ſans cœur y paile mal le temps?	Puisque vous le scruez avec tant de chaleur, Comme ami de Mcédor, pour sauver son honneur, Vous devez l'avertir, que dans la Cour de France, C'est peu d'être galant, qu'il faut de la vaillance, Et qu'un homme sans cœur y paile mal le temps?
Vous luy pouuez donner ces aduis importans.	Vous avait pouvez donner ces avis importants.
ARIMANT.	ARIMANT.
Il n’en a pas beſoin, il ſçait ce qu’il doit faire, I a de Avneur ſan citee temeraire, Pour vous le témoigner, Medor vient aux Tournois.	Il n'en a pas besoin, il sait ce qu'il doit faire, I a de Alleur san citée téméraire, Pour vous le témoigner, Médor vient aux Tournais.
ROLAND.	ROLAND.
L'vniuers retentit au bruit de ſes exploits, Sa valeur eit connuë, & chicun la redoute.	L'univers retentit au bruit de ses exploits, Sa valeur eit connue, et chicun la redoute.
aMdEbNaA.	aMdEbNaA.
Aprés ce qu’il a fait, la peut on inettre en doute!	Après ce qu'il a fait, la peut on inettre en doute!
Mais vous portez enuie à mon Iiberareur.	Mais vous portez envie à mon Jibérareur.
ROLAND.	ROLAND.
Il vient dans les Tournois, pour eſtre ſpectateur, Pour voir ce qui ie paſſe, & non pas pour ſe ba:	Il vient dans les Tournois, pour être spectateur, Pour voir ce qui était passe, et non pas pour se ba:
tre.	tre.
ARIMANT.	ARIMANT.
Voſtre orgueil eſt bien grand, mais il pourroit l’abattre.	Votre orgueil est bien grand, mais il pourrait l'abattre.
ROLAND.	ROLAND.
Plcuſt au Ciel qu’il euſt falt vn ſi hardy deſlein, La peur en me voyant luy glaceroit le ſein;	Plcût au Ciel qu'il eût falt un si hardi délein, La peur en me voyant lui clacerait le sein;
Mcdor jore à la Cour vn mauuais perſonnage, Il n’oſe ſe montrer, il manque de courage,	Mcédor jore à la Cour un mauvais personnage, Il n'ose se montrer, il manque de courage,
MRIMANT.	MRIMANT.
Vous le connoiſſez mal, il a de la valeur.	Vous le connaissez mal, il a de la valeur.
ROLAND.	ROLAND.
Ie ſouſtiendray touſiours que Medor eſt ſans cœur, Iuſqu’à ce qu’Arimant m’ait fait voir le contraite.	Je soutiendrai toujours que Médor est sans cœur, Jusqu'à ce qu'Arimant m'ait fait voir le contraite.
ARIMANT.	ARIMANT.
Suiuez moy ſculement, ie vais vous ſarisfaire.	Suivez -moi sculement, je vais vous sarisfaire.
ANGELIQVE.	ANGELIQUE.
Où courez vous tous deux dans ces emportemens, Eſt-ce là le reſpect que doluent des amans?	Où courez -vous tous deux dans ces emportements, Est-ce là le respect que doluent des amants?
C iiij Apres auoir montré ſi peu de complaiſance, Vous eſtre querellez tous deux en ma preſence;	Ç iiij Après avoir montré si peu de complaisance, Vous être querellez tous deux en ma présence;
Comment oſez vous bien, pour me brauer encot, Former des attentats ſur les iours de Medor?	Comment osez -vous bien, pour me braver encot, Former des attentats sur les jours de Médor?
Le ſuperbe Roland, malgré ſa jalouſie, Deuroit aymer celuy qui m’a ſauué la vie, Eeencone d Riua ende ies cuncmi, Peut-il faire vn combat que ie n’ay pas permis?	Le superbe Roland, malgré sa jalousie, Deurait aimer celui qui m'a sauvé la vie, Eeencone d' Iua ende j' uncimi, Peut-il faire un combat que je n'ai pas permis?
ROLAND.	ROLAND.
Encor que d’vne amante vn cœur ſoit idolatre, eu lle pierepahicherdecols quoiever se baue, D’vn pareil procedé l'on riroit à la Cour, L'on conſulte ſa haine, & non pas ſon amour.	Encor que d'une amante un cœur soit idolâtre, eu lèle pièrepahicherdecols quoiever se bave, D'un pareil procédé l'on rirait à la Cour, L'on consulte sa haine, et non pas son amour.
ANGELIQVE.	ANGELIQUE.
Si vous vous querellez, pour attirer ma haine, I'ay tort de m’en meſler, & de m'en mettre en peine, Mais ſi vous vous battez pour meriter mon choix, Ie puis m’en entremettre, & vous donner dez loix, Et malgré voſtre humeur iniuſte & violente, de iģaulay conciucrr auboite d’Mte.	Si vous vous querellez, pour attirer ma haine, J'ai tort de m'en mêler, et de m'en mettre en peine, Mais si vous vous battez pour mériter mon choix, Je puis m'en entremettre, et vous donner de lois, Et malgré votre humeur injuste et violente, de iģaulay conciucr èboite d'Ute.
ROLAN Dà Arimant.	ROLAN Dà Arimant.
Sans vous laiſſer flechir, n'y l'eſcouter encor, Aprés l’auoir promis faittes moy voir Medor.	Sans vous laisser fléchir, n'y l'écouter encor, Après l'avoir promis faites -moi voir Médor.
ARIMANT.	ARIMANT.
Ie vais vous le montrer ſans tarder dauantage!	Je vais vous le montrer sans tarder davantage!
Permettez-moy d’aller où mon honneur m’engage.	Permettez-moi d'aller où mon honneur m'engage.
ANGELIQVE.	ANGELIQUE.
Ie deffens à tous deux, ſi i'ay quelque pouuoir, A l’vn de le montres, à l’autre de le voir, Sur peine d’encourir ma haine & ma diſgrace, Paittes reflexion dellus cette menace, Et rendez ſur ce point mes deſirs ſatisfaits, Où ſoyez reſolus de ne me voir jamais.	Je défens à tous deux, si j'ai quelque pouvoir, À l'vn de le montres, à l'autre de le voir, Sur peine d'encourir ma haine et ma disgrâce, Paites réflexion dellus cette menace, Et rendez sur ce point mes désirs satisfaits, Où soyez résolus de ne me voir jamais.
ROLAND.	ROLAND.
Aprés vn tel diſcours, que pretendez vous faire.	Après un tel discours, que prétendez -vous faire.
ARIMANT.	ARIMANT.
Contentés vos delirs, ſans pourtant luy déplaire.	Contentez vos délirs, sans tant Seigneur déplaire.
ROLAND.	ROLAND.
Pourrez vous ſatisfaire à tous deux à la fois.	Pourrez -vous satisfaire à tous deux à la fois.
MleiMMl.	MleiMl.
Oüy, car Medor demain doit parolſtre aux Tournoit.	Oui, car Médor demain doit paraître aux Tournait.
NOLAND.	NOLAND.
Mais, ſi de s'y montrer il n'auoit pas l'audace.	Mais, si de s'y montrer il n'avait pas l'audace.
ARTMANT.	ARTMANT.
Ie promets à Roland de combattre en ſa place.	Je promets à Roland de combattre en sa place.
ROLAND.	ROLAND.
l urichay enmqe dennencor.	 lurichai enmqe dennencor.
Pour combattre aux Tournois, Arimant ou Medore Ce noble procedé vous peut-il ſatisfaire.	Pour combattre aux Tournois, Arimant ou Médore Ce noble procédé vous peut-il satisfaire.
ANGELIQVE.	ANGELIQUE.
Oüy, ſi Roland promet de vaincre ſa colere?	Oui, si Roland et de vaincre sa colère?
Si l'on vous voit en paix ſortir tous deux d’icy.	Si l'on vous voit en paix sortir tous deux d'ici.
ROLAND.	ROLAND.
Ie tiendray ma parole.	Je tiendrai ma parole.
ARIMANT.	ARIMANT.
Et moy, la mienne auſſi.	Et moi, la mienne aussi.
e „	 e„
A V.	À V.
SCENE PREMIERE.	SCÈNE PREMIÈRE.
ANGELIQVE ſeule.	ANGELIQUE seule.
STANCES.	STANCES.
VE Ie bon-heur au monde eſt rate!	VE Je bonheur au monde est rate!
Que l’on forme de vains deſirs!	Que l'on forme de vains désirs!
Et que le Ciel pour nous auare, Vend cher la gloire & les plaiſirs!	Et que le Ciel pour nous avare, Vend cher la gloire et les plaisirs!
Entre lès paſſions dont le ſoin nous tourmente, Mais par vn diferent ſoucy, L’amour eſt la plus violente, Et la plus agrcable auſſy.	Entre lès passions dont le soin nous tourmente, Mais par un dièrent souci, L'amour est la plus violente, Et la plus agrable aussi.
Mon ſexc ſuit la bien-ſeance, Il a d’argueilleux ſentimens, Lors que l’audace, ou l’inſolence Nous fait voir d’indignes amans;	Mon sexc suit la bienséance, Il a d'argueilleux sentiments, Lors que l'audace, ou l'insolence Nous fait voir d'indignes amants;
La pudeur juſtement s’irrite, La raiſon auec eux n’eſt jamais bien d’accord, Mais alors qu’vn Amant a beancoup de metite, L’amour eſt couſiours le plus fort.	La pudeur justement s'irrite, La raison avec eux n'est jamais bien d'accord, Mais alors qu'un Amant a beancoup de métite, L'amour est coujours le plus fort.
C'eſt deſirer de nous des choſes impoſſibles, De nous faire brir ce qui nous peut charmer, Celuy qui fit nos cœurs les eut faits inſenſibles, Si c’eſtoit vn crime d’aymer.	C'est désirer de nous des choses impossibles, De nous faire brir ce qui nous peut charmer, Celui qui fit nos cœurs les eut faits insensibles, Si c'était un crime d'aimer.
Cette Sageſſe ſouueraine Veut que nos paſſions eſclatent tour à tour, Si les vices cauſent la haine, Il faut que les vertus faſſent naiſtre l’amour,	Cette Sagesse souveraine Veut que nos passions éclatent tour à tour, Si les vices causent la haine, Il faut que les vertus fassent naître l'amour,
Depuis deux ans qu’vn Prince m’ayme, Que l’illuſtre Medor eſt mon adorateur, Ce ſeroit eſtre ingrate, & me trahir moy-meſme, Que d’auoir des mieſpris pour ce liberateur:	Depuis deux ans qu'un Prince m'aime, Que l'illustre Médor est mon adorateur, Ce serait être ingrate, et me trahir moi-même, Que d'avoir des miespris pour ce libérateur:
Ie fais des ſouhaits pour ſa gloire, Sans ternir mon nom glorieux, Et ſi de ſes rinux il eſt victorieux, Il peut juſqu’à mon cœur oſtendre ſa victoire.	Je fais des souhaits pour sa gloire, Sans ternir mon nom glorieux, Et si de ses rinux il est victorieux, Il peut jusqu'à mon cœur ostendre sa victoire.
En vain.	En vain.
, mais quelqu'vn vient, il faut difiimulet Cet heroique ardeur dont ie me ſens bruſler;	, mais quelqu'un vient, il faut disfiimulet Cet héroïque ardeur dont ie me sens brûler;
1n, eir bhemode, emeimue qu'ene en murdeimce.	1n, eir bhémode, emeimue qu'ène en murdeimce.
SCENE II.	SCÈNE II.
ANGELIQVE, MELINDE,	ANGELIQUE, MELINDE,
ANGELIQVE.	ANGELIQUE.
TV vois.	TU vois.
Meli ide, enfin la fatale iournée, I Qui fait que pour ma gloirc on s’apréte au combat	Méli ide, enfin la fatale journée, I Qui fait que pour ma gloirc on s'apprête au combat
MELINDE.	MELINDE.
Cc iour de voſtre gloire augmeniera l'eſclat.	Cc our de votre gloire augmeniera l'éclat.
C vi	Ç vi
ANGELIQVE.	ANGELIQUE.
Que l’eſtit où ie ſais eſt vne peine rude!	Que l'estit où belle sais est une peine rude!
Et quand on ayme bien qu’on a d’inquietude!	Et quand on aime bien qu'on a d'inquiétude!
MELINDE.	MELINDE.
L’arriuée en ces lieux du genereux Medor Vous deuroit conſoler;	L'arrivée en ces lieux du généreux Médor Vous devrait consoler;
ſon fidel Alidor Eſt venu de ſa part vous aſſeurer encore Que ce Prince amoureux contlamment vous adore, Que malgré ſes Riuaux & vos ſoupçons ialoux, Il vient dans les Tournois vainere ou mourir pour vousr Auez vous oublié ce qu'il vient de vous dire?	son fidel Alidor Est venu de sa part vous assurer encore Que ce Prince amoureux contlamment vous adore, Que malgré ses Rivaux et vos soupçons jaloux, Il vient dans les Tournais vainere ou mourir pour vous Avez vous oublié ce qu'il vient de vous dire?
ANGELIQVE.	ANGELIQUE.
Medor s'en va combattre, & mon cœur en ſoûpire.	Médor s'en va combattre, et mon cœur en soupire.
Mais il eſt dans le Camp, en croyray-je Alidor?	Mais il est dans le Camp, en crois-je Alidor?
Qui me ſçeut abuſer, peut m’abuſer encor:	Qui me sut abuser, peut m'abuser encor:
Pout ne me pas flater d’vne vaine eſperance, Va donc t’en enquerit, Melinde, en diligence;	Pout ne me pas flatter d'une vaine espérance, Va donc t'en enquérit, Melinde, en diligence;
Fais que quelqu’vn des miens aille au camp prõptement, Et m’en viens auertit dans le meſme moment.	Fais que quelqu'un des miens aille au camp promptement, Et m'en viens avertit dans le même moment.
SCENE III.	SCÈNE III.
ANGELIQVE ſeale.	ANGELIQUE seale.
ECamp n’eſt qu'à deux pas ſuc les bord;	ECamp n'est qu'à deux pas suc les bord;
de la Scine, Et Melinde dans peu me tirera de peine.	de la Scine, Et Melinde dans peu me tirera de peine.
Il ne m'eſt pas permis d’aller à ces Toutnoit, Car le Ror le detfend par ſes ſeueres Lois, De peur que ma preſence y cauſc quelque trouble, Et que de mes Amants la fureur ſe redoubles Seus vn ſi beau pretexte on s’excuſe enuers moy:	Il ne m'est pas permis d'aller à ces Toutnait, Car le Ror le détend par ses sévères Lois, De peur que ma présence y causc quelque trouble, Et que de mes Amants la fureur se redoubles Seus un si beau prétexte on s'excuse envers moi:
Mais vn autre motif a fait agir le Roy:	Mais un autre motif a fait agir le Roi:
Le rang que ie diſpuæ à la Fille de France, A fait donner cét ordre auec grande apparence, Et cét ordre cruel me priue du plaiſir De pouuoir contenter mon genereux deſir;	Le rang que je dispuæ à la Fille de France, A fait donner cet ordre auec grande apparence, Et cet ordre cruel me prive du plaisir De pouvoir contenter mon généreux désir;
Mais il nuit à bſedor auſſi bien qu'à moy-meſme;	Mais il nuit à bedor aussi bien qu'à moi-même;
On eſt bien plus vaillant quaud on voit ce qu’on ayme, Et pour de ſes Riuaux eſtre victorieux, Son bras auroit cherché du ſecours dans mes yeux, Et mon illuſtre Amant remportant la victoire, dol caimlse MraSzolnsela r.	On est bien plus vaillant quaud on voit ce qu'on aime, Et pour de ses Rivaux être victorieux, Son bras aurait cherché du secours dans mes yeux, Et mon illustre Amant remportant la victoire, dol caimlse MraSzolnsela r.
Mais Melinde bien-toſt retourne ſur ſes pas.	Mais Melinde bientôt retourne sur ses pas.
SCENE IV.	SCÈNE IV.
MELINDE, ANGELIQVE.	MELINDE, ANGELIQUE.
MELINDE.	MELINDE.
Edor eſt dans le Camp, on ne vous trompe pas:	Édor est dans le Camp, on ne vous trompe pas:
M Mais ie viens vous churmer par me autre nouuelle.	M Mais ici viens vous churmer par me autre nouvelle.
ANGELIQVE.	ANGELIQUE.
Medor pour s’acquerir vne gloire immortelle, A-t'il vaincu Roland?	Medor pour s'acquérir une gloire immortelle, A-t'-il vaincu Roland?
MELINDE.	MELINDE.
C’eſt vn bon-heur plus grand	C'est un bonheur plus grand
ANGELIQVE.	ANGELIQUE.
Quel eſt donc ce bon-heur?	Quel est donc ce bonheur?
MELINDE.	MELINDE.
C'eſt le retour d’Orcm,	C'est le retour d'Orcm,
ANGELIQVE.	ANGELIQUE.
Il m'apporte ſans doute vne heurcuſe nouuelle, Mais pour me témoigner la grandeur de ſon zele, Qui l’a pa retarder de venir iuſqu icy?	Il m'apporte sans doute une heurcuse nouvelle, Mais pour me témoigner la grandeur de son zèle, Qui l'a pa retarder de venir jusqu' ici?
Ie bruſle de le voir.	Je brûle de le voir.
MHLINDE.	MHLINDE.
Madame, le voley.	Madame, le voley.
SCENE V.	SCÈNE V.
ANGELIQVE, ORCAN.	ANGELIQUE, ORCAN.
ANGEEIATB.	ANGEIATB.
ET bien, Orcan, le Ciel m'a-t'il rendu iuſtice?	ET bien, Oran, le Ciel m'a-t'-il rendu justice?
ORCAN.	ORCAN.
Madame, il vous a fait vn fameux ſacrifice:	Madame, il vous a fait un fameux sacrifice:
Voſtre peuple fidele, apres pluſicurs combats, A tué le Tyran qui troubloit vos Eſtats, Et vos Sujets vainqueurs, pour Reyne vous demandent, Aux riuages François vingt voiles vous attendent, Pour vous conduire en paix aux coſtes d’Orient, Le ſort enfin vous montre vn viſage riant, Et deux Ambaiſadeurs qu’vne foule accompagne, L’vn que l’on vous enuoye, & l’autre à Charlemagne, Partis auec moy d’où s'allume le iour, Arriueront demain dans cette auguſte Cour, Pour ſupplier le Roy de vous traitter en Reyne, Et laiſſer librement partir leur Souueraine:	Votre peuple fidèle, après plusicurs combats, A tué le Tyran qui troublait vos États, Et vos Sujets vainqueurs, pour Reine vous demandent, Aux rivages Français vingt voiles vous attendent, Pour vous conduire en paix aux côtes d'Orient, Le sort enfin vous mon v visage riant, Et deux Ambaisadeurs qu'une foule accompagne, L'un que l'on vous envoie, et l'autre à Charmagne, Partis avec moi d'où s'allume le jour, Arriveront demain dans cette auguste Cour, Pour supplier le Roi de vous traiter en Reine, Et sor tir de vous Traite:
Ces deux Ambaiſadeurs ont vn autre ordre encor De chercher dans ces lieux le genereux Medor, Dont la rare valeur, chez eux merite vn Temple, Et pour perdre vn Tyran leur a donné l’exemple:	Ces deux Ambaisadeurs ont un autre ordre encor De chercher dans ces lieux le généreux Médor, Dont la rare valeur, chez eux mérite un Temple, Et pour perdre un Tyran leur a donné l'exemple:
Comme ils n’ignorent pas que cet illuſtre Amant Eſt de race Royale, & du ſang d’Agramant, Ils ſouhaiteroient fort qu’vn cœur ſi magnanime, Par qui vous recouurez vn Thrône legitime our ce minone auce tous lem vineſiomer des non y Si voſtre Majeſté ne blîme pas leur choix.	Comme ils n'ignorent pas que cet illustre Amant Est de race Royale, et du sang d'Agramant, Ils souhaiteraient fort qu'un cœur si magnanime, Par qui vous recouvrez un Thrône légitime our ce minone auce tous le vinesiomer des non y Si votre Majesté ne blâme pas leur choix.
ANGELIQVE.	ANGELIQUE.
Ah!	Ah!
ſi pour ſon bon-heur, mon peuple le deſire, Ie veux bien auec luy partager mon Empire:	si pour son bonheur, mon peuple le désire, Je veux bien avec lui partager mon Empire:
A preſent ce Heros plein de zele & de foy Eſt entré dans la Lice, & s'expoſe pour moy:	À présent ce Héros plein de zèle et de foi Est entré dans la Lice, et s'expose pour moi:
Paites, fidel Orcan, des vœux pour ſa victoire:	Paites, fidèles Orcan, des vœux pour sa victoire:
Allez eſtre au Tournoy le témoin de ſa gloire, Luy promettant le prix que ie luy dois donner, Aux yeux de ſes Riuaux, allez le couronne:	Allez être au Tournoi le témoin de sa gloire, Lui promettant le prix que ie lui dois donner, Aux yeux de ses Rivaux, allez le couronne:
Ou s’il éprouue, helas!	Ou s'il éprouve, hélas!
la forume cruelle, Ne reuenez iamais m'en faire la nouuelle.	la forme cruelle, Ne revenez jamais m'en faire la nouvelle.
SCEIE V.	SCE V.
L.	L.
ANGELIQVE, MELINDE	ANGELIQUE, MELINDE
ANGELIQVE.	ANGELIQUE.
Ve de ſoucis affreux mon cœur eſt combatur 1 Que l'eſtat où ie ſuis a beſoin de vettu!	Ve de soucis affreux mon cœur est combattur 1 Que l'état où je suis a besoin de vétu!
MELINDE.	MELINDE.
Faut-il qu'vne Princeſſe, & ſe trouble & s’eſtonne, Lors que le iuſte Ciel luy rend vne Couronne.	Faut-il qu'une Princesse, et se trouble et s'étonne, Lors que le juste Ciel était rend une Couronne.
ANGELIQVE Ie ne voulois des biens que pour en faire part, Et ſi Medor n’eſt plus, mon bon-heur vient trop tard;	ANGELIQUE Je ne voulais des biens que pour en faire part, Et si Médor n'est plus, mon bonheur vient trop tard;
Par d'inuiſibles traits ie ſens mon ame atteinte, Mon cœur eſt agité d’eſperance & de crainte;	Par d'invisibles traits aux sens mon âme atteinte, Mon cœur est agité d'espérance et de crainte;
Mais la crainte eſt en moy plus fotte que l'eſpoir, Et ina faion a peles Imle ſondeuon , Ie crains auec ſujet le ſort douteux des armes.	Mais la crainte est en moi plus sotte que l'espoir, Et ina sayon a peles Imle sondeuon , Je crains auec sujet le sort douteux des armes.
MELINDE.	MELINDE.
Vn Amant peut tont vaincre, animé par vos charmes, Vous deuez moderer ce violent ſoucy, Pour finir vos tourmens, Alidor vient icy:	Un Amant peut tont vaincre, animé par vos charmes, Vous devez modérer ce violent souci, Pour finir vos tourments, Alidor vient ici:
Il fait voir dans ſes yeux qu’il eſt content dans l'ame,	Il fait voir dans ses yeux qu'il est content dans l'âme,
SCENE VII.	SCÈNE VII.
HNOLEIQVEJAEIDOIJMEEINDE,	HNOLEIQVEJAEIDOIJMEEINDE,
ANGELIQVE.	ANGELIQUE.
Euenez-vous du Camp?	Euenez-vous du Camp?
ALIDOR.	ÀLIDOR.
Ouy, i'en reuiens, Madame, Banniſſez la frayeur qui regne en vos eſprits.	Oui, j'en reviens, Madame, Bannissez la frayeur qui règne en vos esprits.
ANGEDIQVE.	ANGEDIQUE.
Medor eſt-il vainqueur?	Médor est-il vainqueur?
ALIDOR.	ÀLIDOR.
Pour meriter le prix, Il a fait ce que peut vn genereux courage.	Pour mériter le prix, Il a fait ce que peut un généreux courage.
ANGELIQVE.	ANGELIQUE.
Parlez plus clairement, a-t’il cu laduantage Contre ſes fiers Riuaux, les a-t’il ſurmontez!	Parlez plus clairement, a-t-il cv laduantage Contre ses fiers Rivaux, les a-t-il surmontés!
ALIDOR.	ÀLIDOR.
Hſedor eſt glorieux, ſi vous y conſentez, Son ſort eſt en vos mains, puiſque c’eſt vous qu’il aymes Mais pour de ſon combat pouuoir iuger vous meſme, Puiſque dans voſtre gloire il s’eſt intereſſé, de vau, vou, racoucer touce quis eſt panc, Si vous daignez ouyr ce recit d’importance.	Hédor est glorieux, si vous y consentez, Son sort est en vos mains, puisque c'est vous qu'il aimes Mais pour de son combat pouvoir juger vous même, Puisque dans votre gloire il s'est intéressé, de vau, vou, racoucer touée quis est panc, Si vous daignez ouïr ce récit d'importance.
ANGELIQVE.	ANGELIQUE.
Ouy, racontez-moy tout, ie vous donne andience.	Oui, racontez-moi tout, je vous donne andience.
ALIDOR, Pour rendre plus pompeux ces celebres Tournois, Qui pour ſes ſpectatenrs font voir plus de dix Rois, Tout à l'entour du Camp ſont les portraits des belles Auec les Cheualiers qui combattent pour elles:	ÀLIDOR, Pour rendre plus pompeux ces célèbres Tournois, Qui pour ses spectatenrs font voir plus de dix Rois, Tout à l'entour du Camp sont les portraits des belles Avec les Chevaliers qui combattent pour elles:
Chacun ſert ſa Maiſtreſſe, & defend ſes appas, Et mal-heur en ce iour à ceux qui n’ayment pas.	Chacun sert sa Maîtresse, et défend ses appas, Et malheur en ce jour à ceux qui n'aiment pas.
Pour faire houneur au ſexe, à la jouxte galante On voit courir d’abord Marphiſe & Bradamante, Dont le front glorieux eſt couuert de lauriers, Et le peut d’ſpu:	Pour faire houneur au sexe, à la jouxte galante On voit courir d'abord Marphise et Bradamante, Dont le front glorieux est couvert de lauriers, Et le peut d'spu:
er aux plus fameux Guerriers:	er aux plus fameux Guerriers:
Leur adreſſe paroiſt ainſi que leur courage, Sans que l’vnc ſur l’autte ait aucun auantage.	Leur adresse paraît ainsi que leur courage, Sans que l'unc sur l'autte ait aucun avantage.
Cent Cheualiers apres de differents clunats S’eſtans fait remarquer dans ces nobles combats, On en voit paroiſtre vn ſi charmant & ſi leite, Que ſon diuin éclat efface tout le reſte:	Cent Chevaliers après de différents clunats S'étant fait remarquer dans ces nobles combats, On en voit paraître un si charmant et si leite, Que son divin éclat efface tout le reste:
Son harnois precieux peint d’vn celeſte amit Eſt enrichy par tout d’vn or brillant & pur, Et ſur ſon bouclier qui paroiſt magniſique, Où les armes brilloient du plus grand Roy d’Afrique Deux aiglons eſtoient peinis, attaquez d’vn vautour, Que l’on voyoit combattre & vaincre tour à tour:	Son harnais précieux peint d' celeste amit Est enrichi par tout d'un or brillant et pur, Et sur son bouclier qui paraît magnisique, Où les armes brillaient du plus grand Roi d'Afrique Deux aiglons étaient peinis, attaqués d'un vautour, Que l'on voyait combattre et vaincre tour à tour:
Pour deuiſe on liſoit, leur gloire eſt ſans pareille, De ce beau Cheualier l'eſtonnante merueille Rend tous les ſpectateurs de plaiſir enchantez,	Pour devise on lisait, leur gloire est sans pareille, De ce beau Chalier l'étonnante merveille Rend tous les spectateurs de plaisir enchantez,
Et fait faire des vœux à toutes les beautez.	Et fait faire des vœux à toutes les beautés.
Son cheual aux crins blancs auec ſa croupe large, Et l’encolure en arc, orgueilleux de ſa charge, Bondit, écume, hennit, fait vn bruit nompareil.	Son cheval aux crins blancs avec sa croupe large, Et l'encolure en arc, orgueilleux de sa charge, Bondit, écume, hennit, fait un bruit nompareil.
Et tel que l’on nous peint les cheuaux du Soleil, Auec ſon pied ſuperbe en frapant la barriere, Semble aux portes du iour anoncer la lumicre;	Et tel que l'on nous peint les chevaux du Soleil, Avec son pied superbe en frappant la barrière, Semble aux portes du jour anoncer la lumicre;
Ce Cheuilier ſe montre auſſi fier que galand, Et défie au combat l’inuincible Roland;	Ce Chevilier se montre aussi fier que galant, Et défie au combat l'invincible Roland;
Roland en meſme-temps prend vne forte lance, Et vers cét inconnu le Paladin s’atnce, Lay demande ſon nom, croyant que c’eſt Medor;	Roland en même-temps prend une forte lance, Et vers cet inconnu le Paladin s'atnce, Lais demande son nom, croyant que c'est Médor;
Mais l’inconnu luy dit, il n’eſt pas temps encot, Tu le ſçiuras aſſez s mais fans plus de replique, Montrons noſtre courage en faueur d’Angelique;	Mais l'inconnu toujours dit, il n'est pas temps encot, Tu le sçiuras assez s mais sans plus de réplique, Montrons notre courage en faveur d'Angélique;
C’eſt mon deſſcin, répond le Comte à ſon Riual, Mais le combat, dit-il, te deuieudra fatal:	C'est mon desscin, répond le Comte à son Rival, Mais le combat, dit-il, te deuieudra fatal:
L'vn & l'autre à l'inſtant font ouurir la barriere, Et fourniſſeut tous deux vne belle carriere:	L'autre et l'autre à l'instant font ouvrir la barrière, Et fournisseut tous deux belle carrière:
Leurs cheuaux font trembler la terre ſous leurs pas, Et l’on diroit pourtant qu’ils ne la touchent pas.	Leurs chevaux font trembler la terre sous leurs pas, Et l'on dirait pourtant qu'ils ne la touchent pas.
De ces adroits Guerriers les deux lances rompuës, On en voit les éclats voler iuſques aux nuës, Et chacun dans ſa main n’en a que le tronçon, L'vn & l’autre pourtant eſt ferme ſur l’arçon:	De ces adroits Guerriers les deux lances rompues, On en voit les éclats voler jusqu' aux nues, Et chacun dans sa main n'en a que le tronçon, L'un et l'autre pourtant est ferme sur l'arçon:
Pour mieux recommencer vne amoureuſe guerre, Tous deux de leurs cheuaux ſautent ſoudain à tetre, Le courageux Roland, & le beau Cheualier Prennent chacun l’épée auec le bouclier:	Pour mieux recommencer une amoureuse guerre, Tous deux de leurs chevaux sautent soudain à tetre, Le courageux Roland, et le beau Chevalier Prennent chacun l'épée avec le bouclier:
Lors pour vous meriter, adorable Princeſſe, Chacun montre à l’enuy ſa force & ſon adreſſe, Mais l’inconnu laſſe d’vn combat trop égal, Lcuant le bras en haut pour fraper ſon Riual, Fait deſcendre le coup, ainſi qu’vne tempeſte, Sut l’écu de Roland qui luy couuroit la teſte, Il Ie met en morceaux, & Roland ſans écu, S’il ne vange l’affront, croit auoir trop vécu, A perdre I’inconnu ſa valeur occupéc Fend ſon armet en deux par vn ſcul coup d’épée;	Lors pour vous mériter, adorable Princesse, Chacun montre à l'envi sa force et son adresse, Mais l'inconnu lasse d'un combat trop égal, Luant le bras en haut pour frapper son Rival, Fait descendre le coup, ainsi qu'une tempête, Sut l'écu de Roland qui lui couuroit la tête, Il Je met en morceaux, et Roland sans écu, S'il ne venge l'affront, croit avoir trop vécu, À perdre J'inconnu A valeur occupéc Fend son armet en deux par un scul coup d'épée;
Par l’effort de ce coup, & ſi grand & ſi prompt, L'épée entre ſes mains iuſqu’aux gardes ſe rompt, De ce cmel mal-beur le Paladin enrage, Et chacun d’Arimant reconnoiſt le viſage:	Par l'effort de ce coup, et si grand et si prompt, L'épée entre ses mains jusqu'aux gardes se rompt, De ce cmel malheur le Paladin enrage, Et chacun d'Arimant reconnaît le visage:
Sa balle teſte nuë, & ſes cheueux épars De tous les ſpectateurs attirent les regards.	Sa balle tête nue, et ses cheveux épars De tous les spectateurs attirent les regards.
ANGELIQVÉ.	ANGELIQUE.
Quoy!	Quoi!
c’eſtoit Arimant qui prenoit ma defence.	c'était Arimant qui prenait ma défense.
ALIDOR.	ÀLIDOR.
Eſcoutez ce qui reſte auec patience.	Écoutez ce qui reste avec patience.
Ce Heros qui defend voſtre illuſtre beaoté, Montre auec ſa valeur ſa generoſité;	Ce Héros qui défend votre illustre beaoté, Montre avec sa valeur sa générosité;
Son grand cœur ne veut pas vaincre auec auantage, Ny que l'aucugle ſort ſeconde ſon courage.	Son grand cœur ne veut pas vaincre avec avantage, Ni que l'aucugle sort seconde son courage.
Va, dit-il, à Roland, t’armer tout de nouueau, Pour combattre deux fois, le prix eſt aſſez beau, Puiſque nous combattons en l’honneur d’Angelique, Elle n’inſpire rien qui ne ſoit heroïque:	Va, dit-il, à Roland, t'armer tout de nouveau, Pour combattre deux fois, le prix est assez beau, Puisque nous combattons en l'honneur d'Angélique, Elle n'inspire rien qui ne soit héroïque:
Il n’eſt plus temps de feindre, apprend, dit-il eucor Le nom de ton Riual, & que ie ſuis Medor.	Il n'est plus temps de feindre, apprend, dit-il eucor Le nom de ton Rival, et que tu suis Médor.
ANTOELIUVE.	ANTOLIUE.
Arimant eſt Medor, ô Dieux!	Arimant est Médor, ô Dieux!
eſt-il poſſible?	est-il possible?
ALIDOR.	ÀLIDOR.
Oüy, voſtre adorateur à vos yeux fut viſible, Et vous viſtes Medor en voyant Arimant.	Oui, votre adorateur à vos yeux fut visible, Et vous vîtes Médor en voyant Arimant.
ANGELIQVE.	ANGELIQUE.
I’ay peine à reuenir de mon eſtonnement.	J'ai peine à revenir de mon étonnement.
ALIDOR.	ÀLIDOR.
Le Roy ſurpris d'oüir cette auanture rare, Par ſon ordre vn Heraut ces deux Ouemers ſepate, Pour en pouuoic cirer tout l’éclaircillement,	Le Roi surpris d'ouïr cette aventure rare, Par son ordre un Heraut ces deux Ouvement sepate, Pour en pouvoic cirer tout l'éclaircillement,
Il fait iuſqu’à ſon thrône approcher Arimant, Aprés auoir loüé ſa genercuſe audace, Et ſçeu de luy ſon nom, ſon pars, & ſa race, Son amour, ſes exploits:	Il fait jusqu'à son trône approcher Arimant, Après avoir loué sa gencuse audace, Et su de lui son nom, son pars, et sa race, Son amour, ses exploits:
Ce Monarque rauy Des vertus d'vn amant qui l'a ſi bien ſeruy, Et pour luy s’eſt acquis vne gloire immortelle, Dit qu’il veut de Medor terminer la querelle:	Ce Monarque ravi Des vertus d'un amant qui l'a si bien servi, Et pour lui s'est acquis une gloire immortelle, Dit qu'il veut de Médor terminer la querelle:
Puiſque ſes fiers Riuaux ſont ſod̂mis à vos lois Que vous eſtes le prix que l'on donne aux Tournois C’eſt à vous de juger de leur merite inſigne, Et de tous ces Amans de choiſir le plus digne.	Puisque ses fiers Rivaux sont sodis à vos lois Que vous êtes le prix que l'on donne aux Tournais C'est à vous de juger de leur mérite insigne, Et de tous ces Amants de choisir le plus digne.
Ses Riuiux connoiſſans que cet arreſt leur nuit, Et qu’il ſert à Medor, ſe retirent ſans bruit, Horſmis le fier Roland, qui dit qu’il eſt iniuſte, Sans reſpecter ſon Peince, & l’aſſemblée Auguſte, Il mutmure, il eciate, il deuient furieux, Et ſort en menzçant & la terre & les Cieux.	Ses Riuiux connaissant que cet arrêt leur nuit, Et qu'il sert à Médor, se retirent sans bruit, Hormis le fier Roland, qui dit qu'il est injuste, Sans respecter son Peince, et l'assemblée Auguste, Il muture, il eciate, il devient furieux, Et sort en menzçant et la terre et les Cieux.
Ainſi Medor, ainſi, remportant la victoire, Pour augmenter encor la ſpleudeur de ſa gloire, Noſtre fidel Orcan eſt venu liy conter, Ce que le Ciel a fait pour vous feliciter:	Ainsi Médor, ainsi, remportant la victoire, Pour augmenter encor la spludeur de sa gloire, Notre fidel Orcan est venu y conter, Ce que le Ciel a fait pour vous féliciter:
Par le commandement du diuin Charlemagre, Renaud auec Roger iuſqu’icy l’accompagne, Malgré leur talouſie il les à mis d’accort, Ainſi tout contribuẽ à ſon glorieux ſort, Le bruit qui rettentit iuſques dedans la ruë De cet heureux vainqueur annonce la venuë.	Par le commandement du divin Charlemagre, Renaud avec Roger jusqu'ici l'accompagne, Malgré leur talousie il les a mis d'accort, Ainsi tout contribuence à son glorieux sort, Le bruit qui retentit iusques dedans la rue De cet heureux vainqueur annonce la venue.
SCENE DERNIERE.	SCÈNE DERNIÈRE.
ANGELIQVE, MEDOR, RENAVD, ROGER, ALIDOR, ORCAN, MELINDE, ALCANDRE.	ANGELIQUE, MEDOR, RENAUD, ROGER, ALIDOR, ORCAN, MELINDE, ALCANDRE.
ANGELIQYE.	ANGELIQYE.
E ne puis trop loüer voſtre rare valeur, Qui me comble de joye, & vous comble d’honneur.	ET ne puis trop louer votre rare valeur, Qui me comble de joie, et vous comble d'honneur.
MEDOR.	MÉDOR.
telta, der goieuinesye dent oc rons plaire.	telta, der goieinesie dent oc ons plaire.
ANGELIQVE.	ANGELIQUE.
le veux que vos hutstuts reçoment ſeur ſliiſe, Vous n'eſtes plus ialoux de ſa proſperité,	le veux que vos hututs reçoment sûr sûriise, Vous n'êtes plus jaloux de sa prospérité,
RENAVD.	RENAUD.
Il n’a point de bon-heur, qu'il n’ait bien merité.	Il n'a point de bonheur, qu'il n'ait bien mérité.
Le b2 Nous conſentons tous deux qu'Arimant vous poſſede, De delm der amou veuei queronuy ceuc.	Le b2 Nous consentons tous deux qu'Arimant vous possède, De dél der amou veuei quéronui ceuc.
ANGELIQVE à Medor.	ANGELIQUE à Médor.
Vous me cachiez Medor, me montrant Arimant.	Vous me cachiez Médor, me montrant Arimant.
MEDOB.	MEDOB.
Oüy, ſous deux noms diuers vous n’auiez qu’vn amant.	Oui, sous deux noms divers vous n'aviez qu'un amant.
ANGELIQVE.	ANGELIQUE.
Touttes vos actions ſont ſi pleines de gloire, Que c’eſt vous offenſer que de ne vous pas croire Mais me donnerez-vous quelqu’autre marque encot.	Touttes vos actions sont si pleines de gloire, Que c'est vous offenser que de ne vous pas croire Mais me donnez-vous quelqu'autre marque encot.
Qui puiiſe m’aſſeuret qu’Arimant eſt Medor	Qui pvise m'assuret qu'Arimant est Médor
MEDOR.	MÉDOR.
Dans ce jour glorieux, Princeſſe incomparable, Que ie vous deffendis d’vne ourſe épouuentable, Dans le trouble où vous mit ce monſtre furieux, Vous laiſſaſtes tomber cette écharpe à mes yeux;	Dans ce jour glorieux, Princesse incomparable, Que je vous défendis d'une ourse épouuentable, Dans le trouble où vous mit ce monstre furieux, Vous laissâtes tomber cette écharpe à mes yeux;
l ay coments depuus iaſpirencessBe, Qui de ce que ie ſuis peut rendre témoignage.	l ai compents dépuus jaspirencessBe, Qui de ce que je suis peut rendre témoignage.
ORCAN.	ORCAN.
Ie luis temoin encor d’vn ſeruice auſſi grand, Que ce Prince à tué voſtre premier Tyran.	Je luis témoin encor d'une service aussi grand, Que ce Prince à tué notre premier Tyran.
ANGELIQVE.	ANGELIQUE.
C’eſt mon Liberateur que le Ciel me renuoye, avins qu'alesemidisianeuc pliee amiofe:	C'est mon Libérateur que le Ciel me renvoie, avins qu'alesemidisianeuc pliée amieofe:
De Roland & de moy vous eſtes le vainqueur, vous anz Iqcugagner mon eitime o mon cam	De Roland et de moi vous êtes le vainqueur, vous anz Iqugagner mon eitime ô mon cam
MEDOR.	MÉDOR.
Ah, c’eſt trop de bontez pour vne Souueraine.	Ah, c'est trop de bontés pour une Souveraine.
ANGELIQVE.	ANGELIQUE.
Quoy!	Quoi!
faut il eſtre ingrate à cauſe qu'on eſt Reyne?	faut il être ingrate à cause qu'on est Reine?
Pour vous recompenſer, ie veux plus faire encor, Ie veux dans mes Eſtats faire regner Medor;	Pour vous récompenser, ie veux plus faire encor, Je veux dans mes États faire régner Médor;
Ie veux pour m’acquitter, & pour le ſatisfaire, Voir mon Liberateur au thrône de mon Pere;	Je veux pour m'acquitter, et pour le satisfaire, Voir mon Libérateur au trône de mon Père;
Charlemagne approiuunt mon choix & voſtre a mouf, de veult dultporlleue parur de cene Cour;	Charlemagne approivunt mon choix et votre à mous, de veult dultporlleue parur de cène Cour;
Vous m’accompagnerez au glorieux riuge Où mes ſuiets vainqueurs en me rendant hommage, De cent belles Cités les portes m’ouuriront, Et loüans vos vertus ils les courronneront.	Vous m'accompagnerez au glorieux rive Où mes sujets vainqueurs en me rendant hommage, De cent belles Cités les portes m'ouvriront, Et loüans vos vertus ils les courronneront.
MEDOR.	MÉDOR.
Preſt à ſuiure par tout vos bcautez que i’adore, Mes feux impatiens deuanceront l’Aurore, Mais allons rendre grace au Heros des François Le plus ſage mortel & le plus grand des Rois, Qui ſe fait renommer en paix, ainſi qu’en guerre, Qui vient de partager l’empire de la terre, Dont la rate verta oime de toutes parts, Et melle auec les Lys l'eſpgle en ſes éienderts.	Prêt à suivre par tout vos bcautés que j'adore, Mes feux impatiens devanceront l'Aurore, Mais allons rendre grâce au Héros des Français Le plus sage mortel et le plus grand des Rois, Qui se fait renommer en paix, ainsi qu'en guerre, Qui vient de partager l'empire de la terre, Dont la rate verta oime de toutes parts, Et melle avec les Lys l'espègle en ses éienderts.
FIN.	FIN.
