Des que vous auez paru dans la Cour de France, apres auoir fait ſentir voſtre venuë par tous les lieux où vous paſſiez;	Des que vous avez paru dans la Cour de France, après avoir fait sentir votre venue par tous les lieux où vous passiez;
Et apres luy auoir enuoyé deuant vous vne belle renommée, elle vous a regardé auec admiration;	Et après lui avoir envoyé devant vous une belle renommée, elle vous a regardé avec admiration;
Et apres vous auoir long temps conſideré, elle s’eſt retractée en voſtre faueur du ſentiment qu’elle a pour tous les Eſtrangers:	Et après vous avoir long temps considéré, elle s'est retractée en votre faveur du sentiment qu'elle a pour tous les Étrangers:
Vous l’auez forcée d’aduoüer que toute la Politeſſe n’eſt pas chez elle:	Vous l'avez forcée d'avouer que toute la Politesse n'est pas chez elle:
Et quoy qu’à l’exemple de la Grece, elle puiſſe traiter toutes les autres Nations de Barbares;	Et quoique à l'exemple de la Grèce, elle puisse traiter toutes les autres Nations de Barbares;
Elle a exempté de ce reproche le Septentrion, puis qu’ila, la gloire de vous auoir produit.	Elle a exempté de ce reproche le Septentrion, puis qu'ila, la gloire de vous avoir produit.
Elle vous a teſmoigné, MONSEIGNEVR, qu’elle faiſoit vne eſtime tres-particuliere de voſtre perſonne:	Elle vous a témoigné, MONSEIGNEUR, qu'elle faisait une estime très-particulière de votre personne:
lamais Ambaſſadeur n’a mieux plû que vous à cette delicate, du conſentement de tous ceux qui l’a compoſent, elle vous a iugé parfait, & vous vous pouuez vanter d’auoir obtenu d’elle, ce qu’elle a refuſé à tous ceux qui vous ont precedé:	lamais Ambassadeur n'a mieux plu que vous à cette délicate, du consentement de tous ceux qui l'a composent, elle vous a jugé parfait, et vous vous pouvez vanter d'avoir obtenu d'elle, ce qu'elle a refusé à tous ceux qui vous ont précédé:
Combien de bouches ont loüé le glorieux choix qu’a fait de vous, voſtre illuſtre Princeſſe, pour vne Ambaſſade ſi importante que celle que vous auez traitée:	Combien de bouches ont loué le glorieux choix qu'a fait de vous, votre illustre Princesse, pour une Ambassade si importante que celle que vous avez traitée:
Iamais l’eſprit de cette incomparable Reyne, que vous ſeruez, & à qui toute l’Europe rend ſes hommages, n’a paru ſi eminemment, qu’en vous eſliſant pour vn ſi celebre employ.	Jamais l'esprit de cette incomparable Reine, que vous servez, et à qui toute l'Europe rend ses hommages, n'a paru si éminemment, qu'en vous élisant pour un si célèbre emploi.
Vous auez dignement reſpondu à l’attente des deux Couronnes, & ces deux fameux Eſtats, de qui l’éloignement ne peut alterer l’intelligence, vous ſont redeuables d’vne vnion qu’ils ne renouuellent de temps en temps que pour la rendre eternelle:	Vous avez dignement répondu à l'attente des deux Couronnes, et ces deux fameux États, de qui l'éloignement ne peut altérer l'intelligence, vous sont redevables d'une union qu'ils ne renouvellent de temps en temps que pour la rendre éternelle:
Que d’applaudiſſemens ne vous doiuent point la France & la Suede, pendant ce temps, MONSEIGNEVR, que vous faites le deſtin de ces deux Royaumes:	Que d'applaudissements ne vous doivent point la France et la Suède, pendant ce temps, MONSEIGNEUR, que vous faites le destin de ces deux Royaumes:
l’oze vous preſenter l’Hiſtoire du plus infortuné de tous les Politiques & du plus digne de ſon mal-heur.	l'ose vous présenter l'Histoire du plus infortuné de tous les Politiques et du plus digne de son malheur.
Ie veux forcer l’ambitieux Sejanus, à vort voitie Cabinet, à y étudier vos maximes, & a faire cét adueu, que s’il les euſt pratiquées, ſon Gouuernement auroit eſté auſſi doux aux Romains, que le voſtre eſt aimable aux Suedois:	Je veux forcer l'ambitieux Séjanus, à vort voitie Cabinet, à y étudier vos maximes, et à faire cet aveu, que s'il les eût pratiquées, son Gouvernement aurait été aussi doux aux Romains, que le vôtre est aimable aux Sudais:
Vous ſeruez ſi bien leur Monarchie, qu’ils cenfeſſent à toute l’Europe, que vous meriteriez de regner:	Vous servez si bien leur Monarchie, qu'ils cenfessent à toute l'Europe, que vous mériteriez de régner:
Et ſi l’illuſtre ſang du grand Aſtolphe leur manquoit, qu’ils iroient chercher dans voſtre maiſon vn ſucceſſeur digne des Maiſtres qu’ils auroient perdu.	Et si l'illustre sang du grand Astolphe leur manquait, qu'ils iraient chercher dans votre maison successeur digne des Maîtres qu'ils auraient perdu.
C’eſt vous, MONSEIGNEVR, qui ſuccederiez à l’auguſte Guſtaue, dont la vie eſt pleine de Miracles & à ſa diuine heritiere, dont le premier âge eſt remply de prodiges;	C'est vous, MONSEIGNEUR, qui succéderiez à l'auguste Gûtaue, dont la vie est pleine de Miracles et à sa divine héritière, dont le premier âge est rempli de prodiges;
ſi bien que l’aduenir doutera lequel du pere ou de la fille aura le plus fait de merueilles, & lequel de leurs deux ſexes ſera le plus glorieux pour les auoir donnez au monde:	si bien que l'avenir doutera lequel du père ou de la fille aura le plus fait de merveilles, et lequel de leurs deux sexes sera le plus glorieux pour les avoir donnez au monde:
Vous eſtonnerez auſſi l’Hiſtoire, MONSEIGNEVR, & nos nepueux verront auéc admiration, combien dans vn ſiecle la Suede aura porté de grands Perſonnages, l’on les verra ſe plaindre au ſiecle de leurs ayeux, de n’auoir pas reculé voſtre naiſſance iuſqu’à leurs temps, la France fait vne autre eſpece de plainte, elle ſe faſche contr’elle meſme, de vous auoir donné à la Suede, & ſi elle n’apprehendoit de violer cette paix que vous venez d’affermir entr’elles, elle reprendroit le preſent qu’elle luy a fait:	Vous étonnerez aussi l'Histoire, MONSEIGNEUR, et nos neveux verront auéc admiration, combien dans un siècle la Siède aura porté de grands Personnages, eon les verra se plaindre au siècle de leurs aïeux, de n'avoir pas reculé votre naissance jusqu'à leurs temps, la France fait autre espèce de plainte, elle se fâche contr’elle même, de vous auoir donné la Suede, et si elle apprehendoit de violer cette paix que vous venez affermir entr’elles, elle reprendroit le présent elle lui a fait:
Mais, MONSEIGNEVR, querque eſtime qu’elle faſſe de vous, il faut qu’elle vous rende:	Mais, MONSEIGNEUR, querque estime qu'elle fasse de vous, il faut qu'elle vous rende:
Tout le Septentrion vous redemande auec impatience, deux Maiſtreſſes vous y attendent, & celle dont la poſſeſſion vous eſt reſeruée, murmure contre nous de ce que nous vous retenons plus long-temps.	Tout le Septentrion vous redemande avec impatience, deux Maîtresses vous y attendent, et celle dont la possession vous est réservée, murmure contre nous de ce que nous vous retenons plus longtemps.
Repportez luy, MONSEINGEVR, ce viſage qui ne s’eſt point ſi bien compoſé dans noſtre Cour, qu’on n’y ait veu, ſans quelque eſpece de ialouſie, que la France n’eſtoit point voſtre element, & que vous n’aſpiriez qu'à reuoir cét aimable Climat ou ſont enfermez tous vos deſirs:	Réportez Seigneur, MONSEINGEUR, ce visage qui ne s'est point si bien composé dans notre Cour, qu'on n'y ait vu, sans quelque espèce de jalousie, que la France n'était point votre élément, et que vous n'aspiriez qu'à revoir cet aimable Climat ou sont enfermés tous vos désirs:
Ie ſuis afſligé, MONSEIGNEVR, de vous auoir derobé quelques momens, & d’auoir interrompu vos belles idées, au point, ou tout libre des ſoucis que voſtre employ vous donnoit, vous rendiez toute voſtre ame à cette Princeſſe, qui ne la veut partager qu’auec voſtre Reyne;	Je suis affligé, MONSEIGNEUR, de vous avoir derobé quelques moments, et d'avoir interrompu vos belles idées, au point, ou tout libre des soucis que votre emploi vous donnait, vous rendiez toute vôtre âme à cette Princesse, qui ne la veut partager qu'avec votre Reine;
le finis, MONSEIGNEVR, en vous conjurant de ſouffrir, que ie me die,	le finis, MONSEIGNEUR, en vous conjurant de souffrir, que sans me die,
MONSEIGNEVR,	MONSEIGNEUR,
DE VOSTRE EXCELLENCE,	DE VÔTRE EXCELLENCE,
Le tres-humble & tres-obeïſſant.	Le très-humble et très-obeïssant.
MAGNON.	MAGNON.
Exiraicr an Printiege un Rey.	Exiraicr an Priniège un Rey.
AR grace & Priuilege du Roy:	AR grâce et Privilège du Roi:
Donné à Paris le dernier Aouſt 1646.	Donné à Paris le dernier Août 1646.
Signé par le Roy en ſon Conſeil, SYMON:	Signé par le Roi en son Conseil, SIMON:
Il eſt permis à ANTOINE DE SOMMAVILLE, Marchand Libraire à Paris, d’imprimer ou faire imprimer vendre & diſtribuer vne piece de Theatre intitulee, Sejanus Tragedie, & ce durant le temps de cinq ans, à compter du iour que ladite piece ſera acheuee d’imprimer, & defenſes ſeront faites à tous Imprimeurs & Libraires d’en imprimer, vendre & diſtribuer d’autre impreſſion que de celle dudit SOMMAVILLE, ou ſes ayans cauſes, ſur peine aux contreuenans de trois mille liures d’amande, confiſcation des exemplaires, & de tous deſpens, dommages & intereſts, ainſi qu’il eſt plus au long porté par leſdites Lettres.	Il est permis à ANTOINE DE SOMMAVILLE, Marchand Libraire à Paris, d'imprimer ou faire imprimer vendre et distribuer une pièce de Théâtre intitule, Séjanus Tragédie, et ce durant le temps de cinq ans, à compter du jour que ladite pièce sera achevue d'imprimer, et défenses seront faites à tous Imprimeurs et Libraires d'en imprimer, vendre et distribuer d'autre impression que de celle dudit SOMAUILLE, ou ses a causes, ou se aux contreuenans de ai mille liures amande, confiscation des sur, et de tous dépens, dommages et intérêts, aux lilest plusna long porté par lesdites Lettres.
Et ledit SOMMAVILLE a conſenty & conſent, que TOb SSAINVCTQVIIVET, außi Marchand Libraire, iouyſſe par moitté dudit Priuilege, ſuiuant l’accord fait entr'eux.	Et ledit SOMAUILLE a consenti et consent, que TOb SSAINVCTQVIIVET, aussi Marchand Libraire, jouisse par moité dudit Privilège, suivant l'accord fait entr'eux.
Les exemplaires ont eſté fournis.	Les exemplaires ont été fournis.
TIBERE, Empereur de Romme.	TIBERE, Empereur de Romme.
DRVZE, fils de Germanicus, & nepueu de Tibere.	DRUZE, fils de Germanicus, et nepueu de Tibère.
LIVIE, vefue de Druze, fils de Tibere.	LIVIE, veue de Druze, fils de Tibère.
FVLVIE, Conndente de Liuie.	FULVIE, Conndente de Livie.
SEIANVS, Fauory de Tibere.	SEIANVS, Favori de Tibère.
APICATA, ſemme de Sejanus.	APICATA, semme de Séjanus.
VOLVZIE, fille de Sejanus.	VOLVZIE, fille de Séjanus.
TERENCE, Cheualier Romain, amy de Sejanus.	TERENCE, Chevalier Romain, ami de Sejanus.
MAGiun, doronerues Geluerde Tibere.	MAGiun, doronerves Geluerde Tibère.
REGVLVS, ſon Lieutenant.	REGVLVS, son Lieutenant.
Troupe de Gardes.	Troupe de Gardes.
La SCEN Rreje uuni Romme, uans ie Palais de Tibere.	La SCEN Rreje ouvuni Romme, ans ici Palais de Tibère.
LVIE.	LVIE.
OSTRE vnique remede, eſt de toûjours ſouffrir, La douleur qu’on éuẽte, eſt au poinct de s’aigrir.	OSTRE unique remède, est de toujours souffrir, La douleur qu'on éuẽte, est au point de s'aigrir.
Que dira l’auenir de ce ſiecle où nous ſommes?	Que dira l'avenir de ce siècle où nous sommes?
LIVIE.	LIVIE.
Que mon ſexe aura fait ce que n’ont pû des hommes, Et que leur lâcheté me donna lieu d’agir.	Que mon sexe aura fait ce que n'ont pu des hommes, Et que leur lâcheté me donna lieu d'agir.
LVIE.	LVIE.
Ce noble ſentiment les doit faire rougir;	Ce noble sentiment les doit faire rougir;
Et nos Neveux verront l’impuiſſance de Rome, En ce que tous nos temps n'ont pû produire vn hom Qu'elle a degeneré de ſes premieres mœurs, Et qu'elle a contracté de contraires humeurs;	Et nos Neveux verront l'impuissance de Rome, En ce que tous nos temps n'ont pu produire un hom Qu'elle a dégénéré de ses premières mœurs, Et qu'elle a contracté de contraires humeurs;
C’eſt là l’impreßion que donne vne habitude;	C'est là l'impresiion que donne une habitude;
Rome injenſiviemem goue la ferueniere s Elle, qui pour la fuyr ſubjuga l’Uniuers, Cherit ſon eſclauage, & s’aime dans ſes fers.	Rome injensivièmem goue la ferenière s Elle, qui pour la fuir sujuga l'Univers, Chérit son esclavage, et s'aime dans ses fers.
LIVIE.	LIVIE.
Oüy, cette lâcheté diffamera noſtre âge, De n’auoir pû produire vn homme de courage;	Oui, cette lâcheté diffamera notre âge, De n'avoir pu produire un homme de courage;
Vn Peuple belliqueux ſe ſoûmet à Sejan, Et l’ennemy des Roys ſouffre vn petit tyran.	Un Peuple belliqueux se soumet à Séjan, Et l'ennemi des Rois souffre un petit tyran.
L’on immola Tarquin à la haine commune, Appius Decemuir eut la meſme fortune:	L'on immola Tarquin à la haine commune, Appius Décemuir eut la même fortune:
Enfin, de temps en temps, les Dieux ont ſuſcité Quelque reſtaurateur de noſtre liberté;	Enfin, de temps en temps, les Dieux ont suscité Quelque restaurateur de notre liberté;
En donnant des tyrans, ils nous offroient des aydes, Et de la meſme main, les maux & les remedes.	En donnant des tyrans, ils nous offraient des aides, Et de la même main, les maux et les remèdes.
Que n’ont pû les Romains?	Que n'ont pu les Romains?
que n’ont ils pas oſé?	que n'ont ils pas osé?
Brute tua Ceſar, Cinna s’eſt expoſé;	Brute tua César, Cinna s'est exposé;
Et bien que leur grand zele ait paru trop injuſte, Le premier reüßit, l’autre a fait craindre Auguſte;	Et bien que leur grand zèle ait paru trop injuste, Le premier réussit, l'autre a fait craindre Auguste;
A la honte de Rome, vn ſimple fauory, Se conſerne fans crainte, ou Ceſar a pery.	À la honte de Rome, un simple favori, Se conserne sans crainte, ou César a péri.
LVIE.	LVIE.
Sous ce malheureux regne où nous pouuõs tout craindre, Dunepauuupug de plaiſir de ſe plaindre;	Sous ce malheureux règne où nous pouvons tout craindre, Dunepauuupug de plaisir de se plaindre;
Les Romains, comme vous, reſſentent leurs douleurs.	Les Romains, comme vous, ressent leurs douleurs.
Ils attendent du temps la fin de leurs mal-heurs.	Ils attendent du temps la fin de leurs malheurs.
LIVIE.	LIVIE.
Par tes comparaiſons, ma douleur eſt bien pire, Sa mort peut rétablir le repos de l'Empire;	Par tes comparaisons, ma douleur est bien pire, Sa mort peut rétablir le repos de l'Empire;
El pour mes imereſis, jub-il cent jois pery, Ferois-je par ſa mort reuiure mon mary?	Él pour mes imeresis, jub-il cent jois péri, Ferais-je par sa mort reuiure mon mari?
Ie treuuerrois encores la victime imparfaite, Et ie me vengerois, ſans eſtre ſatisfaite.	Je trouverais encore la victime imparfaite, Et personne me vengerais, sans être satisfaite.
LVIE.	LVIE.
Laiſſez ſon châtiment à ſes propres remords;	Laissez son châtiment à ses propres remords;
Ces bourreaux de la vie appaiſent mieux les morts;	Ces bourreaux de la vie apaisent mieux les morts;
Quelque indignation, quelque deſir auide, Qu'on ſuppoſe en vn mort contre ſon homicide, Le ſang de ſon meurtrier luy paroiſt odieux;	Quelque indignation, quelque désir auide, Qu'on suppose en un mort contre son homicide, Le sang de son meurtrier Seigneur paraît odieux;
Et comme par mépris il le remet aux Dieux, Il ſemble abandonner le ſoin de ſa vengeance;	Et comme par mépris il le remet aux Dieux, Il semble abandonner le soin de sa vengeance;
Le Ciel qui l’intereſſe, en prend la connoiſſance.	Le Ciel qui l'intéresse, en prend la connaissance.
LIVIE.	LIVIE.
Des remords dans Sejan!	Des remords dans Séjan!
il en pourroit former!	il en pourrait former!
Luy, qui dedans le crime a pù ſe conſommer!	Lui, qui dedans le crime a puù se consommer!
A qui les attentats ſont plus que legitimes!	À qui les attentats sont plus que légitimes!
Rien que le châtiment n’arreſtera ſes crimes:	Rien que le châtiment n'arrêtera ses crimes:
C’eſt ſeulement la mort qu’il luy faut oppoſer;	C'est seulement la mort qu'il lui faut opposer;
Sans cet empeſchement, Sejan va tout oſer;	Sans cet empêchement, Séjan va tout oser;
C’est vn torrent d’orgueil qui roule auec furie, Dont le débordement inonde ſa patrie, Et dont le cours eſt tel, qu’il entraine aujourd’huy Tout ce qui ſe rencontre entre le Troſne & luy, Purgeons Rome d’vnmonſtre, & ſauuons là de blâme, La perte de Sejan eſt l’œuure d’vne femme, Le ſalut de Tybere eſt meſme dans mes mains, Et ie puis ordonner du bonheur des Romains.	C'est un torrent d'orgueil qui roule avec furie, Dont le débordement inonde sa patrie, Et dont le cours est tel, qu'il entraine aujourd'hui Tout ce qui se rencontre entre le Trône et même, Purgeons Rome d'vnmonstre, et sauvons là de blâme, La perte de Séjan est l'œuvre d'une femme, Le salut de Tybere est même dans mes mains, Et ie puis ordonner du bonheur des Romains.
LVIE.	LVIE.
Et quoy, Sejan conspire?	Et quoi, Séjan conspire?
E.	E.
Et quoy, cela t’étonne?	Et quoi, cela t'étonne?
Ce monſtre s’accouſtume à n'épargner perſonne:	Ce montre s'accoutume à n'épargner personne:
Tybere, agrandiſſant vn tel ambitieux, Arma, ſans y penſer, le bras d’vn furieux, Qui parmy tant d’horreurs ne s'eſtant pu connaiſtre, Deuoit porter le fer dans le ſein de ſon Maiſtre;	Tibère, agrandissant un tel ambitieux, Arma, sans y penser, le bras d'un furieux, Qui parmi tant d'horreurs ne s'étant pu connaître, Deuait porter le fer dans le sein de son Maître;
Ainſi s’estant défait des Fils & des Neveux, Cette mort l’éleuoit au comble de ſes vœux;	Ainsi s'étant défait des Fils et des Neveux, Cette mort l'élevait au comble de ses vœux;
Rien ne peut étancher la ſoif d’vn ſanguinaire, Ny rien ne peut remplir les vœux d’vn temeraire.	Rien ne peut étancher la soif d'un sanguinaire, Ni rien ne peut remplir les vœux d'un téméraire.
Apprens par ce party qu’il a pù propoſer, Et le deſſein qu’il a de vouloir m’épouſer;	Apprends par ce parti qu'il a puù proposer, Et le dessein qu'il a de vouloir m'épouser;
Qu'il veut que noſtre amour ſoit comme l’entremiſe, Et le couronnement d’vne telle entrepriſe;	Qu'il veut que notre amour soit comme l'entremise, Et le couronnement d'une telle entreprise;
Ainſi l’ambition ſe cacha ſous l’amour, Et le meſme ſecret a mis ſon crime au iour;	Ainsi l'ambition se cacha sous l'amour, Et le Seigne ur a mis son crime au jour;
Luy meſme par ſa bouche affermit ma croyance;	Lui même par sa bouche affermit ma croyance;
Le Ciel qui l’aueugloit, permit cette imprudance;	Le Ciel qui l'aveuglait, permit cette imprudance;
Ce lâche empoiſonneur ſe vint luy-meſme offrir;	Ce lâche empoisonneur se vint lui-même offrir;
Ma joye ayda beaucoup à le mieux découurir:	Ma joie aida beaucoup à le mieux découvrir:
Cette alteration que ſouffrit mon viſage, Qu'il deuoit expliquer à ſon deſauantage, Qu'il dût attribuer à mon étonnement, Parut à ce credule vn vray conſentement:	Cette altération que souffrit mon visage, Qu'il devait expliquer à son désavantage, Qu'il dût attribuer à mon étonnement, Parut à ce crédule v rai consentement:
I’arrachay ſes ſecrets, i’appris toute ſa vie, Que mon Druſe eſtoit mort pour l’amour de Liuie, Que la mort de Tybere en ſeroit vn effet, Et qu'elle auoit cauſé tout ce qu’il auoit fait.	J'arrachai ses secrets, j'appris toute sa vie, Que mon Druse était mort pour l'amour de Livie, Que la mort de Tibère en serait un effet, Et qu'elle avait causé tout ce qu'il avait fait.
Voy l’inégalité des mouuemens de l’ame, Des reſolutions que ſe forme vne femme;	Vois l'inégalité des mouvements de l'âme, Des résolutions que se forme quelque femme;
Je le voulois connoistre, & voulois éclater;	Je le voulais connaître, et voulais éclater;
Et l’ayant reconnu, ie le voulois flatter:	Et l'ayant reconnu, Seigneur le voulais flatter:
Jndigne complaiſance, où tu me vois forcée, Di ma langue eſt contrainte à trahir ma penſée!	Indigne complaisance, où tu me vois forcée, Di ma langue est contrainte à trahir ma pensée!
LVIE.	LVIE.
La ſaiſon veut de vous de tels abaiſſemens.	La saison veut de vous de tels abaissements.
I IE.	I IE.
N’ay-je point prattiqué tous ces déguiſemens?	N'ai-je point prattiqué tous ces déguisements?
Auroit on pû deffendre à plus de complaiſance?	Aurait on pu défendre à plus de complaisance?
Tant qu’il a fallu feindre, on a veu ma prudence;	Tant qu'il a fallu feindre, on a vu ma prudence;
Je me reputerois indigne de mon rang;	Je me réputerais indigne de mon rang;
mnuus grums jemimens que me donne vn beau ſang, Vne Niece d’Auguſte auroit cette baſſeſſe?	mnuus grums jemimens que me donne un beau sang, Une Nièce d'Auguste aurait cette bassesse?
Une bru de Tybere auroit cette foibleſſe?	Une bru de Tibère aurait cette faiblesse?
Et la vefue de Druſe vn ſentiment ſi bas?	Et la vue de Druse un sentiment si bas?
LVIE.	LVIE.
Le grand cœur d’Agrippine a cauſé ſon trépas, Voſtre longue prudence eſt encore neceſſaire.	Le grand cœur d'Agripine a causé son trépas, Votre longue prudence est encore nécessaire.
LIVIE.	LIVIE.
N’importe, entreprenons ce qu’elle n’a pû faire;	N'importe, entreprenons ce qu'elle n'a pu faire;
Ce temeraire Amant me demande aujourd’huy, Espouſons le trépas, auant que d’eſtre à luy:	Ce téméraire Amant me demande aujourd'hui, Espousons le trépas, avant que d'être à lui:
Châcun de ſon coſté va faire vvne requefte;	Châcun de son côté va faire vune requête;
Luy demande mon cœur, & moy ie veux ſa teſte.	Lui demande mon cœur, et moi -même veux sa tête.
Cher Druſe, cher Espoux, ie t’offre ce preſent, Et ie t’immole apres vn cœur ſi complaiſant!	Cher Druse, cher Époux, on t'offre ce présent, Et notre t'immole après un cœur si complaisant!
Oüy, ie le vay punir d’vn delay ſi timide, Et d’auoir ſi long-temps ſouffert ton homicide.	Oui, Seigneur le vais punir d'un délai si timide, Et d'avoir si longtemps souffert ton homicide.
LVIE.	LVIE.
nopre mruje estuuimon, ie vous offre vn Espoux;	nopre mruje estuvimon, je vous offre un Époux;
Vn autre de ce nom est-il digne de vous?	Un autre de ce nom est-il digne de vous?
At reſte precrenxe de bir matjon to aanguſte.	At reste précrenxe de bir matjon to aanguste.
Pleurons!	Pleurons!
LIVIE.	LIVIE.
LVIE.	LVIE.
Foibleſſe inſigne, autant qu'elle eſt injuſte!	Faiblesse insigne, autant qu'elle est injuste!
L’ame doit reuenir de ces longues douleurs.	L'âme doit revenir de ces longues douleurs.
I IE.	I IE.
Non pas quand noſtre perte a merité nos pleurs.	Non pas quand notre perte a mérité nos pleurs.
Me puis-je conſoler d’vne perte ſi chere?	Me puis-je consoler d'une perte si chère?
Luy, n’eſt-il point touché de la mort de ſon pere?	Lui, n'est-il point touché de la mort de son père?
Dis-luy, s’il a du cœur, autant qu’il a d’amour, Qu'il vienne auecque moy ſignaler ce beau iour;	Dis-lui, s'il a du cœur, autant qu'il a d'amour, Qu'il vienne avec moi signaler ce beau jour;
Qu’il me ſecondera dans cette noble enuie, Et que c’eſt le ſecret de meriter Liuie.	Qu'il me secondera dans cette noble envie, Et que c'est le secret de mériter Livie.
Sejan vous a ſurpriſe.	Séjan vous a surprise.
LVIE.	LVIE.
Sejan entraue,	Séjan entrave,
LIVIE.	LIVIE.
O ſpectacle odieux!	Ô spectacle odieux!
Ma bouche encore vn coup, vas-tu trahir mes yeux?	Ma bouche encore un coup, vas-tu trahir mes yeux?
Mon cœur, peux-tu ſouffrir cet indigne artifice?	Mon cœur, peux-tu souffrir cet indigne artifice?
Où̈y, trahiſons vn traiſtre!	Oui, trahisons un traître!
LENEII LVIE à l’écart, SEIAN, LIVIE.	LENEII LVIE à l'écart, SEIAN, LIVIE.
EIAN.	EIAN.
T bien, chere complice, La Fortune & les Dieux ſecondent nos deſirs, Et ie vay dans ce iour conſommer mes plaiſirs, Par la poſſe ßion des beautez de Liuie!	T bien, chère complice, La Fortune et les Dieux secondent nos désirs, Et ie vais dans ce jour consommer mes plaisirs, Par la posse ssion des beautés de Livie!
Joüiſſance, où ie mets le repos de ma vie!	Jouissance, où belle mets le repos de ma vie!
Elle a toûjours esté le but de mes ardeurs;	Elle a toujours été le but de mes ardeurs;
Pour y mieux paruenir, i’y vay par les grandeurs:	Pour y mieux parvenir, j'y vais par les grandeurs:
L’ambition me menne où mon amour aspire, Ainſi vous m’éleuez pour monter à l’Empire;	L'ambition me menne où mon amour aspire, Ainsi vous m'élevez pour monter à l'Empire;
Et le Troſne me ſert pour aller juſqu’à vous, Ainſi l’égalité ſera mieux entre nous;	Et le Trône me sert pour aller jusqu'à vous, Ainsi l'égalité sera mieux entre nous;
Le rang d’vn fauory n'eſt pas conſiderable, Si le moindre caprice en fait vn miſerable;	Le rang d'un favori n'est pas considérable, Si le moindre caprice en fait un misérable;
La volonté du Prince a trop de changemens, Et c’eſt mal s’établir, que ſur ces fondemens.	La volonté du Prince a trop de changements, Et c'est mal s'établir, que sur ces fondements.
Le pouuoir exceßif que Tibere me donne, Les charges qu’il vnit dans ma ſeule perſonne, Ce nombre de faueurs dont ie me vois comblé, Ce grand amas d’honneur dont ie ſuis accablé, Ne compoſent enfin qu’vne grandeur commune, Et ne ſont que des dons que i’ay de la Fortune;	Le pouvoir excemif que Tibère me donne, Les charges qu'il vnit dans ma seule personne, Ce nombre de faveurs dont grande me vois comblé, Ce grand amas d'honneur dont grands suis accablé, Ne composent enfin qu'une grandeur commune, Et ne sont que des dons que j'ai de la Fortune;
Preſens, que ie ne vois que d’vn œil de mépris, Toùjours preſt à les rendre, ainſi que ie les pris!	Presens, que venir ne vois que d'un œil de mépris, Toùjours prêt à les rendre, ainsi que ie les pris.
Je vous parois, ſans doute, vn temeraire inſigne;	Je vous parais, sans doute, un téméraire insigne;
Mais pour vous poſſeder, ie dû m'en rendre digne Ie crû que ma grandeur auroit quelques appas, Et qu'elle auroit en foy;	Mais pour vous posséder, je dû m'en rendre digne Je crus que ma grandeur aurait quelques appas, Et qu'elle aurait en foi;
uuquore muuois pas.	Ouquore muois pas.
LIVIE.	LIVIE.
Quelque éclat étranger qu’apporte vne Couronne, Sejan luy donne plus, que ce qu'elle luy donne.	Quelque éclat étranger qu'apporte une Couronne, Séjan tu donne plus, que ce qu'elle lui avait.
EIAN.	EIAN.
C’eſt vous dont le merite honnoreroit vn rang Qui vous eſt deſia dû par la faueur du ſang 4 L'Empire vous attend, & le Ciel eſt trop juste, Pour ne vous point placer ſur le Troſne d’Auguſté:	C'est vous dont le mérite honorerait un rang Qui vous est déjà dû par la faveur du sang 4 L'Empire vous attend, et le Ciel est trop juste, Pour ne vous point placer sur le Trône d'Augusté:
C’eſt vn droict dont les Dieux ne vous ſçauroiẽt priuer, Et le Ciel par ma main vous y veut éleuer, Vous va reſtituer cette haute puiſſance, Et rendre à vos vertus vn droict de la naiſſance;	C'est un droit dont les Dieux ne vous sauraient priver, Et le Ciel par ma main vous y veut élever, Vous va restituer cette haute puissance, Et rendre à vos vertus un droit de la naissance;
Auec trop de Juſtice vn Sceptre vous eſt dû;	Avec trop de Justice un Sceptre vous est dû;
Mais bien ſouuent, ſans crime, vn droict n’eſt pas rendu:	Mais bien souvent, sans crime, un droit n'est pas rendu:
Il faut exterminer les enfans d’Agripine, de pomne en nojouuom noppuuo uu ruvtnie;	Il faut exterminer les enfants d'Agripine, de pomne en nouveau noppuojuo uu ruvtnie;
Il faut iuſqu'au dernier employer le poiſon, Et iuſqu’aux fondemens détruire la maiſon.	Il faut jusqu'au dernier employer le poison, Et jusqu'aux fondements détruire la maison.
LIVIE.	LIVIE.
Sejan, n’attentez point contre le ieune Druſe?	Séjan, n'attentez point contre le jeune Druse?
ETAN.	ETAN.
Quand vn Sceptre eſt offert, voſtre main le refuſe?	Quand un Sceptre est offert, votre main le refuse?
L’heritier d’Agripine aura le meſme orgueil, Que ſa mere a porté iuſque dans ſon cercueil?	L'héritier d'Agripine aura le même orgueil, Que sa mère a porté jusqu dans ' cercueil?
VIE.	VIE.
Il faut entre vos coups mettre quelque interualle;	Il faut entre vos coups mettre quelque intervalle;
Des meurtres ſi frequens cauſeroient vn ſcandale;	Des meurtres si fréquents causeraient un scandale;
Et deſia l’apparence a fait croire aux Romains, Que ie participois dans vos moindres deſſeins.	Et déjà l'apparence a fait croire aux Romains, Que tu participais dans vos moindres desseins.
AN.	AN.
Madame, i'auray ſoin de voſire renommée;	Madame, j'aurai soin de vosire renommée;
Je le feray perir au milieu d’vne armée;	Je le ferai périr au milieu d'une armée;
Sout couleur d’employer le Neveu des Ceſars, Ie vay l'abandonner au milieu des hazars.	Sout couleur d'employer le Neveu des Césars, Je vais l'abandonner au milieu des hasards.
LIVIE.	LIVIE.
Le mejme expediem ne peruu pas ſon pere, Et contre voſtre espoir, ſon ſort luy fut proſpere.	Le mejme expédiem ne perv pas son père, Et contre votre espoir, son sort lui fut prospère.
IAN.	IAN.
Il n’a pû ſe ſoûtraire aux ruſes de Piſon;	Il n'a pu se soustraire aux ruses de Pison;
Qui ſe ſauua du fer, mourut par le poiſon;	Qui se sauva du fer, mourut par le poison;
Si proche de regner, tout nous eſt legitime, Ente vuy coutonner vustre feſte & mon crime;	Si proche de régner, tout nous est légitime, Ente vi coutonner vustre fête et mon crime;
Le Troſne eſt deuant nous, & derriere vn tombeau;	Le Trône est devant nous, et derrière un tombeau;
8 uel ſpectacle des deux vous paroist le plus beau?	8 spectacle des deux vous paroist le plus beau?
Marchons vers le premier, la veuë en eſt plus belle.	Marchons vers le premier, la vue en est plus belle.
LIVIE.	LIVIE.
La conjuration, en quel eſtat eſt-elle?	La conjuration, en quel état est-elle?
EIAN.	EIAN.
Tout m’obeït dans Rome, & ma profuſion Range tous les ſoldats à ma deuotion;	Tout m'obéit dans Rome, et ma profusion Range tous les soldats à ma dévotion;
Et pour former en eux vn ſecours plus facile, Ie les ay reünis dans le cœur de la ville.	Et pour former en eux un secours plus facile, Je les ai réunis dans le cœur de la ville.
De là, ſi ie les porte à des ſouleuemens, Vous les verrez ſe rendre à mes commandemens,	De là, si on les porte à des soulèvements, Vous les verrez se rendre à mes commandements,
Enfoncer auec moy le Palais de Tibere, Sacrifier ſa vie à leur prompte colere;	Enfoncer avec moi le Palais de Tibère, Sacrifier sa vie à leur prompte colère;
Et tous de cette voix, que pouſſe la fureur, A l’aspect des Romains, me créer Empereur.	Et tous de cette voix, que pousse la fureur, A l'aspect des Romains, me créer Empereur.
La charge de Tribun m’eſt encore neceſſaire, Elle ébranle à ſon gré tout l’eſtat populaire;	La charge de Tribun m'est encore nécessaire, Elle ébranle à son gré tout l'état populaire;
Ie me l’aſſujetis par cette authorité;	Je me l'assujet par cette autorité;
Naturellement Rome aime la nouueauté;	Naturellement Rome aime la nouveauté;
Elle, qui dés long-temps vit dans la ſeruitude, Se promet en changeant vn Empire moins rude;	Elle, qui dès longtemps vit dans la servitude, Se promet en changeant un Empire moins rude;
Et d’ailleurs ſon humeur m’étonneroit bien peu;	Et d'ailleurs son humeur m'étonnerait bien peu;
Le naturèl d’vn Peuple agit comme le feu;	Le naturèle d'vn Peuple agit comme le feu;
S’il s’échauffe aiſément à la premiere amorce, Apres ſa violence, il perd toute ſa force:	S'il s'échauffe aisément à la première amorce, Après sa violence, il perd toute sa force:
I’aime mieux m’aſſeurer des premiers du Senat, Et dispoſer les Grands à cet aſſa ßinat;	J'aime mieux m'assurer des premiers du Sénat, Et disposer les Grands à cet assa ssinat;
Ces petits Souuerains trainent la populace;	Ces petits Souverains traînent la populace;
Et leur exemple abat ou ſoûtient ſon audace;	Et leur exemple abat ou soutient son audace;
Ie n’agis point außi comme ces imprudens, Qui ſont foibles dehors, & puiſſans au dedans;	Je n'agis point aussi comme ces imprudents, Qui sont faibles dehors, et puissants au dedans;
I’aime le cabinet, mais ie veux la campagne, Aidé des legions qui ſont dans l’Allemagne;	J'aime le cabinet, mais ainsi veux la campagne, Aidé des légions qui sont dans l'Allemagne;
Et du puiſſant ſecours que leurs Chefs m’ont promis, Ie maintiendray le rang où ie me ſeray mis.	Et du puissant secours que leurs Chefs m'ont promis, Je maintiendrai le rang où ie me serai mis.
Que ne puis-je, aßiſte pur tes troupes fiuelles?	Que ne puis-je, assiste pur tes troupes fivelles?
Par vn Courrier exprés, i'en attens des nouuelles;	Par un Courrier exprès, j'en attends des nouvelles;
Juſqu’à ſon arriuée, on n’entreprendra rien;	Jusqu'à son arrivée, on n'entreprendra rien;
Son ordre eſtant venu, ie donneray te mien.	Son ordre étant venu, Seigneur donnerai te mien.
LIVIE.	LIVIE.
Ie ne ſçay qu'aumtrer uuns on fi gama onurage, Ou de voſtre prudence, ou de voſtre courage.	Je ne sais qu'aumtrer uuns on fi gama onurage, Ou de votre prudence, ou de votre courage.
EIAN.	EIAN.
Mais comme mes deſſeins veulent quelque longueur, Ne me rejettez plus dedans cette langueur?	Mais comme mes desseins veulent quelque longueur, Ne me rejettez plus dedans cette langueur?
Et dans ce long espoir qui menaçoit ma vie, Que ie regne à loiſir, mais poſſedant Liuie!	Et dans ce long espoir qui menaçait ma vie, Que Que regne à loisir, mais possédant Livie!
Dans l’attente d’vn Sceptre on ſe peut conſoler, Mais, Madame, en amour l’on ne peut reculer;	Dans l'attente d'un Sceptre on se peut consoler, Mais, Madame, en amour l'on ne peut reculer;
Ie ne puis differer vn moment dauantage.	Je ne puis différer un moment davantage.
LIVIE.	LIVIE.
Voyez donc l’Empereur, touchant ce mariage.	Voyez donc l'Empereur, touchant ce mariage.
EIAN.	EIAN.
Jl faut par vn écrit ſçauoir ſa volonté;	Il faut par un écrit savoir sa volonté;
C’eſt comme il faut traitter auec ſa Majeſté;	C'est comme il faut traiter auec sa Majesté;
La loy ne permet pas dans de pareilles cauſes, Qu'on luy donne autrement connoiſſance des choſes;	La loi ne permet pas dans de pareilles causes, Qu'on lui donne autrement connaissance des choses;
Terence de ma part ira luy preſenter, Et ſur cet hymenée, il le pourra tenter:	Terence de ma part ira ainsi présenter, Et sur cet hyménée, il le pourra tenter:
Que ma femme en cecy me traitte d’infidelle, Un diuorce bien-toſt me va défaire d’elle;	Que ma femme en ceci me traite d'infidèle, Un divorce bientôt me va défaire d'elle;
Et meſme apres le cours de ſon reſſentiment, Ie veux qu’elle authoriſe vn ſi beau changement.	Et même après le cours de son ressentiment, Je veux qu'elle autorise un si beau changement.
panitauo io touonons, uiemmcureuje iournée;	panitavo jo touonons, uiemcureuje journée;
Qui te va celebrer par ce grand hymenée!	Qui te va célébrer par ce grand hyménée!
LIVIE.	LIVIE.
Je vay dedans ma chambre attendre vn ſi beau iour;	Je vais dedans ma chambre attendre un si beau jour;
Ie veux voir, comme vous, la fin de cette amour.	Je veux voir, comme vous, la fin de cette amour.
AN.	AN.
J'auray iuſqu’à ce temps la meſme impatience,	J'aurai jusqu'à ce temps la même impatience,
L’IVIE en s’en allant, & bas.	L'IVIE en s'en allant, et bas.
Tu l’as pour ton amour, & moy pour ma vengeance;	Tu l'as pour ton amour, et moi pour ma vengeance;
Il ne vient que trop tard.	Il ne vient que trop tard.
IAN ſeul.	IAN seul.
O fortuné moment!	Ô fortuné moment!
Je me ſens approcher de mon contentement!	Je me sens approcher de mon contentement!
O l’incommode objet!	Ô l'incommode objet!
ô l’importune approche Fuyons cette ialouſe?	ô l'importune approche Fuyons cette jalouse?
éuitons ſon reproche.	éviterons son reproche.
SCENE III.	SCÈNE III.
SEIAN, APICATA, VOLVZIE.	SEIAN, APICATA, VOLVZIE.
APICATA.	APICATA.
On, non, Sejan, arreſte?	On, non, Séjan, arrête?
& ne crains rien de moy?	et ne crains rien de moi?
IN Ie viens authoriſer ton manquement de foy;	IN Je viens autoriser ton manquement de foi;
Ie te cede à Liuie, & luy quitte la place;	Je te cède à Livie, et Seigneur quitte la place;
D'vn esprit moderé ie ſouffre ma diſgrace;	D'un esprit modéré ici souffre ma disgrâce;
Puis qu’elle contribuë à ton contentement, Et qu’elle ſemble ayder à ton auancement, Sejan n’eſtoit point né pour de baſſes fortunes, Ny moins pour s’allier à des maiſons communes;	Puis qu'elle contribue à ton contentement, Et qu'elle semble aider à ton avancement, Séjan n'était point né pour de basses fortunes, Ni moins pour s'allier à des maisons communes;
Les Dieux luy reſeruoient la niepce des Ceſars, Liuie estoit acquiſe à ſes moindres regards.	Les Dieux était réservaient la niepce des Césars, Livie était acquise à ses moindres regards.
Va, ſans me regarder, où ton bon-heur t’appelle;	Va, sans me regarder, où ton bonheur t'appelle;
Appaiſe, inſatiable, vne ſi viue ardeur, Et gouſte, ambitieux, des fruits de ta grandeur:	Apaise, insatiable, une si vive ardeur, Et goûte, ambitieux, des fruits de ta grandeur:
Mais fais reflexion qu’elle eſt ſouuent fatale;	Mais fais réflexion qu'elle est souvent fatale;
Prens-en, te défiant, la dot de ma riuale;	Prends-en, te défiant, la dot de ma rivale;
Et quelque grand credit que tu t’en ſois promis, Apprens à ſoupçonner le don des ennemis.	Et quelque grand crédit que tu t'en sois promis, Apprends à soupçonner le don des ennemis.
As-tu d’autres ſujets d’abandonner ta femme?	As-tu d'autres sujets d'abandonner ta femme?
Helas!	Hélas!
IAN.	IAN.
TeAEA.	TeAE.
Te repens-tu?	Te repens-tu?
SEIAN.	SEIAN.
Que ne vois- tu mon ame!	Que ne vois- tu mon âme!
ICATA.	ICACTA.
Je ne la veux point voir, cache là moy toûjours;	Je ne la veux point voir, cache là moi toujours;
Ne me decouure point tes nouuelles amours;	Ne me découvre point tes nouvelles amours;
Le ſoupçon que i’en ay ne m’eſt que trop funeſte;	Le soupçon que j'en ai ne m'est que trop funeste;
8 Que dis je, le ſoupçon!	8 Que dis -je, le soupçon!
ta flame eſt manifeſte?	ta flamme est manifeste?
C'eſt d’vn espoir trop vain que i’oſe me flater;	C'est d'un espoir trop vain que j'ose me flatter;
Le feu que tu cachois, va bien-toſt éclater.	Le feu que tu cachais, va bientôt éclater.
Cruel, éclaircis nous d’vn amour ſi viſible?	Cruel, éclaircis nous d'un amour si visible?
DLVZIE.	DLVZIE.
Seigneur, à tant de voix ſerez vous inſenſible;	Seigneur, à tant de voix serez -vous insensible;
La Nature vous parle, & l’honneur, & la foy.	La Nature vous parle, et l'honneur, et la foi.
AN.	AN.
Ie ſçay bien mon deuoir, & ce qu’il peut ſur moy;	Je sais bien mon devoir, et ce qu'il peut sur moi;
Ie cheris mes enfans à l'égal de moy-meſme, Et Rome a pû connoiſtre à quel poinct ie les aime;	Je chéris mes enfants à l'égal de moi-même, Et Rome a pu connaître à quel point ici les aime;
Tous les jours ie trauaille à voſtre auancement, Et cherche à procurer voſtre établiſſement.	Tous les jours nom travaille à votre avancement, Et cherche à procurer votre établissement.
A d’auguſtes partis ie vous ay fait pretendre;	À d'augustes partis Seigneur vous ai fait prétendre;
Apres vn Claudius, vn Terence eſt mon Gendre:	Après un Claudius, un Terence est mon Gendre:
Receuez, de ma main vn ſi celebre Espoux, Et reconnoiſſez mieux ce que ie fais pour vous.	Recez, de ma main un si célèbre Espoux, Et reconnais mieux ce que ie fais pour vous.
Conſolez vous, Madame;	Consolez -vous, Madame;
Adieu, viuez contente.	Adieu, vivez contente.
NCENET APICATA, VOLVZIE.	NCENET APICATA, VOLVZIE.
APICATA.	APICATA.
O Ette brutale amour eſt enfin éuidente.	Ô Ôte brutale amour est enfin évidente.
Le puis je conceuoir 3 OLVZIE.	Le puis je concevoir 3 OLVZIE.
PICATA.	PICATA.
Tu n’en dois plus douter, Et meſme ſans horreur tu ne peux m'écouter.	Tu n'en dois plus douter, Et ainsi sans horreur tu ne peux m'écouter.
Ah, ſexe imperieux!	Ah, sexe impérieux!
ab, puiſſance exceßiue!	ab, puissance excemive!
Le mary prend des droicts dont luy-meſme nous priue!	Le mari prend des droits dont lui-même nous prive!
Il decide à ſon gré de tous ſes differens!	Il décide à son gré de tous ses différents!
Il nous faut obſeruer la loy de ſes tyrans!	Il nous faut observer la loi de ses tyrans!
qoejutpouifui nom ta puiſfance d’un maiſtre, Et nous mettent au joug, ſans s’y vouloir ſoûmettre!	qojutpouifui nom ta puissance d'un maître, Et nous mettent au joug, sans s'y vouloir soumettre!
JLVZIE.	JLVZIE.
Jl vous dût dispenſer d’vne commune loy.	Il vous dut dispenser d'une commune loi.
APICATA.	APICATA.
Encor ſeroit-ce peu de me manquer de foy;	Encor serait-ce peu de me manquer de foi;
Jl eſt bien plus coupable;	Il est bien plus coupable;
apprens ſes autres crimes, Et voy ſi mes ſoupçons ſont icy legitimes:	apprends ses autres crimes, Et vois si mes soupçons sont ici légitimes:
Il établit ſon regne auec beaucoup de ſang Et la mort par ſon ordre alla de rang en rang Sa main ſe fit hardie à force de grands crimes;	Il établit son règne avec beaucoup de sang Et la mort par son ordre alla de rang en rang Sa main se fit hardie à force de grands crimes;
Il ſe fit immoler des augustes victimes;	Il se fit immoler des augustes victimes;
Le grand Germanicus luy fut ſacrifié;	Le grand Germanicus a fut sacrifié;
Le Senat ſoupçonneux s’en eſtoit dé fié:	Le Sénat soupçonneux s'en était de fié:
Mais malgré ſon ombrage, il ſe fallut contraindre;	Mais malgré son ombrage, il se fallut contraindre;
Rome, par habitude, auoit appris à feindre;	Rome, par habitude, avait appris à feindre;
Le Prince eſtoit meſlé dans ce grand attentat;	Le Prince était mêlé dans ce grand attentat;
Sejan l’interreſſoit dans tous ces coups d’eſtat:	Séjan l'interressait dans tous ces coups d'état:
Il ne voit pas außi que ce faux Politique, Se veut feruir de luy contre la Republique;	Il ne voit pas aussi que ce faux Politique, Se veut servir de peine contre la République;
Et qu’il veut l’employer en tant de lâchetez, Comme vn inſtrument propre à ces meſchantez.	Et qu'il veut l'employer en tant de lâcheté, Comme un instrument propre à ces méchantez.
Ainſi par ce ſecret, l’vn & l’autre ſe joüe;	Ainsi par ce secret, l'une et l'autre se joue;
Il décharge Tybere, & Tybere l’auoüe;	Il décharge Tibère, et Tibère l'auoüe;
Druze eſtoit vn obſtacle aux deſſeins qu’il auoit;	Druze était un obstacle aux desseins qu'il avait;
Auec auidité Sejan le pourſuiuoit;	Avec auidité Séan le poursuivait;
Il fut empoiſonné par les mains de Liuie, l fuitamvenquacoluueque ſuuentiie, Et qui pour s’attirer l’amour d’vn fauory, Uoulut contribuer à la mort d’vn mary.	Il fut empoisonné par les mains de Livie, l fuitamuenquacoluveque suentiie, Et qui pour s'attirer l'amour d' Havori, Uoulut contribuer à la mort d'un mari.
LVZIE.	LUZIE.
Quoy, Madame, Liuie eſt donc ſi criminelle!	Quoi, Madame, Livie est donc si criminelle!
PICATA.	PICATA.
C’eſt là le ſentiment que les Romains ont d’elle;	C'est là le sentiment que les Romains ont d'elle;
Dans tous les cabinets ce grand bruit a couru, Et les moins ſcrupuleux, & l’ont dit, & l’ont crû;	Dans tous les cabinets ce grand bruit a couru, Et les moins scrupuleux, et l'ont dit, et l'ont cru;
Meſme le bruit eſt tel, qu’ils ont trompé Tybere, Que leur bouche a rendu le fils ſuspect au pere, Et que ce diferend, ſurpris par leur rapport, Commit à ces Amans le genre de ſa mort:	Même le bruit est tel, qu'ils ont trompé Tibère, Que leur bouche a rendu le fils suspect au père, Et que ce dierend, surpris par leur rapport, Commit à ces Amants le genre de sa mort:
Ce qui donna du poids à cette erreur publique, Fut qu’il ne pleura point la mort d’vn fils vnique, Et que feignant dans l’ame vn excés de douleurs, Ce cœur dißimulé luy refuſa des pleurs.	Ce qui donna du poids à cette erreur publique, Fut qu'il ne pleura point la mort d'un fils unique, Et que feignant dans l'âme un excès de douleurs, Ce cœur dissimulé cv sa des pleurs.
Ainſi, comme l'Amour, le meurtre les aſſemble;	Ainsi, comme l'Amour, le meurtre les assemble;
Et de ces entretiens qu’ils ont touſiours enſemble, L’on peut bien preſumer qu’apres cette fureur, Ils ont pù concerter la mort de l’Empereur.	Et de ces entretiens qu'ils ont toujours ensemble, L'on peut bien présumer qu'après cette fureur, Ils ont pù concerter la mort de l'Empereur.
Lâche & cruel Sejan.	Lâche et cruel Séjan.
OLVZIE.	OLVZIE.
C’eſt voſtre Eſpoux, Madame.	C'est votre Époux, Madame.
APICATA.	APICATA.
O Dieux!	Ô Dieux!
a-t’il fallu que ie fuſſe ſa femme!	a-t-il fallu que ici fusse sa femme!
Puis qu’il m'eſt deffendu d’offencer mon Espoux, Contre mon ennemie, éclatte mon courroux?	Puis qu'il m'est défendu d'offenser mon Époux, Contre mon ennemie, éclatte mon courroux?
Rigoureuſe vertu, ſouffre que ie la voye, Que i'aille par ma plainte interrompre ſa joye, Et que jans oiier ce que le don à l'on, J'aille donner à l’autre vn ſpectacle importun?	Rigoureuse vertu, souffre que je la voie, Que j'aille par ma plainte interrompre sa joie, Et que jans oile ce que le don à l'on, J'aille donner à l'autre un spectacle importun?
VOLVZIE.	VOLVZIE.
Madame, où courrez-vous?	Madame, où courrez-vous?
APICATA.	APICATA.
Ie vais voir ma riuale;	Je vais voir ma rivale;
Ie vay par elle meſme apprendre ce ſcandale;	Je vais par elle -même apprendre ce scandale;
Et quoy que ce ſecret, ne me ſoit plus douteux, Apprendre par ſa boucne vn Hymen ſi ponteux.	Et quoi que ce secret, ne me soit plus douteux, Apprendre par sa boucne un Hymen si ponteux.
Fin du Premier Acte.	Fin du Premier Acte.
TICTE TT	TICTE TT
SCENE INEMIENE DRVSE, F *LVIE.	SCÈNE INEMIENE DRUZE, F *LVIE.
R SE.	 RE.
& Ourquoy, chere Fulute, as-tu fait voir ma flâme?	et Ourquoy, chère Fulute, as-tu fait voir ma flamme?
& Pourquoy luy montrois-tu les ſecrets de mõ ame?	et Pourquoi Dieu montrais-tu les secrets de mon âme?
Que n’a-t’elle point dit contre ma vanité?	Que n'a-t-elle point dit contre ma vanité?
N’a-t'elle point rougy de ma temerité?	N'a-t'-elle point rougi de ma témérité?
VLVIE.	VLVIE.
Prenez en quelque eſpoir, puis qu'elle l’a ſoufferte.	Prenez en quelque espoir, puis qu'elle l'a soufferte.
SE.	SE.
N'as-tu point veu ſes yeux qui preſageoient ma perte?	N'as-tu point vu ses yeux qui présageaient ma perte?
Ses yeux tous indignez, tous remplis de courroux, D’où la haine chaſſoit ce qu’ils auoient de doux.	Ses yeux tous indignés, tous remplis de courroux, D'où la haine chassait ce qu'ils avaient de doux.
Elle perdroit Sejan!	Elle perdrait Séjan!
LVIE.	LVIE.
Vous vous troublez vous-meſme.	Vous vous troublez vous-même.
Oſai-je me flatter?	Osai-je me flatter?
NVSE.	NUSE.
EvlE.	ÉvlE.
SçacheZ qu’elle vous aime.	Sachez qu'elle vous aime.
E.	E.
Temeraire ſoupçon qu'vne ville a conceu!	Teméraire soupçon qu'une ville a conçu!
Soupçon malicieux, que i'ay ſi bien receu!	Soupçon malicieux, que j'ai si bien reçu!
Legere opinion, tu m'as fait faire vn crime!	Légère opinion, tu m'as fait faire un crime!
oucais quoy?	oucais quoi?
cette creance eſtoit trop legitime;	cette créance était trop légitime;
En cecy l’apparence eſtoit toute pour moy, Et le plus incredule auroit donné ſa foy.	En ceci l'apparence était toute pour moi, Et le plus incrédule aurait donné sa foi.
Liuie eſt innocente!	Livie est innocente!
O Dieux, qui l’euſt pù croire?	Ô Dieux, qui l'eût pù croire?
LVIE.	LVIE.
Elle va recouurer ce qu’elle a moins de gloire;	Elle va recouvrer ce qu'elle a moins de gloire;
Et juſques à ce iour, tant de momens perdus, Luy ſeront par vn ſeul heureuſement rendus.	Et jusques à ce jour, tant de moments perdus, Lui seront par un seul heureusement rendus.
E.	E.
Loin de la condamner, i’appreuue ſa prudence.	Loin de la condamner, j'approuve sa prudence.
Allons la voir, Fuluie.	Allons la voir, Fuluie.
VLVIE.	VLVIE.
Elle-meſme s’auance.	Elle-même s'avance.
RVSE.	RUSE.
Dieux:	Dieux:
pur quer mouuemionn uiuom joupreſté ę Dans mon premier respect, ie me ſens rejetté.	pur quer mouuemionn uivom joupresté Dans mon premier respect, ie me sens rejetté.
CENEIE DRVSE, LIVIE, FVLVIE.	CENEIE DRUZE, LIVIE, FULVIE.
E.	E.
VE n’eus-tu, ma Fuluie, vn peu de retenuë, 2 Ma paßion encor luy ſeroit inconnuë, Et ie n’attendrois pas de ma temerité, L’arreſt qu’elle medite, & que i’ay merité.	VE n'eus-tu, ma Fuluie, un peu de retenue, 2 Ma passion encor lui était inconnue, Et jusqu'attendrais pas de ma témérité, L'arrêt qu'elle médite, et que j'ai mérité.
Oüy, Madame, éclattez contre ce temeraire;	Oui, Madame, éclattez contre ce téméraire;
DeffendeZ de parler à qui n’a pû ſe taire.	Défendez de parler à qui n'a pu se taire.
IE.	JE.
Druſe, il ſe faut porter à de hauts ſentimens, Et ne iamais deſcendre en ces bas complimens;	Druse, il se faut porter à de hauts sentiments, Et ne jamais descendre en ces bas compliments;
24 Des termes ſi communs ſentent trop leur foibleſſe, Ce ne ſont point amours de Prince & de Princeſſe;	24 Des termes si communs sentent trop leur faiblesse, Ce ne sont point amours de Prince et de Princesse;
Cette façon d’aimer ſied bien aux Citoyens, Mais il faut m'acquerir par de nobles moyens.	Cette façon d'aimer sied bien aux Citoyens, Mais il faut m'acquérir par de nobles moyens.
Enfin, ſi vous m'aymez, faites-le moy paroiſtre, Montrez vous aujourd’huy, ce que vous deuez eſtre.	Enfin, si vous m'aimez, faites-le moi paraître, Montrez -vous aujourd'hui, ce que vous devez être.
Et dignes des parens dont vous tenez le iour.	Et dignes des parents dont vous tenez le jour.
RVSE.	RUSE.
Vous ſouffriez par raiſon, i'endurois par amour.	Vous souffriez par raison, j'endurais par amour.
Oſois je conſpirer contre vne chere vie, Et pouuois ie attenter ſur l’Amant de Liuie?	Osais je conspirer contre une chère vie, Et pouvais quelque attenter sur l'Amant de Livie?
Quoy?	Quoi?
dedans cette erreur qu’il fut aimé de vous, I'aurois percé ſon cœur de mille & mille coups;	dedans cette erreur qu'il fut aimé de vous, J'aurais percé son cœur de mille et mille coups;
Ie l’euſſe aſſa ßiné dedans cette croyance.	Je l'eusse assa ssiné dedans cette croyance.
Ah!	Ah!
Madame, l’Amour deſarmoit ma vengeance;	Madame, l'Amour désarmait ma vengeance;
Vous ſeule reteniez & ſuspendiez mon bras:	Vous seule reteniez et suspendiez mon bras:
Oùy, mille fois ſans vous, i’auançois ſon trépas;	Oui, mille fois sans vous, j'avançais son trépas;
Ie l’aurois immolé dans le ſein de Tybere, A l’ombre d’Agripine, aux manes de mon pere;	Je l'aurais immolé dans le sein de Tibère, A l'ombre d'Agripine, aux mânes de mon père;
Le fer ouuertement m’eut vengé du poiſon, Et du cruel autheur des maux de ma maiſon;	Le fer ouuertement m'eut vengé du poison, Et du cruel auteur des maux de ma maison;
Et pour rendre à mon gré ma vengeance plus pleine, Un peu de ialouſie tut augmenit m naine;	Et pour rendre à mon gré ma vengeance plus pleine, Un peu de jalousie tut augménit m aine;
Ie l’euſſe redoublée à l'objet d’vn riual.	Je l'eusse redoublée à l'objet d'un rival.
LIVIE.	LIVIE.
LIVIE.	LIVIE.
Ce premier mouuement vout eut eſté fatal;	Ce premier mouvement vout eut été fatal;
Vous y pouuiez perir auec vn grand courage.	Vous y pouviez périr ainsi un grand courage.
E.	E.
I’y tomberay du moins auec quelque auantage;	J'y tomberai du moins avec quelque avantage;
Et ſi les grands perils me doiuent accabler, J’inspireray la crainte à qui fait tout trembler;	Et si les grands périls me doivent accabler, J'inspirerai la crainte à qui fait tout trembler;
Je le feray pâlir au milieu de ſa ſuitte.	Je le ferai pâlir au milieu de sa suitte.
E.	E.
Geſt uuoin on grunu cœuraute peu de conduite;	Gêt uoin on grunu cœuraute peu de conduite;
C’eſt n’eſtre pas vengé, que de l’eſtre à demy;	C'est n'être pas vengé, que de l'être à demi;
Cupifuiu omeuuu ſpeciuciuuuu jeux d'vn ennemy, Qui ſans eſtre en danger voit de loin noſtre perte.	Cupifuiu omeuuu speciuciuuuu jeux d'un ennemi, Qui sans être en danger voit de loin notre perte.
Il eſt beau de tenter vne entrepriſe ouuerte.	Il est beau de tenter une entreprise ouverte.
E.	E.
Quoy?	Quoi?
forcer ſon Palais, les armes à la main!	forcer son Palais, les armes à la main!
Ozer ce que ne peut tout le peuple Romain!	Ozer ce que ne peut tout le peuple Romain!
La grandeur de Sejan eſt trop bien établie;	La grandeur de Séjan est trop bien établie;
Il n'eſt rien de puiſſant, que ſon bras n’humilie;	Il n'est rien de puissant, que son bras n'humilie;
Son joug s’eſt étendu par tout cet Uniuers;	Son joug s'est étendu par tout cet Univers;
Ce monſtre de Fortune a tout mis dans ſes fers:	Ce montre de Fortune a tout mis dans ses fers:
Si le pouuoir des Dieux n’entreprenoit ſa perte, Rome ne l’oſe pas dedans la force ouuerte;	Si le pouvoir des Dieux n'entreprenait sa perte, Rome ne l'ose pas dedans la force ouuerte;
Rome aujourd’huy domptée, & ſi fiere autrefois, De qui le grand orgueil ne pût ſouffrir des Rois, Eſt aujourd’huy ſoümiſe au caprice d’vn homme, Digne d’aſſujettir cette orgueilleuſe Rome!	Rome aujourd'hui domptée, et si fière autrefois, De qui le grand orgueil ne pût souffrir des Rois, Est aujourd'hui s' au caprice s'un homme, Digne d'assujettir cette orgueilleuse Rome!
Le premier des Ceſars eſt pleinement vengé, Il voit auec plaiſir le Senat affligé.	Le premier des Césars est pleinement vengé, Il voit avec plaisir le Sénat affligé.
Et Rome ſoûpirer dans cette ſeruitude.	Et Rome soupirer dans cette servitude.
SE.	SE.
Elle a receu le prix de ſon ingratitude;	Elle a reçu le prix de son ingratitude;
La longueur du ſupplice amoindrit ſon peché.	La longueur du supplice amoindrit son péché.
Ce ſpectacle m'émeut.	Ce spectacle m'émut.
I3 1E.	J3 1E.
Mon cœur n'eſt point touché;	Mon cœur n'est point touché;
Et ſi vos intereſts n’eſtoient en ſa querelle, Je vous détournerois de trauailler pour elle.	Et si vos intérêts n'étaient en sa querelle, Je vous détournerais de travailler pour elle.
SE.	SE.
Et les ſiens & les miens m’occuperont le moins;	Et les siens et les miens m'occuperont le moins;
C’eſt à vos intereſts que ie donne mes ſoins;	C'est à vos intérêts que tu donne mes soins;
Ie m'en vay épouſer voſtre ſeule vengeance.	Je m'en vais épouser votre seule vengeance.
LIVIE.	LIVIE.
L’on ne ſe peut conduire auec trop de prudence;	L'on ne se peut conduire avec trop de prudence;
Nous ſommes arriuez ſur vn pas dangereux, Et ueuans on perit a nous perare tout deux.	Nous sommes arrivés sur un pas dangereux, Et ueuans on périt à nous pérare tout deux.
RVSE.	RUSE.
Si pour voſtre ſalut mon bon-heur vous deſtine, Don puo tout grortente le martne à ma ruine;	Si pour votre salut mon bonheur vous destine, Don pu tout grortente le martne à ma ruine;
A vous toute la gloire, à moy tout le danger.	À vous toute la gloire, à moi tout le danger.
Le peril eſt trop grand, ie le veux partager.	Le péril est trop grand, Seigneur le veux partager.
Ables doir l Empereun.	Ables doir l Empereun.
SE.	SE.
Que produit cette veuë?	Que produit cette vue?
IE.	JE.
Dans deux heures d’icy vous en verrez l’iſſuë;	Dans deux heures d'ici vous en verrez l'issue;
Preparez ſon esprit à mes impre ßions, Son ame châque inſtant change de paſsions;	Préparez son esprit à mes impre ssions, Son âme châque instant change de passions;
C’eſt le plus inégal que l’Empire ait veu naiſtre;	C'est le plus inégal que l'Empire ait vu naître;
Sejan penetre mal dans l’humeur de ſon maiſtre;	Séjan pénètre mal dans l'humeur de son maître;
Et depuis quelquetimpe quy cou de tu froideur;	Et depuis quelquetimpe qui cou de tu froideur;
Sejan luy fait ombrage auec tant de grandeur;	Séjan était fait ombrage auec tant de grandeur;
Tybere s’en défie, & n'ayant point d’affaire, Ne cherche qu'vn pretexte à s’en pouuoir défaire.	Tibère s'en défie, et n'ayant point d'affaire, Ne cherche qu'un prétexte à s'en pouvoir défaire.
Auecques les ſoupçons, qu’il a deſia conceur, Mes aduertiſſemens ſeront bien toſt receus.	Avec les soupçons, qu'il a déjà conçeur, Mes avertissements seront bien tôt reçus.
DRVSE.	DRUZE.
Et ſi dans le ſuccés vous vous treuuez ſurpriſe!	Et si dans le succès vous vous trouvez surprise!
LIVIE.	LIVIE.
Si ie ne reüßis dedans mon entrepriſe, Ie redonne à vos mains toutes leurs libertez;	Si ici ne réussi dedans mon entreprise, Je redonne à vos mains toutes leurs libertés;
des orus que ne ionou ne ſont plus arreſtez;	des orus que ne ionou ne sont plus arrêtés;
S’il faut vous exciter par quelque recompence, Ie ne ſuis point ingrate.	S'il faut vous exciter par quelque récompense, Je ne suis point ingrate.
RVSE.	RUSE.
O belle impatience!	Ô belle impatience!
Ardeur qui me ſaiſis, & qui me promet tout, Eſt-il quelque peril dont ie ne vienne à bout?	Ardeur qui me saisis, et qui me promet tout, Est-il quelque péril dont personne ne vienne à bout?
»CENE III.	»CENE III.
LIVIE, FVLVIE.	LIVIE, FULVIE.
IVIE.	IVIE.
Tbien, chere Fuiuie, à la nonte des hommes, L'Inutiles, ſans charge, & foibles que nous ſommes, Avous ununs emnopra, cl quus u om pur oge.	Tbien, chère Fuivie, à la nonte des hommes, L'Inutiles, sans charge, et faibles que nous sommes, Avous uns emnopra, cl qu' us om pur oge.
LVIE.	LVIE.
Voſtre deſſein, Madame, eſt tres-bien proposé;	Votre dessein, Madame, est très-bien proposé;
Le Ciel dans noſtre ſexe a mis de grandes ames, Et s’eſt ſouuent ſeruy de la vertu des femmes;	Le Ciel dans notre sexe a mis de grandes âmes, Et s'est souvent servi de la vertu des femmes;
Ils vous ont deſtinée à ce fameux bon-heur, Les hommes eſtoient peu, pour vn ſi grand honneur;	Ils vous ont destinée à ce fameux bonheur, Les hommes étaient peu, pour un si grand honneur;
Leur ſexe a des Heros, & nous des Heroïnes.	Leur sexe a des Héros, et nous des Héroïnes.
IVIE.	IVIE.
Non, non, dans noſtre ſiecle il eſt peu d’Agripines.	Non, non, dans notre siècle il est peu d'Agripines.
LVIE.	LVIE.
Vne ſeule Liuie, a merité ce nom.	Une seule Livie, à mérité ce nom.
LIVIE.	LIVIE.
La femme de Sejan aspire à ce renom;	La femme de Séjan aspire à ce renom;
Et l'on peut dire d'eux, auec quelque juſtice, Que l’on vit s’allier les vertus & le vice.	Et l'on peut dire d'eux, avec quelque justice, Que l'on vit s'allier les vertus et le vice.
LVIE.	LVIE.
Dieux!	Dieux!
elle vient à nous;	elle vient à nous;
quel est ſon mouuement?	quel est son mouvement?
E.	E.
C’est, ſans doute, vn effet de ſon reſſentiment.	C'est, sans doute, un effet de son ressentiment.
SCENE FV.	SCÈNE FU.
FVLVIE, LIVIE, APICATA, VOLVZIE.	FULVIE, LIVIE, APICATA, VOLVZIE.
A PICATA.	À PICATA.
Adame, mon abord a dequoy vous ſurprendre, LEt ie ne ſçai comment vous me pourrez entendre.	Adame, mon abord a dequoy vous surprendre, LEt ici ne sais comment vous me pourrez entendre.
je vous viens ſupplier de me tirer d’erreur;	je vous viens supplier de me tirer d'erreur;
Sejan, pour vos amours, verra-t’il l’Empereur?	Séjan, pour vos amours, verra-t-il l'Empereur?
Ce bruit eſt ſi commun, qu’il a remply la ville.	Ce bruit est si commun, qu'il a rempli la ville.
LIVIE.	LIVIE.
Vous auez pris, ſans doute, vne peine inutille;	Vous avez pris, sans doute, une peine inutille;
Ie vous aſſeure encor de cette verité.	Je vous assure encor de cette vérité.
APICATA.	APICATA.
C’est là le digne effet d’vn enorme traitté, Et l’éclairciſſement de tant de conjectures;	C'est là le digne effet d'un énorme traité, Et l'éclaircissement de tant de conjectures;
L’on n'a qu'à ramaſſer toutes les conjonctures, Et iuger de la fin par le commencemeut;	L'on n'a qu'à ramasser toutes les conjonctures, Et juger de la fin par le commencemut;
Le paſſé ſe r'appelle en cet euenement;	Le passé se rappelle en cet événement;
Et les moins clair-voyans dedans l’ordre des choſes, Treuuent de cet Hymen les veritables cauſes.	Et les moins clair-voyants dedans l'ordre des choses, Treuuent de cet Hymen les véritables causes.
N'eſt ce point par mon ſang, qu’il doit eſtre ſigné?	N'est ce point par mon sang, qu'il doit être signé?
C’eſt là le dernier coup qu’on auoit deſigné;	C'est là le dernier coup qu'on avait désigné;
Druſe en auoit formé les premiers caracteres, Ma mort doit conſommer des amours ſi legeres;	Druse en avait formé les premiers caractères, Ma mort doit consommer des amours si légères;
Pendant qu’on meditoit la mort de voſtre Eſpoux, Vous dreßiez contre moy la pointe de vos coupi;	Pendant qu'on méditait la mort de votre Époux, Vous dressiez contre moi la pointe de vos coupi;
Voſtre repos, Madame, exigeoit ma ruine, Jl n’eſt pas bien fondé ſur celle d’Agripiné;	Votre repos, Madame, exigeait ma ruine, Jl n'est pas bien fondé sur celle d'Agripiné;
Cette pauure Princeſſe affermit vos grandeurs, Et ie dois établir vos nouuelles ardeurs.	Cette pauvre Princesse affermit vos grandeurs, Et grands dois établir vos nouvelles ardeurs.
Aſſurez- vous encor par la mort de Tybère;	Assurez- vous encor par la mort de Tybère;
Qui fit mourir le fils, peut bien tuer le pere:	Qui fit mourir le fils, peut bien tuer le père:
Ce troiſieſme attentat n'eſt pas encor aſſez, Dans mes predictions, d’autres ſont menaſſez;	Ce troisième attentat n'est pas encor assez, Dans mes prédictions, d'autres sont menacsez;
Voſtre amour est fatale, & vous cachezſous elle, Ce que l’ame a de noir, de lâche, & d’infidelle;	Votre amour est fatale, et vous cachezsous elle, Ce que l'âme a de noir, de lâche, et d'infidèle;
Uous charmez, vous flatez ce nouueau Fauory, Et vous le traitterez comme vostre mary:	Uous charmés, vous flattez ce nouveau Favori, Et vous le traiterez comme votre mari:
Jl trouuera bien-toſt la fin de vos careſſes, Et des faueurs que font de pareilles Maïſtreſſes.	Il trouvera bientôt la fin de vos caresses, Et des faveurs que font de pareilles Maïstresses.
Vangez, vangez, Madame, vn ſi cruel affront;	Vengez, vengez, Madame, Un si cruel affront;
Uous me faites languir, que le coup en ſoit prompt.	Vous me faites languir, que le coup en soit prompt.
LIVIE.	LIVIE.
Uous ſçaueZ qui ie ſuis, & le peu que vous eſtes, La foudre ne va point ſur de ſi baſſes teſtes, La Niepce des Ceſars ne va pas juſqu’à vous, Et l’on voit moins tomber, que monter ſon courroux:	Uous Savez qui votre suis, et le peu que vous êtes, La foudre ne va point sur de si basses têtes, La Niepce des Césars ne va pas jusqu'à vous, Et l'on voit moins tomber, que monter son courroux:
Ie pardonne aux tranſports dont vous eſtes troublée;	Je pardonne aux transports dont vous êtes troublée;
Et ſi ie ne voyois vne ame déreglée, Ie vous aurois appris à manquer de respect.	Et si ici ne voyais une âme déréglée, Je vous aurais appris à manquer de respect.
APICATA.	APICATA.
Ie ne deffere point à ce qui m’est ſupect:	Je ne défère point à ce qui m'est supect:
Af	Af
I IE.	I IE.
Außi, c’eſt en ialouſe.	Aussi, c'est en jalouse.
APICATA.	APICATA.
le ne vous pauy puini iu quuuit a Espouſe;	le ne vous pavi puini ju quuvit a Espouse;
C’eſt vn nom glorieux à qui vous aſpire.	C'est un nom glorieux à qui vous aspire.
Vos plaiſirs là deſſous ſeront mieux aſſeurez;	Vos plaisirs là -dessous seront mieux assurés;
Voſtre amour par l’Hymen deuiendra legitime.	Votre amour par l'Hymen deviendra légitime.
LIVIE.	LIVIE.
Oüy, ie vais amoindrir la grandeur de mon crime;	Oui, Seigneur vais amoindrir la grandeur de mon crime;
Ie m'en vay reparer l’honneur que i’ay perdu.	Je m'en vais réparer l'honneur que j'ai perdu.
APICATA.	APICATA.
C’eſt ce que Rome entiere a touſiours attendu;	C'est ce que Rome entière a toujours attendu;
Et dés que le remords ſouffre qu’on le ſurmonte, Qui peche ſans rougir, le diuulgue ſans honte.	Et dès que le remords souffre qu'on le surmonte, Qui pèche sans rougir, le divulgue sans honte.
SCENE V.	SCÈNE V.
CENE APICATA, VOLVZIE.	CÈNE APICATA, VOLUZIE.
PICATA.	PICATA.
H!	H!
ſcandaleuſe amour!	scandaleuse amour!
des-honneur eternel!	des-honneur éternel!
I Y Qui d’elle, où de Sejan, eſt le plus criminel?	I Y Qui d'elle, où de Séjan, est le plus criminel?
Sur lequel de ces deux tombe plus d’infamie?	Sur lequel de ces deux tombe plus d'infamie?
Et de qui ſuis-je, o Dieux!	Et de qui suis-je, ô Dieux!
la plus juſte ennemie?	la plus juste ennemie?
Leur impudicité m'offence égalemant, Et ie voy d’vn meſme œil la Maiſtreſſe & l’Amant;	Leur impudicité m'offense égalemant, Et tu vois d'une même œil la Maîtresse et l'Amant;
L’vne ſe proſtituë, & l’autre m’abandonne.	L'une se prostituë, et l'autre m'abandonne.
OLVZIE.	OLVZIE.
Madame, il faut ſouffrir, voſtre deſtin l'ordonne.	Madame, il faut souffrir, votre destin l'ordonne.
APICATA.	APICATA.
Non, il faut expoſer cet adultere au iour, Il faut faire éclater ma peine & leur amour;	Non, il faut exposer cet adultère au jour, Il faut faire éclater ma peine et leur amour;
A la face de Rome, étalons ce myſtere, Et portons ce flambeau juſqu’aux yeux de Tybere.	À la face de Rome, étalons ce mystère, Et portons ce flambeau jusqu'aux yeux de Tibère.
VOLVZIE.	VOLVZIE.
Sans penſer à leur perte, il faut ſonger à vous.	Sans penser à leur perte, il faut songer à vous.
PICATA.	PICATA.
Bien loin de reculer, ie m’offre à leur courroux.	Bien loin de reculer, Seigneur m'offre à leur courroux.
VOBVLIE.	VOBVLIE.
Vous venez d’enflâmer la fureur de Liuie.	Vous venez d'enflammer la fureur de Livie.
APICATA.	APICATA.
Voy par là le mépris que ie fais de la vie.	Vois par là le mépris que ici fais de la vie.
YOLVZIE.	YOLVZIE.
C’en eſt bien vne marque;	C'en est bien une marque;
& vray ſemblablement, Vous ſerez immolée à ſon reſſentiment.	et vrais semblablement, Vous serez immolée à son ressentiment.
APICAFA.	APICAFA.
Ie ne luy rauis point ſa derniere victime, Et ie luy viens d’offrir la matiere d’vn crime;	Je ne notre ravis point sa dernière victime, Et ie luy viens d'offrir la matière d'un crime;
J'ay voulu luy donner ce qu'elle demandoit.	J'ai voulu cause donner ce qu'elle demandait.
VOLVZIE.	VOLVZIE.
Elle voit arriuer ce qu’elle en attendoit.	Elle voit arriver ce qu'elle en attendait.
Pourquoy luy donniez vous vn ſi grand auantage?	Pourquoi était donniez -vous un si grand avantage?
Elle ſe preparoit à ſouffrir cet outrage;	Elle se préparait à souffrir cet outrage;
Et ſon impatience alloit juſqu'à ce poinct, Que vous l’aurieZ ſurpriſe, en ne l’irritant point.	Et son impatience allait jusqu'à ce point, Que vous l'auriez surprise, en ne l'irritant point.
Deſia ſur ce pretexte, & dans ſa preuoyance, Cet esprit dangereux meditoit ſa vengeance;	Déjà sur ce prétexte, et dans sa prévoyance, Cet esprit dangereux méditait sa vengeance;
Couin ivucerenpre qumges la lu juilon plalrver, Et ne la pas reduire en eſtat d’éclater.	Couin jucerenpre qumges la lu juil plalver, Et ne la pas réduire en état d'éclater.
PICATA.	PICATA.
Que tu penetres mal le fonds de ces penſées!	Que tu pénètres mal le fond de ces pensées!
Ses conspirations y ſont toutes dreſſées, Ses crimes vont par ordre;	Ses conspirations y sont toutes dressées, Ses crimes vont par ordre;
& leur terme arriué, L’on voit l’vn commencer, quand l’autre eſt acheué:	et leur terme arrivé, L'on voit l'un commencer, quand l'autre est achevé:
Ma mort doit ſucceder à celle d’Agripine, Et ie vois approcher le iour de ma ruine.	Ma mort doit succéder à celle d'Agripine, Et ie vois approcher le jour de ma ruine.
Muons trenuer Ceſar, deſillons luy les yeux.	Muons trenuer César, desillons Seigneur les yeux.
VSIE.	VSIE.
RemetteZ voſtre cauſe au iugement des Dieux.	Remettez votre cause au jugement des Dieux.
ICATA.	ICACTA.
Ah!	Ah!
que ſon repentir eſt bien hors d’apparence!	que son repentir est bien hors d'apparence!
LVZIE.	LUZIE.
Pour l’y mieux dispoſer, employons-y Terence;	Pour l'y mieux disposer, employons-y Terence;
Il peut beaucoup ſur luy.	Il peut beaucoup sur force.
Mais, ô Dieux!	Mais, ô Dieux!
le voicy;	le voici;
Et c'eſt noſtre bon-heur qui nous l’adreſſe icy.	Et c'est notre bonheur qui nous l'adresse ici.
E	E
SCENEVI APICATA, VOLVZIE, TERENCE.	SCENEUI APICATA, VOLVZIE, TERENCE.
IENENCE.	JENENCE.
TE vous viens affliger, par de triſtes nouuelles.	TE vous viens affliger, par de tristes nouvelles.
APICATA.	APICATA.
[ſuu nocoutumce, e meſme uuu pais cruelles;	[su nocoutumce, eût été u pais cruelles;
Et dans le triſte eſtat où m'a miſe le ſort, I’attendrois, & l’arrest, & le coup de ma mort.	Et dans le triste état où m'a mise le sort, J'attendrais, et l'arrêt, et le coup de ma mort.
Je ſçait bien que Sejan fait demander Liuie.	Je sais bien que Séjan fait demander Livie.
TERENCE.	TERENCE.
Ie ne vous cele point que c'eſt la ſon enuie, Ie vous tairay bien moins que i’ay pris cet employ.	Je ne vous cèle point que c'est la son envie, Je vous tairai bien moins que j'ai pris cet emploi.
APICATA.	APICATA.
Vous, vous, ſon confident!	Vous, vous, son confident!
ERENCE.	ERENCE.
Il s’eſt ſeruy de moy.	Il s'est servi de moi.
Cetre commipion n'eſ pas juerimnuene.	Cetre commipion n'es pas juerimnuène.
APICATA.	APICATA.
Non, non, témoignez luy quel eſt voſtre grand zele, Et que vous preferez ſon intereſt au mien.	Non, non, témoignez que quel est vôtre grand zèle, Et que vous préférez son intérêt au mien.
TERENCE.	TERENCE.
Je mets en meſme rang, & le voſtre, & le ſien;	Je mets en même rang, et le vôtre, et le sien;
J’honore l’vn & l’autre, & i’aime voſtre fille;	J'honore l'Hôte l'autre, et j'aime votre fille;
Ainſi mon ſort m'attacne à toute la jamille;	Ainsi mon sort m'attacne à toute la jamille;
L’amour & l’amitié m’y tiennent engagé, Et pour voſtre maiſon mon cœur eſt partagé.	L'amour et l'amitié m'y tiennent engagé, Et pour votre maison mon cœur est partagé.
VSIE.	VSIE.
Ne parlons point d’amour dans vn temps ſi contraire;	Ne parlons point d'amour dans un temps si contraire;
Si vous m’aimez encor, allez reuoir mon pere;	Si vous m'aimez encor, allez revoir mon père;
Tachez de l’émouuoir;	Tachez de l'émouvoir;
& pour le mieux toucher, Expoſez à ſes yeux ce qu’il a de plus cher, Son honneur, ſes amis, & toute ſa famille;	et pour le mieux toucher, Exposez à ses yeux ce qu'il a de plus cher, Son honneur, ses amis, et toute sa famille;
Et ( s’il s’en ſouuenoit) parlez luy de ſa fille.	Et ( s'il s'en souvenait) parlez deux de sa fille.
APICATA.	APICATA.
Oüy, par cette amitié que vous nous proteſtez, Et ſi vos ſentimens ne ſont point affectez, Reuoyez mon mary, perſuadez ſon ame, Et rendez, s’il ſe peut, vn Espoux à ſa femme;	Oui, par cette amitié que vous nous protestez, Et si vos sentiments ne sont point affectez, Revoyez mon mari, persuadez son âme, Et rendez, s'il se peut, un Époux à sa femme;
Cehs pounte laurjar ay.	Chs pounte laurjar ai.
TE RENCE.	TE RENÉE.
I'y treuue peu d’espoir;	J'y trouve peu d'espoir;
Mais par l’ordre du Prince, il me le faut reuoir;	Mais par l'ordre du Prince, il me le faut revoir;
Luy dire de ſa part qu’il peut venir luy meſme;	Lui dire de sa part qu'il peut venir lui mesme;
Et ſans trainure les Loix, demander ce qu'il aime.	Et sans trainure les Lois, demander ce qu'il aime.
Fin du Second Acte.	Fin du Second Acte.
DELNE LREMILRL TYBERE, DRVSE,	DELNE LREMILRL TYBERE, DRUZE,
TYBERE.	TYBERE.
Orrompre mes ſoldats, & traitter vne ligue!	Orompre mes soldats, et traiter une ligue!
S Dans Rome, moy preſent, fomenter vne brigue!	S Dans Rome, moi présent, fomenter une brigue!
D2 Dangereux ſeruiteur!	D2 Dangereux serviteur!
esprit lâche & couuert!	esprit lâche et couvert!
Ay-je pû carreſſer vn homme qui me perd?	Ai-je pu carresser un homme qui me perd?
Le combler de faueurs, de dignitez, de graces, Et l’ingrat pût auoir de pareilles audaces!	Le combler de faveurs, de dignités, de grâces, Et l'ingrat pût avoir de pareilles audaces!
Qui ne s’étonneroit de ces hardis projets?	Qui ne s'étonnerait de ces hardis projets?
Iuſqu’à quelle inſolence ont monté nos Sujets?	Jusqu'à quelle insolence ont monté nos Sujets?
Rome, juſques à quand produiras-tu des traiſtres, Et quand ceſſeras-tu d’attenter ſur tes Maiſtres?	Rome, jusques à quand produiras-tu des traîtres, Et quand cesseras-tu d'attenter sur tes Maîtres?
L’on pût iuſtifier le meurtre de tes Rois;	L'on pût justifier le meurtre de tes Rois;
Il te falloit venger le mépris de tes Lois, Te deliurer d’vn joug que tu crûs tyrannique, Et maintenir contr'eux la liberté publique.	Il te fallait venger le mépris de tes Lois, Te délivrer d'un joug que tu crus tyrannique, Et maintenir contr'eux la liberté publique.
La mort des Decemuirs ſe pouuoit pardonner, Ils abuſoient d’vn droict, que tu leur pûs donner;	La mort des Décemuirs se pouvait pardonner, Ils abusaient d'un droit, que tu leur pus donner;
Le faux zele de Brute eſt encor excuſable, Le pretexte qu’il prit, le faiſoit moins coupable:	Le faux zèle de Brute est encor excusable, Le prétexte qu'il prit, le faisait moins coupable:
Mais que toy par ta main tu prennes des tyrans, Tu trahiſſes ainſi les motifs que tu prens, Que dans ta repugnance à ſouffrir noſtre Empire, Tu vueilles retomber ſous vn regne bien pire, As-tu pù conceuoir de ſemblables erreurs, Et preferer Sejan à tes vrais Empereurs?	Mais que toi par ta main tu prennes des tyrans, Tu trahisses ainsi les motifs que tu prends, Que dans ta répugnance à souffrir notre Empire, Tu veilles retomber sous un règne bien pire, As-tu puù conceuoir de semblables erreurs, Et préférer Sejan à tes vrais Empereurs?
Druſe, vois cet eſcrit, tu ſçauras ſes menées, Et de quel artifice elles ſont ordonnées.	Druse, vois cet écrit, tu sauras ses menées, Et de quel artifice elles sont ordonnées.
ORVSE, liſant cet aduis.	ORUSE, lisant cet avis.
A Tybere, Empereur.	À Tibère, Empereur.
Prince, il eſt de ma foy, De te faire auertir de bien ſonger à toy;	Prince, il est de ma foi, De te faire avertir de bien songer à toi;
Garde de negliger l’aduis que ie te donne;	Garde de négliger l'avis que votre te donne;
L’on attente à l’Empire, & deſſus ta Perſonne;	L'on attente à l'Empire, et dessus ta Personne;
Deſia tes legions ſont prestes de marcher, Et c’est vn armement qu’on táche de cacher.	Déjà té légions sont prêtes de marcher, Et c'est armement qu'on tche de cacher.
Quelque precaution qu'on prenne pour leur route, La mine qu'elles ont, éclaircit nostre doute;	Quelque précaution qu'on prenne pour leur route, La mine qu'elles ont, éclaircit notre doute;
Elles n’attendent plus que l’ordre de Sejan;	Elles n'attendent plus que l'ordre de Séjan;
Et ſi tu ne preuiens l’effort de ce tyran, Tu te verras bien-toſt aßiegé dedans Rome, Et forcé par tes mains de couronner cet homme, Ou dedans, ou dehors, il a des partiſans, Qu’il entretient ſans ceſſe à force de preſens.	Et si tu ne préviens l'effort de ce tyran, Tu te verras bientôt assiegé dedans Rome, Et forcé par tes mains de couronner cet homme, Ou dedans, ou dehors, il a des partisans, Qu'il entretient sans cesse à force de presens.
Ton General y meſle vn peu de conniuence, Et preſque tous tes Chefs ſont de l’intelligence.	Ton Général y mêle un peu de connivence, Et presque tous tes Chefs sont de l'intelligence.
Mes compagnons, & moy, voulons ſauuer l’Eſtat, Et voulons t’informer d’vn ſi grand attentat.	Mes compagnons, et moi, voulons sauver l'État, Et voulons t'informer d'un si grand attentat.
Ie t’enuoye vn Courrier auec diligence.	Je t'envoie un Courrier avec diligence.
TYBERE.	TYBERE.
Cher Druſe, il eſt beſoin d’vn extreme prudence.	Cher Druse, il est besoin d'un extrême prudence.
SE.	SE.
Cette occurence icy n'en demande pas tant;	Cette occurence ici n'en demande pas tant;
Il faut precipiter vn deſſein important, Ne point faire languir vne grande entrepriſe, Et pourſuiure vne route, au ßi-toſt qu'on l’a priſe.	Il faut précipiter un dessein important, Ne point faire languir une grande entreprise, Et poursuivre une route, aussitôt qu'on l'a prise.
YBERE.	IBÈRE.
Ie voy mon precipice, il y faut trébucher;	Je vois mon précipice, il y faut trébucher;
N’importe, auec courage, il y faudra marcher, Et i'y vay conſeruer vne audace Royalle, Et cette fermeté qu’on voit par tout égale, Vn front majeſtueux, vn front, que le mal-heur N'aura point veu pâlir, ny changer de couleur.	N'importe, avec courage, il y faudra marcher, Et j'y vais conserver une audace Royalle, Et cette fermeté qu'on voit par tout égale, Un front majestueux, un front, que le malheur N'aura point vu pâlir, ni changer de couleur.
Empereur, dans les fers!	Empereur, dans les fers!
Prince, ou ſans Diadéme!	Prince, ou sans Diadème!
Iuſqu'à l’extremité, i’auray veſcu le meſme!	Jusqu'à l'extrémité, j'aurai vécu le même!
Je veux que mes vainqueurs le puiſſent témoigner, Que Tybere en tous lieux a ſceu l’art de regner?	Je veux que mes vainqueurs le puissent témoigner, Que Tibère en tous lieux a su l'art de régner?
Cette demißion qui ne m'eſt point honteuſe, Pour ton ſeul intereſt, me deuiendra fâcheuſe;	Cette demission qui ne m'est point honteuse, Pour ton seul intérêt, me deviendra fâcheuse;
Ie la ſupporterois auec quelque douceur, Si ie laiſſois l’Empire à mon vray ſucceſſeur:	Je la supporterais avec quelque douceur, Si ici laissais l'Empire à mon vrai successeur:
Mais il faut que ie ſouffre vne entiere diſgrace, Et qu’vn vſurpateur le rauiſſe à ma race.	Mais il faut que ici souffre une entière disgrâce, Et qu'un usurpateur le ravisse à ma race.
Cher Druſe, c’eſtoit toy que i’auois deſtiné, Et que ie choiſiſſois pour eſtre couronné;	Cher Druse, c'était toi que j'avais destiné, Et que je choisissais pour être couronné;
Au cruuute des Hieuns imunou nuuſ mon frere, Cette meſme rigueur m’auoit oſté ton pere.	Au crute des Hieuns imunou nuus mon frère, Cette même rigueur m'avait ôté ton père.
O Ciel!	Ô Ciel!
c’eſtoit trop peu des maux que tu me fis!	c'était trop peu des maux que tu me fis!
Ton inhumanité me priua de deux fils!	Ton inhumanité me priva de deux fils!
DRVSE.	DRUZE.
Seigneur, voſtre indulgence eſtoit trop exce ßiue, Et par voſtre bonté tout ce deſordre arriue.	Seigneur, votre indulgence était trop exce ssiue, Et par votre bonté tout ce désordre arrive.
Ie ne veux point gehenner l’affection des Rois, Le peuple doit iuger des hommes par leurs choix;	Je ne veux point géhenner l'affection des Rois, Le peuple doit juger des hommes par leurs choix;
Et quand de leurs faueurs ils ont crû quelqu'vn digne, Jl luy doit confirmer ce priuilege inſigne;	Et quand de leurs faveurs ils ont cru quelqu'un digne, Ila luy doit confirmer ce privilège insigne;
Et ſans s’examiner s’il l’auoit merité, S’imaginer qu’il l’aye auec quelque equité.	Et sans s'examiner s'il l'avait mérité, S'imaginer qu'il l'aie avec quelque équité.
Les Princes, de leur part, y doiuent leur prudence, Preuenir leurs faueurs de quelque connoiſſance, Et ne les point verſer ſur d’indignes objets;	Les Princes, de leur part, y doivent leur prudence, Prévenir leurs faveurs de quelque connaissance, Et ne les point verser sur d'indignes objets;
L’on s’attire autrement la haine des ſubjets.	L'on s'attire autrement la haine des sujets.
Il ſe fait dans l’Eſtat vn general murmure, Le Prince est plus blâmé, que n’eſt ſa creature, Et la rage du Peuple, au moindre euenement, En condamne la cauſe, & non pas l’instrument;	Il se fait dans l'État un général murmure, Le Prince est plus blâmé, que n'est sa créature, Et la rage du Peuple, au moindre événement, En condamne la cause, et non pas l'instrument;
L’on rejette ſur vous les deſaſtres de Rome, Tant vous aueZ acrû la puiſſance d’vn homme;	L'on rejette sur vous les désastres de Rome, Tant vous avez acru la puissance d'un homme;
Vous auez dans luy ſeul ramaſſe les honneurs, Un homme ſans merite, a le prix de pluſieurs, Les charges de l'Empire en luy ſeul ſont vnies;	Vous avez dans deux seul ramasse les honneurs, Un homme sans mérite, à le prix de plusieurs, Les charges de l'Empire en lui seul sont unies;
Uous répandez ſur luy des graces infinies;	Vous répandez sur On des grâces infinies;
Et par vne faueur, qui fait mille jaloux, Vous auez fait Sejan vn peu moindre que vous;	Et par une faveur, qui fait mille jaloux, Vous avez fait Séjan un peu moindre que vous;
Encor abuſe-t’il du credit qu’on luy donne;	Encor abuse-t-il du crédit qu'on luiprendre;
L’ingrat, & l’inſolent, ne carreſſe perſonne;	L'ingrat, et l'insolent, ne carresse personne;
Et ſur ces hauts degrez, ou ſon bon peur t'a mis, Il dédaigne d’auoir de petits ennemis.	Et sur ces hauts degré, ou son bon peur t'a mis, Il dédaigne d'avoir de petits ennemis.
Ceſi aua granueo mijono que ſes deſſeins s'attachent Mais ſes precautions empeſchent qu’ils ſe ſçachent;	Cési ava granueo mijono que ses desseins s'attachent Mais ses précautions empêchent qu'ils se sachent;
Le poiſon ſourdement, l’a rendu ſans riuaux.	Le poison sourdement, l'a rendu sans rivaux.
TYBERE.	TYBERE.
Oüy, Druſe, ie le crois l’autheur de tous mes maux, I’ay trauaillé moy-meſme à ma propre ruine, Et i'armay d’vn poignard, le bras qui m'aſſaßine:	Oui, Druse, je le crois l'auteur de tous mes maux, J'ai travaillé moi-même à ma propre ruine, Et j'armai d'un poignard, le bras qui m'assassine:
Oüy, ſur mon propre fils il porta ſa fureur.	Oui, sur mon propre fils il porta sa fureur.
Ah!	Ah!
ce cruel ſoupçon, me donne de l’horreur!	ce cruel soupçon, me donne de l'horreur!
Oſtons-nous de l’esprit cette triſte creance?	Ôtons-nous de l'esprit cette triste créance?
SE.	SE.
Cette horrible action a de la vray-ſemblance;	Cette horrible action a de la vraiisemblance;
Ei quey que le porjon ne jui pas aere, Par vne circonſtance on ſe l’eſt figuré;	Ei que que le porjon ne jui pas aère, Par une circonstance on se l'est figuré;
Il recherche ſa vefue.	Il recherche sa veue.
IBERE.	IBÈRE.
Il veut de moy Liuie!	Il veut de moi Livie!
Et dans le meſme temps qu’il attente à ma vie!	Et dans le même temps qu'il attente à ma vie!
E.	E.
Ah!	Ah!
Seigneur, donneZ moy l’ordre de l’arreſter, Iuſques dans ſon Palais, i’iray l’executer;	Seigneur, donnez -moi l'ordre de l'arrêter, Jusque dans son Palais, j'irai l'exécuter;
Il le faut preuenir, plûtoſt que de l’attendre, Et ne luy pas laiſſer le temps de nous ſurprendre.	Il le faut prévenir, plutôt que de l'attendre, Et nea luy pas laisser le temps de nous surprendre.
BERE.	BÉRE.
Mes gens le ſaiſiront auec commodité.	Mes gens le saisiront ap commodité.
Macron, me réponds:	Macron, me réponds:
tu de ta fidelité?	tu de ta fidélité?
MACRON.	MACRON.
din.	din.
Ctjur, mille fois ie te l’ay fait paraiſtre, Et telle qu'vn ſubjet la conſerue à ſon Maiſtre.	Ctjur, mille fois ie te l'ai fait paraître, Et telle qu'un sujet la conserve à son Maître.
ERE.	ÈRE.
Ie puis auoir icy des ſujets d’en douter.	Je puis avoir ici des sujets d'en douter.
As-tu du cœur?	As-tu du cœur?
MACRON.	MACRON.
Aſſez, pour ne rien redouter.	Assez, pour ne rien redouter.
Jl faut ſaiſir Sejan?	Il faut saisir Séjan?
YBERE.	IBÈRE.
MACRON.	MACRON.
Sejan!	Séjan!
YBERE.	IBÈRE.
Tu l’apprehendes?	Tu l'appréhendes?
MACRON.	MACRON.
Non, i’executeray ce que tu me commandes, Auec quelque grand foin qu’il ſe faſſe garder.	Non, j'exécuterai ce que tu me commandes, Avec quelque grand foin qu'il se fasse garder.
E.	E.
Jl n'eſt pas de beſoin de ſe tant hazarder?	Il n'est pas de besoin de se tant hasarder?
Ramaſſe tes ſoldats, & te rends à la porte;	Ramasse tes soldats, et te rends à la porte;
S’il eſt accompagné, fais ta garde plus forte;	S'il est accompagné, fais ta garde plus forte;
Et ſur toutuungu peint que par vn ordre exprés.	Et sur toutuungu peint que par un ordre exprès.
Toy, Regulus.	Toi, Regulus.
GVLVS.	GULUS.
Seigneur.	Seigneur.
TYBERE.	TYBERE.
Tenez vous icy prés.	Tenez vous ici près.
Druſe, il nous faut icy compoſer nos viſages, Et ne luy point donner de ſiniſtres ombrages;	Druse, il nous faut ici composer nos visages, Et ne lui point donner de sinistres ombrages;
Jl doit venir bien-toſt.	Jl doit venir bientôt.
Mais le voicy qui vient;	Mais le voici qui vient;
Sane je juie enereners uey mefme nous preuient.	Sane je juie enéréners ouvei -même nous prévient.
SCENE II.	SCÈNE II.
TYBERE, DRVSE, SEIAN, REGVLVS.	TYBERE, DRUZE, SEIAN, REGVLVS.
EIAN.	EIAN.
ſar, i'enfrains les loix	sar, j'enfrains les lois
I Ie t'en veux diſpenſer.	I Je t'en veux dispenser.
E RE.	E RE.
Qu'vn autre les obſerue,	Qu'un autre les observe,
E AN.	 EN.
Obligeante reſerue!	Obligeante réserve!
BERE.	BÉRE.
Ie ne te traitte pas en homme du commun.	Je ne te traite pas en homme du commun.
IAN Ie ne me laſſe point de vous eſtre importun;	IAN Je ne me lasse point de vous être importun;
Je cherche à vos bontez de nouuelles matieres, Et moins aux Dieux qu'à vous i’adreſſe mes prieres.	Je cherche à vos bontés de nouvelles matières, Et moins aux Dieux qu'à vous j'adresse mes prières.
Auguſte, & vous, Ceſar, m'auez comblé de biens, Mais de loin, vos bien-faits ont ſurpaſſé les ſiens;	Auguste, et vous, César, m'avez comblé de biens, Mais de loin, vos bienfaits ont surpassé les siens;
Vous m’auez accordé tous les honneurs de Rome, Et de quoy contenter tous les deſirs d’vn homme;	Vous m'avez accordé tous les honneurs de Rome, Et de quoi contenter tous les désirs d'un homme;
Le plus ambitieux s’en ſeroit aſſouuy, Außi par ce ſecret vn Prince eſt mieux ſeruy;	Le plus ambitieux s'en serait assoui, Aussi par ce secret un Prince est mieux servi;
Et ces nobles ſujets qui dédaignent la force, Les cœurs ſe laiſſent prendre à cette douce amorce;	Et ces nobles sujets qui dédaignent la force, Les cœurs se laissent prendre à cette douce amorce;
La liberalité fait d’aimables efforts, Et s’acquiert les eſprits, comme l’autre les corps;	La libéralité fait d'aimables efforts, Et s'acquiert les esprits, comme l'autre les corps;
Coje uues pupion qu'un ſubjet ſe hazarde:	Coje ues pupion qu'un sujet se hasarde:
Mon pere auec ce cœur commanda voſtre garde;	Mon père avec ce cœur commanda votre garde;
Et s’eſtant ſignalé dans mille occaſions, Merita voſtre eſtime & vos affections.	Et s'étant signalé dans mille occasions, Mérita votre estime et vos affections.
A peine fut-il mort en ce noble exercice, Que l’on me confirma cet important office;	À peine fut-il mort en ce noble exercice, Que l'on me confirma cet important office;
Tout jeune que i’eſtois, ie me vis dans l’employ, Et i’eus de beaux moyens de vous montrer ma fo J'ay plainement remply cette belle esperance:	Tout jeune que j'étais, je me vis dans l'emploi, Et j'eus de beaux moyens de vous montrer ma fo J'ai plainement rempli cette belle espérance:
Außi, ſi i'ay ſeruy, i'en eu la recompenſe, La charge de Preteur, celle de Conſulat, Et ſucce ßiuement les honneurs du Senat:	Aussi, si j'ai servi, j'en eu la récompense, La charge de Preteur, celle de Consulat, Et sucée uement les honneurs du Sénat:
Je commande à ce corps qui regit cent Prouinces, Et i’ordonne, apres vous, de tous ces petits Princes;	Je commande à ce corps qui régit cent Provinces, Et j'ordonne, après vous, de tous ces petits Princes;
Enfin vous m’auez fait le ſecond des Romains, Et vous voyez, Ceſar, l’ouurage de vos mains;	Enfin vous m'avez fait le second des Romains, Et vous voyez, César, l'ouvrage de vos mains;
Ie puis ſans vanité l’ozer preſque pretendre, Et ie puis aspirer au nom de voſtre gendre;	Je puis sans vanité l'ozer presque prétendre, Et ie puis aspirer au nom de votre gendre;
Si la vefue de Druſe a beſoin d’vn mary, Seigneur, jettez les yeux ſur voſtre fauory:	Si la vefue de Druse a besoin d'un mari, Seigneur, jetés les yeux sur votre favori:
De ſia voſtre alliance illuſtra ma famillé, Le fils de Clodius eut épousé ma fille;	De zia votre alliance illustra ma famillé, Le fils de Clodius eut épousé ma fille;
Ce glorieux Hymen ſe deuoit acheuer, Sans le grand accident qui vint nous l’enleuer, Et qui nous l’arrachant, au plus beau de ſon âge, Détruiſit voſtre espoir, auec ce mariage.	Ce glorieux Hymen se devait achever, Sans le grand accident qui vint nous l'enlever, Et qui nous l'arrachant, au plus beau de son âge, Détruisit votre espoir, avec ce mariage.
Auguste, voſtre pere, à voulu s’allier, Auecques la maiſon d’vn ſimple Cheualier;	Auguste, votre père, à voulu s'allier, Avecques la maison d'un simple Chalier;
Ceſar, i’implore icy voſtre toute puiſſance, Faites moy meriter voſtre auguſte alliance;	César, j'implore ici votre toute puissance, Faites moi mériter votre auguste alliance;
Et puis que voſtre ſang vous éleua ſur nous, Par voſtre abaiſſement, approchez-moy de vous;	Et puis que votre sang vous éleva sur nous, Par votre abaissement, approchez-moi de vous;
Jl n’est rien juſque là qui vaille mon enuie;	Jl n'est rien jusque -là qui vaille mon envie;
C’eſt ſa poſſe ßion!	C'est sa posse ssion!
BERE.	BÉRE.
Qu'on appelle Liuie?	Qu'on appelle Livie?
AN.	AN.
A quel excés d’honneur portez vous vn Subjet!	À quel excès d'honneur portez vous un Subjet!
BERE.	BÉRE.
Tu te peux deceuoir dans vn ſi baut projet;	Tu te peux décevoir dans un si baut projet;
Et ne te flatte point, de penſer que Liuie, Prenne à ton auantage vne ſi baſſe enuie, Qu'elle daigne épouſer vn ſimple Cheualier, Qu'elle ſe méconnoiſſe, & ſe vueille oublier;	Et ne te flatte point, de penser que Livie, Prenne à ton avantage une si basse envie, Qu'elle daigne épouser un simple Chalier, Qu'elle se méconnaisse, et se veuille oublier;
Ce ſeroit vn opprobre aux familles Romaines, Qui virent ſes parens aux charges Souueraines, Qui ne pourroient ſouſſrir ce mélange odieux, Ny voir ta maiſon jointe à la race des Dieux;	Ce serait un opprobre aux familles Romaines, Qui virent ses parens aux charges Souveraines, Qui ne pourraient soussrir ce mêlange odieux, Ni voir ta maison jointe à la race des Dieux;
Ie mettrois mes Neueux dans de longues querelles, Et verrois entre vous des haines immortelles.	Je mettrais mes Neveux dans de longues querelles, Et verrais entre vous des haines immortelles.
Où nous reduiriez-vous, ſi vous veniez aux mains, Et ſi vos diferends partageoient les Romains?	Où nous réduiriez-vous, si vous veniez aux mains, Et si vos diférends partageaient les Romains?
Meſure tes projets auecques ta puiſſance, Ou les proportionne à ta ſeule naïſſance:	Mesure tes projets était ta puissance, Ou les proportionne à ta seule naïssance:
Toute Rome m’haï̃t pour t’auoir agrandy, Et i’en ſuis décrié, loin d’en eſtre applaudy:	Toute Rome m'hait pour t'avoir agrandi, Et j'en suis décrié, loin d'en être applaudi:
Dois- je encourir pour toy l’inimitié publique, Et mettre en ma maiſon vn trouble domeſtique?	Dois- je encourir pour toi l'inimitié publique, Et mettre en ma maison un trouble domestique?
Vit on iamais dans Rome vn ſemblable party, Qui fut tant inégal, & ſi mal aſſorty?	Vit on jamais dans Rome un semblable parti, Qui fut tant inégal, et si mal assorti?
Pour l’exemple d’Auguſte, il me donna ſa fille, Tant il fut inquiet, changeant & difficile;	Pour l'exemple d'Auguste, il me donna sa fille, Tant il fut inquiet, changeant et difficile;
Agrippa l’auoit euë, il me la redonna;	Agrippa l'avait eue, il me la redonna;
Cette inégalité fit qu’on le ſoupçonna;	Cette inégalité fit qu'on le soupçonna;
Il en preuit la ſuitte;	Il en prévit la te;
& s’il faut ainſi dire, La ſouueraineté par là ſe communique;	et s'il faut ainsi dire, La souveraineté par là se communique;
A meſure qu’on monte, on dreſſe vn nouueau plan, Et d’allié du Prince, on deuient ſon tyran.	À mesure qu'on monte, on dresse un nouveau plan, Et d'allié du Prince, on devient son tyran.
Voicy venir Liuie;	Voici venir Livie;
apprenons de ſa bouche, Ce qu'elle a concerté d’vn amour qui me touche, Et ce qu'elle à conclu contre mon intereſt.	apprenons de sa bouche, Ce qu'elle a concerté d'un amour qui me touche, Et ce qu'elle à conclu contre mon intérêt.
SCLNE III TYBERE, DRVSE, SEIAN, LIVIE, REGVLVS.	SCLNE III TYBERE, DRUZE, SEIAN, LIVIE, REGVLVS.
EIAN.	EIAN.
Eſt à vous, ma Princeſſe, à faire mon arreſt;	Est à vous, ma Princesse, à faire mon arrêt;
Releuez nous bien-toſt de l’attẽte où nous ſommes;	Relevez nous bientôt de l'attendre où nous sommes;
Faites moy le plus grantsou le moindre des hommes.	Faites -moi le plus grantsou le moindre des hommes.
IVIE.	IVIE.
Et bien, preſomptueux, l’on voit ta vanité, Et l’on connoiſt l’excés de ta temerité.	Et bien, présomptueux, l'on voit ta vanité, Et l'on connaît l'excès de ta témérité.
Un homme de neant a bien eu cette audace, D’ozer faire regner ſa perſonne & ſa race!	Un homme de néant a bien eu cette audace, D'oser faire régner sa personne et sa race!
Di ie pis u en Strabon, le fils d’vn Cheualier, Auecques les Ceſars, demande à s’allier!	Di grande pis u en Strabon, le fils d'un Chalier, Avecques les Césars, demande à s'allier!
Quoy, Seigneur, fouffreZ vons tettt naute inſolence?	Quoi, Seigneur, souffrez vons tett naute insolence?
Cilal dlanaames	Cilal dlanaâmes
Iy IE.	Ii IE.
Tais-toy?	Tais-toi?
ie t’impoſe ſilence.	Elle t'impose silence.
Ma Princeſſe, eſt-ce ainſi que vous me trahiſſez?	Ma Princesse, est-ce ainsi que vous me trahissez?
Nauez vous point aimé, ce que vous haïſſez?	Navez -vous point aimé, ce que vous haïssez?
E.	E.
Moy, ie t’aurois aimé, le plus lâche des hommes!	Moi, Seigneur t'aurais aimé, le plus lâche des hommes!
Et le plus criminel de l'Empire où nous ſommes!	Et le plus criminel de l'Empire où nous sommes!
Tout le cours de ta vie eſt vn débordement, Et de mille attentats, vn ſeul enchainement:	Tout le cours de ta vie est un débordement, Et de mille attentats, un seul enchaînement:
Inſtruis nous plainement de toutes tes maximes;	Instruis nous plainement de toutes tes maximes;
S’ils ne ſont infinis, nombre moy tous tes crimes;	S'ils ne sont infinis, nombre moi tous tes crimes;
Eſtalle nous par ordre vn amas de forfaits;	Étalle nous par ordre un amas de forfaits;
Dis nous pourquoy, comment, & quand ils furent faits?	Dis nous pourquoi, comment, et quand ils furent faits?
Nul ne s’eſt diuerty du cours de ta vengeance, Elle s’eſt étenduë auecque indifference;	Nul ne s'est diverti du cours de ta vengeance, Elle s'est étendue avec indifférence;
Tu t'immole les Grands, comme les plus petits, Et tout ſang aſſouuit tes brûlans appetits;	Tu t'immole les Grands, comme les plus petits, Et tout sang assouuit tes brûlants appétits;
Tes yeux ſe ſont repûs de diferend carnage;	Tes yeux se sont répus de diérend carnage;
Trois teſtes d’Empereurs te bouchoient vn paſſage;	Trois têtes d'Empereurs te bouchaient un passage;
Et par ta tyrannie, on les a veu tomber;	Et par ta tyrannie, on les a vu tomber;
Toute Rome, auec eux, s’en alloit ſucomber;	Toute Rome, avec eux, s'en allait sucomber;
La maiſon des Ceſars, que tu tenois en bute, S’alloit enuelopper dans cette grande chute;	La maison des Césars, que tu tenais en bute, S'allait envelopper dans cette grande chute;
L’Empire, & l’Empereur, s’y ſeroient veus compris, Si le Ciel ne m’eut miſe au deuant du débris:	L'Empire, et l'Empereur, s'y seraient vus compris, Si le Ciel ne m'eût mise au devant du débris:
Oùy, ce Ciel irrité, qui dedans ſa colere, Souffroit l’aueuglement dans l’ame de Tybere, Luy va monſtrer l’abyſme où ta main le pouſſoit;	Oui, ce Ciel irrité, qui dedans sa colère, Souffrait l'aveuglement dans l'âme de Tibère, Lui va montrer l'abîme où ta main le poussait;
fi ne veur pius de fleaux, ton regne le laſſoit, Tant de meſchancetez ſont à ce iour preſcrites, Ta domination excedoit ſes limites;	fi ne veur pius de fléaux, ton règne le lassait, Tant de méchancetés sont à ce jour prescrites, Ta domination excédait ses limites;
Tu prins plus de credit, qu’il ne t’en a donné, Et plus executé, qu’il n’auoit ordonné.	Tu prins plus de crédit, qu'il ne t'en a donné, Et plus exécuté, qu'il n'avait ordonné.
2	2
ERE.	ÈRE.
Qu'entends-je icy, Sejan?	Qu'entends-je ici, Séjan?
I ue vois-je icy, Madame?	I ue vois-je ici, Madame?
IE.	JE.
Tu l'ozes demander!	Tu l'oses demander!
confuiter-en ton ame s	confuiter-en ton âme s
EIAN.	EIAN.
Seigneur, elle eſt ſeduite, & Druze a concerté.	Seigneur, elle est séduite, et Druze a concerté.
Quoy, traiſtre!	Quoi, traître!
JE.	JE.
RE.	RE.
Qu'elle parle auecque liberté?	Qu'elle parle apprête liberté?
E.	E.
Ie ne veux point parler d’vn million de crimes, Tu les as tous cachez ou rendus legitimes;	Je ne veux point parler d'Han million de crimes, Tu les as tous cachés ou rendus légitimes;
Quelque déguiſement, dont tu les ais couuerts, Jls paroiſtront vn iour aux yeux de l’Uniuers;	Quelque déguisement, dont tu les ais couverts, Ils paraîtront un jour aux yeux de l'Univers;
Et cette verité, qui va par les Prouinces, ( Qu’on n’introduit iamais aux cabinets des Princes, S’y viendra preſenter auec ſa netteté, Et ſortira bien-toſt de ſon obſcurité;	Et cette vérité, qui va par les Provinces, ( Qu'on n'introduit jamais aux cabinets des Princes, S'y viendra présenter avec sa netteté, Et sortira bientôt de son obscurité;
Ces belles veritez, qu’on auoit obſcurcies, Ces morts qu’on pretextoit, s’y verront éclaircies;	Ces belles vérités, qu'on avait obscurcies, Ces morts qu'on prétextait, s'y verront éclaircies;
Piſon n’aura rien fait, qu’il n’ait eu tes aduis, Et mourra criminel, pour les auoir ſuiuis.	Pison n'aura rien fait, qu'il n'ait eu tes avis, Et mourra criminel, pour les avoir suivis.
Là ſe découurira ton horrible malice, L’on verra qu’vn coupable a perdu ſon complice;	Là se découvrira ton horrible malice, L'on verra qu'un coupable a perdu son complice;
Et d’apprehenſion qu’on ne vit ſon peché, Que ſes precautions dans ſon ſang l’ont caché:	Et d'appréhension qu'on ne vit son péché, Que ses précautions dans son sang l'ont caché:
Oüy, perfide, ce meurtre eſt bien plus vray-ſemblable, Que le grand deſespoir, dont tu le fis capable;	Oui, perfide, ce meurtre est bien plus vrai-semblable, Que le grand désespoir, dont tu le fis capable;
Vn láche naturel, vne humeur de Piſon, Une main toûjours preſte à donner le poiſon, N’auroit pas pû choiſir vne mort volontaire;	Un lâche naturel, une humeur de Pison, Une main toujours prête à donner le poison, N'aurait pas pu choisir une mort volontaire;
Jl auroit attendu qu'elle fut neceſſaire;	Il aurait attendu qu'elle fut nécessaire;
Et cette ame ſi baſſe, attachée à ſon corps, Ne l’eut abandonné que par de grands efforts.	Et cette âme si basse, attachée à son corps, Ne l'eut abandonné que par de grands efforts.
Germanicus à peine auoit quitté la place, Que ta temerité monta juſqu’à l’audace;	Germanicus à peine avait quitté la place, Que ta témérité monta jusqu'à l'audace;
Tu te ſacrifias le fils de l'Empereur;	Tu te sacrifias le fils de l'Empereur;
Le fils de Claudius éprouua ta fureur;	Le fils de Claudius éprouva ta fureur;
Et par l'ambition la plus dénaturée, La perte de ton Prince eſt meſme conjurée.	Et par l'ambition la plus dénaturée, La perte de ton Prince est même conjurée.
C’eſt par tous ces degreZ, que tu voulois monter, Et tant d’empeſchemens ſe deuoient ſurmonter;	C'est par tous ces dégréz, que tu voulais monter, Et tant d'empêchements se devaient surmonter;
Mais tu laiſſois, aueugle, vn obſtacle en arriere;	Mais tu laissais, aveugle, un obstacle en arrière;
Ie m'oppoſe à ta courſe, au bout de ta carriere;	Je m'oppose à ta course, au bout de ta carrière;
Tu croyois voir l’effet que tu t’es projetté, Et ſi proche du Troſne, on te voit arreſté.	Tu croyais voir l'effet que tu t'es projetté, Et si proche du Trône, on te voit arrêté.
RVSE.	RUSE.
Rends moy, Germanicus, & me rends Agripine, Toy deſtructeur des miens, cauſe de leur ruine, Abominable autheur des maux qu’ils ont ſouffers, Deteſtable inuenteur des poiſons & des fers?	Rends moi, Germanicus, et me rends Agripine, Toi destructeur des miens, cause de leur ruine, Abominable auteur des maux qu'ils ont souffers, Detestable inventeur des poisons et des fers?
Ah!	Ah!
barbare;	barbare;
quel crime auoit commis ma mere Pour auoir recherché l’aſſa ßin de mon pere?	quel crime avait commis ma mère Pour avoir recherché l'assa Zin de mon père?
Loin d'en auoir juſtice, & d’en tirer raiſon, Elle fut releguée, & mourut en priſon.	Loin d'en avoir justice, et d'en tirer raison, Elle fut releguée, et mourut en prison.
YBERE.	IBÈRE.
Que réponds-tu, Sejan?	Que réponds-tu, Séjan?
SE.	SE.
Que pourroit-il répondre?	Que pourrait-il répondre?
Tous ſes déportemens ont dequoy le confondre.	Tous ses déportements ont dequoy le confondre.
EIAN.	EIAN.
Ce n’eſt pas d’aujourd’huy que Druſe m’entreprend, Il ne peut ſupporter que vous m'ayeZ fait grand, Et garde vne maxime aux Princes ſi commune, Qu'il faut choquer ſans ceſſe vn homme de fortune, Et qu’il n’est pas ſeant de mettre en meſme rang.	Ce n'est pas d'aujourd'hui que Druse m'entreprend, Il ne peut supporter que vous m'ayeZ fait grand, Et garde une maxime aux Princes si commune, Qu'il faut choquer sans cesse un homme de fortune, Et qu'il n'est pas séant de mettre en rendre rang.
Les ſimples Cheualiers, & les Princes du ſang.	Les simples Chevaliers, et les Princes du sang.
Quant à Germanicus, ſa mort fut naturelle, Et Druſe injuſtement m'en forme vne querelle.	Quant à Germanicus, sa mort fut naturelle, Et Druse injustement m'en forme une querelle.
L'on ſŗan à quel exces ſon orgueil ſe porta.	L'on sommes à quel excès son orgueil se porta.
E.	E.
C’eſt vne illuſion que forment tes ſemblables, Cette façon d’agir rend les Princes coupables:	C'est une illusion que forment tes semblables, Cette façon d'agir rend les Princes coupables:
Mais toy, reconnois-tu juſqu’où monte le tien?	Mais toi, reconnais-tu jusqu'où monte le tien?
Toy, dont la vanité n’auoit point de ſoûtien, Et de qui l’inſolence a pû juſque là craiſtre, Que d’ozer demander la fille de ton Maiſtre?	Toi, dont la vanité n'avait point de soutien, Et de qui l'insolence a pu jusque -là craître, Que d'oser demander la fille de ton Maître?
LIVIE.	LIVIE.
Quant à Druſe, meſchant, tu l’as empoiſonné.	Quant à Druse, méchant, tu l'as empoisonné.
A N.	À N.
Moy, ie l’ay fait mourir!	Moi, Seigneur l'ai fait mourir!
14 VIE.	14 VIE.
Ah!	Ah!
l’homme abandonné!	l'homme abandonné!
Tu te veux preualoir du peu de témoignages;	Tu te veux prévaloir du peu de témoignages;
Oüy, ie n’en puis tracer que de legers ombrages;	Oui, je n'en puis tracer que de légers ombrages;
Ie ne te puis conuaincre en manquant de témoins;	Je ne te puis convaincre en manquant de témoins;
L’entrepriſe fut faite auec de trop grands ſoins;	L'entreprise fut faite avec de trop grands soins;
Ta politique enſeigne à détruire vne preuue, Elle deuoit t’apprendre à perdre außi la vefue:	Ta politique enseigne à détruire une preuve, Elle devait t'apprendre à perdre aussi la veue:
Mais le Ciel qui confond tous les conſeils humains, Qui rend, quand il luy plaiſt, nos raiſonnemens vains,	Mais le Ciel qui confond tous les conseils humains, Qui rend, quand il lui plaît, nos raisonnements vains,
T’a forcé, malgré toy, de te trahir toy meſme, Et t’a fait découurir ton propre ſtratageme;	T'a forcé, malgré toi, de te trahir toi y, Et t'a fait découvrir ton propre stratagème;
Tu m'apportois en dot, la teſte d’vn mary;	Tu m'apportais en dot, la tête d'un mari;
A ce ſanglant objet, ſa vefue t’eut chery;	À ce sanglant objet, sa vefue t'eut chéri;
Tu t’en glorifiois, comme d’vne victoire, Comme d’vne action toute pleine de gloire;	Tu t'en glorifiais, comme d'une victoire, Comme d'une action toute pleine de gloire;
Tes entretiens d’amour, auoient ce compliment, Et n’eſtoient embellis, que de cet ornement.	Tes entretiens d'amour, avaient ce compliment, Et n'étaient embellis, que de cet ornement.
Je vous offre vn Empire, acceptez le, Madame;	Je vous offre un Empire, acceptez le, Madame;
Ie vous monſtre par là la grandeur de ma flâme;	Je vous montre par là la grandeur de ma flamme;
Elle exigeoit de moy la mort de voſtre Eſpoux;	Elle exigeait de moi la mort de votre Époux;
Quelle marque plus grande en deſireriez vous?	Quelle marque plus grande en désireriez -vous?
Druſe a deſia pery, ie vay perdre Tybere, A la perte du fils, joindre celle du pere;	Druse a déjà péri, Seigneur vais perdre Tibère, A la perte du fils, joindre celle du père;
Il n'eſt rien de hardy, que ie n'oze tenter, Et par ce ſeul motif, de vous mieux meriter.	Il n'est rien de hardi, que je n'ose tenter, Et par ce seul motif, de vous mieux mériter.
J'attens, pour ce grand coup, des forces d’Allemagne;	J'attends, pour ce grand coup, des forces d'Allemagne;
I’occupe également, la ville & la campagne;	J'occupe également, la ville et la campagne;
Toutes les legions ſuiuront mes étendars;	Toutes les légions suivront mes étendards;
Elles vont m’éleuer au Troſne des Ceſars, hltine uejom mut pieds cette illuſtre conqueſte, Et ceux que la naiſſance auoit mis ſur ma teſte;	Elles vont m'élever au Trône des Césars, hltine uejom mut pieds cette illustre conquête, Et ceux que la naissance avait mis sur ma tête;
Perdons le jeune Druſe.	Perdons le jeune Druse.
A tant de cruautez, Ie fremiſſois en moy de tes deloyautez:	À tant de cruautés, Je frémissais en moi de tes déloyautés:
Malgré toute ma rage, il me falloit contraindre, Deuorer mes ſoúpirs, m'empeſcher de me plaindre;	Malgré toute ma rage, il me fallait contraindre, Dévorer mes soupirs, m'empêcher de me plaindre;
Et par vn vif tourment, qu’on ne peut exprimer, Dire à mon ennemy que ie voulois l’aimer.	Et par un vif tourment, qu'on ne peut exprimer, Dire à mon ennemi que ici voulais l'aimer.
I'attendois ce moment, l’heure enfin eſt venuë, Où ta meſchanceté doit eſtre reconnuë;	J'attendais ce moment, l'heure enfin est venue, Où ta méchanceté doit être reconnue;
Et ut ſia tes remorus t'empeſchent de parler, Ou te veulent contraindre à nous tout reueler.	Et ut zia té morus t'empêchent de parler, Ou te veulent contraindre à nous tout révéler.
YBERE.	IBÈRE.
dejui, que vepenas vine	déjui, que vépenas vine
Leur procedé m’étonne.	Leur procédé m'étonne.
D BERE.	 DERE.
Leue les yeux, & voy cet aduis qu’on me donne.	Leve les yeux, et vois cet avis qu'on me donne.
Tejrine tougis pas?	Téjrine tougis pas?
ton front ne pâlit point?	ton front ne pâlit point?
Sej lit.	Séje lit.
Certes, ton imprudence eſt dans ſon plus haut poinct.	Certes, ton imprudence est dans son plus haut point.
Plus il ſe veut cacher, plus il ſe fait paroiſtre.	Plus il se veut cacher, plus il se fait paraître.
E.	E.
Le cœur, malgré le front, ſe ſçait faire connoistre.	Le cœur, malgré le front, se sait faire connaître.
Ceſar, c’eſt vn effet de leur inuention, Et i’implore à genoux voſtre protection.	César, c'est un effet de leur invention, Et j'implore à genoux votre protection.
Que le Ciel à vos pieds m’abiſme d’vn tonnerre, Ou que vif deuant vous, m'engloutiſſe la terre, Ou que, ie ſois, mon Prince, éloigné de vos yeux;	Que le Ciel à vos pieds m'abîme d'un tonnerre, Ou que vif devant vous, m'engloutisse la terre, Ou que, sans sois, mon Prince, éloigné de vos yeux;
Serment bien plus ſacré, que celuy de nos Dieux.	Serment bien plus sacré, que celui de nos Dieux.
BERE.	BÉRE.
Ceſſe de profaner vn nom ſi redoutable;	Cesse de profaner un nom si redoutable;
L'on gardera ton droict, innocent ou coupable.	L'on gardera ton droit, innocent ou coupable.
Ua te juſtifier de cet aſſa ßinat;	Oùa te justifier de cet assa ssinat;
I'en commets l’examen au pouuoir du Senat, Ta vie eſt dans ſes mains, il iugera ſans haine.	J'en commets l'examen au pouvoir du Sénat, Ta vie est dans ses mains, il jugera sans haine.
Qu'on le faſſe aſſembler:	Qu'on le fasse assembler:
Macron, que l’on l’y meine.	Macron, que l'on l'y mène.
Uous Druſe, & vous Liuie, aßiſtez au procez, Et ne retournez, point, ſans en voir le ſuccez.	Uous Druse, et vous Livie, assistez au procès, Et ne retournez, point, sans en voir le succès.
E Uous reſſouuenez-vous de tant de bons offices, Et que voſtre ſalut eſt l’vn de mes ſeruices.	ÉT -vous ressouuenez-vous de tant de bons offices, Et que votre salut est l'un de mes services.
Seigneur, mon innocence;	Seigneur, mon innocence;
E.	E.
Aura ſes protecteurs;	Aura ses protecteurs;
La paßion n’eſt point parmy des Senateurs.	La passion n'est point parmi des Sénateurs.
Si tu reuiens abſous, mes bras ſont tes refuges;	Si tu reviens absous, mes bras sont tes refuges;
Sinon, ie t’abandonne à l’arreſt de tes fuges,	Sinon, Seigneur t'abandonne à l'arrêt de tes fuges,
Fin du Troiſiéme Acte.	Fin du Troisième Acte.
TETIE 1	TETIE 1
SUENE IREMTERE.	SUENE IREMTERE.
APICATA, VOLVZIE, TERENCE.	APICATA, VOLVZIE, TERENCE.
VOLVZIE.	VOLVZIE.
Ve tẽtez -vous, Madame, & qu’en eſperés vous?	Ve tẽtez -vous, Madame, et qu'en espérez -vous?
Vn Croyez vous obtenir la mort de voſtre Espoux?	Un Croyez -vous obtenir la mort de votre Époux?
Et quoy, vous vous flatez de trouuer vn refuge?	Et quoi, vous vous flattez de trouver un refuge?
Sejan eſt criminel, & Tybere eſt ſon juge;	Séjan est criminel, et Tibère est son juge;
L’arbitre & le coupable, ont icy tout pouuoir, Ils ont autant de droict, qu’ils en veulent auoir;	L'arbitre et le coupable, ont ici tout pouvoir, Ils ont autant de droit, qu'ils en veulent avoir;
Le diuorce eſt permis dans les maiſons de Rome.	Le divorce est permis dans les maisons de Rome.
APICATA.	APICATA.
O Dieux!	Ô Dieux!
juſqu’où s’eſtend l’inſolence d’vn homme!	jusqu'étend l'étend l'insolence d' Homme!
O Loix, qui permettez te utuorte aux Romains, Faites part de ce trouble au reſte des humains?	Ô Lois, qui permettez te utuorte aux Romains, Faites part de ce trouble au reste des humains?
Et puis qu’on peut troubler des amours legitimes, Accordez vn paſſage à tous les autres crimes?	Et puis qu'on peut troubler des amours légitimes, Accordez un passage à tous les autres crimes?
Quoy?	Quoi?
ie luy ſuis fidelle, & luy me veut trahir!	ie lui suis fidèle, et lui me veut trahir!
S’il ceſſe de m’aimer, dois-je pas le haïr?	S'il cesse de m'aimer, dois-je pas le haïr?
Jl briſe le premier le nœud qui nous engage;	Il brise le premier le nœud qui nous engage;
C’eſt vn lâche, vn ingrat, vn perfide, vn volage;	C'est un lâche, un ingrat, un perfide, un volage;
Puis que ce cœur leger me peut manquer de foy, Faut- il qu’vn inconſtant en attende de moy?	Puis que ce cœur léger me peut manquer de foi, Faut- il qu'un inconstant en attende de moi?
VOLVZIE.	VOLVZIE.
Adjoûtez à ces mots, qu’il eſt espoux & pere, Que vous estes enſemble, & ſa femme, & ma mere, Que c’eſt le meſme, enfin, que vous auez chery, Et que vous pourſuiuez la teſte d’vn mary.	Ajoutez à ces mots, qu'il est époux et père, Que vous êtes ensemble, et sa femme, et ma mère, Que c'est le même, enfin, que vous avez chéri, Et que vous poursuivez la tête d'un mari.
Voyez ſi ce combat vous acquiert de la gloire.	Voyez si ce combat vous acquiert de la gloire.
TERENCE.	TERENCE.
Oüy, Madame, iugez quelle eſt vostre victoire.	Oui, Madame, jugez quelle est votre victoire.
Pu'ejles vons denennes	Pu'éjles vons dennes
APICATA.	APICATA.
Et qu’eſt-il deuenu?	Et qu'est-il devenu?
Apres ces lâchetez, Sejan m’est inconnu;	Après ces lâchetés, Séjan m'est inconnu;
Qui diffame ſa vie, eſt indigne de viure.	Qui diffame sa vie, est indigne de vivre.
TERENCE.	TERENCE.
Se jan eſt voſtre Espoux, le deuez-vous pourſuiure?	Se jan est votre Époux, le devez-vous poursuivre?
PICATA.	PICATA.
Eſtes-vous ſon appuy:	Êtes-vous son appui:
Quoy, Terence, & ma Fille, oſent parler pour luy.	Quoi, Terence, et ma Fille, osent parler pour lui.
Soyez ſes delateurs, & non pas ſes refuges.	Soyez ses délateurs, et non pas ses refuges.
ZIE.	ZIE.
Madame, differez, les Dieux ſeront vos Iuges.	Madame, différez, les Dieux seront vos Juges.
CATA.	CATA.
4 Lima Ty) I Non, ie veux voir Tybere, il m’en fera raiſon;	4 Lima Ty) I Non, tu veux voir Tibère, il m'en fera raison;
Il eſt intereſſé dedans leur trahiſon.	Il est intéressé dedans leur trahison.
ENCE.	ENCE.
Pour la troiſieſme fois, ie m’en vais l’entreprendre;	Pour la troisième fois, ie m'en vais l'entreprendre;
je m'en voay le reuoir.	je m'en vais le revoir.
AI ICATA.	AI ICATA.
Et qu’en faut-il attendre?	Et qu'en faut-il attendre?
NCE.	NÉE.
Madame, esperons mieux, allons.	Madame, espérons mieux, allons.
Mais le voicy.	Mais le voici.
CLNE II.	CLNE II.
SEIAN, APICATA, VOLVZIE, TERENCE.	SEIAN, APICATA, VOLVZIE, TERENCE.
AN.	AN.
1t, ma fiutr un, Terence!	1t, ma fiutr un, Terence!
Gloy, ma ſemme au ßi!	Gloi, ma semme au ussy!
I YMacron ſuspẽs ton ordre, & ſouffre que i’embraſſe Tous ceux que mon malheur engage en ma diſgrace.	I JYMacron suspense ton ordre, et souffre que j'embrasse Tous ceux que mon malheur engage en ma disgrâce.
MACRON.	MACRON.
Ces derniers entretiens ſont de tout temps permis, L’on les peut esperer des plus grands énnemis.	Ces derniers entretiens sont de tout temps permis, L'on les peut espérer des plus grands énnemis.
C’eſt auec déplaiſir.	C'est assez déplaisir.
EIAN.	EIAN.
Ne le fais point paraiſtre, Et ſuis joyeuſement les ordres de ton Maiſtre.	Ne le fais point paraître, Et suis joyeusement les ordres de ton Maître.
Deplore, infortunée, vn infidelle Espoux, Qu'vne diuine main ramene à tes genoux, Et qui dedans le temps qu’il t’auoit découuerte, Par vn ſort plus fâcheux, va reſ-ouurir la perte!	Dépore, infortunée, un infidèle Espoux, Qu'une divine main ramène à tes genoux, Et qui dedans le temps qu'il t'avait découverte, Par un sort plus fâcheux, va résouvrir la perte!
Reçois de mon peché, ce repentir contraint, Au moins, s’il eſt tardif, mon remords n'eſt pas feint.	Reçois de mon péché, ce repentir contraint, Au moins, s'il est tardif, mon remords n'est pas feint.
Tu me fuis:	Tu me fuis:
mon uouru uemm muun ſi funeſte?	mon uouru uemm mon si ouvre?
APICATA.	APICATA.
O de tous mes foupçons, preuue trop manifeſte!	Ô de tous mes soupçons, preuve trop manifeste!
C’eſt vn trait de Liuie.	C'est un trait de Livie.
A 2 Oüy, tu l’as preſſenty, Et ton fidelle inſtinct m'en auoit aduerty:	A 2 Oui, tu l'as pressenti, Et ton fidèle instinct m'en avait averti:
Elle-meſme me perd, & l’ingratte m’accuſe, D’auoir empoiſonné Germanicus & Druſe;	Elle-même me perd, et l'ingratte m'accuse, D'avoir empoisonné Germanicus et Druse;
Par l'ordre de Typere l'on me menne au Senat, Pour me iustifier de cet aſſaßinat.	Par l'ordre de Typère l'on me menne au Sénat, Pour me justifier de cet assassinat.
Voy l’eſtat déplorable où m’a mis l’impoſture.	Vois l'état déplorable où m'a mis l'imposture.
O ſenſible ſpectacle?	Ô sensible spectacle?
OLVZIE.	OLVZIE.
TERENCE.	TERENCE.
O funeste auanture!	Ô funeste aventure!
VOLVZIE.	VOLVZIE.
Où le retreuuez-vous?	Où le retruez-vous?
APICATA.	APICATA.
Aun nen omielle pers;	Aun nen omielle pers;
Aydons luy, Voluzie, à ſupporter ſes fers, Tragedie.	Aidons -lui, Voluzie, à supporter ses fers, Tragédie.
Dans ce delaiſſementoù la Cour l’abandonne Om et uijgratie, n'eſt connen ue perſonne.	Dans ce délaissementoù la Cour l'abandonne Om et uijatie, n'est connen ue personne.
TERENCE.	TERENCE.
Eſt-il quelque ſpectacle eſgal à cetobjet?	Est-il quelque spectacle égal à cetobjet?
O ſort!	Ô sort!
pour t'exercer, as-tu prins ce ſujet?	pour t'exercer, as-tu prins ce sujet?
Se jan diſgracié, Cette grande inconſtance, Eſt ſans doute vn effort de ta toute puiſſance;	Se jan disgracié, Cette grande inconstance, Est sans doute un effort de ta toute puissance;
Et ſa cheute m’amis dans vn eſtonnement, Que n’auroit point causé tout autre changement, Vn Roy depoſſedé que ſon peuple abandonne, En ſa comparaiſon n'aura rien qui m’eſtonne, Tous les iours la fortune à de pareils reuers Et mille ſouuerains ſont morts dedans les fers, Mais que cette barbare eſtande ſes outrages Et porte ſa fureur ſur ſes propres ouurages, Quand elle aneantit ſés plus grands fauoris Qu'elle eſt laſſe d’aimer ceux qu’elle a tant cheris;	Et sa chute m'amis dans un étonnement, Que n'aurait point causé tout autre changement, Veun Roi dépossédé que son peuple abandonne, En sa comparaison n'aura rien qui m'étonne, Tous les jours la fortune à de pareils revers Et mille souverains sont morts dedans les fers, Mais que cette barbare étende ses outrages Et porte sa fureur sur ses propres ouvrages, Quand elle anéantit savez plus grands favoris Qu'elle est lasse d'aimer ceux qu'elle a tant chéris;
8 Qu'elle expoſe à nos yeux ces triſtes decadances Nous deuons déplorer de telles inſolences, N’eſt-ce point vne veuë à fondre tout en pleurs Et qu'on puiſſe nommer le comble des mal-heurs.	8 Qu'elle expose à nos yeux ces tristes décadances Nous devons déplorer de telles insolences, N'est-ce point une vue à fondre tout en pleurs Et qu'on puisse nommer le comble des malheurs.
EIAN.	EIAN.
Ouy, Rome m’honnoroit auec idolatrie Et ie ſuis le meſpris de celuy qui me prié, Ce Seian en faueur, ce Dieu des courtiſans Eſt laſchement traby de tous ſes partiſans, Tous ſes adorateurs luy manquent de parole Ils ſe vont proſterner aux pieds d’vn autre idole, Allez la parfumer & de vœux & d’encens Laſches allez briguer le credit des puiſſans, Et par vne habitude à perdre tous vos maiſtres Allez dire au Senat que vous eſtes des traiſtres, Que vous m'auez ſeruy corrompus par mes dons Et que vos repentirs meritent vos pardons.	Oui, Rome m'honorait avec idolâtrie Et tu suis le mépris de celui qui me prié, Ce Séian en faveur, ce Dieu des courtisans Étant lâchement trabi de tous ses partisans, Tous ses adorateurs lui manquent de parole Ils se vont prosterner aux pieds d'un autre idole, Allez la parfumer et de vœux et d'encens Lâches allez briguer le crédit des puissants, Et par une habitude à perdre tous vos maîtres Allez dire au Senat que vous êtes des traîtres, Que vous m'avez servi corrompus par mes dons Et que vos repentirs méritent vos pardons.
APICATA.	APICATA.
Ie l’auois bien preueu?	Je l'avais bien preu?
EIAN.	EIAN.
Ie voy mon precipice:	Je vois mon précipice:
Puiſque i'y ſuis reduit il faut que s’y periſſe, Que toute ma maiſon s'esbranle auecque moy Et qu’vn poids ſi peſant te traine quand & ſoy Si ie ſuis condamné pluſieurs me doiuent ſuiure Le coup dont ie mourray les empeſche de viure, Ie voy mes oppreßeurs pompeux & triomphans Accabler mes amis, ma femme & mes enfans, Comme s’ils pourſuiuoient vne longue victoire D'eſcrier de Sejan iuſques à ſa memoire, De tant d’indigniteZ Rome les va loüer Et la pluſpart des miens me va deſaduoüer, D'vne telle deſroute horrible & generalle Ils en vont eſleuer tous ceux de leur caballe,	Puisque j'y suis réduit il faut que s'y périsse, Que toute ma maison s'ébranle avec moi Et qu'un poids si pesant te traine quand et soi Si je suis condamné plusieurs me doivent suivre Le coup dont sans mourrai les empêche de vivre, Je vois mes oppresseurs pompeux et triomphants Accabler mes amis, ma femme et mes enfants, Comme s'ils poursuivaient une longue victoire D'écrier de Séan jusques à sa mémoire, De tant d'indignité Rome les va louer Et la plupart des miens me va desaduoüer, D'âme me déroute horrible et va Ils envontrible tous ceux De nu caballe,
Deſia ſur ma ruine ils ſe dreßent vn plan Et deuorent entre eux les grands biens de Sejan, Le peuple s’y figure vn monceau de richeſſes Que n’a point diſsipé grand nombre de largeſſes, Vn treſor compoſé de ſang & de ſueurs Vn amas exceßif formé de leurs labeurs, Mes papiers tous remplis de receptes & d’offres Et tout l’or de l’Empire enfermé dans mes coffres, Tibere pourra voir tout ce que i'ay laiſſé Et le nombre des biens que i’auray ramaſſé, Ie laiſſe trois enfans à cette prouidence Qui contre les puiſſans protege l’innocence, Ouy, vous eſtes grands Dieux des tuteurs eternels Ie commets mes enfans à vos ſoins paternels;	Déjà sur ma ruine ils se dresient un plan Et dévorent entre eux les grands biens de Séjan, Le peuple s'y figure un monceau de richesses Que n'a point dissipé grand nombre de largesses, Un trésor composé de sang et de sueurs Un amas excessif formé de leurs labeurs, Mes papiers tous remplis de receptes et d'offres Et tout l'or de l'Empire enfermé dans mes coffres, Tibère pourra voir tout ce que j'ai laissé Et le nombre des biens que j'aurai ramassé, Je laisse trois enfants à cette prouidence Qui contre les puissan protege innocence, , vous estes grands Dieux des tuteurs éternels Ie commets mes enfans vos soins pr;
Ie te remets ma fille, ô conduite eternelle, Contre nos ennemis declare-toy pour elle, Tu la verras bien-toſt le meſpris d’vn Preteur Le diuertiſſement d’vn fils d’vn Senateur, Ta ſageſſe infinie eſgale mieux les choſes Et n’ordonne de rien que par de iuſtes cauſes, S’il eſt expedient qu’elle doiue mourir Enjuit ne Cejan tu la feras perir, Loin qu'elle ſoit du peuple extermine ma race L’aneantiſſement ſied mieux que la diſgrace, Ie t’inſpire ma fille vn raiſonnable orgueil Et s’il faut s’abaiſſer que ce ſoit au cercueil, Mon ſang ne peut ſouffrir des baſſeſſes inſignes, Apres des Empereurs tous partis ſont indignes, Eſpouſe le treſpas & meurs auec honneur, Ie te vay preceder?	Je te remets ma fille, ô conduite éternelle, Contre nos ennemis déclare-toi pour elle, Tu la verras bientôt le mépris d'un Preteur Le divertissement d'un fils d'un Sénateur, Ta sagesse infinie égale mieux les choses Et n'ordonne de rien que par de justes causes, S'il est expédient qu'elle doiue mourir Enjuit ne Céjà tu la feras périr, Loin qu'elle soit du peuple extermine ma race L'anéantissement sied mieux que la disgrâce, Je t'inspire ma fille raisonnable orgueil Et il faut sabaisser que ce soit ' il, Mon fa ne ut souffrir des ' insignes, Apres des Empereurs tous partis sont indignes, Espouse le trépas et meurs auec honneur, Ie te vay précéder?
OLVZIE.	OLVZIE.
Ie vous ſuiuray Seigneur,	Je vous suivrai Seigneur,
SEIAN.	SEIAN.
Sans ſa poſſeßion tu peux viure Terence.	Sans sa possesions tu peux vivre Terence.
Tu ne dois point briguer noſtre triſte alliance, La maiſon de Se jan eſt preſte à ſuccomber, Et c’eſt vn fondement qui te feroit tomber, Et toy ma chere femme ou s’eſtend ton courage, Oſe tu bien te perdre en ce commun haufrage, Non, non, enfrains vn droit que ie n'’ay point tenu Noſtre hymen de ma part fuſt mal entretenu, I'ay violé nos loix tu les pourrois enfraindre Par mon impunité tu dois ceſſer de craindre.	Tu ne dois point briguer notre triste alliance, La maison de Se jan est prête à succomber, Et c'est un fondement qui te ferait tomber, Et toi ma chère femme ou s'étend ton courage, Ais tu bien te perdre en ce commun haufrage, Non, non, enfrains un droit que ie j'ai point tenu Notre hymen de ma part fut mal entretenu, J'ai violé nos lois tu les pourrais enfraindre Par mon impunité tu dois cesser de craindre.
APICATA.	APICATA.
I'en voy le chaſtiment c’eſt moy qui l’ay causé O Dieux dans mes ſouhaits montie a trop oſé, Vn ſimple repentir euſt contenté ma hayne Et par ce grand ſurcroiſt vous adiouſtez la peine, Vous in'auez exaucee au de-là de mes vœux Ce n’eſt point ſa diſgrace, ou ſa mort que ie veux, Mais vous me l’accordeZ rigoureuſe iuſtice, Ordonnez donc pour moy la moitié du ſupplice.	J'en vois le châtiment c'est moi qui l'ai causé Ô Dieux dans mes souhaits montie a trop osé, Un simple repentir eût contenté ma haine Et par ce grand surcroît vous ajoutez la peine, Vous inté exaucée au de-là de mes vœux Ce n'est point sa disgrâce, ou sa mort que ie veux, Mais vous me l'accordez rigoureuse justice, Ordonnez donc pour moi la moitié du supplice.
SEIAN.	SEIAN.
Non le Ciel eſt content de la perte de l’vn Ie vays eſtre immolé pour le ſalut commun, Ie m'offre en ſacrifice à ce courroux celeſte Les Dieux de ma maiſon ſauueront quelque reſte, Ma teſte eſt le ſeul but ou tendra leur fureur Allez vous proſterner aux pieds de l’Empereur, D'vn debris general guarantiſſez vos teſtes Mettez vous par ſa grace à l’abry des tempeſtes, A couuert de la main de vos perſecuteurs L’innocence opprimee à peu de protecteurs, L’homme le plus content montre vn diuers viſage Selon qu’il conſidere ou le calme ou l’orage, Et l’on voit ſes eſprits arreſtez ou flottans Par la diuerſité des hommes ou des temps, Voila l’vnique amy que le Ciel me conſerue, L'on de ces genereux qui n'ont point de reſerue, Qui ne ſçauent que c'eſt de ſeruir à demy, Et ſans point de motif obligent vn amy;	Non le Ciel est content de la perte de l'un Je vais être immolé pour le salut commun, Je m'offre en sacrifice à ce courroux celtes Les Dieux de ma maison sauveront quelque reste, Ma tête est le seul but ou tendra leur fureur Allez vous prosterner aux pieds de l'Empereur, D'un débris général garantissez vos têtes Mettez vous par sa grâce à l'abri des tempêtes, A ouvert de la main de vos persécuteurs L'innocence opprimée à peu de protecteurs, L'homme le plus content montre ur visage Selon il considere ou le calme ou orage, Et on voit ses esprits arrêtez ou flottans Par la diuersité des hommes ou s' temps, Visa vnique amy Se le Ciel me on, L'on de ces généreux qui 'il con de reserue, Qui ne ale que c'est de servir a demi, Et sans ou le motif obligent ç a;
Preſumons tout des Dieux, le Ciel n’eſt point barbare, Il l'eſt s’il fait perir vne amitié ſi rare.	Presumons tout des Dieux, le Ciel n'est point barbare, Il l'est s'il fait périr une amitié si rare.
TERENCE.	TERENCE.
Vous meſme eſpereZ mieux, vous reuiendrez abſous;	Vous -même espérez mieux, vous reviendrez absous;
SEIAN.	SEIAN.
Ie me voiscondamné par la bouche de tous,	Je me voiscondamné par la bouche de tous,
ii Sans que l’on m’examine, & ſans qu’on en conſulte.	ji Sans que l'on m'examine, et sans qu'on en consulte.
Vn iugement ſi prompt, ſe doit faire en tumulte, Pour ſe iuſtifier, le coup fuſt reſolu;	Un jugement si prompt, se doit faire en tumulte, Pour se justifier, le coup fût résolu;
Et dira le Senat, le Prince la voulu?	Et dira le Sénat, le Prince la voulu?
Adieu, ma chere fille, adieu ma chere fame.	Adieu, ma chère fille, adieu ma chère famé.
JOLVZIE.	JOLVZIE.
Ah!	Ah!
Seigneur,	Seigneur,
EIANCachez moy ces foible ſſes de l’ame;	EIANCachez -moi ces faible sses de l'âme;
Retenez vos ſoupirs:	Retenez vos soupirs:
APICATA.	APICATA.
Cruel, qu’ordonnes-tu:	Cruel, qu'ordonnes-tu:
EIAN.	EIAN.
C’eſt dans l'extremité que paroiſt la vertu,	C'est dans l'extrémité que paraît la vertu,
MACRON.	MACRON.
Regulus vient à nous, le Prince le doit ſuiure.	Régulus vient à nous, le Prince le doit suivre.
Ah!	Ah!
Seigneur, deſpéchons,	Seigneur, despéchons,
EIAN.	EIAN.
Ouy, Macron, c'eſt trop viure	Oui, Macron, c'est trop vivre
SVEAVDEEL APICATA, VOLVZIE, TERENCE, REGVLVS.	SVEAVDEEL APICATA, VOLVZIE, TERENCE, REGVLVS.
al l ne la lvlo.	al l ne la lulo.
Viuons le cher Terence;	Vivons le cher Terence;
TERENCE.	TERENCE.
Ouy, delaiſſons ce lieu.	Oui, délaissons ce lieu.
EGVLVS.	EGVLVS.
Seigneur, arreſtez-vous, c’eſt l’ordre de Tybere;	Seigneur, arrêtez-vous, c'est l'ordre de Tibère;
Ie ne fais qu'obeyr.	Je ne fais qu'obéir.
ERENOE T’on offence eſt legere, Mene nous à Caſar,	ERENOE -T-on offense est légère, Mène nous à Casar,
EGVLVS.	EGVLVS.
Luy meſme vient à nous.	Lui même vient à nous.
LTEE V ATTCATA, VOLVZIE, TERENCE, REGVLVS, TIBERE.	LTE V ATTTCATA, VOLVZIE, TERENCE, REGVLVS, TIBERE.
APICATA.	APICATA.
Eigneur, vne affligee embraſſe vos genoux.	Eigneur, une afflige embrasse vos genoux.
YOLVZIE.	YOLVZIE.
Ie me iette à vos pieds,	Je me jette à vos pieds,
TIBERE.	TIBERE.
Ie vous veux faire grace, Quoy, qu'en crime d’Eſtat l’on condamne vne race.	Je vous veux faire grâce, Quoi, qu'en crime d'État l'on condamne une race.
APICATA.	APICATA.
Moins pour nous que pour luy i’implore vos bontez	Moins pour nous que pour ra j'implore vos bontés
TIBERE.	TIBERE.
Non il s’eſt obſtiné contre mes volontez, Je le voulois ſauuer il n’a rien voulu dire.	Non il s'est obstiné contre mes volontés, Je le voulais sauver il n'a rien voulu dire.
Qu'il reſpunde?	Qu'il respunde?
APICATA.	APICATA.
Ah!	Ah!
Ceſar,	César,
TIBERE.	TIBERE.
Qu'on l’emmene cheZ elle:	Qu'on l'emmène chez elle:
Reſoluez-vous au pire;	Résoluez-vous au pire;
APICATA.	APICATA.
Ahy par tout c’eſt la mort?	Ahi par tout c'est la mort?
D I IBERE, TERENCE.	D I IBÈRE, TERENCE.
TIBERE.	TIBERE.
IOy que ta deſtinee attachoit à ſon ſort ¶ Par des preſomptions i’ay commandé tapriſe Et me ſuis figuré que tu ſçais l’en trepriſe, En ce que cét amour dont tu m’auois parlé M’a faict con jecturer qu’il ne t’a rien celé, Et puis qu’il t’honnora de cette confidence Il eſt bien apparant qu’il t’en dit l’importance,	JOi que ta destinée attachait à son sort aisé Par des présomptions j'ai commandé taprise Et me suis figuré que tu sais l'en treprise, En ce que cet amour dont tu m'avais parlé M'a fait con jecturer qu'il ne t'a rien celé, Et puis qu'il t'honora de cette confidence Il est bien apparant qu'il t'en dit l'importance,
Qu’il t’aura deſcouuert l’eſtat de ſes deſſeins Qu’il t’aura reuelé le nom des aſſaßins, Comme dans mon Empire il dreſſoit ſes parties Comme mes legions durent eſtre aduerties, Et qu’au moindre courrier qu’on auroit ſes aduis Son ordre & ſes drapeaux deuoient eſtre ſuiuis, Que pendant que dans Rome il maintenoit ſes brigues Chez tous mes Generaux il ſußitoit des ligues, Qu’il auoit reſpandu grand nombre de preſens Qu’il s’acquerroit par-lâ de puiſſans partiſans, Qu’il auoit corrompu, la Gaule & l’Allemagne Que ſon ſecours marchoit la prochaine campagne, 1 Qu'il viendroit m'aßieger iuſques dans mon Palais Et qu’il me reduiroit à demander la paix.	Qu'il t'aura découvert l'état de ses desseins Qu'il t'aura revelé le nom des assassins, Comme dans mon Empire il dressait ses parties Comme mes légions durent avoir averties, Et qu'au moindre courrier qu'on aurait ses avis Son ordre et ses drapeaux devaient être suivis, Que pendant que dans Rome il maintenait ses brigues Chez tous mes Généraux il sussitoit des ligues, Qu'il avait répandu grand nombre de presens Qu'il s'acquérait parle de puissants partisans, Qu'il avait corrompu, la Que et dAn Que mon Gaule et l' prochaine magne, 1 Qu'il viendroit m'assieger iusques dans mon Palais Et il me reduiroit demander la paix.
Qu'vn nombre de ſoldats, iroient de place en place A ſon election porter la populace, Que moitié par ſuffrage & moitié par terreur Rome l’honoreroit du tiltre d’Empereur, Qu'elle teſmoigneroit de grandes complaiſances Qu'elle metroit m'a mort dans ſes magnificences, Et que par vne pompe à deuorer ſon char Ie ſeruirois de marche à ce nouueau Ceſar, C’eſt ainſi que ce traiſtre ordonnoit ſes penſees C’eſt deſſus ce beau plan qu’elles furent dreſſees, L'entrepriſe eſt viſibiuamiouu jue proceutie, Et dans ces attentats qui ſe ſont ſuccedez, Ne te picque donc point d’vne conſtance extreme Et loin de le ſauuer guaranty-toy toy-meſme, Aduoüe ingenument qu’il esbranla ta foy Que de puiſſants motifs t'armerent contre moy, Que cette paßion qui fait tout meſconnoiſtre Que l’amour t’aueugla, iuſqu’à trahir ton maiſtre, Quen ie monpirant ja fuit ante tons jes jecrets Il te fiſt eſpouſer ſes moindres intereſts.	Qu'un nombre de soldats, iraient de place en place À son élection porter la populace, Que moitié par suffrage et moitié par terreur Rome l'honorerait du titre Ur, Qu'elle témoignerait de grandes complaisances Qu'elle metroit m'a mort dans ses magnificences, Et que par une pompe à dévorer son char Je servirais de marche à ce nouveau César, C’est ainsi que ce traître ordonnait ses pensées C'est dessus ce beau plan m'elles furent dressées, 'entreprise est sem è re, Et dans ces attentats qui se sont succédez, Ne te picque donc point constance extrême Et Loin de le sauuer guaranty-toi toi-même, Aduoüe in , ébranla ta foi Que de ans motifs t'armèrent ce moi, Que cette passion qui fait tout mesconnoistre De amour aueugla, iusqu’ trahir ton maître, Qu' il ava fuit ante tons jecrets Il te fît épouser ses moindres intérêts.
TERENCE.	TERENCE.
Les grands ſont dangereux dans toutes leurs creances Ils tirent leurs ſoubçons des moindres vray-ſemblãces, Et des impreßions que les Princes ſe font Les maux naiſsẽt plus grãds ou moindres qu’ils ne ſont, C’eſt à luy d’auoüer ou de nier ce crime!	Les grands sont dangereux dans toutes leurs créances Ils tirent leurs soubçons des moindres vrai-semblãces, Et des impressions que les Princes se font Les maux naissent plus grands ou moindres qu'ils ne sont, C'est à lui d'auoüer ou de nier ce crime!
Et pour mes intereſts ie deffends mon eſtime, Les plus grands impoſteurs ne la peuuent noircir Ma vie à des clairtez, qu’on ne peut obſcurcir, Ma reputation n’eſt point enſeuelie Et Terence eſt illuſtre aux yeux de l’Italie, La guerre m'eſleua parmy tous ſes haZards Et ma gloire s’eſt faite en ſeruant trois Ceſars, La voix de vos ſoldats parle à mon aduantage Vous ſeul m’en refuſez vn ſimple teſmoignage, Mon plus grand in tereſt fuſt celuy de l’honneur Le ſort m’a contenté i’ay veſcu ſans bon-heur, Sans dignitez, ſans biens, ſans nulle recompenſe Et n’ay point excedé l’eſtat de ma naiſſance, Il eſt vray que Sejan m’a mis dans la faueur Qu'il parla de mon Zele auec grande ferueur,	Et pour mes intérêts après défends mon estime, Les plus grands imposteurs ne la peuvent noircir Ma vie à des clairtez, qu'on ne peut obscurcir, Ma réputation n'est point ensevelie Et Terence est illustre aux yeux de l'Italie, La guerre m'éleva parmi tous ses hasards Et ma gloire s'est faite en servant trois Césars, La voix de vos soldats parle à mon avantage Vous seul m'en refusez un simple témoignage, Mon plus grand Mon terest fût celui de l'honneur Le sort m'a contenté j'avécu sans bon-heur, Sans dignité, sans bien, as su recompense Et ay point excedé estat de ma naissance, Il est vrai que San a mis dans la faueur Qu'il parla de mon Zele auec grande ferveur'
Sejanus, Qu’il auoit entrepris le ſoin de ma fortune Et qu’il me reieſtoit dans vne heure oportune, Eſt-ce vn crime d’Eſtat, que de l’auoir aymé Et par quelle raiſon en ſerois-ie blaſmé Mon amitié luy pluſt, i’ay recherché la ſienne Voſtre inclination a precedé la mienne, Nous honorions en luy l’amy de l’Empereur Voſtre exemple Ceſar excuſoit noſtre erreur, Vous eſtes criminel ſi nous ſommes coupables Si vous vous abſoluez nous ſommes pardonnables, Le reſpect de nos loix eſt-il ſi rigoureux Seriez-vous l’innocent & moy le mal-heureux, Et le Senat, Seigneur, nous rendroit il iuſtice S’il ſauuoit le coupable & perdoit le complice, Il nous diſtribuoit toutes les dignitez La Cour rouloit au gré de ſes proſperitez, Vous l’auiez eſleué ſur toutes les puiſſances Ie luy vy diſpenſer la guerre & les finances, La police & les loix eſtoient dedans ſes mains Il eſtoit apres vous l’Empereur des Romains, Ses amis eſtoient crains & rendus neceſſaires Il leur communiquoit vne part des affaires, Les liberalitez qu’il receuoit de vous Comme par vn canal s’eſpendoient iuſqu’à nous, Nous honnorions en luy l’vne de vos Images Et dans luy voſtre peuple adoroit vos ouurages, Les Dieux vous ont remis la ſouueraineté Vn pouuoir d’agrandir qui n'eſt point limite,	Sejanus, Qu'il avait entrepris le soin de ma fortune Et qu'il me re dans-dire heure oportune, Est-ce un crime d'Estat, que de l'avoir aimé Et par quelle raison en serais-je blâme Mon amitié quelques plaît, j'ai recherché la sienne Votre inclination à précédé la mienne, Nous honorions en lui l'ami de l'Empereur Était exemple César excusait quelque erreur, Vous êtes criminel si nous sommes coupables Si vous vous absolvez nous sommes pardonnables, Le respect de nos lois est- si rigoureux Seriezvous est et moi le mal-vou, Et le St, Seigneur, -vous rendroit il iustice il sauuoit le cou et perdoit le complice, Il nous distribuoit toutes les dignité La Cour rouloit au gré de ses prospérité, Vous auiez esleué sur toutes les puissances Ie lui vi dispenser la guerre et les finances, La police et les loix estoient dedans ses ' Il estoit a vous Empereur des Ai, Ses amis estoient mis et rendus nécessaires Il leur ton part des affaires, Les libéralité il receuoit de vous Comme par canal espendoient iusqu’ nous, Nous honnorions en lui de vos Images Et dans lui vôtre peuple adoroit vos ouurages, Les Dieux vous ont remis la souueraineté pouuoir agrandir qui n'est point limite,
Eſt-ce à nous de iuger le ſecret de ſes choſes Ny quels vous eſleuez ny moins pour qu'elles cauſes, Ce ſont des profondeurs que l’on ne peut trouuer Et difficilement y peut-on arriuer, L’on ne peut paruenir à cette cognoiſſance La ſcience du peuple eſt dans l’obeyſſance, Ne parlons point du iour de ſa calamité Conſiderons le cours de ſa felicité, Dans ce temps glorieux vn homme de merite Euſt rendu des honneurs au moindre de ſa ſuitte, Des eſclaues chez luy s’eſtoient tous enrichis Et nous faiſions la Cour à tous ſes affranchis, L’amitié de Sejan eſtoit aduantageuſe Fauorable autrefois comme elle eſt mal-heureuſe, Ie la veux maintenir iuſqu’au dernier arreſt Et s’il eſt conuaincu quitter ſon intereſt, Comme ie ne prend point le party d'vn coupable Ie n’abandonne pas celuy d’vn miſerable, Peur jes umourt Seſar, il ne m'en cela rien Ie l’en diſſuaday dedans vn entretien, Pour ſes autres proiets s’il en eſtoit capable Luy ſeul de ſon complot, eſt complice & coupable, Nul ne ſçait ſes deſſeins, il ne m’en parla point Et Sejan n'eſt amyque iuſques à ce point.	Est-ce à nous de juger le secret de ses choses Ny quels vous élevez ni moins pour qu'elles causes, Ce sont des profondeurs que l'on ne peut trouver Et difficilement y peut-on arriver, L'on ne peut parvenir à cette connaissance La science du peuple est dans l'obéissance, Ne parlons point du jour de sa calamité Considérons le cours de sa félicité, Dans ce temps glorieux homme de mérite Eut rendu des honneurs au moindre de sa suitte, Des esclaves chez luy s'étaient tous enrichis Et nous faisions la Cour à tous ses affranchis, Lamitié de Sejan estoit aduantageuse Fauorable autrefois comme elle est mal-heureuse, Ie la veux maintenir iusqu’au dernier arrest Et il est convaincu quitter son intérêt, Comme ie ne prend point le party ' coupable Ie a pas celui mi, Peur umourt Sesar, il ne m'en cela rien Ie en dissuaday dedans entretien, Pour ses autres proiets il en estoit capable seul de son m, est complice et coupable, Nul ne sçait ses desseins, il ne en parla point Et Sejan n'est amyque iusques ce point.
TIBERE.	TIBERE.
Le Senat iugera deſſus les apparences Si l’acuſation à quelques vray-ſemblances, Et s’il peut là deſſus appuyer ſon arreſt, Toy qui iuſqu’au peril a pris ſon intereſt, Ta franchiſe m'a pleu i’y voy ton innocence Et cét adueu ſi noble à deſtruit ma creance, La foy peut compatir auecque l’amitié.	Le Sénat jugera dessus les apparences Si l'acusation à quelques vraiisemblances, Et s'il peut là dessus appuyer son arrêt, Toi qui jusqu'au péril a pris son intérêt, Ta franchise m'a plu j'y vois ton innocence Et cet aveu si noble à détruit ma créance, La foi peut compatir auecque l'amitié.
TERENCE.	TERENCE.
Seigneur ſon infortune, eſt digne de pitié,	Seigneur son infortune, est digne de pitié,
TIBERE.	TIBERE.
Lee trois point m'attanarir iaiſſe agir la Iuſtice I'ay remis au Senat ſa grace ou ſon ſupplice, Va reſoudre ſa femme, adieu.	Lee trois point m'attanarir jaisse agir la Justice J'ai remis au Sénat sa grâce ou son supplice, Va résoudre sa femme, adieu.
TERENCE, ſeul.	TERENCE, seul.
Voyons ſa fin?	Voyons sa fin?
Allons, allons, apprendre vn ſi triſte deſtin, Et ce que le Senat ordonnera d’vn homme Qui penuant tant de temps a regné dedans Rome, S’il doit ſeruir d’exemple aux grands de l’Vniuers Mourons & ſuccombons d'vn ſi fameux reuers.	Allons, allons, apprendre un si triste destin, Et ce que le Sénat ordonnera d'un homme Qui penvant tant de temps a régné dedans Rome, S'il doit servir d'exemple aux grands de l'Univers Mourons et succombons d'vn si fameux revers.
Fin du quatrieſme Acte.	Fin du quatrième Acte.
d I 2 A 2 SUEEVE I TIBERE, ſuiuy de REGVLVS.	d I 2 A 2 SUEEVE I IBÈRE, suivi de REGVLVS.
TIBERE.	TIBERE.
Ome s’eſt reuoltee eſt-elle aſſez hardie NDieux, prenez-vous party dans cette perfidie, Et ſouſtenant des miens les inſolens proiets Contre leurs Empereurs armés vous des ſuiets, En faueur de Se jan mon peuple ſe rebelle Quet moiiſ binitreſfe à prenurt ja querelle, Peuple qui dans ta haine és touſiours obſtiné Qeique pouuon que nuje uy ie mal gouuerné Allons nous preſenter à cette populace Et d’vn front d’Empereur arreſtons ſon audace, La preſence du Prince aura quelque pouuoir.	Ôme s'est révolte est-elle assez hardie NDieux, prenez-vous parti dans cette perfidie, Et soutenant des miens les insolents proiss Contre leurs Empereurs armés vous des sujets, En faveur de Se jan mon peuple se rebelle Quet moiis binitresfe à prenurt ja querelle, Peuple qui dans ta haine ès toujours obstiné Qeique pouuon que nuje ui était mal gouverné Allons nous présenter à cette populace Et d front 'Empereur arrêtons son audace, La présence du Prince aura quelque pouvoir.
REGVLVS.	REGVLVS.
Ceſar, ne ſortez, point vous pourriez, l’eſmouuoir, De quartier en quartier toute Rome eſt en armes Ainſi de bouche en bouche on paſſe ces allarmes, L’air eſt battu de cris, de coups & de clameurs, Et l’on n’entend par tout que de ſourdes rumeurs, Rome ne vit iamais des eſmeutes pareilles, Ce bruit prodigieux a frappé mes oreilles, Er uu pueiv au l'atais ie lauvis enienau Quand vostre Maieſté m’y viſt tout eſperdu.	César, ne sortez, point vous pourriez, l'émouvoir, De quartier en quartier toute Rome est en armes Ainsi de bouche en bouche on passe ces alarmes, L'air est battu de cris, de coups et de clameurs, Et l'on n'entend par tout que de sourdes rumeurs, Rome ne vit jamais des émeutes pareilles, Ce bruit prodigieux à frappé mes oreilles, Er pueiv au l'atais ie lauvis enienau Quand vôtre Maiesté y vît tout éperdu.
TIBERE.	TIBERE.
Honteux abaiſſement qu’il me faille l’attendre Et qu’vn peuple me mette en estat de me rendre, Dangereuſe imprudence, ou me vois-ie reduit Que n'auois-ie ordonné qu’on m’en deffit ſans bruit, Que n’ay-ie decidé d’vn procez d’importance Et pourquoy le Senat en eut-il cognoiſſance, Grande raiſon d’Eſtat, ie vous pratiquay mal Ce manque de prudence eſt vn defaut fatal, Le ſoub çon doit ſuffire en vn pareil rencontre Dans les poins delicats le iugement ſe montre, L’on ſe doit eſclaircir par vn ſimple attentat Mais perdre ſourdement vn criminel d’Estat, Et pour peu de clairtez qu’y voye vn politique Paroiſtre en apparence iniuſte & tyrannique, Ne ſe point attacher à la formalité Et ſe bien preualoir de ſon autorité, I'en ay commis la faute & i’en porte la peine Tel eſt l’euenement de la prudence humaine, Nous treuuons le remede apres les accidens Et iuſqu’aux chaſtimens nous ſommes imprudens, Ceſt icy Regulus qu’il faut que ie te blaſme Tu deuois retenir, & Terence & ſa fame, Tu deuois conſeruer ce dangereux dépoſt Et ta main imprudent s’en deſaiſit trop toſt, Ah i rebelle Terence, en vain ie le menace Il rit de ma cholere ainſi que de ma grace, Et ce ſeditieux n'eſt plus en mon pouuoir:	Honteux abaissement qu'il me faille l'attendre Et qu'un peuple me mette en état de me rendre, Dangereuse imprudence, ou me vois-je réduit Que n'avais-je ordonné qu'on m'en défit sans bruit, Que n'ai-je décidé d'uns procez d'importance Et pourquoi le Sénat en eut-il connaissance, Grande raison d'État, je vous pratiquai mal Ce manque de prudence est un défaut fatal, Le soub on doit suffire en un pareil rencontre Dans les poins délicats le jugement se montre, Lon se doit éclaircir par n simple attentat Mais perdre sourdement criminel dEstat, Et pour peu de clairtez y voie politique Paroistre en apparence iniuste et tyrannique, Ne se point attacher la formalité Et se bien prévaloir de son autorité, en ay commis la faute et en porte la peine Tel est événement de la prudence me, Nous treuuons le remède apres les accidens Et iusqu’aux chastimens nous sommes imprudens, Cest y Regulus il faut que ie te blâme Tu deuois retenir, et Terence et sa famé, Tu deuois con ce dangereux dépost Et ta main imprudent en desaisit trop tôt, Ah y rebelle Terence, en vain ie le menace Il rit de ma cholere ainsi que de ma grace, Et ce séditieux n'est plus en mon pouuoir:
C’eſt luy qui s'eſt armé!	C'est lui qui s'est armé!
REGVLVS.	REGVLVS.
Qui l’auroit pû preuoir?	Qui l'aurait pu prévoir?
AIDERCLO Druze tout effrayé retourne auec Liuie Parmy tant de perils a-t’il gardé ſa vie, Il porte dans ſes yeux l’image du danger.	ÀIDERCLO Druze tout effrayé retourne avec Livie Parmi tant de périls a-t-il gardé sa vie, Il porte dans ses yeux l'image du danger.
TE DRVZE, LIVIE, TIBERE, REGVLVS.	TE DRUZE, LIVIE, TIBERE, REGVLVS.
DRVZE.	DRUZE.
Eigneur figurez-vous vn ſoldat eſtranger, Vne armee ennemie vn conquerant dans Rome Et iuſque, ou peut monter la cruauté d’vn homme.	Eigneur figurez-vous un soldat étranger, Une armée ennemie un conquérant dans Rome Et jusque, ou peut monter la cruauté d'un homme.
Ioignez-y la fureur de tous les élemens Les tremblemens, les feux, & les desbordemens, Il n’eſt rien de ſemblable à tant de barbaries Il ſemble que l’Enfer ait vomy ſes furies, Vn deluge de ſang coule de bout en bout Et les corps entaſſes sy rencomrent pur tout, L'on marche ſur les morts?	Ioignez-y la fureur de tous les éléments Les tremblements, les feux, et les débordements, Il n'est rien de semblable à tant de barbaries Il semble que l'Enfer ait vomi ses furies, Un déluge de sang coule de bout en bout Et les corps entasses sy rencomrent pur tout, L'on marche sur les morts?
TIDERE.	TIDERE.
Deſordre eſpeuuentable;	Désordre espeuuentable;
DRVZE.	DRUZE.
La vengeance y fait voir ce qu’elle a d’effroyable, Des maiſons qu'elle force elle en fait des tombeaux, Le corps d’vn ennemy s’y deſchire à lambeaux, Elle arrache ſon cœur auecque ſes entrailles Et d’vne main ſanglante elle en bat les murailles, Elle porte les feux, les cordeaux & le fer L’on ne voit que bruſler, maſſacrer, eſtouffer, Il ſe forme vne voix dés qu’elle eſt entenduë L’ordre qu’on a donné vole de ruë en rue, Ses amis ſont ſuiuis iuſques dans leurs maiſons Et des ſiens l’on remplit le tybre & les priſons, Meure, meure Sejan, crie vn peuple en colere L’ennemy de l’Empire eſt celuy de Tibere, Et d’vn redoublement, d’vn ton plus irrité Mthre, menre, bejan & ja poſteriie.	La vengeance y fait voir ce qu'elle a d'effroyable, Des maisons qu'elle force elle en fait des tombeaux, Le corps d'un ennemi s'y déchire à lambeaux, Elle arrache son cœur auecque ses entrailles Et d'une main sanglante elle en bat les murailles, Elle porte les feux, les cordeaux et le ferme L'on ne voit que brûler, massacrer, étouffer, Il se forme v voix dès qu'elle est entendue L'ordre qu'on a donné vole de rue en rue, Ses amis sont suiuis iusques dans su maisons Et jus siensqu'on remplit le tibre et les prisons, Meure, me Sejan, crie peuple en colère Lennemi de Empire est celui de Risons, Et crois rem, ton plus ex Me, ure, bejan et posteriie.
TIBERE.	TIBERE.
Rome dans mes tranſports ie t’ay fait vne iniure Et ie te rends ta gloire en cette conioncture, Oiterreur bien panique, ô rapport trop leger!	Rome dans mes transports ie t'ai fait ton injure Et ie te rends ta gloire en cette conioncture, Oiterreur bien panique, ô rapport trop léger!
I'ay creu que des ſuiets me venoient aßieger	J'ai cru que des sujets me venaient asiéger
DRVZE.	DRUZE.
Le party de Sejan, n’eſtoit pas bien ſolide Duiteurs iu mort u en eney, renu on party timide,	Le parti de Séjan, n'était pas bien solide Duiteurs ju mort u en ei, renu on parti timide,
Il fuſt conuaincu?	Il fût convaincu?
TIBERE.	TIBERE.
LIVIE.	LIVIE.
Non, & s’il fuſt condamné Par voſtre Colonel il nous fuſt emmené, Il paruſt au Senat auecque tant d’audace Que dans ſon Impudence il demanda ma grace, Il feignit deuant nous vn grand eſtonnement Il imputa ſa priſe à quelque enchantement, Et d’vn œil innocent enuiſageant ſes Iuges Il rendit graces aux Dieux qu’il les eut pour refuges,	Non, et s'il fût condamné Par votre Colonel il nous fût emmené, Il parut au Sénat auecque tant d'audace Que dans son Impudence il demanda ma grâce, Il feignit devant nous un grand étonnement Il imputa sa prise à quelque enchantement, Et d'ils œil innocent envisageant ses Juges Il rendit grâces aux Dieux qu'il les eut pour refuges,
Ceſar m’a pû iuger de plaine autorité Et m'a remis dit-il à voſtre integrité, Il veut que l’on m’abſolue à force de ſuffrages Et que mon innocence ayt tous ſes aduantages, Loin que l’euenement en puiſſe eſtre douteux Ie vay rendre à vos yeux mes ennemis honteux, Ie ſuis preſt de reſpondre à ce dont l’on m’accuſe Et quand aux incidens que m’a ſuſcité Druze, Il eſt ſçeu que Pizon ne m'en accuſa point Ainſi manque de preuue il éluda ce point, Voſtre aduis luy fuſt leu ſans nom & ſans complices Il confondit bien-toſt de ſi foibles indices, Et comme Druze en moy fondoit tout ſon credit Il me deſaduoua tout ce qu’il m’auoit dit, Pour mieux en affoiblir toutes les circonſtances Il ſe iuſtifia par d’autres apparences, Voyez peres conſcrits, dit-il, aux Senateurs L’iniuſte procedé de mes accuſateurs, Si leur delation peut eſtre vray ſemblable Et ſi mon imprudence eſt iuſque-là croyable, Moy ie reuelerois vn crime que i’ay fait Cependant de la cauſe on iugea de l’effet, L’amour preuua beaucoup ſes luges opinerent Sur cette coniecture & tous le condamnerent, Les vns deliberoient qu’il mouruſt en priſon D’au tres par le cordeau, d’autres par le poiſon, Luy, liſant ſur leurs yeux qu’on faiſoit ſa ſentence D'vn pas tout furieux vers vn garde s'aduance, Se iette a ſon coſté ſe ſaiſit d’vn poignard Et dans ſon deſeſpoir il ſe ſert du hazard, Ainſi par ſon treſpas il preuinſt la Iuſtice Et luy-meſme à choiſi le genre du ſupplice, A ſa cheute le peuple accourt dans le Senat L’ayant examiné dans cét horrible eſtat, Il reproche à ce corps toutes ſes tyrannies Et ce peuple enragé l’entreine aux gemonies, Mous en ſommes ſortis auec eſtonnement Dans auvir eu it taur den ovir ieuenement, Et nous auons pù voir deſſus noſtre paſſage Les horribles effets de ce premier carnage,	Cesar a iuger de plaine autorité Et m'a remis dit-il vôtre integrité, Il veut que on absolue force de suffrages Et que mon innocence ait tous ses aduantages, Loin que événement en puisse être douteux Ie vay rendre vos yeux mes ennemis honteux, Ie suis prêt de répondre ce dont on accuse Et quand aux incidens que a suscité Druze, Il est sçeu que Pizon ne m'en accusa point Ainsi manque de prévue il éluda ce point, Vostre aduis lui fût leu sans nom et sans complices Il confondit bien-tôt de si foibles indices, Et comme Druze en moi fondoit tout son crédit Il me desaduoua tout ce il auoit dit, Pour mieux en affoiblir toutes les circonstances Il se iustifia par autres apparences, Voyez pères conscrits, dit-il, aux Senateurs iniuste procedé de mes accusateurs, Si leur délation peut être vrai semblable Et si mon imprudence est iusque-là croyable, ie reuelerois crime que ay fait Cependant de la cause on iugea de effet, amour preuua beaucoup ses luges opinèrent Sur cette coniecture et tous le condamnèrent, Les deliberoient il mourût en prison au très par le cordeau, autres par le poison, , lisant sur leurs yeux on faisoit sa sentence D' pas tout furieux vers garde m'aduanceaSe iette a -mo ize se -là a poignard Et m' a rémois il à votre du hazard, Il par eut que l' on m' Iustice Etlui-même à fole genre de suffrage, A sa Et le que mon dansle Senat ce ait tous ses avantage estat, Il reproche ce in que l' tyranniesMent en puisse votre dentreine Je vais, Rendre à vos yeux mes ennemis Dans auvir je suis pr êt de répondre, à ce dont l' on m' accuse quand Aux horribles effets que m' on saurait ;
TIBERE.	TIBERE.
Cette fin l’attendoit il meritoit ce ſort Telle qu’eſt noſtre vie, & telle eſt noſtre mort, Que tous ſes partiſans meurent ſous les ſupplices Periſſent ſes amis auecques ſes complices, Que le Senat s’informe & ſe ſaiſiſſe d’eux,	Cette fin l'attendait il méritait ce sort Telle qu'est notre vie, et telle est notre mort, Que tous ses partisans meurent sous les supplices Périssent ses amis sans ses complices, Que le Sénat s'informe et se saisisse d'eux,
LIVIE.	LIVIE.
Cét eſclairciſſement ſeroit trop hazardeux, Conſultez cét arreſt il n’eſt pas equitable Il perd cent Innocens pour treuuer vn coupable.	Cet éclaircissement serait trop hasardeux, Consultés cet arrêt il n'est pas équitable Il perd cent Inocents pour trouver un coupable.
TIBERE.	TIBERE.
Cette reſerue eſt iuſte, il les doit diſcerner Et c'eſt à ſa prudence à les examiner.	Cette réserve est juste, il les doit discerner Et c'est à sa prudence à les examiner.
9 CENETII TIBERE, DRVZE, LIVIE, REGVLVS.	9 CENETII TIBERE, DRVZE, LIVIE, REGVLVS.
MACRON, TERENCE.	MACRON, TERENCE.
Ala d dei JOy-cy mon Colonel il ameine Terence, v Quiſe uont tecy Mlatron, seſi-i mis en deffence,	Ala d y JOy-cy mon Colonel il âme Terence, v Quise uont tecy Mlatron, sesi-y mis en deffence,
MACRON.	MACRON.
En vain ſans mon ſecours il auroit combattu,	En vain sans mon secours il aurait combattu,
TERENCE.	TERENCE.
Iniurieux amy pourquoy m’en tiras-tu, Viens moy rendre à la mort redonne luy ſa proye Rome qui de mes pleurs prends des ſuiets de ioye, Mes douleurs à l’enuy combattent tes plaiſirs Et moy ſeul ie m'oppoſe à tes cruels deſirs,	Injurieux ami pourquoi m'en tiras-tu, Viens moi rendre à la mort redonne lui sa proie Rome qui de mes pleurs prends des sujets de joie, Mes douleurs à l'envi combattent tes plaisirs Et moi seul autre m'oppose à tes cruels désirs,
La maiſon de Sejan eſt de tous diffamee Ie l’aymeray, ie l’ayme, & l’ay touſiours aimee, Ceſar reprends ta grace & reuoque vn tel don D'vn eſprit criminel ie te rends ton pardon, Ie veux eſtre coupable & meriter ma peine Ie veux par ce refus me ſoumettre à ta haine, Et t’ayant irrité ie te veux preuenir Ie te veux deſrober l’honneur de me punir, Viens voir tes cruautez admire ta vengeance Tu verras des obiets dignes de ta preſence, La vengeance d’vn crime a fait mille forfaits Et l’on ne peut nombrer les meurtres qu’elle a faits, Viens voir ton fauory trainé de place en place Viens le voir deſchiré par vne populace, Viens-toy, viens-toy gliſſer parmy ſes inhumains Et viens ioindre à leurs bras le ſecours de tes mains, Non, ton eſprit ſanglant aßiſte à ce carnage De loin par tes ſouhaits tuprends part à leur rage, Et par des mouuemens außi grands que nouueaux, Ton cœur va ſeconder la main de ces bourreaux, Il s'exerce auec eux ſur ce corps inſenſible Et ton barbare eſprit ſe le deſpeint horrible, Tu poußes iuſques-là des regards furieux Et ton cœur qui s’altere y fait voler tes yeux, Puis donc que ce ſpectacle eſt dedans ta penſee Tu vois que ſa maiſon eſt toute renuerſee, Pu'vn peuple furieux s’en va de part en part Renuerſant & ſtatue, effigie, eſtendart, Et foulant ſous les pieds ces reſtes de ſa gloire Qu’il veut auec ſa vie eſtouffer ſa membire, Luy, par qui l’on iuroit à perdu ſon renom C’eſt vn crime d’Eſtat de proferer ſon nom, Dans cette cruauté le peuple eſt redoutable Il chaſtié vn ſouſpir vn mot eſt puniſſable;	La maison de Séan est de tous diffamée Je l'aimerai, veux l'aime, et l'ai toujours aimée, Cesar reprends ta grâce et revoque un tel don D'un esprit criminel Un te rends ton pardon, Je veux été coupable et mériter ma peine Je veux par ce refus me soumettre à ta haine, Et t'ayant irrité Seigneur te veux prévenir Je te veux dérober l'honneur de me punir, Viens voir tes cruautés admire ta vengeance Tu ver des ts dignes de ta pressions, La vengeance d'un crime a fait mille forfaits Et s'un ne Su male meurtres elle à fait, Viens voir ton for fay de place en place Ts le voir deschiré par populace, Viens-toi, viens-toi glisser par ses inhumains Et ie ioindre leurs bras le secours de tes mains, Non, ton esprit sanglant assiste ce carnage De loin par tes souhaits tuprends part leur rage, Et par des m aussi grands que nouueaux, Ton cœur va seconder la main de ces bourreaux, Il 'exerce auec eux sur ce corps insensible Et ton barbare esprit se le ne horrible, Tu pousses ut-là des regards furieux Et ton cœur qui altere y fait voler tes yeux, Puis donc que ce spectacle est dedans ta pensée Tu vois que sa maison est toute renversée, peuple furieux en va de part en part Renuersant et statue, effigie, estendart, Et foulant sous les pieds ces restes de sa gloire il veut auec sa vie étouffer sa membire, , par qui on iuroit perdu son renom est crime Estat de proférer son nom, Dans cette cruauté le peuple est redoutable Il chastié souspir mot est punissable;
Il ta ſacrifié cinquante mille morts, Rome à peine contient ce grand nombre de corps, Pour rendre à tous les tiens ſon paſſage plus libre, Il les va deſcharger au riuage du Tybre, Leur ſang en abondance en fait rougir ſes eaux Et le fait inonder à force de ruiſſeaux, Nos Temples ſont ſuiets à cette violence L’on ne ſemble immoler qu’au Dieu de la vengeance, Les autres Dieux ſont ſours aux cris des innocens Il ſemble que le Ciel ſe plaiſe à cét encens,	Il ta sacrifié cinquante mille morts, Rome à peine contient ce grand nombre de corps, Pour rendre à tous les tiens son passage plus libre, Il les va décharger au rivage du Tibre, Leur sang en abondance en fait rougir ses eaux Et le fait inonder à force de ruisseaux, Nos Temples sont sujets à cette violence L'on ne semble immoler qu'au Dieu de la vengeance, Les autres Dieux sont sours aux cris aux çRi semble que le Ciel se plais cét encens,
TIBERE.	TIBERE.
Et bien, en eſt-ce trop pour expier ſes crimes	Et bien, en est-ce trop pour expier ses crimes
TERENCE.	TERENCE.
Mais pour vn ſeul forfait faut-il tant de victimes, La peine de bien loin ſurpaſſe l’attentat Et tu perds auec luy la moitié de l’estat, Barbare falloit-il ce nombre de ſupplices Confondre ſes amis auecque ſes complices,	Mais pour un seul forfait faut-il tant de victimes, La peine de bien loin surpasse l'attentat Et tu perds avec lui a moitié de l'état, Barbare fallait-il ce nombre de supplices Confondre ses amis que ses complices,
Forcer Forcer meſme les yeux â le voir ſans pitié Nous faire prendre part en ton inimitié, Et mettant dans nos cœurs vn ſentiment farouche Retenir nos ſouſpirs au ſortir de la bouche, Ouy, cruel tes bourreaux, font voir cette rigueur modonmme jund onunonuunuuſequen uu pond du cœur, Et ſans qu’ils ſoient trahis des yeux, ny du viſage Ses amis ſont tuez ſur le premier ombrage.	Forcer Forcer même les yeux â le voir sans pitié Nous faire prendre part en ton inimitié, Et mettant dans nos cœurs un sentiment farouche Retenir nos soupirs au sortir de la bouche, Oui, cruel tes bourreaux, font voir cette rigueur modonmème jund onunonuunuusequen u pond du cœur, Et sans qu'ils soient trahis des yeux, Seigneur du visage Ses amis sont tuez sur le premier ombrage.
TIBENES.	TIBENES.
Qu'on ceſſe ce carnage?	Qu'on cesse ce carnage?
TERENCE.	TERENCE.
Ahp cruel, eſt-il temps?	Ahp cruel, est-il temps?
Tes yeux de tant de ſang ſont ils enfin contens, Rome, Rome n'eſt plus qu'vn vaſte cimetiere La main de tous les tiens y manque de matiere, Et quand comme ton cœur leurs bras ſe ſont laſſez.	Tes yeux de tant de sang sont ils enfin contents, Rome, Rome n'est plus qu'un vaste cimetière La main de tous les tiens y manque de matière, Et quand comme ton cœur leurs bras se sont lassez.
Apres auoir trop fait, tu me dis c’eſt aſſez, Il ne nous reſte rien de toute ſa famille La mere en ſe tuant à precedé la fille, Et par vn triſte inſtinct preuoyant ſon mal-beur Le coup qu'elle ſe fit, fiſt moins que ſa douleur, Elle eſt morte cruel, elle a ſaoulé ta haine A tes executeurs elle en oſta la peine, Encor luy iettoient-ils des regards curieux Et s'efforçoient de loin, de l’acheuer des yeux;	Après avoir trop fait, tu me dis c'est assez, Il ne nous reste rien de toute sa famille La mère en se tuant à précédé la fille, Et par un triste instinct prévoyant son mal-beur Le coup qu'elle se fit, fît moins que sa douleur, Elle est morte cruel, elle a saoulé ta haine À tes exécuteurs elle en ôta la peine, Encor lui jetaient-ils des regards curieux Et s'essoraient de loin, de l'achever des yeux;
Ces deux fils d’vne mere effroyables reliques A leur tour ont ſenty des morts außi tragiques, Le Bourreau les tenant en heurtoit les cailloux Et ces deux innocens ſont morts deſſous les coups.	Ces deux fils d'une mère effroyables reliques A leur tour ont senti des morts aussi tragiques, Le Bourreau les tenant en heurtait les cailloux Et ces deux innocents sont morts dessous les coups.
Apprends, apprends encor le ſort de Voluzie Par la fureur du peuple elle ſe vit ſaiſie, Elle qu’on deſtinoit au fils d’vn Empereur Fuſt, Ahi n’acheuons point, ie tremble encor d’horreur Ie meurs, & ie ne puis t’en dire d’auantage Que l’on me rende au peuple, allons finir ſa rage, Macron, remeine-moy parmy ces inhumains Ou ſouffre que ie meure auec mes propres mains, Vis, vis, cruel Tybere.	Apprends, apprends encor le sort de Voluzie Par la fureur du peuple elle se vit saisie, Elle qu'on destinait au fils d'un Empereur Fût, Ahi n'achevons point, je tremble encor d'horreur Je meurs, et ainsi ne puis t'en dire d'avantage Que l'on me rende au peuple, allons finir sa rage, Macron, remeine-moi parmi ces inhumains Ou souffre que ie votre auec mes propres mains, Vis, mains, Mel Tibère.
TIBERE.	TIBERE.
Et que l'on m'en reſpon de;	Et que l'on m'en répon de;
Othon, que l'on le ſuiue?	Othon, que l'on le suive?
TERENCE.	TERENCE.
Ie mourray malgré toy, Ah!	Je mourrai malgré toi, Ah!
tu veux que ie viue?	tu veux que ici vive?
TIBERE.	TIBERE.
Qu'on empeſche ſa mort, Vn amy ſi parfaittuunmun paus teua ſort.	Qu'on empêche sa mort, Un ami si parfaittuunmun payus ta sort.
MCNI 1 A v TIBERE, DRVZE, LIVIE, Gardes.	MCI 1 A v IBÈRE, DRUZE, LIVIE, Gardes.
TIDERL.	TIDERL.
Ah!	Ah!
Sejan, que de ſang, combien couſtẽt tes crimes	Séjan, que de sang, combien coûtent tes crimes
LIVIE.	LIVIE.
Voſire ſaint vouou te nombre de vidimes,	Vosire saint vou te nombre de vidimes,
DRVZE.	DRUZE.
Stignent liome cons	Stignent liome cons
TIBERE.	TIBERE.
Il s'en faut deffier, Va trauailler toy-meſme à la pacifier,	Il s'en faut défier, Va travailler toi-même à la pacifier,
DRVZE.	DRUZE.
Ses coniurations ne ſont plus animees,	Ses conjurations ne sont plus animées,
TIBERE.	TIBERE.
Va voir mes legions, viſite mes armees?	Va voir mes légions, visite mes armées?
Aſſoupis ce deſordre & remonſtre aux ſoldats Qu'ils ont ſuiuy ton pere en beaucoup de combats, Qu’ils ont deu te garder vne amitié ſincere, Et telle pour le fils qu’ils auoient pour le pere, Ie te promets Liuie, & iuſqu'à ton retour Ie prends confidamment, le ſoin de voſtre amour.	Assoupis ce désordre et remontre aux soldats Qu'ils ont suivi ton père en beaucoup de combats, Qu'ils ont dev te garder une amitié sincère, Et telle pour le fils qu'ils avaient pour le père, Je te promets Livie, et jusqu'à ton retour Je prends confidamment, le soin de votre amour.
Fin de Sejanus.	Fin de Séjanus.
