1x 2 223 OMEDIE.	1x 2 223 OMEDIE.
M DESDIEE AVX IEVNES Ueufnes, & ahx vitiſes Piues.	M MESDIE AUX JEUNES Ueufnes, et ahx vitises Pives.
.	.
	
A PARIS Chez IEAN GVIGNARD, au premier pillier de la grand' Salle du Palais.	À PARIS Chez IEAN GUIGNARD, au premier pillier de la grand Salle du Palais.
M.	M.
DC.	DC.
XXXVII.	XXXVII.
Auec Priuilege du Roy	Avec Privilège du Roi
ũ D M ELLES Dames, a qui la Nature & l'honneur ne peuuent & permettre de donner l'aliment S neceſſaire à vos contentemens, les vnes par la perte de vos maris, & les autres pour n’oſer gouſter l’excellence du fruict de vie qui donne naiſſance aux creatures raiſonnables.	ũ LES AUTRES POUR Dames, a qui les Nature et l'honneur ne peuvent et permettre de donner l'aliment S nécessaire à vos contentements, les vnes par la perte de vos maris, et les autres pour n'oser goûter l'excellence du fruit de vie qui donne naissance aux créatures raisonnables.
Uoicy AliZon Fleurie vefue, & ſa ſœur Vieux Thaudis, a ij	OUoici Alison Fleurie veue, et sa sœur Vieux Thaudis, a ici
AVX IEVNES VEVEVLO ET aux vieilles Filles.	AUX JEUNES VEUEULO ET aux vieilles Filles.
fille aagee de ſoixante ans, qui dans l’extremité des desplaiſirs que vous pouue:	fille âge de soixante ans, qui dans l'extrémité dé plaisirs que vous pouve:
conceuoir, faute d’auoir la joüiſſance de l’inſtrument le plus vtile à la conſtructure d'vn corps agiſſant ſous la figure, d’vn homme, viennent par l’exemple de leur vie & de leur patience, vous monſtrer le miroir ſur lequel il faut, Meſdames, que vos esprits ſe conforment, que vos vertus ſe reiglent, que voſtre prudence ſemire, & que vos actions ſe faſſent, afin de trouuer des partis dignes de voſtre longue attente.	concevoir, faute d'avoir la jouissance de l'instrument le plus utile à la constructure d'un corps agissant sous la figure, d'H homme, viennent par l'exemple de leur vie et de leur patience, vous montrer le miroir sur lequel il faut, Mesdames, que vos esprits se conforment, que vos vertus se règlent, que votre prudence semire, et que vos actions se fassent, afin de trouver des partis dignes de votre longue attente.
C’eſt le parfait modelle d’vne vieille & vertueuſe amitié, recherchee de la Nobleſſe, de la Iuſtice, & du tiers Eſtat:	C'est le parfait modèle d'une vieille et vertueuse amitié, recherchée de la Noblesse, de la Justice, et du tiers État:
Dans la contemplation de laquelle vous trouuerez la verité du prouerbe, qui dit, Que dans vn vieux pot on fait ſouuent de bonne ſouppe;	Dans la contemplation de laquelle vous trouverez la vérité du proverbe, qui dit, Que dans un vieux pot on fait souvent de bonne soupe;
veu qu’apres vne inſinité de trauerſes qui ont accompagné la ſuite de leurs annees, elles ont heureuſement rencontré le palais de la felicité, dans lequel elles ſont entrees par la poſſeſſion de deux parfaits Amans, qui les faiſans iouir du bien ſi long-temps attendu, ont encores fait naiſtre l’occaſion des aduantageux mariages des trois filles d’AliZon Fleurie.	vu qu'après une insinité de traverses qui ont accompagné la suite de leurs années, elles ont heureusement rencontré le palais de le felicité, dans lequel elles sont entrées par la possession de deux parfaits Amants, qui les faisant jouir du bien si longtemps attendu, ont encore fait naître l'occasion des avantageux mariages des trois filles d'Alison Fleurie.
Il faut, MESDAMES, que vous n’eſperiez pas vne moindre recompenſe de voſtre ennuyeuſe attente, & que vous croyeZ que ce temps qui court n'eſt que pour atteindre le bon-heur qui vous eſt reſerue, & dont quelque iour le Ciel vous donnera vne entiere iouyſſance.	Il faut, MESDAMES, que vous n'espériez pas une moindre récompense de votre ennuyeuse attente, et que vous croyez que ce temps qui court n'est que pour atteindre le bonheur qui vous est réserve, et dont quelque jour le Ciel vous donnera une entière jouissance.
C’eſt ce que joumo auecques paſſion,	C'est ce que joumo auecques passion,
MESDAMES,	MESDAMES,
Voſtre tres-humble & affectionné ſeruiteur, L.	Votre très-humble et affectionné serviteur, L.
C.	Ç.
DISCRET,	DISCRET,
Aduertiſſement important au Lecteur.	Aduertissement important au Lecteur.
29 ECTEVR, apres tant de rares & ſerieux Poëmes Tragiques, qui depuis quelques * 2uυgs mois ont paru ſur le theatre de nos Comediens auec tant d’éclat & d’admiration de chacun, que le ſeul bruit du Cid de Monſieur Corueille a fait ſouhaiter par toutes les bonnes villes de la France, qu’il y euſt autant de troupes de Mondory, qu’il y en a maintenant de gendarmes dans la Flandre, afin de ioüir du contentement de la repreſentation de leurs merueilleuſes Tragedies.	29 ECTEUR, après tant de rares et sérieux Poèmes Tragiques, qui depuis quelques * 2ugs mois ont paru sur le théâtre de nos Comédiens avec tant d'éclat et d'admiration de chacun, que le seul bruit du Cid de Monsieur Corueille a fait souhaiter par toutes les bonnes villes de la France, qu'il y eût autant de troupes de Mondori, qu'il y en a maintenant de gendarmes dans la Flandre, afin de ju du contentement de la représentation de leurs merveilleuses Tragédies.
I’ay creu qu’en ſuitte de ces ſujets ſi graues & ſi triſtes, il tefalloit donner quelque piece cuſe contre ſon foible iugement:	J'ai cru qu'en suite de ces sujets si graves et si tristes, il tefalloit donner quelque pièce cuse contre son faible jugement:
Auquel routesfois ie cederay touſiours l’honneur deub aux Poëtes de ſa qualité.	Auquel routefois on céderai toujours l'honneur devb aux Poètes de sa qualité.
Au ſurplus, Lecteur, ie t’aduertis, qu’encores que dans ceſte piece i’aye mis des Airs & des Chanſons à dãcer, les Acteurs qui la repreſenteront comme extrememet facile, en pourront chanter de celles qu’ils ſçaurc at, ſans s’abſtraindre à celles-là qui ne ſeruent à mon ſujet, que pour en faire voir l’ordre & la ſuitte:	Au surplus, Lecteur, ie t'avertis, qu'encores que dans cette pièce j'aie mis des Airs et des Chansons à dãcer, les Acteurs qui la représenteront comme extrêmemet facile, en pourront chanter de celles qu'ils saurc at, sans s'abstraindre à celles-là qui ne servent à mon sujet, que pour en faire voir l'ordre et la suite:
Que tu ne trouueras pourtant ny dans les regles des vingt-quatre heures, ny ſans rencontre de voyelles.	Que tu ne trouveras pourtantgez dans les règles des vingt-quatre heures, ni sans rencontre de voyelles.
Mais vn ſujet veritable eſt plus difficile à traicter, que les fabuleux des Autheurs du temps, Adieu.	Mais un sujet véritable est plus difficile à traicter, que les fabuleux des Auteurs du temps, Adieu.
AV SIEVR D, SVR SA Comedie v’AnEOII.	AU SIEUR D, SUR SA Comédie v'AnEOII.
Stime qui voudra tous les ſujets tragiques, AliZon qui fait rire à bien d’autres appas, Ceux-là font les humains ſi fort mellancoliques, Qu'il faut que celle-cy les tirent du treſpas.	Stime qui voudra tous les sujets tragiques, Alison qui fait rire à bien d'autres appas, Ceux-là font les humains si fort mélancoliques, Qu'il faut que celle-cy les tirent du trépas.
D.	D.
R.	R.
A luy-meſme.	A lui-même.
Ariane, le Cid, Ceſar, & Cleopatre, Paroiſſans au theatre, Ont rauy les esprits par l’oreille & les yeux:	Ariane, le Cid, César, et Cléopâtre, Paraissant au théâtre, Ont ravi les esprits par l'oreille et les yeux:
Mais qui preferera le plaiſir à triſteſſe, Doit cherir Alizon autant qu’vne Deeſſe Comme vn preſent des Cieux.	Mais qui préférer le plaisir à tristesse, Doit chérir Alison autant qu'une Deesse Comme présent des Cieux.
C.	Ç.
M.	M.
POLIANDRE,	POLYANDRE,
BELANGE,	BÉLANGE,
FLORIANE.	FLORIANE.
A 101 L 12 omedie.	À 101 L 12 omédie.
A ACTE PREMIER.	A ACTE PREMIER.
FLEVRIE.	FLEURIE.
LE COLPORTEVR.	LE COLPORTEUR.
MAISTRE IEREMIE.	MAÎTRE IEREMIE.
MR KAROLV.	MR AROLU.
POLTANDRE, ROSELIS.	POLTANDRE, ROSELIS.
BELANGE.	BÉLANGE.
SCENE PREMIERE.	SCÈNE PREMIÈRE.
3 FLEVRIE.	3 FLEURIE.
AE prouerbe dit vray, qui m'apprend M SIS qu'vne femme ame, Perd auec ſon mary la moitié de ſon Qu'and la mort ſeparãt leurs deux cœurs bien Luy laiſſe pour jamais des regrets infinis.	AE prouerbe dit vrai, qui m'apprend M SIS qu'une femme âme, Perd avec son mari la moitié de son Qu'and la mort séparant leurs deux cœurs bien Lui laisse pour jamais des regrets infinis.
ſunis --.	sunis --.
Ha!	Ha!
que la mort du mien ma fait de faſcherie;	que la mort du mien ma fait de fâcherie;
Le pauure homme mouroit s’il ne voyoit Fleurie Touſiours aupres de luy, rire, chanter, cauſer, Et n'eſtoit vn moment ſans me venir baiſer:	Le pauvre homme mourait s'il ne voyait Fleurie Toujours auprès de soins, rire, chanter, causer, Et n'était un moment sans me venir baiser:
I'eſtois ſon Alizon, ſon amour, ſon delice, I'eſtois ſa Penelope, il eſtoit mon Vlyſſe:	J'étais son Alison, son amour, son délice, J'étais sa Penelope, il était mon Vlysse:
Chez nous tous les plaiſirs eſtoiẽt à l’abandõ, Si i’eſtois ſon Aſtree, il eſtoit Celadon.	Chez nous tous les plaisirs étaient à l'abandion, Si j'étais son Astre, il était Céladon.
Bref toutes ces douceurs, ceſte amitié parfaite Fait qu'encor tous les iours mon esprit le regrette.	Bref toutes ces douceurs, cette amitié parfaite Fait qu'encor tous les jours mon esprit le regrette.
Mais helas!	Mais hélas!
ce plaiſir euſt eſté bien plus doux Si de mes actions il n'euſt eſté jaloux.	ce plaisir eût été bien plus doux Si de mes actions il n'eût été jaloux.
Ie ne ſçay quels appas j'auois en ma ieuneſſe, Mais chacun m'appelloit ſa petite maiſtreſſe.	Je ne sais quels appas j'avais en ma jeunesse, Mais chacun m'appelait sa petite maîtresse.
I'auois des ſeruiteurs en chacune ſaiſon Autãt que pas vn Prince en ait en ſa maiſon:	J'avais des serviteurs en chacune saison Autant que pas un Prince en ait en sa maison:
uiul.	Ouiul.
& uvaiſtre Hieremie Vous diroient biẽ encor que i'eſtois leur amie.	et aistre Hieremie Vous diraient biẽ encor que j'étais leur amie.
Mais quoy que nos diſcours fuſſent fort innocens, ſens;	Mais quoi que nos discours fussent fort innocents, sens;
COMEDIE.	COMÉDIE.
Iuſqu'au poinct quelquesfois de m'auoir condamnée A ne point voir le iour que par la cheminee, Ie ne voyois les champs que dans vn vieux tableau Où eſtoit peint Mõceaux auec Fõtainebleait:	Jusqu'au point quelquefois de m'avoir condamnée À ne point voir le jour que par la cheminée, Je ne voyais les champs que dans un vieux tableau Où était peint Mõceaux avec Faitainebleait:
Il n'auoit iamais mis ſon cœur à la verdure, Auſſi lay-je ſouuent appellé trop me dure.	Il n'avait jamais mis son cœur à la verdure, Aussi lai-je souvent appelé trop me dure.
En Hyuer, en Eſté, ie gardois le logis:	En Hiver, en Été, Seigneur gardais le logis:
I'ay cent fois ſouhaité d’eſtre Urgande ou Maugis Pour aller quelquesfois faire la promenade Quãd ſes goüttes au lict le retenoient malade:	J'ai cent fois souhaité d'être Urgande ou Maugis Pour aller quelquefois faire la promenade Quand ses goûtes au lit le retenaient malade:
Neaumoins auiourd’huy ſa ſeparation M'apporte en verité beaucoup d’affliction.	Neaumoins aujourd'hui sa séparation M'apporte en vérité beaucoup d'affliction.
Croyez, s’il faut vn iour que ie me remarie On me verra bien fort faire la rencherie:	Croyez, s'il faut un jour que je me remarie On me verra bien fort faire la renchérie:
1 I'ay deſia ſur les bras deux ou trois amoureux Qui du moindre regard s’eſtiment trop heux reux.	1 J'ai déjà sur les bras deux ou trois amoureux Qui du moindre regard s'estiment trop heux reux.
Mais combien que pour moy leur amour ſoit extreme, Ci aime.	Mais combien que pour moi leur amour soit extrême, Ci aime.
En voicy déja l’vn:	En voici déjà l'Hommes:
Or ſus vous diſ-je pas De moment en moment ils ſont deſſus mes pas.	Or sus vous dis-je pas De moment en moment ils sont dessus mes pas.
Ie me veux retirer au fond de mon allee:	Je me veux retirer au fond de mon allée:
Car ie ne me plaiſt pas d’eſtre tant cajollee;	Car ie ne me plaît pas d'être tant cajollée;
Encore celui-cy jargonne inceſſamment, Quoyqu’il faſſe ſans ceſſe vn meſme cõplimẽt.	Encore celui-cy jargonne incessamment, Quoiqu'il fasse sans cesse un même cõplimẽt.
LE COLPORTEVR.	LE COLPORTEUR.
Ay touſiours quelque choſe, & touſiours  quelque choſe, I'ay des liures icy tant en rime qu'en proſe, Le duel de deux gueux dedãs le pré aux Clers:	Ai toujours quelque chose, et toujours quelque chose, J'ai des livres ici tant en rime qu'en prose, Le duel de deux gueux dedans le pré aux Clers:
I'ay les noms des filloux, la miſere des Clers:	J'ai les noms des filloux, la misère des Clers:
I’ay les nouueaux Edits, les nouuelles gazetes:	J'ai les nouveaux Édits, les nouvelles gazètes:
I'ay la commodité des bottes & garſettes:	J'ai la commodité des bottes et garsettes:
I'ay le remede icy pour les paſles couleurs:	J'ai le remède ici pour les pâles couleurs:
I'ay l’amour des Sergens, la pitié des voleurs:	J'ai l'amour des Sergents, la pitié des voleurs:
I'ay tous les cõplimens de la langue Fraçoiſe, La perte depuis peu d’vne ieune Bourgeoiſe adu quartier que chacun m̃me des grauilliers:	J'ai tous les cõplimens de la langue Fraçoise, La perte depuis peu d'une jeune Bourgeoise aval quartier que chacun même des gravilliers:
.	.
.	.
.	.
.	.
.	.
*-	*-
I’ay le contract paſſé dans les hautberuilliers Entre Guillot Grand-jan & GilleteVẽtruë:	J'ai le contrat passé dans les hautbervilliers Entre Guillot Grand-jan et GilleteVẽtruë:
I’ay le cruel combat d’un cinge& d’vne gruë:	J'ai le cruel combat d'un cingeet d'une grue:
I'ay grande quãtité de bons liures nouueaux:	J'ai grande quantité de bons livres nouveaux:
Iay la maniere auſſi cõme on ſevre les veaux, Auec le teſtament du bon Gaultier-garguille:	Iais la manière aussi cõme on sèvre les veaux, Avec le testament du bon Gaulier-garguille:
I’ay le galland qu’il faut à une belle fille.	J'ai le gallant qu'il faut à une belle fille.
Voicyl inuẽtion pour prendre à toutes mains, Vtile aux Procureurs autant qu'aux Medecins:	Voicil inuẽtion pour prendre à toutes mains, Vtyle aux Procureurs autant qu'aux Médecins:
I'ay le pouuoir qu’on donne à chacune ſeruãte De coucher au grãd lictquand madame eſt abI'ay les perfectiõs de la dame AliZon (ſente.	J'ai le pouvoir qu'on donne à chacune servante De coucher au grand litquand madame est abI'ai les perfections de la dame Alizon (sente.
Pour captiuer chacun dans ſa belle priſon;	Pour captiver chacun dans sa belle prison;
Dans vn petit cahier i’ay la bõté des femmes:	Dans un petit cahier j'ai la bien des femmes:
I'aytoute leur malice en trois ouquatre rames:	J'aitoute leur malice en trois ouquatre rames:
I'ay la methode auſſi pour gaigner force eſcus:	J'ai la méthode aussi pour gagner force écus:
I'ay les liſtes icy des garces & cocus, [ternes:	J'ai les listes ici des garces et cocus, [ternes:
Et l’art de les trouuer iour & nuict ſans lanI'ay cõme il faut ſortir sãs payer auxtauernes:	Et l'art de les trouver jour et nuit sans lanIay cõme il faut sortir sans payer auxtavernes:
I'ay quelque choſe en fin pour tous les bons eſprits;	J'ai quelque chose en fin pour tous les bons esprits;
Voila le beau Palais ou loge ma Maiſtreſſe Qui ſurpáſſe en beauté la Romaine Lucrece;	Voilà le beau Palais ou loge ma Maîtresse Qui surpsse en beauté la Romaine Lucrece;
Ie ſçayque mõ humeur luy plaiſt extrememẽt, Que de ſes Amoureux ie ſuis le cher Amant:	Je sçayque mon humeur lui plaît extrêmement, Que de ses Amoureux ie suis le cher Amant:
ar dés qu'elle m'entẽd ievois ſon œil pareſtre, Si ce n’eſt à ſon huis, c'eſt à vne feneſtre.	ar dès qu'elle m'entẽd ievois son œil paraître, Si ce n'est à son huis, c'est à une fenêtre.
Puis qu'on ne luy void pas ſans doute elle eſt eul, aelrs;	Puis qu'on ne force voids pas sans doute elle est eul, aelrs;
Adieu belle priſon de mes vieilles amours.	Adieu belle prison de mes vieilles amours.
FLEVRIE.	FLEURIE.
En dépit du vilain, i’ay honte de vous dire Que i'ay laſché de l’eau à force de trop rire.	En dépit du vilain, j'ai honte de vous dire Que j'ai lâché de l'eau à force de trop rire.
Mõ Dieu qu’il eſt plaisãt, ſi i’auois biẽdequoy Et que ie le vouluſſe, il voudroit bien de moy:	Momme Dieu qu'il est plaisant, si j'avais biẽdequoy Et que ie le voulusse, il voudrait bien de moi:
Mais le proffit qu’il fait à crier des gazettes Ne pourroit en vn an no' fournir delunettes.	Mais le proffit qu'il fait à crier des gazettes Ne pourrait en un an no' fournir délunettes.
Non, ce n’eſt pas mon cas, i'ay des partis meilleurs, Ie ne veux empeſcher qu’il ſe pouruoye ailleurs:	Non, ce n'est pas mon cas, j'ai des partis meilleurs, Je ne veux empêcher qu'il se pourvoie ailleurs:
Que le bon homme donc y cnertne ja fortune.	Que le bon homme donc y cnertne ja fortune.
O dieux qu'en voicy vn qui ſouuent m'importune!	Ô dieux qu'en voici un qui souvent m'importune!
C’eſt maiſtre Hieremie:	C'est maître Hieremie:
En voila déja deux:	En voilà déjà deux:
Si l’on dit qu'à preſent ie ſuis ſans Amoureux Aduoüez maintenant que c’eſt bien ce m'éprendre.	Si l'on dit qu'à présent arrêt suis ans Amoureux Aduoüez maintenant que c'est bien ce m'éprendre.
tendre, Pour ne point m'amuſer ie ne veux pas l’atIoint que i’attends icy mon autre Seruiteur, Qui peut eſtre ialoux feroitquelque malheur.	tendre, Pour ne point m'amuser ici ne veux pas l'atIoint que j'attends ici mon autre Serviteur, Qui peut être jaloux ferait malheur.
SCENE TROISRIESME.	SCÈNE -TROISRIESME.
MAISTRE HIEREMIE.	MAÎTRE HIÈREMIE.
’Eſt grand cas qu’auiourd’huy dans le ſiecle où nous ſommes On ne fait plus eſtat de la vertu des hommes, Quelque belle action qu'ils puiſſent faire voir La recompenſe manque ou finit le deuoir:	Est fait cas qu'aujourd'hui dans le siècle où nous sommes On ne fait plus état de la vertu des hommes, Quelque belle action qu'ils puissent faire voir La récompense manque ou finit le devoir:
La thoiſon d’or n’eſt plus l’honneur de leur conqueſte;	La thoison d'or n'est plus l'honneur de leur conquête;
teſte Depuis quatre-vingts ans que i’ay deſſus la I'en ay pres de cinquante endoſſé le harnois Au ſeruice actuel de quatre de nos Roys.	tête Depuis quatre-vingts ans que j'ai dessus la J'en ai pres de cinquante endossé le harnais Au service actuel de quatre de nos Rois.
Ie me ſuis rencõtré en quarante eſcarmouch	Je me suis rencontré en quarante écarmouch
C ITETRON.	Ç CTETRON.
Où l’õ tuoit le mõde auſſi dru que des mouches I’ay veu deux cens aſſaux, trois cens combats rangez:	Où l'on tuait le monde aussi dru que des mouches J'ai vu deux cens assaux, trois cens combats rangez:
cagez I’ay veit des chaſteaux pris, & des bourgs ſacI'ay veugrãd nõbre auſſi devilles imprenables Miſes en des eſtats grandement deplorables Le Fer, le feu, le ſang, ſeruoit à les punir.	cagez J'ai vit des châteaux pris, et des bourgs sacI'ai vugrand nombre aussi devilles imprenables Mises en des états grandement déplorables Le Fer, le feu, le sang, seruoit à les punir.
Encore maintenant ce triſte ſouuenir Fait ſortir de mes yeux abondance de larmes.	Encore maintenant ce triste souvenir Fait sortir de mes yeux abondance de larmes.
En fin depuis le temps que ie porte les armes, Pour me recompenſer apres tant de tourment On ma fait Anſpeſade en vn vieux regimẽt;	En fin depuis le temps que ici porte les armes, Pour me récompenser après tant de tourment On ma fait Anspesade en un vieux règiment;
Quoy que sãs me vãter i’aye fait des proüeſſes Dont la moindre en effet meritoitdes largeſſes Telles qu’vn puiſſant Roy la fait à ſes ſujets Lorsqu’il adeuãt luy leurs vertus pour objets.	Quoi que sans me vãter j'aie fait des prousses Dont la moindre en effet méritaitdes largesses Telles qu'un puissant Roi la fait à ses sujets Lorsqu'il adeutant lui leurs vertus pour objets.
Car ie me reſouuiens que du temps du Roy Charles Ie fus preſque aſſommé deuãt la ville d’Arles.	Car personne me résouviens que du temps du Roi Charles Je fus presque assommé devant la ville d'Arles.
En ce temps ie n’eſtois qu'vn petit embrelin, Goujat ſuiuent la Cour, mais pourtant bien malin:	En ce temps ici n'étais qu'un petit embrelin, Goujat suivent la Cour, mais pourtant bien malin:
plaine Car trouuant vn corps mort eſtendu ſur la	plaine Car trouvant un corps mort étendu sur la
I'eſtois tout le premier à luy tirer la laine;	J'étais tout le premier à M tirer la laine;
Ie foüillois au gouſſet s’il auoit de l’argent:	Je fouillais au gousset s'il avait de l'argent:
De courir au butin ie n’eſtois negligent.	De courir au butin ie n'étais négligent.
les, Et meſme cegrãd iour que l’onditde ſaint Gil.	les, Et même cegrand jour que l'onditde saint Gil.
Iedemeuray tout ſeulde trois ouquatre milles.	Jedemeurai tout seul trois ouquatre milles.
Aux cõbats de Loudun, S.	Aux combats de Loudun, S.
Denis, & de Dreux I'eſtois couuert de ſang tout iuſques au cheueux, [chelle, En ceux de Moncontour, Donneau, de RoOn perça mon chapeau eſtant en ſentinelle:	Denis, et de Dreux J'étais couvert de sang tout jusques au cheveux, [chelle, En ceux de Moncontour, Donneau, de RoOn perça mon chapeau étant en sentinelle:
Et du tẽps d’Hẽry trois le dernier des Vallois On me nommoit par tout le grand Mars des François.	Et du temps d'Hienri trois le dernier des Vallois On me nommait par tout le grand Mars des Français.
Soudain qu’il ce faiſoit quelqu'hardie entrepriſe, Pour eſtre despremiers i’y courois en chemiſe.	Soudain qu'il ce faisait quelqu'hardie entreprise, Pour été dépremiers j'y courais en chemise.
Auſſi lors qu'on donna la bataille à Coutras Vn coup de faucõneau me perça les deux bras.	Aussi lors qu'on donna la bataille à Coutras Un coup de fauconneau me perça les deux bras.
Et du tẽps du feu Roy à la bataille d’Arques Ie fus bien pres d’aller au Royaume des Parques:	Et du temps du feu Roi à la bataille d'Arques Je fus bien pres d'aller au Royaume des Parques:
Meſme en celle d’Yury il y faiſoit ſi chaud, Qu'vn autre homme que moy, y fuſt mort à	Même en celle d'Yuri il y faisait si chaud, Qu'un autre homme que moi, y fût mort à
10 ATLIDON, Mais que diray-ie encor de Fõtaine Frãçoiſe, Où l’ennemy touſiours m'approchoit d’vne thoiſe Sans apprehenſion le coutelas au poing I’abbatois les ſoldats comme on fauche le foïn.	10 ATLIDON, Mais que dirai-je encor de Faitaine Frãçoise, Où l'ennemi toujours m'approchait d'une thoise Sans appréhension le coutelas au poing J'abatais les soldats comme on fauche le foïn.
En ſin l’on void touſiours que Maiſtre Hieremte N'a nõ plus qu’autrefois la vaillãce endormie En ces croubles derniers, en tous ceuxprecedès Les effets de mon bras ce ſont veus éuidens.	En sin l'on voit toujours que Maître Hieremte N'a nomme plus qu'autrefois la vaillance endormie En ces croubles derniers, en tous ceuxprecedès Les effets de mon bras ce sont vus évidents.
Mais quoy que i’aye acquis vne immortelle gloire, L’Amour a maintenãtdeſſus moy la victoire:	Mais quoi que j'aie acquis une immortelle gloire, L'Amour a maintenãtdessus moi la victoire:
Ce beau petit Archer rauiſſant mes lauriers, Peut dire auoir vaincu le premier des guerriers:	Ce beau petit Archer ravissant mes lauriers, Peut dire avoir vaincu le premier des guerriers:
Le feu, le fer, le plomb, la poudre, ny la meſche N'ont ſceu faire à mon cœur ce que ma fait ſa fleſche:	Le feu, le fer, le plomb, la poudre, ni la mèche N'ont su faire à mon cœur ce que ma fait sa flèche:
Les attraits de Fleurie ont eu ſeuls le pouuoir De ne ſaire oublier le martial deuoir;	Les attraits de Fleurie ont eu seuls le pouvoir De ne zaïre oublier le martial devoir;
Depuis que ſa beauté loge dans ma poitrine A pas vn autre object ie n’ay fait bõne mine:	Depuis que sa beauté loge dans ma poitrine A pas un autre object était n'ai fait bonne mine:
Ie n’en regarde aucun qu’auecques du meſpris Voyant que leurs appas n’eſgale ma Cypris.	Je n'en regarde aucun qu'avecques du mépris Voyant que leurs appas n'égale ma Cypris.
Mais i'ay tant de mal-heur qu’en cherchant l’inhumaine Ie ne la trouue point pour luy dire ma peine.	Mais j'ai tant de malheur qu'en cherchant l'inhumaine Je ne la trouve point pour luidire ma peine.
Tantoſt vn Preſident l’emmeine promener, Tantoſt vn Conſeiller vient chez elle diſner:	Tantôt un President l'emmeine promener, Tantôt un Conseiller vient chez elle dîner:
Souuent elle eſt au Cours ou à la Comedie.	Souvent elle est au Cours ou à la Comédie.
Ha!	Ha!
fi ſi de l’amour, il faut que ie le die Exprés ie viens icy pour trouuer gueriſon Lors que le Medecin n’eſt plus à la maiſon, Puisqu'unde mes amis ma dit qu'elle eſt ſortie Il me faut à demain remettre la partie.	fi si de l'amour, il faut que je le demain Exprès tu viens ici pour trouver guérison Lors que le Médecin n'est plus à la maison, Puisqu'unde mes amis ma dit qu'elle est sortie Il me faut à demain remettre la partie.
OCENE XYATRTESMIE.	OCENE XYATRTESMIE.
FLEVRIE ET KAROLV.	FLEURIE ET §AROLU.
FLEVRIE.	FLEURIE.
E bien!	E bien!
que dites-vous de ce braue AII moureux?	que dites-vous de ce brave AI moureux?
Il eſt vaillant ſoldat, ſon cœur eſt genereux.	Il est vaillant soldat, son cœur est généreux.
Mais quoy?	Mais quoi?
me marier à vn hõme de guerre  -- -.	me marier à un homme de guerre -- -.
.	.
C’eſt fonder mõ eſpoir ſur la forced'vn verre, D'vn ſoldat, d’vn couureur, d’vn marinier auſſi icy.	C'est fonder mon espoir sur la forced' Herre, D'un soldat, d'un couvreur, d'un marinier aussi ici.
La femme eſt touſiours vefue à ce qu’on tient I'en ay tant à choiſir que i'ay crainte de dire Ainſi que beaucoup font, que i'ay fait choix du pire Queiqn vn teſuivat pies, ſienaytetrelu, Celuy qui vient à moy c'eſt Mõſieur Karolu.	La femme est toujours vue à ce qu'on tient J'en ai tant à choisir que j'ai crainte de dire Ainsi que beaucoup font, que j'ai fait choix du pire Que toujours tesuivat pies, sienaytetrelu, Celui qui vient à moi c'est Monsieur Karolu.
Mr KAROLV.	Mr AROLU.
Ma belle, c’eſt luy-meſme à voſtre humble T2.	Ma belle, c'est lui-même à votre humble T2.
Si pour vn tel honneur vous le iugez propice Il eſt preſt d’obeir à vos commandemens.	Si pour un tel honneur vous le jugez propice Il est prêt d'obéir à vos commandements.
FLEVRIE.	FLEURIE.
Vous vous mettez touſiours deſſus les complimens:	Vous vous mettez toujours dessus les compliments:
dites, Mais ne pouuant répondre à tout ce que vous C’eſt deuant les pourceaux ſemer des margueMR KAROLV.	dites, Mais ne pouvant répondre à tout ce que vous C'est devant les pourceaux semer des margueMR AROLV.
rites.	rites.
Ie ne ſçaurois ſouffrir telle comparaiſon, Auecqu'vn bon esprit vous auez la raiſon Qui ne doit point ceder à perſonne du monde.	Je ne saurais souffrir telle comparaison, Avecqu'bon ur vous avez la raison Qui ne doit point céder à personne du monde.
FLEVRIE.	FLEURIE.
Ma ſcience pourtant n'eſt pas beaucoup profonde:	Ma science pourtant n'est pas beaucoup profonde:
pas:	pas:
Monſieur pour m'obliger ne m'entreprenez ar ie ne vous dirois que des galimatias.	Monsieur pour m'obliger ne m'entreprenez ar ie ne vous dirais que des galimatias.
Mr KAROLV.	Mr AROLU.
Das on ſens iout parfait vofre raré eloquece Des meilleurs Orateurs tient la gloire en baFLEVRIE.	Das on sens jout parfait vofre raré éloquece Des meilleurs Orateurs tient la gloire en baFLEURIE.
lance.	lance.
Si n’ay-je iamais leu que Rablais & Marot, Dot u peint a preſent mt founnesseu unmor.	Si n'ai-je jamais lu que Rablais et Marot, Dot peint a présent founnesseu unmor.
Ces modernes autheurs ne me plaiſent à lire Sils n'ont das leurs Romans le petit mot pour	Ces modernes auteurs ne me plaisent à lire Sils n'ont das leurs Romans le petit mot pour
Mr KAROLV.	Mr AROLU.
rire.	rire.
Il n'y a point d’Autheurs que voſtre esprit	Il n'y a point d'Auteurs que votre esprit
ILEVRICe (n'ay leu.	ILEURICe (n'ai lu.
Pas un d’eux ne reſſemble à Mõſieur Karolu.	Pas un d'eux ne ressemble à Mõsieur Arolu.
M RAROLV.	M MAROLV.
C’eſt trop de vanité que voſtre amour me dõ.	C'est trop de vanité que votre amour me dõ.
FLEVRIE.	FLEURIE.
ne.	ne.
Iamais vn bon eſprit n'en reçoit de perſonne.	Jamais un bon esprit n'en reçoit de personne.
MR KAROLV.	MR AROLU.
Le mien manquant auſſi de ceſte qualité A ſes diuins autheurs ſa gloire il a quitté.	Le mien manquant aussi de cette qualité À ses divins auteurs sa gloire il a quitté.
.	.
.	.
.	.
.	.
.	.
	
IDPASIV Mais espargnez vn peu vos amis ievoꝰ prie;	JDPASIV Mais épargnez un peu vos amis ievoꝰ prie;
1111119Ccpuumcbupuommuumren alenrie,	1111119Ccpuumcbupuommuumren alenrie,
FLEVRIE.	FLEURIE.
C’eſt me rendre vn deuoir que ien'ay merité;	C'est me rendre un devoir que yenay mérité;
S’il m'eſt deub quelqu’honneur c’eſt mon antiquité Qui me donne cela par deſſus la jeuneſſe Qui doit auec l’honneur le reſpect à vieilleſſe.	S'il m'est devb quelqu'honneur c'est mon antiquité Qui me donne cela par -dessus la jeunesse Qui doit avec l'honneur le respect à vieillesse.
MR KAROLV.	MR AROLU.
Voſtre aage ne permet de tenir tels propos, Voſtre viſage gay, vos membres ſi dispos Font voir aſſez l’éclat de vos beauteZ par faites, Qui fourniſſent l’amour de bottes d’alumettes mout enptumtepue cannu, on umunt conemoys Reſolu maintenant de vous donner la foy Si voſtre affection accepte ſon ſeruice.	Votre aage ne permet de tenir temps propos, Votre visage gai, vos membres si dispos Font voir assez l'éclat de vos beautés par faites, Qui fournissent l'amour de bottes d'alumettes moût enptumtepue cannu, on umunt conémois Résolu maintenant de vous donner la foi Si votre affection accepte son service.
FLEVRIE.	FLEURIE.
eſt iuſtenient fraper ou mon deſir ce gliſſe;	est justenient frapper ou mon désir ce glisse;
A l’inſtãt que mes yeux ſe sõt jettez ſur vous Ils ont veu dans l’abord vn entretien ſi doux, Que puis que maintenant l’occaſion ce treuue Vous eſtant homme vœuf, auſſi bien que moy veufue .	À l'instant que mes yeux se sont jetés sur vous Ils ont vu dans l'abord un entretien si doux, Que puis que maintenant l'occasion ce trouve Vous étant homme vœuf, aussi bien que moi veuve .
1.	1.
Pour encore gouſter quelque doux paſſe-tẽps, Et viure enſemblement le reſte de nos ans:	Pour encore goûter quelque doux passe-tenants, Et vivre ensemblement le reste de nos ans:
I'ay creu qu'en vous prenant ie ne perdrois au change, Pourueu que voſtre eſprit ne dõne de loüange A ce petit ſujet qui n’en merite pas.	J'ai cru qu'en vous prenant je ne perdrais au change, Pourvu que votre esprit ne donne de louange À ce petit sujet qui n'en mérite pas.
Miais quoy:	Miais quoi:
de pen de tuojeon fait ſoutuent grand cas.	de pen de tuojeon fait souvent grand cas.
Mr KAROLV.	Mr AROLU.
Vos mépris ne font rien qu'accroiſtre voſtre gloire, Déja vous aueZ place au temple de memoire, Et c’eſt trop offencer ce que i’ay de plus cher;	Vos mépris ne font rien qu'accroître votre gloire, Déjà vous avez place au temple de mémoire, Et c'est trop offenser ce que j'ai de plus cher;
De vous baiſer içy ie ne puis m'empeſcher, Afin de reparer vne ſi grande iniure, Que mon parfait amour ne veux pas que i'endure.	De vous baiser ic ie ne puis m'empêcher, Afin de réparer une si grande injure, Que mon parfait amour ne veux pas que j'endure.
FLEVRIE.	FLEURIE.
Hola, n'approchez pas:	Hola, n'approchez pas:
toubeau, teneZ-vous bien, Et dites mon amy que vous ne tenez rien.	toubeau, teneZ-vous bien, Et dites mon ami que vous ne tenez rien.
Ha!	Ha!
Mõſieur Karolu, vous m’auez décoiffee Et iuſques au mourir vous m’auez échauffee, .	Massieur Arolu, vous m'avez décoiffe Et jusques au mourir vous m'avez échauffe, .
.	.
.	.
.	.
.	.
.	.
.	.
.	.
	
M KAROLV.	M MAROLV.
Ce plaiſir eſt ſi doux, qu’il n’eſt point d’Amoureux Qui de mourir ainſi ne ſe creu bien-heureux:	Ce plaisir est si doux, qu'il n'est point d'Amoureux Qui de mourir ainsi ne se cru bienheureux:
Mais dieux, ce doux baiſer m'interdit la pa	Mais dieux, ce doux baiser m'interdit la pays
FLEVRIE.	FLEURIE.
role.	rôle.
Perſonne ne la veu, c'eſt ce qui me conſolle.	Personne ne la vu, c'est ce qui me consolle.
Que i'aurois de regret ſi quelqu'vn par hazard Ate moment jur nons euſtiette ſon regard:	Que j'aurais de regret si quelqu'un par hasard Ate moment jur ons eustiette son regard:
Ie vous laiſſe à pẽſer ce que l’on pourroit dire.	Je vous laisse à pẽser ce que l'on pourrait dire.
M RAROLV.	M MAROLV.
Que ce ſont des Amans qui s’amuſent à rire.	Que ce sont des Amants qui s'amusent à rire.
FLEVRIE.	FLEURIE.
I’aduoüe qu’autrefois cela m'euſt ſemblé bon:	J'avoue qu'autrefois cela m'eût semblé bon:
Mais ma peau reſſemblãt la coined’vn iambõ Faiſant veoir auiourd’huy ma face riſſolee omme vne ſolle fritte ou à demy bruſlee Rend tous mes ſeruiteurs auſſi froids qu'vn glaçon.	Mais ma peau ressemblant la coined' iambõ Faisant veoir auiourd’ ma face rissolée m solle fritte ou demi brûlée Rend tous mes serviteurs aussi froids qu'n glaçon.
Mr KAROLV.	Mr AROLU.
Tant mieux, en vous prenant i’auray chair poiſſon.	Tant mieux, en vous prenant j'aurai chair poisson.
FLEVRIE.	FLEURIE.
abtui jeveue terron mes praes unovenx vede	abtui jevue terron mes praes unovenx vède
MR KAROLV.	MR AROLU.
Quoy?	Quoi?
voir baiſer leur mere au milieu d’vne FLEVRIE.	voir baiser leur mère au milieu d'une FLEURIE.
Truë.	True.
Ouy vrayement, ie ne ſçay ce qu’elles en di	Oui vraiment, Madame ne sais ce qu'elles en di
del ſxARon ve.	dél sxARon ve.
Iroient.	Jraient.
Que deux parfaits amys grandement s’aime	Que deux parfaits amis grandement s'aime
FLEVRIE.	FLEURIE.
froient.	fraient.
Seroit à des enfans donner un bon exemple.	Serait à des enfants donner un bon exemple.
Mr KAROLV.	Mr AROLU.
Hltureny qneiquumie iour noſtre entretien plus ample Me donnera loiſir de conclure auec vous.	Hltureni qneiquumie jour nôtre entretien plus ample Me donnera loisir de conclure avec vous.
FLEVRIE, Loffre que ie vous faits	FLEURIE, Loffre que je vous faits
ſl MEAROEVS.	sl MEAROUS.
d’eſtre vn iour voſtre espoux	d'être un jour votre époux
FLEVRIE.	FLEURIE.
Il faut touſiours courir au biẽ plus neceſſaire.	Il faut toujours courir au bien plus nécessaire.
Mr KAROLV.	Mr AROLU.
Vn Partiſan m'attend pour reſoudre vne affaire.	Un Partisan m'attend pour résoudre une affaire.
Touchant certains aduis que ie luy vais donner Sur la place du change où ie vais promener:	Touchant certains avis que ie cy vais donner Sur la place du change où tu vais promener:
C’eſt la que joliment ce gaigne la pecune, » Alors qu'en peu de temps on veut faire fortu	C'est la que joliment ce gagne la pecune, " Alors qu'en peu de temps on veut faire fortu
Allez, faites proffit, moy ie vais au bouquet Ioüer vn triquetrac, ou peut eſtre vn picquet.	Allez, faites proffit, moi -je vais au bouquet Iouer un triquettrac, ou peut être un piquet.
On me doit bien nommer la Pernette l’heureuſe, Voila trois amoureuxqui n'ont qu’vneamoureuſe:	On me doit bien nommer la Pernette l'heureuse, Voilà trois amoureux n'ont qu'uneamoureuse:
Le Noble, la Iuſtice, auec le tiers Eſtat,  A qui m’aura pour femme ont enſemble combat:	Le Noble, la Justice, avec le tiers État, À qui m'aura pour femme ont ensemble combat:
Mais pourtant celuy-oy a de bons exercices, Il donne des aduis, fait vendre des offices, Il eſt gaigne denier, il pourſuit des procez, Et fait preſter argent à rente ou intereſts.	Mais pourtant celui-toi a de bons exercices, Il donne des avis, fait vendre des offices, Il est gagne denier, il poursuit des procès, Et fait prêter argent à rente ou intérêts.
SCENE CINQVIESME:	SCÈNE CINQUIÈME:
POLIANDRE.	POLYANDRE.
ROSELIS.	ROSELIS.
BELANGE.	BÉLANGE.
POLIANDRE.	POLYANDRE.
Eſtime plus Amour le pouuoir de tes armes, Puis que ma paſſion n'à ſceu gouſter leurs charmes;	Estime plus Amour le pouvoir de tes armes, Puis que ma passion n'à su goûter leurs charmes;
De dix milles objets que ie vois dans la Cour Pas vn iuſqu'auiourd’huy ne ma donné d’amour:	De dix mille objets que je vois dans la Cour Pas un jusqu'aujourd'hui ne ma donné d'amour:
I’ay beat conſiderer l’exceds de leurs merites;	J'ai béat considérer l'excéds de leurs mérites;
Ils ont pour ma froideur des chaleurs trop petites Rour ue point captiuer ma chere liberté:	Ils ont pour ma froideur des chaleurs trop petites Rour ue point captiver ma chère liberté:
I'ahirois les appas d’vne diuinité.	J'ahirais les appas d'une divinité.
TLa.	TLa.
Mais quoy que monthumeur paroiſſe aaga bonde, Ie ne laiſſe pourtant de cherir tout lemonde;	Mais quoi que monthumeur paraisse aaga bonde, Je ne laisse pourtant de chérir tout lemonde;
Ie carreſſe vne Dame autant comme vn amy:	Je carresse une Dame autant comme un ami:
Ie n’aydãs l’Vniuers qu’Amour pour ennemy:	Je n'aidans l'Univers qu'Amour pour ennemi:
Et quelque blaſme encor qu'on donne à l’inconſtance Ie veux iuſqu’au mourir ſuiure l’indifferẽce, aidigreton tes cſorts de te fiis de Cypris.	Et quelque blâme encor qu'on donne à l'inconstance Je veux jusqu'au mourir suivre l'indifférence, aidigreton tes corts de te fiis de Cypris.
ROSELIS.	ROSELIS.
Laſche, il faut que tu meure auecque ton mépris.	Lâche, il faut que tu meure auecque ton mépris.
at ae deaaes Donne-moy le loiſir de tirer mon eſpee.	at ae deaes Donne-moi le loisir de tirer mon épée.
NOSELIS.	NOSELIS.
1 3 Il faut que dãs ton ſang la mienne ſoit trẽpee.	1 3 Il faut que dans ton sang la mienne soit trẽpee.
POLIANDRE.	POLYANDRE.
Quel prodige eſt cecy, deux freres inhumains Pour ce faire mouriront lesarmes aux mains;	Quel prodige est -ceci, deux frères inhumains Pour ce faire mouriront lesarmes aux mains;
Aeſunt tesſepurti jaus aunamtagc attendre,	Aesunt tessepurti jus auntagc attendre,
ROSELIS.	ROSELIS.
En vàin voſtre ſecours taſche de le deffendre.	En vein votre secours tâche de le défendre.
BEEANGE.	BEANGE.
Mõſieur, obligez-nous devous mettre à l’eſcart, Pour iuger qui des coups aura meilleure part.	Monssieur, obligez-nous devous mettre à l'écart, Pour juger qui des coups aura meilleure part.
POLMANDRE.	POLMANDRE.
II 112221 Ie veux auparauant ſçauoir voſtre querelle.	II 112221 Je veux auparavant sçauoir votre querelle.
ROSELIS.	ROSELIS.
t om ntu ponnea ſpauoir ont pius criminelle	 tom nu ponnea spavoir ont pius criminelle
BELANGE.	BÉLANGE.
Si vous appellez crime vn conſeil fraternel, Ie confeſſe en effet que ie ſuis criminel.	Si vous appelez crime un conseil fraternel, Je confesse en effet que personne suis criminel.
Mais pourtant la raiſon qui me doit rendre 1886 Ne m'a fait dire rien à ſon deſaduantage.	Mais pourtant la raison qui me doit rendre 1886 Ne m'a fait dire rien à son désavantage.
ROSELIS.	ROSELIS.
Perfide, oſe-tu bien proferer ce diſcours .	Perfide, ose-tu bien proférer ce discours .
1111Jui M Copunuumdenres iours .	11111Jui M Opunuumdenres jours .
Ha!	Ha!
il faut que i'apprenne à ta ieune ceruelle Qu'en mocquant mon amour tu offences ma	il faut que j'apprenne à ta jeune cervelle Qu'en moquant mon amour tu offenses ma
BELANGE.	BÉLANGE.
belle.	belle.
Ie meure ſi iamais i'ay voulu l’offencer:	Je meure si jamais j'ai voulu l'offenser:
POLIANDRE.	POLYANDRE.
Sa ſatisfaction doit ſon crime effacer.	Sa satisfaction doit son crime effacer.
ROSELIS.	ROSELIS.
Pourquoy m'empeſchez-vous de punir vn infame Qui jette ſon venin ſur l’honneur d’vné dame	Pourquoi m'empêchez-vous de punir un infâme Qui jette son venin sur l'honneur d'uné dame
POLIANDRE.	POLYANDRE.
Ie ne ſouffriray point que l’on paſſe à l’effet Que mon iuſte deſir vous n’ayeZ ſatisfait;	Je ne souffrirai point que l'on passe à l'effet Que mon juste désir vous n'ayeZ satisfait;
Et de quelque coſté que tourne l’iniuſtice It feray te piemter a panii ſa mauice.	Et de quelque côté que tourne l'injustice It ferai te piemer a pani sa mavice.
ROSELIS.	ROSELIS.
Faits-en dono le recit, mais ſi diſcretement Que ie n'aye ſujet de meſcontentement.	Faits-en donc le récit, mais si discrètement Que tu n'aie sujet de mécontentement.
BELANGE.	BÉLANGE.
Souuent l’occaſion ſe monſtre fauorable A celuy que l’Amour veut rendre miſerable:	Souvent l'occasion se montre favorable À celui que l'Amour veut rendre misérable:
Dans le commencement que n'aiſt l’affection On ne void rien d’eſgal à ceſte paſſion:	Dans le commencement que n'aît l'affection On ne voit rien d'égal à cette passion:
Tout ce qu'on ſe propoſe en ce premier rencontre Doit ce sẽble arriuer tel que l'esprit le mõſtre:	Tout ce qu'on se propose en ce premier rencontre Doit ce somme arriver tel que l'esprit le montre:
Mais helas!	Mais hélas!
les effets en ſont ſi differends, Que i'en voudrois les dieux prendre pour mes garends.	les effets en sont si différends, Que j'en voudrais les dieux prendre pour mes garends.
Ce propos que ie tiens ne me ſemble inutile Pour faire voir l’eſtat d'vn eſprit biẽ fragile.	Ce propos que ie tiens ne me semble inutile Pour faire voir l'état d'un esprit bien fragile.
Mon frere que le ciel a veu naiſtre amoureux Auecqu' autant d’ardeur comme il eſt genereux;	Mon frère que le ciel a vu naître amoureux Avecqu' autant d'ardeur comme il est généreux;
Eſpris de la beauté d’vne ieune eſtrangere	Épris de la beauté d'une jeune étrangère
2 Meſme qu’vn ieune Duc l’appelle ſa maiſtreſſe.	2 Même qu'un jeune Duc l'appelle sa maîtresse.
Qu'on ne nomme à la Cour que la belle bergere;	Qu'on ne nomme à la Cour que la belle bergère;
A tant flaté ſon mal par vn eſpoir caché Que dix ans de tourmẽt ne l’en ont empeſché.	À tant flatté son mal par un espoir caché Que dix ans de tourment ne l'en ont empêché.
Pendant les premiers feux de ſon dur eſclauage La Cocquette touſiours luy monſtroit bon viſage:	Pendant les premiers feux de son dur esclavage La Cocquette toujours homme montrait bon visage:
Tout ce qu'elle a voulu a ſorty ſon effet;	Tout ce qu'elle a voulu a sorti son effet;
Quand l’esprit a manqué le courage l'a fait:	Quand l'esprit a manqué le courage l'a fait:
Où la faueur n'a peu faire voir ſa puiſſance Il a forcé les dieux à prendre ſa deffence.	Où la faveur n'a pu faire voir sa puissance Il a forcé les dieux à prendre sa défense.
Luy tout ſeul l’a rauit à Montreüil ſoubs le bois Malgré tous les efforts de deux cẽs villageois:	Lui tout seul l'a ravit à Montreil soups le bois Malgré tous les efforts de deux cẽs villageois:
Il eſt cauſe auiourd’huy que toute la nobleſſe L’eſtime dans la Cour autant qu’vne Princeſſe.	Il est cause aujourd'hui que toute la noblesse L'estime dans la Cour autant qu'une Princesse.
Mais comme cét eſprit remply de vanité A veu que tout le monde admire ſa beaute, Que chacun Courtiſan ſans ceſſe la carreſſe,	Mais comme cet esprit rempli de vanité A vu que tout le monde admire sa beauté, Que chacun Courtisan sans cesse la carresse,
dure.	dure.
Sa grande ambition a porté ſes eſprits A ne luy plus parler qu'auecque du mépris:	Sa grande ambition a porté ses esprits A ne lui plus parler qu'avec du mépris:
Si mon frere l’aborde elle tourne viſage;	Si mon frère l'aborde elle tourne visage;
Penſant la cajoller elle entretient vn page:	Pensant la cajoler elle entretient un page:
S’il luy offre la main pour la mener au bal, Peur de l’incommoder elle prend vn riual.	S'il lui offre la main pour la mener au bal, Peur de l'incommoder elle prend un rival.
S’il preſſe ſa raiſon de vouloir recognoiſtre L’amitié que touſiours il luy a fait paroiſtre, Elle dit froidement qu'elle n’a rien promis Qui le puiſſe empeſcher de viure bons amis:	S'il presse sa raison de vouloir reconnaître L'amitié que toujours il a a fait paraître, Elle dit froidement qu'elle n'a rien promis Qui le puisse empêcher de vivre bons amis:
Voyez ſi c’eſt parler en termes d’vne fille Dont le nom ſeulement bleſſe noſtre famille;	Voyez si c'est parler en termes d'une fille Dont le nom seulement blesse notre famille;
De ſimple villageoiſe elle a eu le bon-heur D’eſtre par ſon credit au comble de l’honneur:	De simple villageoise elle a eu le bonheur D'être par son crédit au comble de l'honneur:
Mais elle cependant tout ce bien-fait oublie, En luy faiſant affront l’ingrate le publie.	Mais elle cependant tout ce bienfait oublie, En Ah faisant affront l'ingrate le publie.
Et quand ie penſe icy dire mon ſentiment Qu’il ne doit pas paroiſtre inſenſible en aimãt Prenant tous mes propos pour vne grande iniure Il me veut mettre à mort pourueu que ie l’en	Et quand ie pense cy dire mon sentiment Qu'il ne doit pas paraître insensible en aimant Prenant tous mes propos pour une grande injure Il me veut mettre à mort pourvu que je l'en
POLIANDRE.	POLYANDRE.
Roſelis en cela me ſemble vn peu trop chaut:	Roselis en cela me semble un peu trop chaut:
Mais pourueu qu'à l’amour ſon honneur il prefere, Puis qu'à mon iugement il a remis l’affaire, Ie veux dire en paſſant par forme de deuis Qu'en ce cas ſa raiſon doit ſuiure voſtre aduis Que vous deuez tous deux vous aimer comme freres, Sans iamais contre vous animer vos coleres.	Mais pourvu qu'à l'amour son honneur il préfère, Puis qu'à mon jugement il a remis l'affaire, Je veux dire en passant par forme de devis Qu'en ce cas sa raison doit suivre ainsi avis Que vous devez tous deux vous aimer comme frères, Sans jamais contre vous animer vos colères.
BELANGE.	BÉLANGE.
cen equhautonaieunon ampore une toy Que mõ frere doit ſuiure auſſi bien cõme moy:	cen equhautonaieunon ampore une toi Que mon frère doit suivre aussi bien comme moi:
Toutéfois iecrains fort qu'il y trouue à redire	Toutéfois iecrains fort qu'il y trouve à redire
POLIANDRE.	POLYANDRE.
Ie ne crains pas auſſi qu’il me vueille dédire.	Je ne crains pas aussi qu'il me veuille dédire.
ROSELIS.	ROSELIS.
avronficur, nou, vous auos tropuopligation, Uoſtre Arreſt prononcé ie ſuis ſans paſſion;	avronficur, nouv, vous avez tropuopligation, Uotre Arrêt prononcé quelque suis sans passion;
Et quoy que ſon effet me ſemble difficile I'eſpere auec le temps me le rendre facile.	Et quoi que son effet me semble difficile J'espère avec le temps me le rendre facile.
POLIANDRE.	POLYANDRE.
Adieu donc, cependant demeureZ bons amis Et me tenez tous deux ce que m'auez promis.	Adieu donc, cependant demeurez bons amis Et me tenez tous deux ce que m'avez promis.
BELANGE.	BÉLANGE.
Pintoſt que u'ymaquerte venx perdreia vte.	Pintôt que u'ymaquerte venx perdreia vite.
ROSELIS.	ROSELIS.
Ta reſolution de la mienne eſt ſuiuie, Pourueu que deſormais paroiſſant plusdiſcret Tu n'ailles à chacun deſcouurir mon ſecret.	Ta résolution de la mienne est suivie, Pourvu que désormais paraissant plusdiscret Tu n'ailles à chacun découvrir mon secret.
Fin du premier Acte,	Fin du premier Acte,
ACTE SECOND.	ACTE SECOND.
SILINDE.	SILINDE.
CLARISTE.	CLARISTE.
FLORIANE.	FLORIANE.
LEVME.	LEUME.
AAROEV.	AAROUE.
M THEREMIE.	M MHÉREMIE.
POLIANDRE.	POLYANDRE.
ROSELIS.	ROSELIS.
BELANGE.	BÉLANGE.
S Cnlva SILINDE.	 Snva SILINDE.
CLARISTE.	CLARISTE.
FLORIANE.	FLORIANE.
FLEVRIE.	FLEURIE.
SILINDE.	SILINDE.
Eſt trop dans le logis demeurer enferinee, Le Soleil n'ayant plus ſa force accouſtumee:	Est trop dans le logis demeurer enferinée, Le Soleil n'ayant plus sa force accoutumée:
D'vn air plus tẽperé fait gouſter lesdouceurs Clariſte, Floriane, où eſtes vous mes ſœurs, Pour icy trauailler apportez voſtre ouurage, Nous nous diuertirons auec le voiſinage.	D'un air plus tẽperé fait goûter lesdouceurs Clariste, Floriane, où êtes -vous mes sœurs, Pour ici trauailler apportez ainsi ouvrage, Nous nous divertirons toujours le voisinage.
CLARISTE.	CLARISTE.
Auec meſme deſſein nous deuallions en bas	Avec même dessein nous devallions en bas
PEORIANE.	PEORIANE.
Déja pour commencer i'auois pris deux rabas.	Déjà pour commencer j'avais pris deux rabas.
SILINDE.	SILINDE.
Ma ſœur, apporte moy vne chaire bien baſſa.	Ma sœur, apporte moi une chaire bien bassa.
FLORIANE.	FLORIANE.
En vonauſadena, ounux quent ſuis laſſe!	En vonausadena, ounux quent suis lasse!
Orſus, auparauant que ie remonte en haut Pour ny plus retournerdites ce qu’ilvous faut	Orsus, auparavant que ici remonte en haut Pour ici plus retournerdites ce qu'il faut
CLARISTE.	CLARISTE.
Deſſus noſtre buffet eſt man poinct de Hongrie.	Dessus notre buffet est man point de Hongrie.
SILINDE.	SILINDE.
I Mon m'eſtier eſt aupres de ſa tapiſſerie;	I Mon m'étier est auprès de sa tapisserie;
Petite pareſſeuſe haſtez-vous de venir.	Petite paresseuse hâtez-vous de venir.
CLARISTE.	CLARISTE.
Il ne faudra rien qu’elle à nous entretenir Si ſon gentil eſprit n'a point d’autres penſees.	Il ne faudra rien qu'elle à nous entretenir Si son gentil esprit n'a point d'autres pensées.
	
FLORIANE.	FLORIANE.
Mes peines deuroient bien eſtre recompẽſees.	Mes peines devraient bien être recompẽsees.
Mais quoy?	Mais quoi?
le droitd aineſſe auec ſa primauté Me rauit bien ſouuent ce que i’ay merité:	le droitd aînesse avec sa primauté Me ravit bien souvent ce que j'ai mérité:
Il faut que la plus ieune endure de l’aiſnee, Il faut tout luy ceder pour n'eſtre mal-menee, Il faut aller par tout, & bien viſte marcher Sans qu'aucune raiſon vous en puiſſe empeſcher.	Il faut que la plus jeune endure de l'aise, Il faut tout cela céder pour n'être mal-mène, Il faut aller par tout, et bien vite marcher Sans qu'aucune raison vous en puisse empêcher.
Sil ſe trouue vn party ſera pour la premiere, La plus ieune touſiours demeure la derniere.	Sil se trouve un parti sera pour la première, La plus jeune toujours demeure la dernière.
En fin s’il ſe pouuoit, pour les fort obliger Mon aage auet le leur ie voudrois biẽ chãger:	En fin s'il se pouvait, pour les fort obliger Mon âge auet le leur personne voudrais bien chãger:
cai ruy vien un regrer demt tes point voir femmes, Et d’obeir touſiours à ces belles madames.	cai rui viens un regrer demt tes point voir femmes, Et d'obéir toujours à ces belles madames.
SILINDE.	SILINDE.
Canſeuſcuſezi vuussuttmtuuer jenlement, Et nous donneZ loiſir de parler vn moment.	Canseuscusezi vuussutmtuuer jenlément, Et nous donnez loisir de parler un moment.
FLORIANE.	FLORIANE.
Quand i'ayde la raiſon ie ne me ſçaurois taire.	Quand j'aide la raison rien ne me saurais taire.
CLARISTE.	CLARISTE.
Vous eſtes d’vne humeur grãdemẽt volõtaire, - --.	Vous êtes d'une humeur grãdemẽt volontaire, - --.
.	.
.	.
	
Il falloit adiouſter à voſtre beau diſcours, Qau teunege eiſ dens parveunons fou	Il fallait ajouter à votre beau discours, Qaveu teunege eis dents parveunons fou
FLORIANE.	FLORIANE.
Cjours.	Cjours.
Il eſt vray que ſouuent i'euſſe eſté bien tapee, Si courãt apres moy vous m'euſſiez attrapee:	Il est vrai que souvent j'eusse été bien tape, Si courant après moi vous m'eussiez attrape:
Mais ma fuitte toujours ma ſeruy de pardon.	Mais ma fuite toujours ma servi de pardon.
SILINDE.	SILINDE.
Briſez ſur ce propos pour en entẽdre vn bon, I'ay ce matin appris de ma bonne commere Que Monſieur Karolu recherche noſtre mere, Qu'à quel prix que ce ſoït il là veut espouſer, anceſuio qu en certumt ucu con tesudeus baiGLARISTE.	Brisez sur ce propos pour en entendre un bon, J'ai ce matin appris de ma bonne commere Que Monsieur Arolu recherche notre mère, Qu'à quel prix que ce souit -il là veut épouser, ancesvio qu' à certumt ucu con témudeus baiGLARISTE.
I ſer.	I ser.
O Dieux!	Ô Dieux!
eſt-il poſſible?	est-il possible?
SILINDE.	SILINDE.
Il eſt trop veritable, Les articles ce iour ſeront mis ſur la table:	Il est trop véritable, Les articles ce jour seront mis sur la table:
Et maiſtre Hleremie & ce vieux Colporteur Ont tous deux leur congé auec grand creueFLORIANE, (cœur.	Et maître Hleremie et ce vieux Colporteur Ont tous deux leur congé avec grand crèveFLORIANE, (cœur.
Ils me deſplaiſoient fort, quoy qu’ils me fiſſent rire, Et i’auois ſans mentir le deſſein de leur dire.	Il me déplaisaient fort, quoi qu'ils me fissent rire, Et j'avais sans mentir le dessein de leur dire.
Il eſt vray qu'à ces deux ie n'euſſe conſenty:	Il est vrai qu'à ces deux ie n'eusse consenti:
Mais Monſieur Karolu, c'eſt vn fort bon party, On cognoiſt ſa lignee autant que ſon merite;	Mais Monsieur Arolu, c'est un fort bon parti, On connaît sa ligne autant que son mérite;
On ſçait qu’il a du biẽ qui n’a point de limite, Que par tout cheZ les Grãds il eſt le biẽ venu;	On sais qu'il a du bien qui n'a point de limite, Que par tout chez les Grands il est le bien venu;
Quit eſt ueuans Luin ac tont tnatuncognen.	Quit est ueuans Luin ac tont tnatuncognen.
Bref il nous fait faueur d’eſtre noſtre beau	Bref il nous fait faveur d'être notre beau
SILINDE.	SILINDE.
pere.	père.
Hola, n'en parlons plus:	Holà, n'en parlons plus:
car voicy noſtre mere	car voici notre mère
Uoila l’un des garçons de noſtre Sauetier 1endoaunumon ouiguin us deux fe	Uoilà l'un des garçons de notre Savetier 1endoaunumon ouiguin us deux se
FLEVRIE.	FLEURIE.
He bien, que faites-vous;	He bien, que faites-vous;
que dit-on au quar	que dit-on au quar
FLORIANE.	FLORIANE.
tier:	tier:
FLEVRIE.	FLEURIE.
Imelles.	Imelles.
Paiſez-oous pabouine, eſtete la les nouuelles Qu'auiourd’huy mon esprit veut entendré de	Paisez-oous pabouine, estete la les nouvelles Qu'aujourd'hui mon esprit veut entendré de
FLORIANE.	FLORIANE.
Fvous.	Fvous.
Que nous aurons bien-toſt un beau-pere chez nous:	Que nous aurons bientôt un beau-père chez nous:
FLEVRIE.	FLEURIE.
2 Mais regardez vn peu la petite ruſee Qui luy en à tant dit.	2 Mais regardez un peu la petite ruse Qui lui en à tant dit.
FLORIANE.	FLORIANE.
araimmmoiRoſée.	araimmmoiRosée.
FLEVRIE.	FLEURIE.
Puis que ma bequenots me prend içy ſansver, Ie ne puis plus celer ce qu’elle a deſcouuert;	Puis que ma béquenots me prend içi sansver, Je ne puis plus celer ce qu'elle a découvert;
La mine eſt euentee au temps que l’on deſire, Auſſi bien dedans peu falloit-il vous le dire.	La mine est évente au temps que l'on désire, Aussi bien dedans peu fallait-il vous le dire.
Sçachez-donc qu’il eſt vray que Monſieur Karolu De m’auoir pour ſa femme eſt biẽ fort reſolu;	Sachez-donc qu'il est vrai que Monsieur Arolu De m'avoir pour sa femme est bien fort résolu;
Ie croy que toutes trois vous en ſerez conten	Je crois que toutes trois vous en serez conten
SILINDE.	SILINDE.
Ites.	Ites.
On nous eſtimeroit tout à fait imprudentes, Si voyant le bon-heur nous preſenter la main Nous ne couriõs apres par vn meſme chemin:	On nous estimerait tout à fait imprudentes, Si voyant le bonheur nous présenter la main Nous ne couris après par un même chemin:
En cela nous deuons ſuiure voſtre ſageſſe, Amnun, vos venus nons miurons i nobleſſe.	En cela nous devons suivre votre sagesse, Amnun, vos venus nons mivrons y noblesse.
Et puis que l’vn & l’autre y ſont tous deux portez, Nous ſerons toutes trois d’eſgales volontez.	Et puis que l'un et l'autre y sont tous deux portés, Nous serons toutes trois d'égales volontés.
FLEVRIE.	FLEURIE.
Ce diſcours me plaiſt fort:	Ce discours me plaît fort:
tu ne dis rien Clariſte.	tu ne dis rien Clariste.
CLARISTE.	CLARISTE.
Elle a parlé pour moy.	Elle a parlé pour moi.
FLEVRIE.	FLEURIE.
Que tu me ſenible triſte.	Que tu me senible triste.
CLARISTE.	CLARISTE.
Vous me pardonnerez.	Vous me pardonnerez.
FLORIANE.	FLORIANE.
Ce tein blanc ſans chaleurs Reſſemble extremement à des pâles couleurs:	Ce tein blanc sans chaleurs Ressemble extrêmement à des pâles couleurs:
Elle mange du ſel, elle boid du vinaigre Pour auoir la peau blanche & le viſage mais Bjai, donre jun inai,	Elle mange du sel, elle boyd du vinaigre Pour avoir la peau blanche et le visage mais Bjai, donre jun inai,
Ha!	Ha!
que voicy grand cas.	que voici grand cas.
FLORIANE.	FLORIANE.
Il luy faut vn mary.	Il lui faut un mari.
TLEVRIE.	TLEURIE.
Uous ne vous tairez pas.	Uous ne vous tairez pas.
FLORIANE.	FLORIANE.
I'auray bien de la peine.	J'aurai bien de la peine.
FLEVRIE En verité ie iure.	FLEURIE En vérité Seigneur jure.
FLORIANE.	FLORIANE.
FLORIANE.	FLORIANE.
she ſevons me vutez, ut fanuruque t'endure,	she sévons me vutez, ut fanuruque t'endure,
FLEVRIR.	FLEURIR.
Entrez dans la maiſon, & nous laiſſez icy.	Entrez dans la maison, et nous laissez ici.
FLORIANE.	FLORIANE.
Bien, ne vous faſchez pas, ie m'y en vais auſſi:	Bien, ne vous fâchez pas, Seigneur m'y en vais aussi:
CLARISTE.	CLARISTE.
Ie loue extremement te bon choix que vous faites.	Je loue extrêmement te bon choix que vous faites.
FLEVRIE.	FLEURIE.
Mon ſentiment n'a point que des raiſons parfaites;	Mon sentiment n'a point que des raisons parfaites;
vous.	vous.
Ie ne fais rien pour moy que ce ne ſoit pour Si ie prens vn mary vous aurez des eſpoux Selon voſtre merite, & auec l’aduantage Ceuomeuſfe quujamcummps de mon vefnage :	Je ne fais rien pour moi que ce ne soit pour Si je prends un mari vous aurez des époux Selon votre mérite, et avec l'avantage Ceuomeusfe quujamcums de mon vefnage :
Avoin ſeront ſentement on petir dejenner, 4 Et puis dans vn baſteau nous irons promener,	Avoin seront sentement on petir déjenner, 4 Et puis dans un basteau nous irons promener,
CLARISTE.	CLARISTE.
mune.	mune.
SILINDE.	SILINDE.
Quand nous arriuera ceſte bonne fortune.	Quand nous arrivera cette bonne fortune.
Telle on la peut nommer, puis qu’elle n'eſt com* ----.	Telle on la peut nommer, puis qu'elle n'est com* --.
29	29
FLEVRIE.	FLEURIE.
Peut-eſtre dés demain, ſelon l’occaſion.	Peut-être dès demain, selon l'occasion.
CLARISTE.	CLARISTE.
La haſte apporteroit de la confuſion, Il vaut mieux retarder vn petit dauantage.	La hâte apporterait de la confusion, Il vaut mieux retarder un petit davantage.
FLEVRIE.	FLEURIE.
Quelqu’vn vient m'aborder, changeons noſtre langage.	Quelqu'H vient m'aborder, changeons notre langage.
OIEINDE.	ÔIEINDE.
Nous irons promener, il eſt tout reſolu.	Nous irons promener, il est tout résolu.
CEARISTE.	CEARISTE.
Urayment bien à propos vient Monſieur	OUraiment bien à propos vient Monsieur
MR KAROLV.	MR AROLU.
Karolu.	Karolu.
Ie ſuis de la partie, & veux que ſoit Dimãche Ie porte auec du vin vn bon paſté d’eſclanche.	Je suis de la partie, et veux que soit Dimanche Je porte avec du vin un bon pas d'éclanche.
Pour vn ſoul nous aurons vn carroſſe à courtaux, Qui n’a pour le mener ny cocher ny cheuaux, Mais là meſme & la Seine, & quelque petit voile, Conduit par vn cocher veſtu de groſſe toile.	Pour un soul nous aurons un carrosse à courtaux, Qui n'a pour le mener toujours cocher ni chevaux, Mais là même et la Seine, et quelque petit voile, Conduit par un cocher vêtu de grosse toile.
FLEVRIE.	FLEURIE.
I'apprehende bien fort la pluye auec le vent.	J'appréhende bien fort la pluie avec le vent.
.	.
·	
Mr KAROLV.	Mr AROLU.
an vejoin te thapronnons ferntroit dauuer,	an véjoin te thapronnons ferntrait dauver,
FLEVRIE.	FLEURIE.
He bien mocquez-vous, vous eſtes à voſtre	He bien moquez-vous, vous êtes à votre
Bnas Iaiſe!	Bnas Iaise!
Uous y ſerez auſſi pourueu que ie vous plaiſe	Uous y serez aussi pourvu que je vous plaise
FLEVRIE.	FLEURIE.
Ha!	Ha!
ne me raillez point, vous aueZ trop d’apPour n'eſtre pas aimé par vn ſujet ſi bas.	ne me raillez point, vous avez trop d'approur n'être pas aimé par un sujet si bas.
I pas Mae ebese	I pas Mae ébese
MR KAROLV.	MR AROLU.
Quoy?	Quoi?
vous ſouſpireZ	vous soupirez
FLEVRIE.	FLEURIE.
Puiſque mentaur ſouſpire.	Puisque mentaur soupire.
C’eſt vn ſigne certain qu'il n’a ce qu'il deſire,	C'est un signe certain qu'il n'a ce qu'il désire,
Mr KAROLV.	Mr AROLU.
Si vous me deſirez, ie ſuis du tout à vous:	Si vous me désirez, Seigneur suis du tout à vous:
FLEVRIE.	FLEURIE.
Filles entreZ dedãs, pour vn peu laiſſez-nous, Prenez place Monſieur, & cauſons vn quart d’heure.	Filles entrez dedans, pour un peu laissez-nous, Prenez place Monsieur, et causons un quart d'heure.
Mr KAROLV.	Mr AROLU.
Ie ne pouuois auoir de rencontre meilleure:	Je ne pouvais avoir de rencontre meilleure:
SCENE SECONDE.	SCÈNE SECONDE.
Mr HIEREMIE.	Mr HIEREMIE.
KAROLV.	VAROLV.
FLEVRIE.	FLEURIE.
Mr HIEREMIE.	Mr HIEREMIE.
Ouffriray-je vn riual piller ſur mes tal lons;	Ouffrirai-je un rival piller sur mes tal lons;
Quand ie penſe aduancer ie tombe à recullons, Ie butte mon espoir à poſſeder Fleurie;	Quand ici pense avancer ie tombe à recullons, Je butte mon espoir à posséder Fleurie;
Lors qu'vn autre la ſert ſans craindre ma fuHa!	Lors qu'un autre la sert sans craindre ma fuHa!
il faut que ſa mort ſatisface ma foy:	il faut que sa mort satisface ma foi:
Trie:	Trie:
Mais toubeau, parlons bas, ils ſont proche de moy, Ie les veux accoſter ſous vn autre viſage, Et par vn feint diſcours remacher mon courage:	Mais toubeau, parlons bas, ils sont proche de moi, Je les veux accoster sous un autre visage, Et par un feint discours remâcher mon courage:
Que quit icy tous ſeuls ces deun purfaits amans.	Que quit ici tous seuls ces de purfaits amants.
Mr KAROLV.	Mr AROLU.
Ils attendent l’honneur de vos commandentẽs,	Ils attendent l'honneur de vos commandents,
Mr HIEREMIE.	Mr HIEREMIE.
Vos eſprits ſont contans.	Vos esprits sont contants.
	
MR KAROLV.	MR AROLU.
Eoitons ny de, taſjaues:	Éaitons ici de, tasjaues:
FLEVRIE.	FLEURIE.
Nous nous entretenions du temps des barri Mr HIEREMIE cades.	Nous nous entretenions du temps des barri Mr HIEREMIE cades.
Aucun n'en peut parler de meſme comme moy:	Aucun n'en peut parler de même comme moi:
Our aixunentre en ce temps jevenon pour te Roy.	Our aixunentre en ce temps jevenon pour te Roi.
FLEVRIE.	FLEURIE.
AſſiſſeZ-vous donc la pour nous dire de grace Quel eſtrange mal-heur cauſa ceſte diſgrace.	Assissez-vous donc la pour nous dire de grâce Quel étrange malheur causa cette disgrâce.
Mr HIEREMIE.	Mr HIEREMIE.
La Religion ſeule apporta tous ces maux, Deux cõtraires partis cauſerent nos trauaux:	La Religion seule apporta tous ces maux, Deux commtraires partis causèrent nos travaux:
Le party Huguenot choque le Catholique;	Le parti Huguenot choque le Catholique;
Celuy-là des Papots reſiſte à l’heretique:	Celui-là des Papots résiste à l'hérétique:
Ainſi l’eau & le feu formerent des debats, Qui par plusdedix ans ont troublé nos Eſtats:	Ainsi l'eau et le feu formèrent des débats, Qui par plusdedix ans ont troublé nos États:
ar apres Henry trois, le grand Roy de Nauarre, Des Princes vertueux l’exemple le plus rare, Succedant à ſon ſceptre auſſi bien qu’à ces mœurs Esprouua des Ligueurs les mauuaiſes humeurs:	ar après Henri trois, le grand Roi de Navarre, Des Princes vertueux l'exemple le plus rare, Sucédant à son sceptre aussi bien qu'à ces mœurs Éprouva des Ligueurs les mauvaises humeurs:
Car venant à Paris on luy ferme la porte, Sous vn pretexte feint on le traite de ſorte, Qu'auecques ſon armee il eſt contraint en fin De reſouldre ſa force à la prendre par faim;	Car venant à Paris on lui ferme la porte, Sous un prétexte feint on le traite de sorte, Qu'avec son armée il est contraint en fin De résouldre sa force à la prendre par faim;
Il aſſiege ſes murs, ſa peine eſt inutile, Chacun veut eſtre maiſtre en ceſtegrãde ville, Chacun veut commander, chacun veut eſtre Iln y à ny raiſon, ny police, ny loy;	Il assiège ses murs, sa peine est inutile, Chacun veut être maître en cestegrãde ville, Chacun veut commander, chacun veut être Iln y à Madame raison, ni police, Seigneur lois;
Roy, Neantmoins à la fin leur esperance eſt vaine.	Roi, Néanmoins à la fin leur espérance est vaine.
M* KAROLV.	M* AROLV.
Il eſt vray qu’à l’inſtant que feu Monſieur dit EPFdine, Fut par le peuple eſleu Lieutenant General, Du quartier de la gréue on me fit caporal.	Il est vrai qu'à l'instant que feu Monsieur dit EPFdine, Fut par le peuple éleu Lieutenant Général, Du quartier de la gréue on me fit caporal.
Mr HIEREMIE.	Mr HIEREMIE.
De tontesnattons ie fcconrs onmanule.	De tontesnattons ici fonconrs onmanule.
Mais chacune à deſſein joüant ſa comedie Eſt contrainte à manger auec ceux de Paris, Des chiens, des chats, des rats, auetques des FLEVRIE.	Mais chacune à dessein joüant sa comédie Est contrainte à manger avec ceux de Paris, Des chiens, des chacune, des rats, auetques des FLEURIE.
ſouris.	souris.
O que de Lanſquenets, d’Eſpagnols & deSuiſ	Ô que de Lansquenets, d'Espagnols et deSuis
L es.	L es.
Regretoient l’alimẽt de leurs meres nourrices, Ils ne viuoient ſinon de raues & nauets, Qu'ils s’é alloiẽt cueillir la haut ſur ces marais Et ſi ie m'en ſouuiens le Capitaine Iacques Míe dõna vne miche aſſez proche dePaſques.	Regretaient l'aliment de leurs mères nourrices, Ils ne vivaient sinon de raves et navets, Qu'ils s'é allaient cueillir la haut sur ces marais Et si tu m'en souviens le Capitaine Jacques Me donna une miche assez proche dePasques.
Mr HIEREMIE.	Mr HIEREMIE.
Ouns donte que ce ſuſt ators queuenx paſteaux Paſſerent malgré nous à la faueur des eaux.	Ôuns donte que ce sût ators queuenx pasteaux Passèrent malgré nous à la faveur des eaux.
FLEVRIE.	FLEURIE.
Ce fut pluſtoſt le iour qu’on nõme des farines.	Ce fut plutôt le jour qu'on nomme des farines.
Mr HIEREMIE Les Seize & L’vnion cauſerent vos ruines:	Mr HIÈREMIE Les Seize et L'union causèrent vos ruines:
Car ſile peupie vny aux volontez du Roy Les euſt abandonnez ſous ce Zele de foIls n'euſſent ſubſiſté vne ſeule iournee.	Car síle peupie uni aux volontés du Roi Les eût abandonnés sous ce Zèle de foIls n'eussent subsisté une seule journée.
Mr KAROLV.	Mr AROLU.
Eu Gour de Ruriement eſunt emprifonnée, Le peuple eſtoit trop foible, & en trop de dã, gers, Pour penſer reſiſter au nombre d'eſtrangers.	Eu Gour de Ruriement éunt emprisonnée, Le peuple était trop faible, et en trop de donner, gers, Pour penser résister au nombre d'étrangers.
Mr HIEREMIE.	Mr HIEREMIE.
Sous le viſage faux d’vn maſque politique, haque ſeditieux ce diſoit Catholique, quieutonbmmamuupeuuvu peut ofter.	Sous le visage faux d'une masque politique, haque séditieux ce disait Catholique, quieutonbmmamuupeuuvu peut ôter.
FLEVRIE.	FLEURIE.
Voire, voire, vrayement vous m'en voulez conter, Ma foy l’on ne fit rien que ſelon l’Euangile Que les Predicateurs preſchoient en ceſte ville	Voire, voire, vraiment vous m'en voulez conter, Ma foi l'on ne fit rien que selon l'Euangile Que les Prédicateurs prêchaient en cette ville
Ml RIREREMIE.	Ml RIREREMIE.
Pauures esprits trompez.	Pauvres esprits trompez.
FLEVRIE.	FLEURIE.
Hole n'en parlons plus, ar nous en viendrions aux priſes là-deſſus.	Hole n'en parlons plus, ar nous en viendrions aux prises là-dessus.
M* HIEREMIE.	M* HIÈREMIE.
Si eſt-ce que pourtãt ien en ay point d’enuie:	Si est-ce que pourtant yen en ai point d'envie:
La Ligue pluſieurs fois ma preſque oſté la vie:	La Ligue plusieurs fois ma presque ôté la vie:
Dun comunt fonptennite puisy de mon Roy Les femmes de Paris ſe bandans contre moy M'euſſent défiguré:	Dun comunt fonptennite puisi de mon Roi Les femmes de Paris se bandans contre moi M'eussent défiguré:
mais par vne ſortie Pour éuiter debat ie quittois la partie.	mais par une sortie Pour éviter débat a quittois la partie.
FLEVRIE.	FLEURIE.
Tenez-vous aſſeuré que i'en ferois autant, Nous appeller ligueurs, l’affront eſt importãt, C’eſt tacher noſtre hõneur par vne calomnie, .	Tenez-vous assuré que j'en ferais autant, Nous appeler ligueurs, l'affront est important, C'est tacher notre honneur par une calomnie, .
Qui ne peut en effet eſtre par trop punie.	Qui ne peut en effet être par trop punie.
Mr HIEREMIE.	Mr HIEREMIE.
Si par la verité du diſcours commancé Voſtre eſprit maintenant ce trouue eſtre offencé, C'eſt vn ſigne certain qu'il en eſt quelque cho	Si par la vérité du discours commancé Votre esprit maintenant ce trouve être offensé, C'est un signe certain qu'il en est quelque cho
FLEVRIE.	FLEURIE.
Monſieur, taiſons-nous donc, voſtre diſcours Jucunje.	Monsieur, taisons-nous donc, votre discours Jucunje.
Que la colere icy m’empeſche de parler.	Que la colère ici m'empêche de parler.
Mr HIEREMIE.	Mr HIEREMIE.
Pluſtoſt que vous faſcher i'aime mieux m'en aller.	Plutôt que vous fâcher j'aime mieux m'en aller.
Mr KAROLV.	Mr AROLU.
Non, Monſieur, ne bougez.	Non, Monsieur, ne bougez.
Mr HIERRMIE.	Mr HIÈRMIE.
Madame eſt en colere.	Madame est en colère.
FLEVRIE.	FLEURIE.
Il eſt vray ie la ſuis, ie ne m'en ſçaurois taire.	Il est vrai assez la suis, ie ne m'en saurais taire.
Mr HIEREMIE.	Mr HIEREMIE.
Vous me pardonnerez, adieu iuſqu'au reuoir Penards, dans peu de temps vous verrez mon pouuoir.	Vous me pardonnerez, adieu jusqu'au revoir Pénards, dans peu de temps vous verrez mon pouvoir.
FLEVRIE.	FLEURIE.
eno ononue noonmu pun vnc escceuente ruſe,	en ononue noonmu pun Ahc escceuente ruse,
Mr KAROLV.	Mr AROLU.
Pour demeurer icy le galland n'a d’excuſe.	Pour demeurer ici le gallant n'a d'excuse.
FLEVRIE.	FLEURIE.
Il m'importunoit fort.	Il m'importunait fort.
a e O le peſant fardeau.	a e Ô le pesant fardeau.
Puis que nous voicy ſeuls, ſans tarder dauandomene funnamnjene dopre mumasee lase,	Puis que nous voici seuls, sans tarder davandomène funnamnjène dopre mumase lase,
PLEVRIE.	PLEURIE.
Ie l’ay bien ſouhaité au faux-bourg ſainct Mr KAROLV.	Je l'ai bien souhaité au faux-bourg saint Mr 4ROLU.
Marceau.	Marceau.
FLEVRIE.	FLEURIE.
Ie ne ſuis en cela que voſtre volonté.	Je ne suis en cela que votre volonté.
Mr KAROLV.	Mr AROLU.
Il faut premierement changer de qualité, Il faut que deſormais vous ſoyez Damoiſelle;	Il faut premièrement changer de qualité, Il faut que désormais vous soyez Damoiselle;
Mais parce que Madame à l’amphaſe plus belle Il vous faut appeller s’il vous ſemble à propos Madame Karolu, ou de la ſauſſe au ros, C’eſt vn bon fief que i'ay proche le Bourg-la	Mais parce que Madame à l'amphase plus belle Il vous faut appeler s'il vous semble à propos Madame Arolu, ou de la sauce au ros, C'est un bon fief que j'ai proche le Bourg-la
FLEVRIE.	FLEURIE.
Ha!	Ha!
vrayment bien ſouuent il faudra qu'on m'y meine, Soit pour faire vendange, on en autre faiſon.	vraiment bien souvent il faudra qu'on m'y mène, Soit pour faire venge, on en autre saison.
Mr KAROLV.	Mr AROLU.
Il faut qu’auſſi dans peu vous changiez de maiſon, Afin de l’eſloigner de cule cognoiſſance Q'onne pent frequenter ſans iſnet nonneur s'offence.	Il faut qu'aussi dans peu vous changiez de maison, Afin de l'éloigner de cule connaissance Qonne pent fréquenter sans isnet nonneur s'offense.
FLEVRIE.	FLEURIE.
Ie marcheray par tout où vous deſirerez, A tous vos bõs deſſeins les miens sõt meſurez, Ie ne ſçaurois faillir deſſous voſtre conduite.	Je marcherai par tout où vous désirerez, À tous vos bons desseins les miens sont mesurés, Je ne saurais faillir dessous votre conduite.
Mr KAROLV.	Mr AROLU.
Pourueu que ma raiſon dit la voſtre à ſa ſuitte:	Pourvu que ma raison dit la vôtre à sa suitte:
Ne nous amuſons point en diſcours ſuperflus.	Ne nous amusons point en discours superflus.
FLEVRIE.	FLEURIE.
Le temps ne permet pas que nous en faſſions plus.	Le temps ne permet pas que nous en fassions plus.
Mr KAROLV.	Mr AROLU.
Quand nous marirons-nous.	Quand nous marirons-nous.
FLEVRIE.	FLEURIE.
Oeſt vien uant res affaires	Oest vien uant rés affaires
MR KAROLV.	MR AROLU.
C'eſt auiourd’huy la findes iours Caniculaires Si vous le trouuez bon ce ſera pour demain.	C'est aujourd'hui la findes jours Caniculaires Si vous le trouvez bon ce sera pour demain.
FLEVRIE.	FLEURIE.
Le temps eſt par trop bref pour y mettre la mdiif, Il faut auparauant des habits à Fleurie.	Le temps est par trop bref pour y mettre la médiif, Il faut auparavant des habits à Fleurie.
Mr KAROLV.	Mr AROLU.
Nous trouuerons de tout dedans la fripperie, Pour trois ou quatre eſcus nous loüerons des atonts Qui nous pourront ſeruir pendant deux ou trois iours.	Nous trouverons de tout dedans la fripérie, Pour trois ou quatre écus nous louerons des atonts Qui nous pourront servir pendant deux ou trois jours.
FLEVRIE.	FLEURIE.
muounez bien raiſon:	muounez bien raison:
car pour mes trois fillettes Ie les habilleray comme des bauollettes;	car pour mes trois fillettes Je les habillerai comme des bavollettes;
Tandis que le tailleur nous fera des habits.	Tandis que le tailleur nous fera des habits.
Mr KAROLV.	Mr AROLU.
Uoila dõc qui vaut fait, prieZ tous vos amis, MetteZ bon ordre à tout, Adieu ma chere amante.	Voilà dõc qui vaut fait, prieZ tous vos amis, Mettez bon ordre à tout, Adieu ma chère amante.
FLEVRIE.	FLEURIE.
Adieu mon petit cœur, ie ſuis voſtre ſeruante.	Adieu mon petit cœur, ie suis votre servante.
Filles, filles, toſt, toſt, deuallez viſte en bas Pour ventr tnez les ſuifs, ne vous amuſeZ SILINDE.	Filles, filles, tôt, tôt, devallez vite en bas Pour ventr talés les suifs, ne vous amusez SILINDE.
pas.	pas.
L	L
En quel lieu dites-vous:	En quel lieu dites-vous:
FLEVRIE.	FLEURIE.
Droict à la Iuifuerie Au logis de Lambert ſous la tonnellerie:	Droit à la Juifuerie Au logis de Lambert sous la tonnellerie:
Marchons, ie vous diray le ſujet en allant, Riecauonne de coun dompuomneneseceſſente	Marchons, Seigneur vous dirai le sujet en allant, Riècavonne de coun dompuomnenesecessente
SCENE TROISIESME.	SCÈNE -TROISIÈME.
POLIANDRE.	POLYANDRE.
ROSELIS.	ROSELIS.
BELANGE.	BÉLANGE.
d0 POLIANDRE.	d0 POLYANDRE.
Auorables effets qui ſuiuez mes caprices, Que ie ſuis redeuable à tous vos bons offices.	Avorables effets qui suivez mes caprices, Que tu suis redevable à tous vos bons offices.
Depuis quatre ou cinq iours ie vois tous les plaiſirs Suiure les mouuemens de mes ieunes deſirs.	Depuis quatre ou cinq jours je vois tous les plaisirs Suivre les mouvements de mes jeunes désirs.
Il n'y a dans la Cour aucune Courtiſane;	Il n'y a dans la Cour aucune Courtisane;
Soit l’agreable Armille, ou la belle Diane, Qui pour gouſter le pasde mon doux entretien A celuy des plus grands ne prefere le mien.	Soit l'agréable Armille, ou la belle Diane, Qui pour goûter le pasde mon doux entretien À celui des plus grands ne préfère le mien.
I'ay par tout où ievais de nouuelles maiſtreſſes L’vne aime mes diſcours & l’autre mes careſes, Et pas vne pourtant ne ſe ſçauroit vanter D’auoir pu quatre iours mon esprit arreſtér.	J'ai par tout où ievais de nouvelles maîtresses L'une aime mes discours et l'autre mes cares, Et pas une pourtant ne se saurait vanter D'avoir pu quatre jours mon esprit arrêter.
Les beauteZ de la Cour me paroiſſent fardees Bien plus facilement ie reçois les idees D'vn viſage bourgeois & d’vn œil innocent, Que d’vn quidãs le cœur paſſe pour rauiſſant.	Les beautés de la Cour me paraissent fardes Bien plus facilement un reçois les idées D'un visage bourgeois et d'un œil innocent, Que d'vn quidans le cœur passe pour ravissant.
Le rouge me déplaiſt auſſi bien que le plaſtre, Poliandre iamais n'en peut-eſtre idolatre:	Le rouge me déplaît aussi bien que le plâtre, Poliandre jamais n'en peut-être idolâtre:
Et quelquesgrãds effets que l’amourfaſſevoir Pour vaincre mon eſprit il n'a pas le pouuoir:	Et quelquesgrãds effets que l'amourfassevoir Pour vaincre mon esprit il n'a pas le pouvoir:
Auſſi-toſt qu'amoureux ieveux la iouyſſance, Dés que le mal me tiẽt ie cherche l’allegeance;	Aussitôt qu'amoureux ieveux mal iouyssance, Dès que le mal me tiẽt ie cherche allégeance;
Et i’ay tant de bon-heur en mon affection Que ie faits à l’inſtant mourir ma paſſion.	Et j'ai tant de bonheur en mon affection Que tu faits à l'instant mourir ma passion.
Voyez ſi mõ plaiſir ne doit pas eſtre extreme;	Voyez si mon plaisir ne doit pas être extrême;
Roſelis que voicy n'en reçois pas de meſme.	Roselis que voici n'en reçois pas de même.
ROSELIS.	ROSELIS.
Monſieur, fort à propos ie vous rencõtre icy, Pour tirer mon eſprit d’vn penible ſoucy, Bellange ce matin ma depeſché ſon page, Pour mapprendre vn duel où ſon honneur langage, A marcher pour ſecond, ſans autre paſſion Il faut rompre ce coup par quelqu inuention.	Monsieur, fort à propos je vous rencontre ici, Pour tirer mon esprit d'un pénible souci, Bellange ce matin ma dépêché son page, Pour ma passion duel où son honneur langage, À marcher pour second, sans autre passion Il faut rompre ce coup par quelqu invention.
POLIANDRE.	POLYANDRE.
Reine, On m’en a dit vn mot auiourd’huy chez la Mais croyant qu'il fuſt faux ie negligeois ma peine:	Reine, On m'en a dit un mot aujourd'hui chez la Mais croyant qu'il fût faux ie négligeais ma peine:
vray, Toutesfois puis qu'en fin le bruit ce trouue Il y faut donner ordre & ſans plus de delay «EusJeis teui coliente.	vrai, Toutefois puis qu'en fin le bruit ce trouve Il y faut donner ordre et sans plus dé lay «EusJeis tui coliente.
ROSELIS.	ROSELIS.
D'vne ſeule arme eſgalle.	D'une seule arme égale.
POLIANDRE.	POLYANDRE.
En quel endroit ſera-ce.	En quel endroit sera-ce.
ROSELIS.	ROSELIS.
aa taplate Royate.	a tapplate Roiate.
POLIANDRE.	POLYANDRE.
Quels ſont les combatans.	Quels sont les combattants.
.	.
.	.
	
ROSELIS.	ROSELIS.
Floramante, Amindoi, Et le ieunt Muuman.	Flormante, Amindoi, Et le jeunt Muuman,
POLIANDRE.	POLYANDRE.
Mais à quelle heure encor.	Mais à quelle heure encor.
ROSELIS.	ROSELIS.
A cinq heures du ſoir ſans aucune remiſe.	À cinq heures du soir sans aucune remise.
POLIANDRE.	POLYANDRE.
Allõs, & ſoyeZ ſeur que ie romps l’entrepriſe.	Allons, et soyeZ sûr que sans romps l'entreprise.
SCENE QVATRIESME,	SCÈNE QUATRIÈME,
Mr HIEREMIE.	Mr HIEREMIE.
Eplorable ſoldat, Amant infortuné;	Éplorable soldat, Amant infortuné;
JMaudit dix mille fois le iour que tu fuſt ne, Ta langue ta trahy, ha pauure Hieremie!	JMaudit dix mille fois le jour que tu fût ne, Ta langue ta trahi, ha pauvre Hieremie!
Tu as donc à preſent ta maiſtreſſe ennemie;	Tu as donc à présent ta maîtresse ennemie;
Celle de qui depend ta joye & ton bon-heur Delaiſſe ton amour & s'arme de fureur:	Celle de qui dépend ta joie et ton bonheur Délaisse ton amour et s'arme de fureur:
LaLigue eſt vn ſujet qu'à ta flame on oppoſe:	LaLigue est un sujet qu'à ta flamme on oppose:
Karolu, Karolu, vous en eſtes, la cauſe.	Karolu, Karolu, vous en estes, la cause.
Mais ſoyez aſſeuré que des apres demain Nous nous verrons tous deux les armes à la miain.	Mais soyez assuré que des après demain Nous nous verrons tous deux les armes à la miain.
Ie ſçay qu'e viuemẽt vous pourſuiuez Fleurie Afin qu'auecques vous elle ſe remarie:	Je sais qu'e vivement vous poursuivez Fleurie Afin qu'avec vous elle se remarie:
Meſme que vous auiez diſpoſé ſon eſprit A me fairé donner mon congé par eſcrit.	Même que vous aviez disposé son esprit À me fairé donner mon congé par écrit.
Mais s’il ſe paſſe rien à mon deſaduantage, Uous verreZ ceque peut vn homme de courage.	Mais s'il se passe rien à mon désavantage, Uous verrez ceque peut un homme de courage.
pe *On ne me berne pas d’vne telle façon:	pe *On ne me berne pas d'une telle façon:
Et Karolu n'eſt pas aſſeZ mauuais garçon.	Et Arolu n'est pas assez mauvais garçon.
I'entends battre vn tambour, c’eſt vn regiment Suiſſe, Qui peut-eſtre auiourd’huy va faire l’exerdace 3.	J'entends battre un tambour, c'est un régiment Suisse, Qui peut-être aujourd'hui va faire l'exerdace 3.
Pour apprẽdre que c’eſt il faut que i'aille voir:	Pour apprendre que c'est il faut que j'aille voir:
SCENE QVATRTESME.	SCÈNE QUATRTESME.
BELANGE.	BÉLANGE.
HIEREMIE.	HIEREMIE.
POLIANDRE -- - -- ---- ROSELIS, –- ----- –-u	POLYANDRE -moi-là - -là- -- ROSELIS, - -- 
BELANGE.	BÉLANGE.
A Ciel, ie ſuis perdu, le Roy nous veut II auoir!	À Ciel, Seigneur suis perdu, le Roi nous veut II avoir!
Il y vient en perſonne, ou enuoye ſa garde:	Il y vient en personne, ou envoie sa garde:
Belange où fuiras-tu, tout chacun te regarde Nud teſte, & ſans manteau, tous tes gens t’ont quitté té:	Bélange où fuiras-tu, tout chacun te regarde Nud tête, et sans manteau, tous tes gens t'ont quitté té:
Surauon ton put tautrt aucun prix emporCe ſauue qui pourra, ie l’eſtimeray ſage.	Suravon ton put tautrt aucun prix emporCe sauve qui pourra, toujours l'estimerai sage.
M MIEREMIE.	M MIEREMIE.
Ie n’ay rien veu du tout.	Je n'ai rien vu du tout.
FLEVRIE.	FLEURIE.
Ie ſuis pris au paſſage, Ct oieat joidar attend pon me prendre aut Mr HIEREMIE.	Je suis pris au passage, Ct oieat joidar attend pon me prendre aut Mr HIERÈMIE.
collet.	collet.
Ha Monſieur qu'eſt-ce-cy!	Ha Monsieur qu'est-ce-cy!
SELANGE.	SÉLANGE.
Ie ſuis nud ſans vallet, Et au danger de voir ma fortune acheuee, Si par ton bon ſecours elle ne m'eſt ſauuee.	Je suis nu sans valet, Et au danger de voir ma fortune achève, Si par ton bon secours elle ne m'est sauvée.
Mr HIEREMIE.	Mr HIEREMIE.
Que faut-il que ie faſſe aller droict au tombeau.	Que faut-il que Seigneur fasse aller droit au tombeau.
BELANGE.	BÉLANGE.
Preſte-moy tu caſaque auecques ton chapeau, aſ duexjxuuen menone	Preste-moi tu casque avec ton chapeau, as duexjxuuen menone
M* HIEREMIE.	M* HIÈREMIE.
Ouy da, tres-volontiers, car i'ay ma bourguinotte Et mon bonnet de nuict attacheZ à mon dos, Qui pour vn tel ſujet viennent fort à propos.	Oui da, très-volontiers, car j'ai ma bourguinotte Et mon bonnet de nuit attachez à mon dos, Qui pour un tel sujet viennent fort à propos.
ROSELIS.	ROSELIS.
O mon Diek Rvontonr:	Ô mon Die Révontonr:
POLIANDRE.	POLYANDRE.
Belange ce déguiſe.	Bélange ce déguise.
RoOun dJ.	RoOun dJ.
Ne nous deſcouurons pas.	Ne nous découvrons pas.
DELANGE.	DELANGE.
Suir tout gardons la priſe:	Suir tout gardons la prise:
Mr HIEREMIE.	Mr HIEREMIE.
Ne marchez pas ſi fort.	Ne marchez pas si fort.
BELANGE.	BÉLANGE.
Sauuons-nous viſtement.	Sauvons-nous vitement.
MEY HIEREMIE.	MEY HIÈREMIE.
Ie le cognois de veuë;	Je le connais de vue;
& non pas autrement.	et non pas autrement.
L Que ſçay-ie maintenant, ſi ce n'eſt point vn drolle.	L Que sais-je maintenant, si ce n'est point un drolle.
Qui pour mieux m'attraper joüe ce plaiſant MTonſieur allons moins viſfe.	Qui pour mieux m'attraper joue ce plaisant MTonsieur allons moins visée.
Trolle.	Trolle.
BELANCE.	BÉLANCE.
Ha Meſſieurs ſuiuez-moy!	Ha Messieurs suivez-moi!
Vous ſçaurez à loiſir d’ou prouient mon efROSELIS.	Vous saurez à loisir d'ou prouient mon EfROSELIS.
roy.	roi.
I Toubeau frere, toubeau, pour vn moment arreſte.	I Toubeau frère, toubeau, pour un moment arrête.
BELANGE.	BÉLANGE.
nonton vonsmnumiſe unqito le pendc la feſte,	nonton vonsmnumise unqito le pendc la fête,
ROSELIS.	ROSELIS.
Non, mais t’oſter la peur dont ie te vois trãſi.	Non, mais t'ôter la peur dont votre te vois trans.
Mr HIEREMIE.	Mr HIEREMIE.
Ie neſçay pas à quoy doit aboutir cecy:	Je nesçai pas à quoi doit aboutir ceci:
Maisvoilades façõs qui ne me plaiſent guere:	Maisvoilades façõs qui ne me plaisent guère:
Ie crains que ma caſaque aillevoir la Fripiere	Je crains que ma casaque aillevoir la Fripière
POLIANDRE.	POLYANDRE.
Bellange, hé quoy?	Bellange, hé quoi?
la peur a gaigné voſtre cœur;	la peur a gagné votre cœur;
Ce n'eſt pas le moyẽ derdemeurer vainqueur.	Ce n'est pas le moyẽ derdemeurer vainqueur.
Or ſus, raſſeurez-vo), eteroyés qu'vne feinte Aux quatre combatans a cauſé ceſte crainte, Le tãbour n’a batu que pour l’amour de vous, Et comme auec dejſei de te ſaiſi de tons.	Or sus, rassurez-vo), éteroyez qu'une feinte Aux quatre combattants a causé cette crainte, Lé jour n'a battu que pour l'amour de vous, Et comme auec dejsei de te saisi de tons.
ROSELIS:	ROSELIS:
Puis que la feinte a eu l’effet que l’on deſire, Allons vous rabiller pour à loifir en rire.	Puis que la feinte a eu l'effet que l'on désire, Allons vous rabiller pour loisir en rire.
Ml TLIEREMTE.	Ml TLIÈREMTE.
Ie veux aller apres.	Je veux aller après.
BELANGE.	BÉLANGE.
Camarade ſuit-nous.	Camarade suit-nous.
M TIEREMIE.	M MIEREMIE.
te niey pas gurde tuſſdemm epoigner de vous.	te nie pas gurde tussdemm époigner de vous.
Fin du ſęçoupheteni	Fin du sęçoupheteni
DI 2 4 L F12 ld	DI 2 4 L F12 ld
ACIE III.	ACIE III.
KAROLV.	VAROLV.
LE' BATELIER.	LE BATELIER.
ILEVRIE.	ILEURIE.
SILINDE.	SILINDE.
CLARISTE.	CLARISTE.
FLORIANE.	FLORIANE.
POLIANDRE.	POLYANDRE.
ROSELIS.	ROSELIS.
BELANGE.	BÉLANGE.
MAISTRE HIEREMIE.	MAÎTRE HIÈREMIE.
D ii	 Di
Mr KAROLV.	Mr AROLU.
mtonocuinere mome paut vne promenade.	mtonocuinere môme paut une promenade.
TLEVRTE.	TLEURTE.
Filles n’oubliez-pas noſtre capilotade.	Filles n'oubliez-pas notre capilotade.
LE BATELIER.	LE BATELIER.
uamuvi,muuumor,muonu ou ſolchacun.	uamuvi,muuumor,muonu ou solchacun.
FLEVRIE.	FLEURIE.
uec ſon Nous ne deſirons pas eſtre auec le commun.	Tec son Nous ne désirons pas change nir le commun.
M RAROLV.	M MAROLV.
Nous voulons vn baſteau pour noſtre compagnie.	Nous voulons un basteau pour notre compagnie.
LE BATELIER.	LE BATELIER.
Monſieur en voila vn.	Monsieur en voilà un.
FLEVRIE.	FLEURIE.
ous, ſans teremonie, Entrons Monſieur Marron, rengeons-nous a ce coing.	ous, sans tremonie, Entrons Monsieur Marron, rengeons-nous a ce coing.
Iie d'	Jie d'
LE BATELEIR.	LE BATELEIR.
Auec les gens d’honneur ie ne marchande point;	Avec les gens d'honneur Ne ne marchande point;
Pour payer ma voiture en monnoyes gentilles Ie me contenterois d’vne de ces trois filles:	Pour payer ma voiture en monnoyes gentilles Je me contenterais d'une de ces trois filles:
Elles ont le tein vif & l’œil bien erraté.	Elles ont le tein if et l'œil bien erraté.
12Bara de.	12Bara de.
Urayment ce baſtelier n'eſt pas trop dégouſté.	Oraiment ce bastelier n'est pas trop dégoûté.
VLARTSTE.	VLARTSTE.
Il n'y a qu'à choiſir & prendre la plus belle.	Il n'y a qu'à choisir et prendre la plus belle.
LE BATELIER.	LE BATELIER.
Ne vous mocquez-vous point.	Ne vous moquez-vous point.
FLORIANE.	FLORIANE.
I'en dis autant comme elle.	J'en dis autant comme elle.
LE BATELIER.	LE BATELIER.
Ma mere l’autre iour fillant à ſon roüet, Me diſoit qu’vne fille auoit vn beau jouet, Et depuis ce temps-là i’ay vne frenaiſie Qui ne ſçauroit ſortirhors de ma fantaiſie;	Ma mère l'autre jour fillant à son rouet, Me disait qu'une fille avait un beau jouet, Et depuis ce temps-là j'ai une frénaisie Qui ne saurait sortirhors de ma fantaisie;
Ie ne dors nuict ny iour, ie me ſens tout emeu Sans que i'aye la fievre.	Je ne dors nuit ni jour, je me sens tout ému Sans que j'aie la fièvre.
FLEVRIE.	FLEURIE.
O le plaiſant camu.	Ô le plaisant camu.
Mr KAROLV.	Mr AROLU.
Il faut l’entretenir, il nous fera bien rire, Quand on eſt amoureux c’eſt vn cruel martyre, L'esprit inquieté ne prend point de repos, Et peu, l’occaſion ſe rencontre à propos Pour vous faire jouir de l’objet qu'on deſire.	Il faut l'entretenir, il nous fera bien rire, Quand on est amoureux c'est un cruel martyre, L'esprit inquiété ne prend point de repos, Et peu, l'occasion se rencontre à propos Pour vous faire jouir de l'objet qu'on désire.
LE BATELIER.	LE BATELIER.
Ie n'entends point pour tout ce que cous vouleZ dire.	Je n'entend point pour tout ce que cous voulez dire.
.	.
.	.
.	.
1.	1.
Mr KAROLV.	Mr AROLU.
N e Memmsiss seimes.	 Nées Eemmiss seimes.
Zuui)	Zuvi)
LE BATELIER.	LE BATELIER.
Ouy, i’aime bien l’argent?	Oui, j'aime bien l'argent?
M RAROEV.	M MAROUE.
O Dieux;	Ô Dieux;
que ton esprit eſt peu intelligent!	que ton esprit est peu intelligent!
Quand ie parle d’aimer c’eſt vne creature:	Quand ici parle d'aimer c'est une créature:
MDATEREAA.	MDATEREAA.
I'auois vn pétit chien de fort bonne nature Qui dãçoit, qui ſautoit, ie l’aimois cõme moy, Et quand il fuſt noyé ie pleurois, pãr ma foy	J'avais un pétit chien de fort bonne nature Qui dãçoit, qui sautait, toujours l'aimais cõme moi, Et quand il fût noyé était pleurais, pãr ma foi
FLEVRIE.	FLEURIE.
Tu ne respond pas bien à ce qu’on te demande.	Tu ne répond pas bien à ce qu'on te demande.
LE BATELIER.	LE BATELIER.
mupter pauondautcalueque uuvmende,	mupter pauondautalcueque uvende,
MR KAROLV.	MR AROLU.
La fille a des appas ſt doux & ſi charmans 2 Que qui ne l'aime point vid ſans contentemẽs.	La fille a des appas st doux et si charmants 2 Que qui ne l'aime point vit sans contentements.
A LE BATELIER.	À LE BATELIER.
La fille à voſtre contr eſt doncqu'vne ſorciere.	La fille à votre contr est doncqu'une sorcière.
Ie me ſouuiens d’vn teur que noſtre chãbriere Seule dans le logis me prenant au manton, M’euſt ie pẽſe eſtrãglé ſans vn coup de baſton Que ie luy deſchargeay bien ſerré ſur la teſte;	Je me souviens d'un teur que notre chãbriere Seule dans le logis me prenant au manton, M'eût iejours estrãglé sans un coup de bâton Que tu lui déchargeai bien serré sur la tête;
Qui fit qu'en s'entallant elle m'appella beſte, Lourdault, niais & ſot, que i'eſtois ſans amour,  quedcuueteiay de laa puesovueetomi.	Qui fit qu'en s'entallant elle m'appela bête, Lourdault, niais et sot, que j'étais sans amour, quedcuueteiay dé jà puesovueetomi.
FLEVRIE.	FLEURIE.
Vrayment c’eſtoit auſſi de trop rudes carreſſes	Vraiment c'était aussi de trop rudes carresses
STLINDE.	STLINDE.
De pareils.	De pareils.
ſeruiteurs n’auroient point de maiſtreſſes.	serviteurs n'auraient point de maîtresses.
3	3
CLARISTE.	CLARISTE.
Pour moy ie ſçay fort bien que ie n’en voudrois pas.	Pour moi ici sais fort bien que ici n'en voudrais pas.
LI	LI
FLORIANE.	FLORIANE.
13 u'eollmeeeſpipquuun tuuce vey pas.	13 u'eollmeeespipquuun tuuce vey pas.
FLEVRIE.	FLEURIE.
En deuiſant voyeZ en quel endroit nous ſom	En devisant voyeZ en quel endroit nous som
M* RAROLV.	M* RAROLU.
Imes.	Imes.
Amy, mets-nous abord, nous paſſons les Bonshommes.	Ami, mets-nous abord, nous passons les Bonshommes.
.	.
ILEVRIE.	ILEURIE.
Allons dedans le bois faire noſtre feſtin.	Allons dedans le bois faire notre festin.
GLARISTE.	GLARISTE.
Uien Batelier.	Uien Batelier.
LE.	LE.
BATELIER.	BATELIER.
I'y vais.	J'y vais.
SILINDE.	SILINDE.
Il eſt encor matin.	Il est encor matin.
SCENE SECONDE.	SCÈNE SECONDE.
ROSELIS.	ROSELIS.
POLIANDRE.	POLYANDRE.
BELANGE	BÉLANGE
ROSELIS.	ROSELIS.
Llons apres diſner à l’Hoſtel de Bourgongne.	Llons après dîner à l'Hôtel de Bourgongne.
POLIANDRE.	POLYANDRE.
Allons pluſtoſt au Cours dans le bois de Bou401187e.	Allons plutôt au Cours dans le bois de Bou40187e.
BRLANGE.	BRLANGE.
Ie croy que vaudroit mieux aller cheZ d’Humery Ioüer vn coup de dez, ou bien voir Mondory.	Je crois que vaudrait mieux aller chez d'Humeri Iouer un coup de dés, ou bien voir Mondori.
POLIANDRE.	POLYANDRE.
Pour eſtre renfermez la ſaiſon eſt trop belle, On void touſiours au Cours quelque Dame nouuelle;	Pour être renfermés la saison est trop belle, On voit tousiours au Cours quelque Dame nouvelle;
Ioint que la promenade en ce temps doux & 661620 Nous fait ſembler Paris eſtre vn triſte tombeau.	Joint que la promenade en ce temps doux et 661620 Nous fait sembler Paris être ; triste tombeau.
BELANGE.	BÉLANGE.
Dien donc, le Rendez-vons.	Diens donc, le Rendez-vons.
ROSELIS.	ROSELIS.
Deuant les Thuilleries.	Devant les Thuilleries.
POLIANDRE.	POLYANDRE.
Dans vne heure à cheual, i'y ſuis ſans railries.	Dans une heure à cheval, j'y suis sans railies.
MN KAROLV.	MN AROLU.
M’amour as-tu rien veu de plus delicieux Que la douceur de l’air & l’odeur de ces lieux!	M'amour as-tu rien vu de plus délicieux Que la douceur de l'air et l'odeur de ces lieux!
En verité ce bois eſt vn ſejour aimable, Un de ſes tapis vers nous ſeruira de table?	En vérité ce bois est un séjour aimable, Un de ses tapis vers nous servira de table?
ILEVRIE.	ILEURIE.
Choiſiſſons vn bocage ou le Soleil hauſſant Ne puiſſe nous y voir non plus que le paſſant.	Choisissons un bocage ou le Soleil haussant Ne puisse nous y voir non plus que le passant.
SHLINDE.	SHLINDE.
Apres auoir par tout fait exâcte reueuë.	Apres avoir par tout fait exâcte revue.
Tieuarepias utaa quiparroujt a ma vene.	Tieuarepias uta quiparrouit à ma vene.
Mr KAROLV.	Mr AROLU.
Arreſtons-nous y donc, & ſans confuſion Que l’on apporte icy noſtre prouiſion.	Arrêtons-nous y donc, et sans confusion Que l'on apporte ic y provision.
CLARISTE.	CLARISTE.
La faim commẽçoit fort à me faire la guërre.	La faim commençait fort à me faire la gurerre.
FLORIANE.	FLORIANE.
Voila noſtre gondolle à la place d’vn verre.	Voilà votre gondolle à la place d'H verre.
F LEVRIE.	F LEURIE.
La, Monſieur Karolu, entamez ce paſté, Il charme l’odorãt par ſa ſuauité.	La, Monsieur Arolu, entamés ce pâté, Il charme l'odorant par sa suavité.
MR KAROLV.	MR AROLU.
Il eſt encor meilleur quand la langue le gouſte, Lamoureux, n'a iamais fait de ſi bõne crouſte.	Il est encor meilleur quand la langue le goûte, Lamoureux, n'a jamais fait de si bien commette.
FLEVRIE.	FLEURIE.
Il eſt fort exteuent, ta mes filles taſtez, Ioüiſſez en ce lieu de toutes priuauteZ.	Il est fort extèvent, ta mes filles tâtez, Ioüissez en ce lieu de toutes privauté.
SILINDEO ma ſœur qu'il eſt bon!	SILINDEO ma sœur qu'il est bon!
CLARISTE.	CLARISTE.
Certes i’en ſuis rauie.	Certes j'en suis ravie.
FLORIANE.	FLORIANE.
Ie n'en ay point mange de meiſſeur en ma vie.	Je n'en ai point mange de meisseur en ma vie.
FLEVRIE.	FLEURIE.
Donnez au batelier.	Donnez au batelier.
*	*
KAROLV.	VAROLV.
damy-vuitts pour toy:	dami-vits pour toi:
Prenez Monſieur Marron, & puis voicy pour moy.	Prenez Monsieur Marron, et puis voici pour moi.
Comme on dit qu’il fait bon de peſcher en eau trouble, I'ay trouué dans le fonds vn morceau de grasdouble, Qui vaut en verité autant qu'vn perdreau.	Comme on dit qu'il fait bon de pêcher en eau trouble, J'ai trouvé dans le fonds un morceau de grâdouble, Qui vaut en vérité autant qu'un perdreau.
22 V AS Nous auons apporté du vin auec de l’eau:	22 V AS Nous avons apporté du vin auec de l'eau:
MRKAROLV.	MRAROLU.
Orſus, beuuons vn coup, & ſi l’on me veux croire Nous chanterons apres vn petit air à boire.	Orsus, buons un coup, et si l'on me veux croire Nous chanterons après un petit air à boire.
FLEVRIE.	FLEURIE.
La muſique eſt compiete en Moſieul Rarolu:	La musique est compiète en Mosieul Rarolu:
CLARISTE.	CLARISTE.
Chantons les Perroquets, ou bien li Canturlu.	Chantons les Perroquets, ou bien li Centurlu.
MR KAROLV.	MR AROLU.
Touſiours vn air nouueau charme mieux les oreilles.	Toujours un air nouveau charme mieux les oreilles.
LE BATELIER.	LE BATELIER.
EſcouteZ donc le mien, ie chante des merueilles.	Écoutez donc le mien, on chante des merveilles.
C’eſt vne folle vanité Que d’eſtimer l’antiquité, Car les murs de Babilone Ne ſont plus veus de perſonne.	C'est une folle vanité Que d'estimer l'antiquité, Car les murs de Babilone Ne sont plus us de personne.
Le grand Colloſſe de Rhodes Eſt cheu dans les antipodes.	Le grand Collosse de Rhodes Est cheu dans les antipodes.
Ce beau Temble de Diane, N'eſt plus rien qu'vne cabane.	Ce beau Temble de Diane, N'est plus rien qu'une cabane.
Du Pharre la renommee A mis ſa gloire en fumee.	Du Pharre la renommée A mis sa gloire en fumée.
Et ces grandes Piramides Ne ſont que des places vuides.	Et ces grandes Pamides Ne sont que des places vides.
Le ſimulacre Olympique N'eſt qu'vne triſte relique.	Le simulacre Olympique N'est qu'une triste relique.
Et ce riche Mauſolee N'eſt plus qu'vne vieille allee.	Et ce riche Mausolée N'est plus qu'une vieille allée.
Mais le vin & les bouteillés Ce ſont bien d’autres merueilles.	Mais le vin et les bouteillés Ce sont bien d'autres merveilles.
Hé bien, qu’en dites-vous, i’aurois fort bonne voix	Hé bien, qu'en dites-vous, j'aurais fort bonne voix
MRKAROEV.	MRAROEU.
Tõ air n’eſtpas mauuais:	Tendre air n'estpas mauvais:
mais eſcoute le noſtre Et puis tu iugeras qu'il en vaut bien vn autre.	mais écoute le vôtre Et puis tu jugeras qu'il en vaut bien un autre.
AIN;	AIN;
Rire & chanter touſiours C’eſt vne choſe aimable:	Rire et chanter toujours C'est une chose aimable:
Mais tréue de diſcours Lors que l’on eſt à table:	Mais trêve de discours Lors que l'on est à table:
Car ces plaiſirs de vent Ne me font point d’enuié;	Car ces plaisirs de vent Ne me font point d'envié;
Boire & manger ſouuent C eſt bien paſſer ſa vie.	Boire et manger souvent Ç est bien passer sa vie.
La Muſique eſt vn bien Qui vainement me touche;	La Musique est un bien Qui vainement me touche;
Sinon quand ie n’ay rien Pour mettre dans ma bouche.	Sinon quand ici n'ai rien Pour mettre dans ma bouche.
Le ſon d’vn inſtrument, Le recit d’vne hiſtoire Me plaiſent rarement Si ce n'eſt apres boire.	Le son d'être instrument, Le récit d'une histoire Me plaisent rarement Si ce n'est après boire.
Tous les jeux où l’on voy Que l’eſprit ce reueille, Ne gaignent rien ſur moy Quand ie tiens la bouteille.	Tous les jeux où l'on voy Que l'esprit ce réveille, Ne gagnent rien sur moi Quand quelque tiens la bouteille.
Mon diuertiſſement Deſpend de ceſte belle, Ic jhis fans montement Eſtant eſloigne d’elle.	Mon divertissement Despend de cette belle, Ic his fans montement Étant éloigne d'elle.
POLIANDRE.	POLYANDRE.
Page, tiens nos cheuaux à la porte du bois.	Page, tiens nos chevaux à la porte du bois.
BELANGE.	BÉLANGE.
Tentends proche de nous vn doux concert de	Tentends proche de nous un doux concert de
ROSELIS.	ROSELIS.
Tvoix.	Toix.
O Dieux ie ſuis rauy, l’excellente Muſique!	Ô Dieux ie suis ravi, l'excellente Musique!
mies	mies
POLIANDRE.	POLYANDRE.
On ta peut a von aroict appeuer Angelique, Mon oreille iamais n'a rien oy de plus doux?	On ta peut à von arais appeuer Angélique, Mon oreille jamais n'a rien oi de plus doux?
BELANGE.	BÉLANGE.
Pour les enuiſager doucement coullons-nous?	Pour les envisager doucement coullons-nous?
ROSELIS.	ROSELIS.
Idance:	Idance:
Allons les accoſter auant que l’on commance.	Allons les accoster avant que l'on commance.
	
FLEVRIE.	FLEURIE.
C’eſt aſſez de Muſique, il faut que chacun	C'est assez de Musique, il faut que chacun
2-	2-
POLIANDRE.	POLYANDRE.
Iseiim tie cenveumnez onutmemes jentimens,	Iseiim tye cenveumnez onutmemes jentiments,
BELANGE.	BÉLANGE.
Mon ame à leur aſpect n’a plus de mouuemẽs.	Mon âme à leur aspect n'a plus de mouvements.
Ie croy que ſous l’habit de ces trois bauollettes Acons ooyons de lu Gonttes Mames plus parfaites.	Je crois que sous l'habit de ces trois bavollettes Acons ooyons de lu Gontes Mames plus parfaites.
ROSELIS.	ROSELIS.
Par ce deguiſement quelque deſſein caché Nous ſera deſcouuert.	Par ce déguisement quelque dessein caché Nous sera découvert.
POLIANDRE.	POLYANDRE.
Ie fuis vien empeſché A former vn ſujet pour faire ma harangue, Mercure aſſiſte-moy de ta diuine langue.	Je fuis vien empêché A former un sujet pour faire ma harangue, Mercure assiste-moi de ta divine langue.
FLEVRIE.	FLEURIE.
Batelier viſtement, allez, retirez-vous, Il n'eſt pas de beſoin qu'on vous voye auec nous.	Batelier vite, allez, retirez-vous, Il n'est pas de besoin qu'on vous voie avec nous.
LE BATELIER.	LE BATELIER.
N'arreſtez-pas long-temps depeur qu’il ne SILINDE.	N'arrêtez-pas longtemps dépeur qu'il ne SILINDE.
m'ennuye.	m'ennuie.
Voicy des Caualliers.	Voici des Cavaliers.
LE BATELIER SORTANT.	LE BATELIER SORTANT.
Nuns aurons ue la pluye:	Nuns aurons ue la pluie:
POLIANDRE.	POLYANDRE.
Meſſieurs excuſeZ-nous ſi l’importunité Nous faiſant oublier noſtre ciuilité, Force nos actions à paroiſtre inſolentes, Uenans troubler l’accord de vos voix excellentes.	Messieurs excuse-nous si l'importunité Nous faisant oublier notre civilité, Force nos actions à paraître insolentes, Uenants troubler l'accord de vos voix excellentes.
Mais les rares beauteZ que nous voyons icy, La bonne compagnie, & la muſique auſſi Tirẽt nos pas vers vous ſans autres artifices;	Mais les rares beautés que nous voyons ici, La bonne compagnie, et la musique aussi Tirenêt nos pas vers vous sans autres artifices;
Sinon pour offrir nos tres-hûmbles ſeruices.	Sinon pour offrir nos très-hûmbles services.
Mr KAROLV.	Mr AROLU.
Nous vous auõs, Meſſieurs, trop d’obligatiõ:	Nous vous avons, Messieurs, trop d'obligation:
Mais vous venez trop tart pour la collation;	Mais vous venez trop tart pour la collation;
Il falloit vous haſter vn petit dauantage, Pour gouſter d’vn paſté, & d'vn rare breuuaQue l’on auoit expres apporté en ces lieux.	Il fallait vous hâter un petit davantage, Pour goûter d'un pasté, et d'un rare breuaQue l'on avait exprès apporté en ces lieux.
re 10	re 10
FLEVRIE.	FLEURIE.
Filles diſcretement, gardez le ſerieux, Uoila trois Caualiers de gentille apparence.	Filles discrètement, gardez le sérieux, Uoilà trois Cavaliers de gentille apparence.
ROSELIS.	ROSELIS.
Idance.	Idance.
Sus, nous ne venons pas pour troubler voſtre Continuez, ou bien nous rebrouſſons chemin.	Sus, nous ne venons pas pour troubler votre Continuez, ou bien nous rebroussons chemin.
M* KAROLV.	M* AROLV.
Com danterez auſſe;	Com danterez aussi;
FLEVRIE.	FLEURIE.
Meſſieurs prenez la main, Et pour vous mettre en train ie tray la pre	Messieurs prenez la main, Et pour vous mettre en train mot trai la pré
POLIANDRE.	POLYANDRE.
Imiere.	Imière.
Et moy ie vous promets de dire la derniere.	Et moi ici vous promets de dire la dernière.
Chanſon de Fleurie.	Chanson de Fleurie.
I'ay bien le meilleur homme Qui ſoit dedans Paris, En tous lieux il me nomme Sa gentille Cloris.	J'ai bien le meilleur homme Qui soit dedans Paris, En tous lieux il me nomme Sa gentille Cloris.
Nous piſſons dans meſme pot, Acons nous purjons a xogo, Mous chantons tan-tire-li-ra-lire Sans iamtais nous dire mot.	Nous pissons dans même pot, Acons nous purions à xogo, Mous chantons tan-tire-li-lire Sans jamtais nous dire mot.
Touſiours l’vn contre l’autre L’on void nos deux mantons, Et ſouuent il ſe veautre Deſſus mes blancs tetons.	Toujours l'un contre l'autre L'on voit nos deux mantons, Et souvent il se veautre Dessus mes blancs tétons.
Nous piſſons, &c.	Nous pissons, etc.
Tout le meſnage il range Le ſoir & le matin, Et ſi ne boid ne mange Que quand ie n'ay plus faim.	Tout le ménage il range Le soir et le matin, Et si ne boyd ne mange Que quand quelque n'ai plus faim.
Nous piſſons, &c.	Nous pissons, etc.
Il deſcrote mes chauſſes, Ma cotte & mon pliſſon, Et fait de bonnes ſauſſes Tant a chair qu'a poiſſon.	Il descrote mes chausses, Ma cotte et mon plisson, Et fait de bonnes sausses Tant à chair qu'a poisson.
Nous piſſons, &c.	Nous pissons, etc.
BELANGE.	BÉLANGE.
Mcaceuente mnanſon, que cuir eſ raniſſant.	Mcacvente mnants, que cuir es ranissant.
Mr KAROLV.	Mr AROLU.
Voila comme l’on prend vn plaiſir innocent.	Voilà comme l'on prend un plaisir innocent.
FLEVRIE.	FLEURIE.
Ne vous en moquez-pas, Clariſte dit la tiẽne Ellevaut pour le moins autãt cõme la mienne.	Ne vous en moquez-pas, Clariste dit la tienne Elle pour le moins autãt cõme la mienne.
CLARISTE.	CLARISTE.
Un rhume quelque peu m'empeſche de chanter, Et ſi ie vous la dis c'eſt pour vous contenter.	Un rhume quelque peu m'empêche de chanter, Et si tu vous la dis c'est pour vous contenter.
Chanſon de Clarfte.	Chanson de Clarfte.
Que ſert de me prier de vous aimer Siluie, Mon ame en verité n'en euſt iamais d’enuie:	Que sert de me prier de vous aimer Silvie, Mon âme en vérité n'en eût jamais d'envie:
Ie ſçay bien que vos yeux ont de charmans appas, (me pas.	Je sais bien que vos yeux ont de charmants appas, (me pas.
Mais ſur tout vous aimez, & moy ie n’aiA quoy ſeruẽt ces pleurs alorsque l’õ me baiſeC’eſt ietter beaucoup d’eau deſſus vn peude braiſe.	Mais sur tout vous aimez, et moi -même n'ai quoi servent ces pleurs alorsque l'on me baiseC'est jeter beaucoup d'eau dessus un peude braise.
Ie ſçay bien que vos yeux ont de charmãs appas;	Je sais bien que vos yeux ont de charmants appas;
me pas.	me pas.
Mais ſut toutvous aimez, & moy ie n'aiA quoy bon ces ſouſpirs qui ſortent de voſtre ame, C’eſt du vent qui d’amour veut eſteindre ma flame:	Mais sut toutvous aimés, et moi je n'aiA quoi bon ces soupirs qui sortent de votre âme, C'est du vent qui d'amour veut éteindre ma flamme:
appas.	appas.
u cuvo eux ont de charmãs Mais ſur tout vous aimeZ, & moy ie n'ai	u cuvo eux ont de charmands Mais sur tout vous aimés, et moi ici n'ai
pas.	pas.
ROSELIS.	ROSELIS.
Dieux la bonne chanſon.	Dieux la bonne chanson.
POLIANDRE.	POLYANDRE.
Ie confeſſe à ceſte heure   uu demelleure.	Je confesse à cette heure u demelleure.
BELANGE.	BÉLANGE.
Ces Dumes que voncy nen uront cues pas.	Ces Dumes que vonci nen uront cues pas.
FLEVRIE.	FLEURIE.
pas;	pas;
Le temps nous preſſe trop, il faut doubler le Dites viſte la voſtre, & puis dans le carroſſe, Nous allons remonter pour eſtre d'vne nopce, Où nous ſommes ce ſoir obligez d’aſſiſter.	Le temps nous presse trop, il faut doubler le Dites vite la vôtre, et puis dans le carrosse, Nous allons remonter pour être d'une nopce, Où nous sommes ce soir obligez d'assister.
LOLIANDNL.	LOLIANDNL.
Or ſus, pour obeir ie vais doncques chanter.	Or sus, pour obéir ainsi vais donc chanter.
Chanſon de Poliandre.	Chanson de Poliandre.
Les loix que l’amour nous donne Ont de ſi charmans appas, Que qui ne les gouſte pas Ne doit iamais voir perſonne:	Les lois que l'amour nous donne Ont de si charmants appas, Que qui ne les goûte pas Ne doit jamais voir personne:
Pour obeir à Tamour Que chacun baiſe à ſon tour.	Pour obéir à Tamour Que chacun baise à son tour.
eſte ordonnance eſt ſi belle Que l’amant n'eſt pas courtois Qui ne le ſuit qu’vne fois Eſtant aupres ſa fidelle:	este ordonnance est si belle Que l'amant n'est pas courtois Qui ne le suit qu'une fois Étant auprès sa fidèle:
Pour obeir, &c.	Pour obéir, etc.
E iiij C’eſt contre luy faire vn crime, Puis que ce Dieu des Amans Veut qu'on baiſe a tous momens Pour ſon nom mettre en eſtime:	E jijà Çest contre lui même un crime, Puis que ce Dieu des Amants Veut qu'on baise a toujours moments Pour son nom mettre en estime:
Pour obeir, &c.	Pour obéir, etc.
FLEVRIE.	FLEURIE.
O ma fille, apres luy il a tiré l’eſchelle!	Ô ma fille, après avoir il a tiré l'échelle!
La tienne maintenant ne me ſemble plus belle.	La tienne maintenant ne me semble plus belle.
S il eſt auſſi courtois qu'il eſt prompt à haiſer, Autant de ſa chanſon il ne peut refuſer.	S il est aussi courtois qu'il est prompt à haiser, Autant de sa chanson il ne peut refuser.
POLIANDRE.	POLYANDRE.
Ceſte obligation me ſemble trop petite R oki jeinii deeIuſets deſt rart memte;	Cette obligation me semble trop petite R oki jeini deeIuss dest rart memte;
MR KAROLV.	MR AROLU.
C’eſt aſſeZ pour ce coup.	C'est assez pour ce coup.
POLIANDRE.	POLYANDRE.
Dites donc s’il vous plaiſt, Où eſt voſtre logis.	Dites donc s'il vous plaît, Où est votre logis.
MRKAROLV.	MRAROLU.
A oilen di imreſ, Demandez Karolu, c’eſt ainſi qu'on me nõme, On vous l’enſtignera.	À elle est imres, Demandez Élarolu, c'est ainsi qu'on me nomme, On vous l'enstignera.
ROSELIS.	ROSELIS.
Vous eſtes vn braue homme, Nous ne manquerons pas de nous donner l'honneur D’aller vous viſiter deſſous ceſte faueur;	Vous êtes un brave homme, Nous ne manquerons pas de nous donner l'honneur D'aller vous visiter dessous cette faveur;
Cependant permettez que noſtre main vous dalaulen Iuſqu'à voſtre carroſſe.	Cependant permettez que notre main vous dalaulen Jusqu'à votre carrosse.
FLEVRIE.	FLEURIE.
Ha!	Ha!
ſeroit trop de peine.	serait trop de peine.
Bien qu’vn meſchant habit nous couure par effet, nous fait;	Bien qu'un méchant habit nous couvre par effet, nous fait;
Nous n'abuſerons-pas de l’honneur qu’on ncemenne uonenty uuetunes voſtre ſuile,	Nous n'abuserons-pas de l'honneur qu'on nécemenne uonenti uuetunes votre suile,
POLIANDRE.	POLYANDRE.
Ie baiſer ay ſes mains auant que ie les quitte.	Je baiser ai ses mains avant que ici les quitte.
SILINDE.	SILINDE.
Monſieur laiſſeZ-cela, vous vous incõmodez.	Monsieur laissez-cela, vous vous incõmodez.
POLIANDRE.	POLYANDRE.
Ie le veux, puis qu’ainſi vous me le cõmandeZ	Je le veux, puis qu'ainsi vous me le commandez
ROSELIS.	ROSELIS.
Madame, obligez-moy, cependant noſtre abſence D’auoir de Roſelis quelquesfois ſouuenance.	Madame, obligez-moi, cependant notre absence D'avoir de Roselis quelquefois souvenance.
CLARISTE.	CLARISTE.
Si ie vous puis ſeruir, par ce doux ſouuenir Croyez qu'il me viendra ſouuent entretenir.	Si ici vous puis servir, par ce doux souvenir Croyez qu'il me viendra souvent entretenir.
BELANGE.	BÉLANGE.
Madame, abſent de vous, Belange ne peut viure, ſuiure.	Madame, absent de vous, Bélange ne peut vivre, suivre.
Dit von, quiite de cait presprit oous veux Bref, ſon bien ne dépend que de voſtre amitié.	Dit von, quiite de cait presprit oous veux Bref, son bien ne dépend que de votre amitié.
FLORIANE.	FLORIANE.
Peut-eſtre quelque iour en auray-je pitié.	Peut-être quelque jour en aurai-je pitié.
FLEVRIE.	FLEURIE.
DDJOIn, Aneſca, 3conj;	DDJOIn, Anéca, 3conj;
FLORIANE.	FLORIANE.
I'ay des cartes ma mere.	J'ai des cartes ma mère.
FLEVRIE.	FLEURIE.
Tant mieux, dans le haſtedu, c’eſt pour joüer Toutesfois il fait beau.	Tant mieux, dans le hâtedu, c'est pour jouer Toutefois il fait beau.
vn here.	un hère.
Mr KAROLV.	Mr AROLU.
Il ne faut craindre rien.	Il ne faut craindre rien.
FLEVRIE.	FLEURIE.
D’icy iuſqu’à Paris ie marcheray fort bien, Allons y doucement, c’eſt autant d’exercice.	D'ici jusqu'à Paris Seigneur marcherai fort bien, Allons y doucement, c'est autant d'exercice.
Mr KAROLV.	Mr AROLU.
Si ie me laſſe auſſi à voſtre prejudice, Lay ple peut que te ſouc iene coutnc auec vous	Si personne me lasse aussi à votre préjudice, Lai ple peut que te souc ène coutnc avec vous
FLEVRIE.	FLEURIE.
Allons, allons cauſeur, ne faites pas le fous.	Allons, allons causeur, ne faites pas le fous.
MR KAROLV.	MR AROLU.
Et noſtre baſtelier on payra de la ſorte.	Et notre bastelier on paiera de la sorte.
FLEVRIE.	FLEURIE.
Ec vonantoſient Mlartontoge torre ſa porté, Il nous obligera de luy porter l’argent.	Éc vonantosient Mlartontoge torre sa porté, Il nous obligera de lui porter l'argent.
Mr KAROLV.	Mr AROLU.
Allons, ie ne crains pas qu’il m'enuoye vn Sergent:	Allons, Seigneur ne crains pas qu'il m'envoie un Sergent:
Idre.	Idre.
Mais le pauure garçon aura beau nous attenIl croira qu'on aura ſon gouſté voulu vendre.	Mais le pauvre garçon aura beau nous attenI croira qu'on aura son goûté voulu vendre.
SCENE QVATRIESME.	SCÈNE QUATRIÈME.
LE BATELIER.	LE BATELIER.
Ncore que le iour commnemte iructuner, Ie ne vois point mes gens deuers moy cheminer;	Ncore que le jour commnemte iructuner, Je ne vois point mes gens devers moi cheminer;
Ils n’apprehendẽt point de mauuaiſe fortune:	Ils n'apprehendẽt point de mauvaise fortune:
S’ils s’en eſtoient allez que i'en aurois bien d’vne, Ie ſerois bien payé de ma peine auiourd’huy, Iamais ie ne mettrois ma ſiance en autruy, Touſiours argent contant auãt que ie démare.	S'ils s'en étaient allés que j'en aurais bien d'une, Je serais bien payé de ma peine aujourd'hui, Jamais personne ne mettrais ma siance en autrui, Toujours argent contant avant que sans démare.
Le monde maintenant me ſemble bien auare, pour auoir beu deux coups, mangeant des reliquas, Deux teſtons bien contez payerõt mon repas.	Le monde maintenant me semble bien avare, pour avoir bu deux coups, mangeant des reliquas, Deux testons bien comptez payero mon se.
C’eſt vendre vn petit cher vne telle denree:	C'est vendre un petit cher une telle denrée:
La campagne n'eſt plus du Soleil eſclairee, Il s’en va toute nuict, ha ie ſuis attrapé!	La campagne n'est plus du Soleil éclairee, Il s'en va toute nuit, ha a suis attrapé!
Ils ont heureuſement de mes mains eſchapé.	Ils ont heureusement de mes mains échappé.
Que l’on void de meſchans dans le temps où nous ſommes, Il me faut mon baſteau remener aux Bonshommes:	Que l'on voit de méchants dans le temps où nous sommes, Il me faut mon basteau remener aux Bonshommes:
Peut-eſtre en m'en allant trouueray-je quelqu’vn, A Paris, à Paris, allons vn ſol chacun.	Peut-être en m'en allant trouverai-je quelqu'un, À Paris, à Paris, allons un sol chacun.
SCENE QVATRIESME.	SCÈNE QUATRIÈME.
BELANGE.	BÉLANGE.
POLIANDRE.	POLYANDRE.
ROSELIS.	ROSELIS.
BELANGE.	BÉLANGE.
E me le celeZ plus.	E me le celeZ plus.
POLIANDRE.	POLYANDRE.
Ie confeſſe Bellange Que ie ſens dans mon ame vn mouuement eſtrange;	Je confesse Bellange Que ainsi sens dans mon âme un mouvement étrange;
ſirs L'amour iuſqu’auiourd’huy cedant à mes deN’a pas eu le pouuoir de troubler mes plaiſirs.	sirs L'amour jusqu'aujourd'hui cédant à mes deN'a pas eu le pouvoir de troubler mes plaisirs.
Mais depuis que Silinde a fait voir ſon viſage Auſſi beau qu’vn Soleil au ſortir d’vn nuage, La glace que mon cœur conſeruoit là dedans A perdu ſa froideur par diuers accidens.	Mais depuis que Silinde a fait voir son visage Aussi beau qu'un Soleil au sortir d'un nuage, La glace que mon cœur conservait là dedans À perdu sa froideur par divers accidents.
Mes deux yeux ont porté la chaleur dans mon ame, Ses belles actions ont allumé la flame, Mon esprit s’eſt flaté d'vn vain contentemẽt, Et l'espoir a charmé mon diuertiſſement.	Mes deux yeux ont porté la chaleur dans mon âme, Ses belles actions ont allumé la flamme, Mon esprit s'est flatté d'un vain contentement, Et l'espoir a charmé mon divertissement.
Mais puis que ievous dis mõ ſecretveritable;	Mais puisque ici vous dis mo secretveritable;
De me dire le voſtre il eſt bien raiſonnable.	De me dire le vôtre il est bien raisonnable.
Confeſſez librement que Floriane auſſi A mis dans voſtre esprit vn ſemblable ſouçy, Et Roſelis apres aduoüra que Clariſte, Luy a fait oublier ſa bergere Floriſte:	Confessez librement que Florisane aussi A mis dans votre esprit un semblable souçi, Et Rosis après aduoüra que Clariste, Lui a fait oublier sa bergère Floriste:
BELANGE.	BÉLANGE.
De quoy me ſeruiroit de vous diſſimuler, Mes yeux trop clairement vous l’ont dit ſans parler.	De quoi me servirait de vous dissimuler, Mes yeux trop clairement vous l'ont dit sans parler.
I’aduoüe franchement que iamais nulle Dame N'a tant qu'elle gaigné de pouuoir ſur mon âme:	J'avoue franchement que jamais nulle Dame N'a tant qu'elle gagné de pouuoir sur mon âme:
Et puis que ie la vois ſortable à mon humeur, Ie deſire l’auoir par les degrez d’honneur.	Et puis que ici la vois sortable à mon humeur, Je désire l'avoir par les degré d'honneur.
ROSELIS.	ROSELIS.
Vne ſimple Bergere eſt plus qu'vne Princeſſe Alors que la vertu s'eſt jointe à ſa baſſeſſe, Auſſi ma qualité qui flate mes eſprits Par l’espoir d’espouſer vne Dame de prix, Portoit mon iugement à quelque repugnance, Contre le plus bel œil qui ſoit dedãs la Frãce.	Une simple Bergère est plus qu'une Princesse Alors que la vertu s'est jointe à sa bassesse, Aussi ma qualité qui flate mes esprits Par l'espoir d'épouser une Dame de prix, Portait mon jugement à quelque répugnance, Contre le plus bel œil qui soit dédans la France.
Clariſte c’eſt le tien, dont l’extreme beauté Triomphe maintenant deſſus la vanité:	Clariste c'est le tien, dont l'extrême beauté Triomphe maintenant dessus la vanité:
Toutes tes actions luy ſont de durs martyres:	Toutes tes actions lui sont de durs martyres:
Elle void tes vertus au deſſus des Empires, Elle void dans tes feux les ſiens enſeuelis:	Elle voit tes vertus au dessus des Empires, Elle voit dans tes feux les siens ensevelis:
Bref, elle ne tient plus le cœur de Roſelis.	Bref, elle ne tient plus le cœur de Roselis.
Eſtrange effet d’amour, admirable rencontre.	Étrange effet d'amour, admirable rencontre.
BELANGE.	BÉLANGE.
Pourueu qu’à nos deſſeins fauorable il ſe monſtre, Et que nos chers objects bruſlent de meſmes feux, Il aura fait ce iour ſix parfaits amoureux.	Pourvu qu'à nos desseins favorable il se montre, Et que nos chers objects brûlent de mêmes feux, Il aura fait ce jour six parfaits amoureux.
IOLIAIADND.	JOLIAIADND.
Aduiſons entre nous au moyen ſalutaire Qu'il faut pour ſagement cõduire ceſte affaire	Aduisons entre nous au moyen salutaire Qu'il faut pour sagement cuduire cette affaire
ROSELIS.	ROSELIS.
Pour l’acheminement de ce diuin project, La chanſon à danſer ſeruira de ſujet;	Pour l'acheminement de ce divin project, La chanson à dans servira de sujet;
L’entree du logis vous eſt déja permiſe, En leur allant porter voſtre chanſon promiſe;	L'entre du logis vous est déjà permise, En leur allant porter votre chanson promise;
Et Belange auec moy vous accompagnera;	Et Bélange lez -moi vous accompagnera;
eliiſMMla.	eliisMMla.
POLIANDRE.	POLYANDRE.
Il faut s’apriuoiſer, & frequenter cheZ-elles, Ie croy que c'eſt leur bien qui les fait Damoiſelles:	Il faut s'apriuoiser, et fréquenter cheZ-elles, Je crois que c'est leur bien qui les fait Damoiselles:
Mais n'importe, chacune a des perfections Qui releuent l'eſtat de leurs extractions.	Mais n'importe, chacune a des perfections Qui relèvent l'état de leurs extractions.
Portons-là nos deſſeins, & faiſons voir au monde Que c’eſt ſur lavertu que noſtre esprit ſe fode,	Portons-là nos desseins, et faisons voir au monde Que c'est sur lavertu que notre esprit se sode,
BELANGE.	BÉLANGE.
Afaells fle guualllr, Si le Roy ne va point coucher à ſainct Germain.	Afaels flèle gualllr, Si le Roi ne va point coucher à saint Germain.
POLIANDRE.	POLYANDRE.
Sans doute il n'y vapas, car l’on tient chez la Reine Le voyãge remis iuſqu’à l’autre ſemaine.	Sans doute il n'y vapas, car l'on tient chez la Reine Le voyãge remis jusqu'à l'autre semaine.
ROSELIS.	ROSELIS.
Le pluſtoſt vaut mieux de crainte d’vn riual,	Le plutôt vaut mieux de crainte d'un rival,
POLIANDRE.	POLYANDRE.
Allons-nous en tous trois remonter à cheual, En nous Emnous en retournan.	Allons-nous en tous trois remonter à cheval, En nous Émnous en retournan.
tieyyllau reſte	tiellau reste
BELANGE.	BÉLANGE.
Pour moy ie ne croy pas qu'aucun nous les	Pour moi ici ne crois pas qu'aucun nous les
MAISTRE HIEREMIE.	MAÎTRE HIÈREMIE.
KAROLV.	VAROLV.
FLEVRIE.	FLEURIE.
Les aſſiſtans au Chariuaris.	Les assistants au Chariuaris.
Mr HIEREMIE, & ſes camarades.	Mr HIÈREMIE, et ses camarades.
Areil à ſes hiboux qui ne vont que de M nuiet, Ie n’oſerois paroiſtre où le Soleil me luict.	Arreil à ses hiboux qui ne vont que de M uiet, Je n'oserais paraître où le Soleil me luict.
Apres le mauuais tour que ma iouë Fleurie Il faut que ma raiſon cedant à ma furie, Pour vanger cét affront faſſe vn chariuaris, Dont iamais on ay fait le ſemblable à Paris.	Après le mauvais tour que ma joue Fleurie Il faut que ma raison cédant à ma furie, Pour venger cet affront fasse un chariuaris, Dont jamais on ai fait le semblable à Paris.
Ie n'oſe me monſtrer où la gloire m'appelle, Qu'à l'inſtant mes amis ne m'entretiennent d’elle:	Je n'ose me montrer où la gloire m'appelle, Qu'à l'instant mes amis ne m'entretiennent d'elle:
L’vn dit que Karolu ſeul a cauſé ce mal, Qu'il a ſurpris l’eſprit de ce ſot animal;	L'un dit que Œarolu seul a causé ce mal, Qu'il a surpris l'esprit de ce sot animal;
Que ie meritois bien d’auuir la preference.	Que Elle méritais bien d'avenir la préférence.
L’autre s'’offre ſecõd ſi i'en veux la vẽgeance.	L'autre s'offre seconds si j'en veux la vendre.
En fin chacun pour moy veut porter le cartel, Et iuſques dans le ſein donner le coup mortel.	En fin chacun pour moi veut porter le cartel, Et jusques dans le sein donner le coup mortel.
I'aydans mon regimẽt quatre cens camarades, Qui s'en iroient chez luy faire mil algarades Deſſous l’authorité de mon conſentement:	J'aidans mon règiment quatre cens camarades, Qui s'en iraient chez chez était mil algarades Dessous l'autorité de mon consentement:
Mais i'ay trop de courage & trop de iugemẽt Ie ne veux point meſler perſonne en ma querelle, I’ay la force à la main & la raiſon pour elle;	Mais j'ai trop de courage et trop de jugement Je ne veux point mêler personne en ma querelle, J'ai la force à la main et la raison pour elle;
Ioint qu'on m'accuſeroit d’vn crime d’aſſaſſin.	Joint qu'on m'accuserait d'un crime d'assassin.
Pourſuiuons ſeulemẽt noſtre premier deſſein.	Poursuivons seulement notre premier dessein.
Or ſus donc mes enfans, hardiment que l’on ſonne, Faiſons vn ſi grãd bruit que Paris s’en étõne:	Or sus donc mes enfants, hardiment que l'on sonne, Faisons un si grand bruit que Paris s'en étonne:
Faiſons que la rumeur de tous ces inſtrumens Aille auecques frayeur reueiller ſes Amans:	Faisons que la rumeur de tous ces instruments Aille était frayeur réveiller ses Amants:
Mais à mon premier cry qu’auſſi toſt chacun ceſſe:	Mais à mon premier cri qu'aussi tôt chacun cesse:
preſſe.	presse.
Sus voila la maiſon, frappons le temps nous Ils font le Charriuaris, puis Hieremie dit:	Sus voilà la maison, frappons le temps nous Ils font le Charrivaris, puis Hieremie dit:
Or eſcouteZ petits & grands,	Or écoutez petits et grands,
C eſt qu'auiourd'huy Dame Pſenrie A Xarola ſe remarie, Aagé de ſoixante & quinze ans, S’il ne ſçauroit mettre dedans Ie ſhis vlen danis qui men pile.	Ç est qu'auiourd'hui Dame Psenrie A Xarolà se remarie, Aagé de soixante et quinze ans, S'il ne saurait mettre dedans Je shis vlen danis qui men pile.
Qui ſont ſes inſolens parlans ainſi la bas:	Qui sont ses insolents parlants ainsi la bas:
Sus, ſus, ma halebarde auec mon couſtelas, Mon piſtolet, mon caſque, allez ouurir là porte;	Sus, sus, ma halebarde avec mon coutelas, Mon pistolet, mon casque, allez ouvrir là porte;
Des pierres oifetmes, acpeſchons que ie ſorte.	Des pierres oivetmes, acpêchons que Il sorte.
Ils recommancent le Chariuaris, & M Karolu paroiſt à la feneſtre diſant:	Ils recommancent le Chariuaris, et M Alarolu paraît à la fenêtre disant:
FLEVRIE.	FLEURIE.
Ha Monſieur Xarolu;	Ha Monsieur Xaru;
vous ne ſortirez pas!	vous ne sortirez pas!
Mr KAROLV.	Mr AROLU.
Aux volleurs, aux volleurs.	Aux volleurs, aux volleurs.
MAATEREMIE.	MATEREMIE.
Retournons ſur nos pas, De peur que la commune à preſent eſueillee Ne nous vienne engager dedans vne meſlee:	Retournons sur nos pas, De peur que la commune à présent éveille Ne nous vienne engager dedans une mêlée:
Mr XAROLV:	Mr XAROLV:
Ie vous tueray pendarts:	Je vous tuerai pendards:
FLEVRIE.	FLEURIE.
le tey aſſommeray.	le tey assommerai.
Mr KAROLV.	Mr AROLU.
Ie n’entends plus de bruit, chacun s’eſt retiré.	Je n'entends plus de bruit, chacun s'est retiré.
Que nous auons icy vn pauure voiſinage, Aucun n'a pas monſtre ſeulement ſon viſage.	Que nous avons ici un pauvre voisinage, Aucun n'a pas montre seulement son visage.
DDIRIE.	DDIRIE.
C’eſt pourcequ’à la nopce ils n'ont eſté mãdez.	C'est pourcequ'à la noce ils n'ont été mandés.
NR NAROLV.	NR NAROLU.
Allons-nous recoucher.	Allons-nous recoucher.
FLEVRIE.	FLEURIE.
Ie vous prie attendez.	Je vous prie attendez.
MR KAROLV.	MR AROLU.
Depeſchons viſtement.	Dépêchons vitement.
FLEVRIE.	FLEURIE.
Ie crains que ces beliſtres Ne reuiennẽt biẽ toſt caſſer toutes nosviſtres.	Je crains que ces bélîtres Ne reviennent bienne tôt casser toutes nosvistres.
MR KAROLV.	MR AROLU.
Maudit foit tes maraux, ſans ce bruit diſſolu, I'aurois déja baſty vn petit Karolu, (taine, Mais ie m’en vangeray, la choſe eſt tres-cerEt Maiſtre Hieremie en portera la peine.	Maudit soit tes maraux, sans ce bruit dissolu, J'aurais déjà bâti un petit Karolu, (taine, Mais Seigneur m'en vengerai, la chose est très-cerEt Maître Hieremie en portera la peine.
Fin du troiſieſme Acte.	Fin du troisième Acte.
ACTE IIII.	ACTE IIII.
CLARISTE SILINDE.	CLARISTE SILINDE.
FLORIANE.	FLORIANE.
KAROLV.	VAROLV.
FLEVRIE.	FLEURIE.
LE SOLDAT.	LE SOLDAT.
POLIANDRE.	POLYANDRE.
ROSELIS.	ROSELIS.
BELANGE.	BÉLANGE.
SCENE PREMIERE.	SCÈNE PREMIÈRE.
CLARISTE.	CLARISTE.
Vre neceſſité contraire à mon bon-heur, TQue vous tyranniſeZ le respect & l'honneur.	Vre nécessité contraire à mon bonheur, TQue vous tyrannise le respect et l'honneur.
Le mortel captiué ſous voſtre triſte empire, N’oſe ouurir à ſon cœur ce que l’esprit deſire, Le respect eſt à bas, & la grandeur le fuit, L’homme neceſſiteux void la peur qui le ſuit, Mil apprehenſions cherchent le miſerable, Alors qu’il veut cacher ſon eſtat deplorable;	Le mortel captivé sous votre triste empire, N'ose ouvrir à son cœur ce que l'esprit désire, Le respect est à bas, et la grandeur le fuit, L'homme nécessiteux voit la peur qui le suit, Mil appréhensions cherchent le misérable, Alors qu'il veut cacher son état déplorable;
La triſteſſe eſt ſa mere, & ſon pere vn regret De n’oſer deſcouitrir à chacun ſon ſecret.	La tristesse est sa mère, et son père un regret De n'oser descouitrir à chacun son secret.
Ce n'eſt pas ſans raiſon que ie tiens ce lãgage,	Ce n'est pas sans raison que ie tiens ce langage,
On me fait prendre icy ce gentil equipage.	On me fait prendre ici ce gentil équipage.
Et cependant mes ſœurs auſſi bien comme moy Pour aſpirer ſi haut n'ont pas aſſeZ dequoy.	Et cependant mes sœurs aussi bien comme moi Pour aspirer si haut n'ont pas assez dequoy.
Nous ne sõmes pourtãt qu’enfans d’obeiſſanNoſtre felicité deſpend de l’esperance.	Nous ne sommes pourtant qu'enfants d'obéissanNotre félicité dépend de l'espérance.
Ice, Si le Ciel qui peut tout a pour nous de l’amour L’eſpoir que nous auons peut arriuer vn iour.	Ice, Si le Ciel qui peut tout a pour nous de l'amour L'espoir que nous avons peut arriver un jour.
C'eſt donc à luy qu’il faut faire noſtre priere, Suiuant le ſentiment de noſtre bonne mere, Afin que les effets fauoriſans nos veux Donnẽt à nosdeſſeins des ſuccez biẽ-heureux.	C'est donc à peine qu'il faut faire notre prière, Suivant le sentiment de notre bonne -mère, Afin que les effets favorisants nos veux Donnêt à nosdesseins des succès biẽ-heureux.
Helas!	Hélas!
ſi Roſelis ſçauoit combien ie l’aime, Combien pour le ſeruir mon deſir eſt extreme;	si Roselis Savait combien Prince l'aime, Combien pour le servir mon désir est extrême;
Sans doute ſa raiſon me voudroit preferer A toutes les beautez qu’il pourroit adorer.	Sans doute sa raison me voudrait préférer À toutes les beautés qu'il pourrait adorer.
Mais qui l’aſſeurera de mon obeiſſance, Si ce n’eſt mon ſeruice auec ma bien-veillance, Aucun autre en effet ne luy peut teſmoigner:	Mais qui l'assurera de mon obéissance, Si ce n'est mon service avec ma bienveillance, Aucun autre en effet ne La peut témoigner:
S’il vient nous viſiter ſera beaucoup gaigner:	S'il vient nous visiter sera beaucoup gagner:
Mais i’apprehende fort que la chanſon promiſe Nous faſſe long-temps voir leurviſite remiſe.	Mais j'appréhende fort que la chanson promise Nous fasse longtemps voir leurvisite remise.
Pourtant ſi ces Meſſieurs l’executent ce iour, C'eſt vn ſigne certain qu'ils ſont touchez d’amour, Laiſſons-en la conduitte à la bonne fortune.	Pourtant si ces Messieurs l'exécutent ce jour, C'est un signe certain qu'ils sont touchés d'amour, Laissons-en la conduite à la bonne fortune.
O mo Dieu, qu'a preset Silinde m'importune!	Ô mo Dieu, qu'a preset Silinde m'importune!
SILINDE.	SILINDE.
Ma ſœur, tu ne ſçay pas vn ſecret important;	Ma sœur, tu ne sais pas un secret important;
Floriane auiourd’huyn a point l’eſprit contãt Belange aſſeurement luy donne dans la veuë;	Floriane aujourd'huin a point l'esprit contant Bélange assurément avait donne dans la vue;
Contre ſon naturel ie la vois toute eſmeuë, Triſte, penſiue:	Contre son naturel ie la vois toute émue, Triste, pensive:
En fin c'eſt vn grand changeCLARISTE.	En fin c'est un grand changCLARISTE.
Iment.	Iment.
Il faut donc confeſſer qu'elle eſt ſans iugemẽt, Veu l’inegalité de l’vn auecques l’autre.	Il faut donc confesser qu'elle est sans jugement, Veu l'inégalité de l' amou autre!
SILINDE.	SILINDE.
Pourquoy?	Pourquoi?
mon ſentiment eſt donc contraire au voſtre, Floriane eſt gentille, & Bellange a du bien.	mon sentiment est donc contraire au vôtre, Floriane est gentille, et Bellange a du bien.
CLARISTE.	CLARISTE.
La beauté maintenant eſt vn foible moyen, Il faut que la richeſſe accompagne les belles, Ou biê en ce tẽps-cy point tic partis ponr elles, Le plus triſte viſage en parlant contre moy, Eſt autant eſtimé pourueu qu'il ait dequoy.	La beauté maintenant est un faible moyen, Il faut que la richesse accompagne les belles, Ou biêmes en ce temps-cy point tic partis ponr elles, Le plus triste visage en parlant contre moi, Est autant estimé pourvu qu'il ait dequoy.
SILINDE.	SILINDE.
Du ceiintouitofoi, memt queique choſe,	Du ciintouitofoi, mémt queique chose,
CLARISTE.	CLARISTE.
C'eſt vn grand argument que ton esprit propoſe, momnempumumememugouuunaduis, Me fera couper court pour changer de deuis,	C'est un grand argument que ton esprit propose, momnempumumememugouuunaduis, Me fera couper court pour changer de devis,
SILINDE.	SILINDE.
Dit ce qu’il te plaira, mais neatmoins conmoppeomcuopumuuvuvouavouſiours la preſſe;	Dit ce qu'il te plaira, mais néanmoins conmoppeomcuopumuuvuvouavousiours la presse;
Elle a cent ſeruiteurs, contre vne laide deux,	Elle a cent serviteurs, contre une laide deux,
CLARISTE.	CLARISTE.
Tu t'engages ma ſœur dans vn piege hazardeux, Eu fonfaens les veautez à cauſe de da tienne.	Tu t'engages ma sœur dans un piège hasardeux, Eu fonfaends les veautez à cause de da tienne.
SILINDE.	SILINDE.
Helas!	Hélas!
en verité ie ne penſe à la mienne, C’eſt vn trop bas ſujet pour nous entretenir.	en vérité ie ne pense à la mienne, C'est un trop bas sujet pour nous entretenir.
CLARISTE.	CLARISTE.
.	.
Inir.	Inir.
A quelqu’autre deſſein tu veux doncques veTon parler d'action, & ton cœur qui ſouspire Cache queque ſecret que tu ne veux pas dire.	À quelqu'autre dessein tu veux doncques viton parler d'action, et ton cœur qui soupire Cache que secret que tu ne veux pas dire.
SILINDE.	SILINDE.
4 ont au taut, ſais mentir.	4 ont au taut, sais mentir.
CLARISTE.	CLARISTE.
Dit ce que tu voudras:	Dit ce que tu voudras:
Mais vn ſoubçon conçeu tu ne m'oſteras pas.	Mais un soubon conçu tu ne m'ôteras pas.
Quel?	Quel?
daae d	dae d
CLARISTE.	CLARISTE.
C’eſt que Poliandre a gliſſé dans ton ame Quelque douce chaleur de l’amoureuſe flame.	C'est que Poliandre a glissé dans ton âme Quelque douce chaleur de l'amoureuse flamme.
SILINDE.	SILINDE.
Ie ne le penſe pas?	Je ne le pense pas?
CLARISTE.	CLARISTE.
Tu rougis neaumoins?	Tu rougis neaumoins?
Va, va, ie n’en veux point de plus fermes teſmoins?	Va, va, Madame n'en veux point de plus fermes témoins?
ſommes.	sommes.
Il n’en faut pas t’en dire en ce temps où nous Mais pleuſt à Dieu mes ſœurs que ces trois Gentil-hommes Euſſent pour nous aimer vn deſir genereux.	Il n'en faut pas t'en dire en ce temps où nous Mais plût à Dieu mes sœurs que ces trois Gentilhommes Eussent pour nous aimer un désir généreux.
SILINDE.	SILINDE.
Roſelis en ce cas ſeroit ton amoureux.	Roselis en ce cas serait ton amoureux.
CLARISTE.	CLARISTE.
da ayals ecssaedsserslss	da ayals ecssaedsserslss
SILINDE.	SILINDE.
Que tu fais bien la fine?	Que tu fais bien la fine?
Quand tu veux d’éguiſer que tu fais bonne mine, Que tu m'as battu froid dans le commencemiẽt.	Quand tu veux d'éguiser que tu fais bonne mine, Que tu m'as battu froid dans le commencement.
CLARISTE.	CLARISTE.
La crainte à ta raiſon ſeruiroitde truchemẽt, Des que pour me parler tu as ouuert la bouche I'ay porté mon esprit ſur le mal qui te touche.	La crainte à ta raison servirait truchement, Des que pour me parler tu as ouvert la bouche J'ai porté mon esprit sur le mal qui te touche.
SILINDE.	SILINDE.
Ie confeſſe vrayment que c’eſt bien deuiner:	Je confesse vraiment que c'est bien deviner:
Mais auſſi i’ay ſujet de beaucoup m'eſtonner, Maintenat que ie vois Roſelis dans fon ame, Toy qui faiſois tantoſt des leçons à ma flame, Ie venois bien icy me confeſſer au loup.	Mais aussi j'ai sujet de beaucoup m'étonner, Maintenat que ie vois Roselis dans son âme, Toi qui faisais tantôt des leçons à ma flamme, Je venais bien ici me confesser au loup.
CLARISTE.	CLARISTE.
Nos trois çœurs ont eſté frappeZ d’vn meſme coup;	Nos trois çœurs ont été frappés d'un même coup;
dre, Et pourueu que celuy des Amãs ne ſoit moinMa ſœur, aſſeurément nous ne deuons nous Mais ou va Floriane?	dre, Et pourvu que celui des Amants ne soit moinMa sœur, assurément nous ne devons nous Mais ou va Floriane?
plaindre.	plaindre.
LA	LA
COMEDIE.	COMÉDIE.
SILINDE.	SILINDE.
Elle vient à grand pas.	Elle vient à grand pas.
Mes ſœurs:	Mes sœurs:
FLORIANE.	FLORIANE.
SILINDE.	SILINDE.
Que voulez-vous:	Que voulez-vous:
FLORIANE.	FLORIANE.
Ces Meſſieurs ſont la bas;	Ces Messieurs sont la bas;
rts demanutnt ivronptur, nxauaint, ou bien leurs filles.	rts demanutnt jronptur, navaint, ou bien leurs filles.
SILINDE.	SILINDE.
Allons au deuant d'eux, pareſſons bien genRengeZ bien tout içy, courons-toſt?	Allons au devant d'eux, paressons bien genrengés bien tout içi, courons-tôt?
tilles.	tilles.
CLARISTE.	CLARISTE.
O ma ſœur!	Ô ma sœur!
Que le Ciel auiourd’huy nous promet de bon heur?	Que le Ciel aujourd'hui nous promet de bon heur?
SGENE SECONDE.	SGENE SECONDE.
POLIANDRE.	POLYANDRE.
SILINDE.	SILINDE.
ROSE LIS.	ROSE LIS.
CLARISTE.	CLARISTE.
BELANGE.	BÉLANGE.
FLORIANE.	FLORIANE.
POLIANDRE.	POLYANDRE.
Finde n’eſtre pas accuſe de pareſſe, Ie viens chaſtes beautez, acquitter me promeſſe:	Finde n'être pas accuse de paresse, Je viens chastes beautés, acquitter me promesse:
eſte chanſon promiſe hier dedans le bois, Poist vous la preſenier nous fait oenir tous trois.	este chanson promise hier dedans le bois, Poist vous la présenier nous fait oenir tous trois.
SILINDE.	SILINDE.
Meſſieurs, vos actions ſont les vrais teſmoignages rages:	Messieurs, vos actions sont les vrais témoignages rages:
Des vertueux deſſeins qui portent vos couPar les humbles effets que vous nous faites voir, uoir Nous manquons de vertu autant que de pouPour recognoiſtre vn iour vnefaueur ſi grãde	Des vertueux desseins qui portent vos couPar les humbles effets que vous nous faites voir, oir Nous manquons de vertu autant que de pouPour reconnaître un jour vnefaueur si grande
POLIANDRE.	POLYANDRE.
L’honneur à nos eſprits, ceſte gloire demande, Les loix de la nobleſſe & de l’humilité Pour ſeruir vos beautez n'ont rien de limité.	L'honneur à nos esprits, cette gloire demande, Les lois de la noblesse et de l'humilité Pour servir vos beautés n'ont rien de limité.
Auſſi quand le deuoir eſt eſtimé ſeruice, On ne ſçauroit iamais rendre vn meilleur ofCLARISTE.	Aussi quand le devoir est estimé service, On ne saurait jamais rendre un meilleur ofLARISTE.
fice.	fiée.
Si par vn tel eſtime, encor qu’iniuſtement Nous pouuons vous donner quelque contentemient.	Si par un tel estime, encor qu'injustement Nous pouvons vous donner quelque contentement.
Meſſieurs, aſſeureZ-vous qu’il tient place en noſtre ame Dame.	Messieurs, assurez-vous qu'il tient place en notre âme Dame.
Du plus grand qui iamais fuſt receu d’vne	Du plus grand qui jamais fut reçu d'une
ROSELIS.	ROSELIS.
Ha!	Ha!
que parfaitement vous ſçaueZ obliger, Ie vois bien que par là vous voulez vous vanger:	que parfaitement vous savez obliger, Je vois bien que par là vous voulez -vous venger:
Ilouſie, Mais quoy que vous faſſiez, ie veux par jaVoir ceder vos deſirs à noſtre courtoiſie.	Ilousie, Mais quoi que vous fassiez, je veux par jaVoir céder vos désirs à notre courtoisie.
FLORIANE.	FLORIANE.
La bonne volonté ne manquera iamais, Et ſi vous n'envoyez quelqu'effet deſormais, Accuſez-le deſtin dont la noire malice Nous rauit le bon-heur de vous rẽdre ſeruice.	La bonne volonté ne manquera jamais, Et si vous n'envoyez quelqu'effet désormais, Accusez-le destin dont la noire malice Nous ravit le bonheur de vous radre service.
BELANGE.	BÉLANGE.
A faire l’impoſſible on n'eſt point obligé, N'impute à la raiſon le ſujet de la faute.	À faire l'impossible on n'est point obligé, N'impute à la raison le sujet de la faute.
SILINDE.	SILINDE.
Voſtre cõception me ſemble vn peu trop hauté Demeurez ſur ce point, pour prẽdre ſeulemẽt Sur ces chaires icy le repos d’vn moment.	Votre commception me semble un peu trop hauté Demeurez sur ce point, pour prendre seulement Sur ces chaires ici le repos d'un moment.
POLIANDRE.	POLYANDRE.
Nous pouuons librement diſcourir vn quart d'heure.	Nous pouvons librement discourir un quart d'heure.
SILINDE.	SILINDE.
Uous trouueriez ailleurs occaſion meilleure:	Uous trouveriez ailleurs occasion meilleure:
CLARISTE.	CLARISTE.
dtemen uopouodumdemeu punuumcuuuſſement.	dtemen uopouodumdemeu punuumcuuussement.
ROSELIS.	ROSELIS.
On n'en ſçauroit trouuer vn qui ſoit plus POLINDRE.	On n'en saurait trouver un qui soit plus POLINDRE.
charmant:	charmant:
Aucun n’a iamais pleu dauantage à mon ame:	Aucun n'a jamais plu davantage à mon âme:
umnujumi pramnemomemnoouqtanoner, Maddmie, Que vos perfections ont tant gaigné ſur moy, Que mon cœur deſormais ne ſuit plus d’autré	umnujumi pramnemomemnoouqtanoner, Maddame, Que vos perfections ont tant gagné sur moi, Que mon cœur désormais ne suit plus d'autré
SILINDE.	SILINDE.
loy:	loi:
Monſieur, vous me fattz d'vnt esperance vaine,	Monsieur, vous me fatz d'unt espérance vaine,
Uous, dont la qualité vaut le prix d’vne reine.	Uous, dont la qualité vaut le prix d'une reine.
NOSELIS.	NOSELIS.
Que ie ſerois heureux, ſi de mes actions Seiqu ont ponnon pluic a vospeiſecuons.	Que était serais heureux, si de mes actions Seiqu ont ponnon pluic à vospeisecuons.
CLARISTE.	CLARISTE.
Puis qu'en toutes façons chacune eſt ſalutaire, Ie ne ſçaurois penſer qu'elles puiſſent déplaire	Puis qu'en toutes façons chacune est salutaire, Je ne saurais penser qu'elles puissent déplaire
BELANGE.	BÉLANGE.
Madame, croirez-vous que dans voſtre enIDettci Ie trouue en verité mon plus ſouuerain bien.	Madame, croirez-vous que dans votre enIDett Ie trouue en vérité mon plus souverain bien.
FLORIANE.	FLORIANE.
IugereZ-ojous, Monſieur, que mon cœur increduié, M'aduertit que le voſtre à preſent diſſimule.	Jugerez-jous, Monsieur, que mon cœur increduié, M'avertit que le vôtre à présent dissimule.
TOLIANDNE.	TOLIANDNE.
La feinte & la grandeur ne font point de ſeOu loge le ſujet d’vn veritable amour.	La feinte et la grandeur ne font point de seOu loge le sujet d'un véritable amour.
jour,	jour,
SILINDE.	SILINDE.
Quoy que la paſſion en donne vne aſſeurance, Il faut touſiours douter de la perſeuerance.	Quoi que la passion en donne une assurance, Il faut toujours douter de la persévérance.
ROSELIS.	ROSELIS.
I'espere auec le temps, ſeruant voſtre beauté, Luy monſtrer les effets de ma fidelité.	J'espere auec le temps, servant votre beauté, Lui montrer les effets de ma fidélité.
CLARISTE.	CLARISTE.
Certaine opinion ou mon ame eſt plongee, Me uii qu'ajenremen la vonie erengagee,	Certaine opinion ou mon âme est plonge, Me qu'ajenremen la vonie erengagee,
BELANGE.	BÉLANGE.
Ie meurs ſi i'aimay iamais en aucuns lieux, Sinon depuis hier que ie vis vos beaux yeux.	Je meurs si j'aimai jamais en aucuns lieux, Sinon depuis hier que ici vis vos beaux yeux.
FLORIANE.	FLORIANE.
Mions qn’ontoutuſan ueſirt nous ſurprendrè Ileſt fort malaiſé des en pouuoir deffendre.	Mions qn'ontoutusan ouvesirt nous surprendé Ilest fort malaisé des en pouvoir défendre.
POLIANDRE.	POLYANDRE.
Les preuues ſe verront dans les occaſions Qui pourront confirmer nos perſuaſions.	Les preuves se verront dans les occasions Qui pourront confirmer nos persuasions.
DILINDE.	DILINDE.
Ie trouue fort aiſé de dire que l’on aime;	Je trouve fort aisé de dire que l'on aime;
Mais de le croire auſſi le peril eſt extreme.	Mais de le croire aussi le péril est extrême.
ROSELIS.	ROSELIS.
I’ay chery quelque temps vn Aſtre de la Cour:	J'ai chéri quelque temps un Astre de la Cour:
auatus poutuſene mepii a vunuy nou Amour;	avatus poutusène mepi a vunui nouv Amour;
CLARISTE.	CLARISTE.
[ce, I'apprehende bien plus que ce ſoit l’inconſtan	[ce, J'appréhende bien plus que ce soit l'inconstan
Qui marque voſtre eſprit ue ſon mnuiſſerance.	Qui marque votre esprit ue son ménuisserance.
BELANGE.	BÉLANGE.
Si mon contentement despend de vous ſeruir Mauuaiſe avranudiſe, vuntt Z vous ce vunentaime ra	Si mon contentement dépend de vous servir Mauvaise auranudise, vunt Z -vous ce vunentaime ra
FLORIANE.	FLORIANE.
Cuir.	Cuir.
L’Amant veut qu'on le croye en toutes ſes paroles, Quoy que le plus ſouuent il d'ſe des friuolles.	L'Amant veut qu'on le croie en toutes ses paroles, Quoi que le plus souvent il d'se des frivoles.
POLIANDRE.	POLYANDRE.
Auuone amtqna eeyaaaaemn, Ie vous declarerois quel eſt noſtre deſir:	Auvone amtqna eeyaaaaemn, Je vous déclarerais quel est notre désir:
SILINDE.	SILINDE.
Mõſieur, vous le pouuez, loccaſion preſente Rendra par ce moyen noſtre ame fort contẽte.	Monssieur, vous le pouvez, loccasion présente Rendra par ce moyen notre âme fort contente.
NUEnlIS.	NUEnlIS.
Poliandre tout ſeul ſçait quel eſt mon deſſein, omme pareillement i’ey le ſien dãs mon ſein,	Poliandre tout seul avait quel est mon dessein, omme pareillement j'éi le sien dans mon sein,
CLARISTE.	CLARISTE.
Pour moy ie iugerois que ce qui vous ameine, Eſt pour paſſer le tẽps peut-eſtre vne ſemaine.	Pour moi ici jugerais que ce qui vous âmeine, Est pour passer le temps peut-être été semaine.
DE l ARON.	DE l ARON.
Mon espoir appuyé d’vn deſir genereux, Me donne en voſtre endroit le tiltre d’Amoureux.	Mon espoir appuyé d'Hommes des généreux, Me donne en votre endroit le titre d'Amoureux.
FLORIANE.	FLORIANE.
Encore qu’il fuſt vray ie n’oſerois voꝰ croire, Mon merite, Monſieur, n'approchant voſtre	Encore qu'il fût vrai ie n'oserais v croire, Mon mérite, Monsieur, n'approchant votre
POLIANDRE.	POLYANDRE.
gloire.	gloire.
Apres que dãs le cœur i'ay veu chaque beauté, I ay trouue que lavoſtre a lhonneur emporté.	Après que dans le cœur j'ai vu chaque beauté, I ai trouve que lavotre a lhonneur emporté.
SILINDE.	SILINDE.
Sçachant trop les deffauts qui ſont en mon vi6 Mon esprit n'eſt point vain pour croire ce ROSELIS.	Sachant trop les défauts qui sont en mon vi6 Mon esprit n'est point vain pour croire ce ROSELIS.
langage.	langage.
royeZ qu’il n’eſt ſur terre aucun objet mortet A qui pluſtoſt qu'à vous mon cœur dreſſe vn u du do l d d Mv.	royez qu'il n'est sur terre aucun objet mortet À qui plutôt qu'à vous mon cœur dresse u du do .
autel.	autel.
I'eſtime grandement vn choix ſi fauorable:	J'estime grandement un choix si favorable:
Mais vn feu violant n'eſt pas beaucoup du	Mais un feu violant n'est pas beaucoup du
DELANGE.	DELANGE.
rable.	rable.
Pluſtoſt que de manquer à cherir vos appas, Ie voudrois que le Ciel me donnaſt le trespas.	Plutôt que de manquer à chérir vos appas, Je voudrais que le Ciel me donnât le trépas.
FLORIANE.	FLORIANE.
Auant que de cauſer vn mal-heur ſi funeſte, Ie voudrois que le mien fuſt à tous manifeſte.	Avant que de causer un malheur si funeste, Je voudrais que le mien fût à tous manifeste.
POLIANDRE.	POLYANDRE.
Madame, nous venons pour apprẽdre de vous (En qualité d’Amãs) ſi vous voudreZ de nous	Madame, nous venons pour apprendre de vous (En qualité d'Amant) si vous voudrez de nous
SILINDE.	SILINDE.
L’offre d’vn ſi grãd heur eſt d’vne cõſequence Qui merite, Monſieur, que noſtre esprit y penſe.	L'offre d'vn si grand heur est d'une cõsequence Qui mérite, Monsieur, que notre esprit y pense.
ROSELIS.	ROSELIS.
Quiteur,	Quiteur,
Pourueu que vous n'ayez point d’autre ſerRoſelis quelque iour çaignera voſtre cœur.	Pourvu que vous n'ayez point d'autre servir quelque jour aignera votre cœur.
CLARISTE.	CLARISTE.
Clariſte & ſes deux ſœurs que vous voye preſentes, En matiere d’amour ſont beaucoup innocẽtes.	Clariste et ses deux sœurs que vous voient présentes, En matière d'amour sont beaucoup innocence.
BELANGE.	BÉLANGE.
Ie voy bien que le Ciel a ſoin de nos Amours, Puis que pas vn riual n'en interrõpt le cours.	Je vois bien que le Ciel a soin de nos Amours, Puis que pas un rival n'en interront le cours.
TEORTANE.	TEORTANE.
Noſtre peu de beauté nous cauſe ce dommage:	Notre peu de beauté nous cause ce dommage:
Mais ſur d’autres auſſi vout aueZ l’auãtage.	Mais sur d'autres aussi vout aueZ l'avantage.
POLIANDRE.	POLYANDRE.
nCencuuonouumomuere puie ouc etcetion, Suiuant le mouuement de noſtre affection:	nCencuuonouumomuere puie ouc etcetion, Suivant le mouvement de notre affection:
Penſez-y meurement, & croyeZ que la feinte N'exerce ſon pouuoir ſur vne ame contrainSILINDE.	Pensez-y meurement, et croyez que la feinte N'exerce son pouvoir sur une âme contrainILINDE.
te.	te.
Pour éuiter le bruit de quelques differends,	Pour éviter le bruit de quelques différends,
Nous en prendrons l’aduis de nos proches paTen.	Nous en prendrons l'avis de nos proches paTen.
ROSELIS.	ROSELIS.
L’aſſaire le merite, & auec diligence, De crainté que le Roy ne nous meine en ProCLARISTE.	L'assaire le mérite, et avec diligence, De crainté que le Roi ne nous mène en ProCLARISTE.
uence.	uence.
Vous en aureZ demain la reſolution.	Vous en aurez demain la résolution.
BELANGE.	BÉLANGE.
Nous viurons cependant dans l’apprehenſion Qu'il ſe trouue a nos veeux quelque demon contratie.	Nous vivrons cependant dans l'appréhension Qu'il se trouve à nos veveux quelque démon contratie.
FLORIANE.	FLORIANE.
muuntunutguorepa,uchoſe eſt volontatre, On nons ame par trop pour forternos plaiSILINDE.	muuntunutguorepa,uchose est volontatre, On nons âme par trop pour forternos plaiSILINDE.
ſirs.	sirs.
On ne nous marira que ſelon nos deſirs.	On ne nous marira que selon nos désirs.
CLARISTE.	CLARISTE.
Pourueu que noſtre pere à ce deſſein conſente, Croyez que noſtre mere en ſera fort contente.	Pourvu que notre père à ce dessein consente, Croyez que notre mère en sera fort contente.
POLIANDRE.	POLYANDRE.
Nous-nous eſtions promis le bon-heur de les voir:	Nous-nous étions promis le bonheur de les voir:
Mais puis qu’ils n'y ſont pas, par vn iuſte deuoir, Nous leur rẽdrons demain la ſemblablevi ſite:	Mais puis qu'ils n'y sont pas, par un juste devoir, Nous leur riendrons demain la semblablevi site:
Cependant la nuict vient, il faut que chacun quitte Son charmant entretien;	Cependant la nuit vient, il faut que chacun quitte Son charmant entretien;
anant nous ſeparer De vos commandemé̃s voulez-vous m’honorer.	anant nous séparer De vos commandemé̃s voulez-vous m'honorer.
SILINDE.	SILINDE.
St ie puis commander en qualite d’Amante, Ie veux que voſtre eſprit me croye ſa ſeruãte.	St ici puis commander en qualité d'Amante, Je veux que votre esprit me croie sa servante.
POLIANDRE.	POLYANDRE.
Chonneur de vous ſeruir m'eſt vit treſor ſi cher, Que ie mourray pluſtoſtquede m'en empeſcher	Chonneur de vous servir m'est vit trésor si cher, Que tu mourrai plustostquede m'en empêcher
ROSELIS.	ROSELIS.
Madame, obligez-moy de voſtre bien-veillance, Et de mon amitié ie vous donne aſſeurance.	Madame, obligez-moi de votre bienveillance, Et de mon amitié , vous donne assurance.
CLARISIL.	CLARISIL.
B2 S.	B2 S.
Monſieur, ſoyez certain que ſelon mon pouitoir, En toute occaſion ie vous le feray voir.	Monsieur, soyez certain que selon mon pouitoir, En toute occasion je vous le ferai voir.
4.	4.
F1E:	F1E:
220 22 C- 11i	220 22 Ç- 11i
Source gallica.	Source galica.
bnf.	bnf.
fr ( Biblic	fr ( Biblic
BELANGE.	BÉLANGE.
Adieu donc pour ce iour Reine de ma penſée, ſamats voſrre peante n'en pent iſiic eſſacee.	Adieu donc pour ce jour Reine de ma pensée, samats vos péante n'en pent isiic essacée.
FLORIANE.	FLORIANE.
Monſieur, ce n’eſt vn bien qui purt d’vn naturel Plus courtois qu'amoureux:	Monsieur, ce n'est un bien qui purt d'Han naturel Plus courtois qu'amoureux:
toutefois il eſt tel Que i'en feray touſiours vne eſtime incroyable, Afin qu'en vous ſeruãt, ie vous ſois agreable.	toutefois il est tel Que j'en ferai toujours une estime incroyable, Afin qu'en vous servant, enfin vous sois agréable.
SILINDE.	SILINDE.
Hé bien, mes cheres ſœurs, quels ſont vos ſenti mens Sur le doux entretien de nos parfaits Amans?	Hé bien, mes chères sœurs, quels sont vos senti mens Sur le doux entretien de nos parfaits Amants?
Pour moy ie vous diray le mien ſans flaterie;	Pour moi ici vous dirai le mien sans flatterie;
C'eſt qu’ils parlent tous trois ſans nulle raillerie.	C'est qu'ils parlent tous trois sans nulle raillerie.
CLARISTE.	CLARISTE.
Il eſt ſacile à voir, leur emulation Teſmoigne clairement quelle eſt leur paſſion, Ie n'ay rien entendu que des paroles bonnes, Et veu des actions dignes de leurs perſonnes.	Il est sacile à voir, leur émulation Témoigne clairement quelle est leur passion, Je n'ai rien entendu que des paroles bonnes, Et vu des actions dignes de leurs personnes.
FLORIANE.	FLORIANE.
Si l’on peut du projet paruenir à l’effet, C'eſt vn diuin plaiſir que la vertu nous fait;	Si l'on peut du projet parvenir à l'effet, C'est un divin plaisir que la vertu nous fait;
Il en faut conſulter auec noſtre beau-pere, Qui vient tout à propos auec noſtre mere.	Il en faut consulter auec jours beau-père, Qui vient tout à propos avec notre mère.
Mr KAROLV.	Mr AROLU.
La couſtume eſt ainſi, les femmes de Paris Doiuent vne viſite aux parans des maris.	La coutume est ainsi, les femmes de Paris Doivent une visite aux parants des maris.
FLEVRIE.	FLEURIE.
La mode eſt importune aux perſonnes aagez;	La mode est importune aux personnes aagés;
Ceux-là qui font ces loix nous ont deſ-obli(las, Et pour mon regard ſeul i’ay les deux pieds ſi teideves aſfennement te ny ncronmne pas,	Ceux-là qui font ces lois nous ont dé-obliglas, Et pour mon regard seul j'ai les deux pieds si teideves asfennement te rien ncronmène pas,
MR KAROLV.	MR AROLU.
Les nouueaux marieZ font cela dordinaire.	Les nouveaux marieZ font cela dordinaire.
FLEVRIE.	FLEURIE.
On ne m’y tiendroitpas ſi c’eſtoit à refaire.	On ne m'y tiendroitpas si c'était à refaire.
MR KAROLV.	MR AROLU.
Quoy?	Quoi?
vous eſtes deſia dedans le repentir.	vous êtes déjà dedans le repentir.
FLEVIeLE.	FLEVIeLE.
Ie dis naifuement la choſe ſans mentir:	Je dis naifuement la chose sans mentir:
Mais tant de parenté déplaiſt fort à Fleurie.	Mais tant de parenté déplaît fort à Fleurie.
G iiij	G jijà
Mr KAROLV.	Mr AROLU.
Hé bien, nous n'irons plus, parlons bas ie vous prie, (der.	Hé bien, nous n'irons plus, parlons bas sens vous prie, (der.
Silinde & ſes deux ſœurs nous viennẽt aborMes mignonnes, quelqu'vn m'eſt venu demander.	Silinde et ses deux sœurs nous viennent aborMes mignonnes, quelqu'amour m'est venu demander.
DILINDE.	DILINDE.
ie croyez-vous que c’eſt?	Ne croyez-vous que c'est?
M XAROLV.	M MXAROLV.
Monſieur de la Fuſtaille.	Monsieur de la Fûtaille.
A lvAax.	À luvAax.
C'eſt ma ſœur, vieux thodis, ou Madame Racaille.	C'est ma sœur, vieux thodis, ou Madame Racaille.
FLORIANE.	FLORIANE.
bois Non, ce ſont ces Meſſieurs trouueZ dedans le Quejmoignent auoir de l’amour pour nous frots.	bois Non, ce sont ces Messieurs trouvés dedans le Quejmoignent avoir de l'amour pour nous frots.
TLEVRIE Floriane, vraynent vous eſtes trop hardie.	TLEURIE Floriane, vrainent vous êtes trop hardie.
FLORIANE.	FLORIANE.
Sçachant la verité il faut que ie la die.	Sachant la vérité il faut que je la die.
FLEVRIE.	FLEURIE.
Ie n'ay point encor veu rien de plus effronté.	Je n'ai point encor vu rien de plus effronté.
CLARISTE.	CLARISTE.
Il eſt vray qu’ils ſont pleins de bonne volõté, Ils nous ont fait icy mil offres de ſeruices, Que l'on lit ſur leur front eſtre ſans artiſices.	Il est vrai qu'ils sont pleins de bonne volõté, Ils nous ont fait ici mil offres de services, Que l'on lit sur leur front être sans artisices.
M* KAROLV.	M* AROLV.
Ne vous y fiez pas, Ces esprits ſi courtois Pour mieux vous attraper font ainſi les matois.	Ne vous y fiez pas, Ces esprits si courtois Pour mieux vous attraper font ainsi les matois.
SILINDE.	SILINDE.
Non veritablement, il n’y a rien à craindre, Leur ame ſans mentir, ne ſçait que c’eſt de feindre, Les ſermens qu'ils ont faits auec leurs actions Nous informent aſſez de leurs affections.	Non véritablement, il n'y a rien à craindre, Leur âme sans mentir, ne sait que c'est de feindre, Les serments qu'ils ont faits avec leurs actions Nous informent assez de leurs affections.
FLEVRIE.	FLEURIE.
Hd!	Hd!
que n'eſtois-ie icy, en trois mots & ſans peine I’aurois leu dans leur cœur le deſſein qui les CLARISTE.	que n'étais-je ici, en trois mots et sans peine J'aurais lu dans leur cœur le dessein qui les CLARISTE.
meine.	mène.
Il ne faut point douter qu'il eſt fort bon pour nous, Chacun d’eux dés demain s’offre pour noſtre eſpoux, Ils vous viendront eux-meſmes en faire la denlauiihe,	Il ne faut point douter qu'il est fort bon pour nous, Chacun d'eux dès demain s'offre pour notre époux, Ils vous viendront eux-mêmes en faire la denlauiihe,
FLEVRIE.	FLEURIE.
I'ay de la peine à croire vne faueur ſi grande, Et ie crains que ſçachant noſtre incommodité Ils ne cheriſſent plus l’habit ny la beauté.	J'ai de la peine à croire une faveur si grande, Et a crains que sachant notre incommodité Ils ne chérissent plus l'habit ni la beauté.
SILINDE.	SILINDE.
Ie ne le penſe pas;	Je ne le pense pas;
la parfaite nobleſſe Conſiſte à preferer l’honneur à la richeſſe:	la parfaite noblesse Consiste à préférer l'honneur à la richesse:
Iointqu’à tous ces perils, leurs eſpritsdispoſez Ne craignent ſeulement que d'eſtre refuſez	Jointqu'à tous ces périls, leurs espritsdisposez Ne craignent seulement que d'être refusés
A l ſ  Uous n'aueZ rien promis qui nous puiſſe déplatre.	À l ' Un n'avez rien promis qui nous puisse déplatre.
CLARISTE.	CLARISTE.
Que de ſuiure en cela voſtre aduis neceſſaire.	Que de suivre en cela vôtre appuis nécessaire.
Mr KAROLV.	Mr AROLU.
Laiſſons-les donc venir.	Laissons-les donc venir.
FLEVRIE.	FLEURIE.
O filles qu’à propos On vous a mis ce iour ces habits ſur le dos!	Ô filles qu'à propos On vous a mis ce jour ces habits sur le dos!
Vous paſſeZ aupres d’eux pour ieunes Damoiſelles.	Vous passez auprès d'eux pour jeunes Damoiselles.
FLORIANE.	FLORIANE.
It yien uocantoup quint font point ſibelles.	It yien uocantoup quint font point sibelles.
Mr KAROLV.	Mr AROLU.
Il'eſt vray, ie vous iure.	Il'est vrai, Seigneur vous jure.
FLEVRIE Allons mon petit cœur Prendre ſur le ſupperquelque peu de viguear.	FLEURIE Allons mon petit cœur Prendre sur le superquelque peu de viguear.
MRKAROLV.	MRAROLU.
Entrez touſiours deuant, faites mettre à la broche.	Entrez toujours devant, faites mettre à la broche.
Mais que veut ce ſoldat qui pres de moy s’approche;	Mais que veut ce soldat qui pres de moi s'approche;
Las!	Las!
ce ieune garçon n'eſt guere reſolu?	ce jeune garçon n'est guère résolu?
SOLDAT.	SOLDAT.
Monſieur, eſt-ce point vous qu'on nomme Karolu, Mary d’vne Fleurie en beautez ſans exẽple, Et qu'on ma dit loger dãs les marais du l’ẽple.	Monsieur, est-ce point vous qu'on nomme Arrolu, Mari d'une Fleurie en beautés sans exemple, Et qu'on ma dit loger dans les marais du l'enple.
Mr KAROLV.	Mr AROLU.
Mon enfant, c'eſt luy-meſme.	Mon enfant, c'est lui-même.
SOLDAT.	SOLDAT.
Vn guerrier immortel Pour voir voſtre valeur enuoye ce cartel.	Un guerrier immortel Pour voir votre valeur envoie ce cartel.
Mr KAROLV.	Mr AROLU.
Voyons de quent part.	Voyons de quent part.
SOLDAT.	SOLDAT.
C’eſt de noſtre anspeſade.	C'est de notre anspesade.
Mr KAROLV.	Mr AROLU.
Ie ſuis fort aiſe, amy, d’vne telle ambaſſade.	Je suis fort aise, ami, d'une telle ambassade.
Cartel de Maiſtre Hieremie à Monſieur Karolu.	Cartel de Maître Hieremie à Monsieur Karolu.
Si tu te veux monſtrer quelque peu genereux, Rends-toy demain matin derriere les Chartreux:	Si tu te veux montrer quelque peu généreux, Rends-toi demain matin derrière les Chartreux:
Hieremie l’autheur des belles entrepriſes Si trouuera tout ſeul à ſix heures preciſes;	Hymie l'auteur des belles entreprises Si trouvera tout seul à six heures précises;
Et comme il a le cœur autant bon que courtois Des armes du combat il te donne le choix.	Et comme il a le cœur autant bon que courtois Des armes du combat il te donne le choix.
NTMAROLV.	NTMAROLV.
Voila quiva fort bien, à Dieu mon camarade, Ie m'y rendray demain auec vne eſtocade, Qui vient du Cheualier qu'on appelloit Lõgis	Voilà quiva fort bien, à Dieu mon camarade, Je m'y rendrai demain avec une estocade, Qui vient du Chevalier qu'on appelait Légis
SOLDAT.	SOLDAT.
Adieu, n’oubliez pas voſtre adreſſe au logis.	Adieu, n'oubliez pas Seigneur adresse au logis.
Findu quatrieſme Acte.	Findu quatrième Acte.
ACTE V.	ACTE V.
AalEllaro HIEREMIE.	Aalllaro HIEREMIE.
FLEVRIE.	FLEURIE.
EL SILINDE.	EL SILINDE.
CLARISTE.	CLARISTE.
FLORIANE.	FLORIANE.
KAROLV.	VAROLV.
NOSEEIS.	NOSEIS.
NODIANDRE.	NODIANDRE.
BELANGE.	BÉLANGE.
SCENE PREMIERE.	SCÈNE PREMIÈRE.
Me HIEREMIE.	Me HIEREMIE.
Eſolu de mourir, ou d’auoir la victoire, NIe marche maintenant ſur le champ de la gloire;	Éolu de mourir, ou d'avoir la victoire, NIe marche maintenant sur le champ de la gloire;
L’honneur ce mon duel predeſtiné du ſort Me dõne dans vne heure ou la vie ou la mort.	L'honneur ce mon duel prédestiné du sort Me dont un e heure ou la vie ou la mort.
Vous generoſité, hardieſſe, viillance, Force, adreſſe, bon-heur, agilite, nrudence, Ne m'abandonnez pas en ma neceſſité.	Vous générosité, hardiesse, viillance, Force, adresse, bonheur, agilité, nrudence, Ne m'abandonnez pas en ma nécessité.
Ie n’ay iamais tremblé deuant vne Cité;	Je n'ai jamais tremblé devant une Cité;
Et ſongeant au combat que ie veux entreprendre, A peine ny-ie le cœurde me pouuoir deffendre;	Et songeant au combat que ici veux entreprendre, À peine ni-je le cœurde me pendant défendre;
Quelque ſecret caché cauſe ce changement, Et peut eſtre le ciel ne veut pas autrement.	Quelque secret caché cause ce changement, Et peut -être le ciel ne veut pas autrement.
Karolu me fait peur, & cent fois vne armee N’a point dõné de crainte à ma dextre animeé I'exemptois des faits reſerueZ au Dieu Mars:	Çarolu me fait peur, et cent fois une armée N'a point dõné de crainte à ma dextre anime J'exemptais des faits rés au Dieu Mars:
Ie cherchois de la gloire au milieu des hazards.	Je cherchais de la gloire au milieu des hasards.
Et maintenant poltron vne ſeule perſonne Espouuante ton ame, & ton courage eſtonne, Ah!	Et maintenant poltron une seule personne Espouuante ton âme, et ton courage étonne, Ah!
ſans doute l’amour opere les effets, Et d’vn œil de trauers il regarde mes faits.	sans doute l'amour opère les effets, Et d'un œil de travers il regarde mes faits.
Mais que diſie, ignorant, ce demon ne void goutte;	Mais que disie, ignorant, ce démon ne voit goutte;
S’il oſte ſon bandeau, c’eſt ſigne qu’il me redoute:	S'il ôte son bandeau, c'est signe qu'il me redoute:
S’il void clair a preſent, c'eſt afin d’éuiter, Les traicts que contre luy ma fureur peut jetter.	S'il voit clair a présent, c'est afin d'éviter, Les traits que contre nô ma fureur peut jeter.
Que ne peut en ce ſiecle vn gierrier de ma Lors que la jalouſie & la fureur l’emporte?	Que ne peut en ce siècle un gierrier de ma Lors que la jalousie et la fureur l'emporte?
Hardimẽt ſa valeur s’attacheroit aux cieux, Et contraindroit l’Amour d’abandonner ces lieux.	Hardiment sa valeur s'attacherait aux cieux, Et contrainrait l'Amour d'abandonner ces lieux.
Fleutie, ton mépris cauſe ce deſordre, este faſcheuſe enuie a ſur moy voulu mors dre.	Flutie, ton mépris cause ce désordre, este fâcheuse envie a sur moi voulu mors dre.
Mais i’eſpere dans peu mõſtrer à ton mignon Qu'il ne madeub traicter en petit compagnon:	Mais j'espère dans peu montrer à ton mignon Qu'il ne madeu traicter en petit compagnon:
Ie vais comme vn oiſeau le prendre à la pipee, Quand chez vn Fourbiſſeur i’auray pris vne espee.	Je vais comme un oiseau le prendre à la pipée, Quand chez un Fourbisseur j'aurai pris une espèse.
SCENE SECONDE.	SCÈNE SECONDE.
FLEVRIE.	FLEURIE.
Mon Dieu qu'eſt-cecy!	Mon Dieu qu'est-ceci!
las que viensie de voir:	las que viensie de voir:
Mes filles accourez, ie ſuis au deſeſpoir, Ie n’ay plusde mary, vous n'auez plus de pere.	Mes filles accourez, je suis au désespoir, Je n'ai plusde mari, vous n'avez plus de père.
SILINDE.	SILINDE.
Helas!	Hélas!
elle ce paſme:	elle ce pâme:
hé qu'aueZ qu'auez-vous ma mere?	hé qu'avez qu'avez-vous ma mère?
FLEVRIE.	FLEURIE.
VoyeZ dans ce papier le ſujet de mon dueil, Qui voſtre pere & moy conduit dans le cercueil, (table, Le pauure homme en ſortant la laiſſé ſur la Afin de m'aduertir de ſa mort lamentable.	VoyeZ dans ce papier le sujet de mon deuil, Qui votre père et moi conduit dans le cercueil, (table, Le pauvre homme en sortant la laissé sur la Afin de m'avertir de sa mort lamentable.
ober delromlacau hueciu a ricuſſe, que Silinde lit.	ober delromlacau hueciv a ricusse, que Silinde lit.
M’amour, vn vieil ſoldat plus jaloux qu’amoureux, Ma fait faire vn appel derriere les Chartreux;	M'amour, un vieil soldat plus jaloux qu'amoureux, Ma fait faire un appel derrière les Chartreux;
pare.	pare.
Le courage & l’honneur veulent que i'y comAdieu chere moitie, le deſtin nous ſepare, Ne vous affligez pas, ayeZ ſoin ſeulement De me faire dreſſer vn riche monument.	Le courage et l'honneur veulent que j'y comAdieu chère moitie, le destin nous sépare, Ne vous affligez pas, ayeZ soin seulement De me faire dresser un riche monument.
SILINDE.	SILINDE.
Iuſte Ciel, de quel œil voyeZ-vous nos fortunes, (munes, Ne confeſſez-vous pas qu'elles ne ſont comPuis qu'eſtant ſur le point d’atteindre le bonheur, Uous les voyeZ mourir par vn coup de malheur.	Juste Ciel, de quel œil voyez-vous nos fortunes, (munes, Ne confessez-vous pas qu'elles ne sont comPuis qu'étant sur le point d'atteindre le bonheur, Uous les voyeZ mourir par un coup de malheur.
O mes ſœurs, c’eſt ce iour qu’il faut verſer des larmes!	Ô mes sœurs, c'est ce jour qu'il faut verser des larmes!
Puis que pour nous vanger nous n'auons que ces armes?	Puis que pour nous venger nous n'avons que ces armes?
Il faut que le torrent de tant de triſtes pleurs Aatite untontamuy nojen camtmeur de nos douleurs.	Il faut que le torrent de tant de tristes pleurs Aatite untontamui nojen camteur de nos douleurs.
CLARISTE.	CLARISTE.
O que ce foible espoir contente mal mon ame!	Ô que ce faible espoir contente mal mon âme!
Cheres ſœurs, ie me mœurs, la vẽgeance m'enflame, (luy de jaut que.	Chères sœurs, votre me mœurs, la viengeance m'enflamme, (lui de jaut que.
ines denamaiits ſaſſent monrir ceQui nous cauſe à preſent tant de mal & d’ennuy.	ines denamaiits sassent monrir ceQui nous cause à présent tant de mal et d'ennui.
4	4
FLORIANE.	FLORIANE.
Helas!	Hélas!
que ces diſcours me ſemblent inutiles;	que ces discours me semblent inutiles;
Cherchons pour le ſauuer des moyens plus faciles, Et s’il n’eſt point trop tart, courons viſte apres eux, Empeſcher du combat l’euenement douteux,	Cherchons pour le sauver des moyens plus faciles, Et s'il n'est point trop tart, courons vite après eux, Empêcher du combat l'événement douteux,
FLEVRIE.	FLEURIE.
Mes enfans s'en eſt fait, il a trop de courage Pour n'auoir iuſqu içy mis l’eſcrime en vſaPourtant ſans plus tarder, ie croy qu’il faut pluſtoſt Aller en diligence aduertir le Preuoſt, nujin qque prompremeinteur donnedes gardes, Qui pour les ſeparer portent des hallebardes.	Mes enfants s'en est fait, il a trop de courage Pour n'avoir jusqu' ici mis l'escrime en usaPourtant sans plus tarder, on crois qu'il faut plutôt Aller en diligence avertir le Prévôt, nujin qque prompremeinteur donnedes gardes, Qui pour les séparer portent des hallebardes.
CLARTSTE.	CLARTSTE.
C’eſt fort bien aduiſé.	C'est fort bien avisé.
FLEVRIE.	FLEURIE.
Que l’on m'aide à marcher.	Que l'on m'aide à marcher.
Nous prendrons en paſſant noſtre voiſin l’archer;	Nous prendrons en passant notre voisin l'archer;
Depuis qu'il eſt du guet, la caſaque eſcarlatte Luy a fait negliger l’allaine & la ſauate.	Depuis qu'il est du guet, la casaque écarlatte Lui a fait négliger l'allaine et la saute.
S’il n’a fait ceſte nuict capture de fillous, Il ſera fort joyeux de venir auec nous:	S'il n'a fait cette nuit capture de fillous, Il sera fort joyeux de venir avec nous:
I’ay mis dedans ma bourſe vn teſton de Loraine, Pour le recompenſer du ſucceZ de ſa peine, Ie n’espargneray rien en ce ſujet icy.	J'ai mis dedans ma bourse un teston de Loraine, Pour le récompenser du succès de sa peine, Je n'épargnerai rien en ce sujet ici.
Allons, il faut paſſer la porte de Buſſi.	Allons, il faut passer la porte de Bussi.
SCENE TROISIESME.	SCÈNE -TROISIÈME.
Emblable à l’innocent que l’on meine au O ſupplice, Ie ne ſçaurois ſçauoir de quoy ie ſuis complice?	Emblable à l'innocent que l'on mène au Ô supplice, Je ne saurais savoir de quoi -même suis complice?
mort, On me fait mon prõceZ, on me condamne à Et l’on ne me dit point a qui i'ay fait de tort.	mort, On me fait mon prendrez, on me condamne à Et l'on ne me dit point à qui j'ai fait de tort.
Le mal que i'ày commis, & dont ce ſoldat crie, Eſt d’auoir eſpouſé l’agreable Fleurie.	Le mal que j'à commis, et dont ce soldat crie, Est d'avoir épousé l'agréable Fleurie.
Hieremie auiourd’huy ne ſçauroit endurer De voir à ſa valeur ma vertu preferer:	Hymie aujourd'hui ne saurait endurer De voir à sa valeur ma vertu préférer:
Pour en auoir raiſon il veut que nos eſpees A diſputer ſon prix ſoient ce iour occupees.	Pour en avoir raison il veut que nos espères A disputer son prix soient ce jour occupées.
Mais helas!	Mais hélas!
le pauure homme y vient vn peis trop tart, Sans canon ceſte nuict i’ay fait breſche au rampart;	le pauvre homme y vient un pis trop tart, Sans canon cette nuit j'ai fait brèche au rampart;
Et ſi deſ-apreſent ie deſcends dans la foſſe, Ie puis bien aſſeurer que ie la laiſſe groſſe.	Et si des-aprésent apprendre descends dans la fosse, Je puis bien assurer que ici la laisse grosse.
En fin me voicy preſt de le bien receuoir, Ie veux à ce guerrier ma force faire voir Ie luy veux teſmoigner que ie me ſçay deffendre Alors qu’vn temeraire oſe de m'entreprẽdre.	En fin me voici prêt de le bien recevoir, Je veux à ce guerrier ma force faire voir Je lui veux témoigner que sans me sais défendre Alors qu'un téméraire ose de m'entreprendre.
La plume auec l’espee, où il va de l’honneur, Ont vne ſimpatie auecques mon humeur:	La plume avec l'épée, où il va de l'honneur, Ont une simpatie avec mon humeur:
Ie m'en ſçays eſcrimer, alors que la rencontre Pour en voir les effets à ma gloire ſe monſtre.	Je m'en sçays escrimer, alors que la rencontre Pour en voir les effets à ma gloire se montre.
Voicy doncques la place où preſide le ſort La vie eſt d’vn coſté, de l’autre on void la mort;	Voici donc la place où preside le sort La vie est d'un côté, de l'autre on voit la mort;
Et toutesfois les deux dedans l’indiference, Donnent à mon eſprit vne meſme esperance.	Et toutefois les deux dedans l'indiférence, Donnent à mon esprit une grande espérance.
La iuſtice diuine a le foudre à la main Pour punir le mortel quand il eſt inhumain, L’iniquité n'a point de plus grande ennemie.	La justice divine a le foudre à la main Pour punir le mortel quand il est inhumain, L'iniquité n'a point de plus grande ennemie.
En fin ie ne vois point approcher Hieremié, Ie croy qu’il a changé de reſolution;	En fin ici ne vois point approcher Hieremié, Je crois qu'il a changé de résolution;
La nuict, chaſſe ſouuent la folle paſſion.	La nuit, chasse souvent la folle passion.
Peut eſtre que rentré dans vne raiſon forte,	Peut être que rentré dans une raison forte,
11 A ce folaſtre amour il a fermé la porte.	11 À ce folâtre amour il a fermé la porte.
Mais n'eſt-ce point auſſi qu’il a ſceu ma valeur:	Mais n'est-ce point aussi qu'il a su ma valeur:
En ce cas ie craignois ceux à qui ie faits peur.	En ce cas esprit craignais ceux à qui a faits peur.
Ie n’ay point de beſoin de chemiſe de mailles, Vne main de papier peut garder mes entraules.	Je n'ai point de besoin de chemise de mailles, Une main de papier peut garder mes entraules.
Il fait bon conſeruer le moule du pourpoint, L'eſpee aſſeurément ne là percera point:	Il fait bon conserver le moule du pourpoint, L'épée assurément ne là percera point:
Elle eſt ſi proprement deſſus le petit ventre, Qu'il ne faut auoir peur que l’eſtocade y en tre.	Elle est si proprement dessus le petit ventre, Qu'il ne faut avoir peur que l'estocade y en tre.
O qu’il verra tantoſt eſcrimer joliment!	Ô qu'il verra tantôt escrimer joliment!
Ie ne le crains non plus que tout ſon regiment, Pourueu que mes deux yeux me ſeruent d’auantegardes.	Je ne le crains non plus que tout son régiment, Pourvu que mes deux yeux me servent d'avantegardes.
Mais le voicy qui vient, tenons-nous ſur nos gardes, On ne ſe doit, dit-on, fier à l’ennemy.	Mais le voici qui vient, tenons-nous sur nos gardes, On ne se doit, dit-on, fier à l'ennemi.
Me HIEREMIE.	Me HIEREMIE.
Dieu te gard Karolu.	Dieu te gard Karolu.
Mr KAROLV.	Mr AROLU.
Et à toy mon amy.	Et à toi mon ami.
M.	M.
HIEREMIE.	HIEREMIE.
Luy vcantonp pins tarae qne tuture entre Mr KAROLV.	Lui vantonp pins tarae qne tuture entre Mr KAROLV.
Inous priſe.	Inous prise.
I'ay creu que ta folie eſtoit vn peu raſſiſe, Et que depuis hier, ayant dormy la nuict, Tu auois oublié l’appel qui nous conduit.	J'ai cru que ta folie était un peu rassise, Et que depuis hier, ayant dormi la nuit, Tu avais oublié l'appel qui nous conduit.
Mr HIEREMIE.	Mr HIEREMIE.
Ma colere en ce cas trompe donc ton attente, Car plus elle vieillit, plus elle eſt violante, Et ſans vn Fourbiſſeur qui ma long-temps Indubitablement ie t’aurois preuenu;	Ma colère en ce cas trompe donc ton attente, Car plus elle vieillit, plus elle est violante, Et sans un Fourbisseur qui ma longtemps Indubitablement avait t'aurais prévenu;
Itenu, Tu ſerois maintenant en l’eſtat de paroiſtre, De ceux qu’au Chaſtelet on va pour recognoifre.	Itenu, Tu serais maintenant en l'état de paraître, De ceux qu'au Châtelet on va pour reconnaître.
Mais c’eſt trop diſcourir, ſus, ſus, le manteau Le pourpoint, le chapeau.	Mais c'est trop discourir, sus, sus, le manteau Le pourpoint, le chapeau.
bas,	bas,
Mr KAROLV.	Mr AROLU.
te n'y manqner ay pas.	te n'y manqner ai pas.
Mais tire-toy plus loing, car la main meurtriere Des gens de ta façon peut fraper par derriere.	Mais tire-toi plus loing, car la main meurtrière Des gens de ta façon peut frapper par derrière.
M.	M.
HIEREMIE.	HIEREMIE.
Ie ne ſuis pas bourreau pour te traiter ainſi, L’honneur dedans mon ſein a logé inſqu’icy, Iamais la trahiſon n'euſt de place en mõ ame.	Je ne suis pas bourreau pour te traiter ainsi, L'honneur dedans mon sein a logé insqu'ici, Jamais la trahison n'eût de place en mon âme.
Mais c’eſt toy vieux hibou, qui fuſt traiſtre à ma flàme, Par les laſches deſtours de l’infidelité, Tu m'as rauy le bien que i'auois merité.	Mais c'est toi vieux hibou, qui fût traître à ma flême, Par les lâches détours de l'infidélité, Tu m'as ravi le bien que j'avais mérité.
ave  Pauure foux, ie te plains auec ta reſuerie.	Je Pauvre foux, ie te plains avec ta rêverie.
M* HIEREMIE.	M* HIÈREMIE.
Apprends donc auiourd huy que tu meurs pour Fleurie.	Apprends donc aujourd' hui que tu meurs pour Fleurie.
Mr KAROLV.	Mr AROLU.
Ie meure il s'en rencontre aux petites maiſons iuiſent pins que toy de miuchres raiſons, Et pour moy ſi lon croit ma ſcience certaine, Si tu reſte viuant il faut que l’ont'y meine.	Je meure il s'en rencontre aux petites maisons juisent pins que toi de miuchres raisons, Et pour moi si lon croit ma science certaine, Si tu reste vivant il faut que l'ont'y mène.
Mr HIEREMIE.	Mr HIEREMIE.
C’eſt trop long-temps cauſer, eſt tu preſt, depeſchons.	C'est trop longtemps causer, est tu prêt, dépêchons.
Mr KAROLV.	Mr AROLU.
Il verra ce papier ſi nous nous approchons, Vn peu de patience, attends, car mon espeet Tient dedans ſon foureau.	Il verra ce papier si nous nous approchons, Un peu de patience, attends, car mon espète Tient dedans son foureau.
Mr HIEREMIE.	Mr HIEREMIE.
La plaiſante eſquipee:	La plaisante équipée:
Tu penſes prolonger ta vie à diſcourir, Lors qu’il vaudroit bien mieux te reſoudre à mourir.	Tu penses prolonger ta vie à discourir, Lors qu'il vaudrait bien mieux te résoudre à mourir.
Mr KAROLV.	Mr AROLU.
Ol ſus, cenons unae muins, prend garde à cette botte.	Ol sus, cenons unae muins, prend garde à cette botte.
M HIEREMIE.	M MIEREMIE.
La ripoſte eſt meilleure.	La riposte est meilleure.
MR KAROLV.	MR AROLU.
Ainſi qui ie complote, Dans toneneure au pluſair deſſus un anantpas, Karolu s’en vamettre vn anspeſade bas.	Ainsi qui grande complote, Dans toneneure au plusair dessus un anantpas, Arolu s'en vamettre un anspesade bas.
Mr HIEREMIE.	Mr HIEREMIE.
?	?
Pante ceconp jounre, autremcut te taſfedre Qu'il faut aller là bas reparer mon iniure.	Pante ceconp jounre, autremut te tasfedre Qu'il faut aller là bas réparer mon injure.
Mr KAROLV.	Mr AROLU.
Pouſſe, pour le parer ie me mets en eſtat.	Pousse, pour le parer ici me mets en état.
Mr HIEREMIE.	Mr HIEREMIE.
Ben donc, voila ta mort d’vn coup de vieux ſoldat.	Ben donc, voilà ta mort d'un coup de vieux soldat.
MR KAROLV.	MR AROLU.
Ie deffend celuy-là qui paſſe la jartiere:	Je défend celui-là qui passe la jartienne:
Garde, ie vois quelqu'vn qui te prend par derriere.	Garde, Seigneur vois quelqu'un qui te prend par derrière.
M' HIEREMIE.	M' HIEREMIE.
Ta feinte en mon endroit ne reüſſira pas, Mes yeux n'ont point d’obiect que celuy de ton bras:	Ta feinte en mon endroit ne réussira pas, Mes yeux n'ont point d'objet que celui de ton bras:
Monſtre icy ton effort:	Monsieur ici ton effort:
mais point de ſtratageme.	mais point de stratagème.
Mr KAROLV.	Mr AROLU.
Ie garde vn dernier coup qui te va rendre NSne Is EJens, (bleſme,	Je garde un dernier coup qui te va rendre NSne Is EJens, (bles,
Mr HIEREMIE.	Mr HIEREMIE.
O que ie la void bien!	Ô que ici la voit bien!
MR KAROLV.	MR AROLU.
Pour m'eſtre trop preſſé mon coup n'a valu AvI LIIEREMIE.	Pour m'être trop pressé mon coup n'a valu AvI LIEREMIE.
Irien.	Jrien.
Ne ſçais-tu que cela, ie me rid de ta peine.	Ne sçais-tu que cela, ie me rid de ta peine.
MR KAROLV.	MR AROLU.
Hola, tout doucement, prenons vn peu d’haMe HIEREMIE.	Holà, tout doucement, prenons un peu d'haMe HIEREMIE.
Pleine.	Pleine.
Non, non, apres tamort tu ſeras en repos.	Non, non, après tamort tu seras en repos.
Ma vaillance touſiours ſe rencontre à propos, Tu la verras bien-toſt par les lauriers ſuiuie.	Ma vaillance toujours se rencontre à propos, Tu la verras bientôt par les lauriers suivie.
Mr HIEREMIE.	Mr HIEREMIE.
Si tu veux m'aictmet dtmmuamtay la vie, Peut-eſtre ma pitié te pourra pardonner.	Si tu veux m'aictmett dtmmuamtay la vie, Peut-être ma pitié te pourra pardonner.
Mr KAROLV.	Mr AROLU.
Ie ne demande point ce qu'on ne peut donner, Ne t'imagine pas l’auoir en ta puiſſance Tandis que ceſte main ſera ſur la deffence.	Je ne demande point ce qu'on ne peut donner, Ne t'imagine pas l'avoir en ta puissance Tandis que cette main sera sur la défense.
M* HIEREMIE.	M* HIÈREMIE.
Pourſuiuons-donc le fil du duel commencé.	Poursuivons-donc le fil du duel commencé.
Mr KAROLV.	Mr AROLU.
S’il t'en arriue mal ie ne t’en ay preſſé.	S'il t'en arrive mal On ne t'en ai pressé.
Or ſus, c'eſt maintenant qu'il faut joüer du 3 reſte, deſere-Implorant le ſecours de la bonté celeſte.	Or sus, c'est maintenant qu'il faut jouer du 3 reste, desère-Implorant le secours de la bonté celeste.
SCENE DERNIERE.	SCÈNE DERNIÈRE.
FLEVRIE.	FLEURIE.
ROSELIS, SILINDE.	ROSELIS, SILINDE.
FLORIANE.	FLORIANE.
CLARISTE.	CLARISTE.
POLIANDRE.	POLYANDRE.
M' KAROLV.	M' AROLU.
M'HIEREMIE.	M'HIÈREMIE.
BELANGE.	BÉLANGE.
FLEVRIE.	FLEURIE.
Eſſieurs, qu’heureuſement nous vous IVI auons trouuez our venir appaiſer le mal que vous ſçauez Helas, noſtre douleur eſt tellement ſenſible!	Essieurs, qu'heureusement nous vous IVI avons trouvez our venir apaiser le mal que vous savez Hélas, notre douleur est tellement sensible!
Que d’en voir ſa ſemblable il vous eſt impoſſible.	Que d'en voir sa semblable il vous est impossible.
ROSELIS.	ROSELIS.
Nous ſortions du logis pour donner le bon iour A vn Ambaſſadeur logeant pres Luxembour.	Nous sortions du logis pour donner le bon jour A un Ambassadeur logeant pres Luxembour.
SILINDE.	SILINDE.
ne grace dont, Mreſſeurs, haſtons noſtré	ne grâce dont, Mresseurs, hâtons nostré
POLIANDRE.	POLYANDRE.
Ivoyage.	Joyage.
Mais encor, quel deſſein portoit voſtre courage.	Mais encor, quel dessein portait votre courage.
CLARISTE.	CLARISTE.
Nouz allions au logis du Preuoſt Deffunctis, ------- - L'adueiti uumuuroul quuuboubeſtes ſortis,	Nouz allions au logis du Prévôt Deffunctis, -à-dire -dire L'adueiti uumuuroul quuuboubestes sortis,
BELANGE.	BÉLANGE.
Pourueu qu’ils ſoient viuans lors de noſtre arriuee, Uous verreZ par la paix leur diſpute acheuee.	Pourvu qu'ils soient vivants lors de notre arrivée, Uous verrez par la paix leur dispute achève.
EEGRIANE.	ÉGRIANE.
Pleuſt au Ciel que deſia nous y fuſſiõs ſautez	Plût au Ciel que déjà nous y fussiõs sautés
FLEVRIE.	FLEURIE.
Ie crains bien que la mort ne nous les ait oſteZ Voſtre pere eſt hardy:	Je crains bien que la mort ne nous les ait ôtez Votre père est hardi:
mais l’autre a la vail4 lance, Et des tours de la guerre il à lexperience.	mais l'autre a la vail4 lance, Et des tours de la guerre il à lexpérience.
Le pauure corps, helas, n’aura guiere duré!	Le pauvre corps, hélas, n'aura guière duré!
O ſans doute il eſt mort, c’eſt vn fait aſſeuré!	Ô sans doute il est mort, c'est un fait assuré!
POLIANDRE.	POLYANDRE.
De tropdaſcuons vos espnits jetrauaillef.	De tropdascuons vos épnits jetravaillef.
FLEVRIE.	FLEURIE.
Filles ſouſtenez-moy, car les jambes me faillent.	Filles soutenez-moi, car les jambes me faillent.
ROSELIS.	ROSELIS.
ça, ça, donnez la main, nous approchons le lieit.	Ça, ça, donnez la main, nous approchons le lieit.
FLEVRIE.	FLEURIE.
muquur puuuiutuy donnaurmadieu.	muquur puviutui donnaurmadieu.
POLIANDRE.	POLYANDRE.
Ouy, ie vous le promets, puis que deſſus ces mottes Nous les voyons tous deux ſe porter quelques bottes.	Oui, Seigneur vous le promets, puis que dessus ces mottes Nous les voyons tous deux se porter quelques bottes.
BELANGE.	BÉLANGE.
Meſdames, dememreZcepeutint que nous trois Les irons ſeparer.	Mesdames, dememreZcepeutint que nous trois Les irons séparer.
FLEVRIE.	FLEURIE.
Non, non, ie ne ſçaurois.	Non, non, Madame ne saurais.
ROSELIS.	ROSELIS.
Vne heure ſeulement.	Une heure seulement.
FLEVRIE.	FLEURIE.
Auant vne demie Il faut que mes deux mains eſtranglent Hieremie, I'ay trop d’affection pour demeurer icy.	Avant une demie Il faut que mes deux mains étranglent Hieremie, J'ai trop d'affection pour demeurer ici.
Allons viſte.	Allons vite.
TLORCLINE.	TLORCLINE.
SILINDE.	SILINDE.
Courons.	Courons.
uduo Muvui de.	uduo Muvi de.
Maiſtre Hieremie ſortant de derriere le Theatre.	Maître Hieremie sortant de derrière le Théâtre.
Quelle troupe eſt cecy?	Quelle troupe est ceci?
Traiſtre, tu m'as trahy, du ſecours on t'ameine, Mais croy que ioſt ou tart tu payeras ma peine.	Traître, tu m'as trahi, du secours on t'amène, Mais crois que iost ou tart tu payeras ma peine.
Mr KAROLV.	Mr AROLU.
Pit as manty, voleur, idmais ie ne fuſt tel, Tu vomiras le mot auec ce coup mortel.	Pit as manti, voleur, idais ie ne fût tel, Tu vomiras le mot avec ce coup mortel.
POLIANDRE.	POLYANDRE.
Toubeait, toubeau Meſſieurs, hola, que l’on s’arreſte.	Toubeait, toubeau Messieurs, holà, que l'on s'arrête.
M* HIEREMIE.	M* HIÈREMIE.
Que le plus las de viure à la parque s’appreſte, Si l'on m'approche trop i'en perceray quelqu'vn.	Que le plus las de vivre à la parque s'apprête, Si l'on m'approche trop j'en percerai quelqu'un.
O quenc iajencteueſtit quutre conteon.	Ô quenc iajencteuestit quutre conteon.
Mr HIEREMIE.	Mr HIEREMIE.
Fme.	Fme.
Si vous venez plus pres ie vous enfilleray.	Si vous venez plus presque vous enfillerai.
FLEVRIE.	FLEURIE.
O vieux ratatiné, tu veux tuer mon homme!	Ô vieux ratiné, tu veux tuer mon homme!
Ramaſſons des cailloux, garre que ie l’aſſom	Ramassons des cailloux, garre que sans l'assom
FLEVRIE.	FLEURIE.
Mon fils, aſſeure-toy que ie te vangeray, Preſte-moy ton topec.	Mon fils, assure-toi que sans te vengerai, Preste-moi ton topec.
Mr HIEREMIE.	Mr HIEREMIE.
O la plaiſante foſe:	Ô la plaisante fose:
M* KAROLV.	M* AROLV.
En l'eſpoir de ta mort mon eſprit ſe conſole,	En l'espoir de ta mort mon esprit se console,
ROSELIS.	ROSELIS.
Soldat, oblige-nous de ne point offencer ſcer:	Soldat, oblige-nous de ne point offenser scer:
Cenx qui tiennet en main ce quii'y peut forRetire-toy pluſtoſt, nous t'en donnons licence.	Cenx qui tiennet en main ce quii'y peut forRétire-toi plutôt, nous t'en donnons licence.
BELANGE.	BÉLANGE.
Ie croy que ce ſoldat eſt de ma cognoiſſance.	Je crois que ce soldat est de ma connaissance.
d da ans ne, d au das.	 da ans ne, au das.
Camarade, remets ton eſpee au fourreau, Où t’aſſeure bien-toſt d’eſtre ſur le carreau.	Camarade, remets ton espee au fourreau, Où t'assure bientôt d'être sur le carreau.
Mr HIEREMIE.	Mr HIEREMIE.
S’il n’y auoit que vous ie n’aurois point de BELANGE.	S'il n'y avait que vous Seigneur n'aurais point de BÉLANGE.
Icrainte.	Icrainte.
Amy, i’ay cõtre toy vn vray ſujet de plainte, Si ton cœur ne ſuit pas noſtre iuſte deſir.	Ami, j'ai comtre toi un vrai sujet de plainte, Si ton cœur ne suit pas notre juste désir.
Mr HIEREMIE.	Mr HIEREMIE.
Ha Mõſieur, eſt-ce vous qui m'oſteZ le plaiſir De vanger maintenant vn affront d’imporPainte,	Ha Mõsieur, est-ce vous qui m'ôtez le plaisir De venger maintenant un affront d'imporPainte,
BELANGE.	BÉLANGE.
Nous en auons appris toute la conſequence, Il faut auant partir que vous ſoyeZ amis, Ou nous croire tous trois vos plus grands ennemis.	Nous en avons appris toute la conséquence, Il faut avant partir que vous soyez amis, Ou nous croire tous trois vos plus grands ennemis.
FLEVRIE.	FLEURIE.
A quoy ſert cediſcours, il n'eſt point neceſſaire Mettez-le moy par terre, ou bien me laiſſeZ faire.	À quoi sert cédiscours, il n'est point nécessaire Mettez-le moi par terre, ou bien me lais faire.
Mr HIEREMIE.	Mr HIEREMIE.
Le reſpect que ie dois à voſtre qualité Fait ceder la raiſon à ma brutalité, Ie mets les armes bas:	Le respect que Prince dois à votre qualité Fait céder la raison à ma brutalité, Je mets les armes bas:
mais c'eſt ſous l’aſſeurance Qu'il ne me ſera fait aucune violance.	mais c'est sous l'assurance Qu'il ne me sera fait aucune violance.
DBEAioL.	DBEAioL.
Non, ie te le promets, & ces Meſſieurs & moy Feront ſi tu le veux vn accord auec toy.	Non, Seigneur te le promets, et ces Messieurs et moi Feront si tu le veux accord toujours toi.
Quel?	Quel?
M' HIFREMIE.	M' HIFREMIE.
ROSELIS.	ROSELIS.
Monſieur Karolu tiendra la meſme place Qu’il auoit dans voſtre ame auant ceſte diſgrace.	Monsieur Arolu tiendra la même place Qu'il avait dans votre âme avant cette disgrâce.
Mr HIEREMIE.	Mr HIEREMIE.
Ce n’eſt pas là, Meſſieurs, la ſatisfaction, D’auoir rauy Fleurie a mon affection.	Ce n'est pas là, Messieurs, la satisfaction, D'avoir ravi Fleurie a mon affection.
MFKAROLV.	MFFAROLV.
Puic trompe, ooiuai, euc n eſout promiſe Auant qu’elle euſt iamais ta viſite permiſe.	Puic trompe, ooivai, euc n' out promise Avant qu'elle eût jamais ta visite permise.
FLEVRIE.	FLEURIE.
Mon-dieu, laiſſez-le dire, & ne l'iritez plus, ReſereZ voſtre espee.	Mon-dieu, laissez-le dire, et ne l'irités plus, Résèrez votre espee.
Mr HIEREMIE.	Mr HIEREMIE.
O que ie ſuis confus!	Ô que ici suis confus!
Où eſt le temps jadis, ou eſt ma hardieſſe, Qui portoit la terreur au cœur de la Nobleſſe;	Où est le temps jadis, ou est ma hardiesse, Qui portait la terreur au cœur de la Noblesse;
Cent homme contre moy deſſus le pont de Sé, Ne m'eſtonnoient non plus qu'vn poullet fricaſſé;	Cent homme contre moi dessus le pont de Sé, Ne m'étonnaient non plus qu'un poullet fricassé;
ſorte:	sorte:
I'euſſe bien fait la nicque aux gens de voſtre 27 n'y veux plus ſonger la colere m'emporte, Aitieu, Meſſieurs, adieu,	J'eusse bien fait la nicque aux gens de votre 27 n'y veux plus songer la colère m'emporte, Aitieu, Messieurs, adieu,
FLEVRIE.	FLEURIE.
Si l'on le laiſſe aller.	Si l'on le laisse aller.
le vois que des demain it oon ſait rappeller.	le vois que des demain it oon sait rappeler.
POLIANDRE.	POLYANDRE.
Soldat, encore vn mot, oblige nous de dire La ſatisfaction que ton eſprit deſire.	Soldat, encore un mot, oblige nous de dire La satisfaction que ton esprit désire.
Mr HIEREMIE.	Mr HIEREMIE.
Etimort de Mitrom, pout auoir espouſé Celle, qui de ſes vœux m’auoit fauoriſé.	Etimort de Mitrom, pout avoir épousé Celle, qui de ses vœux m'avait favorisé.
FLEVRIE.	FLEURIE.
Certes cela n'eſt pas?	Certes cela n'est pas?
MR KAROLV.	MR AROLU.
Non, ie iure en mon ame.	Non, Seigneur jure en mon âme.
NOSELIS.	NOSELIS.
En fin le mal eſt fait, c’eſt maintenant ſa femme.	En fin le mal est fait, c'est maintenant sa femme.
FLEVRIE.	FLEURIE.
Ie crois que ce bon homme a les ſens interdits:	Je crois que ce bon homme a les sens interdits:
Hé bien, contenteZ-vous de ma ſœur, vieux thodis, Si vous la deſirez ie me faits forte d’elle;	Hé bien, contente-vous de ma sœur, vieux thodis, Si vous la désirez toujours me faits forte d'elle;
Elle n’eſt moins que moy, propre, gentille & belle:	Elle n'est moins que moi, propre, gentille et belle:
Pour des biens elle en a (ie dis ſans vanité BJANTER Less se de in deeſes	Pour des biens elle en a (ie dis sans vanité BANTER Less se de in dees
POLIANDRE.	POLYANDRE.
L’offre eſt tres-raiſonnable, & Monſieur ſans excuſe, Nous deſ-obligeras il faut qu'il la refuſe.	L'offre est très-raisonnable, et Monsieur sans excuse, Nous des-obligeras il faut qu'il la refuse.
Mr HIEREMIE.	Mr HIEREMIE.
Vous liez mon eſprit d’vne obligation Contraire tout à fait à mon intention:	Vous liez mon esprit d'une obligation Contraire tout à fait à mon intention:
Et toutesfois forcé par voſtre courtaiſie, Ie vois par vos raiſons vainere ma fantaiſie:	Et toutefois forcé par votre courtaisie, Je vois par vos raisons vaine ma fantaisie:
Il faut qu’elle obeiſſe à vos commandemens, Quoy qu'elle ſente en ſoy d'eſtranges monueAſciss.	Il faut qu'elle obéisse à vos commandements, Quoi qu'elle sente en soi d'étranges monueAsciss.
BELANGE.	BÉLANGE.
Cher amy, tu nous faits vn plaiſir indicible.	Cher ami, tu nous faits un plaisir indicible.
POLIANDRE.	POLYANDRE.
La paix d’entre vous deux nous oblige au poſſible.	La paix d'entre vous deux nous oblige au possible.
Mr HIEREMIE.	Mr HIEREMIE.
Ouy donc, executãt les mots qui me ſont dits.	Oui donc, executãt les mots qui me sont dits.
MR KAROLV.	MR AROLU.
Edis.	Édis.
Ouy, ce ſera pour vous Madame, vieux tho	Oui, ce sera pour vous Madame, vieux tho
ROSELIS.	ROSELIS.
Uous voiht uent unoborur	Uous voih uent unoborur
SILINDE.	SILINDE.
Mon Dieu, que i'en ſuis aiſe:	Mon Dieu, que j'en suis aise:
FLEVRIE.	FLEURIE.
Approche petit cœur, il faut que ie te baiſe.	Approche petit cœur, il faut que je te baise.
Aaſs deds ve.	Aass deds ve.
Petite follichon, tu n'as point de respect,	Petite follichon, tu n'as point de respect,
FLEVRIE.	FLEURIE.
Ie ne vois point icy quelqu'vn qui ſoit ſuſpect Ces Meſſieurs ont appris comme quoy ie vous aime, Par le reſſentiment de ma douleur extreme:	Je ne vois point ici quelqu'un qui soit suspect Ces Messieurs ont appris comme quoi ie vous aime, Par le ressentiment de ma douleur extrême:
Vous leur eſtes, mon fils, grandement obligé,	Vous leur êtes, mon fils, grandement obligé,
Mr KAROLV.	Mr AROLU.
Ie ne veux pas mourir ſans m'en eſtre vangé;	Je ne veux pas mourir sans m'en être vengé;
Si le Ciel quelque iour fait l’occaſion n’aiſtre, Ma bonne volonté ie leur feray paraiſtre.	Si le Ciel quelque jour fait l'occasion n'aître, Ma bonne volontépris leur ferai paraître.
POLIANDRE.	POLYANDRE.
Si vous eſtes, Monſieur, en reſolution D'vſer de recompenſe à noſtre affection:	Si vous êtes, Monsieur, en résolution D'user de récompense à notre affection:
Uous ne verreZ iamais d’occaſiõs plus belles, Voicy proche de nous trois ieunes DamoiſelDe qui nous eſperons d’eſtre vn iour les eſpoux, Di noſt re von deſſem s accorde auecques vous,	Uous ne verrez jamais d'occasions plus belles, Voici proche de nous trois jeunes DamaiselDe qui nous espérons d'être un jour les époux, Di nos re ton desseman s accorde avec vous,
Mr KAROLV.	Mr AROLU.
Nous voila ſurchargez de faueurs infinies;	Nous voilà surchargés de faveurs infinies;
Mon amour, qu'en dis-tu, nos querelles finies, Nous voyons maintenant que la felicité Veut combler nos maiſons d’heur & prosperite, Nous gouſtons tout d’vn coup mille plaiſirs enſemble, Filles approchez-vous.	Mon amour, qu'en dis-tu, nos querelles finies, Nous voyons maintenant que la félicité Veut combler nos maisons d'heur et prospérité, Nous goûtons tout d'un coup mille plaisirs ensemble, Filles approchez-vous.
FLEVRIE.	FLEURIE.
Hé bien, que vous en ſemble?	Hé bien, que vous en semble?
Ces Meſſieurs maintenant s’offrent pour vos maris, Ie croy qu’il s’en void peu de pareils à Paris.	Ces Messieurs maintenant s'offrent pour vos maris, Je crois qu'il s'en voit peu de pareils à Paris.
ROSELIS.	ROSELIS.
Adorables ſujets de l’amoureux ſeruage, C’eſt mettre trop long-temps le ſilẽce envſage, Iuſques içy, la peur auecques les ſanglots Dans vn espoir douteux retenoit vos propos, Mais puis que le deſtin ne fait plusde menace, Et qu’il tourne vers nous vne riante face:	Adorables sujets de l'amoureux servage, C'est mettre trop longtemps le silẽce envsage, Jusques içi, la peur avec les sanglots Dans avoir douteux retenait vos propos, Mais puis que le destin ne fait plusde menace, Et qu'il tourne vers nous une riante face:
Ne penſons ſeulement qu'à rire deſormais, Et queumtent Pyjeu puamais.	Ne pensons seulement qu'à rire désormais, Et queumtent Pyjeu jamais.
FLORIANE.	FLORIANE.
Ie confeſſe, Mõſieur, que la peur & la crainte A nos foibles eſprits ont donné telle atteinte, guecomme moy mes ſuurs onftontes à la fois Perdu la liberté des ſens & de la voix.	Je confesse, Monsieur, que la peur et la crainte À nos faibles esprits ont donné telle atteinte, gucomme moi mes suurs onfontes à la fois Perdu la liberté des sens et de la voix.
CLARISTE.	CLARISTE.
Pour moy i'en ſuis encor ſi puiſſamment eſmetté, Que ie ne ſçay comment la langue me remuë.	Pour moi j'en suis encor si puissamment esmetté, Que Elle ne sais comment la langue me remue.
SILINDE.	SILINDE.
Ie puis bien aſſeurer que l'apprehenſion N'a iamais fait ſur moy ſi forte impreſſion:	Je puis bien assurer que l'appréhension N'a jamais fait sur moi si forte impression:
Mais petit à petit ie ſens qu'elle me quitte.	Mais petit à petit mot sens qu'elle me quitte.
BELANGE.	BÉLANGE.
C’eſt alors qu’elle void nos deſirs à ſa ſuitte.	C'est alors qu'elle voit nos désirs à sa suitte.
FLEVRIE.	FLEURIE.
Respondez donc, Silinde, à ces Meſſieurs icy?	Respondez donc, Silinde, à ces Messieurs ici?
Si vous le vouleZ bien, nous le voulons auſſi;	Si vous le voulez bien, nous le voulons aussi;
La fille rarement refuſe d’eſtre femme.	La fille rarement refuse d'être femme.
Il ſeroit mal ſeant que deuãt vous, Madame, Aucune de nous trois entrepriſt de parler:	Il serait mal séant que devant vous, Madame, Aucune de nous trois entreprît de parler:
Par tout ſousvoſtre eſprit le noſtre doit aller, Et ſuiuant de vos loix les plus obeiſſantes, Si vous le deſirez nous en ſerons contentes.	Par tout sousvotre esprit le vôtre doit aller, Et suivant de vos lois les plus obéissantes, Si vous le désirez nous en serons contentes.
Mr KAROLV.	Mr AROLU.
Meſſieurs,vous l’entendeZ, que deſicez-vous plus, Pas vne maintenant ne fait aucun refus;	Messieurs,vous l'entendez, que désicez-vous plus, Pas une maintenant ne fait aucun refus;
PreneZ chacun la voſtre, & apres vos partages Allons executer vos quatre mariages.	Prenez chacun la vôtre, et après vos partages Allons exécuter vos quatre mariages.
POLIANDRE.	POLYANDRE.
Madame, ſi iamais vn parfait amoureux A eu quelque ſujet de s’eſtimer heureux, Ie iuy venx diſpuier one faneui ſt prande, Puis qu'en vous poſſedant i'ay l’heur que ie demande.	Madame, si jamais un parfait amoureux A eu quelque sujet de s'estimer heureux, Je j' est dispuier one faneui st prande, Puis qu'en vous possédant j'ai l'heur que je demande.
SILINDE.	SILINDE.
Monſieur, aſſeurément vous vous trompe:	Monsieur, assurément vous vous trompe:
au choix, Regardez que Silinde eſt la moindre des trois.	au choix, Regardez que Silinde est la moindre des trois.
Pourtant ſi voſtre amour deſire ma perſonne, On uoſoun ponnon jni euie tt vons donne.	Pourtant si votre amour désire ma personne, On uosoun ponnon jni euie tant vons donne.
ROSELIS.	ROSELIS.
Ie confeſſe, Madame, auccques verité, Que dedans vos appas giſt ma felicité, Et que par le bon-heur de voſtre iouyſſancé, Ie ſeray le Phenix des Amans de la France.	Je confesse, Madame, auccques vérité, Que dedans vos appas gît ma félicité, Et que par le bonheur de votre iouyssancé, Je serai le Phénix des Amants de la France.
CLARISTE.	CLARISTE.
Le Ciel vous a pourueu de tant de qualiteZ, Qu'elles m'ont preſqu'oſté toutes mes volonteZ 5 De ſorte qu'à preſent il ne m'en reſte qu’vne, Pour ſelon vos deſirs ſuiure voſtre fortune.	Le Ciel vous a pourvu de tant de qualités, Qu'elles m'ont presqu'ôté toutes mes volontés 5 De sorte qu'à présent il ne m'en reste qu'une, Pour selon vos désirs suivre votre fortune.
BELANGE.	BÉLANGE.
Madame, puis qu’Amour comme ſon fauory Veut que preſentement ie ſois voſtre mary Receuez ce baiſer d'vne bouche enſlamee D’vn doux feu dont pour vous mon ame eſt conſommee.	Madame, puis qu'Amour comme son favori Veut que présentement je sois votre mari Recez ce baiser d'une bouche enslamee D'un doux feu dont pour vous mon âme est consommée.
FLORIANE.	FLORIANE.
Puis que voſtre baiſer doit eſtre ſi ardent, Permettez-moy, Monſieur, d’éuiter l’accidẽt Que ie pourrois courir d’vne ſi viue flame:	Puis que votre baiser doit être si ardent, Permettez-moi, Monsieur, d'éviter l'accident Que ie pourrais courir d'une si vive flamme:
Ponte-jois eſe aencomme de onſtre femine.	Ponte-jois eze aencomme de onstre femine.
FLEVRIE.	FLEURIE.
Sus, ſus, c’eſt aſſeZ dit, pour ne point differer, Allons diligemment les nopces prepareer, Marchons mon amitié.	Sus, sus, c'est assez dit, pour ne point différer, Allons diligemment les noces prépareer, Marchons mon amitié.
Mr KAROLV.	Mr AROLU.
axdons enere Paenr te, ertes ie penſe encor que ie me remarie?	axdons enère Paenr te, ertesprit pense encor que je me remarie?
Mr (HIEREMIE.	Mr (HIEREMIE.
Or puis que tout chacun ſe trouue ſi contant, Ie veux de mon coſté en faire tout autant Auec mon Vieux-Thodis, monſtrant à la ieuneſſe Que pour faire l’amour il n'eſt que la vieilleſſe.	Or puis que tout chacun se trouve si contant, Je veux de mon côté en faire tout autant Avec mon Vieux-Thodis, montrant à la jeunesse Que pour faire l'amour il n'est que la vieillesse.
Ar grace & priuilege du Roy, il eſt I permis à Iean Guignard, Marchand Libraire, d’imprimer ou faire imprimer, vendre & debiter vn liure intitulé, Alizon Comedie:	Ar grâce et privilège du Roi, il est I permis à Iean Guignard, Marchand Libraire, d'imprimer ou faire imprimer, vendre et débiter un livre intitulé, Alison Comédie:
auec deffences à tous Libraires, Imprimeurs, & autres de quelque qualité ou condition qu’ils ſoient, de faire imprimer, vendre ny diſtribuer ledit liure, durant le temps & eſpace de ſix ans, comme plus amplement eſt porté par ledit Priuilege.	auec deffences à tous Libraires, Imprimeurs, et autres de quelque qualité ou condition qu'ils soient, de faire imprimer, vendre ni distribuer ledit livre, durant le temps et espace de six ans, comme plus amplement est porté par ledit Privilège.
Donné à Paris le quinzieſme Iuillet mil ſix cens trenteſept, & de noſtre regne le vingt-ſeptieſ	Donné à Paris le quinzième Juillet mil six cens trentesept, et de notre règne le vingt-septies
Age 9.	Age 9.
vers 8.	vers 8.
liſez Rochebelle, au lieu de Rochelle.	lisez Rochebelle, au lieu de Rochelle.
I Page Io.	I Page Io.
vers 7.	vers 7.
liſez troubles, pour croubles.	lisez troubles, pour croubles.
Page 34, vers n.	Page 34, vers n.
liſez la Marne, au lieu de la meſme.	lisez la Marne, au lieu de la même.
Page 35.	Page 35.
vers 2.	vers 2.
liſez deux fois bien.	lisez deux fois bien.
Page37.	Page37.
vers 3.	vers 3.
liſez ie tenois, pour ſe tenois.	lisez ici tenais, pour se tenais.
Page 4o.	Page 4o.
vers 2.	vers 2.
liſez vrayment, pour vrayement.	lisez vraiment, pour vraiment.
Pagr 43.	Pagr 43.
vers 4.	vers 4.
liſez de s’eſloigner, pour deſloigner.	lisez de s'éloigner, pour déloigner.
Page 67.	Page 67.
vers ia.	vers ja.
liſez apportez, pour apporté.	lisez apportez, pour apporté.
Page 104.	Page 104.
vers 4.	vers 4.
liſez qui croyez, pour que croyez.	lisez qui croyez, pour que croyez.
Il y a des fautes en l’ortographe, & au nombre des Scenes de quelques actes, à quoy le Lecteur ſuppléera s’il luy plaiſt.	Il y a des fautes en l'ortographe, et au nombre des Scènes de quelques actes, à quoi le Lecteur suppléera s'il lui plaît.
Contraste insuffisant NF Z 43-120-14	Contraste insuffisant NIN Z 43-120-14
Contraste insuffisant NF Z 43-120-14	Contraste insuffisant NIN Z 43-120-14
