Extraict du Priuilege du Roy.	Extrait du Privilège du Roi.
PAR Grace & Priuilege du Roy, Donné à Paris,le 9.	PAR Grâce et Privilège du Roi, Donné à Paris, 9.
iour de luillet 1646.	jour de luillet 1646.
Signé, Par le Roy en ſon Conſeil, CONRART, Et ſcellé.	Signé, Par le Roi en son Conseil, CONRART, Et scellé.
Il eſt permis à AVGVSTIN COVRBE Marchand Libraire à Paris, d’imprimer ou faire imprimer, vendre & debiter vne Tragedie intitulée PERSELIDE, OV LA CONSTANCE D’AMOVR, auec deffences à tous Imptimeurs & Libraires, & autres de quelque qualité & condition qu’ils ſoient, de le contrefaire ny d’en vendre de contrefaits en quelque ſorte ny maniere que ce ſoit pendant le terme & eſpace de cinq ans, ſans le conſentement dudit expoſant, ſur les peines contenuës plus au long eſdites Lettres de Priuilege.	Il est permis à AUGUSTIN COURBE Marchand Libraire à Paris, d'imprimer ou faire imprimer, vendre et débiter un Tragédie intitulée PERSELIDE, OU LA CONSTANCE D'AMOUR, avec défenses à tous Imptimeurs et Libraires, et autres de quelque qualité et condition qu'ils soient, de le contrefaire ici d'en vendre de contrefaits en quelque sorte ny manière que ce soit pendant le terme et espace de cinq ans, sans le consentement dudit exposant, sur les peines contenues plus au long temps Plus au Long.
*	*
Acheué le treiZieſme iour d’Aouſt 1646.	Achevé le treizième jour d'Août 1646.
Les Exemplaires ont eſté fournis.	Les Exemplaires ont été fournis.
ACTEVRS.	ACTEURS.
AMINTHAS, Amant de Floriſelle.	AMINTHAS, Amant de Floriselle.
Amant de Eloriſelle,	Amant de Éloriselle,
MELAS,	MÊLAS,
CALLISTE, Sœur d’Aminthas, amoureuſe de Melas	CALLISTE, Sœur d'Aminthas, amoureuse de Mélas
ed citonnan, almouredle de Lucidor.	ed citonnan, alouredle de Lucidor.
PERSELIDE, Amoureuſe d’Aminthas.	PERSELIDE, Amoureuse d'Aminthas.
FLORIDOR, Frere de Perſelide.	FLORIDOR, Frère de Persélide.
CLORIMAN, Amy comiham	CLORIMAN, Ami comiham
LYSIS,	LYSIS,
Confident de Perſelide,	Confident de Persélide,
LVCIDOR, Perſelide deſguiſée en Page.	LUCIDOR, Persélide déguisée en Page.
PERSELIDE.	PERSELIDE.
OV LA CONSTANCE D’AMOVR.	OU LA CONSTANCE D'AMOUR.
TRAGI-COMEDIE.	TRAGI-COMÉDIE.
ACTE PREMIER.	ACTE PREMIER.
SCENE PREMIERE.	SCÈNE PREMIÈRE.
AMINTHAS, CALLISTE.	AMINTHAS, CALLISTE.
8588 *:	8588 *:
32882 M 1 AMINTHAS.	32882 M 1 AMINTHAS.
Alheureux Aminthas, aimable Floriſelle!	Alheureux Aminthas, aimable Floriselle!
Que l’vn eſtmiſerable, et que l’autre eſt craelle.	Que l'un estmisérable, et que l'autre est craelle.
11 35 Ta beauté, mon amour, ta rigueur, & le ſort Conspirent contre moy par vn commun accord.	11 35 Ta beauté, mon amour, ta rigueur, et le sort Conspirent contre moi par un commun accord.
Mais le mal le plus grand, dont l’excés me ſurmonte.	Mais le mal le plus grand, dont l'excès me surmonte.
L’inhumaine aujourd’huy fait gloire de ma honte.	L'inhumaine aujourd'hui fait gloire de ma honte.
Elle me voit bruſler, & ſe rit de mes feux, Son eſprit eſt touſiours inſenſible à mes vœux.	Elle me voit brûler, et se rit de mes feux, Son esprit est toujours insensible à mes vœux.
Miſerable Aminthas, aimable Perſelide.	Misérable Aminthas, aimable Persélide.
Qu'Amour cruellement te vange d’vn perfide.	Qu'Amour cruellement te venge d' perfide.
Si pour te ſatisfaire, il faut me voir puni, Tu ſçauras, qu'Aminthas ſouffre vn mal infini, Qu'Amour, & ta riuale ont quelque intelligence, Pour croiſtre mon tourment, & punir mon offence.	Si pour te satisfaire, il faut me voir puni, Tu sauras, qu'Aminthas souffre un mal infini, Qu'Amour, et ta rivale ont quelque intelligence, Pour croître mon tourment, et punir mon offense.
Calliſte cét Amour, ce grand tyran des Dieux, Quoy qu’il ſoit vn enfant, qu’il eſt malicieux:	Calliste cet Amour, ce grand tyran des Dieux, Quoi qu'il soit un enfant, qu'il est malicieux:
Tous ſes coups ſont mortels, la grandeur de ma peine Fait voir deuant nos yeux ſa rigueur inhumaine.	Tous ses coups sont mortels, la grandeur de ma peine Fait voir devant nos yeux sa rigueur inhumaine.
Ie n'ay plus d’eſperance en l’eſtat ou je ſuis;	Je n'ai plus d'espérance en l'état ou je suis;
Et le ſeul deſespoir peut finir mes ennuis.	Et le seul désespoir peut finir mes ennuis.
Chere ſœur as-tu veu la rigueur de ma belle, Du moins voy les effets de ſon amour cruelle.	Chère sœur as-tu vu la rigueur de ma belle, Du moins vois les effets de son amour cruelle.
CALLISTE.	CALLISTE.
Si j’oſois vous parler auecque verité, Mes diſcours blaſmeroient voſtre infidelité.	Si j'osais vous parler avec vérité, Mes discours blâmeraient votre infidélité.
Perſelide a raiſon de vous juger coupable, Floriſelle n'a rien, qui luy ſoit comparable.	Persélide a raison de vous juger coupable, Floriselle n'a rien, qui lui soit comparable.
AMINTHAS.	AMINTHAS.
Calliſte je le ſçay:	Calliste je le sais:
mes yeux en ſont teſmoins, Perſelide vaut mieux.	mes yeux en sont témoins, Persélide vaut mieux.
Mais quoy, je l’aime moins.	Mais quoi, je l'aime moins.
Floriſelle aujourd’huy triomphe de mon ame, (me.	Floriselle aujourd'hui triomphe de mon âme, (me.
Ses beaux yeux mes vainqueurs ont vn trait qui m’enflâMais qui dois-je accuſer, ſi je ſuis mal-heureux, Je cheris & mon mal, & l’ardeur de mes feux.	Ses beaux yeux mes vainqueurs ont un trait qui m'enflamMais qui dois-je accuser, si je suis malheureux, Je chéris et mon mal, et l'ardeur de mes feux.
O Dieux c’eſt ce qui rend ma douleur plus extréme, Ie ne puis malgré moy m'en prendre qu'à moy-meſme.	Ô Dieux c'est ce qui rend ma douleur plus extrême, Je ne puis malgré moi m'en prendre qu'à moi-même.
Ie ſçai bien que mon cœur peut rompre ſa priſon, Que de moy ſeulement dépend ma guariſon.	Je sais bien que mon cœur peut rompre sa prison, Que de moi seulement dépend ma garison.
Mais quoy qu’on me l’offrit, je l’aurois refusée.	Mais quoi qu’on me l'offrit, je l'aurais refusée.
O Dieux armés vos mains, punißés ma pensée, Inuentés contre moy quelque nouueau tourment.	Ô Dieux armez vos mains, punissez ma pensée, Inventés contre moi quelque nouveau tourment.
Ie parle encor en maiſtre, & non pas en amant.	Je parle encor en maître, et non pas en amant.
Ie ne ſuis plus à moy, Floriſelle eſt ma Reine, Elle doit commander comme vne ſouuerainé, Ou bien, pour mieux parler, c’eſt la diuinité Arbitre de ma vie, & de ma liberté Il eſt vray, qu’en dépit de ſon humeur cruelle, Mon cœur ſera touſiours ſouſmis à Floriſelle.	Je ne suis plus à moi, Floriselle est ma Reine, Elle doit commander comme une souuerainé, Ou bien, pour mieux parler, c'est la divinité Arbitre de ma vie, et de ma liberté Il est vrai, qu'en dépit de son humeur cruelle, Mon cœur sera toujours sousmis à Floriselle.
Le nœud du beau lien, qui l’attache eſt ſi fort, Que meſme il ne craint pas la fureur de la mort.	Le nœud du beau lien, qui l'attache est si fort, Que même il ne craint pas la fureur de la mort.
CALLISTE.	CALLISTE.
Mon frere vous flatez vn ſerpent qui vous tuë.	Mon frère vous flattez un serpent qui vous tue.
e qjes vuncagcemtat, dont coptre ait eſt decene.	 qjes vuncagcemat, dont coptre ait est décène.
AMINTHAS.	AMINTHAS.
Ah, c’eſt trop chere ſœur, apprend a parler mieux, Tu ſçais que j’ai pour guide vn Dieu qui n’a point d’yeux.	Ah, c'est trop chère sœur, apprend a parler mieux, Tu sais que j'ai pour guide un Dieu qui n'a point d'yeux.
Il eſt vray, que j’eus tort de quitter Perſelide;	Il est vrai, que j'eus tort de quitter Persélide;
Mais vn Amant peut-il voir plus clair, que ſon guide.	Mais un Amant peut-il voir plus clair, que son guide.
L’Amour en meſme temps me bruſlant de ſes feux Me priue de la veue, & me rend mal-heureux.	L'Amour en même temps me brûlant de ses feux Me prive de la vue, et me rend malheureux.
Si je manque en ce point, vn Dieu fait mon excuſe.	Si je manque en ce point, un Dieu fait mon excuse.
CAPLISTE.	CAPLISTE.
Non, non, c’eſt vn' erreur d’vn Amant qui s’abuſe.	Non, non, c'est un erreur d'un Amant qui s'abuse.
Detrompés voſtre esprit, ce qu’on appelle Amour Ne fut jamais vn Dieu, que le Ciel mit au jour, C’eſt vne paßion, de qui la violence Nous rend ſans jugement, ſans yeux, & ſans prudence:	Détrompez votre esprit, ce qu'on appelle Amour Ne fut jamais un Dieu, que le Ciel mit au jour, C'est toujours passion, de qui la violence Nous rend sans jugement, sans yeux, et sans prudence:
C’eſt vn deſreglement de noſtre volonté, Qui haſtit de ſon crime vne diuinite;	C'est un dérèglement de notre volonté, Qui hâtit de son crime une divinité;
Qui dedans ſon mal-heur deuenant inſolente Ne ſe contente pas du titre de ſeruante, Mais oſant meſpriſer les ordres de ſon Roy Parle contre raiſon de lui donner la loy:	Qui dedans son malheur devenant insolente Ne se contente pas du titre de servante, Mais osant mépriser les ordres de son Roi Parle contre raison de lui donner la loi:
Puis pour authoriſer ce crime deteſtable Commet vn ſacrilege, & ſe rend plus coupable.	Puis pour autoriser ce crime détestable Commet un sacrilège, et se rend plus coupable.
AMINTHAS.	AMINTHAS.
Ma ſœur ou diſons-nous vn éternel adieu, Ou parle à l’auenir plus ſagement d’vn Dieu.	Ma sœur ou disons-nous un éternel adieu, Ou le à l'avenir plus sagement d'un Dieu.
Tu ſçauras apres tout, que la force est à craindre De ce bras glorieux, qui m’oblige à me plaindre.	Tu sçauras après tout, que la force est à craindre De ce bras glorieux, qui m'oblige à me plaindre.
I'e ſens encor le coup, dont il bleſſa mon cœur, Je ſçai par ma douleur combien peut ce vainqueur.	J'e sens encor le coup, dont il blessa mon cœur, Je sais par ma douleur combien peut ce vainqueur.
Mais c’eſt trop raiſonner dans vn malheur extréme, Il ſuſit en vn mot pour tout diſcours:	Mais c'est trop raisonner dans un malheur extrême, Il susit en un mot pour tout discours:
que j’aime, Qu'Amour ſoit vn des Dieux, ou qu’il ne le ſoit pas, Floriſelle à mes yeux poſſede tant d’appas, Que mon cœur amoureux dans l’excez, de ſes peines Se ſent plus honoré, que preße de ſes cheſnes.	que j'aime, Qu'Amour soit un des Dieux, ou qu'il ne le soit pas, Floriselle à mes yeux possède tant d'appas, Que mon cœur amoureux dans l'excès, de ses peines Se sent plus honoré, que presse de ses chaînes.
Ma ſœur, ſi dans ton cœur vn reste d’amitié T’oblige à voir mon mal d’vn regard de pitié, Seconde mon amour, j'ai beſoin de ton aide, Ne m’abandonne pas, c’eſt mon dernier remede.	Ma sœur, si dans ton cœur un reste d'amitié T'oblige à voir mon mal d'un regard de pitié, Seconde mon amour, j'ai besoin de ton aide, Ne m'abandonne pas, c'est mon dernier remède.
Je ſçai que Floriſelle a de l’amour pour toi.	Je sais que Floriselle a de l'amour pour toi.
Laiſſe agir ta bonté, va lui parler de mos,	Laisse agir ta bonté, va lui parler de mos,
CALLISTE.	CALLISTE.
Connoiſſant Floriſelle, & ſon humeur hautaine.	Connaissant Floriselle, et son humeur hautaine.
Sçachant qu’elle ſe plaiſt à pareſtre inhumaine, I'euſſe bien deſire de guarir ton esprit, Et rendre ſans pouuoir le charme qui te prit.	Sachant qu'elle se plaît à paraître inhumaine, J'eusse bien désire de garir ton esprit, Et rendre sans pouvoir le charme qui te prit.
Puiſque quelque deſſein, qui ſe forme en mon ame, Ie ne puis esperer d’amortir cette flâme, Ie me rends à la fin, & malgré mes diſcours.	Puisque quelque dessein, qui se forme en mon âme, Je ne puis espérer d'amortir cette flamme, Je me rends à la fin, et malgré mes discours.
Ie veux à l’auenir approuuer tes amours.	Je veux à l'avenir approuver tes amours.
Ie veux meſme obliger ta belle impitoiable A regarder ton mal d’vn œil plus fauorable.	Je veux même obliger ta belle impitoyable A regarder ton mal d'un œil plus favorable.
AMINT HAS.	AMINT HAS.
Comment recompenſer cett' obligation, Ie n’attendois pas moins de ton affection.	Comment récompenser cett - obligation, Je n'attendais pas moins de ton affection.
Mais enfin chere ſœur ie crains, que Floriſelle Ne rende doublement mon ame criminelle.	Mais enfin chère sœur a crains, que Floriselle Ne rende doublement mon âme criminelle.
I'offençai Perſelide en luy manquant de foy, Et j’ay peur maintenant d’eſtre ingrat enuers toy.	J'offensai Persélide en lui manquant de foi, Et j'ai peur maintenant d'être ingrat envers toi.
Ce n'est pas qu'Aminthas ne veuille reconneſtre La grandeur de lamour, que tu lui fais pareſtre.	Ce n'est pas qu'Aminthas ne veuille reconnaître La grandeur de lamour, que tu lui fais paraître.
Mais le debte eſt ſi grand, dont tu m'as obligé, Qu’il me faudra touſiours demeurer engagé.	Mais le détte est si grand, dont tu m'as obligé, Qu'il me faudra toujours demeurer engagé.
Pardon, ie ſçai, ma ſœur, que ce diſcours t’offence, Ton cœur n'eſpere point aucune recompence, &l trep Selltrenx.	Pardon, Seigneur sais, ma sœur, que ce discours t'offense, Ton cœur n'espère point aucune récompense, etl trep Seltrenx.
CALLISTE.	CALLISTE.
Briſons-là ces propos.	Brisons-là ces propos.
Puiſque ton mal le veut, auançons ton repos.	Puisque ton mal le veut, avançons ton repos.
Enuoye à Floriſelle vn billet par ton Page, Ie veux voir quel effet produira ce meſſage.	Envoie à Floriselle un billet par ton Page, Je veux voir quel effet produira ce message.
AMINTIIAS.	AMINTIIAS.
Ah ma ſœur, qu’Aminthas.	Ah ma sœur, qu'Aminthas.
CALLISTE.	CALLISTE.
Va t'en eſcrire:	Va t'en écrire:
adieu.	adieu.
Reuien-tost, ſi tis peux;	Revien-tôt, si tis peux;
je t’attends en ce lieu,	je t'attends en ce lieu,
4 E A DE CATEEEAL.	4 E À DE CATEEEAL.
E	E
CALLISTE ſeule.	CALISTE seule.
A fortune eſt pour moy!	À fortune est pour moi!
de qui me dois-je plaindre.	de qui me dois-je plaindre.
T'Tout me vient à ſouhait, je n'ai plus rien à craindre, Ie puis tout esperer, nous ſommes deux contre vn, L’intereſt de monfrere, & le mieneſt commun.	T'Tout me vient à souhait, je n'ai plus rien à craindre, Je puis tout espérer, nous sommes deux contre un, L'intérêt de monfrere, et le mienest commun.
Que Melas aujourd’huy careſſe Floriſelle, Je ſçat, que je vaincray ſon amour infidelle, J'eſpere, que bien-toſt finira mon ennuy, Ou le frere, ou la ſœur triompheront de lui.	Que Mélas aujourd'hui caresse Floriselle, Je sat, que je vaincrai son amour infidèle, J'espère, que bientôt finira mon ennui, Ou le frère, ou la sœur triompheront de lui.
Il m’eſt indifferent d’en r'emporter la gloire, Ie cueïllerai le fruit qui ſuiura la victoire.	Il m'est indifférent d'en rapporter la gloire, Je cuellerai le fruit qui suivra la victoire.
L’ingrat ſera contraint de m’adreſſer ſes vœux, L’Amour dedans ſon cœur r’allumera ſes feux.	L'ingrat sera contraint de m'adresser ses vœux, L'Amour dedans son cœur rallumera ses feux.
Si mon frere Aminthas peut gagner Floriſelle, Mlelas ne voudra plus ſoupirer apres elle.	Si mon frère Aminthas peut gagner Floriselle, Mlelas ne voudra plus soupirer après elle.
Il ne pourra ſouffrir, qu’vn riual plus heureux Luy vienne trauerſer ſes deſſeins amoureux.	Il ne pourra souffrir, qu'un rival plus heureux Lui vienne traverser ses desseins amoureux.
Vn mespris, vn ſoupçon aigrira ſon couragé, C’est lors que ie verray reuenir ce volage.	Un mépris, un soupçon aigrira son couragé, C'est lors que ici verrai revenir ce volage.
Ie nage dans l’espoir, qui flatte mon esprit, De reuoir cét Amant, par qui l’Amour me prit.	Je nage dans l'espoir, qui flatte mon esprit, De revoir cet Amant, par qui l'Amour me prit.
Ie le voy, ce me ſemhle, implorer ma clemence, Ie luy veux accorder ſon pardon par auance.	Je le vois, ce me semhle, implorer ma clémence, Je lui veux accorder son pardon par avance.
Ah qu'Amour cét autheur des belles paßions Nous rend ingenieux dans nos affections.	Ah qu'Amour cet auteur des belles passions Nous rend ingénieux dans nos affections.
Les diſcours, que j’ay faits pour engager mon frere, Ont produit vn effet, qui leur ſembloit contraire.	Les discours, que j'ai faits pour engager mon frère, Ont produit un effet, qui leur semblait contraire.
L’Amour eſt vn enfant, qui parmi ſes plaiſirs Veut ſouuent, qu’vn refus augmente ſes deſirs.	L'Amour est un enfant, qui parmi ses plaisirs Veut souvent, qu'un refus augmente ses désirs.
Alors que j'ayblaſmé les deſſeins de ſon Ame, Ie n’ai fait, que jetter de l’huiſle ſur la flame.	Alors que j'ayblasmé les desseins de son Âme, Je n'ai fait, que jeter de l'huisle sur la flamme.
Cét eſprit inconſtant eſt enfin arreſté, Ie ne crains plus les traits de ſa legereté.	Cet esprit inconstant est enfin arrêté, Je ne crains plus les traits de sa légèreté.
Mais voicy qu’il reuient:	Mais voici qu'il revient:
dißimulons encore.	dissimulons encore.
Angmentons, s’il ſe peut, le feu qui le deuore.	Angmentons, s'il se peut, le feu qui le dévore.
a¬.	a¬.
S – 1 E N L TROISIESME.	 SO 1 E N E -TROISIÈME.
AMINTHAS, CALLISTE, LVCIDOR.	AMINTHAS, CALLISTE, LUCIDOR.
AMINTHAS.	AMINTHAS.
A ſœur voicy la lettre, allons l’ouurir au jour, Tu verras ſi c'eſt mal exprimer ſon amour.	À sœur voici la lettre, allons l'ouvrir au jour, Tu verras si c'est mal exprimer son amour.
CALLISTE liſant la Lettre.	CALISTE lisant la Lettre.
Elle ne croyez-pas, qu’vn Amant miſerable 13 Vous parle de l'excez de ſon affection.	Elle ne croyez-pas, qu'un Amant misérable 13 Vous parle de l'excès de son affection.
Vous ne pouuez douter qu’elle eſt ma paſſion N’ignorant pas combien Floriſelle eſt aimable.	Vous ne pouvez douter qu'elle est ma passion N'ignorant pas combien Floriselle est aimable.
Il faut puiſqu’il vous plaiſt, que mon cœur diſſimule:	Il faut puisqu'il vous plaît, que mon cœur dissimule:
Bien qu’en ce point je ſouffre vn tourment ſans égal.	Bien qu'en ce point je souffre un tourment sans égal.
Si voſtre cruauté ſe moque de mon mal, Du moins voyez mes maux, & ſouffrez que je brûle.	Si votre cruauté se moque de mon mal, Du moins voyez mes maux, et souffrez que je brûle.
Ce diſcours va fort bien, il n’y faut rien changer, Ie veux que Lucidor en ſoit le Meſſager.	Ce discours va fort bien, il n'y faut rien changer, Je veux que Lucidor en soit le Messager.
AMINTHAS.	AMINTHAS.
Connois-tu Lucidor cét objet adorable, De qui la cruauté m’a rendu miſerable.	Connais-tu Lucidor cet objet adorable, De qui la cruauté m'a rendu misérable.
Tu vois cher Lucidor, que ie ſuis amoureux, Sçache que Floriſelle eſt cauſe de mes feux.	Tu vois cher Lucidor, que je suis amoureux, Sçache que Floriselle est cause de mes feux.
Porte luy ce billet, prend garde à ſon viſage, Et ma vie, & ma mort depend de ton meſſage.	Porte eux ce billet, prend garde à son visage, Et ma vie, et ma mort dépend de ton message.
Parle luy, ſi tu veux, de mon affection, Que l’on ne vit iamais d’eſgalle paßion.	Parle -moi, si tu veux, de mon affection, Que l'on ne vit jamais d'égale passion.
Va, dis-luy, qu’en depit de ſon humeur farouche Le nom de Floriſelle eſt touſiours dans ma bouche.	Va, dis-lui, qu'en dépit de son humeur farouche Le nom de Floriselle est toujours dans ma bouche.
Que pluſtoſt le Soleil eſclairera la nuit;	Que plutôt le Soleil éclairera la nuit;
Et preſtera ſon Char à ſa ſœur, qui le fuit, Ou que pluſtoſt le temps changera la nature, Que l’exceZ de l’amour, que mon ame lui jure.	Et prêtera son Char à sa sœur, qui le fuit, Ou que plutôt le temps changera la nature, Que l'excès de l'amour, que mon âme lui jure.
CALLISTE.	CALLISTE.
Veux-tu donc arreſter Lucidor tout vn jour, Depuis qu'on le retient il ſeroit de retour.	Veux-tu donc arrêter Lucidor tout un jour, Depuis qu'on le retient il serait de retour.
S - 4 Pi N AVAXTRTESME.	S - 4 Pi NY AUAXTRTESME.
LVCIDOR ſeule.	LUCIDOR seule.
E	E
STANCES.	STANCES.
Mour, qui bleſſes ma penſée!	Mour, qui blesses ma pensée!
AAy-je donc trop peu d’ennemis, De ceux que le Ciel a commis, Pour tourmenter vn’inſensée!	AI-je donc trop peu d'ennemis, De ceux que le Ciel a commis, Pour tourmenter uneinsensée!
N'eſt-ce pas aſſeZ, que tes feux Attaquent vn cœur mal-heureux, Vne riuale pour me nuire Fait, qu'vn ingrat fauce ſa foy!	N'est-ce pas assez, que tes feux Attaquent un cœur malheureux, Vienne rivale pour me nuire Fait, qu'un ingrat fauce sa foi!
Mais falloit-il pour me deſtruire, Que tu m'armaſſes contre moy.	Mais fallait-il pour me détruire, Que tu m'armasses contre moi.
Aimable cauſe de ma flâme, Cher autheur de ma paßion Reuoque ta commißion:	Aimable cause de ma flamme, Cher auteur de ma passion Révoque ta commion:
Pren garde au trouble de mon ame?	Pren garde au trouble de mon âme?
Dois-je faire ce que tu veux!	Dois-je faire ce que tu veux!
Serai-je contraire a mes vœux!	Serai-je contraire à mes vœux!
Dois-je obeir, ma peine eſt grande, Ie ne ſçai, ce que ie pretends, Mon amour qui me le commande, Me le deffend en meſme temps.	Dois-je obéir, ma peine est grande, Je ne sais, ce que je prétends, Mon amour qui me le commande, Me le défend en même temps.
L’amour, dont te ſuis combattué, Qui me fait aimer Aminthas, Quoy que l’ingrat ne m'aime pas, Me fait cherir, ce qui me tue.	L'amour, dont te suis combattué, Qui me fait aimer Aminthas, Quoi que l'ingrat ne m'aime pas, Me fait chérir, ce qui me tue.
Je ſçai, que le Ciel dont l’arreſt Fait noſtre fort comme il luy plaiſt:	Je sais, que le Ciel dont l'arrêt Fait notre fort comme il lui plaît:
M'ordonne d’aimer vn perfide.	M'ordonne d'aimer un perfide.
Et que mespriſant mes deſirs, Et lintereſt de Perſelide,	Et que méprisant mes désirs, Et linterest de Persélide,
de tiy preenre jes playny:	de ty prévenre jes plaini:
Mais il faut außi, que ie m’aime, Dans ce contraire ſentiment Je ne puis ſeruir mon amant Sans conſpirer contre moi-meſme.	Mais il faut aussi, que ainsi m'aime, Dans ce contraire sentiment Je ne puis servir mon amant Sans conspirer contre moi-même.
L’amour s’oppoſe à mon amour, Ie me fais la guerre à mon tour.	L'amour s'oppose à mon amour, Je me fais la guerre à mon tour.
Cependant ie ſuis amoureuſe, Ie meurs, & par vn cruel ſort Pour me rendre puit miut neureuſe Tous ces contraires ſont d’accord.	Cependant mot suis amoureuse, Je meurs, et par un cruel sort Pour me rendre puit mû neureuse Tous ces contraires sont d'accord.
Mais ſi l’ingrat est vn perfide, Faut il, que trompant mon deſſoin, Je porte le fer dans mon ſein, Et deuienne mon homicide.	Mais si l'ingrat est un perfide, Faut -il, que trompant mon dessoin, Je porte le fer dans mon sein, Et devienne mon homicide.
O Ciel vois-tu l’extremité, Ou me reduit ta cruauté.	Ô Ciel vois-tu l'extrémité, Ou me réduit ta cruauté.
Ie ſçai bien, ce que ie dois faire, Mais mon amour, ou mon mal-heur Me force a ſuiure le contraire, Meſme au meſpris de mon honneur.	Je sais bien, ce que ici dois faire, Mais mon amour, ou mon malheur Me force a suivre le contraire, Même au mépris de mon honneur.
SCE N E CINQVIESME, LVCIDOR, LYSIS.	SCE N INQUIESME, LUCIDOR, LYSIS.
LVCIDOR.	LUCIDOR.
J'Oy Lyſis à quel point le deſtin m’a reduite, V Et pleure auecque moy les mal-heurs de ma fuite, Depuis le temps, qu'Amour eſt entré dans mon cœur, Et qu’vn perfide amant l’a rendu mon vainqueur.	J'Oy Lys à quel point le destin m'a réduite, VOit pleure auecque moi les malheurs de ma fuite, Depuis le temps, qu'Amour est entré dans mon cœur, Et qu'un perfide amant l'a rendu mon vainqueur.
Voy comment ce tyran, pour croiſtre mon martire, Exerce auec rigueur contre moy ſon Empire.	Vois comment ce tyran, pour croître mon martyre, Exerce avec rigueur contre moi son Empire.
Ce n’est pas, cher Liſis, qu’en ce point mal-heureux, Ce n'eſt pas, que mon cœur ſe plaigne de ces ſeux.	Ce n'est pas, cher Lis, qu'en ce point malheureux, Ce n'est pas, que mon cœur se plaigne de ces seux.
Malgré les ſentimens d’vn amant infidelle, Leur cauſe m’eſt aimable, & leur flâme eſt trop belle.	Malgré les sentiments d'âme amant infidèle, Leur cause m'est aimable, et leur flamme est trop belle.
Mais quoy que mon amour cheriſſe ſa douleur, Que mon bon-heur conſiſte en mon propre mal-heur, Le faſcheux deſeſpoir, dont ie ſens les atteintes Oblige bien ſouuent mon eſprit à des plaintes.	Mais quoi que mon amour chérisse sa douleur, Que mon bonheur consiste en mon propre malheur, Le fâcheux désespoir, dont ie sens les atteintes Oblige bien souvent mon esprit à des plaintes.
Jl ne me faſche point, qu’vn ingrat auiourd’huy Oblige ſon amante à courir apres luy, Non, ie n’accuſe point ſon humeur d’inconſtance, Contre mon intereſt i'entreprens ſa deffence:	Il ne me fâche point, qu'un ingrat aujourd'hui Oblige son amante à courir après avoir, Non, je n'accuse point son humeur d'inconstance, Contre mon intérêt j'entreprends sa défense:
Mais qu’vn ſort rigoureux me force en ce moment A trauailler moi-meſme à perdre mon amant, Et que par vn excez d'vn amour ſans eſgale Je trahiſſe mon cœur, & ſerue ma riuale.	Mais qu'un sort rigoureux me force en ce moment À travailler moi-même à perdre mon amant, Et que par un excès d'un amour sans égale Je trahisse mon cœur, et serve ma rivale.
LYSIS.	LYSIS.
Ie n’oſe pas icy condamner vos amours, Mais ie ne ſçai comment vous donner du ſecours.	Je n'ose pas ici condamner vos amours, Mais je ne sais comment vous donner du secours.
Si iadis mon conſeil euſt rien peu ſur voſtre ame, Vous ſerieZ hors de peine, & tous deux hors de blaſme.	Si jadis mon conseil eût rien pu sur votre âme, Vous seriez hors de peine, et tous deux hors de blâme.
LVCIDOR.	LUCIDOR.
Alors qu’il m’en ſouuient, le penſer odieux Arrache inceſſamment des larmes de mes yeux.	Alors qu'il m'en souvient, le penser odieux Arrache incessamment des larmes de mes yeux.
fl faut, qu’apres auoir conſpire ma deffaitte, "4	fl faut, qu'après avoir conspire ma défaite, "4
Jls lauent dans leurs eaux la faute, qu’ils ont faite.	Ils lavent dans leurs eaux la faute, qu'ils ont faite.
Mais du moins, cher Lyſis, dans mon affliction Ie demeure obligée à ton affection.	Mais du moins, cher Lysis, dans mon affliction Je demeure obligée à ton affection.
Cependant que le Ciel, qu’vn amant, que moy-meſme Oſent m'abandonner dans vn malheureux extréme, Toy ſeul en ce rencontre as aſſeZ de bonté Pour ne me quitter point en cette exttemité.	Cependant que le Ciel, qu'un amant, que moi-même Osent m'abandonner dans un malheureux extrême, Toi seul en ce rencontre as assez de bonté Pour ne me quitter point en cette exttemité.
Mais voi comment l’amour engage vne perſonne, Qui ſuit aueuglement les conſeils, qu’il lui donne.	Mais voi comment l'amour engage une personne, Qui suit aveuglement les conseils, qu'il lui donne.
Tu ſçais les ſentimens de mon cœur amoureux, Que les yeux d’Aminthas allumerent mes feux!	Tu sais les sentiments de mon cœur amoureux, Que les yeux d'Aminthas allumèrent mes feux!
qu'Amour tes plaiſirs ſont de peu de durée, Leur joye eſt incertaine, & leur perte aſſeurée, Tu n'és rien, qu'vn ſerpent, que noſtre cœur nourrit, Qui flattes nos deſirs, & trompes noſtre esprit:	qu'Amour tes plaisirs sont de peu de durée, Leur joie est incertaine, et leur perte assurée, Tu n'avez rien, qu'un serpent, que notre cœur nourrit, Qui flattes nos désirs, et trompes notre esprit:
O cruel ſouuenir de ma gloire paßée, Dont la priuation rend mon ame inſensée.	Ô cruel souvenir de ma gloire passée, Dont la privation rend mon âme insensée.
Elhr.	Elhr.
44 Si jamais j’eus de part à tes moindres faueurs?	44 Si jamais j'eus de part à tes moindres faveurs?
Qu'auecque cruauté j'espreuue tes rigueurs.	Qu'avec cruauté j'épreuve tes rigueurs.
C’eſt peu, que ta fureur m'ait eſté ſi contraire, Qu’il m’ait falu quitter la maiſon de mon pere Pour ſuiure vn inconſtant, ou bien pluſtoſt mon cœur, Qui m'oſoit delaiſſer pour ſuiure ſon voleur.	C'est peu, que ta fureur m'ait été si contraire, Qu'il m'ait fallu quitter la maison de mon père Pour suivre un inconstant, ou bien plutôt mon cœur, Qui m'osait délaisser pour suivre son voleur.
Voy ce papier Lyſis!	Vois ce papier Lysis!
en connois-tu la lettre.	en connais-tu la lettre.
C’eſt le plus grand aſſaut, que m'ait liuré ce traiſtre.	C'est le plus grand assaut, que m'ait livré ce traître.
Voy ce papier, Lyſis, & pleure auecque moy L'exceZ de ces mal-heurs, où m’engage ma foy.	Vois ce papier, Lysis, et pleure avec moi L'excès de ces malheurs, où m'engage ma foi.
Tu ſçais, que mon amant ne me fut infidelle, Qu'à meſme, que ſes yeux eurent veu Floriſelle, Il ſortit de mes fers pour entrer dans les ſiens, Les feux de ma riuale eſteignirent les miens.	Tu sais, que mon amant ne me fut infidèle, Qu'à même, que ses yeux eurent veu Floriselle, Il sortit de mes fers pour entrer dans les siens, Les feux de ma rivale éteignirent les miens.
Voi ce papier, Lyſis, c’eſt le coup le plus rude, Que i’ay iamais receu de ſon ingratitude.	Vois ce papier, Lysis, c'est le coup le plus rude, Que j'ai jamais reçu de son ingratitude.
C’eſt vn billet d’amour, que ce perfide eſcrit, Et c’eſt ce qui le plus tourmente mon eſprit, Qu'il me faille moi-meſme en eſtre la porteuſe, Et chercher le remede à ſa peine amoureuſe.	C'est un billet d'amour, que ce perfide écrit, Et c'est ce qui le plus tourmente mon esprit, Qu'il me faille moi-même en être la porteuse, Et chercher le remède à sa peine amoureuse.
LYSIS.	LYSIS.
Calme vn peu ces tranſports, arreſte enfin tes pleurs, L’amour t’offre un moyen pour finir tes mal-heurs.	Calme un peu ces transports, arrête enfin tes pleurs, L'amour t'offre un moyen pour finir tes malheurs.
Iamais l’occaſion ne s’offrira ſi belle, Pour vanger les mespris d’vn amant infidelle.	Jamais l'occasion ne s'offrira si belle, Pour venger les mépris d'un amant infidèle.
Trahiſſons vn ingrat:	Trahissons un ingrat:
il nous eſt bien permis D'vſer de perfidie enuers nos ennemis.	il nous est bien permis D'user de perfidie envers nos ennemis.
LVCIDOR.	LUCIDOR.
Mon amour eſt montée en vn point ſi ſupréme, Que ſi i’aime Aminthas, ie l’aime pour lui-meſme:	Mon amour est montée en un point si suprême, Que si j'aime Aminthas, toujours l'aime pour lui-même:
Que ſi ie me portois à trahir mon amant, Je trahirois außi mon propre ſentiment.	Que si ici me portais à trahir mon amant, Je trahirais aussi mon propre sentiment.
LYSIS.	LYSIS.
Quelle façon d’aimer, que d’aimer pour vn autre, Vous prefereZ le bien d’vne riuale au vostre.	Quelle façon d'aimer, que d'aimer pour un autre, Vous préférez le bien d'une rivale au vôtre.
LVCIDOR.	LUCIDOR.
C’eſt ainſi, que l’amour, cét esprit inconſtant Par ce qu’il n’eſt qu’vn enfant, me gouuerne en enfant, Qui m’ayant fait ſentir ſa rigueur, qui me tuë, Me contraint de baiſer la main, qui m’a battué.	C'est ainsi, que l'amour, cet esprit inconstant Par ce qu'il n'est qu'un enfant, me gouverne en enfant, Qui m'ayant fait sentir sa rigueur, qui me tue, Me contraint de baiser la main, qui m'a battué.
Le deſſein, que i’ay pris, l’espoir, qui me conduit, N’eſt point de r’amener cét amant, qui me fuit.	Le dessein, que j'ai pris, l'espoir, qui me conduit, N'est point de ramener cet amant, qui me fuit.
Ie veux deuant ſes yeux lui prouuer ma conſtance, Puis par vn coup heureux mourir en ſa preſence.	Je veux devant ses yeux lui prouver ma constance, Puis par un coup heureux mourir en sa présence.
LYSIS.	LYSIS.
Mais quel fruit croyeZ-vous en pouuoir retirer.	Mais quel fruit croisez-vous en pouvoir retirer.
LVCIDOR.	LUCIDOR.
Peut-eſtre cét ingrat, qui m’oblige a pleurer, Et dont la cruaute ſe moque de ma flâme, Aura voyant ma mort vn regret dedans l’ame.	Peut-être cet ingrat, qui m'oblige a pleurer, Et dont la cruauté se moque de ma flamme, Aura voyant ma mort un regret dedans l'âme.
Peut-estre qu'à la fin condemnant ſa froideur, Il voudra par ſes pleurs ſoulager mon ardeur.	Peut-être qu'à la fin condamnant sa froideur, Il voudra par ses pleurs soulager mon ardeur.
LYSIS.	LYSIS.
Quoy que toûjours l’amour dans ton eſprit combatte, Sçache, que c’est en vain, que cét eſpoir te flatte.	Quoi que toujours l'amour dans ton esprit combatte, Sache, que c'est en vain, que cet espoir te flatte.
Qu'à la fin Aminthas, ainſi que tu le veux, Se rende apres ta mort fauorable à tes vœux!	Qu'à la fin Aminthas, ainsi que tu le veux, Se rende après ta mort favorable à tes vœux!
Quel ſera ton deſſein!	Quel sera ton dessein!
en peux-tu rien pretendre!	en peux-tu rien prétendre!
Verras-tu ſoulager les ardeurs de tacendre, Quand la main de la mort oſte à nos yeux le jour, Nos ſens ne gouſtent plus les plaiſirs de l’amour.	Verras-tu soulager les ardeurs de tacendre, Quand la main de la mort ôte à nos yeux le jour, Nos sens ne goûtent plus les plaisirs de l'amour.
LVCIDOR Ton conſeil, cher Lyſis.	LUCIDOR Ton conseil, cher Lysis.
& les yeux du perfide Allumerent le feu, qui bruſle Perſelide.	et les yeux du perfide Allumèrent le feu, qui brûle Persélide.
LYSIS.	LYSIS.
Si iamais mon eſprit fut d’aduis auec toi, D’eſtimer Aminthas, & lui donner ta foi:	Si jamais mon esprit fut d'avis Seigneur toi, D'estimer Aminthas, et lui donner ta foi:
C’eſt lors, que ton honneur te le pouuoit permettre, Tu pouuois, ſans rougir;	C'est lors, que ton honneur te le pouvait permettre, Tu pouuois, sans rougir;
le receuoir pour Maiſtre.	le recevoir pour Maître.
Mais puiſque cet ingrat a voulu te quitter, Ie blaſme ton deſſein, ie ne puis te flatter.	Mais puisque cet ingrat a voulu te quitter, Je blâme ton dessein, et ne puis te flatter.
Que ton cœur ſe propoſe vne fin legitime;	Que ton cœur se propose une fin légitime;
T on procedé ſera condamné camme vn crime.	T on procédé sera condamné camme un crime.
C’eſt le mal-heur dù ſexe.	C'est le malheur dù sexe.
LVCIDOR Il faut donc que l’honneur, Qui n’eſt rien, qu’vn vain nom, empeſche mon bonheur, Et que ſuiuant vn bien, qui n’eſt, qu’en apparance, Je trompe mon amour, & perde l’esperance.	LUCIDOR Il faut donc que l'honneur, Qui n'est rien, qu'un vain nom, empêche mon bonheur, Et que suivant un bien, qui n'est, qu'en apparance, Je trompe mon amour, et perde l'espérance.
C’eſt vn raiſonnement de ces eſprits réueurs, Qui croyoient, mais en vain, eſteindre nos ardeurs.	C'est un raisonnement de ces esprits rêveurs, Qui croyaient, mais en vain, éteindre nos ardeurs.
Peut eſtre dirés-vous, que dedans cet affaire Ie vay ſuiure vn conſeil, qui peut faſcher mon pere:	Peut être direz-vous, que dedans cet affaire Je vais suivre un conseil, qui peut fâcher mon père:
Conſultons la nature, eſcoutons bien ſa loy, Iamais on ne deut tant à ſonpere, qu'à ſoy!	Consultons la nature, écoutons bien sa loi, Jamais on ne déut tant à sonpère, qu'à soi!
C n)	Ç n)
Eſt-ce pour nous regler ſelon leur fantaiſie, Ou ſelon nos deſirs, qu’ils nous donnent la vie.	Est-ce pour nous régler selon leur fantaisie, Ou selon nos désirs, qu'ils nous donnent la vie.
Le Ciel nous rend Seigneurs de noſtre liberté!	Le Ciel nous rend Seigneurs de notre liberté!
Pourquoy trahir les droits de noſtre volonté.	Pourquoi trahir les droits de notre volonté.
Si ie manque en ce point!	Si belle manque en ce point!
eſt-iltemps de s’en plaindre, Il falloit m’aduertir, lorſque ie pouuois craindre.	est-iltemps de s'en plaindre, Il fallait m'avertir, lorsque notre pouvais craindre.
Ton conſeil m’importune, il n'est plus de ſaiſon, Mon amour me deffend d’eſcouter de raiſon, Blaſme-le, s’il te plaiſt, quoi que tu puiſſes dire, Sçache, que ie ſuiurai le conſeil qu’il m’inspire.	Ton conseil m'importune, il n'est plus de saison, Mon amour me défend d'écouter de raison, Blâme-le, s'il te plaît, quoi que tu puisses dire, Sache, que ainsi suivrai le conseil qu'il qu'inspire.
L'ingrat a beau payer mon amour de mespris, Je veux touſiours l’aimer, le conſeil en eſt pris.	L'ingrat a beau payer mon amour de mépris, Je veux toujours l'aimer, le conseil en est pris.
Si mon cruel aman tir utaui perpor, Faut-il qu’vn meſme crime accuſe Perſelide.	Si mon cruel aman tir utaui perpor, Faut-il qu'un même crime accuse Persélide.
Non, non:	Non, non:
pluſtoſt l’enfer s’ouurira ſous mes pas.	plutôt l'enfer s'ouvrira sous mes pas.
Que mon cœur amoureux abandonne Aminthas.	Que mon cœur amoureux abandonne Aminthas.
Fin du premier Acte.	Fin du premier Acte.
A I R DE VXIESME.	À I R DE VXIESME.
SCENE PREMIERE,	SCÈNE PREMIÈRE,
FLORISELLE ſeule.	FLORISELLE seule.
*3 Ou vient, que mon esprit parmi les ſolitudes 263 *Cherche à m’entretenir dans des inquietudes;	*3 Ou vient, que mon esprit parmi les solitudes 263 *Cherche à m'entretenir dans des inquiétudes;
2 281 Ie me plais a reuer dans les lieux eſcartez, Où iamais le Soleil n’enuoya ſes clarteZ:	2 281 Je me plais a rêver dans les lieux écartés, Où jamais le Soleil n'envoya ses clartés:
Les diuertiſſements, qui m’eſtoient ordinaires, Et charmoient mes ennuis me deuiennent contraires:	Les divertissements, qui m'étaient ordinaires, Et charmaient mes ennuis me deviennent contraires:
I'eſleue cependant les mains deuers les Cieux:	J'élève cependant les mains devers les Cieux:
Mais mon eſprit ne ſçait, que demander aux Dieux.	Mais mon esprit ne sait, que demander aux Dieux.
Ce qui me faſche plus dans ce mal-heur extreme, Ie me ſuis bien ſouuent ennuyeuſe à moy meſme.	Ce qui me fâche plus dans ce malheur extrême, Je me suis bien souvent ennuyeuse à moi -même.
Alors que le Soleil va cacher ſon flambeau, Que la nutt vient ſur nous eſtendre ſon manteau, Mon œil m’abandonnant au ſoin, qui me deuore Attend ſans ſe fermer le retour de l’aurore.	Alors que le Soleil va cacher son flambeau, Que la nut vient sur nous étendre son manteau, Mon œil m'abandonnant au soin, qui me dévore Attend sans se fermer le retour de l'aurore.
Que ſi mes yeux laſſés ſe faſchent d’eſtre ouuerts, Mon ſommeil eſt troublé de cent ſonges diuers.	Que si mes yeux lassès se fâchent d'être ouverts, Mon sommeil est troublé de cent songes divers.
Le Page d’Aminthas, cet enfant agreable Cauſe le changement, qui me rend miſerable.	Le Page d'Aminthas, cet enfant agréable Causse le changement, qui me rend misérable.
Sa grace ſans pareille en tout temps, en tous lieux, Sans ceſſe, malgré moy, ſe preſente à mes yeux.	Sa grâce sans pareille en tout temps, en tous lieux, Sans cesse, malgré moi, se présente à mes yeux.
Touſiours ce ſeul obiet occupe ma penſee, Songe à toy Floriſelle!	Toujours ce seul objet occupe ma pensée, Songe à toi Floriselle!
es-tu point inſenſée, Seroit-ce point l’amour, qui s’attaque à ton cœur, Qui veut par ce moyen ſe rendre ton vainqueur.	es-tu point insensée, Serait-ce point l'amour, qui s'attaque à ton cœur, Qui veut par ce moyen se rendre ton vainqueur.
Si l’amour fait trouuer un viſage agreable, Que Lucidor eſt beau, que ce Page eſt aimable, Que s’il n'est, qu’vn deſir d’vne poſſeßion, De l’obiet, qui peut plaire à noſtre eſlection!	Si l'amour fait trouver un visage agréable, Que Lucidor est beau, que ce Page est aimable, Que s'il n'est, qu'un désir d'une possession, De l'objet, qui peut plaire à notre élection!
Puiſi’encor ignorer, que ie ſuis malheureuſe:	Puisque Pencor ignorer, que sans suis malheureuse:
C’en eſt fait, ie voy bien, que ie ſuis amoureuſe.	C'en est fait, ie vois bien, que je suis amoureuse.
Mon eſprit eſperdu court apres Lucidor,	Mon esprit éperdu court après Lucidor,
Dans ſa poſſeßion ie mets tout mon treſor.	Dans sa possession Seigneur mets tout mon trésor.
Mon cœur auec le ſien ou s’enuole, ou s’arreſte, Cependant ie me plais dans les maux, qu’il m’appreste!	Mon cœur avec le sien ou s'envole, ou s'arrête, Cependant ie me plais dans les maux, qu'il m'apprête!
Mais quel but apres tout me puis-je propoſer!	Mais quel but après tout me puis-je proposer!
Quel deſſein puis-i’auoir!	Quel dessein puis-j'avoir!
le pretens-ie espouſer.	le prétends-je épouser.
Ce deſir est conçeu ſans aucune apparence.	Ce désir est conçu sans aucune apparence.
C'eſt en vain, que ie fonde vne telle esperance;	C'est en vain, que ici fonde un telle espérance;
Et quand bien ie pourrois m’oublier à ce point, Monfrere auroit raiſon de n’y conſentir point.	Et quand bien ie pourrais m'oublier à ce point, Monfrere aurait raison de n'y consentir point.
Je bruſle toutesfois, mon cœur eſt tout en flame, Ie ne puis plus ſouffrir les ardeurs de mon ame.	Je brûle toutefois, mon cœur est tout en flamme, Je ne puis plus souffrir les ardeurs de mon âme.
Ah c’eſt trop raiſonner, agiſſons hardiment, Ie veux, ſi ie le puis, m’acquerir cét amant.	Ah c'est trop raisonner, agissons hardiment, Je veux, si tu le puis, m'acquérir cet amant.
Mais voicy l’ennemy qui me rend inſensée, Faiſons luy voir le coup, dont mon ame eſt bleßée.	Mais voici l'ennemi qui me rend insensée, Faisons tu voir le coup, dont mon âme est blessée.
8 7	8 7
LVCIDOR.	LUCIDOR.
Je ſçay qu’il eſt bien vray, qu’en ce temps, où nous ſommes, On craint auec raiſon de ſe fier aux hommes.	Je sais qu'il est bien vrai, qu'en ce temps, où nous sommes, On craint avec raison de se fier aux hommes.
Mais voyeZ, qu’en voulant accuſer Aminthas, Vous ne le figurieZ tout autre, qu’il n'eſt pas.	Mais voyeZ, qu'en voulant accuser Aminthas, Vous ne le figuriez tout autre, qu'il n'est pas.
Non, non:	Non, non:
vous en deuez, condamner la pensée.	vous en devez, condamner la pensée.
Voſtre beauté pourroit s’en trouuer offensée.	Votre beauté pourrait s'en trouver offensée.
CroyeZ-vous, qu’Aminthas, ie parle ſans flatter, Quoy qu’il eut ce deſſein, vous peut jamais quitter.	Croyez-vous, qu'Aminthas, Elle parle sans flatter, Quo qu’il eut ce dessein, vous peut jamais quitter.
Vos attraits tout diuins ont aſſez de puiſſance, Pour arreſter l’esprit de la meſme inconstance.	Vos attraits tout divins ont assez de puissance, Pour arrêter l'esprit de la même inconstance.
F LORISELLE.	 FORISELLE.
Ce n'eſt pas vainement, que ie forme vn ſoupçon.	Ce n'est pas vainement, que ici forme soupçon.
Ie veux, que Lucidor approuue ma raiſon.	Je veux, que Lucidor approuve ma raison.
Aminthas fit bien voir, qu’il eſtoit vn perfide, Alors que ſans ſujet il quitta Perſelide.	Aminthas fit bien voir, qu'il était un perfide, Alors que sans sujet il quitta Persélide.
Je ne croiray jamais retenir cet esprit, Apres que Perſelide a perdu ſon credit.	Je ne croirai jamais retenir cet esprit, Après que Persélide a perdu son crédit.
LVCIDOR.	LUCIDOR.
Je connoy Perſelide, & ie voy Floriſelle, Quoy qu’on puiſſe inuenter, Floriſelle eſt plus belle.	Je connais Persélide, et ainsi vois Floriselle, Quoi qu'on puisse inventer, Floriselle est plus belle.
Il eſt vray, que jamais de mon conſentement Aminthas n’eut changé, pour eſtre voſtre amant.	Il est vrai, que jamais de mon consentement Aminthas n'eut changé, pour être votre amant.
FLORISELLE.	FLORISELLE.
Ie voy bien Lucidor, que tu n’és pas vn traiſtre, Ce vice n’appartient ſeulement, qu’à ton Maiſtre.	Je vois bien Lucidor, que tu n'avez pas un traître, Ce vice n'appartient seulement, qu'à ton Maître.
Mais ie crains, qu’en voulant eſtre vn peu trop flateur, Ce diſcours ne te face eſtimer vn menteur.	Mais ainsi crains, qu'en voulant être un peu trop flatteur, Ce discours ne te face estimer un menteur.
Que ie ſerois heureuſe en ce point, qui me touche, Si ton cœur n’eſtoit pas dementy par ta bouche.	Que était serais heureuse en ce point, qui me touche, Si ton cœur n'était pas démenti par ta bouche.
Ie connois Perſelide, & ie voy mes deffauts, Ie ſçay ce qu'elle tient ie ſçay ce que ie vaux,	Je connais Persélide, et Seigneur vois mes défauts, Je sais ce qu'elle tient ie sçay ce que ie vaux.
LVCIDOR.	LUCIDOR.
Vous auez, à combattre vne forte partie, La verité s’oppoſe a voſtre modeſtie.	Vous avez, à combattre une forte partie, La vérité s'oppose a été modestie.
Mais ie croy que vos yeux, & voſtre jugement, Ne vous permettent pas d’auoir ce ſentiment.	Mais petit crois que vos yeux, et votre jugement, Ne vous permettent pas d'avoir ce sentiment.
Vous pourriez en voulant paroiſtre plus diſcrete Eſtant moins veritable eſtre außi moins parfaite.	Vous pourriez en voulant paraître plus discrète Étant moins véritable était aussi moins parfaite.
Celles qui comme vous ont pour tout du meſpris, eoutonnuo puuu fouuenn uuioiuinſturs eſprits.	Celles qui comme vous ont pour tout du mépris, eoutonnuo pu fouuenn uuioiuinsturs esprits.
PLORISELLE.	PLORISELLE.
Floriſelle n’a pas aſſez d’effronterie, Pour ſe laiſſer ſurprendre à cette flaterie.	Floriselle n'a pas assez d'effronterie, Pour se laisser surprendre à cette flatterie.
Ie n'ayrien neantmoins a de mander aux Dieux, Si i’ay quelque beauté, qui peut plaire à tes yeux.	Je n'airien néanmoins a de mander aux Dieux, Si j'ai quelque beauté, qui peut plaire à tes yeux.
LVCIDOR.	LUCIDOR.
Mon eſprit eſt en tout ſi peu de conſequence, Qu'on tient ſes iugemens dedans l’indifference.	Mon esprit est en tout si peu de conséquence, Qu'on tient ses jugements dedans l'indifférence.
FLORISELLE.	FLORISELLE.
Quand le Ciel faiſant voir ſes prodigalitez Eſtale ſur nos corps ſes plus rares beautés, L’eſtime, que la eour' ou le peuple en peut faire, N’eſt point le vray plaiſir, qui nous doit ſatisfaire.	Quand le Ciel faisant voir ses prodigalités Étale sur nos corps ses plus rares beautés, L'estime, que la eour ou le peuple en peut faire, N'est point le vrai plaisir, qui nous doit satisfaire.
Le pri.	Le pri.
e eſt bien plus beau, qu’on en peut eſperer, Et le fruit bien plue doux, qu’on en doit deſirer.	 est bien plus beau, qu'on en peut espérer, Et le fruit bien plue doux, qu'on en doit désirer.
Lucidor en ce point le plus grand auantage, Que puiſſe retirer la beauté d’vn viſage, C’eſt de pouuoir bleſſer d’vn trait imperieux Vn amant, qui ſe trouue agreable à ſes yeux.	Lucidor en ce point le plus grand avantage, Que puisse retirer la beauté d'un visage, C'est de pouvoir blesser d'un trait impérieux Un amant, qui se trouve agréable à ses yeux.
Croi donc, que le plaiſir qui me reſte eſt extréme, De voir le iugement, que tu fals de moi-meſme.	Crois donc, que le plaisir qui me reste est extrême, De voir le jugement, que tu fals de moi-même.
LVCIDOR.	LUCIDOR.
Ces mots ſont trop obſcurs, pour ycomprendre rien.	Ces mots sont trop obscurs, pour ycommprendre rien.
Ou ie ſuis trop großier.	Ou ici suis trop grognier.
FLORISELLE.	FLORISELLE.
Non, non:	Non, non:
tu m’entends bien, C’est en vain Lucidor, que tu t’en veux deffendre.	tu m'entends bien, C'est en vain Lucidor, que tu t'en veux défendre.
Si tu ne m'entends pas, tu ne veux pas m’entendre.	Si tu ne m'entends pas, tu ne veux pas m'entendre.
Tu feins de n’ouir point le ſens de mon diſcours, Afin de me pouuoir refuſer ton ſecours.	Tu feins de n'ouïr point le sens de mon discours, Afin de me pendant refuser ton secours.
Que s’il faut m’expliquer d’vne façon plus claire, Mon front a beau rougir, i’y conſens pour te plaire.	Que s'il faut m'exprimer d'une façon plus claire, Mon front a beau rougir, j'y consens pour te plaire.
C’eſt en vain, qu Aminthas s’obſtine en ſon amour, Qui trouble ſon repos & la nuit, & le iour.	C'est en vain, qu' Aminthas s'obstine en son amour, Qui trouble son repos et la nuit, et le jour.
Qu’il rompe ſa priſon, que ſon cœur ſe deſtache.	Qu'il rompe sa prison, que son cœur se détache.
Son importunité m'incommode, & me faſche.	Son importunité m'incommode, et me fâche.
Ie ſçai, qu’il vaut beaucoup, qu’on le doit eſtimer.	Je sais, qu'il vaut beaucoup, qu'on le doit estimer.
Mais mon eſprit ne peut conſentir à l’aimer:	Mais mon esprit ne peut consentir à l'aimer:
Quoy qu’il puiſſe inuenter, les ardeurs de ſa flame N'eſchauferont jamais la glace de mon ame.	Quo qu’il puisse inventer, les ardeurs de sa flamme N'échaufferont jamais la glace de mon âme.
Les Dieux l’ont reſolu, c’est vn arreſt des Cieux.	Les Dieux l'ont résolu, c'est un arrêt des Cieux.
Il n’y faut plus penſer.	Il n'y faut plus penser.
Mais toy, pour faire mieux, A bandonne aujourd’huy l’intereſt de ton Maiſtre.	Mais toi, pour faire mieux, A bandonne aujourd'hui l'intérêt de ton Maître.
Sers-toy de ce bon-heur que l’Amour te fait naistre.	Sers-toi de ce bonheur que l'Amour te fait naître.
Oublions Aminthas, ne parlons plus de luy, A avouene fans raiſon, ceut pratues pourautriey.	Oublions Aminthas, ne parlons plus de lui, A vouène fans raison, ceut prattues pourautrie.
Parle pour Lucidor.	Parle pour Lucidor.
LVCIDOR.	LUCIDOR.
Oſez-vous inhumaine Mespriſer vn amant, & rire de ſa peine, Vous riez de l’exceZ de ſon affection, Et mespriſeZ l’eſtat de ſa condition.	Osez-vous inhumaine Mespriser un amant, et rire de sa peine, Vous riez de l'excès de son affection, Et méprisez l'état de sa condition.
Cette comparaiſon du ſeruiteur au Maiſtre, Deſcouure voſtre cœur, & me fait bien connaiſtre, Que vous le regardez comme indigne de vous, Qu'il n’eſt pas aſſez grand, pour eſtre voſtre eſpoux!	Cette comparaison du serviteur au Maître, Découvre votre cœur, et me fait bien connaître, Que vous le regardez comme indigne de vous, Qu'il n'est pas assez grand, pour être votre époux!
Eſt-ce donc là le but, où l’amour doit pretendre, Eſt-ce donc là le priæ, qu’vn amant doit attendre.	Est-ce donc là le but, où l'amour doit prétendre, Est-ce donc là le priæ, qu'un amant doit attendre.
FLO	FLO
FLORISELLE.	FLORISELLE.
Tu ne iuges pas bien du diſcours, que i’ay fait.	Tu ne juges pas bien du discours, que j'ai fait.
Si ie ſuis Aminthas, ou ſi mon cœur le hait.	Si ici suis Aminthas, ou si mon cœur le hait.
Ce n'est pas, qu'en effet mon esprit le mépriſe, Je connois, ce qu’il vaur, ie ſuis trop bien appriſe, I'eſtime ſon merite, & ſa condition:	Ce n'est pas, qu'en effet mon esprit le méprise, Je connais, ce qu'il vaur, une suis trop bien apprise, J'estime son mérite, et sa condition:
MCais ie ne puis respondre à ſon affection.	MAisCite ne puis répondre à son affection.
Que ſi i’ay preferé l’amitié de ſon Page, C’eſt qu’außi Lucidor me plaiſt bien dauantage.	Que si j'ai préféré l'amitié de son Page, C'est qu'aussi Lucidor me plaît bien davantage.
Mon front ne rougit point pour deſcouurir mon cœur, Jl faut que le vaincu rende hommage au vainqueur.	Mon front ne rougit point pour découvrir mon cœur, Il faut que le vaincu rende hommage au vainqueur.
Qui pourroit reſiſter au pouuoir de tes charmes.	Qui pourrait résister au pouvoir de tes charmes.
L’amour pour me bleſſer s’eſt ſerui de tes armes.	L'amour pour me blesser s'est servi de tes armes.
Ie ne marreste point au rang de mes ayeux, L’amour eſt vn enfant, qui s’eſt creué les yeux.	Je ne marrête point au rang de mes aïeux, L'amour est un enfant, qui s'est crué les yeux.
2novunnm Quib tuois to Prxuuſere du tonnerre De venir icy-bas ſouspirer ſur la terre, Et les Deeſſes meſme ont quitté leurs autels, Les Cieux, & leur grandeur pour l’amour des mortels,	2novunnm Quib tuais to Prxuusere du tonnerre De venir ici-bas soupirer sur la terre, Et les Déesses femme ont quitté leurs autels, Les Cieux, et leur grandeur pour l'amour des mortels,
LVCIDOR.	LUCIDOR.
Je connois Floriſelle, elle eſt trop vertueuſe.	Je connais Floriselle, elle est trop vertueuse.
Affin que Lucidor la rendit amoureuſe, Les plus grands de la cour s’eſtimeroient heureux, Si vous vouliez preſter voſtre oreille à leurs vœux.	Affin que Lucidor la rendit amoureuse, Les plus grands de la cour s'estimeraient heureux, Si vous vouliez prêter votre oreille à leurs vœux.
Ahchangez, de diſcours, c’eſt vne moquerie D’vn esprit, qui ſe plaiſt dedans la raillerie.	Ahchangez, de discours, c'est une moquerie D'un esprit, qui se plaît dedans la raillerie.
Vous croyez, que mon cœur ſoit plein de vanité, Ou bien que Lucidor ſe pique de beauté.	Vous croyez, que mon cœur soit plein de vanité, Ou bien que Lucidor se pique de beauté.
FLORISELLE.	FLORISELLE.
Ce penſer me fait tort, que le Ciel & la Terre, Si ie ments deuant toy, me declarent la guerre.	Ce penser me fait tort, que le Ciel et la Terre, Si tu mens devant toi, me déclarent la guerre.
I'eſpere d’arracher ce doute de ton cœur, Si tu veux te reſoudre à fleſchir ta rigueur.	J'espère d'arracher ce doute de ton cœur, Si tu veux te résoudre à fléchir ta rigueur.
S E L TROISTEEIE.	S E L TROISTEIE.
E	E
FLORISELLE ſeule.	FLORISELLE seule.
Apprens donc par les maux de mon ame enflamée, A Quel mal-heur c’est d’aimer, ſans pouuoir eſtre aimée Tigres, viuans rochers, qui rieZ des tourments, Que vous voyeZ ſouffrir aux mal-heureux amants.	Apprends donc par les maux de mon âme enflamée, A Quel malheur c'est d'aimer, sans pouvoir être aimée Tigres, vivants rochers, qui rieZ des tourments, Que vous voyez souffrir aux malheureux amants.
Dont le cœur ſans pitié ſe moque de leurs plaintes, Et paye ingratement leurs deuoirs par des feintes.	Dont le cœur sans pitié se moque de leurs plaintes, Et paie ingratement leurs devoirs par des feintes.
OſeZ-vous trriter le pouuoir de l’amour, Voyez, comme il me fait ſouspirer à mon tour.	Osez-vous triter le pouvoir de l'amour, Voyez, comme il me fait soupirer à mon tour.
Je me plûs, com me vous, a paroiſtre cruelle, Mais cette cruauté me rendit criminelle:	Je me plus. com me vous, a paraître cruelle, Mais cette cruauté me rendit criminelle:
Aminthas m'adoroit, ie mespriſois ſes vœux, Et ce cruel mepris en fait deux mal-heureux.	Aminthas m'adorait, tu méprisais ses vœux, Et ce cruel mépris en fait deux malheureux.
Ce pauure amant languit, & ie voy ſes miſeres, Mais l’amour me deffend d’eſcouter ſes prieres.	Ce pauvre amant languit, et je vois ses misères, Mais l'amour me défend d'écouter ses prières.
Aminthas m’aime encor, ie le fuis, il me ſuit, Mais i’aime Lucidor, ie le ſuis, il me fuit.	Aminthas m'aime encor, tu le fuis, il me suit, Mais j'aime Lucidor, une le suis, il me fuit.
Que ſi contre Aminthas i’ay commis vn’offence!	Que si contre Aminthas j'ai commis un'offense!
Falloit-il, que ſon Page en tirat la vengeancé.	Fallait-il, que son Page en tirât la vengeancé.
Pourquoy pour appaiſer l’exceZ de mes douleurs!	Pourquoi pour apaiser l'excès de mes douleurs!
Ne puis-je pas noyer ma flame dans mes pleurs.	Ne puis-je pas noyer ma flamme dans mes pleurs.
Permettez, iuſtes Dieux, dans ce mal-heur extréme, On que i'aime Aminthas, ou que Lucidor m’aime.	Permettez, justes Dieux, dans ce malheur extrême, On que j'aime Aminthas, ou que Lucidor m'aime.
A ui voy-ie deuant moy!	A Avi vois-je devant moi!
quel objet odieux Vient troubler mon repos, & s’offrir à mes yeux.	quel objet odieux Vient troubler mon repos, et s'offrir à mes yeux.
S CEN E AVATRIESME.	 SEN EU AUTRIESME.
MELAS, FLORISELLE.	MÊLAS, FLORISELLE.
MELAS.	MÊLAS.
E traiſtre auroit-il pû par ſa perſeuerance ESurmonter Floriſelle, & vaincre ſa conſtance:	E traître aurait-il pu par sa persévérance ESurmonter Floriselle, et vaincre sa constance:
Ce Vage eſt d’Aminthas.	Ce Vage est d'Aminthas.
Ie ne ſçay, qu'en iuger, Mais ie ſçay, qu’vne fille eſt ſujette à changer.	Je ne sais, qu'en juger, Mais apprendre sais, qu'une fille est sujet à changer.
F LOR ISELLE.	 FOR ISELLE.
Cét amant a l’esprit troublé de ialouſie, Je vay l’entretenir dans cette fantaiſie.	Cet amant à l'esprit troublé de jalousie, Je vais l'entretenir dans cette fantaisie.
MELAS ayant veu la lettre d’Aminthas.	MÊLAS ayant vu la lettre d'Aminthas.
Aminthas ſe ſçait-il expliquer dans ſes feux!	Aminthas se sait-il expliquer dans ses feux!
Efevatait aupt vien, quit ſeint dejere amtousene.	Efevatait aupt vien, quit seint déjère amtousene.
c	ç
FLORISELLE monſtrant la lettre d’Aminthas.	FLORISELLE montrant la lettre d'Aminthas.
Il eſt vray, qu'Aminthas s’il eſtoit veritable Me teſmoigne vn amour qui n’a point de ſemblable.	Il est vrai, qu'Aminthas s'il était véritable Me témoigne un amour qui n'a point de semblable.
Mais ces esprits changeants, qui viennent de la cour, Lors qu’ils en ont le moins teſmoignent plus d’amour.	Mais ces esprits changeants, qui viennent de la cour, Lors qu'ils en ont le moins témoignent plus d'amour.
Ils ſont accouſtumez a ces cageolleries, Et leur humeur ſe plaiſt à ces galanteries.	Ils sont accoutumés a ces cageoleries, Et leur humeur se plaît à ces galanteries.
MELAS.	MÊLAS.
Vous nous blaſmeZ à tort!	Vous nous blâmez à tort!
croyez--vous, que Melas Se plaigne außi d’vn feu, dont il ne bruſle pas.	croyez-vous, que Mélas Se plaigne aussi d'un feu, dont il ne brûle pas.
C’eſt vous faire vn injure, &t c’eſt mal vour connoiſtre De croire, que le Ciel ait encore pu permettre.	C'est vous faire un injure, ett c'est mal hour connaître De croire, que le Ciel ait encore pu permettre.
De regarder vos yeux nos aimables vainqueurs, Sans en ſentir les traits iuſqu’au fonds de nos cœurs.	De regarder vos yeux nos aimables vainqueurs, Sans en sentir les traits jusqu'au fond de nos cœurs.
FLORISELLE.	FLORISELLE.
Melas cette raiſon combat contre toy-meſme, Et malgré ton deſſein prouue, qu’Aminthas m’aime.	Mélas cette raison combat contre toi-même, Et malgré ton dessein provue, qu'Aminthas m'aime.
Va t'en trouuer Calliste, & fais-luy ces diſcours, Où tu pourras mieux voir reußir tes amours.	Va t'en trouver Calliste, et fais-lui ces discours, Où tu pourras mieux voir revenir tes amours.
S C TAVE CINQVIESME	S CA TAUE CINQUIÈME
MELAS ſeul.	MÊLAS seul.
Nſin tu vois Melas, qu’Aminthas eſt le maiſtre.	Nsin tu vois Mélas, qu'Aminthas est le maître.
L Floriſelle à changé:	L Floriselle à changé:
tu le peux bien connaiſtre, Elle aime ton riual, ſon eſprit aujourd’huy, N'estime qu'Aminthas, & ne vit, que pour luy.	tu le peux bien connaître, Elle aime ton rival, son esprit aujourd'hui, N'estime qu'Aminthas, et ne vit, que pour lui.
Ne vois-tu pas, que c’eſt vneffet de ſa lettre.	Ne vois-tu pas, que c'est uneffet de sa lettre.
Mais ce ferpurira l’audace de ce traiſtre,	Mais ce ferpurira l'audace de ce traître,
Le perfide en mourra.	Le perfide en mourra.
Mais à quoy ces tranſports, Qui troublent ma raiſon par leurs puiſſants efforts.	Mais à quoi ces transports, Qui troublent ma raison par leurs puissants efforts.
Je blaſme mon riual, & ie le croy blaſmable, S’il trouue, comme moy, ma Maiſtreſſe adorable!	Je blâme mon rival, et Seigneur le crois blâme, S'il trouve, comme moi, ma Maîtresse adorable!
Ne peut-il point aimer ſans ma permißion!	Ne peut-il point aimer sans ma permission!
Peut-il point dispoſer de ſon affection.	Peut-il point disposer de son affection.
Melas ſi tu te plains, de ce qu’Aminthas aime, Ton riual peut außi ſe plaindre de toy-meſme.	Mélas si tu te plains, de ce qu'Aminthas aime, Ton rival peut aussi se plaindre de toi-même.
Hé quoy ſi nous aimons en meſme lieu tous deux, Croi-je, que mon amour doiue eſteindre ſes feux.	Hé quoi si nous aimons en même lieu tous deux, Croi-je, que mon amour doive éteindre ses feux.
S’il a de l’auantage accuſons Floriſelle, Con lamnons ſon humeur, qui la rend infidelle.	S'il a de l'avantage accusons Floriselle, Con lamnons son humeur, qui la rend infidèle.
Mais quoy puis-je trahir l’intereſt de Melas, Et prendre contre moy le parti d’Aminthàs.	Mais quoi puis-je trahir l'intérêt de Mélas, Et prendre contre moi le parti d'Aminthàs.
Ce perfide oſe-t’il me conteſter la gloire Du combat, où l’amour me promet la victoire.	Ce perfide ose-t-il me contester la gloire Du combat, où l'amour me promet la victoire.
Qu’il en meure:	Qu'il en meure:
außi bien viuroit-il mal-heureux, Si Floriſelle eſtoit fauorable à mes vœux.	aussi bien vivrait-il malheureux, Si Floriselle était favorable à mes vœux.
Et moy pourrois-je voir, ſans mourir de triſteſſe.	Et moi pourrais-je voir, sans mourir de tristesse.
Qu’vn riual plus heureux me rauit ma Maistreſſe.	Qu'un rival plus heureux me ravit ma Maîtresse.
Jl faut que l’vn de nous preuienne le mal-heur, Et la neceßité de mourir par douleur.	Il faut que l'un de nous prévienne le malheur, Et la necemité de mourir par douleur.
Fin du deuxieſme Acte.	Fin du deuxième Acte.
ACTE	ACTE
A C T E TROISIESME.	À Ç T E TROISIÈME.
DSSAVS AACEMAEDEC La CALLISTE.	DSAUS AACEMAEDEC La CALISTE.
LVCIDOR,	LUCIDOR,
2 A CALLISTE.	2 À CALLISTE.
Minthas à donc tort de croire, que ſa peine * Puiſſe iamais flechir cét humeur inhumaine.	Minthas à donc tort de croire, que sa peine * Puisse jamais fléchir cet humeur inhumaine.
YLs *Il faut donc à la fin, qu’il eſtouffe ſes feux, 2931 Ou bien qu'il ſe reſolue à viure mal-heureux.	YLs *Il faut donc à la fin, qu'il étouffe ses feux, 2931 Ou bien qu'il se résolue à vivre malheureux.
LVCIDOR.	LUCIDOR.
Aminthas perd ſon temps, c’eſt en vain, qu’il ſe flatte, S’il croit auec ſes ſoins ſurmonter cette ingratte.	Aminthas perd son temps, c'est en vain, qu'il se flatte, S'il croit auec ses soins surmonter cette ingrate.
l'ay veu le ſentiment de ſon cœur auiourd’huy, Floriſelle a bien plus de haine contre luy, Ou plus d’auerſion, qu’il n’a d’amour pour elle.	l'ai vu le sentiment de son cœur aujourd'hui, Floriselle a bien plus de haine contre quelque, Ou plus d'aversion, qu'il n'a d'amour pour elle.
CALLISTE.	CALLISTE.
Mais dis-moy les diſcours, que t’a fait Florifelle.	Mais dis-moi les discours, que t'a fait Florifèle.
LVCIDOR.	LUCIDOR.
En vain, m’a-t’elle dit, Aminthas fait l’amour, En vain il ſe trauaille & la nuit, & le iour.	En vain, m'a-t-elle dit, Aminthas fait l'amour, En vain il se travaille et la nuit, et le jour.
Son importunité m’incommode, & me faſche, Qu’il rompe ſa priſon, que ſon cœur ſe deſtache.	Son importunité m'incommode, et me fâche, Qu'il rompe sa prison, que son cœur se détache.
Je ſçay qu’il vaut beaucoup, qu’on le doit estimer, Mais mon esprit ne peut conſentir à l’aimer.	Je sais qu'il vaut beaucoup, qu'on le doit estimer, Mais mon esprit ne peut consentir à l'aimer.
Quoy qu’il puiſſe inuenter, les ardeurs de ſa flame N'eſchaufferont iamais la glace de mon ame, Ce ſont ſes propres mots, iugez, par ces diſcours De quel eſpoir Monſieur peut nourrir ſes amours.	Quoi qu'il puisse inventer, les ardeurs de sa flamme N'échaufferont jamais la glace de mon âme, Ce sont ses propres mots, jugez, par ces discours De quel espoir Monsieur peut nourrir ses amours.
CALISTE.	CALISTE.
D'où vient cette rigueur, qui nous eſt ſi contraire, Qui l’oblige a traitter ſi rudement mon frere, D'où naiſſent ces dédains;	D'où vient cette rigueur, qui nous est si contraire, Qui l'oblige a traiter si rudement mon frère, D'où naissent ces dédains;
d’où luy vient ce meſpris!	d'où amour vient ce mépris!
En ſçais-tu la raiſon.	En sais-tu la raison.
1 1-	1 1-
LVCIDORN Ie n’en ay rien appris.	LUCIDORN Je n'en ai rien appris.
Si ce n’eſt qu’elle nomme Aminthas vn perfide.	Si ce n'est qu'elle nomme Aminthas un perfide.
2 12 donike, dinu empimanuiiranit t enjende, Que ſon cœur en vn mot ne veut pas s’engager Apres vn inconſtant, qui n’aime qu’a changer.	2 12 donike, dinu empimanviranit tendre enjende, Que son cœur en un mot ne veut pas s'engager Apres un inconstant, qui n'aime qu'a changer.
CALLISTE.	CALLISTE.
Tu n’as donc peu rien faire en faueur de ton Maiſtre, Mais parmi ſes rigueurs a-t'elle ouuert la lettre.	Tu n'as donc peu rien faire en faveur de ton Maître, Mais parmi ses rigueurs a-t'-elle ouvert la lettre.
LVGIDOR.	LUGIDOR.
Apres l’auoir receuë elle ne l’ouurit point, nouonsſe que Rravurls tepapuas ſuun et pointe	Après l'avoir reçue elle ne l'ouvrit point, nouvonsse que Rauravurls tepapuas suun et pointe
CALLISTE.	CALLISTE.
Adieu:	Adieu:
ie n’enveux pas apprendre dauantage.	Il n'enveux pas apprendre davantage.
Je ſçay ce que ie veux.	Je sais ce que Seigneur veux.
Mais voicy ce volagé, Qui deſtourne ſes pas, & craint de m'accoſter, Il connoit ſon peché, ie m'en vay l’arreſter.	Mais voici ce volagé, Qui détourne ses pas, et craint de m'accoster, Il connaît son péché, une m'en vais l'arrêter.
TEEQ	TEQ
S CEN DEVXIESME.	 SEN DEUXIÈME.
CALLISTE, MELAS.	CALISTE, MÊLAS.
CALLISTE.	CALLISTE.
L	L
MELAS.	MÊLAS.
Mon œil, pardonne moy, ne t’a pas apperceuë.	Mon œil, pardonne -moi, ne t'a pas aperçue.
CALLISTE.	CALLISTE.
Ton esprit eſt ailleurs.	Ton esprit est ailleurs.
F.	F.
nj	néj
MELAS.	MÊLAS.
Je reſuois en effet.	Je rêvais en effet.
* CALLISTE.	* CALLISTE.
Mais ton cœur qu’en fais-tu.	Mais ton cœur qu'en fais-tu.
MELAS.	MÊLAS.
Jl eſt entre vos mains.	Il est entre vos mains.
Mais qu’enaueZ vous fait.	Mais qu'enavez -vous fait.
CALLISTE.	CALLISTE.
Jl eſt chez Floriſelle.	Il est chez Floriselle.
Ton cœur, & ton esprit ſont encor auec elle.	Ton cœur, et ton esprit sont encor avec elle.
MELAS.	MÊLAS.
Floriſelle il eſt vray poſſede tant d’attraits, Qu'a peine pourroit-on reſiſter a leurs traits.	Floriselle il est vrai possède tant d'attraits, Qu'a peine pourrait-on résister à leurs traits.
CALLISTE.	CALLISTE.
Toy moſmouuſa uuaunomu feuti latteinté.	Toi mosmouusa uaunomu feuti latteinté.
MELAS.	MÊLAS.
Pourquoy dißimuler!	Pourquoi dissimuler!
pourquoy trembler de crainte!	pourquoi trembler de crainte!
Pourquoy cacher mes feux!	Pourquoi cacher mes feux!
eſt-ce donc que mon cœur Ne veut pas reconceſtre vn ſi puiſſant vainqueur.	est-ce donc que mon cœur Ne veut pas reconcêtre un si puissant vainqueur.
Non:	Non:
i'aime Floriſſoile, & d’vn' amour extreme?	j'aime Florissoile, et d'Hel amour extrême?
Pourquoy donc ay-ie peur d’auouer, que ie l’aime.	Pourquoi donc ai-je peur d'avouer, que sans l'aime.
Calliſte mon esprit ne ſçauroit te flatter.	Calliste mon esprit ne saurait te flatter.
Tes beautés autres fois auoient pu m’arreſter, Tes yeux auoient des feux, dont ie ſentois la flame Ta bonté, ia douceur auoient charmé mon ame.	Tes beautés autres fois avaient pu m'arrêter, Tes yeux avaient des feux, dont ie sentais la flamme Ta bonté, ja douceur avaient charmé mon âme.
Melas ne trouuoit rien, qui fut égal à toy, Ie m'eſtimois heureux de viure ſous ta loy.	Mélas ne trouvait rien, qui fut égal à toi, Je m'estimais heureux de vivre sous ta loi.
Floriſſelle auiourd’huy me paroiſt plus aimabl, Et rien que ſa beaute ne me ſemble agreable.	Florisselle aujourd'hui me paraît plus aimabl, Et rien que sa beauté ne me semble agréable.
Si ce diſcours t’offence, & cette liberté, Lamour excuſera mon inciuilité.	Si ce discours t'offense, et cette liberté, Lamour excusera mon incivilité.
CALLISTE.	CALLISTE.
Melas tu fais fort bien de choiſir la plus belle, A a iet jpaleross jallelt eralltant Plorijeues	Mélas tu fais fort bien de choisir la plus belle, À a jet jpaleross jallelt erallant Plorijeues
MELAS.	MÊLAS.
Le pouuoir de l’amour ſans mon conſentement Merauii à moy meſme, & me rend ſon amant.	Le pouvoir de l'amour sans mon consentement Méraui à moi -même, et me rend son amant.
Il'esf vray que ce Dieu marque autant d’inconſtance, Que ſon bras glorieux teſmoigne de puiſſance.	Il'est vrai que ce Dieu marque autant d'inconstance, Que son bras glorieux témoigne de puissance.
CALLISTE.	CALLISTE.
On peut auec raiſon blaſmer ton ſentiment, Un Dieu ne fut iamais ſujet au changement.	On peut avec raison blâmer ton sentiment, Un Dieu ne fut jamais sujet au changement.
Melas il faut, qu’vn Dieu ſoit autant immuable, Que ſon pouuoir eſt grand, & ſon eſtre adorable.	Mélas il faut, qu'ab Dieu soit autant immuable, Que son pouvoir est grand, et son être adorable.
MELAS.	MÊLAS.
Pourquoy, donneroit-on des aiſles à ce Dieu.	Pourquoi, donnerait-on des ailes à ce Dieu.
Si ſon esprit pouuoit s’arreſter en vn lieu.	Si son esprit pouvait s'arrêter en un lieu.
CALLISTE.	CALLISTE.
L’amour pourra-t’il bien endurer cet t' inju re Qui ie rena imparfait, & ueſtrntt ja nature.	L'amour pourra-t-il bien endurer cet t' inju re Qui ie mana imparfait, et et nature.
MELAS.	MÊLAS.
Poibls le tols de jensy svix eproir potur trkel fui Seroit-il vn enfants s’il n’aimoit à changer.	Paibls le tols de jensy svix éproir potur trkel fui Serait-il -il enfants s'il n'aimait à changer.
CALLISTE.	CALLISTE.
9274 Pourquoy blaſmer vn Dieu, pour s’excuſer ſoy-meſme, Retracté ton diſcours, condamne ton blaſpheme.	9274 Pourquoi blâmer un Dieu, pour s'excuser soi-même, Retracté ton discours, condamne ton blâme.
Di-moy, que tu feignois de bruſler de mes feux, Et que iamais Melas ne m’adreſſa ſes vœux.	Dis-moi, que tu feignais de brûler de mes feux, Et que jamais Mélas ne m'adressa ses vœux.
Ne croypoint, qu’il m'en faſche, on n’a pas d’auantage, D’eſtre dedans l’eſprit d’vn amant ſi volage.	Ne croispoint, qu'il m'en fâche, on n'a pas d'avantage, D'être dedans l'esprit d'un amant si volage.
Di-moy, que ton amour ne peut eſtre arreſté, Que par les doux attraits de la ſeule beauté, Qu'on n'a pas de raiſon de te croire infidelle, Puiſque cette beauté ſe trouue en Floriſelle.	Dis-moi, que ton amour ne peut être arrêté, Que par les doux attraits de la seule beauté, Qu'on n'a pas de raison de te croire infidèle, Puisque cette beauté se trouve en Floriselle.
MELAS.	MÊLAS.
Calliſte, ie ne puis deſauouer l’amour, Dont pendant ſi long-temps i’ay fait gloire à la Cour.	Caliste, Madame ne puis désavouer l'amour, Dont pendant si longtemps j'ai fait gloire à la Cour.
Toy meſme tu pourrois me faire cett' iniure, Que de me condamner par ma propre eſcriture!	Toi même tu pourrais me faire cett injure, Que de me condamner par ma propre écriture!
Respon moy ſur ce point!	Respon moi sur ce point!
les hommes en ce temps Sont ils moins eſtimés, pour pareſtre inconſtans.	les hommes en ce temps Sont ils moins estimés, pour paraître inconstants.
Alors que ie vouai mon ſeruice à Calliſte!	Alors que Ne vouai mon service à Caliste!
Dis tu que i’auois tort de quitter Amathiſte?	Dis tu que j'avais tort de quitter Amathiste?
Blaſmas-tu mon humeur, ou ma legerete!	Blâmas-tu mon humeur, ou ma légère!
Fus-ie moins bien receu?	Fus-je moins bien reçu?
fus-ie plus mal traitté.	fus-je plus mal traité.
CADETSTLa Je t’ay touſiours tenu dedans l’indifference.	CADETSTLa Je t'ai toujours tenu dedans l'indifférence.
MELAS.	MÊLAS.
Pourquoy donc aujourd’huy m’accuſer d’inconſtance, Vn amant, qui languit, veut qu’on l’aime à ſon tour, L’amour eſt vn enfant, qui ſe nourrit d’amour.	Pourquoi donc aujourd'hui m'accuser d'inconstance, Un amant, qui languit, veut qu'on l'aime à son tour, L'amour est un enfant, qui se nourrit d'amour.
C’eſt donc ta cruauté, qui dans cett' auanture A fait mourir vn Dieu faute de nourrituré.	C'est donc ta cruauté, qui dans cel' aventure A fait mourir un Dieu faute de nourrituré.
CALLISTE.	CALLISTE.
Qu’il ſoit mort, ou qu’il viue:	Qu'il soit mort, ou qu'il vive:
il m’eſt indifferent.	il m'est indifférent.
Le nombre des Amants est aujourd’huy ſi grand.	Le nombre des Amants est aujourd'hui si grand.
Leur importunité, leurs deuoirs inutiles Nous forcent bien ſouuent à pareſtre inciuiles.	Leur importunité, leurs devoirs inutiles Nous forcent bien souvent à paraître inciviles.
Jls ſont à noſtre porte, & la nuit, & le iour.	Ils sont à notre porte, et la nuit, et le jour.
Ils nous ſont ennuyeux auecque leur amour.	Ils nous sont ennuyeux auecque leur amour.
On n’a iamais de peine, & iamais d’autre affaire, Qu'à trouuer les moyens de s’en pouuoir deffaire.	On n'a jamais de peine, et jamais d'autre affaire, Qu'à trouver les moyens de s'en pouvoir défaire.
Je ne me faſche point, que tu ſoir inconſtant, Ie voudrois, qu'Alcidor en eut fait tout autant.	Je ne me fâche point, que tu soir inconstant, Je voudrais, qu'Alcidor en eut fait tout autant.
Romp, Melas, romp mes fers:	Romp, Mélas, romp mes fers:
ie ſerois bien faſchée, Si ton ame inconſtante en eſtoit attachée.	Ce serais bien fâchée, Si ton âme inconstante en était attachée.
Que ie crains neantmoins, que ton amour MCelas N’attire vne querelle auiourd’huy ſur tes bras.	Que ainsi crains néanmoins, que ton amour MCélas N'attire une querelle aujourd'hui sur tes bras.
Tu ſçais bien, qu'Aminthas adore Floriſelle, Tu ne peux ignorer l’amour, qu’il a pour elle!	Tu sais bien, qu'Aminthas adore Floriselle, Tu ne peux ignorer l'amour, qu'il a pour elle!
Pourra-t’il endurer les deſſeins d’vn riual, Il a beaucoup d’amour, & du cœur à l’égal.	Pourra-t-il endurer les desseins d'Hum rival, Il a beaucoup d'amour, et du cœur à l'égal.
Ie ne puis teflatter, il n'eſt pas temps de feindre, Mon frere eſt genereux.	Je ne puis teflatter, il n'est pas temps de feindre, Mon frère est généreux.
La colere eſt à craindre, Que deux feux violents allument dans vn cœur.	La colère est à craindre, Que deux feux violents allument dans un cœur.
MELAS.	MÊLAS.
Le Ciel verra bien-toſt, qui ſera le vainqueur.	Le Ciel verra bientôt, qui sera le vainqueur.
Melas connoiſt aſſeZ l’adreſſe de ton frere, Mlais s’il eſt ſi vaillant, ie le puis ſatisfaire.	Mélas connaît assez l'adresse de ton frère, Mlais s'il est si vaillant, Seigneur le puis satisfaire.
CALLISTE.	CALLISTE.
Melas quelle fureur:	Mélas quelle fureur:
tu ne craindras-donc pas, S’il faut noyer ton fer dans le ſang d’Aminthas.	tu ne craindras-donc pas, S'il faut noyer ton fer dans le sang d'Aminthas.
Veux-tu pour contenter ta paßion brutale, Diſſoudre vn'amitié, qui ſembloit ſans eſgale.	Veux-tu pour contenter ta passion brutale, Dissoudre une amitié, qui semblait sans égale.
As-tu donc oublié cett'obligation, Qui te fit voir l’excez de ſon affection.	As-tu donc oublié cett-obligation, Qui te fit voir l'excès de son affection.
Perfide, ton esprit peut donc auoir enuie De t’en prendre à celuy, qui t’a ſauué la vie.	Perfide, ton esprit peut donc avoir envie De 'en prendre à celui, qui t'a sauvé la vie.
Sçais-tu bien, qui retint la fureur de ton Roy, Lors qu’il auoit deſſein de ſe vanger de toy.	Sais-tu bien, qui retint la fureur de ton Roi, Lors qu'il avait dessein de se venger de toi.
MELAS.	MÊLAS.
En ce temps, qu’Aminthas me rendit ce ſeruice!	En ce temps, qu'Aminthas me rendit ce service!
Creut-il, que ſon deßein luy portat preiudice!	Creut-il, que son dessein te portât préjudice!
Se fut-il employé pour ſauuer vn riual?	Se fut-il employé pour sauver un rival?
Eut-il iamais voulu ſe procurer du mal.	Eût-il jamais voulu se procurer du mal.
Si ce fer, ou ce bras ailleurs, qu’en cette affaire Se poüuoient employer en faueur de ton frere;	Si ce fer, ou ce bras ailleurs, qu'en cette affaire Se pouvaient employer en faveur de ton frère;
Je me croirois heureux d’auoir l’occaſion De le pouuoir ſeruir auecque paßion:	Je me croirais heureux d'avoir l'occasion De le pouvoir servir auecque passion:
Mais de ceſſer d’aimer, parce qu'Aminthas aime!	Mais de cesser d'aimer, parce qu'Aminthas aime!
Seroit-ce pas me faire injuſtice à moi-meſme.	Serait-ce pas me faire injustice à moi-même.
Tu ſembles t’eſtonner de l’amour de Melas, Tu ſçais, qu'il a des yeux außi bien qu’Aminthas.	Tu sembles t'étonner de l'amour de Mélas, Tu sais, qu'il a des yeux aussi bien qu'Aminthas.
Si ton frere eſt faſché, que i’aime Floriſelle, Nos mains, quand il voudras vuideront la querelle.	Si ton frère est fâché, que j'aime Floriselle, Nos mains, quand il voudras videront la querelle.
G iij	G jijà
A A AESICSIIE.	A À AESICSIE.
CALLISTE ſeule.	CALISTE seule.
Amour n’a dõc des traits, que pour bleſſer mon cœur Il fait voir ſeulement contre moy ſa rigueur!	Amour n'a domme des traits, que pour blesser mon cœur Il fait voir seulement contre moi sa rigueur!
Ce tyran importun n’eſt donc armé de flame, Que pour faire ſentir ſes ardeurs à mon ame, Ce Monſtre ſans pitié, qui trouble mon repos!	Ce tyran importun n'est donc armé de flamme, Que pour faire sentir ses ardeurs à mon âme, Ce Monstre sans pitié, qui trouble mon repos!
Na-t’il donc auiourd’huy des aiſles ſur ſon dos Qu'afin de les preſter à mon amant volage, Qu’il me rend inconſtant pour teſmoigner ſa rage!	Na-t-il donc aujourd'hui des ailes sur son dos Qu'afin de les prêter à mon amant volage, Qu'il me rend inconstant pour témoigner sa rage!
Fait-il donc de l’aueugle!	Fait-il donc de l'aveugle!
ou voilet-il ſes yeux, Pour pouuoir s’excuſer, s’il eſt malicieux.	ou voilet-il ses yeux, Pour pouvoir s'excuser, s'il est malicieux.
Son enfance fait voir, qu’il n’a pas la puiſſance, De punir les amants, qui manquent de conſtance.	Son enfance fait voir, qu'il n'a pas la puissance, De punir les amants, qui manquent de constance.
Où s’il en espargne vn, qui n’eut iamais de foy,	Où s'il en épargne un, qui n'eut jamais de foi,
5	5
C’eſt que tout ſon pouuoir vtent fondre contre moy.	C'est que tout son pouvoir utent fondre contre moi.
En vn mot cet amour, qui me rend mal-heureuſe N’eſt amour, ſi ce n’eſt pour me rendre amoureuſe:	En un mot cet amour, qui me rend malheureuse N'est amour, si ce n'est pour me rendre amoureuse:
Ou Melas ſentiroit la force de ſon bras.	Ou Mélas sentirait la force de son bras.
O dieux, ie diſcours mal.	Ô dieux, Seigneur discours mal.
Hé quoy ne ſçai-ie pas, Que le cœur de l’ingrat brusle pour Floriſelle.	Hé quoi ne sais-je pas, Que le cœur de l'ingrat brûle pour Floriselle.
Melas eſt amoureux, quoy qu’il ſoit infidelle:	Mélas est amoureux, quoi qu’il soit infidèle:
Je n’en puis plus douter, luy-meſme me l’a dit.	Je n'en puis plus douter, Seigneur-même me l'a dit.
Je ne puis plus tromper, ny flatter mon esprit.	Je ne puis plus tromper, ni flatter mon esprit.
Mais voyeZ ce perfide, auec quelle aſſeurance M'a-t’il osé parler de ſa folle inconstance.	Mais voyeZ ce perfide, avec quelle assurance M'a-t-il osé parler de sa folle inconstance.
Floriſelle a ſes yeux poſſede tant d’apas, Qu’il faut ou bien l’aimer, ou bien ne la voir pas.	Floriselle a ses yeux possède tant d'appas, Qu'il faut ou bien l'aimer, ou bien ne la voir pas.
Rien ne luy plaiſt ſans elle, & l’amour n’a point d’armes, Qu'autant que Floriſelle en fournit de ſes charmes!	Rien ne lui plaît sans elle, et l'amour n'a point d'armes, Qu'autant que Floriselle en fournit de ses charmes!
Mais faut-il pour punir vn mal-heureux amant, Qu’il ſoit abandonné dans ſon aueuglement.	Mais faut-il pour punir un malheureux amant, Qu'il soit abandonné dans son aveuglement.
Infortuné Melas, que ie ſeray vangée, Alors que l’on ſçaura, que tu m’auras changée Pour vne moins aimable, & moins belle que moy:	Infortuné Mélas, que je serai vengée, Alors que l'on sçaura, que tu m'auras changée Pour une moins aimable, et moins belle que moi:
Ainſi ſans y penſer, tu ne fais mal, qu'a toy.	Ainsi sans y penser, tu ne fais mal, qu'a toi.
Tu ne fais mal qu’a toy?	Tu ne fais mal qu'a toi?
ſuis-te donc inſenſible.	suis-te donc insensible.
Pourquoy dißimuler, mon mal eſt trop viſible, Hé quoy ne ſens-ie pas, que Melas auiourd’huy Eſt Maiſtre chez Calliſte außi bien, que chez luy.	Pourquoi dissimuler, mon mal est trop visible, Hé quoi ne sens-je pas, que Mélas aujourd'hui Est Maître chez Calliste aussi bien, que chez lui.
Ses attraits, ſa rigaeur par vn coup admirable Me font voir ce perfide eſgalement aimable?	Ses attraits, sa rigaeur par un coup admirable Me font voir ce perfide également aimable?
Mais außi faut-il eſtre eſclaue de l’amour;	Mais aussi faut-il être esclave de l'amour;
Qu'vn genereux dépit me maiſtriſe à ſon tour.	Qu'un généreux dépit me maîtrise à son tour.
Souffrir, qu’vn infolent ſe moquant de ma flame Triomphe des douleürs, qu’il cauſe dans mon ame, Qu’il face des diſcours de ma credulité, Qu'il rie impunément de ma ſimplicité.	Souffrir, qu'un insolent se moquant de ma flamme Triomphe des doulevers, qu'il cause dans mon âme, Qu'il face des discours de ma crédulité, Qu'il rie impunément de ma simplicité.
Endurer, qu’vn ingrat me face cét outrage.	Endurer, qu'un ingrat me face cet outrage.
Non, non:	Non, non:
il me faudroit auoir moins de courage.	il me faudrait avoir moins de courage.
Il faut, que la fureur s’empare de mon cœur, 3 Et qu’en me reuoltant ie perde mon vainqueur.	Il faut, que la fureur s'empare de mon cœur, 3 Et qu'en me révoltant toujours perde mon vainqueur.
L’amour n’a plus de lieu dans mon ame inſenſee, Le deſir de vangeance occupe ma penſee.	L'amour n'a plus de lieu dans mon âme insensée, Le désir de vengeance occupée ma pensée.
SCENE	SCÈNE
SCET A VATRIESME.	SCET A VATRIESME.
CALLISTE, AMINTHAS.	CALISTE, AMINTHAS.
AMINTHAS, Vi retient Lucidor, qu’il deuient pareſſeux.	AMINTHAS, Vi retient Lucidor, qu'il devient paresseux.
QO Dieux, que ſa longueur repond mal à mes vœux.	Q Dieux, que sa longueur répond mal à mes vœux.
CALLISTE.	CALLISTE.
Condamne ton ſoupçon, qui blaſme à tort ton Page, Il vient de me quitter, il a fait ſon meſſage.	Condamne ton soupçon, qui blâme à tort ton Page, Il vient de me quitter, il a fait son message.
AMINTHAS.	AMINTHAS.
At-’il veu Floriſelle.	At-il vu Floriselle.
* CALLISTE.	* CALLISTE.
Jl en eſt de retour.	Il en est de retour.
AMINTHAS.	AMINTHAS.
2 Hè bien quelle eſperance ai-je dans mon amour!	2 HÉ bien quelle espérance ai-je dans mon amour!
Doisje m'imaginer que ma longue conſtancé Puiſſe enfin receuoir ſa juſte recompence.	Doisje m'imaginer que ma longue constancé Puisse enfin recevoir sa juste récompense.
CALLISTE.	CALLISTE.
Ie ne ſuis pas d’auis pour ton propre intereſt, Que tu te preſſes tant d’entendre ton arreſt.	Je ne suis pas d'avis pour ton propre intérêt, Que tu te presses tant d'entendre ton arrêt.
AMINTHAS.	AMINTHAS.
Mooufaury uu fagon mnmumumauupatience.	Mooufaury u fagon mnmumumauupatience.
CALLISTE.	CALLISTE.
Fay venir Lucidor, pour ſçauoir ta ſentence.	Fais venir Lucidor, pour savoir ta sentence.
AMINTHAS.	AMINTHAS.
Ma ſœur, ſi tu la ſçais, prononce hardiment, Ne craint pas de ſaſcner Ont mat-neureax amant.	Ma sœur, si tu la sais, prononce hardiment, Ne craint pas de sascner Ont mat-nureax amant.
CALLISTE.	CALLISTE.
Monfrere c’eſt en vain, que ton cœur s’imagine, De pouuoir ſurmonter vn' humeur, qui s’obſtine A conſeruer pour toy bien plus de cruauté, Que ton cœur amoureux n'a de fidelité.	Monfre c'est en vain, que ton cœur s'imagine, De pouvoir surmonter une humeur, qui s'obstine A conserver pour toi bien plus de cruauté, Que ton cœur amoureux n'a de fidélité.
AMINTHAS.	AMINTHAS.
Mal-heureux que ie ſuis!	Malheureux que ici suis!
ai-je encor donc enute Apres ce deſespoir de conſeruer ma vie.	ai-je encor donc envute Après ce désespoir de conserver ma vie.
en pompuenuns vetcoesuo nnes treſces muese peutrs Pourra tamais finir, ou charmer mes douleurs.	en pompuenuns vetcoesuo nnes très mues peutrs Pourra toujours finir, ou charmer mes douleurs.
Iuhumaine beauté, tu veux donc que ie meure, Ie m’en vay contenter ton deſir à cet t’heure.	Juhumaine beauté, tu veux donc que de meure, Je m'en vais contenter ton désir à cet t'heure.
CALLISTE.	CALLISTE.
Ah Dieux, que vas-tu faire Aminthas!	Ah Dieux, que vas-tu faire Aminthas!
quelle erreur	quelle erreur
Hii T’oblige d’exercer contre toy ta fureur.	Hi T'oblige d'exercer contre toi ta fureur.
Rappelle ton esprit, ton deſſein eſt blaſmable!	Rappelle ton esprit, ton dessein est blâmable!
Faut-il que l’innocent ſouffre pour le coupable.	Faut-il que l'innocent souffre pour le coupable.
Si ton amour ſe plaint d’vn' ingrate auiourd’huy, Quel a fats Amtetnus pour tattaquer a luy.	Si ton amour se plaint d'Hommes ingrate aujourd'hui, Quel a fats Amtetnus pour tattaquer a lui.
AMINTHAS.	AMINTHAS.
Je pretends d’vn ſeul coup me tirer hors de peine, Satisfaire à ma belle, & contenter ſa haine.	Je prétends d'un seul coup me tirer hors de peine, Satisfaire à ma belle, et contenter sa haine.
CALLISTE.	CALLISTE.
Tu ne recognois pas la cauſe de ton mal, Si tu n’és pas content, accuſe-en vn riual.	Tu ne reconnais pas la cause de ton mal, Si tu n'avez pas content, accuse-en un rival.
MINTHAS.	MINTHAS.
Mais ma ſœur, appren-moy le nom du temeraire, Qui me rend Florifelle à mes yeux ſi contraire.	Mais ma sœur, appren-moi le nom du téméraire, Qui me rend Florifèle à mes yeux si contraire.
CALLISTE.	CALLISTE.
Mon frere ton riual eſt le traiſtre Melas, Si i’en pouuois douter, ie ne le croirois pas.	Mon frère ton rival est le traître Mélas, Si j'en pouvais douter, ie ne le croirais pas.
AMINTHAS.	AMINTHAS.
Melas eſt mon riual.	Mélas est mon rival.
CALLISTE.	CALLISTE.
Le frere de Siluie.	Le frère de Silvie.
AMINTHAS.	AMINTHAS.
Melas, celuy, qui m’est obligé de la vie.	Mélas, celui, qui m'est obligé de la vie.
Ma ſœur, ie ne croy point, qu’il ſoit ſi mal-heureux, Ou bien il ne ſçait pas, que ie ſois amoureux.	Ma sœur, Seigneur ne crois point, qu'il soit si malheureux, Ou bien il ne sait pas, que ie sois amoureux.
Mais peut-il ignorer les deſſeins de mon ame, Apres que ie l’ay fait confident de ma flame.	Mais peut-il ignorer les desseins de mon âme, Après que je l'ai fait confident de ma flamme.
Mon amour a commis ſes ſecrets à ſa foy, De qui ie m'aſſeurois außi bien, que dvinoy, Celuy qui de mon cœür eſtoit depoſitaire, Celuy que i'eſtimois à l’eſgal de monfrere!	Mon amour a commis ses secrets à sa foi, De qui Elle m'assurais aussi bien, que dvinoy, Celui qui de mon crur était dépositaire, Celui que j'estimais à l'égal de monfrere!
Pourroit-il me trahir;	Pourrait-il me trahir;
il a trop de vertu, Ce diſcours me ſurprend, quels teſmoins en as-tu.	il a trop de vertu, Ce discours me surprend, quels témoins en as-tu.
H iij	H Hijà
CALLISTE.	CALLISTE.
Monfrere, c’eſt en vain, que ta bonté te flate.	Monfre, c'est en vain, que ta bonté te flatte.
Appren mieux à cognoiſtre vn' ame trop ingrate.	Appren mieux à connaître une âme trop ingrate.
Que tu fais vn mauuais iugement de Melas, fugeant de ſon eſprit parceluy d'Aminthas.	Que tu fais un mauvais jugement de Mélas, fugeant de son esprit parcelui d'Aminthas.
AMINTHAS.	AMINTHAS.
Non, cette trahiſon me paroiſt trop infame, Pour croire, que Melas en euſt tâché ſon ame.	Non, cette trahison me paraît trop infâme, Pour croire, que Mélas en eût tâché son âme.
CALLISTE.	CALLISTE.
I'en ſçay la verité par ſes propres diſcours, Sa bouche a deuant moy deſcouuert ſes amours, Il eſt encor ſi vain, que meſme il a l’audace, De croire, qu'Aminthas luy doit ceder la place.	J'en sais la vérité par ses propres discours, Sa bouche a devant moi découvert ses amours, Il est encor si vain, que même il a l'audace, De croire, qu'Aminthas lui doit céder la place.
Peut-eſtre rioit-il.	Peut-être riait-il.
AMINTHAS.	AMINTHAS.
CALLISTE.	CALLISTE.
c'eſt en vain, que tu veux antounjen omongioig ouvte tantomeue deureux.	c'est en vain, que tu veux antounjen omongioig ouvte tantome devreux.
AMINTHAS.	AMINTHAS.
Je veux dans vn moment enſeigner à ce traiſtre, Qu'il eſt bien dangereux de ne pas ſe conneſtre?	Je veux dans un moment enseigner à ce traître, Qu'il est bien dangereux de ne pas se connaître?
A-t’il donc oublié quelle fut la bonté, Qui l’alla ſecourir dans ſa neceßité.	A-t-il donc oublié quelle fut la bonté, Qui l'alla secourir dans sa necemité.
Il n’oſera iamais, ou mon ame eſt trompée, Si ie fais l’appeller, dégaigner ſon épée.	Il n'osera jamais, ou mon âme est trompée, Si tu fais l'appeler, dégaigner son épée.
Il ſe reſſouuiendra de l’obligation, Dont il eſt redeuable à mon affection.	Il se ressouviendra de l'obligation, Dont il est redevable à mon affection.
CALLISTE, I’ay ſondé ſur ce point ſon cœur opiniaſtre, Et ie ſçay, que ce traiſtre eſt tout prest à combattre.	CALLISTE, J'ai sondé sur ce point son cœur opiniâtre, Et ton sais, que ce traître est tout prêt à combattre.
Il te veut auiourd’huy témoigner par ſon bras, Que Melas eſt autant amoureux, qu'Aminthas.	Il te veut aujourd'hui témoigner par son bras, Que Melas est autant amoureux, qu'Aminthas.
AMINTHAS.	AMINTHAS.
Sçachons ſi les effets reſpondent au langage, Ie verray, ſi la force égale le courage.	Sachons si les effets répondent au langage, Je verrai, si la force égale le courage.
Ce bras, qui m’a ſeruy dans mille occaſions, Ne démentira pas ſes nobles actions.	Ce bras, qui m'a servi dans mille occasions, Ne démentira pas ses nobles actions.
Mais parmi les douleurs, dont l’excez m’importune, Ie me dois ſatisfaire, & benir ma fortune.	Mais parmi les douleurs, dont l'excès m'importune, Je me dois satisfaire, et bénir ma fortune.
Ie me voy plus heureux, que ie ne croyois pas, C’eſt qu’au moins mon riual eſt digne d’Aminthas.	Je me vois plus heureux, que sans ne croyais pas, C'est qu'au moins mon rival est digne d'Aminthas.
Eſt digne d’Aminthas, i’offence Floriſelle.	Est digne d'Aminthas, j'offense Floriselle.
Il faut auoir du cœur pour aimer cette belle.	Il faut avoir du cœur pour aimer cette belle.
.	.
, rfait, rien de defectueux N’oſeroit, ſans rougir, porter ſi haut ſes vœux, Ses yeux ſont deux ſoleils, qui bleſſent les paupieres, Il n'appartient, qu'à l’aigle, à ſouffrir leurs lumieres.	, Çafait, rien dé défectueux N'oserait, sans rougir, porter si haut ses vœux, Ses yeux sont deux soleils, qui blessent les paupières, Il n'appartient, qu'à l'aigle, à souffrir leurs lumières.
SCENE	SCÈNE
S CE CIN( N L VIESME.	SEIGNEUR CE CIN( GRÈS NIÈME.
CLORIMAN, AMINTHAS.	CLORIMAN, AMINTHAS.
CLORIMAN.	CLORIMAN.
Ve veut dire Aminthas, ce viſage abbatu, D'ou vient ce changement, quel deſplaiſir as-tu.	Ve veut dire Aminthas, ce visage abattu, D'ou vient ce changement, quel déplaisir as-tu.
Ces yeux tous enfonceZ, qui ſont remplis de flame Deſcouurent, malgré toy, le trouble de ton ame.	Ces yeux tous enfoncés, qui sont remplis de flamme Découvrent, malgré toi, le trouble de ton âme.
Seroit-ce point l’amour, ce tyran de nos cœurs, Qui fait voir auiourd’huy contre toy ſes rigueurs.	Serait-ce point l'amour, ce tyran de nos cœurs, Qui fait voir aujourd'hui contre toi ses rigueurs.
S'ans doute la douleur, dont ton ame eſt ſaiſie Ne procede d’ailleurs, que d’vne jalouſie.	S'ans doute la douleur, dont ton âme est saisie Ne procède d'ailleurs, que d'une jalousie.
AMINTHAS.	AMINTHAS.
Il eſt vray Cloriman, il eſt temps de parler, Tu reconnois le mal, que ie ne puis celer.	Il est vrai Cloriman, il est temps de parler, Tu reconnais le mal, que ie ne puis celer.
Il est vray, qu’vn ingrat, par vn deſſein perfide, Trahiſſant mon amour, ſe rend mon homicide.	Il est vrai, qu'vn ingrat, par un dessein perfide, Trahissant mon amour, se rend mon homicide.
Mais le traiſtre en mourra, ſçais tu bien, que l’amour M’obligea de partir ſi ſoudain de la Cour.	Mais le traître en mourra, sçais tu bien, que l'amour M'obligea de partir si soudain de la Cour.
l’auois veuchez, Medor l’aimable Floriſelle.	l'avais veuchez, Médor l'aimable Floriselle.
Mon cœur en fut bleſſé d’vn atteinte mortelle, Alors qu’elle partit pour venir dans ces lieux, Ie ne püs demeurer eſloigné de ſes yeux, Melas s’offrit à moy dans l’ardeur de mon ame, Et ie fis cét ingrat confident de ma flame.	Mon cœur en fut blessé d'un atteinte mortelle, Alors qu'elle partit pour venir dans ces lieux, Je ne puis demeurer éloigné de ses yeux, Melas s'offrit à moi dans l'ardeur de mon âme, Et ainsi fis cet ingrat confident de ma flamme.
Mais ce perfide au lieu de ſeruir ſon amy A fait voir, qu’il eſtoit mon plus grand ennemy.	Mais ce perfide au lieu de servir son ami A fait voir, qu'il était mon plus grand ennemi.
Il s’eſt laiſſé ſurprendre aux charmes de ma belle, Et ſon cœur n'a pas craint de ſe rendre infidelle.	Il s'est laissé surprendre aux charmes de ma belle, Et son cœur n'a pas craint de se rendre infidèle.
CLORIMAN.	CLORIMAN.
Ce rencontre, Aminthas, fait voir deuant tes yeux, Qu'on ne peut éuiter la Iuſtice des Cieux.	Ce rencontre, Aminthas, fait voir devant tes yeux, Qu'on ne peut éviter la Justice des Cieux.
Ils ont voulu punir dans cette inquietude Ta ſale trahiſon par vn ingratitude Tu trompas Perſelide, & luy manquas doſoy, 2 Et tu crois, qu’on ait tort d’en manquer enuers boy.	Ils ont voulu punir dans cette inquiétude Ta sale trahison par un ingratitude Tu trompas Perselide, et lui manquas dos, 2 Et tu crois, qu'on ait tort d'en manquer envers boy.
Mais ie dis, que ton crime eſt encor bien plüs laſche, Amy pardonne moy, ſi ce diſcours te faſche.	Mais ici dis, que ton crime est encor bien plüs lâche, Ami pardonne moi, si ce discours te fâche.
Je trouue que Melas à moins fait, qu'Aminthas, Ie ne voy, qu'Aminthas, d’offencé par Celas, Mais Aminthas fait tort à toute vne famille.	Je trouve que Mélas à moins fait, qu'Aminthas, Je ne vois, qu'Aminthas, d'offensé par Celas, Mais Aminthas fait tort à toute une famille.
Melas trahit vn homme, Aminthas vne fille.	Mélas trahit un homme, Aminthas une fille.
Les hommes ont receu dans leurs mains le pouuoir, De vanger les affronts, qu’ils peuuent receuoir, Mais il faut, qu'vne fille endure ton offence Sans qu'elle oſe esperer d’en tirer la vangeance.	Les hommes ont recev dans leurs mains le pouvoir, De venger les affronts, qu'ils peuvent recevoir, Mais il faut, qu'une fille endure ton offense Sans qu'elle ose espérer d'en tirer la vengeance.
AMINTHAS.	AMINTHAS.
Il est vray, que i'eus tort de faucer mes ſermens, Obeuis quoye eſt ont eboſe oruinutre aux Amants.	Il est vrai, que j'eus tort de saucer mes serments, Obis quoie est ont ébose oruinutre aux Amants.
Et le Ciel nous pardonne aiſement cett' injure, Alors que dans l’amour noſtre esprit ſe parjure, Mais le traiſtre en mourra, qui m’a manqué de foy,	Et le Ciel nous pardonne aisément cett' injure, Alors que dans l'amour nôtre esprit se parjure, Mais le traître en mourra, qui m'a manqué de foi,
CLORIMAN.	CLORIMAN.
Mais außi Floridor ſe veut vanger de toy,	Mais aussi Floridor se veut venger de toi,
I il On n’a pas veu depuis ton depart Perſelide, Tout le moùde à la Cour te prend pour vn perfide, On t’excuſe, on t’accuſe, on ne ſçait, qu’en penſer:	I il On n'a pas vu depuis ton départ Persélide, Tout le moùde à la Cour te prend pour un perfide, On t'excuse, on t'accuse, on ne sait, qu'en penser:
Tes amis d’vn coſte te veulent excuſer, Les autres au contraire accuſent ta malice:	Tes amis d'un côte te veulent excuser, Les autres au contraire accusent ta malice:
Le Roy meſme a permis d’en faire la juſtice.	Le Roi même a permis d'en faire la justice.
L’on cherche des teſmoins, on court, on va par tout, Le Prince veut pouſſer l’affaire iuſqu’au bout.	L'on cherche des témoins, on court, on va par tout, Le Prince veut pousser l'affaire jusqu'au bout.
Mais Floridor paroiſt transporté de colere, La volonté du Roy ne peut ſatisfaire, Cetté longueur le faſche, il demandé ſa ſœur, Jl ſouſtient qu'Aminthas en eſt le rauiſſeur.	Mais Floridor paraît transporté de colère, La volonté du Roi ne peut satisfaire, Ceté longueur le fâche, il demandé sa sœur, Il soutient qu'Aminthas en est le ravisseur.
AMINTHAS.	AMINTHAS.
Que i’ay rauy ſa ſœur.	Que j'ai ravi sa sœur.
Floridor n’eſt pas ſage De tenir ces diſcours à mon deſauantage.	Floridor n'est pas sage De tenir ces discours à mon désavantage.
CLORIMAN.	CLORIMAN.
Tu pourrois te tromper, Floridor à deſſein De parler auec toy, mais l’espée à la main.	Tu pourrais te tromper, Floridor à dessein De parler avec toi, mais l'épée à la main.
AMINTHAS.	AMINTHAS.
J'aimay iadis la ſœur, i’aime aujourd’huy lefrere.	J'aimai jadis la sœur, j'aime aujourd'hui lefre.
Son courage me plaiſt, ie le veux ſatisfaire, Son bras, quandil voudra, rencontrera le mien, Qui ſera touſiours preſt pour contenter le ſien.	Son courage me plaît, je le veux satisfaire, Son bras, quandil voudra, rencontrera le mien, Qui sera toujours prêt pour contenter le sien.
Puis qu’il croit, qu'Aminthas a rauy Perſelide, On ne ſçauroit blaſmer la fureur qui le guide, Ie ne puis, qu’approuuer ſa reſolution.	Puis qu'il croit, qu'Aminthas a ravi Persélide, On ne saurait blâmer la fureur qui le guide, Je ne puis, qu'approuver sa résolution.
CLORIMAN.	CLORIMAN.
Jl a quitté la Cour à cett’intention, On louoit ſon deſſein, mais le Roy s’en offence, Il croit, que Floridor ait choque ſa puiſſance.	Il a quitté la Cour à cett-intention, On louait son dessein, mais le Roi s'en offense, Il croit, que Floridor ait choque sa puissance.
Le Conſeil ſur ce point m'a deſpeſché vers toy, Appren par ce papier la volonté du Roy.	Le Conseil sur ce point m'a dépêché vers toi, Appren par ce papier la volonté du Roi.
AMINTHAS, liſant la Lettre du Roy.	AMINTHAS, lisant la Lettre du Roi.
Loridor en colere, eſt party de la Cour, A On n’a pû retenirce cœur opiniaſtre, Mais ton Prince, Aminthas, te deffend de te battre, Ie voudrois te reuoir, auance ton retour.	Loridor en colère, est parti de la Cour, A De n'a pu retenirce cœur opiniâtre, Mais ton Prince, Aminthas, te défend de te battre, Je voudrais te revoir, avance ton retour.
CLORIMAN.	CLORIMAN.
Queue ſeſponco umiſ cona iu donc, que ie faſſe,	Queue sesponco umis cona ju donc, que votre fasse,
AMINTHAS.	AMINTHAS.
Que ie veux obeïr.	Que tu veux obéir.
CLORIMAN.	CLORIMAN.
Adieu, que ie t’embraſſe.	Adieu, que rien t'embrasse.
S A E 2 SIXIESME.	S À E 2 SIXIÈME.
AMINTHAS ſeul.	AMINTHAS seul.
A	À
STANCES.	STANCES.
Beïr:	Béir:
le pourrois-ie?	le pourrais-je?
ah traiſtre ſentiment?	ah traître sentiment?
OAy-ie oſe proferer vn mot ſi laſchement, Alors que l’on m'appelle.	OI-je ose proférer un mot si lâchement, Alors que l'on m'appelle.
Obeir:	Obeir:
ie ne puis:	Ne ne puis:
ce ſeroit me trahir, I4 eſioignant ente temps des yeux de Floriſelle, Pour vouloir obeir.	ce serait me trahir, I4 esioignant ente temps des yeux de Floriselle, Pour vouloir obéir.
Ie veux plutoſt punir vn inſolent riual, Que ce bras animé faße voir, qu’on fait mal D’irriter ma colere.	Je veux plutôt punir un insolent rival, Que ce bras animé fasse voir, qu'on fait mal D'irriter ma colère.
Courons à Floridor, donnons luy ce plaiſir,	Courons à Floridor, donnons-même ce plaisir,
Allons parler à luy, ie le veux ſatisfaire Dans ſon iuste deſir.	Allons parler à Rome, je le veux satisfaire Dans son juste désir.
883e 2532	883e 2532
Ou te reſcudras-tu miſerable Aminthas, A l’inſtant, que ie veux me vanger de Melas, Floridor me demande.	Ou te récudras-tu misérable Aminthas, A l'instant, que ie veux me venger de Mélas, Floridor me demande.
Qui dois-ie ſatisfaire!	Qui dois-je satisfaire!
ô Dieux ma peine eſt grande?	ô Dieux ma peine est grande?
Quel eſt le plus preſſe.	Quel est le plus presse.
u	
Ie ne ſçay quel conſeil ie dois prendre aujourd’huy?	Je ne sais quel conseil apprendre dois prendre aujourd'hui?
Me deurois-ie reſoudre à contenter autruy, Außi toſt que moy meſme.	Me devrais-je résoudre à contenter autrui, Aussi tôt que moi -même.
Enonnents dans mion esprit compat auet tamour, Tous deux de ma ſoibleſſe en ce malheur extreme Triomphent à leur tour.	Enonnents dans myon esprit compat auet tamour, Tous deux de ma soiblesse en ce malheur extrême Triomphent à leur tour.
Tous deux éralement commandent dans mon cœur Mais voyons a la fin, qui ſera le vainqueur	Tous deux éralement commandent dans mon cœur Mais voyons à la fin, qui sera le vainqueur
Dedans Dedans cette querelle.	Dedans Dedans cette querelle.
La perte de l’honneur me cauſe le treſpas, Mais mon cœur pourroit bien oublier Floriſelle	La perte de l'honneur me cause le trépas, Mais mon cœur pourrait bien oublier Floriselle
Sans la mort d'Aminthas.	Sans la mort d'Aminthas.
236 *30 Laiſſons donc Floridor, allons contre Melas, Il me faut ſouſtenir l’intereſt d’Aminthas, Et prendre ſa deffence.	236 *30 Laissons donc Floridor, allons contre Mélas, Il me faut soutenir l'intérêt d'Aminthas, Et prendre sa défense.
Je ſçay, qu’außi l’amour eſt plus cher, que l’honneur, L’honneur dedans l’esprit a fait ſa reſidence, L’amour dedans le cœur.	Je sais, qu'aussi l'amour est plus cher, que l'honneur, L'honneur dedans l'esprit a fait sa résidence, L'amour dedans le cœur.
2838 Mis Que l’amour, & l’honneur ayent vn pouuoir eſgal, Ils ſont tous deux d’accord, & contre mon riual	2838 Mis Que l'amour, et l'honneur aient un pouuoir égal, Ils sont tous deux d'accord, et contre mon rival
Quelle erreur me ſurprend:	Quelle erreur me surprend:
non, non:	non, non:
ie ne ſçaurois Oublier mon amour, quand meſme ie pourrois En conceuoir l’enuie.	Ne ne saurais Oublier mon amour, quand rendre un pourrais En concevoir l'envie.
Si mon œil voit encor la lumiere du iour, Ie n’ay point de chaleur, qui conſerue ma vie, Que celle de l’amour.	Si mon œil voit encor la lumière du jour, Je n'ai point de chaleur, qui conserve ma vie, Que celle de l'amour.
aigriſſent mon courage.	aigrissent mon courage.
Ce m’eſt vn deſ-honneur, qui tombe ſur mon front, D'endurer, qu’vn riual ait ſur moy l’auantage, Sans vanger cét affront.	Ce m'est un des-honneur, qui tombe sur mon front, D'endurer, qu'un rival ait sur moi l'avantage, Sans venger cet affront.
Allons donc hardiment, armons-nous pour noſtre heur, Souſtenons l’intereſt de l’amour, & l’honneur, Combat tons pour leur gloire.	Allons donc hardiment, armons-nous pour notre heur, Soutenons l'intérêt de l'amour, et l'honneur, Combat tons pour leur gloire.
Je vay faire appeller ce traiſtre audacieux, Mon courage auiourd’huy me promet la victoire, De la part de deux Dieux.	Je vais faire appeler ce traître audacieux, Mon courage aujourd'hui me promet la victoire, De la part de deux Dieux.
Prlruu tromeime Acte.	Prlru tromeime Acte.
A I TROISIESME.	A I TROISIÈME.
FLORISELLE, ſeule.	FLORISELLE, seule.
MN peu de treue amour, vn moment de relaſche, S8 * 4e Mon ame n’en peut plus, ta fureur me l’arache!	MN peu de trouve amour, un moment de relâche, S8 * 4e Mon âme n'en peut plus, ta fureur me l'arache!
Traitestu donc ſi mal ceux, qui ſont ſous ta loy!	Traitestu donc si mal ceux, qui sont sous ta loi!
Qu'il fait mauuais d’auoir vn tyran pour ſon Ah cruel permets moy de prendre vn peu d’haleine, (Roy.	Qu'il fait mauvais d'avoir un tyran pour son Ah cruel permets moi de prendre un peu d'haleine, (Roi.
Pour mieux pouuoir ſouffrir la rage de ta haine.	Pour mieux pouvoir souffrir la rage de ta haine.
Amour ta cruauté ſe trompe en ſon deſſein, Mon ame ne ſent plus les efforts de ta main.	Amour ta cruauté se trompe en son dessein, Mon âme ne sent plus les efforts de ta main.
A force de ſouffrir ie deuiens inſenſible.	À force de souffrir ainsi deviens insensible.
Helas ie parle en vain, ton cœur eſt inflexible.	Hélas der parle en vain, ton cœur est inflexible.
L’amour auec la mort eſt d’accord en ce point, Ils ont tous deux vn cœur, qui ne s’amolit point.	L'amour avec la mort est d'accord en ce point, Ils ont tous deux un cœur, qui ne s'amolit point.
Non, non:	Non, non:
ils ſont ſans cœur, ſans yeux, & ſans oreilles, Ou bien i'aurois flechy ces rigueurs ſans pareilles.	ils sont sans cœur, sans yeux, et sans oreilles, Ou bien j'aurais fléchi ces rigueurs sans pareilles.
S'ils n'eſtoient pas ſans yeux.	S'ils n'étaient pas sans yeux.
L’amour voyant mes maux Ne me liureroit pas de ſi cruels aſſauts.	L'amour voyant mes maux Ne me livrerait pas de si cruels assauts.
Si l’amour n’eſtoit ſourd, il entendroit ma plainte, Jlſçauroit les douleurs, dont mon ame eſt atteinte, Que s’il auoit vn cœur, il ſe lairroit toucher A l’excés de mes pleurs?	Si l'amour n'était sourd, il entendrait ma plainte, Jlsçauroit les douleurs, dont mon âme est atteinte, Que s'il avait un cœur, il se lairrait toucher A l'excès de mes pleurs?
fut-ce vn cœur de rocher.	fut-ce un cœur de rocher.
C’eſt en vain, que ie veux excuſer la malice D’vn monſtre, dont mes maux teſmoignent l’injuſtice.	C'est en vain, que ainsi veux excuser la malice D'un monstre, dont mes maux témoignent l'injustice.
Ce tyran me tourmente & dedans, & dehors, Il preſſe également mon eſprit, & mon corps.	Ce tyran me tourmente et dedans, et dehors, Il presse également mon esprit, et mon corps.
Alors qu’il me vainquit, il me ſurprit en traiſtre.	Alors qu'il me vainquit, il me surprit en traître.
Maintenant il fait voir, qu’il eſt vn mauuais maiſtre.	Maintenant il fait voir, qu'il est un mauvais maître.
D’abord pour m’attaquer ce monſtre ſans pitié, Me parut ſous le voile, & le nom d’amitié.	D'abord pour m'attaquer ce monstre sans pitié, Me parut sous le voile, et le nom d'amitié.
Il ne ſe fait plus voir, que tout armé de flame, Et craignant le dépit, qui peut naiſtre en mon ame, Qu'elle ne reuoltat contre luy ma raiſon,	Il ne se fait plus voir, que tout armé de flamme, Et craignant le dépit, qui peut naître en mon âme, Qu'elle ne révoltât contre lui ma raison,
Il s’eſt mis dans mon cœur luy meſme en garniſon, Et pour mieux s’aſſeurer par vn malheur extreme, Il a fait deux partis contraires dans moy meſme, Le ſien eſt le plus fort:	Il s'est mis dans mon cœur était même en garnison, Et pour mieux s'assurer par un malheur extrême, Il a fait deux partis contraires dans moi -même, Le sien est le plus fort:
tous mes ſens d’vn costé Combattent contre moy pour ſon authorité.	tous mes sens d'un côté Combattent contre moi pour son autorité.
Retien ton bras amour, ſi ta rage infinte Exerce ainſi par tout la meſme tyrannie!	Retien ton bras amour, si ta rage infinte Exerce ainsi par tout la même tyrannie!
Qu’elle fin te peux-tu propoſer pour objet, Enfin tu cours danger d’eſtre vn Roy ſans ſujet.	Qu'elle fin te peux-tu proposer pour objet, Enfin tu cours danger d'être un Roi sans sujet.
Qui pourroit reſiſter à tant de maux enſemble, Que l’importunité de ta fureur aſſemble.	Qui pourrait résister à tant de maux ensemble, Que l'importunité de ta fureur assemble.
Lucidor ce tyran, qui me tient ſous ſa loy, Et me fait tant ſouffrir ne depend, que de toy!	Lucidor ce tyran, qui me tient sous sa loi, Et me fait tant souffrir ne dépend, que de toi!
Cruel veux-tu ſeruir d’inſtrument à ſa rage, Maintenant qu’ilaigrit contre moy ſon courage.	Cruel veux-tu servir d'instrument à sa rage, Maintenant qu'ilaigrit contre moi son courage.
Arreſte Lucidor la fureur d’vn enfant, Que tes diuins attraits ont rendu triomphant.	Arrête Lucidor la fureur d'Hô enfant, Que tes divins attraits ont rendu triomphant.
Blaſmons le ſentiment de l’ignorant vulgaire, Qui nous dit, que l’amour à Venus pour ſa mere.	Blâmons le sentiment de l'ignorant vulgaire, Qui nous dit, que l'amour à Venus pour sa mère.
Tu fais voir Lucidor leur erreur en ce lieu, Tes charmes ont donné la naiſſance à ce Dieu.	Tu fais voir Lucidor leur erreur en ce lieu, Tes charmes ont donné la naissance à ce Dieu.
L’amour, qui me tourmente, eſt vn enfant ſans mere, Il n’a cher Lucidor, que tes yeux pour ſon pere.	L'amour, qui me tourmente, est un enfant sans mère, Il n'a cher Lucidor, que tes yeux pour son père.
Tes attraits l’ont fait naiſtre, & mon cœur le nourrit, Et c’eſt ce qui le plus afflige mon esprit,	Tes attraits l'ont fait naître, et mon cœur le nourrit, Et c'est ce qui le plus afflige mon esprit,
Qu’vne neceßité d’vnè force abſoluë M’oblige de nourrir le ſerpent, qui me tuë.	Qu'une necessité d'vnè force absolue M'oblige de nourrir le serpent, qui me tue.
Que i’aime Lucidor, cette neceßité Qui force mon eſprit d’adorer ta beauté.	Que j'aime Lucidor, cette nécessité Qui force mon esprit d'adorer ta beauté.
Tire amour contre moy, ie cheris tes bleſſures!	Tire amour contre moi, ie chéris tes blessures!
S'erpent enuenimé, que i’aime tes piqueures.	S'erpent envenimé, que j'aime tes piqueures.
frrite ta fureur:	frrite ta fureur:
mais fai moy voir encor La cauſe de mon mal, l’aimable Lucidor.	mais fait moi voir encor La cause de mon mal, l'aimable Lucidor.
Allons chez Aminthas, peut-eſtre ſa fortune Offrira le ſecours au mal, qui m’importune.	Allons chez Aminthas, peut-être sa fortune Offrira le secours au mal, qui m'importune.
Allons cheZ Aminthas, cherchons l’occaſion Pour pouuoir contenter ma belle paſsion.	Allons chez Aminthas, cherchons l'occasion Pour pouvoir contenter ma belle passion.
S 4 4 E T DEVXIESME.	 4 4 E TE DEUXIÈME.
CLORIMAN, FLORIDOR.	CLORIMAN, FLORIDOR.
E	E
FLORIDOR.	FLORIDOR.
NE traiſtre a donc osé trahiſſant vne fille CFaire ce deſ-honneur à toute ma famille.	NE traître a donc osé trahissant une fille CFaire ce déshonneur à toute ma famille.
Ses diſcours affecteZ n’ont point trompé ma ſœur.	Ses discours affectes n'ont point trompé ma sœur.
S’il la tient en ſes mains, il en eſt rauiſſeur.	S'il la tient en ses mains, il en est ravisseur.
Quoy qu'on die à la Cour, ie connois Perſelide.	Quo qu'on die à la Cour, je connais Persélide.
Elle a trop de vertu pour aimer ce perfide.	Elle a trop de vertu pour aimer ce perfide.
Allons donc hardiment.	Allons donc hardiment.
Il faut vanger l’affront, Qui tombe ſur ma teſte, & fait rougir mon front.	Il faut venger l'affront, Qui tombe sur ma tête, et fait rougir mon front.
Endurer que l’enuie impute à ma memoire, D’auoir mal ſouſtenu l’intereſt de ma gloire.	Endurer que l'envie impute à ma mémoire, D'avoir mal soutenu l'intérêt de ma gloire.
Il faut pluſtoſt noyer ce fer dedans ſon flanc, Et lauer cette taſche auec fon propre ſang.	Il faut plutôt noyer ce fer dedans son flanc, Et lauer cette tâche homme son propre sang.
Comment à l’auenir oſerois-ie pareſtre, St ie nevangeois pas l’audace de ce traiſtre.	Comment à l'avenir oserais-je paraître, St tu nevangeais pas l'audace de ce traître.
Mais voicy Cloriman:	Mais voici Cloriman:
mon cœur en eſt ſurpris.	mon cœur en est surpris.
Il vient pour empeſcher le deſſein, que i’ay pris.	Il vient pour empêcher le dessein, que j'ai pris.
Allons à ſa rencontre, & s’il m’eſt trop contraire, Il le faut engager auec moy dans l’affaire.	Allons à sa rencontre, et s'il m'est trop contraire, Il le faut engager avec moi dans l'affaire.
Je connois Cloriman, ie ſçay, qu’il est ſoldat, Ie ſçay qu’il n’oſeroit refuſer le combat.	Je connais Cloriman, ie sais, qu'il est soldat, Je sais qu'il n'oserait refuser le combat.
Celoriman, quel ſujet t’ameine en la Prouince.	Celoriman, quel sujet t'amène en la Province.
CLORIMAN.	CLORIMAN.
I'obeïs Floridor aux volontés du Prince, Le Roy me commanda de partir de la Cour, Afin de t’obliger d’auancer ton retour.	J'obéis Floridor aux volontés du Prince, Le Roi me commanda de partir de la Cour, Afin de t'obliger d'avancer ton retour.
Il croit, quoy que ton cœur ait ſujet de ſe plaindre, Que ton eſprit deuoit pour vn temps ſe contraindre.	Il croit, quoi que ton cœur ait sujet de se plaindre, Que ton esprit devait pour un temps se contraindre.
Qu'il faloit luy laiſſer la vangeance en ſa main, Qu'il eut bien mieux, que toy pourſuiuy ton deſſein.	Qu'il fallait toujours laisser la vengeance en sa main, Qu'il eut bien mieux, que toi poursui ton dessein.
Tous nos raiſonnemens ne l’ont pù ſatisfaire, Il ſcuit, que Floridor tranſporté de colere Va chercher Aminthas pour ſe battre auec luy, Il voudroit en peſcher ce deſſein aujourd’huy.	Tous nos raisonnements ne l'ont pu satisfaire, Il sit, que Floridor transporté de colère Va chercher Aminthas pour se battre a lui, Il voudrait en pêcher ce dessein aujourd'hui.
FLORIDOR.	FLORIDOR.
Souffrir donc, Cloriman, qu’vn traiſtre ait eu l’audace De faire vn des honneur ſi ſanglant à ma race.	Souffrir donc, Cloriman, qu'un traître ait eu l'audace De faire un des honneur si sanglant à ma race.
Qu’il me ſoit deffendu d’en tirer la raiſon.	Qu'il me soit défendu d'en tirer la raison.
Ce conſeil m’importune, il n'eſt pas de ſaiſon.	Ce conseil m'importune, il n'est pas de saison.
Si ie receus l’honneur en naiſſant pour partagé, Ie ne le perdray pas à faute de courage.	Si ici reçus l'honneur en naissant pour partagé, Je ne le perdrai pas à faute de courage.
CLORIMAN.	CLORIMAN.
Floridor, c’eſt en vain, que nous auons des Rois, Si nous ne voulons pas obeir à leurs Lois, Si l’on rauit nos biens, ſi quelqu’vn nous offence, Ce n'eſt pas à nos mains d’en tirer la vangeance.	Floridor, c'est en vain, que nous avons des Rois, Si nous ne voulons pas obéir à leurs Lois, Si l'on ravit nos biens, si quelqu'un nous offense, Ce n'est pas à nos mains d'en tirer la vengeance.
Que ſi nous nous battons contre leur volonté, Nous faiſons vn injure à leur authorité.	Que si nous nous battons contre leur volonté, Nous faisons un injure à leur autorité.
FLORIDOR.	FLORIDOR.
C’eſt vn raiſonnement de quelque esprit timide, Qui n’auroit pas le cœur de punir vn perfide.	C'est un raisonnement de quelque esprit timide, Qui n'aurait pas le cœur de punir un perfide.
Ie connois Cloriman, ne t’en excuſe point, Ton cœur démentira ta langue ſur ce point.	Je connais Cloriman, ne t'en excuse point, Ton cœur démentira ta langue sur ce point.
Il eſt trop genereux pour tenir la maxtme, Qui croit, que la grandeur du courage eſt vn crime.	Il est trop généreux pour tenir la maxtâme, Qui croit, que la grandeur du courage est un crime.
Tu ne ſçaurois ſouffrir, qu’vn homme t’oſfenpat Quno oomon, que tu mutis euton fertevangeat.	Tu ne saurais souffrir, qu'un homme t'osfenpat Quno oommon, que tu mutis euton fertevangeat.
CLORIMAN.	CLORIMAN.
Si le Roy refuſoit de me rendre justice.	Si le Roi refusait de me rendre justice.
Ie ſçay bien, qu’il faudroit que ie me la rendiſſe.	Je sais bien, qu'il faudrait que personne me la rendisse.
FLORIDOR.	FLORIDOR.
Faut-il pour ſe vanger d’vn affront, qu’on nous fait, Attendre qu’vn procez, ſoit inſtruit, & parfaif.	Faut-il pour se venger d'un affront, qu'on nous fait, Attendre qu'un procès, soit instruit, et parfait.
Ie ne ſçaurois ſouffrir ces longueurs ordinaires, Ie hais tous ces delais, qui ſont lors neceſſaires.	Je ne saurais souffrir ces longueurs ordinaires, Je hais tous ces délais, qui sont lors nécessaires.
Tu ſçais, que la vangeance à bien plus de douceur, Alors que l’offence peut punir l’offenceur,	Tu sais, que la vengeance à bien plus de douceur, Alors que l'offense peut punir l'offenseur,
CLORIMAN.	CLORIMAN.
S’il nous eſtoit permis de nous vanger nous meſmes.	S'il nous était permis de nous venger nous mêmes.
Les inconueniens, qui ſuiuroient ſont extremes.	Les inconvéniens, qui suivraient sont extrêmes.
On verroit des appels ſur vn ſimple ſoupçon, On verroit des combats, qui naiſtroient ſans raiſon.	On verrait des appels sur un simple soupçon, On verrait des combats, qui naîtraient sans raison.
Nos cœurs n’auroient iamais aſſez de patience, Pour voir ſi l’offenceur ſeroit dans l’innocence.	Nos coeurs n'auraient jamais assez de patience, Pour voir si l'offenseur serait dans l'innocence.
Les ſûjets des duels ne finiroient iamais, Perſonne ne pourroit s’aſſeurer de la paix.	Les sujets des duels ne finiraient jamais, Personne ne pourrait s'assurer de la paix.
Si ie meurs au combat, apres ce coup funeſte, I'auray pour me vanger vn amy, qui me reſte.	Si personne meurs au combat, après ce coup funeste, J'aurai pour me venger un ami, qui me reste.
Noſtre esprit aueugle par noſtre paßion, Nous embaraſſeroit dans la confuſion.	Notre esprit aveugle par notre passion, Nous embarrasserait dans la confusion.
Crois-tu bienpour vouloir contenter ſon enuie, Qu'on puiſſe abſolument dispoſer de ſa vie.	Crois-tu bienpour vouloir contenter son envie, Qu'on puisse absolument disposer de sa vie.
Elle n’eſt pas a nous:	Elle n'est pas à nous:
nous la deuons chacun, Conſeruer auec ſoin pour le bien du commun.	nous la devons chacun, Conserver avec soin pour le bien du commun.
Mais vots-tu le malheur, que ton erreur t’appreste, Regarde le danger, ou ta fureur te jette.	Mais vots-tu le malheur, que ton erreur t'apprête, Regarde le danger, ou ta fureur te jette.
A meſme que tu veux, te vanger d’vn affront;	A même que tu veux, te venger d'un affront;
N’en peus-tu pas außi receuoir vn ſecond.	N'en pus-tu pas aussi recevoir un second.
Je connois Aminthas:	Je connais Aminthas:
tu le connois toy-meſme, Ie ne le flatte point, à cauſe que ie l’aime.	tu le connais toi-même, Je ne le flatte point, à cause que ie l'aime.
Tu ſçais, qu’il eſt adroit, & qu’il eſt courageux, Il a ſouuent fait voir, qu’il eſtoit genereux.	Tu sais, qu'il est adroit, et qu'il est courageux, Il a souvent fait voir, qu'il était généreux.
Jl connoit ta valeur, & tu connois la ſienne, Son espée est pointue, außi bien, que la tienne.	Il connaît ta valeur, et tu connais la sienne, Son épée est pointue, aussi bien, que la tienne.
FLORIDOR.	FLORIDOR.
Que le ſort fauoriſe, à qui le Ciel voudra, Mais ou bien Floridor, ou le traiſtre en mourrãI’eſpere que les Dieux n’auront pas la malice De laiſſer aujourd’huy triomphar l’injuſtice.	Que le sort favorise, à qui le Ciel voudra, Mais ou bien Floridor, ou le traître en mourrandIespère que les Dieux n'auront pas la malice De laisser aujourd'hui triomphar l'injustice.
Dop quupuiſeummuuiu puuu, paus craindre rien, Effacer cet affront dans ſon ſang, ou le mien,	Dop quupuiseummuuiu puuu, paus craindre rien, Effacer cet affront dans son sang, ou le mien,
CLORIMAN.	CLORIMAN.
Es-tu bien aſſeuré, qu’Aminthas ſoit coupable Qu’il ait raui ta ſœur, qu'il ſoit ſi miſerable.	Es-tu bien assuré, qu'Aminthas soit coupable Qu'il ait ravi ta sœur, qu'il soit si misérable.
C’est vn peu Floridor ſe trop precipiter, Tu condamnes vn homme auant que l’eſcouter.	C'est un peu Floridor se trop précipiter, Tu condamnes un homme avant que l'écouter.
Eſclaircy-toy pluſtoſt:	Esclaircy-toi plutôt:
ſois aſſeuré du crime, Lors ton reſſentiment ſe rendra legitime.	sois assuré du crime, Lors ton ressentiment se rendra légitime.
FLORIDOR.	FLORIDOR.
Ah pourquoy Cloriman excuſer ce voleur, Tu ſçais bien à quel point ce traiſtre aimoit ma ſœur.	Ah pourquoi Cloriman excuser ce voleur, Tu sçais bien à quel point ce traître aimait ma sœur.
Je croiray que l’amour leur partageoit ſes flames, Que d’vn eſgale ardeur il bruſloit leurs deux ames.	Je croirai que l'amour leur partageait ses flammes, Que d'un égale ardeur il brûlait leurs deux âmes.
CLORIMAN.	CLORIMAN.
Mais conſidere außi, qu’vn homme genereux emenut toupours thonnenr, quoy quit ſoit amoureux.	Mais considère aussi, qu'une homme généreux emenut toupours thonnenr, quoi quit soit amoureux.
FLORIDOR.	FLORIDOR.
L’honneur n’a point de lieu dans noſtre ame inſenſes, Quand les traits de l’amour en bleſſent la penſée.	L'honneur n'a point de lieu dans notre âme insensés, Quand les traits de l'amour en blessent la pensée.
Si ie blaſme Aminthas:	Si ici blâme Aminthas:
c’eſt que depuis le iour, Que ce perfide oſa s’abſenter de la Cour, On n’a pas veu ma ſœur.	c'est que depuis le jour, Que ce perfide osa s'absenter de la Cour, On n'a pas vu ma sœur.
CLORIMAN.	CLORIMAN.
Le ſoupçon, qui t’offence, N’a pour ſon fondement, que la ſeule apparence.	Le soupçon, qui t'offense, N'a pour son fondement, que la seule apparence.
Mais moy, qui viens de voir Aminthas aujourd’huy, Ie me ſuis eſclaircy ſur ce point auec luy.	Mais moi, qui viens de voir Aminthas aujourd'hui, Je me suis éclairci sur ce point avec lui.
FLORIDOR.	FLORIDOR.
Le traiſtre eſt donc icy:	Le traître est donc ici:
mon ame eſt ſatisfaite.	mon âme est satisfaite.
Ie n’ay plus à chercher le lieu de ſa retraite.	Je n'ai plus à chercher le lieu de sa retraite.
L iii Il ne peut m’eſchapper, par quelle folle erreur Oſoit-il eſperer d’euiter ma fareur.	 Li Il ne peut m'échapper, par quelle folle erreur Osait-il espérer d'éviter ma fareur.
Vn meſchant tost, ou tard reçoit ſa recompence, Le Cierne pent fouſpin onetimnt fana cangeance.	Un méchant tôt, ou tard reçoit sa récompense, Le Cierne pent fouspin onetimnt fana cangeance.
CLORIMAN.	CLORIMAN.
Si tu veux te vanger, va chercher l’offenceur, Aminthas m’a iuré, qu’il n’a point veu ta ſœur.	Si tu veux te venger, va chercher l'offenseur, Aminthas m'a juré, qu'il n'a point vu ta sœur.
Il eſt vray, qu’autrefois il a bruſle pour elle.	Il est vrai, qu'autrefois il a brûle pour elle.
MCais ie ſçay maintenant, qu’il aime Floriſelle.	MAis ie sais maintenant, qu'il aime Floriselle.
Alors que cette belle abandonna la Cour, Il ne peut endurer l’abſence d’vn ſeul iour.	Alors que cette belle abandonna la Cour, Il ne peut endurer l'absence d'un seul jour.
FLORIDOR.	FLORIDOR.
C’eſt en vain, Cloriman, que ce traiſte s’amuſe A vouloir inuenter vne ſi foible excuſe.	C'est en vain, Cloriman, que ce traîte s'amuse A vouloir inventer une si faible excuse.
Jl croit deſauouant le crime, qu’il a fait, Que mon cœur en pourra demeurer ſatisfait:	Il croit désavouant le crime, qu'il a fait, Que mon cœur en pourra demeurer satisfait:
Ce perfide à la fin, a connu ſon offence, Il voudroit m'appaiſer:	Ce perfide à la fin, a connu son offense, Il voudrait m'apaiser:
il en craint la vangeancé,	il en craint la vengeancé,
CLORIMAN.	CLORIMAN.
Tu ne le connois pas, il n’eut iamais de peur, Alors qu’il luy falut combatre pour l’honneur.	Tu ne le connais pas, il n'eût jamais de peur, Alors qu'il apprendre fallut combattre pour l'honneur.
Cét eſprit genereux m’a fait aſſeZ conneſtre, Qu’il eſtoit offencé, qu’on le prit pour vn traiſtre, Il eſtoit ſur le point de ſe battre auec toy.	Cet esprit généreux m'a fait assez connaître, Qu'il était offensé, qu'on le prit pour un traître, Il était sur le point de se battre avec toi.
Mais le Roy luy deffend.	Mais le Roy lui défend.
FLORIDOR.	FLORIDOR.
Malgré l’ordre du Roy, Ce traiſtre ſe battra, quoy qu’il n’ait pas d’enuie, Jls'y verra contraint pour conferuer ſa vie.	Malgré l'ordre du Roi, Ce traître se battra, quoi qu'il n'ait pas d'envie, Jls'y verra contraint pour conserver sa vie.
D C E N E TROISIESME.	D Ç E N E TROISIÈME.
AMINTHAS.	AMINTHAS.
CALLISTE.	CALLISTE.
AMINTHAS.	AMINTHAS.
E ne ſçay quel eſpoir renaiſt dedans mon cœur?	ET ne sais quel espoir renaît dedans mon cœur?
TL’amour ſeroit-il las d’exercer ſa rigueur?	TL'amour serait-il las d'exercer sa rigueur?
Auroit-il obligé cette belle inhumaine De voir auec pitié la grandeur de ma peine.	Aurait-il obligé cette belle inhumaine De voir avec pitié la grandeur de ma peine.
Ie ne ſçay qu’en iuger!	Je ne sais qu'en juger!
dois-i’esperer, ou non.	dois-j'espérer, ou non.
Mon eſprit me dejfend d’attendre rien de bon.	Mon esprit me déjend d'attendre rien de bon.
Quoy qu'enfin le deſir pour cét espoir combatte I'ay peur ma chere ſœur, que mon cœur ne ſe flatte.	Quoi qu'enfin le désir pour cet espoir combatte J'ai peur ma chère sœur, que mon cœur ne se flatte.
CAL	CAL
CALLISTE.	CALLISTE.
Maintenant Aminthas, que le bonheur te rit!	Maintenant Aminthas, que le bonheur te rit!
Quelle peur de nouueau vient troubler mon eſprit.	Quelle peur de nouveau vient troubler mon esprit.
Ton amour, mon cherfrere, eſt trop ingenieuſe Pour croiſtre les tourments d’vn’ame malheureuſe.	Ton amour, mon cherfre, est trop ingénieuse Pour croître les tourments d'vn’âme malheureuse.
Chaſſe cette frayeur, fai ſur toy cét effort, Il faut à l’auenir eſperer mieux du ſort.	Chasse cette frayeur, fait sur toi cet effort, Il faut à l'avenir espérer mieux du sort.
AMINTHAS.	AMINTHAS.
Ma ſœur, i’ay ſi ſouuent ſouffert ſon injuſtice, uhuemitutpouque ie croins ſa malice.	Ma sœur, j'ai si souvent souffert son injustice, uhuemitutpouque ie croins sa malice.
Mlon esprir apres tont nepeut Simaginer, Que le Ciel ſe reſolue à vouloir m'eſpargner.	Mlon éprir après tont neput Simaginer, Que le Ciel se résolue à vouloir m'épargner.
Je ſuis trop malheureux.	Je suis trop malheureux.
CALLISTE.	CALLISTE.
Banny cette triſteſſe, Cette crainte importune offence ta Maiſtreſſe, Floriſelle eſt enfin fauorable à tes vœux, L’amour bruſle ſon cœur de l’ardeür de tes feux.	Banni cette tristesse, Cette crainte importune offense ta Maîtresse, Floriselle est enfin favorable à tes vœux, L'amour brûle son cœur de l'arder de tes feux.
Sa viſite a fait voir, qu’à la fin cette belle Ne peut plus meſpriſer vn' amour ſi fidelle.	Sa visite a fait voir, qu'à la fin cette belle Ne peut plus mépriser une amour si fidèle.
AMINTHAS.	AMINTHAS.
Quoy que cette viſite ait charmé mes douleurs, I'ay peur de rencontrer vn ſerpent ſous des fleurs.	Quoi que cette visite ait charmé mes douleurs, J'ai peur de rencontrer un serpent sous des fleurs.
Qui puiſſe teſmoigner, que mon amour te bouche.	Qui puisse témoigner, que mon amour te bouche.
CALLISTE.	CALLISTE.
He quoy ne faut-il pas vn peu dißimuler.	He quoi ne faut-il pas un peu dissimuler.
Va, va, pour vn amant, tu ne vois guere clair.	Va, va, pour un amant, tu ne vois guère clair.
Tu ne connois pas mieux le deſſein d’vn amante, Qui s’efforce à cacher l’amour, qui la tourmente.	Tu ne connais pas mieux le dessein d'un amante, Qui s'efforce à cacher l'amour, qui la tourmente.
Mon frere Floriſelle à plus d’amour que toy.	Mon frère Floriselle à plus d'amour que toi.
Tu peux aſſeurement t'en rapporter à moy.	Tu peux assurément t'en rapporter à moi.
Ces yeux, cette rougeur, ce trouble de ſon ame, Faiſoient pareſtre aßés la grandeur de ſa flame.	Ces yeux, cette rougeur, ce trouble de son âme, Faisaient paraître assez la grandeur de sa flamme.
AMINTHAS.	AMINTHAS.
Mais las!	Mais las!
que ſes diſcours!	que ses discours!
& que tant de froideur, Ma ſœur, me ſembloient mal reſpondre à mon ardeur.	et que tant de froideur, Ma sœur, me semblaient mal répondre à mon ardeur.
Si quelque mot m'a plû!	Si quelque mot m'a plusu!
dy moy quelle apparence, Que mon cœur en oſat conceuoir d’eſperance.	dis -moi quelle apparence, Que mon cœur en osât concevoir d'espérance.
C’eſtoit vu pur effet de ſa ciuilité, Qui la faiſoit parler contre la verité?	C'était vu pur effet de sa civilité, Qui la faisait parler contre la vérité?
Hé quoy tu n’as donc pas reconnu la contrainte.	Hé quoi tu n'as donc pas reconnu la contrainte.
Qu'ene auoit a reſpondre auecque tant de feinte.	Qu'enée avait à répondre auecque tant de feinte.
CALLISTE.	CALLISTE.
Elle ne pouuoit mieux te deſcouurir ſon cœur, Sans en bannir la honte, & trahir ſon honneur.	Elle ne pouvait mieux te découvrir son cœur, Sans en bannir la honte, et trahir son honneur.
Mon frere voulois-tu, que ſa langue indiſcrete Parlat plus clairement de ſa flame ſecrete, Ses yeux qui demeuroient ſur ton pagé attachés Parloient aſſés des feux, qu’elle tenoit cachés.	Mon frère voulais-tu, que sa langue indiscrète Parlat plus clairement de sa flamme secrète, Ses yeux qui demeuraient sur ton pagé attachez Parlaient assez des feux, qu'elle tenait cachés.
Elle a pris Lucidor, pour la mener chez elle.	Elle a pris Lucidor, pour la mener chez elle.
Il t'en rapportera quelque heureu ſe nouuelle.	Il t'en rapportera quelque heureu se nouvelle.
La honte l’empeſchoit de dire deuant moy, Que ſon cœur amoureux ne bruſloit, que pour toy.	La honte l'empêchait de dire devant moi, Que son cœur amoureux ne brûlait, que pour toi.
AMINTHAS.	AMINTHAS.
Attendons donc, ma ſœur:	Attendons donc, ma sœur:
mais cependant mon ame, Ne peut ſouffrir, qu’vn traiſtre oſe trahir ma flame.	mais cependant mon âme, Ne peut souffrir, qu'un traître ose trahir ma flamme.
Ie veux auec ce ſer enſeigner à Melas.	Je veux avec ce ser enseigner à Mélas.
Qu'il fait mal d’irriter la fureur de mon bras.	Qu'il fait mal d'irriter la fureur de mon bras.
CALLISTE.	CALLISTE.
Tu n'as, cher Aminthas, qu’à faire de querelle, Si tu peux poſſeder le cœur de Floriſelle.	Tu n'as, cher Aminthas, qu'à faire de querelle, Si tu peux posséder le cœur de Floriselle.
Vn traiſtre n’a iamais de ſi grand deplaiſir, Que quand ſa trahiſon ne peut pas reuſſir.	Un traître n'a jamais de si grand déplaisir, Que quand sa trahison ne peut pas réussir.
AMINTHAS.	AMINTHAS.
Mais Melas publira, que faute de puiſſance, Je n'ay pas chaſtié ſon extreme inſolence, Que ſi ma courtoiſie auoit ſceu l’obliger, Ce perfide apprendra, que ie ſçay me vanger.	Mais Mélas publira, que faute de puissance, Je n'ai pas châtié son extrême insolence, Que si ma courtoisie avait su l'obliger, Ce perfide apprendra, que tu sais me venger.
S CDN E ATRIESME.	 SDN E ATRIESME.
CALLISTE ſeule.	CALISTE seule.
Vel conſeil dois-tu prendre amante infortunée?	Vel conseil dois-tu prendre amante infortunée?
Blaſmeras-tu touſiours ta rude deſtinée.	Blâmeras-tu toujours ta rude destinée.
La colere, & l’amour me troublent à la fois Tous deux eſgalement me tiennent ſous leurs lois.	La colère, et l'amour me troublent à la fois Tous deux également me tiennent sous leurs lois.
Si te ſuy les tranſports d’vne injuſte colere, Il faut punir Melas par les mains de mon frere.	Si te suis les transports d'une injuste colère, Il faut punir Mélas par les mains de mon frère.
L'amour en meſme temps me deffend de blaſmer Celuy, pour qui ie ſuis contrainte de m’aimer.	L'amour en même temps me défend de blâmer Celui, pour qui tu suis contrainte de m'aimer.
Mais quoy ſouffrir außi, qu’vn autre le poſſede.	Mais quoi souffrir aussi, qu'un autre le possède.
Accourez deſeſpoirs, accoureZ a mon aide.	Accourez désespoirs, accourez à mon aide.
Souffrir, qu’vne riuale ait le traiſtre en ſes bras Non, non:	Souffrir, qu'une rivale ait le traître en ses bras Non, non:
il faut pluſtoſt ſe vanger de Mela.	il faut plutôt se venger de Mela.
Souffrir impunement, que l’amour, qui me dompte, Permette, qu’vn ingrat trio nphe de ma honte.	Souffrir impunément, que l'amour, qui me dompte, Permette, qu'vn ingrat trio nphe de ma honte.
Laiſſons agir mon frere augmentons ſa fureur.	Laissons agir mon frère augmentons sa fureur.
Qu’il vange d’vn ſeul coup & le frere, & la ſœur.	Qu'il venge d'un seul coup et le frère, et la sœur.
Qu’aujourd’huy des amants cét humeur inconſtante Apprene, qu’il fait mal d’irriter vn’amante.	Qu'aujourd'hui des amants cet humeur inconstante Apprène, qu'il fait mal d'irriter une amante.
Floriſelle a fait voir, qu’elle adoroit Melas, Perdons donc ce perfide, & ne l’espargnons pas.	Floriselle a fait voir, qu'elle adorait Mélas, Perdons donc ce perfide, et ne l'épargnons pas.
Qu’il meure:	Qu'il meure:
& ſi ſans luy Calliſte ne peut viure, Elle ſçaura trouuer le moyen de le ſuiure.	et si sans lui Caliste ne peut vivre, Elle saura trouver le moyen de le suivre.
SCEN -2 R CINQVIESME LVCIDOR.	SCEN 2 RINVIESME LUCIDOR.
u duuine STANC ES.	Ou du STANC ES.
Ve Floriſelle eſt miſerable!	Ve Floriselle est misérable!
Qu'elle ſent de rudes aſſauts:	Qu'elle sent de rudes assauts:
Pour moy ie laiſſe tous mes maux, Pour pleurer celuy, qui l’accable.	Pour moi quelque laisse tous mes maux, Pour pleurer celui, qui l'accable.
Soleil, toi qui ſur l’Vniuers 2 .	Soleil, toi qui sur l'Univers 2 .
* Portes tes yeux touſiours ouuerts!	* Portes tes yeux toujours ouverts!
4 2).	4 2).
Vis-tu iamais de peine égale, nluigus:	Vis-tu jamais de peine égale, nluigus:
Puiſque l’exces de ſes douleurs Oblige meſme vne riuale D'auoir pitié de ſes malheurs.	Puisque l'excès de ses douleurs Oblige même une rivale D'avoir pitié de ses malheurs.
3.	3.
.	.
	
Son mal ne guarit pas le mien.	Son mal ne guérit pas le mien.
C’eſt auec raiſon, qu’on nous chante, Que l’amour n'eſt rien, qu’vn enfant.	C'est avec raison, qu'on nous chante, Que l'amour n'est rien, qu'un enfant.
L’eſpoir, qui reſte dans mon ame, Flatte la douleur, qui me nuit, Mais ma' riuale, qui me ſuit!	L'espoir, qui reste dans mon âme, Flatte la douleur, qui me nuit, Mais ma rivale, qui me suit!
Qu'eſperoit-elle dans ſa flame.	Qu'espérait-elle dans sa flamme.
Aminthas eſtant inconſtant Me rend heureuſe en vn inſtant.	Aminthas étant inconstant Me rend heureuse en un instant.
Floriſelle eſt plus mal-heureuſe, Mon mal eſt moindre, que le ſien, Mais dans cetté peine amoureuſe CeſſeZ ames trop dédaigneuſes, Uoyez le pouuoir de l’amour, Comment ſa colere en vn iour Rend trois perſonnes mal-heureuſes.	Floriselle est plus malheureuse, Mon mal est moindre, que le sien, Mais dans ceté peine amoureuse Cessez âmes trop dédaigneuses, Uoyez le pouvoir de l'amour, Comment sa colère en un jour Rend trois personnes malheureuses.
Si lors que l’on peut ſe vanger Nos maux ſe pouuoient alleger.	Si lors que l'on peut se venger Nos maux se pouvaient alléger.
Amour ta iuſtice eſt extreme, Qui ne voit pas en vn moment, Que tu me vanges par moi-méme De ceux, qui cauſent mon tourment.	Amour ta justice est extrême, Qui ne voit pas en un moment, Que tu me venge par moi-même De ceux, qui causent mon tourment.
Il fait voir, qu'il eſt impuiſſant .	Il fait voir, qu'il est impuissant .
Dans ce malheur, qui nous tourmente.	Dans ce malheur, qui nous tourmente.
A minthas auec ſa froideur Ne peut ſoulager mon ardeur.	À minthas avec sa froideur Ne peut soulager mon ardeur.
Dautre part cette miſerable Se voit conſumer dans ſes yeux;	Dautre part cette misérable Se voit consumer dans ses yeux;
Et par vn ſort impitoyable Mon ſexe s’oppoſe à ſes vœux.	Et par un sort impitoyable Mon sexe s'oppose à ses vœux.
Ah banniſſons la ialouſie, Deliurons-la de ſon erreur:	Ah bannissons la jalousie, Délivrons-la de son erreur:
Mais c’eſt courir à mon malheur, Que de guarir ſa fantaiſie.	Mais c'est courir à mon malheur, Que de garir sa fantaisie.
Ie pourrois dans ce changement, L’obliger d’aimer mon amant.	Je pourrais dans ce changement, L'obliger d'aimer mon amant.
Laiſſons là donc, qu’elle ſoupire, Quelle languiſſe nuit, & iour.	Laissons là donc, qu'elle soupire, Quelle languisse nuit, et jour.
Donnons, pour croistre ſon martire, De l’esperance a ſon amour.	Donnons, pour croître son martyre, De l'espérance à son amour.
S { E N SIXIESME.	 { E N SIXIÈME.
FLORIDOR, LVCIDOR.	FLORIDOR, LUCIDOR.
E	E
FLORIDOR.	FLORIDOR.
Es yeux ſont-ils troublés d’vn objet enchanteur, I?	Es yeux sont-ils troublés d'être objet enchanteur, I?
RIuſtes Dieux!	RItes Dieux!
que ce page eſt ſemblable à ma ſœur.	que ce page est semblable à ma sœur.
Apprenons & ſon nom, & celuy de ſon maiſtre.	Apprenons et son nom, et celui de son maître.
Mais il ſemble rougir, & n’oſer pas pareſtre.	Mais il semble rougir, et n'oser pas paraître.
Cn m'a dit que c’eſtoit la maiſon d’Aminthas?	Cn m'a dit que c'était la maison d'Aminthas?
Mais ſeroit-ce ma ſœur, haſtons vn peu le pas.	Mais serait-ce ma sœur, hâtons un peu le pas.
LVCIDOR.	LUCIDOR.
Il eſt vray c’est ta ſœur, c’est cette miſerable, Qui par vn trait hardy, qui n’a point de ſemblable, Apres auoir perdu ſon eſprit, & ſon coeur Oſe courir apres, & ſuiure ſon vainqueur.	Il est vrai c'est ta sœur, c'est cette misérable, Qui par un trait hardi, qui n'a point de semblable, Après avoir perdu son esprit, et son coeur Ose courir apres, et suivre son vainqueur.
fe n’ay pas fait pourtant ce tort à ma famille, Que d’auoiroubtie te denoin done fiute.	se n'ai pas fait pourtant ce tort à ma famille, Que d'avoiroubtie te denoin done fivte.
FLORIDOR.	FLORIDOR.
Va monſtre, va l’horreur de la terre, & des Cieux!	Va montre, va l'horreur de la terre, et des Cieux!
Oſes-tu bien encore te monſtrer à mes yeux.	Oses-tu bien encore te montrer à mes yeux.
Va, va fille effrontée?	Va, va fille effrontée?
as-tu bien l’inſolence D’ouurir ſi hardiment la bouche en ta deffence.	as-tu bien l'insolence D'ouvrir si hardiment la bouche en ta défense.
Va, du moins tu deurois apres cett’action, Marquer vn repentir par ta confuſion.	Va, du moins tu devrais après cel'action, Marquer un repentir par ta confusion.
Apres auoir commis vne faute ſi noire, Pour croiſtre ton peché, tu veux en faire gloire.	Après avoir commis une faute si noire, Pour croître ton péché, tu veux en faire gloire.
Mais quoy, ſi ton honneur n’auoit pas le pouuoir De rompre le deſſein, que tu pouuois auoir!	Mais quoi, si ton honneur n'avait pas le pouvoir De rompre le dessein, que tu pouvais avoir!
Reſpon moy ſur ce point!	Respon moi sur ce point!
que t’auoit fait tonfrere.	que t'avait fait tonfrere.
Tu deuois t’arreſter pour l’amour de ton pere.	Tu devais t'arrêter pour l'amour de ton père.
Tu deuois épargner l’honneur de ta maiſon.	Tu devais épargner l'honneur de ta maison.
Mais ton cœur n’eſtoit pas capable de raiſon.	Mais ton cœur n'était pas capable de raison.
ii	ji
escon peres LVCIDOR.	écon pères LUCIDOR.
FLORIDOR.	FLORIDOR.
Pour couurir la honte de ta vie, Peut-eſtre diras-tu, qu'Aminthas t’a rauie.	Pour couvrir la honte de ta vie, Peut-être diras-tu, qu'Aminthas t'a ravie.
Mais ton effronterie, & ce deſguiſement, Font voir, qu'on ne doit pas accuſer ton amant.	Mais ton effronterie, et ce déguisement, Font voir, qu'on ne doit pas accuser ton amant.
Enfin à mon malheur mes yeux m’ont fait conneſtre, Que i’auois tort de prendre Aminthas pour vn traiſtre.	Enfin à mon malheur mes yeux m'ont fait connaître, Que j'avais tort de prendre Aminthas pour un traître.
Ta fuite eſt vn effet de ta meſchanceté, ſeil el jalal, qu aceufer tontinpharelle.	Ta fuite est un effet de ta méchanceté, seil jalal, aceufer tontinpharelle.
Mais du moins il faloit éuiter le ſcandale En voulant contenter ta paßion brutale.	Mais du moins il fallait éviter le scandale En voulant contenter ta passion brutale.
LVCIDOR.	LUCIDOR.
Floridor, il eſt vray, ie ne m'en deffends pas.	Floridor, il est vrai, Seigneur ne m'en défends pas.
Toy-meſme tu ſçais bien, que i’aimois Aminthas.	Toi-même tu sais bien, que j'aimais Aminthas.
Mais ce perfide amant n’eut pas veu Floriſelle, Qu'il fauſſa ſes ſermens, & me fut infidelle.	Mais ce perfide amant n'eut pas veu Loriselle, Qu'il faussa ses serments, et me fut infidèle.
Ie ne pus endurer les mépris de l’ingrat, Qu’il ſuiuit ma riuale, & qu’il m’abandonnat.	Je ne pus endurer les mépris de l'ingrat, Qu'il suivît ma rivale, et qu'il m'abandonnât.
FLORIDOR.	FLORIDOR.
Aminthas en ce poinct n’eſt pas digne de blaſme.	Aminthas en ce point n'est pas digne de blâme.
N’auoit-il pas raiſon de quitter vn infame.	N'avait-il pas raison de quitter un infâme.
Apres auoir connu quelle eſtoit ton hum.	Apres avoir connu quelle était ton hum.
ur!	ur!
Deuoit-il conſeruer tes flames dans ſon cœur.	Devait-il conserver tes flammes dans son cœur.
Aminthas a fait voir vn trait d’vn homme ſage, On aime la vertu beaucoup mieux, qu’vn viſage!	Aminthas a fait voir un trait d'un homme sage, On aime la vertu beaucoup mieux, qu'un visage!
Crois-tu donc qu’il deuoit ne brusler, que pour toyNon, non:	Crois-tu donc qu'il devait ne brûler, que pour toiNon, non:
il a bien fait de retirer ſa foy.	il a bien fait de retirer sa foi.
Jl fit bien d’adreſſer ſes vœux à Floriſelle, Puiſque c’eſt vne fille, auſsi ſage, que belle.	Il fit bien d'adresser ses vœux à Floriselle, Puisque c'est une fille, aussi sage, que belle.
LVCIDOR.	LUCIDOR.
mom ejprbesr portoron epe peni prrs de vn erreur, Ett tu fais ſans raiſon vn injure à ta ſœur.	moment éjprbesr portoron épe peni près de un erreur, Ett tu fais sans raison un injure à ta sœur.
Flori ſelle il eſt vray n’eſt pas ſi malheureuſe.	Flori selle il est vrai n'est pas si malheureuse.
Mais außi ie ſçai bien, qu’elle eſt moins vertueuſe.	Mais aussi apprendre sais bien, qu'elle est moins vertueuse.
FLORIDOR.	FLORIDOR.
Apres auoir perdu tœn honneur!	Apres avoir perdu tœn honneur!
voudrois-tu Attaquer Floris lle, & noircir ſa vertu!	voudrais-tu Attaquer Floris lèle, et noircir sa vertu!
N iij Oſes-tu te porter à cette meſdiſance.	 Nij Oses-tu te porter à cette médisance.
LVCIDOR.	LUCIDOR.
Les preuues, que i’en ay m’en donnent aſſeurance.	Les preuves, que j'en ai m'en donnent assurance.
Elle aime Perſelide, & ſon cœuramoureux M’a ſouuent deſcouuert la grandeur de ſes feux.	Elle aime Persélide, et son cœuramoureux M'a souvent découvert la grandeur de ses feux.
L’amour qui n’a point d’yeux à trompe ſa penſée, Il n’a pas reconnu, que i’eſtois deſguiſée.	L'amour qui n'a point d'yeux à trompe sa pensée, Il n'a pas reconnu, que j'étais déguisée.
Va cheZ elle à minuit, & iuge par effet, Si i’ay rien inuenté du diſcours, que i’ay fait.	Va chez elle à minuit, et juge par effet, Si j'ai rien inventé du discours, que j'ai fait.
Vn'aßignation m'eſt donnée à cette heure, Rus jgoio oinejeset oiotonnene ſeers fer oto meure.	Un assignation m'est donnée à cette heure, Rus jgoio oinejeset oiotonnene seers fer oto meure.
Va-t’en, au rendés-vous, ie m’arreſte à ces mots.	Va-t-en, au rendez-vous, Elle m'arrête à cette mots.
Et ne puis ſans rougir acheuer ces propos.	Et ne puis sans rougir achever ces propos.
FLORIDOR.	FLORIDOR.
Cepandant chere ſœur, quelle eſt cett' injuſtice, Que l’amour aujourd’huy me rende ton complice.	Cépandant chère sœur, quelle est cett' injustice, Que l'amour aujourd'hui me rende ton complice.
Ouy ma ſœur il le faut, & ſans plus raiſonner J’approuue vn’action, que i’oſois condamner.	Oui ma sœur il le faut, et sans plus raisonner J'approuve inaction, que j'osais condamner.
Que ſi ton procedé ſembloit peu legitime, Je veux par mon exemple authoriſer ton crime, Mais quoy que ie conſente aux deſirs de ton cœur.	Que si ton procédé semblait pu légitime, Je veux par mon exemple autoriser ton crime, Mais quoi que deux consente aux désirs de ton cœur.
lii vi Ie voudrois bien außi conſeruer ton honneur.	li vi Je voudrais bien aussi conserver ton honneur.
I'approuue touamour, & l’ardeur de ta flame.	J'approuve touamour, et l'ardeur de ta flamme.
Mais ie blaſme vn deſſein, qui te peut rendre infame, Deſpouille ces habits:	Mais ici blâme un dessein, qui te peut rendre infâme, Despouille ces habits:
ſans ce deſguiſement Peut-eſtre pourrons nous ramener ton amant.	sans ce déguisement Peut-être pourrons nous ramener ton amant.
Ie t'en oſe aſſeurer:	Je t'en ose assurer:
puiſque par ton adreſſe Mon cœur, ſans y peuſer, recouure vne maiſtreſſe.	puisque par ton adresse Mon cœur, sans y peuser, recouvre une maîtresse.
Fin du quatrieſme Acte.	Fin du quatrième Acte.
A { I E CINQVIESME	À „ I E INQUIESME
SCENE IREMIERE.	SCÈNE IREMIÈRE.
FLORIDOR, FLORISELLE.	FLORIDOR, FLORISELLE.
2.	2.
FLORIDOR.	FLORIDOR.
Eiiss *** Elle ne croyeZpas, que ie ſois à genoux Pour vouloir arreſter vostre iuſte courroux.	Éjiss * Elle ne croyeZpas, que deux sois à genoux Pour vouloir arrêter votre juste courroux.
Non, non:	Non, non:
ie ſuis vn traiſtre, vn' ame deſloyale, Dont la temerité ſe trouue ſans eſgale.	Je suis un traître, une âme déloyale, Dont la témérité se trouve sans égale.
Prenez, ce fer en main, pouſſeZ-le dans mon flanc, PoiſſeZ, il faut noyer ma faûte dans mon ſang.	Prenez, ce fer en main, poussés-le dans mon flanc, Poissez, il faut noyer ma faûte dans mon sang.
Voſtre Voſtre esprit eſt ſaiſi d’vn courroux legitime, Armez-vous contre moy, vangés-vous de mon crime.	Votre Votre esprit est saisi d'un courroux légitime, Armez-vous contre moi, vengez-vous de mon crime.
FLORISELLE.	FLORISELLE.
O Cieux en quel haſard!	Ô Cieux en quel hasard!
ai-je mis mon honneur, D'auoir receu chés-nous, & de nuit vn voleur.	ai-je mis mon honneur, D'avoir recev chez-nous, et de nuit un voleur.
FLORIDOR.	FLORIDOR.
Va, tu mets ton honneur à couuert de l’enuie, Si par tes propres mains le traiſtre en perd la vie, Mon ſang témoignera, qu’vn mal-heureux amant Entra de nuit enesstoy jaus torc confentemenr.	Va, tu mets ton honneur à couvert de l'envie, Si par tes propres mains le traître en perd la vie, Mon sang témoignera, qu'un malheureux amant Entra de nuit enesstoi jaus torc confentemenr.
Prence fer!	Prence fer!
que crains-tu.	que crains-tu.
Fai voir par ta vengeance La preuué de mon crime, & de ton innocence.	Fai voir par ta vengeance La preué de mon crime, et de ton innocence.
FLORISELLE.	FLORISELLE.
Ie veux, qu’apres ta mort ton ſang ait le pouuoir D'oſter l’opinion, qu’on pourroit conceuoir.	Je veux, qu'après ta mort ton sang ait le pouvoir D'ôter l'opinion, qu'on pourrait concevoir.
Ie puis tromper vn peuple en ce malheur extréme!	Je puis tromper un peuple en ce malheur extrême!
Mais puis-je me flatter, & me tromper moi-meſme.	Mais puis-je me flatter, et me tromper moi-même.
Perfide tu ſçais bien, que ie ne le puis point, Et que ma conſcience eſt mon iuge en ce point.	Perfide tu sais bien, que je ne le puis point, Et que ma conscience est mon juge en ce point.
Malgré tous les diſcours, qu’vn peuple en pourra faire, Elle ſera touſiours certaine du contraire.	Malgré tous les discours, qu'un peuple en pourra faire, Elle sera toujours certaine du contraire.
S'ans ceſſe ſa juſtice en tout temps, en tous lieux Offriroit la grandeur de ma faute à mes yeux.	S'ans cesse sa justice en tout temps, en tous lieux Offrirait la grandeur de ma faute à mes yeux.
Et pourrois ie ſouffrir de me voir accuſee Par l’importunité d’vne telle penſée.	Et pourrais ie souffrir de me voir accuse Par l'importunité d'une telle pensée.
FLORIDOR.	FLORIDOR.
Souffrés, ſouffrés du moins, que ce fer, & ce bras Pour punir mon audace auancent mon trespas.	Souffrez, souffrez du moins, que ce fer, et ce bras Pour punir mon audace avancent mon trépas.
Puis que vous refusés de me rendre juſtice!	Puis que vous refusez de me rendre justice!
Voulés-vous empécher, que ce bras me puniſſe.	Voulez-vous empêcher, que ce bras me punisse.
Jl me faut reparerma faute par ma main.	Il me faut réparerma faute par ma main.
En voicy le moyen.	En voici le moyen.
FLORISELLE.	FLORISELLE.
Arreſte ton deſſein.	Arrête ton dessein.
Quelle erreur te ſurprent, quelle fureur t'emporte ?	Quelle erreur te surprend, quelle fureur t'emporte ?
Crois-tu donc reparer toncrime de la ſorte.	Crois-tu donc réparer toncrime de la sorte.
Non, va-t'en, ſors d’icy:	Non, va-t'-en, sors d'ici:
cependant que la nuit Ne fait pas encor place au Soleil, qui la ſuit.	cependant que la nuit Ne fait pas encor place au Soleil, qui la suit.
Va, cache ton depart, empeche que l’enuie Ne faſſe auec raiſon des diſcour, de ma vie.	Va, cache ton départ, empèche que l'envie Ne fasse auec Roi des discour, de ma vie.
Je demande vne grace a ton affection De ne me perdre pas de reputation.	Je demande une grâce a ton affection De ne me perdre pas de réputation.
Mais quelle eſt la rigueur, où le Ciel m’a reduite, Qu'au lieu de me vanger ie procure ta fuite.	Mais quelle est la rigueur, où le Ciel m'a réduite, Qu'au lieu de me venger quelque procure ta fuite.
Amour, dont le conſeil m’a miſe en ce danger, Honneur, dont le respect defend de me vanger.	Amour, dont le conseil m'a mise en ce danger, Honneur, dont le respect défend de me venger.
Comment ſe doit mon cœur reſoudre en cet affaire, Que la neceßité de vos loix eſt contraire.	Comment se doit mon cœur résoudre en cet affaire, Que la necessité de vos lois est contraire.
Autheur de mon malheur aimable Lucidor, Parmy cet accident mon cœur t’adore encor.	Auteur de mon malheur aimable Lucidor, Parmi cet accident mon cœur t'adore encor.
Mon ame eſt toute en feu, ſi la tienne eſt de glace:	Mon âme est toute en feu, si la tienne est de glace:
Mais pourquoy m'enuoyer vn perfide à ta place?	Mais pourquoi m'envoyer un perfide à ta place?
N'eſtoit-ce pas aſſés de meſpriſer mes vœux Sans publier encor la honte de mes feux.	N'était-ce pas assez de mépriser mes vœux Sans publier encor la honte de mes feux.
FLORIDOR.	FLORIDOR.
Ie veux en quatre mots te tirer hors de peine, Que ce fer puis apres ſatisface à ta haine.	Je veux en quatre mots te tirer hors de peine, Que ce fer puis après satisface à ta haine.
Si ie me viens offrir au lieu de Lucidor, Il auoit tranſporté ſes droits à Floridor.	Si personne me viens offrir au lieu de Lucidor, Il avait transporté ses droits à Floridor.
Tu ne trouueras pas ſon deſſein fort eſtrangé, Alors que tu ſçauras le ſujet de ce change, Lucidor ne pouuoit eſtre ton poſſeſſeur, Son ſexe l’empechoit, Lucidor eſt ma ſœur.	Tu ne trouveras pas son dessein fort estrangé, Alors que tu sauras le sujet de ce change, Lucidor ne pouvait être ton possesseur, Son sexe l'empêchait, Lucidor est ma sœur.
Perſelide eſt ſon nom:	Persélide est son nom:
mais l’amour, qui la guide, La nomme Floridor au lieu de Perſelide.	mais l'amour, qui la guide, La nomme Floridor au lieu de Persélide.
Tu ſçais quels ont eſté les deſſeins d’Aminthas, Sçache außi, que ma ſœur ne le hayſſoit pas.	Tu sais quels ont été les desseins d'Aminthas, Sçache aussi, que ma sœur ne le haïssait pas.
L’amour brusloit leurs cœurs d’vn ardeur mutuelle, Mais a peine Aminthas eut connu Floriſelle.	L'amour brûlait leurs cœurs d'un ardeur mutuelle, Mais a peine Aminthas eut connu Floriselle.
Qu’il ſentit dans ſon cœur allumer d’autres feux, Qu'il oublia ma ſoeur, & t’adreſſa ſes voeux.	Qu'il sentit dans son cœur allumer d'autres feux, Qu'il oublia ma soeur, et t'adressa ses voeux.
Mais pourquoy s’arreſter a parler de ſa flame, Tu connois mieux que moy les ardeurs de ſon ame.	Mais pourquoi s'arrêter a parler de sa flamme, Tu connais mieux que moi les ardeurs de son âme.
Ie croy, que la grandeur de ſon affection, T’a ſouuent témoigné, quelle eſt ſa paßion.	Je crois, que la grandeur de son affection, T'a souvent témoigné, quelle est sa passion.
Tu ſçais, que ton départ l’obligea de te ſuiure.	Tu sais, que ton départ l'obligea de te suivre.
Tu ſçais, que loin de toy cét amant ne peut viure.	Tu sais, que loin de toi cet amant ne peut vivre.
Mais ma ſoeur d’autrepart ſe faſchant, qu’vn ingrat Oubliat ſes ſermens, & qu’il l’abandonnat, Ne peut pas l’imiter en cette perfidie, Mais l’amour en ce temps la rendant plus hardie La tranſveſtit en Page, & ſous ce veſtement Elle quit ta la Cour, & ſuiuit ſon amant.	Mais ma soeur d'autrepart se fâchant, qu'un ingrat Oubliat ses serments, et qu'il l'abandonnât, Ne peut pas l'imiter en cette perfidie, Mais l'amour en ce temps la rendant plus hardie La transvêtit en Page, et sous ce vêtement Elle quit ta la Cour, et suivit son amant.
Juge de ce qui ſuit.	Juge de ce qui suit.
Perſelide eſt ce Page, Qui vient en ce moment de te faire vn meſſage.	Persélide est ce Page, Qui vient en ce moment de te faire un message.
Si iamais Lucidor eut de part en ton coeur, Donne la meme place au frere, qu'à la ſoeur.	Si jamais Lucidor eut de part en ton coeur, Donne la même place au frère, qu'à la soeur.
FLORISELLE.	FLORISELLE.
Que ie ſuis Floridor heureuſement trompée, Pour vanger ton offence, il ne faut plus d’espée.	Que ie suis Floridor heureusement trompée, Pour venger ton offense, il ne faut plus d'épée.
Puiſqu’aujourd’hui les Cieux nous veulẽt redre heureux, Qu'ils ſemblent approuuer nos deſſeins amoureux, Donne-moy ta parole, attendant la iournée, Qu'onpourra publier vn ſibel Hymenée.	Puisqu'aujourd'hui les Cieux nous veulent redre heureux, Qu'ils semblent approuver nos desseins amoureux, Donne-moi ta parole, attendant la journée, Qu'onpourra publier un sibel Hyménée.
E N DEVXIESME.	E N DEUXIÈME.
PERSELIDE, LYSIS.	PERSELIDE, LYSIS.
E	E
PERSELIDE.	PERSELIDE.
Aut-il pour redoubler des tourments ſi faſcheux, T Que Floridor s'en vienne opposer à mes voeux.	Aut-il pour redoubler des tourments si fâcheux, T Que Loridor s'en vienne opposer à mes voeux.
Mais deurois-ie, Lyſis, en ce malheur extreme Obeir à mon frere, & me trahir moi-meſme.	Mais devrais-je, Lysis, en ce malheur extrême Obeir à mon frère, et me trahir moi-même.
LYSIS.	LYSIS.
Alors qu’aueuglément tu cours a ton malheur.	Alors qu'aveuglément tu cours a ton malheur.
Les Dieux ont pris le ſoin de ſauuer ton honneur.	Les Dieux ont pris le soin de sauver ton honneur.
Beny les immortels, de t’auoir dégagée Du perilleux abiſme, ou tu t’estois plongée.	Béni les immortels, de t'avoir dégagée Du périlleux abîme, ou tu t'étais plongée.
PERSELIDE.	PERSELIDE.
On doit conſiderer l’honneur de nos maiſons, Quand l’amour nous permet d’écouter ces raiſons.	On doit considérer l'honneur de nos maisons, Quand l'amour nous permet d'écouter ces raisons.
AMCais alors, qu’en tyran il regne dans nos ames, Nous ne pouuons ſonger, qu’a ſoulager nos flames.	AMCais alors, qu'en tyran il règne dans nos âmes, Nous ne pouvons songer, qu'a soulager nos flammes.
[inxe an BepberUn, que laborlegunnespezire Pecequ il fend arorreho mon deſe rtei	[inxe an BepberUn, que laborlegunnespésire Pecequ il fend arreho mon dése rètei
LYSIS.	LYSIS.
Eſcoute:	Écoute:
tu fais mal de perdre l’eſperance, Atten de ton amour la iuste recompence.	tu fais mal de perdre l'espérance, Aten de ton amour la juste récompense.
Laiſſe agir Floridor, rapporte-t'en a moy, Ton frere pourſuiura ton deſſein, mieux que toy.	Laisse agir Floridor, rapporte-t'-en à moi, Ton frère poursuivra ton dessein, mieux que toi.
Hé quoy ne ſçais-tu pas, s’il trompe Floriſelle, Qu'il faudra, qu’il espouſe auiourd’huy cette belle.	Hé quoi ne sais-tu pas, s'il trompe Floriselle, Qu'il faudra, qu'il épouse aujourd'hui cette belle.
PERSELIDE, Mais l’heur de Floridor ne me ſatisfait pas, Si ie n’oſe esperer de reuoir Aminthas.	PERSELIDE, Mais l'heur de Floridor ne me satisfait pas, Si grande n'ose espérer de revoir Aminthas.
Ie veux, que le ſuccez reſponde à ſon attente!	Je veux, que le succès réponde à son attente!
Quel ſera le moyen de me rendre contente.	Quel sera le moyen de me rendre contente.
LYSIS.	LYSIS.
Connois-tu bien l’amour, qui trouble ton eſprit, Le deſir l’a fait naiſtre, & l’eſpoir le nourrit.	Connais-tu bien l'amour, qui trouble ton esprit, Le désir l'a fait naître, et l'espoir le nourrit.
Sçache ſi Floridor poſſede Floriſelle, Qu'Aminthas ne pourra ſouſpirer apres elle, Duaaisoan ceſjera, lite cerrds lourir, A meſme, qu’il n’aura plus dequoy ſe nourrir.	Sache si Floridor possède Floriselle, Qu'Aminthas ne pourra soupirer après elle, Duaaisoan cesjera, lite cerrds lourir, A même, qu'il n'aura plus dequoy se nourrir.
PERSELIDE.	PERSELIDE.
Ie croy bien, qu’Aminthas n’aura pas la conſtance Pour atmer Floriſelle en perdant l’eſperance.	Je crois bien, qu'Aminthas n'aura pas la constance Pour atmer Floriselle en perdant l'espérance.
Mais i’ay peur que l’excés de mes triſtes malheurs Ne faſſe redoubler la cauſe de mes pleurs.	Mais j'ai peur que l'excès de mes tristes malheurs Ne fasse redoubler la cause de mes pleurs.
Le deſtin enuieux me montre tant de haine, Que ie n’oſe eſperer de remede à ma paine, Ie crains, que cet ingrat n’adreſſe ailleurs ſes vœux, Que ſon cœur ne demeure inſenſible à mes feux.	Le destin envieux me montre tant de haine, Que je n'ose espérer de remède à ma paine, Je crains, que cet ingrat n'adresse ailleurs ses vœux, Que son cœur ne demeure insensible à mes feux.
Ie connois cèt humeur, & cet eſprit volage, Ie crains, qu’vn autre obiet plus puiſſant ne l'engage.	Je connais cè humeur, et cet esprit volage, Je crains, qu'un autre objet plus puissant ne l'engage.
LYSIS.	LYSIS.
LYSIS.	LYSIS.
En vain ton deſeſpoir augmente tes malheurs, Et fait naiſtre en ton coeur des nouuelles douleurs.	En vain ton désespoir augmente tes malheurs, Et fait naître en ton coeur des nouvelles douleurs.
Floriſelle empechoit les deſſeins de ton ame, Et l’amour d’vn ingrat s’oppoſoit à ta flame.	Floriselle empêchait les desseins de ton âme, Et l'amour d'un ingrat s'opposait à ta flamme.
3 drauiio puio epcoin des nomomene dpay y que ta verras Triompher auiourd’huy ta beauté d’Aminthas.	3 draudio vio epcoin des nomomène dpay y que ta verras Triompher aujourd'hui ta beauté d'Aminthas.
PERSELIDE.	PERSELIDE.
Ie le ſouhaite plus, que mon coeur ne l’eſpere, Quiimiiminmuejpuururccamours de mon frere.	Je le souhaite plus, que mon coeur ne l'espère, Quiimiiminmuejpuururccamours de mon frère.
ln depit genereux animera ſon coeur, Pour ſe vanger du frere, il haïra la ſoeur.	In dépit généreux animera son coeur, Pour se venger du frère, il haïra la soeur.
J'en ay peur.	J'en ai peur.
LYSIS.	LYSIS.
Sa fureur ſe rendra trop extreme.	Sa fureur se rendra trop extrême.
S’il faut pour ſe vanger qu’il s’en prene à ſoy meſme.	S'il faut pour se venger qu'il s'en prène à soi -même.
Ne deſeſpere pas de la bonté des Dieux, Tu pourrois at tirer la colere des Cieux.	Ne désespère pas de la bonté des Dieux, Tu pourrais at tirer la colère des Cieux.
S C EN Ti TROISIESME.	 SE EN Ti TROISIÈME.
AMINTHAS.	AMINTHAS.
MELAS.	MÊLAS.
CLORIMAN.	CLORIMAN.
CLORIMAN.	CLORIMAN.
Lors que la raiſon rentrera dans ton ame, Y IAminthas blaſmera la rage, qui l’enflame, La fureur, & l’amour tous deux également Offuſquent ton eſprit d’vn double aueuglement.	Lors que la raison rentrera dans ton âme, Y IAminthas blâmera la rage, qui l'enflamme, La fureur, et l'amour tous deux également Offusquent ton esprit d'un double aveuglement.
AMINTHAS.	AMINTHAS.
S'ouffrir, que ce perfide eſchape à ma colere.	S'ouffrir, que ce perfide échappe à ma colère.
MELAS.	MÊLAS.
Alors que tu voudras, ie te veux ſatisfaire, La partie eſt remiſe, il n'est rien de perdu.	Alors que tu voudras, Seigneur te veux satisfaire, La partie est remise, il n'est rien de perdu.
CLORIMAN.	CLORIMAN.
C’eſt aſſés du combat, que vous aueZ rendu.	C'est assez du combat, que vous avez rendu.
Pourſuiués hardiment, vuidés voſtre querelle, Pendant que Floridor eſpouſe Floriſelle!	Poursuivez hardiment, videz votre querelle, Pendant que Floridor épouse Floriselle!
Il eſt temps de ſe batre:	Il est temps de se battre:
vn riual plus heureux Accomplira pour vous vos deſſeins amoureux.	un rival plus heureux Accomplira pour vous vos desseins amoureux.
AMANTIR AJe Pendant que Floridor eſpouſe Floriſelle.	AMANTIR AJe Pendant que Floridor épouse Floriselle.
CLORIMAN.	CLORIMAN.
Il vange ainſi ſa ſœur d’vn amant infidelle.	Il venge ainsi sa sœur d'une amant infidèle.
Mais eſt-ce pour ſi peu, qu’vn ſi grand cœur s’abat.	Mais est-ce pour si peu, qu'un si grand cœur s'abat.
AMINTAS.	AMINTAS.
Ah re tournons Melas, retournons au combat.	Ah re tournons Mélas, retournons au combat.
Puis qu’il n’eſt plus pour nous de douceur en la vie, Allons, allons Melas, ou l’honneur nous conute.	Puis qu'il n'est plus pour nous de douceur en la vie, Allons, allons Mélas, ou l'honneur nous convte.
Puis que le Ciel jaloux trahit noſtre bon-heur, Mourons pour Floriſelle,, acquerons cet honneur.	Puis que le Ciel jaloux trahit notre bonheur, Mourons pour Floriselle, acquérons cet honneur.
MELAS.	MÊLAS.
Genereux Aminthas, tire moy hors de peine, Conteurt à couſcutcoup monueju, & la hainc.	Généreux Aminthas, tire moi hors de peine, Conteurt à couscutcoup monueju, et la hainc.
Ce traiſtre veut mourir, mais il veut que ta main Te vangeant d’vn ingrat acheue ſon deſſein.	Ce traître veut mourir, mais il veut que ta main Te vengeant d'un ingrat achève son dessein.
CLORIMAN.	CLORIMAN.
En cett' occaſion nous pouuons reconneſtre, Que le Ciel ne peut pas s’entendre auec vn traiſtre!	En cett - occasion nous pouvons reconnaître, Que le Ciel ne peut pas s'entendre avec un traître!
Faloit-il aujourd’huy voir triompher Melas Par vne trahiſon des amours d’Aminthas.	Falait-il aujourd'hui voir triompher Mélas Par une trahison des amours d'Aminthas.
Faloit-il, qu’vn ingrat eut trompé Perſelide, Que le Ciel fut propice aux deſſeins d’vn perfide.	Falait-il, qu'ins ingrat eut trompé Perside, Que le Ciel fut propice aux desseins d'un perfide.
Il faloit Aminthas, en ce commun malheur, Que le frere vangeat l’iniure de la ſœur.	Il fallait Aminthas, en ce commun malheur, Que le frère vangeat l'injure de la sœur.
9 8 EN E ATRIESME.	9 8 EN E TRIESME.
CALLISTE.	CALLISTE.
AMINTHAS.	AMINTHAS.
CLORIMAN.	CLORIMAN.
MELAS, CALISTE.	MÊLAS, CALISTE.
voyant du ſang ſur la place.	voyant du sang sur la place.
Vel ſpectacle d’ho’rreur ſe preſente à ma veüe.	Vel spectacle d'ho'rreur se présente à ma vue.
JAminthas, & Melas?	JAminthas, et Mélas?
ſerois ie point deceué, C’eſt du ſang, que ie voy, ie crains également, Et la perte d’vn frere, & celle d’vn amant.	serais ie point deceué, C'est du sang, que sans vois, tu crains également, Et la perte d'un frère, et celle d'un amant.
C’eſt Melas, qui le perd.	C'est Mélas, qui le perd.
CLORIMAN.	CLORIMAN.
VoyeZ, voyeZ perfides, De qui voſtre fureur vous rend les homicides.	VoyeZ, voyez perfides, De qui votre fureur vous rend les homicides.
C’eſt ta ſœur Aminthas.	C'est ta sœur Aminthas.
22	22
AMINTHAS.	AMINTHAS.
Ma ſœur.	Ma sœur.
CALLISTE.	CALLISTE.
Retire-toy I raiſtre ſaru voulois, ne t'en prendre qu'à moy.	Retire-toi I raistre saru voulais, ne t'en prendre qu'à moi.
Ce corps eut ſatisfait à ton ame inſensée.	Ce corps eut satisfait à ton âme insensée.
Perfide ta vangeance eut eſté plus aisee.	Perfide ta vengeance eut été plus aise.
AMINTHAS.	AMINTHAS.
Reconnois-tu ton frere.	Reconnais-tu ton frère.
CALLISTE.	CALLISTE.
Arreſte tes Miſcohrse.	Arrête tes Miscohrèse.
Je ſçaurai bien mourir ſans ce triſte ſecours:	Je saurai bien mourir sans ce triste secours:
Peut-eſtre me veux-tu raconter ta victoire.	Peut-être me veux-tu raconter ta victoire.
Mais veux-tu deuant moy triompher de ta gloire.	Mais veux-tu devant moi triompher de ta gloire.
Tu l’as ſurpris en traiſtre.	Tu l'as surpris en traître.
AMINTHAS.	AMINTHAS.
Elle croit, que Melas Soit dedans ce combat le vainqueur d’Aminthas.	Elle croit, que Mélas Soit dedans ce combat le vainqueur d'Aminthas.
CALLISTE.	CALLISTE.
Ie ne me trompe point, ie te prens pour mon frere, Et c’eſt ce qui le plus m’aflige en ma miſere, Qu'il faille, que ta main ſaiuant mon mouuement Aille auiourd’huy rauir la vie à mon amant.	Je ne me trompe point, ie te prends pour mon frère, Et c'est ce qui le plus m'aflige en ma misère, Qu'il faille, que ta main saisant mon mouvement Aille aujourd'hui ravir la vie à mon amant.
C’eſt ſon ſang.	C'est son sang.
MELAS.	MÊLAS.
Ah Melas, que cet amour t’accuſe, Confeſſe ton peché, ne cherche point d’excuſe!	Ah Mélas, que cet amour t'accuse, Confesse ton péché, ne cherche point d'excuse!
Faloit-il Aminthas, que ta ſœur par ſa foy Témoignaſt, qu'elle auoit plus de vertu, que moy, Reconnoi-toi Melas, & renonce à ton crime, Reſpond à cet amour d’vne amour legitime.	Falait-il Aminthas, que ta sœur par sa foi Témoignât, qu'elle avait plus de vertu, que moi, Reconnait-toi Melas, et renonce à ton crime, Respond à cet amour d'une amour légitime.
Ouy belle, ſi tu peux m’accorder mon pardon, Que ta bonté t’oblige a m'en faire le don.	Oui belle, si tu peux m'accorder mon pardon, Que ta bonté t'oblige a m'en faire le don.
Iuobinvuruuenir effacer auec gloire La bomle de mncie evimt auce (Aineneorre .	Iuobinvuruuenir effacer avec gloire La bomle de mncie eimt auce (Ainèneorre .
CALLISTE.	CALLISTE.
Ah reiette, Aminthas, ſur ta ſœur tout le tort.	Ah rejet, Aminthas, sur ta sœur tout le tort.
Je ſuis, ie ſuis Melas, la cauſe de ta mort.	Je suis, Seigneur suis Mélas, la cause de ta mort.
Calliſte à d’Aminthas la fureur ainmée, Elle a pouſſe ſa main, mes diſcours l’ont armée.	Calliste à d'Aminthas la fureur ainmée, Elle a pousse sa main, mes discours l'ont armée.
A meſme que i’ay veu, que ie perdois Melas.	À même que j'ai vu, que ici perdais Mélas.
Mon amour l’a voulu perdre par ſon treſpas.	Mon amour l'a voulu perdre par son trépas.
Ie n’ay pas pu ſouffrir qu’vne riuale heureuſe Triomphat de l’autheur de ma peine amoureuſe.	Je n'ai pas pu souffrir qu'une rivale heureuse Triomphat de l'auteur de ma peine amoureuse.
Qu'elle rauit vn bien, qui n’eſtoit deu qu’a mõy, Vn bien, que ie croyois meriter par ma foy.	Qu'elle ravit un bien, qui n'était dev qu'a mouri, Un bien, que sans croyais mériter par ma foi.
Malheureux inſtrument d’vn’iniuſte vangeance Acheue mon deſſein, & panit mon offence.	Malheureux instrument d’vn’injuste vengeance Achève mon dessein, et panit mon offense.
Pouſſe Aminthas ce fer, pouſſe le dans mon cœtr, Il faut par ce moyen aſſouutr ta furcur.	Pousse Aminthas ce fer, pousse le dans mon cœtr, Il faut par ce moyen assouutr ta furcur.
MELAS.	MÊLAS.
MELAS.	MÊLAS.
Caliſte, c’eſt ce corps, contre lequel ton frere Pourroit auec iuſtice exercer ſa colere, C’eſt contre moy, que doit s’animer Aminthas.	Caliste, c'est ce corps, contre lequel ton frère Pourrait avec justice exercer sa colère, C'est contre moi, que doit s'animer Aminthas.
I'ay merité la mort, ie n’y recule pas.	J'ai mérité la mort, ie n'y recule pas.
Je croy, que les enfers dans leur plus creux abiſme N’ont point veu de ſupplice aſſés grand pour mon crime.	Je crois, que les enfers dans leur plus creux abîme N'ont point vu de supplice assez grand pour mon crime.
CLORIMAN.	CLORIMAN.
Pourrois-tu reßiſter à leur affection, Et ne pas conſentir à leur intention.	Pourrais-tu rivister à leur affection, Et ne pas consentir à leur intention.
Ta ſœur doit, Aminthas, malgré ta jalouſie Appaiſer le courroux s'dont ton ame eſt ſaiſie.	Ta sœur doit, Aminthas, malgré ta jalousie Apaiser le courroux s'dont ton âme est saisie.
Tu connois leur deſſein, tu connois leurs amours Peus-tu ſans iniuſtice en arreſter le cours!	Tu connais leur dessein, tu connais leurs amours Peus-tu sans injustice en arrêter le cours!
Veux-tu trahir la foy, qu’eux deux ſe ſont donnée.	Veux-tu trahir la foi, qu'eux deux se sont donnée.
Laiſſe leur acheuer leur heureux Hymenee.	Laisse leur achever leur heureux Hymène.
Conſens-y, tu le dois.	Consens-y, tu le dois.
AMINTHAS.	AMINTHAS.
Jl le faut, ie le veux.	Jl le faut, on le veux.
l'approuue leur amour, & m'accorde à leurs vœux.	l'approuve leur amour, et m'accorde à leurs vœux.
Ie conſens, que le nœud d’vn iuſte mariage Arreſte enfin le cœur de cet esprit volage.	Je consens, que le nœud d'être juste mariage Arrête enfin le cœur de cet esprit volage.
Viuez heureux amants:	Vivez heureux amants:
mais ſouffreZ, que vos pleurs Soulagent quelquefois l'excez, de mes mal-heurs.	mais souffrez, que vos pleurs Soulagent quelquefois l'excès, de mes malheurs.
ds CIN AV E TIESME.	ds CIN AU E IESME.
AMINTHAS ſeul.	AMINTHAS seul.
Aut-il donc iuſtes Dieux, que ſur ma ſeule teſte L Le Ciel vienne auiourd’huy deſcharger ſa tempeſte.	Aut-il donc justes Dieux, que sur ma seule tête L Le Ciel vienne aujourd'hui décharger sa tempête.
C’est trop, c’eſt trop ſouffert:	C'est trop, c'est trop souffert:
il est temps deſormais, Qu’il voulut ſe reſoudre à me doner la paix:	il est temps désormais, Qu'il voulut se résoudre à me doner la paix:
Faut-il, que fa fureur contre moy ſe débonde, Cependant, qu’il s’accorde auecque tout le monde.	Faut-il, que fa fureur contre moi se débonde, Cependant, qu'il s'accorde avec tout le monde.
Melas n’eſprouue plus la colere du ſort, Proche de ſon naufrage il a trouué le port.	Mélas n'éprouve plus la colère du sort, Proche de son naufrage il a trouvé le port.
C Il recouure ma ſœur, lors qu’il perd Floriſelle, Le mal-heur rend heureux cét amant infidelle.	Ç Il recouvre ma sœur, lors qu'il perd Floriselle, Le malheur rend heureux cet amant infidèle.
Ie ſuis ſeul mal heureux, qui parmy mes trauaux N’oſerois esperer de remede a mes maux.	Je suis seul mal heureux, qui parmi mes travaux N'oserais espérer de remède à mes maux.
I'ay perda Ferſelide, & ie perds Florifelle, Et te ſens les tourments d’vn' ame criminelle.	J'ai perda Fersélide, et ainsi perds Florifèle, Et te sens les tourments d'un âme criminelle.
Mon crime, & mon amour me font également, Paſſes pour vn perſide, & mal heureux amant.	Mon crime, et mon amour me font également, Passes pour un perside, et mal heureux amant.
E.	E.
E S CEN SIXIESME.	E S CEN SIXIÈME.
LYSIS, AMINTHAS.	LYSIS, AMINTHAS.
E	E
LYSIS.	LYSIS.
TOus auons à la fin ſceu le nom du perfide, NEt ſçauons, qu'Aminthas nous rauit Perſelide, Dhomemuicaujompueyiceuuuoy ron peche, Ton crime mal-heureux ne nous eſt plus caché.	TOut auons à la fin su le nom du perfide, NEt Savons, qu'Aminthas nous ravit Perselide, Dhomemuicaujompueyiceuuuoy ron pèche, Ton crime malheureux ne nous est plus caché.
Nos ſoins ont malgré-toy découuert ta malice, El l'oine nous peut plus refuſer la iuſtice.	Nos soins ont malgré-toi découvert ta malice, Él l'oine nous peut plus refuser la justice.
AMINTHAS.	AMINTHAS.
Ah Lyſis, il eſt vray, que ie ſuis criminel, Ie ſçay, que ie merite vn ſupplice éternel, Ie reconnois ma faute, Aminthas eſt coupable, Le crimé, que i’ay fait ne peut eſtre excuſable.	Ah Lysis, il est vrai, que je suis criminel, Je sais, que ie mpérite un supplice éternel, Je reconnais ma faute, Aminthas est coupable, Le crimé, que j'ai fait ne peut être excusable.
Apres tant de ſerments, que mon cœur a faucez.	Après tant de serments, que mon cœur a saucés.
Croirai-je, que les Dieux n’en ſoient pas offenceZ.	Croirai-je, que les Dieux n'en soient pas offensés.
Il est vray, que i’eus tort d’adorer Floriſelle, De quitter Perſelide, & me rendre infidelle.	Il est vrai, que j'eus tort d'adorer Floriselle, De quitter Persélide, et me rendre infidèle.
Mais de l’auoir rauie, ah i’oſe m’excuſer, Et mier l’action, dont tu viens m’accuſer.	Mais de l'avoir ravie, ah j'ose m'excuser, Et mier l'action, dont tu viens m'accuser.
Jl eſt vray pour ſortir de ce faſcheux abiſme, Qu’il me faut excuſer vn crime par vn crime, Puis qu’il faut auoüer mon infidelité, Et qu'on pourra blaſmer mon cœur de laſcheté.	Il est vrai pour sortir de ce fâcheux abîme, Qu'il me faut excuser un crime par un crime, Puis qu'il faut auoüer mon infidélité, Et qu'on pourra blâmer mon cœur de lâcheté.
LYSIS.	LYSIS.
Briſons là:	Brisons là:
c’eſt en vain, qu’Aminthas s’eſtudie A vouloir ſe purger de cette perfidie.	c'est en vain, qu'Aminthas s'étudie À vouloir se purger de cette perfidie.
Tu ne peux te lauer de cette trahiſon Floridor a trouué ſa ſœur à ta maiſon.	Tu ne peux te lauer de cette trahison Floridor a trouvé sa sœur à ta maison.
AMINTHA Sa fœur à ma maiſon!	AMINTHA Sa fœur à ma maison!
8	8
Qiii	Qiii
LYSIS.	LYSIS.
Oſeras-tu perfide Déjahouser encor d ahoir cell erfelae.	Oseras-tu perfide Déjahouser encor ahoir cell erfelàe.
AMINTHAS.	AMINTHAS.
Nu motn ucpuis ie tout, qu'vn mal-heureux amour M’obligea ſans rien dire à partir à la Cour,	Nu motn ucpuis après tout, qu'un malheureux amour M'obligea sans rien dire à partir à la Cour,
Connois-tu Lucidor.	Connais-tu Lucidor.
LYSIS.	LYSIS.
AMINTHAS.	AMINTHAS.
Lucidor eſt mon page.	Lucidor est mon page.
LYSIS.	LYSIS.
Va, tu feins de ne pas conneſtre ce viſage.	Va, tu feins de ne pas connaître ce visage.
AMIN THAS.	AMIN THAS.
A combien de malheurs m’a le ſort deſtiné.	À combien de malheurs m'a le sort destiné,
Tout coniure à l’enuy contre vn infortuné:	Tout conjure à l'envi contre un infortuné:
Les hommes, & les Dieux, & le Ciel, & la Terre, Tous d’vn conſentement me declarent la guerre!	Les hommes, et les Dieux, et le Ciel, et la Terre, Tous d'un consentement me déclarent la guerre!
Mais falloit-il pour perdre vn miſerabie amant, Que ſon mal-heur s’accreut par ſon aueuglement.	Mais fallait-il pour perdre un misérabie amant, Que son malheur s'accrut par son aveuglement.
Perſelide les Dieux pour ſe vanger d'vn traiſtre, Ont permis, que mes yeux ne t’ont peu reconneſtre.	Persélide les Dieux pour se venger d'un traître, Ont permis, que mes yeux ne t'ont peu reconnêtre.
LYSIS.	LYSIS.
Mais quoy la faute eſt faite, il la faut reparer.	Mais quoi la faute est faite, il la faut réparer.
AMINTHAS.	AMINTHAS.
Comment, quelle vangeance en peut-on deſirer.	Comment, quelle vengeance en peut-on désirer.
Commande, ie ſuis preſt de ſubir l’ordonnance, Par laquelle il me faut effacer mon offence.	Commande, Madame suis prêt de subir l'ordonnance, Par laquelle il me faut effacer mon offense.
S' l Ciel me pouuoit promettre cét honneur, Di remettre Aminthas en ſon premier bon-heur, J'oſerois eſperer de reparer ma faute, Mais qui peut me promettre vne gloire ſi haute.	S' à Ciel me pouvait promettre cet honneur, Di remettre Aminthas en son premier bonheur, J'oserais espérer de réparer ma faute, Mais qui peut me promettre quelque gloire si haute.
LYSIS.	LYSIS.
Si ton cœur Aminthas ne ſe plaiſt, qu’à changer, Eroisciu que Perſetide ail 'vnespri tegers	Si ton cœur Aminthas ne se plaît, qu'à changer, Eroisive que Persetide ail 'vnespri tegers
AMINTHAS.	AMINTHAS.
Non, ie n’accuſe point ſon humeur d’inconſtance, Mais elle à deü changer pour chercher ſa vangeance.	Non, notre n'accuse point son humeur d'inconstance, Mais elle a déun changer pour chercher sa vengeance.
On deuroit condamner ſon cœur de laſcheté, S’il pouuoit pardonner mon infidelité.	On devrait condamner son cœur de lâcheté, S'il pendant pardonner mon infidélité.
Pourroit on m’excuſer!	Pourrait on m'excuser!
ſeroit il legitime Son oreille, & ſes yeux ſont teſmoins de mon crime.	serait -il légitime Son oreille, et ses yeux sont témoins de mon crime.
SCENE	SCÈNE
S CEN SEPTIESME.	 SEN SEPTIÈME.
P TEORIDOR, AMAAVTTATIO TDTCODEIDD, FLORISELLE, CALLISTE, MELAS, CLORIMAN, LYSIS.	 PEORIDOR, AMAAVTTATIO TDTCODEIDD, FLORISELLE, CALLISTE, MÊLAS, CLORIMAN, LYSIS.
FLORIDOR.	FLORIDOR.
Army tant de bon-heurs, qui comblent nos deſirs I Aminthas autourd’huy vient troubler mes plaiſirs.	Armi tant de bonheurs, qui comblent nos désirs I Aminthâ tourd'hui vient troubler mes plaisirs.
La fureur, mon bon-heur, celuy de Perſelide Doiuent authoriſer la fureur, qui me guide.	La fureur, mon bonheur, celui de Persélide Doivent autoriser la fureur, qui me guide.
AMINTHAS.	AMINTHAS.
Il eſt vray, Floridor, il faudroit te vanger, Mon crime, & ton honneur t’y deuroient obliger.	Il est vrai, Floridor, il faudrait te venger, Mon crime, et ton honneur t'y devraient obliger.
Aminthas y conſent, ie connoy mon offence, Mon deſespoir en veut rechercher la vangeance.	Aminthas y consent, ie connais mon offense, Mon désespoir en veut rechercher la vengeance.
2 FLORIDOR.	2 FLORIDOR.
Perfide apres ton crime!	Perfide après ton crime!
oſes-tu bien encor T’offrir effrontement aux yeux de Floridor.	oses-tu bien encor T'offrir effrontément aux yeux de Floridor.
Connois-tu Lucidor, vien traiſtre, vien, approche!	Connais-tu Lucidor, viens traître, vien, approche!
Connois-tu ce viſage.	Connais-tu ce visage.
AMINTHAS.	AMINTHAS.
O ſenſible reproche.	Ô sensible reproche.
Mais quitte Floridor, quitte moy ces diſcours, Ta fureur a beſoin d’vn plus puiſſant ſecours.	Mais quitte Floridor, quitte moi ces discours, Ta fureur a besoin d'un plus puissant secours.
Arme toy contre moy, vange auec cett' espée Celle, que mes ſerments ont ſi ſouuent trompée.	Arme toi contre moi, venge avec cett - épée Celle, que mes serments ont si souvent trompée.
Aminthas eſt vn traiſtre, il ſçait qu’il doit perir.	Aminthas est un traître, il sait qu'il doit périr.
Luy-meſme n'oſe pas refuſer de mourir.	Lui-même n'ose pas refuser de mourir.
PERSELIDE.	PERSELIDE.
Ie t’excuſe Aminthas, & i’ay tort de me plaindre.	Je t'excuse Aminthas, et j'ai tort de me plaindre.
Si tu ne m'aimois pas!	Si tu ne m'aimais pas!
t’y pouuois-je contraindre, Si ie ſais obligée à verſer tant de pleurs, !	t'y pouvais-je contraindre, Si ie sais obligée à verser tant de pleurs, !
Ce n’eſt, que mon mal-heur, qui cauſe mes douleurs.	Ce n'est, que mon malheur, qui cause mes douleurs.
Pour deffaire Aminthas, il falloit d’autres armes, Que celles, que i’oſois esperer de mes charmes!	Pour défaire Aminthas, il fallait d'autres armes, Que celles, que j'osais espérer de mes charmes!
Quelle preſomption de te voir arreſté Auec ſi peu de force, & ſi peu de beauté.	Quelle présomption de te voir arrêté Avec si peu de force, et si peu de beauté.
fl falloit pour te vaincre vn objet plus aimable.	fl allait pour te vaincre un objet plus aimable.
AMINTHAS.	AMINTHAS.
Non, non:	Non, non:
c’eſt ce qui rend Aminthas plus blamable, Que connoiſſant en toy tant de perfections, Il ait eſté volage en ſes affections.	c'est ce qui rend Aminthas plus blâmable, Que connaissant en toi tant de perfections, Il ait été volage en ses affections.
Le Ciel pour acheuer ta beauté ſans ſeconde Berhbtt tauoti oubtie tout te reſet ais monde.	Le Ciel pour achever ta beauté sans seconde Berhat tauotiot oubtie tout te réset ais monde.
Cette bouche, ces yeux, cét eſprit merueilleux Condamnent à la fois vn amant mal-heureux.	Cette bouche, ces yeux, cet esprit merveilleux Condamnent à la fois un amant malheureux.
AEISIETS.	ÀEISIETS.
Tu fis bien, s’il faloit adorer la plus belle, De ſortir de mes fers, pour aimer Florifelle.	Tu fis bien, s'il fallait adorer la plus belle, De sortir de mes fers, pour aimer Florifelle.
AMINTHAS.	AMINTHAS.
L’amour eſt vn aueugle, il faut, qu’aueuglement, S’il veut ſeruir de guide, il conduiſe vn amant.	L'amour est un aveugle, il faut, qu'aveuglement, S'il veut servir de guide, il conduise un amant.
Je ſçay que Perſelide en a beaucoup plus qu'elle.	Je sais que Persélide en a beaucoup plus qu'elle.
Mais ie veux, qu’elle ait eu l’auantage ſur toy!	Mais a veux, qu'elle ait eu l'avantage sur toi!
Faloit-il qu’vn ingrat renonçat à ſa foy?	Falait-il qu' ingrat renonçat à sa foi?
Pouuois-ie auec raiſon trahir vne Maiſtreſſe!	Pouvais-je ici raison trahir une Maîtresse!
Pouuois-je auec iuſtice oublier ma promeſſe.	Pouvais-je ici justice oublier ma promesse.
PERSELIDE.	PERSELIDE.
Tu pouuois diſpoſer de ton affection.	Tu pouvais disposer de ton affection.
AMINTHAS.	AMINTHAS.
Non, non:	Non, non:
n’excuſe point vne folle action, I'eus tort de te quitter, ic reconnois mon crime, Je deuois conſeruer vn ardeur legitime, Et non pas laſchement porter ailleurs mes veux, Et ſouffrir, que mon cœur fut bruslé d’autres feux.	n'excuse point une folle action, QUE mon tort fut brûlé quitter, ic reconnais mon crime, Je devais conserver un ardeur légitime, Et non pas lâchement porter ailleurs mes veux, Et souffrir, que mon cœur fut brûlé d'autres feux.
FLORIDOR.	FLORIDOR.
Leur amour auiourd’huy vuidera leur querelle, Et vangera ma ſœur d’vn amant infidelle, Il nous faut accorder a leur intention, Et pourſaiure l’effet de leur affection, Ma ſœur, ce criminel reconnoit ſon offence.	Leur amour aujourd'hui videra leur querelle, Et vengera ma sœur d'Hannant infidèle, Il nous faut accorder à leur intention, Et poursaiure l'effet de leur affection, Ma sœur, ce criminel reconnaît son offense.
Accorde le pardon à ſa reconnoiſſance.	Accorde le pardon à sa reconnaissance.
Pour ſigner cét accord, & ſuuir vos mal-heurs.	Pour signer cet accord, et suir vos malheurs.
It faul, quon mariage aſſemete vos deux cœurs.	It saul, quon mariage assemète vos deux cœurs.
AMINTHAS Dans ta conſuſton, dont veaces me furmonfe, Voſtre bonté pourſuit à me combler de honte.	AMINTHAS Dans ta consûton, dont veaces me furmonfe, Votre bonté poursuit à me combler de honte.
CLORIMAN.	CLORIMAN.
ViueZ heureux amants, que le Ciel deſormais Arreſtant ſa fureur s’accorde à vos ſouhaits.	Vivez heureux amants, que le Ciel désormais Arrêtant sa fureur s'accorde à vos souhaits.
Que la poſſeßion vous rende plus fidelles, Et qu’vne douceguere appaiſe vos querelles.	Que la possesions vous rende plus fidèles, Et qu'une douceguere apaise vos querelles.
* Fin du cinquiéme & dernier Acte.	* Fin du cinquième et dernier Acte.
Et pourſaiure l’effet de leur affection, Ma ſœur, ce criminel reconnoit ſon offence.	Et poursaiure l'effet de leur affection, Ma sœur, ce criminel reconnaît son offense.
Accorde le pardon à ſa reconnoiſſance.	Accorde le pardon à sa reconnaissance.
Pour ſigner cét accord, & ſuuir vos mal-heurs.	Pour signer cet accord, et suir vos malheurs.
It faul, quon mariage aſſemete vos deux cœurs.	It saul, quon mariage assemète vos deux cœurs.
AMINTHAS Dans ta conſuſton, dont veaces me furmonfe, Voſtre bonté pourſuit à me combler de honte.	AMINTHAS Dans ta consûton, dont veaces me furmonfe, Votre bonté poursuit à me combler de honte.
CLORIMAN.	CLORIMAN.
ViueZ heureux amants, que le Ciel deſormais Arreſtant ſa fureur s’accorde à vos ſouhaits.	Vivez heureux amants, que le Ciel désormais Arrêtant sa fureur s'accorde à vos souhaits.
Que la poſſeßion vous rende plus fidelles, Et qu’vne douceguere appaiſe vos querelles.	Que la possesions vous rende plus fidèles, Et qu'une douceguere apaise vos querelles.
* Fin du cinquiéme & dernier Acte.	* Fin du cinquième et dernier Acte.
