1 ONSEIGNEUR,	1 1NSEIGNEUR,
Il faut que je ſois bien perſuadé de vos utez pour oſer vous dedier une Comedie ns avoir jamais eü l’honneur d’eſtre conI de vous loin d’en pretendre de la gloire, ſuis ioûjours dans l’apprehenſion d’en receoir du blâme;	Il faut que je sois bien persuadé de vos utés pour oser vous dédier une Comédie ns avoir jamais eu l'honneur d'être conI de vous loin d'en prétendre de la gloire, suis toujours dans l'appréhension d'en receoir du blâme;
outre que le preſent que je vus fais a ſi peu de rapport à vos grands mettes, que je n’oſe qu'en tremblant mettre vôtilluſtre nom à la teſte d’un ſi petit Ouvrage.	outre que le présent que je vus fais a si peu de rapport à vos grands mettes, que je n'ose qu'en tremblant mettre vôtillustre nom à la tête d'un si petit Ouvrage.
avoue que s’il m’étoit permis de vous dire approbations que pluſieurs perſonnes de qualit!	avoue que s'il m'était permis de vous dire approbations que plusieurs personnes de qualit!
luy ont données, & avec combius d’avantage pour moy on a remarque qu j’avois ſuivy avec beaucoup de juſteſſe, leſ de la veritable Hiſtoire dont j’ay compoſt cette Comedie, vous en excuſeriez plus aiſe, ment les defauts qui ne pourront s’echaper.	Elle ont données, et avec combius d'avantage pour moi on a remarque qu 'avais suivi avec beaucoup de justesse, les de la véritable Histoire dont j'ai compost cette Comédie, vous en excuseriez plus aise, ment les défauts qui ne pourront pourront echaper.
la delicateſſe de vôtre eſprit.	la délicatesse de votre esprit.
C’eſt à et mémes Perſonnes, diſ je, que j’auray recour ſi la choſe en reußiſſoit pas comme on me l’a fat eſperer;	C'est à et mêmes Personnes, dis -je, que j'aurai recour si la chose en revissait pas comme on me l'a fat espérer;
vù que ſans leurs perſuations je n’uſ ſe oſe jamais la produire, & encor moins emprunter une ſi fameuſe Protection que la votn pour le faire.	Où que sans leurs persuations je n'us se ose jamais la produire, et encor moins emprunter une si fameuse Protection que la votn pour le faire.
I’eſpere toutefois que vous n m’en ſçaurez pas mauvais gré;	J'espère toutefois que vous n 'en saurez pas mauvais gré;
puiſque j’an prens de la bouche de tous ceux méme qui out I’honneur d’approcher de vous, que ſi voint merite vous a extrémement élevé, vous avix uns bonté genereuſe qui en ſçait accomme, der la grandeur a la portée de ceux qui voul preſentent leurs ſoûmiſſions.	puisque j'an prends de la bouche de tous ceux même qui out J'honneur d'approcher de vous, que si voint mérite vous a extrêmement élevé, vous avix uns bonté généreuse qui en sait accomme, der la grandeur a la portée de ceux qui voul présentent leurs soumissons.
Vous en donnts des marques tous les jours;	Vous en donns des marques tous les jours;
& c’eſt pour ce ſujl MONSEIGNEVR, que dans une di plus belles & des plus importantes chargesd Royaume, où vos vertus vous ont fait mos ter, vous vous attirez en méme temps l ſtim & l’amitié d’un grand Roy, le reſpe & la crainte de ſes Peuples;	et c'est pour ce sujl MONSEIGNEUR, que dans une di plus belles et des plus importantes charges Royaume, où vos vertus vous ont fait mos ter, vous vous attirez en même temps l stim et 'amitié d'un grand Roi, le respe et la crainte de ses Peuples;
ce qui fait pu blier avec juſte ſujet à la revommée, que pos grinds Hommes de ce Siecle.	ce qui fait pu blier avec juste sujet à la revommée, que pô grinds Hommes de ce Siècle.
Votre Eloquen.	Votre Éloquen.
ce qui a tant de fois parlé pour notre grand Monarque, & qui a tant ſervy pour mainienir ſes intereſts ravit tous les eſprits:	ce qui a tant de fois parlé pour notre grand Monarque, et qui a tant servi pour mainienir ses intérêts ravit tous les esprits:
C’eſt elle qui engage toute la France à ſe feliciter de la gloire de vous poſſeder, & particulierement le Celebre Parlement de Roüen, dont vous étes la Bage & l’appuy.	C'est elle qui engage toute la France à se féliciter de la gloire de vous posséder, et particulièrement le Clèbre Parlement de Rouen, dont vous êtes la Bage et l'appui.
Souffrez donc, MONSEIGNEVR, que cette production, qui eſt mon coup d’eſſay faſſe connoitre à la poſterite ces éclatantes veritez.	Souffrez donc, MONSEIGNEUR, que cette production, qui est mon coup d'essai fasse connaître à la postérité ces éclatantes vérités.
I’attens de votre Generoſite le bonheur de vous voir Protecteur de cette petite Piéce, que je vous conſacre comme le premice de mes travaux;	J'attends de votre Générosite le bonheur de vous voir Protecteur de cette petite Pièce, que je vous consacre comme le premice de mes travaux;
Peut-étre que dans la ſuite je peurray faire quelque choſe qui meritera mieux de vous être preſentée.	Peut-être que dans la suite je peurrai faire quelque chose qui méritera mieux de vous être présentée.
l’ay fondé là d ſſus l’eſpoir de vous plaire;	l'ai fondé là d sus l'espoir de vous plaire;
étant preſque aſſure que quand aurez appris le ſujet qui m’a fait fatre cette Comedie que je vous preſente, & qu’enfin ſon denoument n’a rien que de tres-veritable, vous vous plairez encor d’avantage à l’entendre.	étant presque assure que quand aurez appris le sujet qui m'a fait fattre cette Comédie que je vous présente, et qu'enfin son dénoûment n'a rien que de très-véritable, vous vous plairez encor d'avantage à l'entendre.
Sur tout je vous ſupplie de croire que le plus grand motif qui ma fait reſoudre à vous la venir preſenter étoit de vous ie’moigner que je ſuis avec tout le reſpect imaginable.	Sur tout je vous supplie de croire que le plus grand motif qui ma fait résoudre à vous la venir présenter était de vous témoigner que je suis avec tout le respect imaginable.
MONSEIGNEUR, Vôtre tres-humble & tresabeïſſant ſerviteur FIOT	MONSEIGNEUR, Votre très-humble et tresabeïssant serviteur FIOT
AU LECTEUR.	AU LECTEUR.
E Sujet qui ma fait compoſer ceue Comedie, à tant fait de bruit dans tout ce l'ays-cy, que je croy qu’il eſt & inutile de vous avertir qu’il ny a rien que de tres-veritable dans cette piece, & que ſi toutes les autres n’ont rien que de fabuleur, celle-cy eſt entierementfondée ſur la verité d’une avanture arrivée ces jours paſſez;	 Sujet qui ma fait composer ceue Comédie, à tant fait de bruit dans tout ce l'ais-cy, que je crois qu'il est et inutile de vous avertir qu'il ni a rien que de très-véritable dans cette pièce, et que si toutes les autres n'ont rien que de fabuleur, celle-cy est entierementfondée sur la vérité d'une aventure arrivée ces jours passez;
je veux ſeulemẽt vous faire ſçavoir qu’on me la fait Imprimer malgré moy, & que ſi j’euſſe olé jamais aſpiret à la qualité d’Auteur, j’autois voulu débuter pat un autre Ouvrage que celuy-là pour me mettre d’abord en eſtime, mais mes remontrances n’ont eü aucun effet, & une infinité de perſonnes ſe veulent contenter plûtôt que moy, & en veulent des Copies à toure reſte.	je veux seulement vous faire savoir qu'on me la fait Imprimer malgré moi, et que si j'eusse olé jamais aspiret à la qualité d'Auteur, j'autais voulu débuter pat un autre Ouvrage que celui-là pour me mettre d'abord en estime, mais mes remontrances n'ont eu aucun effet, et une infinité de personnes se veulent contenter plutôt que moi, et en veulent des Copies à toure reste.
J’ay eu beau leur remontrer qu’en moins de huit jours elle fut concûe & achevée:	J'ai eu beau leur remontrer qu'en moins de huit jours elle fut conçue et achevée:
parce qu’une perſonne de conſideration qui m’en avoit prié, m’avoit oblgé de me depêcher.	parce qu'une personne de considération qui m'en avait prié, m'avait oblé de me dépêcher.
L’Approbation que la multitude luy a donné me la fait expoſer aux yeux d’une ſi grande Ville toutefois avec bien de la crainte;	L'Approbation que la multitude lui a donné me la fait exposer aux yeux d'une si grande Ville toutefois avec bien de la crainte;
mais j’eſperc que vous excuſerez l’empreſſement qu’on m’ena fait, & le peu de temps que j’ay eü à me reconnoître, vû qu’il a fallu en paſſer par là, & croyez que n’ayant eù pour tout ſujet que le Contract qu’une Fille ſigna par raillerie, qu’on voulut faire paſſer pour effectif étoit une matiere fort maigre pour avoir diverſifié la Scene comme elle eſt dans oute la ſuite de cette Piece.	mais j'esperc que vous excuserez l'empressement qu'on m'ena fait, et le peu de temps que j'ai eu à me reconnaître, vu qu'il a fallu en passer par là, et croyez que n'ayant éù pour tout sujet que le Contrat qu'une Fille signa par raillerie, qu'on voulut faire passer pour effectif était une matière fort maigre pour avoir diversifié la Scène comme elle est dans oute la suite de cette Pièce.
SONNET.	SONNET.
Ui ne voit ce Sujet qu'à la ſuperficie Ne porte pas les yeux ſur ſa ſolidité, Il faut pour le goûter, un eſprit alaité e toutes les douceurs de la Philoſophie.	Oui ne voit ce Sujet qu'à la superficie Ne porte pas les yeux sur sa solidité, Il faut pour le goûter, un esprit alaité est toutes les douceurs de la Philosophie.
Si Moliere vivoit, il porteroit envie ſçavoir de Fiot qui la ſeul inventé, recque tant d’eſprit & de nayveté ſ'on n’en ſçauroit aſſez admirer le genie.	Si Molière vivait, il porterait envie savoir de Fiot qui la seul inventé, reque tant d'esprit et de nayveté s'on n'en saurait assez admirer le génie.
Le Theatre reçoit, de ce divin Autheur oute ſa vanité, ſa gloire & ſon bonheur, eur l’avoir honoré d’une heure de ſes veilles.	Le Théâtre reçoit, de ce divin Auteur oute sa vanité, sa gloire et son bonheur, eur l'avoir honoré d'une heure de ses veilles.
Mais en revange auſſi, publiant ce Tableau l fait voir au Public tant de rares merveilles montte que ſon nom ne crains pas le tombeau.	Mais en revange aussi, publiant ce Tableau l fait voir au Public tant de rares merveilles montte que son nom ne crains pas le tombeau.
P.	P.
LE COINTE.	LE COINTE.
EPIGRAMME,	ÉPIGRAMME,
I FIOT nous fait voir dans ſon Amou Fantaſque, Trois Amans bien ſenſez, l’autre diſpos en baſ que;	I FIOT nous fait voir dans son Amou Fantasque, Trois Amans bien sensé, l'autre dispos en bas que;
C’eſt pour nous aſſurer qu’il n’ignore de rien Et que pour les cacher ſous un même viſage.	C'est pour nous assurer qu'il n'ignore de rien Et que pour les cacher sous un même visage.
Tout autre genie que le ſien Autoit perdu peine & Courage.	Tout autre génie que le sien Autait perdu peine et Courage.
P.	P.
LE COINTE	LE COINTE
EPIGRAMME.	ÉPIGRAMME.
A Monſieur Fiot ſur ſa Comedie.	À Monsieur Fiot sur sa Comédie.
Ui fait dans une Comedie.	Vi fait dans une Comédie.
O Connoitre la Terre & les Cieux, La Sageſſe, eſt langue des nieux Et qui d’une bravoure hardie Triomphe d’un bras en tous lieux, Eſt le favory quoy qu’on die D’Appollon le plus glorieux.	Ô Connaître la Terre et les Cieux, La Sagesse, est langue des nieux Et qui d'une bravoure hardie Triomphe d'un bras en tous lieux, Est le favori quoi qu'on die D'Apollon le plus glorieux.
A IONSIEUR FIOT SUR SA COMEDIE DE L’AMOUR FANTASQUE.	À JONSIEUR FIOT SUR SA COMÉDIE DE L'AMOUR FANTASQUE.
9 ET	9 ET
2 A Comedie d’ordinaire Eſt un aimable amuſement, Qui ſe paſſant en un moment muv Ne peut pas long-temps ſatisfairs.	2 À Comédie d'ordinaire Est un aimable amusement, Qui se passant en un moment mu Ne peut pas longtemps satisfairs.
Mais icy l’on ne ſçauroit taire, Qu'un ſolide contentement, Ne nous oblige inceſſamment A dire par tout le contraire, Son Autheur, l’Illuſtre FIOT;	Mais ici l'on ne saurait taire, Qu'un solide contentement, Ne nous oblige incessamment A dire par tout le contraire, Son Auteur, l'Illustre FIOT;
Qui n’a jamais bû de Piot Que de celuy de l’Hypocréne.	Qui n'a jamais bu de Piot Que de celui de l'Hypocrène.
Fait voir qu’on ne peut faire mieux, Et que rien n’égale ſa veint Pour le Comique, ou ſerieux.	Fait voir qu'on ne peut faire mieux, Et que rien n'égale sa vint Pour le Comique, ou sérieux.
A MONSIEVR FIOT, SUl ſur ſa Comedie de l’Amour Fantaſque.	À MONSIEUR FIOT, SUl sur sa Comédie de l'Amour Fantasque.
D.	D.
C.	Ç.
A MONSIEVR FIOT SVR SA Comedie de L’Amour Fantaſque.	À MONSIEUR FIOT SUR SA Comédie de L'Amour Fantasque.
I L ne faut pas être devin vif & brillant eſprit de t’appeller Divin, Platon moins juſtement merita cette gloirẽ llaton ſur un ſeul point excella ſeulement, uis tu fais voir icy bien plus excellement Que tu merite d’être au Temple de memoire.	I Y ne faut pas être devin vif et brillant esprit de t'appeler Divin, Platon moins justement mérita cette gloir llaton sur un seul point excella seulement, uis tu fais voir ici bien plus excellement Que tu mérite d'être au Temple de mémoire.
Le même,	Le même,
A MONSIEVR FIOT SVR SA Comedie de L’Amour Iantaſque.	À MONSIEUR FIOT SUR SA Comédie de L'Amour Jantasque.
Ue le feu de tes beaux écrits,  Ravit plaiſamment les eſprits, a Nature dans toy fait bien voir ſes miracles t'un & l'autre Parnaſſe eſt ſoûmis à ta Loy Du moins chacun de nous t’en eſtime le Roy, toyant des Vers ſi prompts paſſer pour des Oracles.	Que le feu de tes beaux écrits, Ravit plaisamment les esprits, a Nature dans toi fait bien voir ses miracles t'un et l'autre Parnasse est soumis à ta Loi Du moins chacun de nous t'en estime le Roi, toyant des Vers si prompts passer pour des Oracles.
ACTEVRS	ACTEURS
ANGELIQUE,	ANGELIQUE,
LYSANDRE, Amoureux d’Ange.	LYSANDRE, Amoureux d'Ange.
lique.	lique.
CEPHISE.	CÉPHISE.
Couſine d’Angelique.	Cousine d'Angélique.
PADILLE, Valet de Lyſandre.	PADILE, Valet de Lysandre.
PHILINTE,	PHILINTE,
ORONTE,	ORONTE,
La Scene eſt dans un e petlte ville de la Normandie.	La Scène est dans un e petlte ville de la Normandie.
Y AVI FANTASQUE.	Y AVI FANTASQUE.
DU LE JUGE DE SOY MESME.	DU LE JUGE DE SOI MÊME.
ODEDIE.	ODEDIE.
ACTE PREMIERE.	ACTE PREMIÈRE.
SCENE PREMIERE.	SCÈNE PREMIÈRE.
LYSANDRE, PADILLE.	LYSANDRE, PADILLE.
PADILLE.	PADILE.
OUS verray-je toûjours un viſage ſi blême?	OÙS verrai-je toujours un visage si blême?
Qu’avez-vous donc, Monſieur?	Qu'avez-vous donc, Monsieur?
LYSANDRE.	LYSANDRE.
Mon chagrin eſt exttême;	Mon chagrin est exttême;
PADILLE.	PADILE.
uquoy vous chagriner?	uquoy vous chagriner?
Ariſtore nous dit, Que jamais le chagrin n’apporte aucun profi	Aristore nous dit, Que jamais le chagrin n'apporte aucun profi
LYSANDRE.	LYSANDRE.
si comme moy.	si comme moi.
Padille avoit une Maîtreſſe.	Padille avait une Maîtresse.
me cien?	me cien?
PADILLE.	PADILE.
LYSANDRE.	LYSANDRE.
Que ſa fierté mépriſat ta tendreſſe Tu dirois comme moy.	Que sa fierté méprisat ta tendresse Tu dirais comme moi.
PADILLE.	PADILE.
Je ne ſuis pas ſi fou J’aurois le cœur pour elle auſſi dur qu’un caillos	Je ne suis pas si fou J'aurais le cœur pour elle aussi dur qu'un caillos
LYSANDRE.	LYSANDRE.
Si ſa haine pour toy devenoit effroyable!	Si sa haine pour toi devenait effroyable!
ADILLE Je la deteſterois tout comme on fait le piabl	ADILE Je la détesterais tout comme on fait le piabl
LYSANDRE.	LYSANDRE.
Ah!	Ah!
tu n’eſt pas Amant.	tu n'est pas Amant.
PADILLE.	PADILE.
Et pourquoy l’êtes-vous Sçavez-veus pas, Monſieur, que les Amans ſot foux,	Et pourquoi l'êtes-vous Savez-vus pas, Monsieur, que les Amants sot foux,
LYSANDRE.	LYSANDRE.
Que ta plaiſanterie eſt de mauvaiſegrace!	Que ta plaisanterie est de mauvaiségrace!
Conſeille moy plûtôt ce qu’il faut que je faſſe, Et trouve un prompt remede à ma vive doules	Conseille moi plutôt ce qu'il faut que je fasse, Et trouve un prompt remède à ma vive doules
A DTLLE Faut-il qu’un Medecin, donne ordre à ce mi heur ?	À DTLE Faut-il qu'un Médecin, donne ordre à ce mi heur ?
LYSANDRE.	LYSANDRE.
Si mon malte touchoit tu ne voudtois pas ril	Si mon malte touchait -tu ne voudais pas ril
P ADILLE.	 PDILLE.
J''́coute tout de bon, vous n’avez rien qu’à di	J''écoute tout de bon, vous n'avez rien qu'à di
LYSANDRE.	LYSANDRE.
Tu ſçais bien qu’Angelique avoit charmé mes yeux, Que de tous mes rivaux, j’étois reçeu le mieux, Mlais depuis peu pour moy cette beauté ſirate Par je ne ſçay quel ſort à l’eſpnt ſi bizaire, Que moy, ny mes rivaux n oſons plus approcher De l’unique beauté que je veux rechercher.	Tu sais bien qu'Angélique avait charmé mes yeux, Que de tous mes rivaux, j'étais reçu le mieux, Mlais depuis peu pour moi cette beauté sirate Par je ne sais quel sort à l'épnt si bizaire, Que moi, ni mes rivaux n osons plus approcher De l'unique beauté que je veux rechercher.
PADILLE.	PADILE.
Vous diſ-je pas ce ſexe eſt ſujet à la Lune.	Vous dis-je pas ce sexe est sujet à la Lune.
Car tantôt on luy plaiſt, tantôt on l’importune,	Car tantôt on avait plaît, tantôt on l'importune,
Y SANDRE.	Y SANDRE.
ſe qui me f che, plus c’eſt que je pers l’eſpoir.	se qui me f che, plus c'est que je perds l'espoir.
Aprés ce qu’elle à dit, de jamais la revoir.	Après ce qu'elle a dit, de jamais la revoir.
ſon amour ne veut plus d’un Amant Gentilhomme, z eſt le bel elprit leul a preſent qu'on renomme, Dit elle, & celuy-la pourra m’appartenir Qui le plus ſçavamment poutra m’entretenir.	son amour ne veut plus d'un Amant Gentilhomme, z est le bel prit leul a présent qu'on renomme, Dit elle, et celui-la pourra m'appartenir Qui le plus Savamment poutra m'entretenir.
Ce fantaſtique objet tient ſon ame obſedée, Ce qui fait que la mienne en eſt moins poſſedée	Ce fantastique objet tient son âme obsédée, Ce qui fait que la mienne en est moins possédée
A DILLE.	À DILLE.
Sice n’eſt que cela.	Sice n'est que cela.
Monſieur, tout ira bien.	Monsieur, tout ira bien.
LYSANDRE.	LYSANDRE.
Imploye tout pour moy je n’épaigneray rien.	Imploie tout pour moi je n'épaigneray rien.
ADILLE.	ADILE.
uy, vous ſçavez par fois plus d’eſprit qu’une bête.	Oui, vous savez par fois plus d'esprit qu'une bête.
ll faut, puiſqu’à ce point la Doctrine l’entête, la frapper par l’endroit qu’elle veut en tâter Et ſi prendre ſi bien qu’on n’aille rien gâter, Déguiſons nous tous deux, vous prendrez la figure D’un Philoſophe, & moy d’un brave l’encolure.	ll faut, puisqu'à ce point la Doctrine l'entête, la frapper par l'endroit qu'elle veut en tâter Et si prendre si bien qu'on n'aille rien gâter, Déguisons nous tous deux, vous prendrez la figure D'un Philosophe, et moi d'un brave l'encolure.
Croyez-moy, nous ferois un eſſay glorieux, Et nous vertons celuy qu’elle aimera le mieur, Si ces deux ne ſont pas ſuffiſans pour luy plaire Deux amis attitrez pouiront aprés le faire.	Croyez-moi, nous ferais un essai glorieux, Et nous vertons celui qu'elle aimera le mieur, Si ces deux ne sont pas suffisants pour lui plaire Deux amis attitrez pouiront après le faire.
L’un faiſant l’Aſtrologue, & raiſonnant ſort bie D’un Art, où cependant il ne connoîtra rien.	L'un faisant l'Astrologue, et raisonnant sort bye D'un Art, où cependant il ne connaîtra rien.
L’autre pour rendre enfin ſa paſſion complete, Comme abregé de tout, ſe dira grand Poëte.	L'autre pour rendre enfin sa passion complète, Comme abrégé de tout, se dira grand Poète.
Aviſez aux moyens de vous bien traveſtir, Et croyez que le tout nous va bien divertir, Etudiez vous à faire un parfait Philoſophe.	Avisez aux moyens de vous bien travestir, Et croyez que le tout nous va bien divertir, Éudiez -vous à faire un parfait Philosophe.
LYSANDRE.	LYSANDRE.
Mais il faudroit unhomme iey d’une autre éroffe Car comment m’élever ſur de beaux Argumens Sans en avoit devant conſulté les ſçavans.	Mais il faudrait unhomme iey d'une autre éroffe Carment comment m'élever sur de beaux Arguments Sans en avait devant consulté les savants.
De me faite enſeigner peu ſoigneux fut mon pei Des Nobles de Province enfin c’eſt la miſere.	De me faite enseigner peu soigneux fut mon pi Des Nobles de Province enfin c'est la misère.
Ce n’eſt pas dans le fons que j’ignore de rien, Et de tout, Dieu mercy, je raiſonne aſſez biet Je ſçais mieux me tirerd’une affaire preſſée, Que d’un grand philoſophe atteindre la penſé?	Ce n'est pas dans le fonds que j'ignore de rien, Et de tout, Dieu merci, je raisonne assez biét Je sais mieux me tirerd'une affaire pressée, Que d'un grand philosophe atteindre la pensé?
Padille, là deſſus je te laiſſe à ſonger.	Padille, là -dessus je te laisse à songer.
Suis-je propre à cela ?	Suis-je propre à cela ?
PADILLE.	PADILE.
Fant il tant ménage Combien en voyons nous dans le Siecle où noſommes Par un hardy diſcours, paſſer pour de grans Hommes?	Fant il tant ménage Combien en voyons nous dans le Siècle où nosommes Par un hardi discours, passer pour de grans Hommes?
D’ailleurs ne craignez rien échauffé par l’Amos Vous ne paſſerez pas pour un ſçavant d’un jo	D'ailleurs ne craignez rien échauffé par l'Amos Vous ne passerez pas pour un suavant d'un jo
LYSANDRE.	LYSANDRE.
Je vois à tes diſcours quelque peu d'apparence Un ſeul point ſeulement choque mon eſperan Pas un de mes amis n’eſt Aſtrologue.	Je vois à tes discours quelque peu d'apparence Un seul point seulement choque mon espéran Pas un de mes amis n'est Astrologue.
PADILLE Bou, Qu’il lile avant cela l’Almanach tout du long Mille mots inconnus feront bient oſt connoitre, Que dans l’Aſtrologie il s’eſt fait paſſer maiſtre.	PADILE Bou, Qu'il lile avant cela l'Almanach tout du long Mille mots inconnus feront bient ost connaître, Que dans l'Astrologie il s'est fait passer maître.
la, les termes de l’Art rangez ou mal, ou bien, On les admirera, ſans y connoître rien.	la, les termes de l'Art rangez ou mal, ou bien, On les admirera, sans y connaître rien.
Si pour ce haut ſçavoir vôtte belle maitreſſe A l’Aſtrologue ſeul rémoigne ſa tendreſſe, L’Aſtrologue attitré, de ſon Tiltie démy Vous mettant en ces droits fera le coup d’amy Ainſi vous vous ferez aimer de vôtre Da me.	Si pour ce haut savoir vôtte belle maîtresse À l'Astrologue seul rémoigne sa tendresse, L'Astrologue attitré, de son Tiltie démi Vous mettant en ces droits fera le coup d'ami Ainsi vous vous ferez aimer de votre Da me.
LYSANDRE.	LYSANDRE.
Par tes plaiſans diſcouts tu me réjoüis l’ame;	Par tes plaisants discouts tu me réjouis l'âme;
Je brûle en verité d’en venir aux effets, Padille eſt par ma foy, la perle des valets.	Je brûle en vérité d'en venir aux effets, Padille est par ma foi, la perle des valets.
Oüy, mais ſi ta bravoure, & ma Philoſophie Luy plaiſent auſſi peu comme l’Aſtrologie, Nous nous turons en vain, & nous perdrons nos pas, La ſcience en trois Arts ne ſe renferme pas, Sans quelque Roolle encor la piéce eſt imparfaite.	Oui, mais si ta bravoure, et ma Philosophie Lui plaisent aussi peu comme l'Astrologie, Nous nous turons en vain, et nous perdrons nos pas, La science en trois Arts ne se renferme pas, Sans quelque Role encor la pièce est imparfaite.
PADILLE.	PADILE.
Il faut qu’un autre amy faſſe.	Il faut qu'un autre ami fasse.
LYSANDRE.	LYSANDRE.
Hè quoy?	Hér quoi?
PADILLE.	PADILE.
Le Poëte,	Le Poète,
LYSANDRE.	LYSANDRE.
Où le trouver,	Où le trouver,
PADILLE.	PADILE.
Comment dans ce vaſte Univers On ne voit plus, Monſieur, que des faiſeurs de vers;	Comment dans ce vaste Univers On ne voit plus, Monsieur, que des faiseurs de vers;
C’eſt un fleau de Dieu dont ce Siecle fourmile L’un en fait bons ou non, s’il n’en fait il en pille A toute reſte il veut par un méchant écrit De rimeur dans le monde uſurper le crédit, Sans ceſſe de leurs vers j’ay a tête étourdie Et croy que de rimeurs il a fait une pluye.	C'est un fléau de Dieu dont ce Siècle fourmile L'un en fait bons ou non, s'il n'en fait il en pille À toute reste il veut par un méchant écrit De rimeur dans le monde usurper le crédit, Sans cesse de leurs vers j'ai a tête étourdie Et crois que de rimeurs il a fait une pluie.
ANDRE.	ANDRÉ.
Tu te fais fort de tout Padille mais j’ay peur De ne pouvoir trouver un aſſez bon pimeut,	Tu te fais fort de tout Padille mais j'ai peur De ne pouvoir trouver un assez bon pimeut,
DILLE.	DILLE.
A:	A:
cut hazard Monſieur, dedans cette occurenée Padille le fera, j’ay certaineſcier ce.	cut hasard Monsieur, dedans cette occurenée Padille le fera, j'ai certainescier ce.
ANDRE.	ANDRÉ.
Padille, on vient à nous;	Padille, on vient à nous;
c’eſt Angelique, ya Songe à bien rencontrer ces Perſonnages la Et d'un grand fanfaron va prendre le viſage.	c'est Angélique, ya Songe à bien rencontrer ces Personnages la Et d'un grand fanfaron va prendre le visage.
ADILLE J'y vais, & vous ſongez à vôtre perſonnage.	ADILE J'y vais, et vous songez à votre personnage.
iiſin.	jisin.
CENE II.	CÈNE II.
ANGELIQUE.	ANGELIQUE.
LYSANDRE.	LYSANDRE.
LYSANDRE,	LYSANDRE,
Algré tous vos mépris, je viens à vos geMhoux, Demander pour ma flamme un traitement plus doux;	Algré tous vos mépris, je viens à vos géMhoux, Demander pour ma flamme un traitement plus doux;
Madame, & ſi jamais Lyſandre à ſçu vous plaire, Veuillez ne prendre pas un ſentiment çontraire.	Madame, et si jamais Lysandre à suiv vous plaire, Veuillez ne prendre pas un sentiment çontraire.
si d’un ſçavoir exquis les ſublimes appas Dans ma Perſonne enfin ne ſe rencontrent pas, Toújours fidelle Amant au moins ſais-je connoître Le beau feu qu’en mon cœur vos charmes ont uie dt i Et prés de vous jamais aucun homme viyant Sur un pareil ſujet ne ſera ſi ſçavant.	si d'un savoir exquis les sublimes appas Dans ma Personne enfin ne se rencontrent pas, Toújours fidèle Amant au moins sais-je connaître Le beau feu qu'en mon cœur vos charmes ont uie dût y Et près de vous jamais aucun homme viyant Sur un pareil sujet ne sera si Savant.
ANGELTQUE.	ANGELTQUE.
Je conçois aſſez bien ce que vous voulez dire, Et je vois bien, Monſieur, que vous voulez vous rire, Si le ſçavoir m’a plû, vous avez un grand tort Pour m’en deſabuſer de faite aucun effort,	Je conçois assez bien ce que vous voulez dire, Et je vois bien, Monsieur, que vous voulez -vous rire, Si le savoir m'a plu, vous avez un grand tort Pour m'en désabuser de faite aucun effort,
LYSANDRE.	LYSANDRE.
De grace écoutez-moy, ſans vous mettre encolere.	De grâce écoutez-moi, sans vous mettre encolère.
ANGELIQUE Dans le Monde jamais peut-on ſe ſatisfaire, Sans contemplet à fond & la Terre, & les Cieux, Et ces beaux mouvemens qui raviſſent nos yeux.	ANGELIQUE Dans le Monde jamais peut-on se satisfaire, Sans contemplet à fond et la Terre, et les Cieux, Et ces beaux mouvements qui ravissent nos yeux.
Je ne ſuis qu’une Fille, & ſi j’ay dans mon ame.	Je ne suis qu'une Fille, et si j'ai dans mon âme.
ne ſçavoir toute choſe une invincible flamme.	ne savoir toute chose une invincible flamme.
Les teimes des ſçavans ont pour moy tant d’appas, Que je meurs de regret de ne les ſçavoir pas.	Les teimes des Savants ont pour moi tant d'appas, Que je meurs de regret de ne les savoir pas.
Je Pâme quand j’entens ce qu’on dit de la Sphere Et ces doctes raiſons que par tout on revere, Et je veux la deſlus, pour contenter mon cœur, Qu’un ſçavant ſur ce point devienne mon vainqueur	Je Pame quand j'entends ce qu'on dit de la Sphère Et ces doctes raisons que par tout on révère, Et je veux la délus, pour contenter mon cœur, Qu'un savant sur ce point devienne mon vainqueur
LYSANDRE.	LYSANDRE.
Amour, ſeconde moy dedans mon entrepriſe, La reſolution, Madame, en eſt dont priſe?	Amour, seconde moi dedans mon entreprise, La résolution, Madame, en est dont prise?
Et vous prefererez un orgueilleux ſçavant A la ſincerité d’un ſi parfait Amant?	Et vous préférez un orgueilleux Savant À la sincérité d'un si parfait Amant?
Vous, qui vous plaiſiez tant à voir croîtte mi Hamme;	Vous, qui vous plaisiez tant à voir croîtte mi Hamme;
Que tous deux bien unis nous ne faiſions qu’uns ame, Craignez qu’un repentir que produira l’amour, Vous donne mais trop tard du deplaiſir un jout.	Que tous deux bien unis nous ne faisions qu'uns âme, Craignez qu'un repentir que produira l'amour, Vous donne mais trop tard du déplaisir un jout.
Quelquefois des plus fiers ce Dieu prend la vengeance.	Quelquefois des plus fiers ce Dieu prend la vengeance.
ANGELIQUE.	ANGELIQUE.
Je crains peu vôtre amour, j’ay pour moy la Sci ence.	Je crains pu votre amour, j'ai pour moi la Sci ence.
LYSANDRE.	LYSANDRE.
Les ſeuls ſçavans pourtant font éclater ſes loir.	Les seuls Savants pourtant font éclater ses loir.
ANGELIQUE Pour ſe faire admirer ils le font quelquefois.	ANGELIQUE Pour se faire admirer ils le font quelquefois.
LYSANDRE.	LYSANDRE.
Je n’ay pas un eſprit pour répondre à vos pointes Trop de ſubtilitez à vos diſcours ſont jointes.	Je n'ai pas un esprit pour répondre à vos pointes Trop de subtilités à vos discours sont jointes.
ANGELIQUE.	ANGELIQUE.
Quand vous dites cela, vous vous moquez de nous.	Quand vous dites cela, vous vous moquez de nous.
LYSANDRE.	LYSANDRE.
C’en eſt aſſez, Madame;	C'en est assez, Madame;
adieu, ſouvenez-vous Que dans tous vos Amans rien ne ſera ſi tendre, Que l’amour qu’à pour vous le mal’heureux Ly ſandre, D’un Philoſophe allons vite prendre l’habit;	adieu, souvenez-vous Que dans tous vos Amants rien ne sera si tendre, Que l'amour qu'à pour vous le malheureux Ly sandre, D'un Philosophe allons vite prendre l'habit;
Inſpire la ſcience, Amour en mon eſprit.	Inspire la science, Amour en mon esprit.
it ſon	it son
SCENE III.	SCÈNE III.
ANGELIQUE, PADILLE deguiſt en capitan.	ANGELIQUE, PADILLE déguist en capitan.
PAD’ILLE' à pars.	PAD'ILÉLÉ à pars.
Entrevois Angelique, ah!	Entrevois Angélique, ah!
c'eſt icy, Padille, Qu’il faut comme un Soleil que ton bel eſprit bri le	c'est ici, Padille, Qu'il faut comme un Soleil que ton bel esprit bry le
ANGELIQUE.	ANGELIQUE.
Cét homme en veut à nous, que voulez vous Monſieur.	Cet homme en veut à nous, que voulez -vous Monsieur.
ADTLLE.	ADTLE.
Madame, vous voyez le Fils de la terreur;	Madame, vous voyez le Fils de la terreur;
Ou, pour mieux m’expliquer dans ma bravoure extréme, M'étant creé tout ſeul, je ſuis la tetreur même.	Ou, pour mieux m'expliquer dans ma bravoure extrême, M'étant cré tout seul, je suis la tetreur même.
Sans me ſervir d’un bras qui tua le pieu Mars, Je ſoûmis l’Univers d’un ſeul de mes regats.	Sans me servir d'un bras qui tua le pieu Mars, Je soumis l'Univers d'un seul de mes rats.
Tel que vous me voyez, j’ay forgé le Tonnerre bes Geans qu’enfanta le Ciel contre la Terre.	Tel que vous me voyez, j'ai forgé le Tonnerre bes Géans qu'enfanta le Ciel contre la Terre.
les gages que par an je donne à mes valets Sont les Sceptes dorez des Roys que je ſoûmets.	les gages que par an je donne à mes valets Sont les Sceptes dorés des Rois que je soumets.
J’ay vaincu les Cæſars, défait les Alexandres J’ay pillé leurs Etats, mis leurs Trônes en cendre.	J'ai vaincu les Cæsars, défait les Alexandres J'ai pillé leurs États, mis leurs Trônes en cendre.
La Chimere, & Meduſe ont ſenty ma fureur, Quoy qu’à Bellerophon on en donne l’honneur.	La Chimère, et Méduse ont senti ma fureur, Quoi qu'à Bellerophon on en donne l'honneur.
ay fait plus, comme en moy le genre humain ſe fonde,	ai fait plus, comme en moi le genre humain se fonde,
ne cent monſtres affreux, j’ay delivré le monde Mais qui pourroit encor croire, aprés tout cela Que j’ay d’un ſoufle éteint les feux du mont Etna J’en ay tant fait qu’enfin les Iaſons, les Hercules Prés de moy, s’ils vivoient, paroîtroient ridicule, Aprés avoir ſur terre eſſuyé ces travaux, Non content, je noyé Neptune dans ſes eaux, Pour avoir ſans mon otdre elevé la tempête Qu’Enée a reſſenty pourſuivant ſa conquére.	ne cent monstres affreux, j'ai délivré le monde Mais qui pourrait encor croire, après tout cela Que j'ai d'un souffle éteint les feux du mont Etna J'en ai tant fait qu'enfin les Jasons, les Hercules Près de moi, s'ils vivaient, paraîtraient ridicule, Après avoir sur terre essuyé ces travaux, Non content, je noyé Neptune dans ses eaux, Pour avoir sans mon otdre élevé la tempête Qu'Enée a ressent poursuivant sa conquère.
Me voyant ainſi maître & du monde, & des Men Je fis décendre auſſi ma valeur aux Enfers.	Me voyant ainsi maître et du monde, et des Mén Je fis décendre aussi ma valeur aux Enfers.
La, malgré de Pluton l’inſolence brutale, Je fis ceſſer Siſiphe, & repoſer Tantale.	La, malgré de Pluton l'insolence brutale, Je fis cesser Sisiphe, et reposer Tantale.
Je briſé tous leurs fers, & pour parlet aux Dieur.	Je brisé tous leurs fers, et pour parlet aux Dieur.
Des Enfers, ou j’étois je monté dans les Cieur Jupiter, pour donner à mes faits recompenſe, Ordonna que ſur tout j’aurois pleine puiſſance Que je pouvois uſer des Celeſtes beautez, Les prendre, & les choiſit ſelon mes volontez, Mais rien ne m’y plaiſant, j’en ſortis algrand end Et vous voyant du Ciel briller deſſus la terte;	Des Enfers, ou j'étais je monté dans les Cieur Jupiter, pour donner à mes faits récompense, Ordonna que sur tout j'aurais pleine puissance Que je pouvais user des Célestes beautés, Les prendre, et les choisit selon mes volontés, Mais rien ne m'y plaisant, j'en sortis aland end Et vous voyant du Ciel briller dessus la terte;
Je me crois trop heureux:	Je me crois trop heureux:
Madame, ſi je vis Iour voir vôtre beauté de mes travaux le pri	Madame, si je vis Jour voir votre beauté de mes travaux le pri
ANGELIQUE.	ANGELIQUE.
Pourquoy finiſſez vous?	Pourquoi finissez -vous?
vos diſcours mont chi mée.	vos discours mont chi mée.
PADILLE.	PADILE.
La bravoure, Madame, eſt par vous eſtimée.	La bravoure, Madame, est par vous estimée.
ANGELIQUE.	ANGELIQUE.
Ce n’eſt pas ce qui fait tout mon charme po tant, Mais le ſtile joly d’un diſcours ſi plaiſant;	Ce n'est pas ce qui fait tout mon charme pô tant, Mais le style joli d'un discours si plaisant;
Et vous avz, Monſieur, le don de l’Eloque	Et vous avez, Monsieur, le don de l'Éloque
PADILLE.	PADILE.
Vous ne voulez donc rien qu’un homme de Science 1 it le pouvoir qu’en tout vous ſçavez qu’a mon Olds .	Vous ne voulez donc rien qu'un homme de Science 1 it le pouvoir qu'en tout vous savez qu'à mon Olds .
Pour prendre un autre Amant ne vous étonne rlu e Eh bien	Pour prendre un autre Amant ne vous étonne ru e Eh bien
ANGELIQUE.	ANGELIQUE.
Qui peut, Monſieur, tout à coup vous ſurprendre.	Qui peut, Monsieur, tout à coup vous surprendre.
PADILLE ſoriant.	PADILE soriant.
Je vais mettre aujourd’huy tous les ſçavans en cendre.	Je vais mettre aujourd'hui tous les Savants en cendre.
SCENE IV.	SCÈNE IV.
ANGELIQUE, LYSANDRE deguiſe en Philoſophe.	ANGELIQUE, LYSANDRE déguise en Philosophe.
LYSANDRE.	LYSANDRE.
Aiſſez le Capitan, Madame, écoutez nous L Deduire pour vous plaire un diſcours bien plus doux.	Aissez le Capitan, Madame, écoutez nous Déduire pour vous plaire un discours bien plus doux.
ANGELIQUE.	ANGELIQUE.
Si c’eſt du haut ſçavoir.	Si c'est du haut savoir.
Monſieur, j’en ſuis ravie.	Monsieur, j'en suis ravie.
LYSANDRE.	LYSANDRE.
Madame, c’eſt icy de la philoſophie.	Madame, c'est ici de la philosophie.
ANGELIQUE.	ANGELIQUE.
Mes ſens ſont de cét Art déja tous enchantez,	Mes sens sont de cet Art déjà tous enchantez,
lieux.	lieux.
LYSANDRE:	LYSANDRE:
J’en ſuis plus réjoüy puiſque vous les goûtez, pour la philoſophie apprenez par avance, Que ce n’eſt pas un Art, mais bien une Science Par elle je connois tous les quatre Elemens, Leur centre, leur ſubſtance, & tous leurs acc dens.	J'en suis plus réjoüy puisque vous les goûtez, pour la philosophie apprenez par avance, Que ce n'est pas un Art, mais bien une Science Par elle je connais tous les quatre Éléments, Leur centre, leur substance, et tous leurs acc ends.
Celuy qui ſe noya pour ne pouvoir comprendis Le reflus de la mer pouvoit de moy l’apprendit D’où precedent les vents je ne l’ignore pas, Et les ay deffiny mieux qu’Anaxagoras.	Celui qui se noya pour ne pouvoir comprendis Le reflus de la mer pouvait de moi l'apprendit D'où précédent les vents je ne l'ignore pas, Et les ai définy mieux qu'Anaxagoras.
Je ſçais, hors Dieu, que tout à ſa cauſe ſeconde Et tous les beaux effets qu’on admire en ét monde.	Je sais, hors Dieu, que tout à sa cause seconde Et tous les beaux effets qu'on admire en est monde.
J’ay prouvé quand quelqu’un d’une épèe et pevoit, Que c’étoit l’air non pas le fer qui le tuoit.	J'ai prouvé quand quelqu'un d'une épée et pevait, Que c'était l'air non pas le fer ait le tuait.
’ay fait voir que ce monde eſt pareil dans l Lune;	ais fait voir que ce monde est pareil dans l' Une;
nt que d’elle, & de luy la figure eſt commune.	naît que d'elle, et de Seigneur la figure est commune.
Je ſçay tres bien la Sphere, & je n’ignore point Qu’au milieu de la mer la terre eſt comme u point Bref, je connois les corps tant internes, qu’e ternes, Et les lieux ſouverains d’avec les ſubalternes.	Je sais très bien la Sphère, et je n'ignore point Qu'au milieu de la mer la terre est comme point Bref, je connois les corps tant internes, ternes, Et les lieux souverains avec les subalternes.
Je ſçais Cauſe, Effet, Forme, Eſpece, Mouve mens, Vuide.	Je sais Causse, Effet, Forme, Espèce, Mouve mens, Vuide.
Exiſtence, Atome, Idées, Argumens, anfin le reſultat de cette connoiſſance A le ſouverain bien pour but de ſa ſcience, 2t d’aimer les beautez approchantes des Dieur Je n’en vois point que vous, Madame, dans c Et je ſuis trop heureux, ſi ce bel œil m’ordonne Que mon Art s’incorpore avec vôtre Perſonne.	Existence, Atome, Idées, Arguments, anfin le résultat de cette connaissance A le souverain bien pour but de sa science, 2t d'aimer les beautés approchantes des Dieur Je n'en vois point que vous, Madame, dans c' Et je suis trop heureux, si ce bel œil m'ordonne Que mon Art s'incorpore avec votre Personne.
ANGELIQU E.	ANGELIQU E.
Pour vôtre haut ſçavoir ce prix ſeroit tropbas.	Pour votre haut savoir ce prix serait tropbas.
LYSANDRE.	LYSANDRE.
Mon ſçavoir tel qu’il eſt ne vous merite pas, Vous faites trop d’honneur à ma Philoſophie.	Mon savoir tel qu'il est ne vous mérite pas, Vous faites trop d'honneur à ma Philosophie.
ANGELIQUE.	ANGELIQUE.
Mais la ſcience enfin deffend qu’on ſe marie.	Mais la science enfin défend qu'on se marie.
LYSANDRE.	LYSANDRE.
Au contraite il faut joindre:	Au contraite il faut joindre:
avec les beautez Pour leur perfection les ſublimes clartez.	avec les beautés Pour leur perfection les sublimes clartés.
ANGELIQUE.	ANGELIQUE.
Ce ſont des argumens qu’a loiſit j’examine.	Ce sont des arguments qu'a loisit j'examine.
L YSANDRE.	 LYSANDRE.
madams, npour mioy intte cœur ſe deſtine, J’attens patiemment ce moment bien heureux.	madams, npour mioi intte cœur se destine, J'attends patiemment ce moment bien heureux.
ANGELIQUE.	ANGELIQUE.
On ne peut pas, Monſieur, ſe marier à deux;	On ne peut pas, Monsieur, se marier à deux;
Vos raiſons là deſſus ſont de peu d’importance, Excuſez moy, je veux épouſer laScience.	Vos raisons là dessus sont de peu d'importance, Excusez moi, je veux épouser laScience.
LYSANDR E bai.	LYSANDR E bai.
Voyons;	Voyons;
car là deſſus je l’ay bien empreſſé, Si nôtre amy fera ce que j’avois penſé Madame;	car là dessus je l'ai bien empreessé, Si notre ami fera ce que j'avais pensé Madame;
puis qu’icy ce diſcours vous ennuye, Recevez les adieux de la Philoſophie.	puis qu'ici ce discours vous ennuie, Recevez les adieux de la Philosophie.
il ſont	il sont
EN E ANGELIQUE, PHILINTE deguiſt en Aſins logue, un Sphere à la main.	EN E ANGELIQUE, PHILINTE déguist en Asins logue, un Sphère à la main.
ILINT E Oin de plaire à vos yeux ces ſçavans de Bibus L Dévroient tous, ſur mon ame, eſſuyer vos refus, Un ſçavant, comme moy, Madame, ſur la Sphere noit prétendre tout ſeul à l’honneur de vous plaire.	ILINT E In de plaire à vos yeux ces sçavans de Bibus L Dévroient tous, sur mon âme, essuyer vos refus, Un savant, comme moi, Madame, sur la Sphère noit prétendre tout seul à l'honneur de vous plaire.
eſtant un racourcy des ſublimes ſçavans.	étant un racourci des sublimes Savants.
Qui merite le mieux d’être de vos Amans.	Qui mérite le mieux d'être de vos Amants.
ANGELTQU Eà part ne ſçavoir quel il eſt je ſens brûler mon ame.	ANGELTQU Eà part ne savoir quel il est je sens brûler mon âme.
Je ſuis.	Je suis.
HILINTE,	HILINTE,
NGELIQUE.	NGELIQUE.
Hè quoy, Monſieur	Hér quoi, Monsieur
PHILINTE Aſtrologue, Madame.	PHILINTE Astrologue, Madame.
ANGELIQUE.	ANGELIQUE.
CétArt de tous les Arts approche plus des Dieux.	CetArt de tous les Arts approche plus des Dieux.
HILINTE.	HILINTE.
Mais c’eſt ſur tout pour moy qui m’y connois des mieux Si vous me demandez à quoy ſert cette Sphere.	Mais c'est sur tout pour moi qui m'y connais des mieux Si vous me demandez à quoi sert cette Sphère.
J’en conpois du Soleil, l’une & l’autre Hemiſs PhE,	J'en conpois du Soleil, l'une et l'autre Hémiss PhE,
je ſçay par la combien le Ciel a de hauteur, Et la Terre de tout, la Mer de profondeur, je connois chaque, Etoille & qu’une ame commune, Ne voit pas comme moy le Soleil, & la Lune.	je sais par la combien le Ciel a de hauteur, Et la Terre de tout, la Mer de profondeur, je connais chaque, Étoille et qu'une âme commune, Ne voit pas comme moi le Soleil, et la Lune.
Je fens l’air, & la nuë;	Je sens l'air, et la nue;
& je vais quand je veux Voir ces beaux mouvemens qui font tourner les Cieux, Mon pouvoir eſt tres-grand, par le moyen des aſtres, I'annonce les malheurs, je prévois les deſaſtres.	et je vais quand je veux Voir ces beaux mouvements qui font tourner les Cieux, Mon pouvoir est très-grand, par le moyen des astres, J'anne les urs, je prévois les désastres.
Si vous ne croyez pas mon pouvoir ſouverain, Pour l’experimenter donnez moy vôtre main.	Si vous ne croyez pas mon pouvoir souverain, Pour l'expérimenter donnez moi votre main.
ANGELIQUE.	ANGELIQUE.
Dans un plaiſit ſi grand rêvé-je, ou ſi je veille?	Dans un plaisit si grand rêvé-je, ou si je veille?
PHILINTE.	PHILINTE.
Donnez-moy yôtre main, je vais faire merveille.	Donnez-moi notre main, je vais faire merveille.
ANGELIQUE luy donnant ſa main.	ANGELIQUE était donnant sa main.
Quoy?	Quoi?
vous m’allez montrer tout ce que j’ay pensé.	vous m'allez montrer tout ce que j'ai pensé.
PHILINTE.	PHILINTE.
Oüy, je ſçais l'avenir, Madame, & le paſſé.	Oui, je sais l'avenir, Madame, et le passé.
regardant dans ſa main.	regardant dans sa main.
Cét aſpect de Venus me fait bientôr comprendre Qu’un Amant vous en veut qui ſe nemme tyſandre.	Cet aspect de Venus me fait bientôr comprendre Qu'un Amant vous en veut qui se nemme tysandre.
ANGELIQUE.	ANGELIQUE.
Autois je pû jamais;	Autais -je pu jamais;
o Ciel men défier ?	ô Ciel men défier ?
Monſieur, vous êtes diable, ou pour le moins ſorcier.	Monsieur, vous êtes diable, ou pour le moins sorcier.
PHILINTE.	PHILINTE.
Mais cét aſpect entrant dans la Lune aſcendante Vous a rendu pour luy l’ame tres inconſtante, Mercure retrogtade occupe vôtre main Qui fait qu’hors les ſçavans tout vous eſt à de.	Mais cet aspect entrant dans la Lune ascendante Vous a rendu pour lui l'âme très inconstante, Mercure retrogtade occupe votre main Qui fait qu'hors les savants tout vous est à de.
dain.	dain.
Mais je remarque icy qu’une ligne douteuſe nenote qu’en Amans vous ſerez mal’hureuſe;	Mais je remarque ici qu'une ligne douteuse nenote qu'en Amants vous serez mal'heureuse;
Mais que vous le ſerez encor plus mille fois, Si de tous vos Amans Lyſandre n’eſt le choix.	Mais que vous le serez encor plus mille fois, Si de tous vos Amants Lysandre n'est le choix.
Il faut ſans contredit qu’il ait la preference, Ie parle contre moy prédiſant la puiſſance.	Il faut sans contredit qu'il ait la préférence, Je parle contre moi prédisant la puissance.
Qu'un aſtre pour Lyſandre annonce, en bonne Ioy.	Qu'un astre pour Lysandre annonce, en bonne Ioi.
Mais pourriez vous aimer un hõmecomme moy?	Mais pourriez vous aimer un homme moi?
J'aj comme vous ſçivez la plus belle doctrine.	J'aj comme vous sivez la plus belle doctrine.
ANGELTQUE.	ANGELTQUE.
Je crains trop du deſtin la puiſſance pivine.	Je crains trop du destin la puissance pivine.
ILINTE.	ILINTE.
L’Aſtrologie icy ni’a dont point de pouvoir?	L'Astrologie ici ni'a dont point de pouvoir?
NGELIQUE.	NGELIQUE.
Je veux avec plaiſit vous entendre & vous voit.	Je veux avec plaisit vous entendre et vous voit.
TLINTE.	TLINTE.
Ouy, mais de vôtre hymen vous me croyez indigne.	Oui, mais de votre hymen vous me croyez indigne.
rour vous plaire il vous faut quelque ſçavã inſigne	rour vous plaire il vous faut quelque sçavã insigne
Le plus parfait.	Le plus parfait.
Monſieur, doit eſtre mon époux,	Monsieur, doit être mon époux,
HTLINTE Madame, apparemment que ce n’eſt dont pas nous.	HTLINTE Madame, apparemment que ce n'est dont pas nous.
ANGELIQUE Le temps peut être enfin pourta nous y reſoudre.	ANGELIQUE Le temps peut être enfin pourta nous y résoudre.
HTLINT EJe vous jure, pour moy, c’eſt un vray coup de foudre, De dépit, je m’en vais peut êtrè me noyer.	HTLINT EJe vous jure, pour moi, c'est un vrai coup de foudre, De dépit, je m'en vais peut êtrè me noyer.
il ſont.	il sont.
ANGELIQUE.	ANGELIQUE.
Enfin tous les ſçavans me vont deſennuyer.	Enfin tous les Savants me vont désennuyer.
SCENE VI.	SCÈNE VI.
ANGELIQUE, PADILLE déguiſe en Peëue,	ANGELIQUE, PADILLE déguise en Peëue,
PADILLE.	PADILE.
Aiſſez ce fou, Madame, avecque ſa Planete, L Et venez écouter un celebre poëte.	Aissez ce fou, Madame, avec sa Planète, L Et venez écouter un célèbre poète.
Par un iuſtine ſecret que jay reçû des Cieux.	Par un justine secret que jay reçu des Cieux.
ſe parle habiliement le langage des Dieux, Favory d’Apollon j’ay dans le mont Parnaſſe, Malgré mes envieux, la plus inſigne place;	se parle habiliement le langage des Dieux, Favori d'Apollon j'ai dans le mont Parnasse, Malgré mes envieux, la plus insigne place;
Et je bois à mon gré de ces ſaintes liqueurs, Qui font, comme je ſuis les illuſtres Autheurs.	Et je bois à mon gré de ces saintes liqueurs, Qui font, comme je suis les illustres Auteurs.
Seul, je vis de Lauriers, je loge au mont Caucaſe, J’ay pour valet ma Muſe, & pour cheval Pegaſe.	Seul, je vis de Lauriers, je loge au mont Caucase, J'ai pour valet ma Muse, et pour cheval Pégase.
I’oëte tres fidelle au grand Dieu que je ſers, Ma proſe a ſon congé, je ne parle qu’en vers, Je ſçais l’art de bien dire, & la philoſephie :	J'ôte très fidèle au grand Dieu que je sers, Ma prose a son congé, je ne parle qu'en vers, Je sais l'art de bien dire, et la philosephie :
Et la Mathematique, avec l’Aſtrologie Jentens bien toute langue, & l’on ne peut trouver, Rien que tres-doctement, je ne puiſſe prouves, Et de vous meriter j’ay lieu plus que perſonne, Si c’eſt au plus ſçivant que votre main ſe donne.	Et la Mathématique, avec l'Astrologie Jentends bien toute langue, et l'on ne peut trouver, Rien que très-doctement, je ne puisse prouves, Et de vous mériter j'ai lieu plus que personne, Si c'est au plus sivant que votre main se donne.
ANGELIQUE J’avoüe en verité que vous me charmez plus Qu’un tas de beaux eſprits qu’on nomme ſuperflus, 1 Et pour cela, Monſieur, vous avez l’art de plaire	ANGELIQUE J'avoue en vérité que vous me charmez plus Qu'un tas de beaux esprits qu'on nomme superflus, 1 Et pour cela, Monsieur, vous avez l'art de plaire
A DILLEbas.	À DILEbas.
Padille l’a trouvé;	Padille l'a trouvé;
ma foy, voicy l’affaire.	ma foi, voici l'affaire.
Je puis donc eſperer, Madame, le bonheur D’être choiſi par vous pour vôtre ſerviteur?	Je puis donc espérer, Madame, le bonheur D'être choisi par vous pour votre serviteur?
ANGELIQUE.	ANGELIQUE.
Qui vous a ditcela?	Qui vous a ditcela?
craignez de vous méprext dse.	craignez de vous méprext dse.
ADILLE.	ADILE.
Vous ne voulez donc pas à mon ſçavoir vous rendre	Vous ne voulez donc pas à mon savoir vous rendre
ANGELIQUE.	ANGELIQUE.
Sije veux un mary ce n’eſt pas encor vous.	Sije veux un mari ce n'est pas encor vous.
A D'I L LE bas.	À D'I L LE bas.
Voyez donc l’abregé des folles & des foux.	Voyez donc l'abrégé des folles et des foux.
Mais ſans tant de raiſons voulez vous toûjoun taire, Celuy qui pour époux pourra jamais vous plairt	Mais sans tant de raisons voulez -vous toûjoun aire, Celui qui pour époux pourra jamais vous plaît
ANGE IQUE.	ANGE IQUE.
Comme au plus écaliré de ceux que je connois.	Comme au plus écaliré de ceux que je connais.
Je veux bien vous montret celuy que j’aimerois Je prétens que l’époux que je veux reconnoîge Soit ent galante humeur, des plus ſçavans le Maître, En un mot que de tout il raiſonne ſi bien, Qu’il charme tout le monde avec ſon entretier Et que de ſon eſprit la gentille nature, Dans l’adreſſe, & dans tout ſoit ſemblable;	Je veux bien vous montret celui que j'aimerais Je prétends que l'époux que je veux reconnaître Soit ent galante humeur, des plus sçavans le Maître, En un mot que de tout il raisonne si bien, Qu'il charme tout le monde avec son entretier Et que de son esprit la gentille nature, Dans l'adresse, et dans tout soit semblable;
Mercute, Adieu, cherchez ailleurs à vous entretenir.	Mercute, Adieu, cherchez ailleurs à vous entretenir.
elle ſou	elle sou
ADILLE Bon, je vois à propos mon Maiſtre tevenir.	ADILE Bon, je vois à propos mon Maître tevenir.
SCENE VII.	SCÈNE VII.
LYSAN DRE, PADILLE.	LYSAN DRE, PADILLE.
LYSANDRE.	LYSANDRE.
E bien t'a telle fait encore quelque fraſque?	E bien t'a telle fait encore quelque frasque?
11 PADILLE Non, je ne vis jamais un amour ſi fantaſque.	11 PADILLE Non, je ne vis jamais un amour si fantasque.
LYSANDRE.	LYSANDRE.
Cette bizarre humeur me met au deſeſpoir.	Cette bizarre humeur me met au désespoir.
A D’ILLE ne vou fouereepome, je ſçauray bienl’avoir.	À D'ÎLE ne vou fouerepome, je saurai bienl'avoir.
LYSANDRE.	LYSANDRE.
Qoy?	Qoi?
tu pourrois trouver quelque ombre d’apparence.	tu pourrais trouver quelque ombre d'apparence.
A D I LLE Je la tiens dans vos tets, Monſieur, en aſſurance.	À D I LLE Je la tiens dans vos tets, Monsieur, en assurance.
LYSANDRE Dis donc vite, je cede à cét eſpoir ſi doux.	LYSANDRE Dis donc vite, je cède à cet espoir si doux.
A DILLE, Il faut avant cela que nous allions chez vous.	À DILLE, Il faut avant cela que nous allions chez vous.
LYSANDRE.	LYSANDRE.
Je brûle de ſçivoir ce que tume veux dire.	Je brûle de sçivoir ce que tume veux dire.
PADILLE.	PADILE.
Allons, chemin faiſant, je vais vous en inſtruire.	Allons, chemin faisant, je vais vous en instruire.
LYSANDRE:	LYSANDRE:
D'eù conçois tu padille un ſi charmanteſpoir.	D'eù conçois -tu padille un si charmantespoir.
PADILLE.	PADILE.
Retirons nous vous dis-je, vous l’allez ſçrvoit	Retirons -nous vous dis-je, vous l'allez sçrvoit
Fin du premier Acte.	Fin du premier Acte.
ACTE II.	ACTE II.
SCENE PREMIERE.	SCÈNE PREMIÈRE.
ANGELIQUE, CEPHISE.	ANGELIQUE, CÉPHISE.
CEPHISE.	CÉPHISE.
Nfin j’entens par tout que ta bizarterie E pour les hommes ſçavans va juſqu’a la folie D’où vient donc que par tout on dit cela de tou Tu perdras ton renom, Couſine, en bonne foyJe t’en viens avertir comme étant ton amie.	Nfin j'entends par tout que ta bizarterie E pour les hommes sçavans va jusqu'a la folie D'où vient donc que par tout on dit cela de tou Tu perdras ton renom, Cousine, en bonne foie t'en viens avertir comme étant ton amie.
ANGELIQUE.	ANGELIQUE.
Vous prenez trop de ſoin, j’en ſuis toute aver tie, Et pouriez vous paſſer, ſans vous faire un gran tort, De me traitter de folle, & vous me fachez fort	Vous prenez trop de soin, j'en suis toute aver tye, Et pouriez -vous passer, sans vous faire un gran tort, De me traiter de folle, et vous me fâchez fort
CEPHISE.	CÉPHISE.
Si vous le prenez là, je vais bientot me :	Si vous le prenez là, je vais bientôt me :
aire Puis-je retenir, moy, la langue du Vulgaite?	aire Puis-je retenir, moi, la langue du Vulgaite?
On m’a fait ce raport, j’ay de vous avertir	On m'a fait ce rapport, j'ai de vous avertir
ANGELIQUE.	ANGELIQUE.
Mais vous croyez auſſi que c’eſt une folie D’aimer tant les ſçavans	Mais vous croyez aussi que c'est une folie D'aimer tant les savants
CEPHISE.	CÉPHISE.
en crois une partie.	en crois une partie.
ANGELIQUE.	ANGELIQUE.
Vous avez là deſſus de tres beaux ſentimens!	Vous avez là dessus de très beaux sentiments!
l’ignorance vous plaiſt comme à beaucoup de gens.	l'ignorance vous plaît comme à beaucoup de gens.
CEPHISE.	CÉPHISE.
V'oulez vous aprés tout que l’eſprit d’une femme	V'oulez -vous après tout que l'esprit d'une femme
ANGELIQUE.	ANGELIQUE.
Briſons là, s’il vous plaiſt, je vous quitte, Madame Et ne puis avec vous plus durer un moment.	Brisons là, s'il vous plaît, je vous quitte, Madame Et ne puis avec vous plus durer un moment.
CRPITSE.	CRPITSE.
On vient à nous;	On vient à nous;
adieu, voila quelque ſçavant.	adieu, voilà quelque savant.
SCENE II.	SCÈNE II.
ANGELIQUE, PADILLE tres bien mis.	ANGELIQUE, PADILE très bien mis.
PADILLE.	PADILE.
’Entens de tous cô ez que vous ſeriez bien.	’Entens de tous cô ez que vous seriez bien.
aiſe ne rencontrer, Madame, un amant qui vous plaiſe.	aise ne rencontrer, Madame, un amant qui vous plaise.
Je viens mal à propos m’offrir pour ce ſujet, Mais vous excuſerez peut-être mon projet,	Je viens mal à propos m'offrir pour ce sujet, Mais vous excuserez peut-être mon projet,
ANGELIQUE.	ANGELIQUE.
J’admire avec p’aiſic vôtre aimable genie	J'admire avec p'aisic votre aimable génie
PADILLE.	PADILE.
Je vout amene icy mauvai ſe compagnie	Je vout amène ici mauvai se compagnie
ANGELIQUE.	ANGELIQUE.
J’eois leule pourtant.	J'eais leule pourtant.
PADILLE.	PADILE.
Seule avec vôtre eſprit, Vous vallez mieux cent fois qu’un cerle de credit	Seule avec votre esprit, Vous vallez mieux cent fois qu'un cerle de crédit
ANGELIQUE.	ANGELIQUE.
La pointe à vos diſcours eſt par tout energique	La pointe à vos discours est par tout énergique
ADILLE Vos yeux ſeuls ont ſur moy la pointe qui me pi.	ADILE Vos yeux seuls ont sur moi la pointe qui me pi.
ſDi que.	sDi que.
Madame;	Madame;
& mon amour fait parler mon eſprit,	et mon amour fait parler mon esprit,
ANGELIQUE Avec peine je croy ce que vous m’avez dit.	ANGELIQUE Avec peine je crois ce que vous m'avez dit.
Quoy?	Quoi?
̀ vôtre liberté ſeroit elle aſſervie,	 Votre liberté serait -elle asservie,
ADILLE.	ADILE.
Ouy, Madame, & je croy que j’en tiens pour ma vie Mieux, Madame, que n’eſt un eſclave en Turqui?	Oui, Madame, et je crois que j'en tiens pour ma vie Mieux, Madame, que n'est un esclave en Turqui?
Et je crois me voyant brûler ſi fortement.	Et je crois me voyant brûler si fortement.
Vôtre eſprit un Soleil, vôtre œil miroir ardent De grace, moderez ce rayon qui me tuë.	Votre esprit un Soleil, votre œil miroir ardent De grâce, modérez ce rayon qui me tue.
ANGELIQUE àpart.	ANGELIQUE àpart.
Par ces charmans diſcours mon ame eſt abbatuë;	Par ces charmants discours mon âme est abattue;
Et s’ils étoit offert pour étre mon amant, Mon cœur reſiſteroit aſſez mal-aiſément.	Et s'ils était offert pour être mon amant, Mon cœur résisterait assez malaisément.
PADILLE.	PADILE.
l’adore la ſcience & je ſoûtiens.	l'adore la science et je soutiens.
Madame, Q’un homme ſans ſçavoir n’eſt rien qu’ul corps ſans ame.	Madame, Q'un homme sans savoir n'est rien qu'ul corps sans âme.
J'aime les beaux écris les Vers, & les Romans, Er ces productions que font toue les ſçavans.	J'aime les beaux écris les Vers, et les Romans, Er ces productions que font toue les sçavans.
ANGELIQUE.	ANGELIQUE.
Nous avons pour cela d’étroites ſympathies.	Nous avons pour cela d'étroites sympathies.
TADILLE.	TADILE.
Mais aimez vous auſſi ces belles Comedies.	Mais aimez -vous aussi ces belles Comédies.
ANGELIQUE Je prens à les entendre un extréme plaiſir.	ANGELIQUE Je prends à les entendre un extrême plaisir.
A DILLE.	À DILLE.
Tant mieux;	Tant mieux;
j’en ay fait une.	j'en ai fait une.
avez vous le loiſit Que dedans un moment on vous la repreſente	avez vous le loisit Que dedans un moment on vous la représente
ANGELIQUE Dittes m’en le ſujes;	ANGELIQUE Dittes m'en le sujès;
eſt elle bien plaiſante?	est elle bien plaisante?
PADILLE.	PADILE.
On va vous la joüer, les tolles ſont appris.	On va vous la jouer, les tollés sont appris.
Sept ou huit bons Acteurs depuis peu les ont pris	Sept ou huit bons Acteurs depuis peu les ont pris
ANGELIQUE.	ANGELIQUE.
Iy voudrois bien auſſi faire mon perſonnage	Ii voudrais bien aussi faire mon personnage
PADILLE, Cerfoncieneisteas ?	PADILE, Cerfoncieneisteas ?
ANGELIQUE.	ANGELIQUE.
Fait ou un mariage.	Fait ou un mariage.
PADILLE, Ie m’en ſouviens, Madame, un rolle eſt à donner.	PADILE, Je m'en souviens, Madame, un rolle est à donner.
Une fille au contrat vient ſimplement ſigner, Vous la ferez, il faut paroître, & ne rien dire.	Une fille au contrat vient simplement signer, Vous la ferez, il faut paraître, et ne rien dire.
A tout ce qu’on dira vous n’avez qu’à ſouſcrire, Vous ferez vôtre rolle aſſez facilement.	À tout ce qu'on dira vous n'avez qu'à souscrire, Vous ferez votre rolle assez facilement.
Vous n’avez, s’il vous plaiſt qu’à ſonger ſeulemẽt, Que vous ne paroiſſez qu’en la Scene derniere,	Vous n'avez, s'il vous plaît qu'à songer seulement, Que vous ne paraissez qu'en la Scène dernière,
ANGELIQUE.	ANGELIQUE.
Je vais me réjoüir de la bonne maniere Mais de tous les Acteurs qui eſt le favory	Je vais me réjouir de la bonne manière Mais de tous les Acteurs qui est le favori
PADILLE.	PADILE.
Je fais celuy qui doit être vôtre mary.	Je fais celui qui doit être votre mari.
Vous ſignez ce contract que je viens de vousdire,	Vous signez ce contrat que je viens de vousdire,
ANGELIQUE Je ſigneray fort bien;	ANGELIQUE Je signerai fort bien;
Ciel!	Ciel!
que nous allons rite	que nous allons rite
PADILLE.	PADILE.
Je vois tout à propos venir tous mes amis.	Je vois tout à propos venir tous mes amis.
SCENE III.	SCÈNE III.
ANGELIQUE, PHILINTE.	ANGELIQUE, PHILINTE.
ORONTE VALERE, DAMON.	ORONTE VALÈRE, DAMON.
PADILLE	PADILE
ANGELIQUE.	ANGELIQUE.
E vois déja l’effet que l’on m’avoit promis, I Meſſieurs, & me faiſant l’honneur que vous mi faites Il faut que vous ſoyez extrémement honnêtes C’eſt à vous ſeul que j’ay certe obligation	E vois déjà l'effet que l'on m'avait promis, I Messieurs, et me faisant l'honneur que vous mi faites Il faut que vous soyez extrêmement honnêtes C'est à vous seul que j'ai certe obligation
PADILLE.	PADILE.
Ces Meffieurs n’ont pas moins pour vous de paſſion	Ces Meffieurs n'ont pas moins pour vous de passion
ANGELIQUE.	ANGELIQUE.
Vous venez tout à temps pour nôtre Comedie.	Vous venez tout à temps pour notre Comédie.
PHILINTE, Madame il faut qu’icy, Monſieur, vous la dedie Vôtre eſprit, & vos yeux font par tout biend bruit, Mais je vois qu’il en eſt bien plus qu’on n’ent dit.	PHILINTE, Madame il faut qu'ici, Monsieur, vous la dédie Votre esprit, et vos yeux font par tout biend bruit, Mais je vois qu'il en est bien plus qu'on n'ent dit.
ANGELIQUE.	ANGELIQUE.
Monſieur, vous avez trop pour moy de complat ſance	Monsieur, vous avez trop pour moi de complat sance
PADILLE, Meſſieurs, ſi vous voulez que la piece commenc Ie Il eſt tems, s’il vous plaiſt, de s’aller traveſtirq elqu’un de ces Meſſieurs reſte à vous divertir Je n’emmene avec moy que philinte & Valere.	PADILE, Messieurs, si vous voulez que la pièce commenc Ère Il est temps, s'il vous plaît, de s'aller travestirq elle afin de ces Messieurs reste à vous divertir Je n'emmène avec moi que philinte et Valère.
ANGELIQUE.	ANGELIQUE.
Revenez donc bien-toſt.	Revenez donc bientôt.
PADILLE.	PADILE.
Nous ne tarderons guere.	Nous ne tarderons guère.
SCENE IV.	SCÈNE IV.
ANGELIQUE, ORONTE, DAMON.	ANGELIQUE, ORONTE, DAMON.
ANGELIQUE.	ANGELIQUE.
Ans la piece, Meſſieurs, quels rolles faites D vous.	Ans la pièce, Messieurs, quels rolles faites D vous.
RONTE.	RONTE.
A vos charmans appas nous ferons les yeux doux Mais vous aimerez mieux un amant ridicule.	À vos charmants appas nous ferons les yeux doux Mais vous aimerez mieux un amant ridicule.
ANGELIQUE.	ANGELIQUE.
Il faut donc la deſſus que je me diſſimule, Car je ne puis ſouffrir que de rares eſprits.	Il faut donc la dessus que je me dissimule, Car je ne puis souffrir que de rares esprits.
ORONTE.	ORONTE.
Mais vous vous trõperiez, ſi vous nous aviez pris.	Mais vous vous trôperiez, si vous nous aviez pris.
ANGELIQUE.	ANGELIQUE.
Je parle, en bonne foy du profond de mon ame.	Je parle, en bonne foi du profond de mon âme.
RONTE, Vous avez mille fois trop de bontez, Madame,	RONTE, Vous avez mille fois trop de bontés, Madame,
ANGELIQUE.	ANGELIQUE.
Iaiſſons les complimens, je n’ay que le deſir De connoitre la piece,	Jaissons les compliments, je n'ai que le désir De connaître la pièce,
ORONTE.	ORONTE.
A ce leger pla iſic.	À ce léger pla isic.
M adame, preferez celuy de la ſurpriſe.	M adame, préférez celui de la surprise.
ANGELIQUE.	ANGELIQUE.
De ſçavoir ce que c’eſt mon ame eſt toute épuiſe Mais d’une Comedie on fait peu de façon, Avant que la joüer d’en annoncer le nom, Dites le moy!	De savoir ce que c'est mon âme est toute épuise Mais d'une Comédie on fait peu de façon, Avant que la jouer d'en annoncer le nom, Dites le moi!
Monſieus,	Monsieus,
RONTE.	RONTE.
Je veux bien vous le dire.	Je veux bien vous le dire.
qvand on m’a lû la piece, enfin je l’ay pû lite Le iître eſt.	Oqvand on m'a lu la pièce, enfin je l'ai pu lite Le jittre est.
Vous ſçavez que ce tître eſt nouveau, La ſuppoſition veritable.	Vous savez que ce tître est nouveau, La supposition véritable.
ANGELIQUE.	ANGELIQUE.
Il eſt beau.	Il est beau.
On nomme ces rcrits, poëmes Dramatiques;	On nomme ces rits, poèmes Dramatiques;
Dont les uns ſont plaiſans, & les autres tragiques J’entens du bruit, nos gens vont bien-toſt reveH113 antrez tous deux icy moy je vais m’y tenir.	Dont les uns sont plaisants, et les autres tragiques J'entends du bruit, nos gens vont bientôt réveH13 antrez tous deux ici moi je vais m'y tenir.
Je parois ſeulement dans la ſcene derniere.	Je parais seulement dans la scène dernière.
RONTE à Angelique.	RONTE à Angélique.
quond on vous le dira, vous viendrez la derniere.	quond on vous le dira, vous viendrez la dernière.
Ils entrent tous deux, & Angelique prend un ſiege au coté du Theatre pour entendre la Comedie, & les Violons jouent uue ouverture.	Ils entrent tous deux, et Angélique prend un siège au coté du Théâtre pour entendre la Comédie, et les Violons jouent ouve ouverture.
PERSONNAGES.	PERSONNAGES.
DOM PEDRE de Stambole.	DOM PÉDRE de Stambole.
ANGELIQUE Maiſtreſſe de Dom Pedre.	ANGELIQUE Maîtresse de Dom Pèdre.
DOM ALVARE LOM SANCHE Rivaux de Dom Pedre.	DOM ALVARE LOM SANCHE Rivaux de Dom Pédre.
La Scene eſt dans une Ville de l’Eſpagne.	La Scène est dans une Ville de l'Espagne.
LA SUPPOSITION VERITABLE OMEDIE EN UN ACTE.	LA SUPPOSITION VÉRITABLE OMEDIE EN UN ACTE.
SCENE PREMIERE.	SCÈNE PREMIÈRE.
DOM ALVARE, DOM SANCHE.	DOM ALVARE, DOM SANCHÉ.
DOM SANCHE.	DOM SANCHÉE.
Nge ique, Mouſieur, qui vous cher ſloit tant, Vous prefere aujourd’huy ce ridicule Amant ?	Ne ique, Mousieur, qui vous cher slait tant, Vous préfère aujourd'hui ce ridicule Amant ?
Ce Iot original Dom Pedre de ftambole?	Ce Jot original Dom Pèdre de ftambole?
DOM ALVARE Ouy;	DOM ALVARE Oui;
j’ay dans mon chagrin beſoin qu’on me conſole.	j'ai dans mon chagrin besoin qu'on me console.
DOM SANCHE.	DOM SANCHÉE.
Vous fûtes monrival, je fus le vôtre auſſi, Conſolons-nous tous deux, ſoyons amis ainſi	Vous fûtes monrival, je fus le vôtre aussi, Consolons-nous tous deux, soyons amis ainsi
DOM ALVARE.	DOM ALVARE.
Je le veux;	Je le veux;
toutefois mon cœur ſe deſeſpere.	toutefois mon cœur se désespère.
DOM SANCHE.	DOM SANCHÉE.
Mais puiſque ſa folie à ce fou vous préfere, Le bon ſens dans ce choix n’eſt pas fort reche ché Et vous ne devez pas en être trop fâché.	Mais puisque sa folie à ce fou vous préfère, Le bon sens dans ce choix n'est pas fort rêche ché Et vous ne devez pas en être trop fâché.
DOM ALVARE, Je ne puis aisément delaiſſer ce que j’aime.	DOM ALUARE, Je ne puis aisément délaisser ce que j'aime.
DOM SANCHE.	DOM SANCHÉE.
Avec moins de raiſon on vous quitte vous mé me.	Avec moins de raison on vous quitte vous mé me.
DOM ALVARE.	DOM ALVARE.
Comme elle, je ne puis la quitter tout d’un couf Que cela ne m’étonne & m’afflige beaucoup.	Comme elle, je ne puis la quitter tout d'un cous Que cela ne m'étonne et m'afflige beaucoup.
DOM SANCHE, Il faut vaincre ce foible, & s’en rendre le maiſtre	DOM SANCHÉ, Il faut vaincre ce faible, et s'en rendre le maître
DOM ALVARE.	DOM ALVARE.
nans le trouble ou je ſuisje ne me puis connois tre, Le ſouvenir charmant de ſes divins appas Fait qu’en un même temps je veux, & ne veu pas, Malgré moy, dans mon cœur je ſens regnert tendre, que je voudrois chaſſer, & ne puis m’en défen dre;	nans le trouble ou je suisje ne me puis connais tre, Le souvenir charmant de ses divins appas Fait qu'en un même temps je veux, et ne veu pas, Malgré moi, dans mon cœur je sens régnert tendre, que je voudrais chasser, et ne puis m'en défens dre;
Et je mourray, Monſieur, ſi ſa charmante main pour ce fol que vous dites a changé ſon de ſen.	Et je mourrai, Monsieur, si sa charmante main pour ce fol que vous dites a changé son de sen.
DOM SANCHE.	DOM SANCHÉE.
Ce que je vous ay dit, Monſieur;	Ce que je vous ai dit, Monsieur;
eſt veritable;	est véritable;
ẽt me rend auſſi bien que vous fort miſerable.	ẽt me rend aussi bien que vous fort miserable.
lais, ſans nous chagriner tous deux que n’aldo112 H0u3 arler un peu de prés à ce maiſtre des fous?	lais, sans nous chagriner tous deux que n'aldo12 H0u3 arler un peu de près à ce maître des fous?
e luy ferois lentir ma valeur offenſée.	 eût ferais lentir ma valeur offensée.
DOM ALVARE.	DOM ALVARE.
ne faut pas, Monſieur, avoir cette penſée.	ne faut pas, Monsieur, avoir cette pensée.
faut qu’un Gentilhomme obeiſſe à ſon Roy, it ſi vous m’encroyez, vous ferez comme moy, uis qu’enfin pour nous deux Angelique eſt contraite, le la contraignons point, Monſieur, laiſſons la one.	faut qu'un Gentilhomme obéisse à son Roi, it si vous m'encroyez, vous ferez comme moi, uis qu'enfin pour nous deux Angélique est contraite, le la contraignons point, Monsieur, laissons la one.
ce choix ridicule on ne peut s’oppoſer.	ce choix ridicule on ne peut s'opposer.
DOM SANCHE.	DOM SANCHÉE.
lais ce fol doit venir aujourd’huy l’épouſer.	lais ce fol doit venir aujourd'hui l'épouser.
SCENE II.	SCÈNE II.
OM PEDRE, DOM DIEGUE, DOM ALVARE, DOM SANCHE.	OM PEDRE, DOM DIEGUE, DOM ALVARE, DOM SANCHÉE.
DOM PEDRE.	DOM PÉDRE.
E quelfo!	E quelfo!
veut parler ce couple de pecores?	veut parler ce couple de pécores?
IJe vous l’ay dit, beau-pere, & vous le dis encores à Dom Alvare.	JJe vous l'ai dit, beau-père, et vous le dis encor à Dom Alvare.
Dom Sanche qui i’arrétent à le regarder.	Dom Sanche qui j'arrêtent à le regarder.
M’avez vous aſſez vû?	M'avez -vous assez vu?
ſuis je bien fait?	suis -je bien fait?
badauts Hé morbleu décampez, peſte ſoit des nigauts Avez-vous jamais vû deux plus ſottes figures.	badauts Hé morbleu décampés, peste soit des nigauts Avez-vous jamais vu deux plus sottes figures.
DOM ALVARE.	DOM ALVARE.
Nous ſortirons aſſez, ſans toutes vos injures.	Nous sortirons assez, sans toutes vos injures.
DOM PEDRE.	DOM PÉDRE.
Mais vous ne branlez point !	Mais vous ne branlez point !
les avez vous mans dez, Beau-pere?	les avez vous mans dé, Beau-père?
dites donc.	dites donc.
Il eſt ſourd répondez.	Il est sourd répondez.
DOM DIEGUE.	DOM DIÉGUE.
Mey dlaue,	Mei dlave,
DOM PEDRE.	DOM PÉDRE.
Moy?	Moi?
non qui donc?	non qui donc?
ce ſtupide beaupeit eſt comme une ſtarue à les cegarder faire.	ce stupide beaupit est comme une starue à les cégarder faire.
DOM DIEGUE.	DOM DIÉGUE.
Croyez-vous voir ma fille, ètant ſi mal appris!	Croyez-vous voir ma fille, ètant si mal appris!
DOM PEDRE.	DOM PÉDRE.
Vous êtes par ma foy le plus ſot des eſprits Faites les donc ſortir.	Vous êtes par ma foi le plus sot des esprits Faites les donc sortir.
DOM DIEGUE, Voulez-vous que je faſſe.	DOM DIEGUE, Voulez-vous que je fasse.
DOM PEDRE.	DOM PÉDRE.
Hé, radoteur vieillard' faites leur la grimace.	Hé, radoteur vieillard' faites leur la grimace.
DOM ALVARE.	DOM ALVARE.
Sur le pavé du Roy pouvez vous nous gêner?	Sur le pavé du Roi pouvez vous nous gêner?
DOM PEDRE mettant la main à l'éptt Vous voulez donc, marauts, me faire dégainer?	DOM PEDRE mettant la main à l'éptt Vous voulez donc, marauts, me faire dégainer?
Il donne pluſieurs coups de plat d’épíe Dom Diegue,	Il donne plusieurs coups de plat d'épée Dom Diègue,
DOM ALVARE t'en allant.	DOM ALVARE t'en allant.
Vous m’avez maltraité, de vôtre violence Je m’en vais informer les Maréchaux France.	Vous m'avez maltraité, de votre violence Je m'en vais informer les Maréchaux France.
SCENE III.	SCÈNE III.
DOM PEDRE, DOM DIEGUE.	DOM PEDRE, DOM DIEGUE.
DOM DIEGUE.	DOM DIÉGUE.
NIel!	NIel!
comme vous frapez!	comme vous frappez!
je ſuis preſque A	je suis presque A
DOM PEDRE.	DOM PÉDRE.
Ces deux petits cadets ſentoient le vieux battu.	Ces deux petits cadets sentaient le vieux battu.
Mlais ſans tant reculer montrez moy vôtre fille;	Mlais sans tant reculer montrez -moi votre fille;
afin que pour la nopce au piûtoſt je m’habille.	afin que pour la nopce au piûtost je m'habille.
je brerens toureron von Gevant ſon muſeau, Sil eſt laid, je la laiſſe, & la prens s’il eſt beau, Au diable, s’il répond Quelle peſte de mine.	je brers toureron von Gevant son museau, Sil est laid, je la laisse, et la prends s'il est beau, Au diable, s'il répond Quelle peste de mine.
fait ce vieux fou !	fait ce vieux fou !
je croy que toûjouis il rechine, Il eſt muet & ſourd, ou je parle trop bas Beau-pere extravagant ne m’entendez vous pas y perdray mon latin, vieillard, que Dieu confonde, Répõs, on fais pour toy que quelqu’un me répõde, Veux tu bailler ta fille, ou ne la pas bailler!	je crois que toûjouis il rechine, Il est muet et sourd, ou je parle trop bas Beau-père extravagant ne m'entendez vous pas y perdrai mon latin, vieillard, que Dieu confonde, Réponde, on fais pour toi que quelqu'un me répõde, Veux -tu bailler ta fille, ou ne la pas bailler!
DOM DIEGUE.	DOM DIÉGUE.
Pour la prendre, Monſieur, vous n’avez qu’à parler.	Pour la prendre, Monsieur, vous n'avez qu'à parler.
DOM PEDRE Allez, ſi ma moitié vous reſſemble, beau-pere, Et que tout comme vous elle ne parle guere, Les cornes ſur ma tête auront peine à ſortir, Qu'elle vienne donc vite ou je m’en vais partir,	DOM PEDRE Allez, si ma moitié vous ressemble, beau-père, Et que tout comme vous elle ne parle guère, Les cornes sur ma tête auront peine à sortir, Qu'elle vienne donc vite ou je m'en vais partir,
PHILINTE a Aagelique dant une aîle du Theaire dit ce ven & ſe retire.	PHILINTE a Aagelique dant une aîle du Théaire dit ce ven et se retire.
Venez vite, Madame, il eſt tems de paroître.	Venez vite, Madame, il est temps de paraître.
Angelique i’avance ſur la Seene.	Angélique j'avance sur la Seène.
SCENE IV.	SCÈNE IV.
ANGELIQUE, DOM PEDRE.	ANGELIQUE, DOM PEDRE.
DOM DIEGUE.	DOM DIÉGUE.
DOM DIEGUEa Angilique, A fille, pour époux vous pouvez recon noître, Monſieur, le voulez voue?	DOM DIEGUEa Angilique, A fille, pour époux vous pouvez répon naître, Monsieur, le voulez voue?
DOM PEDRE.	DOM PÉDRE.
Elle ne tépoud rien,	Elle ne tépoud rien,
DOM DIEGUE Je croy pourtant, Moi ſieur, qu’elle vous voudr ibien.	DOM DIEGUE Je crois pourtant, Moi sieur, qu'elle vous voudr ibien.
Acceptez vous Monſieur?	Acceptez -vous Monsieur?
ANGELIQUE à qui on ſouſſe de derriere le Theatre.	ANGELIQUE à qui on sousse de derrière le Théâtre.
Je le veux bien mon pert	Je le veux bien mon pert
DOM PEDRE.	DOM PÉDRE.
Pour de l’eſprit, je voy que vous n’en avez guer La belle;	Pour de l'esprit, je vois que vous n'en avez guer La belle;
mais enfin j’en ſuis peu ſoucieux, Et je croy que mon front s’en portera bie mieux.	mais enfin j'en suis peu soucieux, Et je crois que mon front s'en portera bye mieux.
Mais ne parlez jamais quoy qu’un homme v  die.	Mais ne parlez jamais quoi qu'un homme v die.
Quels ſont donc vos plaiſits?	Quels sont donc vos plaisits?
le bal?	le bal?
la Comedie?	la Comédie?
Aimez vous bien les Vers?	Aimez -vous bien les Vers?
ou ces Ecrits galans?	ou ces Écrits galants?
A quoy ſongez vous dõc?	À quoi songez -vous donner?
faites vous des Romãs?	faites -vous des Romans?
ji vous ne répondez, je ne parle plus guere Mais quand donc proceder à nôtre hymen, beaupere?	ji vous ne répondez, je ne parle plus guère Mais quand donc procéder à notre hymen, beaupère?
DOM DIEGUE.	DOM DIÉGUE.
Le Notaire venu, vous n’avez qu’à finir.	Le Notaire venu, vous n'avez qu'à finir.
DOM PEDRE.	DOM PÉDRE.
Qui vous empêche donc de le faire venir.	Qui vous empêche donc de le faire venir.
DOM DIEGUE Je ne ſçay pas pourquoy ſi long-tems il demeure?	DOM DIEGUE Je ne sais pas pourquoi si longtemps il demeure?
Mais le voicy, M ſieur, qui vient à la bõne heure	Mais le voici, M eur, qui vient à la bõne heure
SCENE DERNIERE.	SCÈNE DERNIÈRE.
DOM PEDRE, DOM DIEGUE, ANGELIQUE, LE NOTAIRE.	DOM PEDRE, DOM DIEGUE, ANGELIQUE, LE NOTAIRE.
LE NOTAIRE tenant un Contrat dans Iſes mains.	LE NOTAIRE tenant un Contrat dans Ises mains.
E viens tard, mais auſſi le Contrat eſt écrit.	E viens tard, mais aussi le Contrat est écrit.
DOM PEDRE bai au Notaire.	DOM PEDRE bai au Notaire.
Avez vous mis les nome comme je vous ay dit,	Avez -vous mis les nome comme je vous ai dit,
LE NOTAIRE.	LE NOTAIRE.
Le Contrat eſt en forme, & de bonne mauiere.	Le Contrat est en forme, et de bonne mavière.
DOM PEDRE à Angelique La belle il faur pour moy, quittervôtre humeur fiere, .	DOM PEDRE à Angélique La belle il saur pour moi, quittervôtre humeur fière, .
Car le Contrat ſigné, dans une heure d’icy Je diſpoſe de vous comme vôtre mary.	Car le Contrat signé, dans une heure d'ici Je dispose de vous comme votre mari.
Nous allons par les Loix du Ciel, & de Nature.	Nous allons par les Lois du Ciel, et de Nature.
Proceder, comme il faut, à la progeniture.	Procéder, comme il faut, à la progéniture.
Et comme au mariage il faut bien des appreſts, Voyons, ſi pour cela tous nos meubles ſont preſts Pour le ménage il faut quantité d’uſtenciles.	Et comme au mariage il faut bien des apprêts, Voyons, si pour cela tous nos meubles sont prêts Pour le ménage il faut quantité d'ustenciles.
DOM DIEGUE.	DOM DIÉGUE.
Monſieur, j’en ay fait faire à des Maîtres habiles,	Monsieur, j'en ai fait faire à des Maîtres habiles,
DOM PEDREa Dom Dugue.	DOM PEDREa Dom Dugue.
Que faut-il faire plus?	Que faut-il faire plus?
donnez donc vôtre ſeing,	donnez donc votre seing,
LE NOTAIREà Uom Pedre.	LE NOTAIREà Uom Pedre.
Vous devez cõmencer comme Auteur du deſſein,	Vous devez commencer comme Auteur du dessein,
DOM PEDRE.	DOM PÉDRE.
Signõs dõc, je le veux.	Signons dont, je le veux.
C’eſt ainſi qu’on s’explique	C'est ainsi qu'on s'explique
LE NOTAIRE à Angelique.	LE NOTAIRE à Angélique.
Madanse, vôtre nom.	Madanse, votre nom.
ANGELIQUE à qui on ſoufle totijours:	ANGELIQUE à qui on souffle totijours:
Je me nomme Angelique.	Je me nomme Angélique.
Signez.	Signez.
LE NOTAIRE.	LE NOTAIRE.
ANGELIQUE à qui on ſouſle toûjours.	ANGELIQUE à qui on soûle toujours.
, Je le veux bien elle ſigne.	, Je le veux bien elle signe.
DOM PEDREàPU.	DOM PEDREàPU.
Je vous tiens, par ma foy.	Je vous tiens, par ma foi.
Me voila maintenant plus content que le Roy.	Me voilà maintenant plus content que le Roi.
Allons donc conſommer vite le mariage.	Allons donc consommer vite le mariage.
LE NOTAIRE.	LE NOTAIRE.
Icvje n’ay plus rien à faire davantage.	Icvje n'ai plus rien à faire davantage.
Jeſors.	Jésors.
1 Il ſort aves lerautret.	1 Il sort aves lerautret.
DOM PEDRE.	DOM PÉDRE.
Adieu Meſſieurs.	Adieu Messieurs.
DOM ALVARE.	DOM ALVARE.
Adieu:	Adieu:
ſoyez contens Ein de la petite Comedie.	soyez contents Ein de la petite Comédie.
SCENE V.	SCÈNE V.
ANGELIQUE, (PADILLE qui joüoit le volle de Dom Pedre.	ANGELIQUE, (PADILE qui jouait le volle de Dom Pèdre.
ANGELIQUE.	ANGELIQUE.
Ourquoy nous quittent-ils?	Ourquoy nous quittent-ils?
Se mocquent.	Se moquent.
I ils des gens?	I ils des gens?
Ne me direz-vous point quel eſt tout ce myſtere?	Ne me direz-vous point quel est tout ce mystère?
PADILLE luy montrant le Contract quelle viens de ſigner.	PADILE belle montrant le Contrat quelle viens de signer.
Ouy:	Oui:
Madame;	Madame;
il eſt temps de ne vous plus rien tane , Il n’eſt plus de dedit, le Contract eſt ſigné.	il est temps de ne vous plus rien tane , Il n'est plus dé dit, le Contrat est signé.
ANGELIQUE.	ANGELIQUE.
quoy le même Contract que vous m’avez donné	quoi le même Contrat que vous m'avez donné
ADILLE.	ADILE.
Ouy, vous acheverez avec moy, ſur mon ame, La ſuppoſition veritable, Madame.	Oui, vous achèverez avec moi, sur mon âme, La supposition véritable, Madame.
ANGELIQUE.	ANGELIQUE.
De tout ce qu’il me dit déja le cœur me bat.	De tout ce qu'il me dit déjà le cœur me bat.
A DILLE.	À DILLE.
Vous avez crû jouer en ſignant ce Contract;	Vous avez cru jouer en signant ce Contrat;
Mais ſçachez qu’il eſt fait de la bonne maniere;	Mais sachez qu'il est fait de la bonne manière;
Et que ſous nos deux noms la clauſe eſt toute entiere, Il eſt en bonne forme, & prétens aujourd’huy En qualité d’époux terminer mon ennuy.	Et que sous nos deux noms la clause est toute entière, Il est en bonne forme, et prétends aujourd'hui En qualité d'époux terminer mon ennui.
Vous avez refusé, dans le Siecle où nous ſommes, Des Nobles, des Sçavans, & toutes ſortes d’hommes, Moy, plus ſubtil que ceux qui vous venoien chercher, ’ay ſçû qu’un bel eſprit pouvoit ſeul vous touche Dont la gentille humeur fut ſemblable a Mer cure:	Vous avez refusé, dans le Siècle où nous sommes, Des Nobles, des Savants, et toutes sortes d'hommes, Moi, plus subtil que ceux qui vous venoyen chercher, 'ai su qu'un bel esprit pouvait seul vous touche Dont la gentille humeur fut semblable a Mer cure:
I'ay du mieux que j’ay pû contrefait ſa figure:	J'ai du mieux que j'ai pu contrefait sa figure:
Et dedans cette piece attitrant des amis, J’ay dreſſé le beau piege, où je vous ay, bier mis.	Et dedans cette pièce attitrant des amis, J'ai dressé le beau piège, où je vous ai, bier mis.
ANGELIQUE.	ANGELIQUE.
Je feray tout caſſer par les loix de Juſtice, Diſant que le Contract eſt fait par artifice.	Je ferai tout casser par les lois de Justice, Disant que le Contrat est fait par artifice.
PADILLE.	PADILE.
Je vais chez un Sergeant pour vous faire aſsignet Sur le Conttact qu’icy vous venez de ſigner.	Je vais chez un Sergeant pour vous faire assignet Sur le Contact qu'ici vous venez de signer.
On n’entend point de jeu ſur de telle matiere, Et quand vous y ſerez ce n’eſt pas la premiere,	On n'entend point de jeu sur de telle matière, Et quand vous y serez ce n'est pas la première,
ANGELIQUE.	ANGELIQUE.
Je periray plûtoſt que tu ſois mon époux.	Je périrai plutôt que tu sois mon époux.
A DILLE, I’eſpere toutefois cét honneur malgré vous.	À DILE, J'espère toutefois cet honneur malgré vous.
ANGETIQUE.	ANGETIQUE.
Un fourbe !	Un fourbe !
PADILLE.	PADILE.
Vous feriez vĩngt fois mieux de vous tairé Le Juge ordonnera de toute notre affaire.	Vous feriez vintngt fois mieux de vous tairé Le Juge ordonnera de toute notre affaire.
ANGELIQU E bas.	ANGELIQU E bas.
Juſte Ciel!	Juste Ciel!
que je ſuis mal’heureuſe en Amans!	que je suis mal'heureuse en Amants!
Embroüillant mon eſprit avec tous ces ſçavans;	Embrouillant mon esprit avec tous ces Savants;
Mais que faite aprés tout, ſi je ſuis condamnée!	Mais que faite après tout, si je suis condamnée!
Si je pers mon proceds qu’elle eſt ma deſtinée.	Si je perds mon procéds qu'elle est ma destinée.
Il faut aller bientôt me rendre à la maiſon.	Il faut aller bientôt me rendre à la maison.
Afin d’y recevoir cetteaſ ſsignation.	Afin d'y recevoir cetteas signation.
elle ſon	elle son
PADILLE.	PADILE.
Allons, devant qu’enfin la cauſe aille paroître, De tout ce qu’il faut faire avertir notre maître.	Allons, devant qu'enfin la cause aille paraître, De tout ce qu'il faut faire avertir notre maître.
Fin du ſecond Acte.	Fin du second Acte.
AC TE III SCENE PREMIERE.	AC TE III SCÈNE PREMIÈRE.
Le Theaire repreſenie un Parquet.	Le Théaire représénie un Parquet.
POLIDORE, LYSANDRE,	POLIDORE, LYSANDRE,
POLI DORE.	POLI DORE.
Uoy?	Uoi?
ton valet tout ſeul auroit joüé ce tour,	ton valet tout seul aurait joué ce tour,
LYSANDRE.	LYSANDRE.
Il a fait tout cela pour ſervir mon amour.	Il a fait tout cela pour servir mon amour.
POLIDORE.	POLIDORE.
Tu railles un peu bien fort cette belle maîtreſſe.	Tu railles un peu bien fort cette belle maîtresse.
LYSANDRE.	LYSANDRE.
Je ne puis autrement m’acquerir ſa tendreſte,	Je ne puis autrement m'acquérir sa tendreste,
POLIDORE.	POLIDORE.
Fort bien;	Fort bien;
mais puis-je enfin ſoulager ton ſoucy	mais puis-je enfin soulager ton souci
LYSANDRE.	LYSANDRE.
On t’a fait depuis peu juge de ce lieu-cy, Et comme devant toy nôtre affaire eſt remiſe, Je ſouhaiterois fort pour la rendre ſurpriſe Qu’avec tes Conſeillers, prenant ta place, moi Je decide l’affaire, & juge au lieu de toy.	On t'a fait depuis peu juge de ce lieu-cy, Et comme devant toi notre affaire est remise, Je souhaiterais fort pour la rendre surprise Qu'avec tes Conseillers, prenant ta place, moi Je décide l'affaire, et juge au lieu de toi.
La robbe & le bonnet, & l’air que je vais prendre A ſes yeux aisément déguiſeront Lyſandre.	La robe et le bonnet, et l'air que je vais prendre A ses yeux aisément déguiseront Lysandre.
Ainſi je la gueris de ſes entétemens.	Ainsi je la guéris de ses entêtements.
Et parviens au bon-heur des plus heureux amans	Et parviens au bonheur des plus heureux amants
OLIDORE.	OLIDORE.
Je crains de mez-uſer des droits de la juſtice, Et qu’on ne me démette aprése de mon Office.	Je crains de mez-user des droits de la justice, Et qu'on ne me démette après de mon Office.
SANDRE.	SANDRE.
Au contraire un chacun trouveroit à propos De mettre là deſſus ſon eſprit en repos,	Au contraire un chacun trouverait à propos De mettre là -dessus son esprit en repos,
LIDORE.	LIDORE.
Je n’examine rien.	Je n'examine rien.
& quoy qu’il en puiſſe être.	et quoi qu'il en puisse être.
Iais ce que tu voudras, je t’en laiſſe le maître, Je ne puis refuſer un amy tel que toy.	Iais ce que tu voudras, je t'en laisse le maître, Je ne puis refuser un ami tel que toi.
YSANDRE.	YSANDRE.
Amy, je te rendray la pareille, croy moy.	Ami, je te rendrai la pareille, crois -moi.
LIDORE Allons donc avertit nos gens en diligen ce;	LIDORE Allons donc avertit nos gens en diligen ce;
Car il faut avec nous avoir mon aſſiſlance, Tu ue ſçaurois juger ſans cela;	Car il faut avec nous avoir mon assislance, Tu ue sçaurois juger sans cela;
les voicy Je voy mes Conſeillers, & mon Greffier auſſi.	les voici Je vois mes Conseillers, et mon Greffier aussi.
CENE II POIIDORE LYSANDRE I CONGEILIER II.	CÈNE II POIIDORE LYSANDRE I CONGEILIÈR II.
CONSEILLER, LE GREFFIER.	CONSEILLER, LE GREFFIER.
POLIDORE aux Conſuilleri Eſſieurs, je vous ſupplie icy, qu’en mor M abſence.	POLIDORE aux Consuilleri Essieurs, je vous supplie ici, qu'en mór M absence.
Vous acceptiez, Mõſieur, pour juge en l’audience, Laiſſez-le, s’il vous plaiſt, pour un ſujet preſſant Preſider au barreau comme mon Lieuteuant.	Vous acceptiez, Monsieur, pour juge en l'audience, Laissez-le, s'il vous plaît, pour un sujet pressant Présider au barreau comme mon Lieuteuant.
Vous me ferez, Meſſieurs, une faveur entiere.	Vous me ferez, Messieurs, une faveur entière.
I.	I.
CONSETLLER.	CONSETLLER.
Commandez nous, Monſieur, ſans uſer de priere.	Commandez nous, Monsieur, sans user de prière.
POLIDORE.	POLIDORE.
Il eſt fort entendu, bien expert ſur la Loy.	Il est fort entendu, bien expert sur la Loi.
I.	I.
CONSEILLER.	CONSEILLER.
Sans nous en dire rien, à ſon ait je le voy.	Sans nous en dire rien, à son ait je le vois.
POLIDORE à Lyſandre.	POLIDORE à Lysandre.
Venez vîte changer vôtre robbe à la mienne.	Venez vite changer votre robe à la mienne.
Meſſieurs, prenezſceance attendant qu’il reviene.	Messieurs, prenezséance attendant qu'il reviene.
LYSANDRE ſortant avec Pelidore.	LYSANDRE sortant avec Pélidore.
Je m’en vais revenir, Meſſieurs, dans un moment.	Je m'en vais revenir, Messieurs, dans un moment.
Let Conſeilleri ſe rangent aux deux cotez de la chaiſe du Preſi lent, & ie Greffier au deſſousd’eux.	Let Conseilleri se rangent aux deux côtés de la chaise du Prési lent, et été Greffier au dessousd'eux.
SCENE III, ANGELIQUE, PADILLE.	SCÈNE III, ANGELIQUE, PADILLE.
I CONSEILLER, II.	I CONSEILLER, II.
CONSEILLER, LE GREVFIER.	CONSEILLER, LE GREUFIER.
ANGELIQU Eau Greffier.	ANGELIQU Eau Greffier.
Uattend on pour plaider?	Oùattend on pour plaider?
e LE GREFFIER.	 JE GREFFIER.
Monſieur le Preſident,	Monsieur le Président,
ANGELIQUE bat.	ANGELIQUE bat.
Quel procez ay-je la?	Quel procès ai-je la?
que je ſuis malheureuſei	que je suis malheureusei
PADILLE à Angelique.	PADILE à Angélique.
Vous voila donc icy.	Vous voilà donc ici.
Madame la plaideuſe?	Madame la plaideuse?
ANGELIQUE.	ANGELIQUE.
Fourbe, j’y viens pour toy.	Fourbe, j'y viens pour toi.
PADILLEà Angelique, Voila vôtre Contrat	PADILLEà Angélique, Voilà votre Contrat
ANGELIQUE.	ANGELIQUE.
Je le recuſeray.	Je le récuserai.
PADILLE.	PADILE.
peſte, à bonchat, bon ne	peste, à bonchat, bon ne
LE GREFFIER.	LE GREFFIER.
Qu’on le taſſe là, pais;	Qu'on le tasse là, pais;
Le Preſident entre,	Le Président entre,
SCENE DERNIERE.	SCÈNE DERNIÈRE.
LYSANDRE avec la robbe de Preſilent L.	LYSANDRE avec la robe de Pressilent L.
CONSEILLER, II.	CONSEILLER, II.
CONSEILLER, LE GREFFIER, ANGELIQUE,	CONSEILLER, LE GREFFIER, ANGELIQUE,
PADILLE.	PADILE.
LYSANDRE aſſis dans la chaiſe de Preſident,	LYSANDRE assis dans la chaise de President,
A Ppellez quelque cauſe.	À Ppelez quelque cause.
LE GREFFIER appelle à h uie voix Ange ique, l'adille.	LE GREFFIER appelle à h uie voix Ange ique, l'adille.
PADILLE l'avance & plaide, Icy c’eſt une choſe, Dont vous allez, Meſſieurs!	PADILE l'avance et plaide, Ici c'est une chose, Dont vous allez, Messieurs!
, être en étonnement.	, être en étonnement.
Ma Partie a voulu que je ſois ſon Amant.	Ma Partie a voulu que je sois son Amant.
Pour legitime Epoux elle accepte à me prendre, Preſence de témoins, ce qui va vous ſurprendre,	Pour légitime Époux elle accepte à me prendre, Pré de témoins, ce qui va vous surprendre,
ANGELIQUE voulant l’inMeſſieurs, c’eſt.	ANGELIQUE voulant l'inMessieurs, c'est.
ienompre.	ienompre.
LYSANDRE.	LYSANDRE.
Attendez.	Attendez.
PADILLE.	PADILE.
La choſe en cét état, D?	La chose en cet état, D?
nôtre mariage elle ſigne un contrat;	notre mariage elle signe un contrat;
Qui dit que pour époux, Angelique icy fille, Ses pere & mere morts veut bien prendre Padille.	Qui dit que pour époux, Angélique ici fille, Ses père et mère morts veut bien prendre Padille.
Le Notaire & Témoins ont ſur ce ſigné tous.	Le Notaire et Témoins ont sur ce signé tous.
Et c’eſt la cauſe enfin qu’on plaide devant vous, Meſſieurs, rien ſçauroit il retarder davantage La conſommation de nôt te mariage?	Et c'est la cause enfin qu'on plaide devant vous, Messieurs, rien saurait il retarder davantage La consommation de notre te mariage?
ANGELIQUE.	ANGELIQUE.
Ouy mais, Meſſieurs, j’apprens que ce n’eſt qu’un Valet.	Oui mais, Messieurs, j'apprends que ce n'est qu'un Valet.
PADILLE.	PADILE.
Vous l’avez bien voulu, pourquoy l’avez vout fait,	Vous l'avez bien voulu, pourquoi l'avez vout fait,
ANGELIQUE.	ANGELIQUE.
Il eſt vray, j’ay ſigné dans une Comedies, Non effectivement pour prendre ma partie.	Il est vrai, j'ai signé dans une Comédies, Non effectivement pour prendre ma partie.
Sous un nom de Roman j’ay ſigné le Conttat, C’eſt ce qui me le fait recuſer tout à plat	Sous un nom de Roman j'ai signé le Conttat, C'est ce qui me le fait récuser tout à plat
PADTLLE.	PADTLE.
Voyez la verité de ce qu’elle a pû dire, Et dans nôtre Contrat ce qu’elle a fait écrite:	Voyez la vérité de ce qu'elle a pu dire, Et dans notre Contrat ce qu'elle a fait écrite:
LE GREFFIER lis la clauſe du Contrat, Angelique, ſuivant la Coûtume & la Loy, Prend pour Epoux Padille, & luy donne ſa	LE GREFFIER lis la clause du Contrat, Angélique, suivant la Coutume et la Loi, Prend pour Époux Padille, et lui donne sa
à Angelique.	à Angélique.
Le Contrat eſt en forme étant fait de la ſorte Vous ſerezcondamnée	Le Contrat est en forme étant fait de la sorte Vous serezcondamnée
ANGELIQUE toute eperduë.	ANGELIQUE toute éperdue.
Ah, mon Dieu, je ſuis morte De grace, moderez, Meſſieurs, mon jug ment.	Ah, mon Dieu, je suis morte De grâce, modérez, Messieurs, mon jug ment.
Mais helas!	Mais hélas!
c’en eſt fait, je n’ay plus qu’un mo ment, Les Conſeilleriſe levent, & deliberent	c'en est fait, je n'ai plus qu'un mo ment, Les Conseillerise levent, et délibèrent
avec le Preſident.	avec le Président.
Malheureuſe!	Malheureuse!
pourquoy ne vouloir pas merendre A mon premier Amant, à mon tres-cher Ly ſandre?	pourquoi ne vouloir pas mendre À mon premier Amant, à mon très-cher Ly sandre?
D’un bizarre deſtin je me vois le jouët, Et je vais être enfin la femme d’un valet.	D'un bizarre destin je me vois le jouet, Et je vais être enfin la femme d'un valet.
LYSANDRE aſſis avec ſes Conſeillers prononce.	LYSANDRE assis avec ses Conseillers prononce.
Sur la cauſe aujourd’huy devant nous énoncée La Cour veut qu’Angelique icy ſoit condamnée A prendre, ſans appel, Padille pour epoux.	Sur la cause aujourd'hui devant nous énoncée La Cour veut qu'Angélique ici soit condamnée A prendre, sans appel, Padille pour époux.
Et de vivre avec luy dans un accord bien doux.	Et de vivre avec peine dans un accord bien doux.
Greffier, je vous permets d’en delivrer l’inſtance.	Greffier, je vous permets d'en délivrer l'instance.
le Greffiez éerit.	le Greffiez éerit.
ANGELIQUE.	ANGELIQUE.
Juſte Ciel!	Juste Ciel!
moderez, s’il vous plaiſt, la Sentence.	modérez, s'il vous plaît, la Sentence.
Prendray-je pour mary par vôtre autorité Un Valet, moy, qui ſuis fille de qualité?	Prendrai-je pour mari par votre autorité Un Valet, moi, qui suis fille de qualité?
Si tu ſçavois Lyſandre, où mon ame eſt reduite?	Si tu savais Lysandre, où mon âme est réduite?
Amant Amant infortuné, tu t’y rendrois bien vîte.	Amant Amant infortuné, tu t'y rendrais bien vite.
Mais il en eſt trop loin, ô deſirs inſenſez.	Mais il en est trop loin, ô désirs insensés.
LYSANDRE décendant de ſa chaire, & ſe faiſant connoître.	LYSANDRE décendant de sa chaire, et se faisant connaître.
Non, Madame, il n’eſt pas ſi loin que vous penſez, Moderez vos frayeurs, il eſt tems de vous dire Qu’enfin c’eſt moy qui ſuis Lyſandre.	Non, Madame, il n'est pas si loin que vous pensez, Modérez vos frayeurs, il est temps de vous dire Qu'enfin c'est moi qui suis Lysandre.
ANGELIQUE.	ANGELIQUE.
Je reſpire.	Je respire.
LYSANDRE.	LYSANDRE.
Pardonnez, ſi voyant mon amout prévenu.	Pardonnez, si voyant mon amout prévenu.
Aces extrémitez, Madame, on eſt venu.	Aces extrémités, Madame, on est venu.
Tout mon deſſein n’étoit que de vous faire rendre it le Ciel aux Amans laiſſe tout entreprendre.	Tout mon dessein n'était que de vous faire rendre it le Ciel aux Amants laisse tout entreprendre.
Ioin de vous commander, je demande à genoux Vôtre conſentement pour être vôtre époux.	Join de vous commander, je demande à genoux Votre consentement pour être votre époux.
Oublions tout, Madame, & qu’un doux mariage Nous aſſemble tous deux, ſans tarder davantage.	Oublions tout, Madame, et qu'un doux mariage Nous assemble tous deux, sans tarder davantage.
ANGELIQUE.	ANGELIQUE.
Je ne ſçais où j’en ſuis, tant mes plaiſirs ſon grands, C’eſt vous qui m’avez fait venir tous ces ſçavans.	Je ne sais où j'en suis, tant mes plaisirs son grands, C'est vous qui m'avez fait venir tous ces sçavans.
LYSANDRE.	LYSANDRE.
De tous ces incidens fouffrez que l’on vous die Que nous en pourrions bien faire une Comedie.	De tous ces incidents souffrez que l'on vous die Que nous en pourrions bien faire une Comédie.
Meſſieurs, venez auſſi, faites nous cét honneur.	Messieurs, venez aussi, faites nous cet honneur.
I.	I.
CONSEILLER.	CONSEILLER.
Vous nous faites vrayment trop de grace, Monſieur, *	Vous nous faites vraiment trop de grâce, Monsieur, *
ADILLE à Iyſandre.	ADILE à Iysandre.
Je jouë un plaiſant rolle aujourd’huy ſur mon ame.	Je joue un plaisant rolle aujourd'hui sur mon âme.
Donc, Padille, Monſieur, eſt le macy ſans femme ?	Donc, Padille, Monsieur, est le macy sans femme ?
De me démarier avez vous le pouvoir,	De me démarier avez vous le pouvoir,
YSANDRE.	YSANDRE.
La bouteille de vin conſole ton eſpoir.	La bouteille de vin console ton espoir.
ADILLE.	ADILE.
Mais j’ay plaidé pour vous quel ſera mon ſalaire,	Mais j'ai plaidé pour vous quel sera mon salaire,
LYSANDRE.	LYSANDRE.
Padille, pour cela, ſera mon Secretaire.	Padille, pour cela, sera mon Secrétaire.
ADILLE Le Secretariat me vient bien, ſur ma foy;	ADILE Le Secrétariat me vient bien, sur ma foi;
Et l’on ne vit jamais rien plus ſecret que moy.	Et l'on ne vit jamais rien plus secret que moi.
YSANDRE.	YSANDRE.
Changeons nôtre chagrin dans une joye extrême, xt faiſons voir la fin du Juge de ſoy-même.	Changeons notre chagrin dans une joie extrême, faisons voir la fin du Juge de soi-même.
Fin du troiſitme & dernier Acte.	Fin du troisième et dernier Acte.
ADILLE à Iyſandre.	ADILE à Iysandre.
Je jouë un plaiſant rolle aujourd’huy ſur mon ame.	Je joue un plaisant rolle aujourd'hui sur mon âme.
Donc, Padille, Monſieur, eſt le macy ſans femme ?	Donc, Padille, Monsieur, est le macy sans femme ?
De me démarier avez vous le pouvoir,	De me démarier avez vous le pouvoir,
YSANDRE.	YSANDRE.
La bouteille de vin conſole ton eſpoir.	La bouteille de vin console ton espoir.
ADILLE.	ADILE.
Mais j’ay plaidé pour vous quel ſera mon ſalaire,	Mais j'ai plaidé pour vous quel sera mon salaire,
LYSANDRE.	LYSANDRE.
Padille, pour cela, ſera mon Secretaire.	Padille, pour cela, sera mon Secrétaire.
ADILLE Le Secretariat me vient bien, ſur ma foy;	ADILE Le Secrétariat me vient bien, sur ma foi;
Et l’on ne vit jamais rien plus ſecret que moy.	Et l'on ne vit jamais rien plus secret que moi.
YSANDRE.	YSANDRE.
Changeons nôtre chagrin dans une joye extrême, xt faiſons voir la fin du Juge de ſoy-même.	Changeons notre chagrin dans une joie extrême, faisons voir la fin du Juge de soi-même.
Fin du troiſitme & dernier Acte.	Fin du troisième et dernier Acte.
Achevé d’imprimer pour la premiere fois le vingt-fixiéme jour de Ianvier 1682 avet Permiſſion.	Achevé d'imprimer pour la première fois le vingt-sixième jour de Janvier 1682 avet Permission.
