ln L 2 A TRAGEDIE EN MVSI( L PVE.	Un L 2 A -TRAGÉDIE EN MUZY( L UE.
ORNE’E D’ENTRE’ES DE BALLET, De Machines, & de Changements de Theatre.	ORNE D'ENTREES DE BALLET, De Machines, et de Changements de Théâtre.
Repreſentée devant Sa Majeſté à Saint Germain en Laye, le dixiéme jour de lanvier 1675.	Représentée devant Sa Majesté à Saint Germain en Laye, le dixième jour de lanvier 1675.
A PARIS, Par CHRISTOPHE BALLARD, ſeul Imprimeur du Roy, pour la Muſique, ruë Saint Jean de Beauvais au Mont Parnaſſe.	À PARIS, Par CHRISTOPHE BALLARD, seul Imprimeur du Roi, pour la Musique, rue Saint Jean de Beauvais au Mont Parnasse.
M.	M.
DC.	DC.
LXXV.	LXXV.
ACTEVRS DV IROLOGVE.	ACTEURS DU JROLOGUE.
Chœur d'Amours, de Graces, de Plaiſirs, & de Ieux-	Chœur d'Amours, de Grâces, de Plaisirs, et de Jeux-
Deux Graces.	Deux Grâces.
Meſdemoiſelles Bony, & Pieſche.	Mesdemoiselles Boni, et Pièche.
Deux Amours.	Deux Amours.
Les ſieurs Marolle, & Lanneau Pages.	Les sieurs Marole, et Lanneau Pages.
Les Plaiſirs chantants.	Les Plaisirs chantants.
Meſſieurs Gillet, Colin, Miracle, Taulet, Foreſtier, Langeais, & Servant.	Messieurs Gillet, Colin, Miracle, Taulet, Forestier, Langeais, et Servant.
Les Ieux chantants.	Les Jeux chantants.
Meſſieurs Deſtival, Beaumont, Derciſamps l’aiſme, Deſchamps cadet, Beaumavlele, Romgnoi, & Seguin.	Messieurs Destival, Beaumont, Dercisamps l'aisme, Déchamps cadet, Beaumavlele, Romgnoi, et Séguin.
BACCHVS.	BACHUS.
Monſieur de la Grille.	Monsieur de la Grille.
VENVS.	VENUS.
Mademoiſelle Beaucreux.	Mademoiselle Beaucreux.
CERES.	CERES.
Mademoiſehe de la Borde,	Mademoisehe de la Borde,
MARS Le ſieur Goudonneſche.	MARS Le sieur Goudonnesche.
BELLONE.	BÉLONE.
Le ſieur Dauphin.	Le sieur Dauphin.
Troupe de Moiſſonneurs qui ſuivent Cerés.	Troupe de Moissonneurs qui suivent Cerés.
Troupe de Silvains, & de Bacchantes qui ſuivent Bacchus.	Troupe de Silvains, et de Bacchantes qui suivent Bacchus.
Dix de la ſuite de Bacchus chantants.	Dix de la suite de Bacchus chantants.
Meſſieurs Bony, Rebel, Le Maire, Colin, Martial, De Maſſe, Jolain, Servant, Lavernay!	Messieurs Boni, Rebel, Le Maire, Colin, Martial, De Masse, Jolain, Servant, Lavernay!
& Le Febvre.	et Le Febre.
Les ſieurs Noblet, Leſtang, Barazé, & Blondy.	Les sieurs Noblet, Létang, Barasé, et Blondi.
Quatre ſuivantes de Cerés dançantes.	Quatre suivantes de Cerés dançantes.
Les ſeurs boiſiaru, Arſſai, noutviſie, & de Benne Quatre ſuivans de Bacchus dançants.	Les sûreurs boisiaru, Arssai, noutvisie, et de Benne Quatre suivants de Bacchus dançants.
Monſieur Dolivet pere, Les ſieurs Chicanneau, le Chantre, & Peſant.	Monsieur Dolivet père, Les sieurs Chicanneau, le Chantre, et Pesant.
Quatre ſuivantes de Bacchus dançantes.	Quatre suivantes de Bacchus dançantes.
Les ſieurs Mayeu, Renier, Charlot, & Dolivet fils.	Les sieurs Majeu, Renier, Charlot, et Dolivet fils.
La Scene du Prologue eſt dans les Iardins de Verſailles.	La Scène du Prologue est dans les Jardins de Versailles.
L 2 A.	 2 A.
Le Theatre repreſente les Iardins & la Façade du Palais de Verſailles.	Le Théâtre représente les Jardins et la Façade du Palais de Versailles.
Chœur d’Amours, de Graces, de Plaiſirs,	Chœur d'Amours, de Grâces, de Plaisirs,
& de leux.	et de leux.
Uyons, la Guerre eſt de retour.	Uyons, la Guerre est de retour.
Fuyons ſes fureurs inhumaines.	Fuyons ses fureurs inhumaines.
UN PLAISIR, Monſieur Langeais.	UN PLAISIR, Monsieur Langeais.
C’eſtoit dans ces Jardins, au bord de ces Fontaines, Que l’aimable Mere d’Amour Eſperoit d’eſtablir ſa bien-heureuſe Cour, mimuuupeoeſporums ſont vaines,	C'était dans ces Jardins, au bord de ces Fontaines, Que l'aimable Mère d'Amour Esperait d'établir sa bienheureuse Cour, mimuupéoesporums sont vaines,
Le Chœur.	Le Chœur.
Fuyons, la Guerre eſt de retour, Fuyons ſes fureurs inhumaines.	Fuyons, la Guerre est de retour, Fuyons ses fureurs inhumaines.
Le Bruit chaſſe la Paix de ces charmantes Plaines, Et vunx cintcines gomm teomouos outuilvouve.	Le Bruit chasse la Paix de ces charmantes Plaines, Et vunx cintcines gomm teomouos ouvilvouve.
LES PLAISIRS, & LES JEUX, Meſſieurs Langeais, Beaumaviele, & Miracle, Ah!	LES PLAISIRS, et LES JEUX, Messieurs Langeais, Beaumavie, et Miracle, Ah!
quelles peines De quitter un ſi beau ſejour!	quelles peines De quitter un si beau séjour!
Les Amours s’enfuyent avec les Graces, les Plaiſirs & les Jeux,	Les Amours s'enfuient avec les Grâces, les Plaisirs et les Jeux,
Chœur.	Chœur.
Fuyons, la Guerre eſt de retour.	Fuyons, la Guerre est de retour.
Fuyons ſes fureurs inhumaines.	Fuyons ses fureurs inhumaines.
VENUS.	VENUS.
ReveneZ, Amours, revenez,;	Revenez, Amours, revenez,;
Pourquoy me laiſſez-vous au milieu des allarmes?	Pourquoi me laissez-vous au milieu des alarmes?
La Beauté perd ſes plus doux charmes, Si-toſt que vous l’abandonneZ Revenez, Amours, reveneZ.	La Beauté perd ses plus doux charmes, Sitôt que vous l'abandonnez Revenez, Amours, reveneZ.
Beaux Lieux, où les Plaiſirs ſuivoient par tout mes pas, Que ſont devenus vos appas?	Beaux Lieux, où les Plaisirs suivaient par tout mes pas, Que sont devenus vos appas?
Qu'un ſi charmant Sejour eſt triſte & ſolitaire!	Qu'un si charmant Séjour est triste et solitaire!
Helas!	Hélas!
helas!	hélas!
Les Amours n’y ſont pas, Sans les Amours, rien ne peut plaire.	Les Amours n'y sont pas, Sans les Amours, rien ne peut plaire.
Revenez,	Revenez,
Revenez, Amours, reveneZ.	Revenez, Amours, revenez.
Eſt-il quelque danger dont il ne vous délivre?	Est-il quelque danger dont il ne vous délivre?
Il chaſſe les Fureurs de ces Lieux fortunez, A la ſeule Victoire il permet de le ſuivre.	Il chasse les Fureurs de ces Lieux fortunés, À la seule Victoire il permet de le suivre.
Revenez,, Amours, revenez.	Revenez, Amours, revenez.
On entend des Trompettes & des Tambours dont Ie bruit ſe meſle au ſon de pluſieurs Inſtruments Chaſſpeſtres.	On entend des Trompettes et des Tambours dont Je bruit se mêle au son de plusieurs Instruments Chasspêtres.
Cependaſit Mars paroſit rul Ton Char avec Bellone.	Cépendasit Mars parosit rul Ton Char avec Belone.
MARS, ſur ſon Char.	MARS, sur son Char.
Que rien ne trouble icy Venus & les Amours.	Que rien ne trouble ici Venus et les Amours.
Que ſous d’aymables Loix, dãs ces douces Retraites, On paſſe en repos d’heureux jours;	Que sous d'aimables Lois, dans ces douces Retraites, On passe en repos d'heureux jours;
Que les Haut-bois, que les Muſettes L’emportent ſur les Trompettes, Et ſur les Tambours.	Que les Haut-bois, que les Musettes L'emportent sur les Trompettes, Et sur les Tambours.
Que rien ne trouble icy Venus & les Amours.	Que rien ne trouble ici Venus et les Amours.
On n’entend plus le bruit des Trompettes & des Tambours:	On n'entend plus le bruit des Trompettes et des Tambours:
Et pluſieurs Inſtrumens Champeſtres joüent dans le temps que Mars deſcend.	Et plusieurs Instruments Champêtres joüent dans le temps que Mars descend.
MARS.	MARS.
ParteZ, alleZ, voleZ, redoutable Bellone.	Partez, allez, volez, redoutable Belone.
LaiſſeZ en paix icy les Amours & les Ieux;	Laissez en paix ici les Amours et les Jeux;
Que Ceres, que Bachus, s’avancent avec eux;	Que Ceres, que Bachus, s'avancent avec eux;
Eſloignez ce qui les eſtonne.	Éloignez ce qui les étonne.
PorteZ aux Ennemis de cét Empire heureux Tout ce que la Guerre a d’affreux:	Portez aux Ennemis de cet Empire heureux Tout ce que la Guerre a d'affreux:
Venus le veut, Mars vous l’ordonne.	Venus le veut, Mars vous l'ordonne.
ParteZ, allez, volez, redoutable Bellone.	Partez, allez, volez, redoutable Belone.
Bellone obeït, & s’envole.	Belone obéir, et s'envole.
VENUS.	VENUS.
Inexorable Mars, pourquoy deſchaînez-vous Contre un Heros vainqueur tant d’Ennemis jaloux ?	Inexorable Mars, pourquoi déchaînez-vous Contre un Héros vainqueur tant d'Ennemis jaloux ?
Faut-il que l’Univers avec fureur-conspire Contre ce glorieux Empire Dont le ſejour nous eſt ſi doux?	Faut-il que l'Univers avec fureur-conspire Contre ce glorieux Empire Dont le séjour nous est si doux?
Sans une aimable Paix peut-on jamais attendre De beaux jours ny d’heureux moments?	Sans une aimable Paix peut-on jamais attendre De beaux jours ni d'heureux moments?
La plainte la plus tendre, Ets plls aoha joupuis des Aimantrs, Sont le ſeul bruit qu’on doit entendre En des Lieux ſi charmans.	La plainte la plus tendre, Ets plls aha joupuis des Aimants, Sont le seul bruit qu'on doit entendre En des Lieux si charmants.
MARS.	MARS.
Que dans ce beau Sejour rien ne vous épouvante, Un nouveau Mars rendra la France triomphante.	Que dans ce beau Séjour rien ne vous épouvante, Un nouveau Mars rendra la France triomphante.
Le Deſtin de la Guerre en ſes mains eſt remis;	Le Destin de la Guerre en ses mains est remis;
Et ſi j’augmente Le nombre de ſes Ennemis, C’eſt pour rendre ſa gloire encor plus éclatante.	Et si j'augmente Le nombre de ses Ennemis, C'est pour rendre sa gloire encor plus éclatante.
Le Dieu de la Valeur doit toûjours l’animer.	Le Dieu de la Valeur doit toujours l'animer.
ENUS.	ENUS.
Venus répand ſur luy tout ce qui peut charmer	Venus répand sur deux tout ce qui peut charmer
LOGUE.	LOGUE.
MARS.	MARS.
Malheur, malheur à qui voudra contraindre Un ſegrand Terbs à s’armer.	Malheur, malheur à qui voudra contraindre Un segrand Terbs à s'armer.
VENUS.	VENUS.
Tout doit l’aimer.	Tout doit l'aimer.
MANS.	MANS.
Tout doit le craindre.	Tout doit le craindre.
VENUS & MARS.	VENUS et MARS.
Tout doit le craindre, Tout doit l’aimer.	Tout doit le craindre, Tout doit l'aimer.
MARS & VENUS.	MARS et VENUS.
Qu’il paſſe, au gré de ſes deſirs, De la Gloire aux Plaiſirs, Des Plaiſirs à la Gloire.	Qu'il passe, au gré de ses désirs, De la Gloire aux Plaisirs, Des Plaisirs à la Gloire.
Venez, aimables Dieux, venez tous dans ſa Cour.	Venez, aimables Dieux, venez tous dans sa Cour.
Meſlez aux chants de Victoire Ete doucee Onunpons u'Amour.	Mêlez aux chants de Victoire Éte doucepe Onunpons Amour.
Bacchus & Ceres ſuivis de Moiſſonneurs, de Silvains & de Bacchantes, rameinent les Amours, les Graces, les Plaiſirs, & les Jeux.	Bacchus et Ceres suivis de Moissonneurs, de Syvains et de Bacchantes, raminent les Amours, les Grâces, les Plaisirs, et les Jeux.
Le Chœur.	Le Chœur.
Meſlons aux Chants de Victoire Les douces Chanſons d’Amour.	Mêlons aux Chants de Victoire Les douces Chansons d'Amour.
BACCHUS, & CERE’S.	BACCHUS, et CERE’S.
Que tout le reſte de la Terre Porte envie au bõheur de ces Lieux pleins d’attraits.	Que tout le reste de la Terre Porte envie au bheur de ces Lieux pleins d'attraits.
Le Chœur.	Le Chœur.
Que tout le reſte de la Terre Porte envie au uonut de cta Lieux pleins d’attraits.	Que tout le reste de la Terre Porte envie au uonut de cta Lieux pleins d'attraits.
MARS, & VENUS.	MARS, et VENUS.
Au milieu de la Guerre Gouſtons les plaiſirs de la Paix.	Au milieu de la Guerre Goûtons les plaisirs de la Paix.
La Troupe des Moiſſonneurs commence une Dançe agreable, & environne Cerés dans le temps qu’elle chante.	La Troupe des Moissonneurs commence une Dançe agréable, et environne Cerés dans le temps qu'elle chante.
Le Chœur.	Le Chœur.
Au milieu de la Cnerre Gouſtons les plaiſirs de la Paix.	Au milieu de la Cnerre Goûtons les plaisirs de la Paix.
CERE’S.	CERÈ'S.
Trop heureux qui moiſſonne Dans les Champs des Amours!	Trop heureux qui moissonne Dans les Champs des Amours!
Amants que rien ne vous eſtonne, L’esperance eſt un grand ſecours:	Amants que rien ne vous étonne, L'espérance est un grand secours:
Quand on vient à cueïllir les Fruits que l’Amour donne, On eſt riche à jamais, & content pour toüjours, Trop heureux qui moiſſonne Dans les Champs des Amours!	Quand on vient à cueilir les Fruits que l'Amour donne, On est riche à jamais, et content pour toujours, Trop heureux qui moissonne Dans les Champs des Amours!
Bacchus chante au milieu des Silvains & des Bacchantes qui dançent.	Bacchus chante au milieu des Silvains et des Bacchantes qui dançent.
Pour les plus Fortunez, pour les plus Malheureux, Dans l’Empire amoureux, Le Dieu du vin eſt neceſſaire:	Pour les plus Fortunés, pour les plus Malheureux, Dans l'Empire amoureux, Le Dieu du vin est nécessaire:
S’il prend part aux plaiſirs c’eſt pour les redoubler;	S'il prend part aux plaisirs c'est pour les redoubler;
Il charme les chagrins des Cœurs qu’on deſeſpere;	Il charme les chagrins des Cœurs qu'on désespère;
Duvonn a dequoy conſoler De tous les maux qu’Amour peut faire.	Duvonn a dequoy consoler De tous les maux qu'Amour peut faire.
La Troupe qui ſuit Cerés, & la Troupe des ſuivans de Bacchus ſe réüniſſent, & expriment enſemble leur joye par une Dançe, que les autres Dieux accompagnent de leurs chants;	La Troupe qui suit Cerrez, et la Troupe des suivants de Bacchus se réunissent, et expriment ensemble leur joie par une Dançe, que les autres Dieux accompagnent de leurs chants;
& tous enfin ſe retirent pour faire place, & pour prendre part au magnifique Divertiſſement qui va paroiſtre.	et tous enfin se retirent pour faire place, et pour prendre part au magnifique Divertissement qui va paraître.
MARS, & VENUS.	MARS, et VENUS.
Qu’il paſſe au gré de ſes deſirs De la Gloire aux Plaiſirs, DB Plaiſtrs a la Giosre;	Qu'il passe au gré de ses désirs De la Gloire aux Plaisirs, DB Plaistrs a la Giosre;
VeneZ, aimables Dieux, veneZ tous, dans ſa Cour:	VeneZ, aimables Dieux, venez tous, dans sa Cour:
MeſleZ aux Chants de Uictoire Les douces Chanſons d’Amour.	Mêlez aux Chants de Uictoire Les douces Chansons d'Amour.
Le Chœur.	Le Chœur.
Meſlons aux Chants de Victoire Les douces Chanſons d’Amour.	Mêlons aux Chants de Victoire Les douces Chansons d'Amour.
Que tout le reſte de la Terre Porte envie au bonheur de ces Lieux pleins d’at17AllJ.	Que tout le reste de la Terre Porte envie au bonheur de ces Lieux pleins d'at17AllJ.
Le Chœur.	Le Chœur.
Que tout le reſte de la Terre Porte envie au bonheur de ces Lieux pleins d’attraits.	Que tout le reste de la Terre Porte envie au bonheur de ces Lieux pleins d'attraits.
MARS, & VENUS.	MARS, et VENUS.
Aut mitien de ta Guerre, Gouſtons les Plaiſirs de la Paix.	Aut mitien de ta Guerre, Goûtons les Plaisirs de la Paix.
Le Chœur.	Le Chœur.
Au milieu de la Guerre, Gouſtons les Plaiſirs de la Paix.	Au milieu de la Guerre, Goûtons les Plaisirs de la Paix.
Fin du Prologue.	Fin du Prologue.
ACTEVRS DE LA TRAGEDIE.	ACTEURS DE LA TRAGÉDIE.
Lhaur de Combaltans.	Lhaur de Combaltants.
ÆGLE', Princeſſe eſlevée ſous la tutele d’Ægée Roy d’Athenes.	ÆGLE', Princesse élevée sous la têtele d'Ægée Roi d'Athène.
Mademoiſelle Aubry.	Mademoiselle Aubri.
CLEONE, Confidente d’Æglé.	CLÉONE, Confidente d'Églé.
Madelle Brigogne.	Madelle Brigogne.
ARCAS, Confuent u IEgee Roy d Ainenes.	ARCAS, Confuent IEgee Roy Ainenes.
Mr Morel.	Mr Morel.
mu Gianat Presbrejje ve Oramen ce.	mu Gianat Presbrejje ve Oramen ce.
lrae Verdier.	lrae Verdier.
ÆGE’E, Roy d’Athenes.	ÉGÉGE, Roi d'Athène.
Monſieur Gaye.	Monsieur Gaie.
Suivans d'Ægée;	Suivants d'Ægée;
Roy d’Athenes.	Roi d'Athène.
Les ſieurs Allard, Vagnart cadet, Louis, Cæzar, Alexandre, & Pompée.	Les sieurs Allard, Vagnart cadet, Louis, Cæzar, Alexandre, et Pompée.
Chœur de Preſtreſſes de Minerve.	Chœur de Prêtresses de Minerve.
Troupe de Sacrificateurs de Minerve.	Troupe de Sacrificateurs de Minerve.
MEDE’E, Princeſſe Magicienne.	MÈDE, Princesse Magicienne.
Mademoiſelle S.	Mademoiselle S.
Chriſtophe.	Christophe.
DORINE, Confidente de Medée.	DORINE, Confidente de Medée.
Madelle Beaucreux.	Madelle Beaucreux.
Chœur & Troupe de la Populace d’Athenes.	Chœur et Troupe de la Populace d'Athènes.
THESE’E, Fils inconnu d’Ægée Roy d'Athenes.	THÉSE'E, Fils inconnu d'Ægée Roi d'Athène.
Monſieur Clediere.	Monsieur Clédière.
Le Deſeſpoir.	Le Désespoir.
Troupe de Lutins.	Troupe de Lutins.
Chœur des Habitants des Enfers.	Chœur des Habitants des Enfers.
P il Painene.	P il Painène.
Chœur & Troupe d’Habitans heureux de l’Iſle Enchantée.	Chœur et Troupe d'Habitants heureux de l'Île Enchantée.
Chœur & Troupe d’Atheniens.	Chœur et Troupe d'Athéniens.
Les Furies.	Les Furies.
MINERVE.	MINERVE.
Mademoiſelle Des-Fronteaux.	Mademoiselle Des-Fronteaux.
Chœur de Divinitez qui accompagnent Minerve.	Chœur de Divinités qui accompagnent Minerve.
Vn grand Seigneur de la Cour d’Ægée.	Un grand Seigneur de la Cour d'Ægée.
Troupe des plus conſiderables Courtiſans du Roy d’Athenes.	Troupe des plus considérables Courtisans du Roi d'Athènes.
Troupe d’Eſclaves.	Troupe d'Esclaves.
La Scene eſt à Athenes.	La Scène est à Athènes.
THESE’E.	THÉSE'E.
EEMSR TECROEDIL.	EEMSR TECRODIL.
ACTE PREMIER Le Theatre repreſente le Temple de Minerve.	ACTE PREMIER Le Théâtre représente le Temple de Minerve.
SCENE PREMIERE.	SCÈNE PREMIÈRE.
Combattans que l’on entend & que l’on ne voit I point;	Combattants que l'on entend et que l'on ne voit I point;
A A Vançons, avançons;	A À Vançons, avançons;
que rien ne nous eſtonne, Frappons, perçons, frappons;	que rien ne nous étonne, Frappons, perçons, frappons;
qu’on n’épargne perſonne;	qu'on n'épargne personne;
Il faut perir, il faut perir;	Il faut périr, il faut périr;
Il faut vaincre, où mourir.	Il faut vaincre, où mourir.
SCENE SECONDE.	SCÈNE SECONDE.
ÆGLE’, Combattans que l’on entend & que Ion ne voit point.	ÆGLE’, Combattant que l'on entend et que Ion ne voit point.
ÆGLE'.	ÆGLE'.
Vel que ſoit mon deſtin, il faut icy l’attendre, Minerve, c’est à vous que je viens recourir.	Vel que soit mon destin, il faut ici l'attendre, Minerve, c'est à vous que je viens recourir.
Divinité qui devez prendre Le ſoin de nous deffendre, Elalares e olle cte lratre feectsssis	Divinité qui devez prendre Le soin de nous défendre, Élalares e olle cte lratre feectsssis
Combattans.	Combattants.
Il faut vaincre, ou mourir.	Il faut vaincre, ou mourir.
ÆGLE’.	ÆGLE’.
O Ciel!	Ô Ciel!
ô juste Ciel!	ô juste Ciel!
vous est-il doux d’entendre Ces cris pleins de fureur que je ne puis ſouffrir?	vous est-il doux d'entendre Ces cris pleins de fureur que je ne puis souffrir?
Dieux!	Dieux!
aimez vous à voir tant de ſang ſe répãdre?	aimez -vous à voir tant de sang se répãdre?
Combattans.	Combattants.
Il faut perir, il faut perir, Il faut vaincre, ou mourir.	Il faut périr, il faut périr, Il faut vaincre, ou mourir.
SCENE TROISIESME.	SCÈNE -TROISIÈME.
CLEONE, ÆGLE', Combattans que l’on entend & que l’on ne voit point.	CLÉONE, ÆGLE', Combattants que l'on entend et que l'on ne voit point.
ÆGLE’.	ÆGLE’.
St-ce aux Atheniens, eſt-ce au Party cõtraire, 2 Que l’avantage eſt demeuré?	St-ce aux Athéniens, est-ce au Parti comtraire, 2 Que l'avantage est demeuré?
Dy moy pour qui le Sort s’eſt enfin declaré.	Dis -moi pour qui le Sort s'est enfin déclaré.
Ton ſilence me deſeſpere.	Ton silence me désespère.
CLEONE.	CLÉONE.
PardonneZ à la peur qui me force à me taire.	Pardonnez à la peur qui me force à me taire.
Mes yeux troubleZ d’effroy n’ont rien conſideré:	Mes yeux troublés d'effroi n'ont rien considéré:
Theſée eſt le Dieu tutelaire Qui me donne en ce Temple un refuge aſſûré:	Thesée est le Dieu tutélaire Qui me donne en ce Temple un refuge assuré:
Ie ne ſçais rien de plus, & j’ay creu beaucoup faire De gagner en tremblant cét AZile ſacré.	Je ne sais rien de plus, et j'ai cru beaucoup faire De gagner en tremblant cet AZile sacré.
ÆGLE'.	ÆGLE'.
Au milieu des clameurs, au travers du carnage, Theſée a juſqu’icy conduit mes pas errants:	Au milieu des clameurs, au travers du carnage, Thesée a jusqu'ici conduit mes pas errants:
Son genereux courage A fait ſes premiers ſoins de m’ouvrir un pa ſſage Entre deux effroyables rangs De morts & de mourants.	Son généreux courage A fait ses premiers soins de m'ouvrir un paysage Entre deux effroyables rangs De morts et de mourants.
N’as-tu point admiré l’ardeur noble & guerriere Dont il court au peril & s’expoſe au treſpas?	N'as-tu point admiré l'ardeur noble et guerrière Dont il court au péril et s'expose au trépas?
Ah qu’un jeune Heros dans l’horreur des Combats Couvert de ſang, & de poußiere, Aux yeux d’une Princeſſe fiere A de charmans appas!	Ah qu'un jeune Héros dans l'horreur des Combats Couvert de sang, et de pouière, Aux yeux d'une Princesse fière A de charmants appas!
CLEONE.	CLÉONE.
Theſée eſt aimable, il vous aime;	Thesée est aimable, il vous aime;
Tout cede à ſa valeur extreſme;	Tout cède à sa valeur extrême;
A ij Vous pouvez ſans rougir ſouffrir à vostre tour Que juſqu’a voſtre cœur il porte ſa victoire.	A ij Vous pouvez sans rougir souffrir à votre tour Que jusqu'a votre cœur il porte sa victoire.
Il n’eſt rien de ſi beau que les nœuds de l’Amour Quana its font jormeZ par ta Gloire,	Il n'est rien de si beau que les nœuds de l'Amour Quana its font jormés par ta Gloire,
ÆGLE', & CLEONE.	ÉGLÉE, et CLÉONE.
Ie neprien de ſi beau que les nœuds de l’Amour Quand ils ſont formeZ par la Gloire.	Je neprien de si beau que les nœuds de l'Amour Quand ils sont formés par la Gloire.
Combattans.	Combattants.
Il faut perir, il faut perir, Il faut vaincre ou mourir.	Il faut périr, il faut périr, Il faut vaincre ou mourir.
SCEIE QCAIKIESME.	SCIE QCAIGIESME.
ARCAS, ÆGLE', CLEONE.	ARCAS, ÇGLÉ, CLEONE.
ÆGLE'.	ÆGLE'.
E Ciel ne veut-t-il point mettre fin à nos peines?	E Ciel ne veut-t-il point mettre fin à nos peines?
Eſclaircy nous, Arcas, quel eſt le ſort d’Athenes?	Esclaircy nous, Arcas, quel est le sort d'Athènes?
RCAS.	RACS.
Le Combat dure encor, il eſt ſanglant, affreux, Et le ſuccez en eſt douteux.	Le Combat dure encor, il est sanglant, affreux, Et le succès en est douteux.
Le Roy m’a commandé de prendre Le ſoin de l’avertir s’il falloit vous deffendre, Et ce n’eſt que pour vous qu’il eſt touché d’effroy.	Le Roi m'a commandé de prendre Le soin de l'avertir s'il fallait vous défendre, Et ce n'est que pour vous qu'il est touché d'effroi.
ÆGLE'.	ÆGLE'.
Theſée eſt-il avec le Roy?	Thesée est-il avec le Roi?
GEDI ARCAS.	GÉDI ARCAS.
Des plus fiers Ennemis il écarte la foule, On reconnoit ſa trace aux flots du ſang qui coule:	Des plus fiers Ennemis il écarte la foule, On reconnaît sa trace aux flots du sang qui coule:
y ne greſie de I raits ne lia point rerenu.	y ne gresie de I raits ne lia point rerenu.
ÆGLE'.	ÆGLE'.
O Dieux!	Ô Dieux!
Ia Elle dit ce qui ſuit à Cleone.	Ia Elle dit ce qui suit à Cléone.
Mon ſecret eſt connu;	Mon secret est connu;
Ie crains devant Arcas d’en faire trop entendre, Cleone, s’il ſe peut, obtien qu’il aille aprendre Ce que Theſée eſt devenu.	Je crains devant Arcas d'en faire trop entendre, Cléone, s'il se peut, obtien qu'il aille apprendre Ce que Thesée est devenu.
SCENE CINQUIESME.	SCÈNE CINQUIÈME.
CLEONE, ARCAS, Combattans que l’on entend & que l’on ne voit point.	CLÉONE, ARCAS, Combattants que l'on entend et que l'on ne voit point.
CLEONE.	CLÉONE.
Anopriuubimrniceſſe,  Prier en paix la Déeſſe.	Anopriuubimrnicesse, Prier en paix la Déesse.
Arcas, je veux cuoir en ce jour Iuſqu'où va pour moy ton amour.	Arcas, je veux cuoir en ce jour Jusqu'où va pour moi ton amour.
ARCAS.	ARCAS.
Peux-tu douter de ma tendreſſe?	Peux-tu douter de ma tendresse?
CLEONE.	CLÉONE.
I'en doute encor, je le confeſſe.	J'en doute encor, je le confesse.
Tu m’as fait des ſerments cent fois Que tu ſuivrois toujours mes loix, Et qu’il te ſeroit doux de mourir pour me plaire;	Tu m'as fait des serments cent fois Que tu suivrais toujours mes lois, Et qu'il te serait doux de mourir pour me plaire;
Mais la pluſpart des Amants S'ont ſujets à faire Olert des fahx jeriienrs.	Mais la plupart des Amants S'ont sujets à faire Olert des fahx jérienrs.
ARCAS.	ARCAS.
Tu n’as qu’à commander, tu ſeras ſatisfaite.	Tu n'as qu'à commander, tu seras satisfaite.
CLEONE.	CLÉONE.
Cherche Theſée, & ſuy ſes pas diyuu a ja clereirt paijaile;	Cherche Thesée, et suivi ses pas diyuu a ja clereirt paijaile;
Ou juſqu’à ſon trépas.	Ou jusqu'à son trépas.
RCAS.	RACS.
D’où vient qu’en ſa faveur ton ame s’inquiéte?	D'où vient qu'en sa faveur ton âme s'inquiète?
CLEONE.	CLÉONE.
Si tu veux que je t’aime, Arcas, Fay ce que je ſouhaite, Et ne replique pas.	Si tu veux que je t'aime, Arcas, Fais ce que je souhaite, Et ne réplique pas.
ARCAS.	ARCAS.
Pour un autre que moy Cleone s’intereſſe?	Pour un autre que moi Cléone s'intéresse?
Pretens-tu que je ſois un Amant qui me preſſe De me charger d’un ſoin à mon amour fatal?	Prétends-tu que je sois un Amant qui me presse De me charger d'un soin à mon amour fatal?
C’eſt un plaiſir charmant de ſervir ſa Maiſtreſſe, Anani e eſt ail tnesnix jans exar De ſervir ſon Rival.	C'est un plaisir charmant de servir sa Maîtresse, Anani e est ail tnesnix jans exar De servir son Rival.
L’ordre du Roy m’engage A prendre ſoin de vous:	L'ordre du Roi m'engage A prendre soin de vous:
CLEONE.	CLÉONE.
L’Ennemy juſqu’icy n’oſe porter ſa rage.	L'Ennemi jusqu'ici n'ose porter sa rage.
Tout le monde eſt aux mains, veux-tu ſeul fuïr les coups?	Tout le monde est aux mains, veux-tu seul fuir les coups?
ARCAS.	ARCAS.
Ce grand empreſſement me donne de l’ombrage.	Ce grand empressement me donne de l'ombrage.
CLEONE.	CLÉONE.
La Valeur à mes yeux a des charmes bien doux.	La Valeur à mes yeux a des charmes bien doux.
Et le moindre ſoupçon m’outrage:	Et le moindre soupçon m'outrage:
Ie ne veux point avoir d’Epoux Qui ſoit jaloux, Ny d’Amant qui ſoit ſans courage.	Je ne veux point avoir d'Époux Qui soit jaloux, Ni d'Amant qui soit sans courage.
ARCAS.	ARCAS.
Faut-il qu’un Eſtranger ait pour toy tant d’appas?	Faut-il qu'un Étranger ait pour toi tant d'appas?
CLEONE.	CLÉONE.
Ie te l’ay dé ja dit, & je te le repete, Si tu veux que je t'aime, Arcas Fay ce que je ſouhaite, Et ne replique pas.	Je te l'ai dé ja dit, et je te le répète, Si tu veux que je t'aime, Arcas Fais ce que je souhaite, Et ne replique pas.
ARCAS.	ARCAS.
Hé bien, je ſuivray ton envie, I'en veux faire toüjours ma loy;	Hé bien, je suivrai ton envie, J'en veux faire tue ma loi;
La peur de te déplaire est mon plus grand effroy:	La peur de te déplaire est mon plus grand effroi:
Ie crains peu d’expoſer ma vie, Ie ne puis hazarder rien qui ne ſoit à toy.	Je crains peu d'exposer ma vie, Je ne puis hasarder rien qui ne soit à toi.
Combattans.	Combattants.
Avançons, avançons, que rien ne nous eſtonne;	Avançons, avançons, que rien ne nous étonne;
Frappos, perçons, frappons, qu'on n'épargne persone;	Frapppos, perçons, frappons, qu'on n'épargne persone;
Il faut perir, il faut perir, Il faut vaincre ou mourir.	Il faut périr, il faut périr, Il faut vaincre ou mourir.
SCENE SIXIESME.	SCÈNE SIXIÈME.
LA GRANDE PRESTRESSE.	LA GRANDE PRÊTRESSE.
DE MINERVE, ÆGLE', CLEONE, Combattans que l’on entend & que l’on ne voit point.	DE MINERVE, ÆGLE', CLENE, Combattants que l'on entend et que l'on ne voit point.
LA GRANDE PRESTRESSE.	LA GRANDE PRÊTRESSE.
JRions, prions la Déeſſe De nous dégager Du danger Qui nous preſſe 2 vruils , prrons tes Ecenes	JRions, prions la Déesse De nous dégager Du danger Qui nous presse 2 vrils , prrons tes Écènes
LA PRESTRESSE, ÆGLE', CLEONE.	LA PRÊTRESSE, ÉGLE, CLÉLEONE.
Prions, prions la Déeſſe.	Prions, prions la Déesse.
CoiDattaris.	CoiDattaris.
Mourez, moureZ, perfides Cœurs, Tompez jous les coups des Uainqueurs.	Mourez, mourez, perfides Cœurs, Tompez jous les coups des Uainqueurs.
LA GRANDE PRESTRESSE.	LA GRANDE PRÊTRESSE.
Dieux!	Dieux!
quelle barbarie!	quelle barbarie!
ÆGLE.	ÆGLE.
Entendrons-nous toûjours ces horribles clameurs?	Entendrons-nous toujours ces horribles clameurs?
LA PRESTRESSE, ÆGLE', CLEONE.	LA PRÊTRESSE, ÉGLE, CLÉLEONE.
Dieux!	Dieux!
quelle barbarie!	quelle barbarie!
Combattans.	Combattants.
Mourez, mourez, perfides Cœurs, Tombez ſous les coups des Vainqueurs.	Mourez, mourez, perfides Cœurs, Tombez sous les coups des Vainqueurs.
Vn	Un
G DIE.	G DIE.
Vn Combattant.	Un Combattant.
Sauve un malheureux qui te prie.	Sauve un malheureux qui te prie.
An je mcurs?	An je mens?
ab je mheurs?	ab je meurs?
LA GRANDE PRESTRESSE, ÆGLE', CLEONE.	LA GRANDE PRÊTRESSE, ÆGLE', CLEONE.
Dieux!	Dieux!
quelle barbarie!	quelle barbarie!
Vn Combattant.	Un Combattant.
321 Je, mlebsro, di je mnebrs;	321 Je, mêlébsro, di je mynebrs;
Sauve un malheureux qui te prie.	Sauve un malheureux qui te prie.
Combattans.	Combattants.
Mourez, moureZ, perfides Cœurs, Tombez ſous les coups des Vainqueurs.	Mourez, mourez, perfides Cœurs, Tombez sous les coups des Vainqueurs.
LA GRANDE PRESTRESSE.	LA GRANDE PRÊTRESSE.
O Minerve!	Ô Minerve!
arreſtez la cruelle furie Put defole nostre Parrie.	arrêtez la cruelle furie Pût désole notre Parrie.
Ecartez loin de nous la Guerre & ſes horreurs;	Écartés loin de nous la Guerre et ses horreurs;
Ciel!	Ciel!
eſpargneZ le ſang, contentez-vous de pleurs,	épargnez le sang, contentez-vous de pleurs,
LA GRANDE PRESTRESSE, ÆGLE', CLEONE.	LA GRANDE PRÊTRESSE, ÆGLE', CLEONE.
Ciel!	Ciel!
eſpargnez le ſang, contentez-vous de pleurs.	épargnez le sang, contentez-vous de pleurs.
Combattans.	Combattants.
Liberté, liberté.	Liberté, liberté.
Uictoire, victoire, victoire.	Victoire, victoire, victoire.
Courons, courons tous à la Gloire.	Courons, courons tous à la Gloire.
Combattons avec fermeté Deffendons nostre liberté.	Combattons avec fermeté Défendons notre liberté.
Liberté, liberté.	Liberté, liberté.
Emportons la victoire.	Emportons la victoire.
Victoire, victoire, victoire.	Victoire, victoire, victoire.
Liberté, liberté.	Liberté, liberté.
Victoire, victoire, victoire.	Victoire, victoire, victoire.
SCENE SEPTIESME.	SCÈNE SEPTIÈME.
ÆGE’E ROY D’ATHENES, LA GRANDE TRESTREDDE, IEGLE, CLEONE, Suivans du Roy d’Athenes.	ÆGE’, ROY D'ATHÈNES, LA GRANDE TRESTREDDE, JÉGLE, CLENE, Suivants du Roi d'Athères.
LE ROY.	LE ROY.
ES Mutins ſont vaincus, leurs Chefs ſont immoleZ Leuy vaine eſperance est deſtruite.	ES Mutins sont vaincus, leurs Chefs sont immolés Leute vaine espérance est détruite.
Tous les Peuples voiſins qu’ils avoient appelleZ Soui dans nos fers, où ſont en fuite.	Tous les Peuples voisins qu'ils avaient appelleZ Souri dans nos fers, où sont en fuite.
LA GRANDE PRESTRESSE.	LA GRANDE PRÊTRESSE.
Rendons graces aux Dieux.	Rendons grâces aux Dieux.
Tous enſemble.	Tous ensemble.
Rendons graces aux Dieux.	Rendons grâces aux Dieux.
LAISTRESSE.	LAISTRESSE.
Puiſque le juste Ciel à nos vœux est propice, Allons, empreſſons-nous d’offrir un ſacrifice A la Divinité qui protege ces Lieux.	Puisque le juste Ciel à nos vœux est propice, Allons, empressons-nous d'offrir un sacrifice À la Divinité qui protege cette Lieux.
Rendons graces aux Dieux.	Rendons grâces aux Dieux.
Tous enſemble.	Tous ensemble.
Rendons graces aux Dieux.	Rendons grâces aux Dieux.
SCENE HUITIESME.	SCÈNE HUITIÈME.
LEROE, LGLE,	LEROE, LGLE,
LE ROY.	LE ROY.
EſſeZ, charmante Æglé, de répandre des larmes, Commençons aprés tant d’allarmes A jouir d’un deſtin plus doux:	Essez, charmante Églé, de répandre des larmes, Commençons après tant d'allarmes A jouir d'un destin plus doux:
Puiſque je voy mon Thrône affermy par les armes, I'y veux joindre de nouveaux charmes En le partageant avec vous.	Puisque je vois mon Thrône affermi par les armes, J'y veux joindre de nouveaux charmes En le partageant avec vous.
ÆGLE' Avec moy!	ÆGLE' Avec moi!
vous!	vous!
S’eigneur!	S'eigneur!
LE ROY.	LE ROY.
Que voſtre trouble ceſſe.	Que votre trouble cesse.
C’est peut-eſtre, un peu tard vouloir plaire à vos yeux, Ie ne ſuis plus au temps de l’aimable jeuneſſe.	C'est peut-être, un peu tard vouloir plaire à vos yeux, Je ne suis plus au temps de l'aimable jeunesse.
Mais je ſuis Roy, belle Princeſſe, Et Roy victorieux.	Mais je suis Roi, belle Princesse, Et Roi victorieux.
Faites grace à mon âge en faveur de ma gloire, Voyez le prix du Rang qui vous est destiné:	Faites grâce à mon âge en faveur de ma gloire, Voyez le prix du Rang qui vous est destiné:
La Vieilleſſe ſied bien ſur un Front couronné, Quand on y voit briller l’éclat de là Victoire.	La Vieillesse sied bien sur un Front couronné, Quand on y voit briller l'éclat de là Victoire.
ParleZ charmante Æglé, parleZ à vostre tour.	Parlez charmante Æglé, parleZ vôtre tour.
ÆGLE'.	ÆGLE'.
Depuis que j’ay perdu mon Pere Vos ſoins ont prevenu mes vœux dans voſtre Cour.	Depuis que j'ai perdu mon Père Vos soins ont prévenu mes vœux dans votre Cour.
Ie doy vous reſpecter, Seigneur, je vous revere.	Je dois vous respecter, Seigneur, je vous révère.
LE ROY.	LE ROY.
Vous parleZ de respect quand je parle d’amour.	Vous parlez de respect quand je parle d'amour.
AEdE M Mais vostre foy, Seigneur, à Medée eſt promiſe?	AEdE M à Maître foi, Seigneur, à Medée est promise?
LE ROY.	LE ROY.
Je ſçay que lors qu’on la mépriſe On s’expoſé aux fureurs de ſes reſſentiments.	Je sais que lors qu'on la méprise On s'exposé aux fureurs de ses ressentiments.
Toute la Nature est ſoümiſe A ſes affreux commandements, L’Enfer la favoriſe, Elle confond les Elements, Le Ciel meſme est troublé par ſes enchantements.	Toute la Nature est soumise A ses affreux commandements, L'Enfer la favorise, Elle confond les Éléments, Le Ciel même est troublé par ses enchantements.
Oueais (ay faut etetver en fetret dans Trœzene Vn fils qui peut m’oster de peine:	Oueais (ai faut etetver en fetret dans Trœzène Un fils qui peut m'ôter de peine:
Ie veux qu’en eſpouſant Medée au lieu de moy, Il dégage ma foy.	Je veux qu'en épousant Medée au lieu de moi, Il dégage ma foi.
ÆGLE'.	ÆGLE'.
Mais ſi malgré vos ſoins, Medée ambitieuſe, Ne s'attache qu’au Rang que vous me preſenteZ:	Mais si malgré vos soins, Medée ambitieuse, Ne s'attache qu'au Rang que vous me présentez:
LE ROY.	LE ROY.
Que vous estes ingenieuſe A trouver des difficultez!	Que vous êtes ingénieuse A trouver des difficultés!
Que Medée en fureur, s’arme, menacé, tonne, Il faut que ma main vous couronne Quand il m’en couſteroit & l’Empire, & le Jour.	Que Medée en fureur, s'arme, menacé, tonne, Il faut que ma main vous couronne Quand il m'en coûterait et l'Empire, et le Jour.
Vn grand Cœur qui ſe ſent animé par l’Amour Ne doit jamais trouver de peril qui l’eſtonne.	Un grand Cœur qui se sent animé par l'Amour Ne doit jamais trouver de péril qui l'étonne.
I'atteste Minerve à vos yeux, I'atteste le Maistre des Cieux, Et ſa foudroyante juſtice.	J'atteste Minerve à vos yeux, J'atteste le Maître des Cieux, Et sa foudroyante justice.
ÆGLE'.	ÆGLE'.
Tout est preſt pour le Sacrifice, Chacun s’avance dans ces lieux, Rendons graces aux Dieux.	Tout est prêt pour le Sacrifice, Chacun s'avance dans ces lieux, Rendons grâces aux Dieux.
SCENE NEVFIESME.	SCÈNE NEUFIESME.
LE ROY, ÆGLE', SVIVANS DV ROY, CLEONE, LA GRANDE PRESTRESSE	LE ROY, ÆGLE', SVIVANS DU ROY, CLEONE, LA GRANDE PRÊTRESSE
Deux Timballiers.	Deux Timballiers.
Philidor l’aiſné, & Philidor cadet.	Philidor l'aîné, et Philidor cadet.
Et Empire puiſſant que vostre ſoin conſerve Vient reconnoiſtre icy voſtre divin ſecours, Favorable Minerve!	Et Empire puissant que votre soin conserve Vient reconnaître ic y divin secours, Favorable Minerve!
Protege (-nous toujours.	Prote (nous toujours.
LE CHOEUR DES PRESTRESSES.	LE CHOEUR DES PRÊTRESSES.
Favorable Minerve, Protegez-nous toûjours.	Favorable Minerve, Protegez-nous toujours.
LA GRANDE PRESTRESSE.	LA GRANDE PRÊTRESSE.
Le peril eſtoit redoutable:	Le péril était redoutable:
Mais vous nous inſpireZ un courage indomptable Qui de nostre malheur a détourné le cours, O Pallas favorable!	Mais vous nous inspirez un courage indomptable Qui de notre malheur a détourné le cours, Ô Pallas favorable!
ProtegeZ-nous toüjours.	Protessez-nous toujours.
LE CHOEUR DES PRESTRESSES.	LE CHOEUR DES PRÊTRESSES.
O Pallas favorable!	Ô Pallas favorable!
ProtegeZ-nous toujours.	Protestez-nous toujours.
LA GRANDE PRESTRESSE, Il faut profiter Du bonheur de nos armes.	LA GRANDE PRÊTRESSE, Il faut profiter Du bonheur de nos armes.
C’est trop eſcouter Le bruit des allarmes, Le cours de nos larmes Se doit arrester, Songeons à gouſter Un ſort plein de charmes;	C'est trop écouter Le bruit des alarmes, Le cours de nos larmes Se doit arrêter, Songeons à goûter Un sort plein de charmes;
Il faut profiter Du bonheur de nos armes.	Il faut profiter Du bonheur de nos armes.
ChanteZ tous en paix, ChanteZ la Victoire, Et que la memoire En vive à jamais:	Chantez tous en paix, Chantez la Victoire, Et que la mémoire En vive à jamais:
Chantez, les attrais Dont brille la Gloire;	Chantez, les attrais Dont brille la Gloire;
Camle Chantez, la Victoire.	Camle Chantez, la Victoire.
LA GRANDE PRESTRESSE.	LA GRANDE PRÊTRESSE.
Le calme est bien doux Apres un grand orage.	Le calme est bien doux Après un grand orage.
La gloire est pour nous, La honte & la rage Seront le partage Des Uoiſins jaloux:	La gloire est pour nous, La honte et la rage Seront le partage Des Uoisins jaloux:
Tout cedde à nos coups, Tout cedde au courage:	Tout cède à nos coups, Tout cède au courage:
Le calme est bien doux Apres un grand orage.	Le calme est bien doux Après un grand orage.
LE CHOEUR DES PRESTRESSES.	LE CHOEUR DES PRÊTRESSES.
Chantons tour à tour Dans ces Lieux aimables, Des Dieux favorables T font leur ſejour:	Chantons tour à tour Dans ces Lieux aimables, Des Dieux favorables T ont leur séjour:
Les ſeuls traits d’Amour T ſont redoutables:	Les seuls traits d'Amour T sont redoutables:
Chantons tour à tour Dans ces Lieux aimables.	Chantons tour à tour Dans ces Lieux aimables.
SCENE DIXIESME.	SCÈNE DIXIÈME.
LE ROY, ÆGLE', CLEONE, SVIVANS DV ROY, LA GRANDE PRESTRESSE, CHOEVR DES PRESTRESSES, Sacrificateurs Combattans qui apportent les Eſtendars & les Deſpoüilles des Ennemis vaincus.	LE ROY, GLE, CLEONE, SVIVANS DU ROY, LA GRANDE PRÊTRESSE, CHOEUR DES PRÊTRESSES, Sacrificateurs Combattants qui apportent les Étendards et les Despouilles des Ennemis vaincus.
Dix-huit aſſiſtants au Sacrifice chantants.	Dix-huit assistants au Sacrifice chantants.
Les ſieurs Deſtival, Baumaviele, Baumont, Bony, Le Maire, Roſſignol, Miracle, Goudonneſche, Renier, Foreſtier, Deſchamps l’aiſné, Deſchants cadet, Vaïſſe, Jolin, Servant, Lavernay, de Maſſe, Colin, & le Febvre.	Les sieurs Destival, Baumavie, Baumont, Boni, Le Maire, Rossignol, Miracle, Goudonnesche, Renier, Forestier, Dêchamps l'aîné, Deschants cadet, Vaïsse, Jolin, Servant, Lavernay, de Masse, Colin, et le Fébre.
Sacrificateurs Combatants dançants.	Sacrificateurs Combatants dançants.
Monſieur Beauchamp, les ſieurs Deſmatins, Favre, Peſant, Favier cadet, Blondy, Joubert, & Foignart cadet.	Monsieur Beauchamp, les sieurs Dématins, Favre, Pesant, Favier cadet, Blondi, Joubert, et Foignart cadet.
Six Preſtreſſes dançantes.	Six Prêtresses dançantes.
Les ſieurs Magny, Faüre, Noblet, Germain, Pecourt, & Boutville.	Les sieurs Magny, Faüre, Noblet, Germain, Pecourt, et Boutville.
LA GRANDE PRESTRESSE.	LA GRANDE PRÊTRESSE.
Minerve ſçavante!	Minerve Savante!
O Guerriere Pallas!	Ô Guerrière Pallas!
Que par voſtre faveur puiſſante Une felicité charmante Nous offre chaque jour mille nouveaux appas, O Minerve ſçavante!	Que par votre faveur puissante Une félicité charmante Nous offre chaque jour mille nouveaux appas, Ô Minerve sçavante!
O Guerriere Pallas!	Ô Guerrière Pallas!
Les	Les
Les Chœurs.	Les Chœurs.
Animez, nos cœurs, & nos bras, Rendez la Uictoire conſtante, ConduiſeZ nos Soldats, Par tout, devant leurs pas, Jettez le trouble & l’épouvante;	Animez, nos cœurs, et nos bras, Rendez la Uictoire constante, ConduiseZ nos Soldats, Par tout, devant leurs pas, Jettez le trouble et l'épouvante;
e Mimter vt [pacallle.	 Eimter [pacallle.
O Guerriere Pallas!	Ô Guerrière Pallas!
LA GRANDE PRESTRESSE.	LA GRANDE PRÊTRESSE.
coufrez qu’un Jeu ſacré dans ces Lieux vous preUne image innocente De guerre & de combas.	couffrez qu'un Jeu sacré dans ces Lieux vous prUne image innocente De guerre et de combas.
ſente	sente
es dls, O Minerve ſçavante!	es dls, Ô Minerve savante!
O Guerriere Pallas!	Ô Guerrière Pallas!
On forme un Combat à la maniere des Anciens.	On forme un Combat à la manière des Anciens.
Les Chœurs.	Les Chœurs.
Que la Guerre ſanglante Paſſe en d’autres Eſtats, O Minerve ſçavante!	Que la Guerre sanglante Passe en d'autres États, Ô Minerve savante!
O Guerriere Pallas!	Ô Guerrière Pallas!
Que la foudre menaçante Porte plus loin ſes éclats:	Que la foudre menaçante Porte plus loin ses éclats:
O Minerve ſçavante!	Ô Minerve Savante!
O Guerriere Pallas!	Ô Guerrière Pallas!
Puißions-nous voir toûjours Athenes triomphante, Puiſſe ſon Roy vainqueur des plus grands Potentats La rendre heureuſe & floriſſante.	Puissions-nous voir toujours Athènes triomphante, Puisse son Roi vainqueur des plus grands Potentats La rendre heureuse et florissante.
Les Chœurs.	Les Chœurs.
O Minerve ſçavante!	Ô Minerve Savante!
Q Gnerriere Palas?	QU Génerrière Palas?
Fin du premier Acte.	Fin du premier Acte.
ACTE SECOND.	ACTE SECOND.
Le Theatre change & repreſente le Palais d’Ægée Roy d’Athenes.	Le Théâtre change et représente le Palais d'Ægée Roi d'Athène.
SOLATD IRLNIEENE MEDE’E, DORINE.	SOLATD IRLNIENE MEDEDE, DORINE.
Ca.	Ca.
60 MEDE’E.	60 MÉDÉLE.
Oux repos, innocenté paix, Heureux, heureux un Cœur qui ne vous pert jamais!	Oux repos, innocenté paix, Heureux, heureux un Cœur qui ne vous pert jamais!
L’impitoiable Amour m’a toujours pourſuivie;	L'impitoyable Amour m'a toujours poursuivie;
faits!	faits!
N'eſtoit-ce point aſſez des maux qu’il m’avoit Pourquoy ce Dieu cruel avec de nouveaux Traits Vient-il encor troubler le reſte de ma vie?	N'était-ce point assez des maux qu'il m'avait Pourquoi ce Dieu cruel avec de nouveaux Traits Vient-il encor troubler le reste de ma vie?
Doux repos, innocente paix, mais!	Doux repos, innocente paix, mais!
Heureux, heureux un Cœur qui ne vous pert ja	Heureux, heureux un Cœur qui ne vous pert ja
Recommencez, d’aimer, repreneZ l’eſperance, Theſée eſt un Heros charmant, Mépriſez en l’aimant L’Ingrat Iaſon qui vous offence.	Recommencez, d'aimer, repreneZ l'espérance, Thesée est un Héros charmant, Méprisez en l'aimant L'Ingrat Iason qui vous offense.
Il faut par le changement Punir l’inconſtance, JLLROCxvrce.	Il faut par le changement Punir l'inconstance, JLLROCxvrce.
De faire un nouvel Amant.	De faire un nouvel Amant.
MEDE’E La gloire de Theſée à mes yeux paroiſt belle, On l’a veu triompher dés qu’il a combattu;	MÈDE A La gloire de Thesée à mes yeux paraît belle, On l'a vu triompher dès qu'il a combattu;
Le Deſtin de Medée eſt d’estre criminelle, Mais ſon cœur eſtoit fait pour aimer la vertu.	Le Destin de Medée est d'être criminelle, Mais son cœur était fait pour aimer la vertu.
DORINE.	DORINE.
Le Dépit veut que l’on s’engage Sous de nouvelles Loix, Quand on s'avlije au premier cnoix;	Le Dépit veut que l'on s'engage Sous de nouvelles Lois, Quand on s'avlije au premier cnoix;
On n’eſt pas volage Pour ne changer qu’une fois.	On n'est pas volage Pour ne changer qu'une fois.
MEDE’E.	MÈDE.
Vn tendre engagement va plus loin qu’on ne penſe, On ne voit pas, lors qu’il commence, Tout ce qu’il doit couſter un jour:	Un tendre engagement va plus loin qu'on ne pense, On ne voit pas, lors qu'il commence, Tout ce qu'il doit coûter un jour:
Mon cœur auroit encor ſa premiere innocence S’il n’avoit jamais eu d’amour.	Mon cœur aurait encor sa première innocence S'il n'avait jamais eu d'amour.
De mon implacable fureur;	De mon implacable fureur;
I'ay remply l’Vnivers d’horreur, Aviuus te cruec amour a fait ſeut vous mes crimes.	J'ai rempli l'Univers d'horreur, Avivus te cru amour a fait seut vous mes crimes.
DORINE.	DORINE.
Eſperez, de former de plus aimables nœuds.	Espérez, de former de plus aimables nœuds.
Vne cruelle experience Vous aprend que l’amour eſt un mal dangereux;	Une cruelle expérience Vous apprend que l'amour est un mal dangereux;
Mais l’ennuyeuſe indifference Ne rena pus uir cuur puus neureux.	Mais l'ennuyeuse indifférence Ne rena pus cuur puus neureux.
Aimez, aimez Theſée, aimez ſa gloire extréme,	Aimez, aimez Thesée, aimez sa gloire extrême,
MEDEE.	MÈDE.
Mais qui me répondra qu’il m’aime?	Mais qui me répondra qu'il m'aime?
DORINE.	DORINE.
Peut-il trouver un ſort plus beau?	Peut-il trouver un sort plus beau?
MEDE’E.	MÈDE.
Peut-eſtre que mon Cœur cherche un malheur nouveau.	Peut-être que mon Cœur cherche un malheur nouveau.
Mon Depit, tu le ſçais, dédaigne de ſe plaindre:	Mon Dépit, tu le sais, dédaigne de se plaindre:
Jl est difficile à calmer, O te Cctsote d Jevahborrper 3 Jl faudroit du ſang pour l’éteindre.	Il est difficile à calmer, Ô te Cctsote d' Jevahborrper 3 Jl faudrait du sang pour l'éteindre.
DORINE.	DORINE.
Que ne peut point Medée avec l’art de charmer?	Que ne peut point Medée avec l'art de charmer?
MEDE’E.	MÈDE.
2e pun qu p 9a poudre.	2e pun qu pun p9a poudre.
Les Enfers quãd je veux ſont contrains à s’armer.	Les Enfers quand je veux sont contrains à s'armer.
Mais on ne force point un cœur à s’enflamer;	Mais on ne force point un cœur à s'enflammer;
Mes charmes les plus forts ne ſçauroient l’y contraindre,	Mes charmes les plus forts ne sauraient l'y contraindre,
H	H
SCENE SECONDE.	SCÈNE SECONDE.
LE ROY, MEDE’E, DORINE, Suivans du Roy.	LE ROY, MÈDE, DORINE, Suivant du Roi.
S:	S:
LE ROY.	LE ROY.
E voy le ſuccez favorable Des ſoins que vous m’avez, promis, Medée & ſon art redoutable Ont gardé ce Palais contre mes Ennemis.	E vois le succès favorable Des soins que vous m'avez, promis, Medée et son art redoutable Ont gardé ce Palais contre mes Ennemis.
I'ay differé long-temps de tenir ma promeſſe, Ie devrois estre vostre Epoux.	J'ai différé longtemps de tenir ma promesse, Je devrais être votre Époux.
MEDEE.	MÈDE.
L’Hymen n’a rien qui preſſe Ny pour moy, ny pour vous.	L'Hymen n'a rien qui presse Ni pour moi, ni pour vous.
LE ROY.	LE ROY.
Vous pouvez ſans chagrin ſouffrir que je differe.	Vous pouvez sans chagrin souffrir que je diffère.
Avec un Epoux plein d’appas L’himen a de la peine a plaire;	Avec un Époux plein d'appas L'hymen a de la peine a plaire;
Quelle peur ne doit-il pas faire Quand l’Epoux ne plaiſt pas?	Quelle peur ne doit-il pas faire Quand l'Époux ne plaît pas?
Deſormais ſans peril je puis faire paraiſtre Vn Fils que dans ma Cour je n’oſois reconnaiſtré:	Désormais sans péril je puis faire paraître Un Fils que dans ma Cour je n'osais reconnaistré:
Il peut venir dans peu de temps.	Il peut venir dans peu de temps.
MEDE’E.	MÈDE.
Laiſſons-là voſtre Fils Seigneur, je vous entends La jeune Æglé vous paroiſt belle, Chaque jour, je m’en aperçoy:	Laissons-là votre Fils Seigneur, je vous entends La jeune Æglé vous paroist belle, Chaque jour, je en aperçoy:
Si vous m’abandonnez pour elle, Theſee est ſeul digne de moy.	Si vous m'abandonnez pour elle, Thesee est seul digne de moi.
LEROY, &MEDE’E.	LEROY, etMEDE’E.
Ne nous piquons point de conſtance;	Ne nous piquons point de constance;
Conſentons à nous dégager.	Consentons à nous dégager.
Gouſtons d intenigenee La douceur de changer.	Goûtons d' intenigenee La douceur de changer.
MEDEE.	MÈDE.
Quand on ſuit une amour nouvelle, C’est une trahiſon cruelle De laiſſer dans l’engagement On elelar lenure & plaehe s Mais rien n’eſt ſi charmant Qu'une inconſtance mutuelle.	Quand on suit une amour nouvelle, C'est une trahison cruelle De laisser dans l'engagement On elelar lenure et plahe s Mais rien n'est si charmant Qu'une inconstance mutuelle.
LEROY, &MEDEE.	LEROY, etMEDEE.
Heureux deux Amants inconſtants, Quand ils le ſont en meſme temps.	Heureux deux Amants inconstants, Quand ils le sont en même temps.
SCENE TROISIESME.	SCÈNE -TROISIÈME.
ARCAS, LE ROY, MEDE’E, DORINE, Suivans du Roy.	ARCAS, LE ROY, MÉDÉDÉE, DORINE, Suivants du Roi.
ARCAS.	ARCAS.
Eigneur, ſongez à vous.	Eigneur, songez à vous.
LE ROY.	LE ROY.
Quel malheur nous menace?	Quel malheur nous menace?
ARCAS.	ARCAS.
Theſée est ſi puiſſant qu’il peut vous allarmer, Ses glorieux Exploits charment la Populace, Au lieu d’un Heritier qui manque à voſtre Race, Pour vostre Succeſſeur on le veut proclamer.	Thesée est si puissant qu'il peut vous alarmer, Ses glorieux Exploits charment la Populace, Au lieu d'un Héritier qui manque à votre Race, Pour votre Successeur on le veut proclamer.
LE ROY.	LE ROY.
Il ſalil arreſter cel ahdate.	Il salil arrêter cel ahdate.
SCENE QVATRIESME.	SCÈNE QUATRIÈME.
DORINE, ARCAS.	DORINE, ARCAS.
DORINE.	DORINE.
Emeure, eſcoute un mot, Arcas.	Emeure, écoute un mot, Arcas.
IINOTD.	IINOTD.
Mon devoir prés du Roy m’appelle, Il faut que je ſuive ſes pas.	Mon devoir près du Roi m'appelle, Il faut que je suive ses pas.
DORINE.	DORINE.
Autrefois tù m’estois fidelle, Tu jurois de m’aimer d’une ardeur éternelle.	Autrefois tù m'étais fidèle, Tu jurais de m'aimer d'une ardeur éternelle.
ARCAS.	ARCAS.
Nous sõmes dans un temps de trouble & deCõbats.	Nous sommes dans un temps de trouble et deCõbats.
DORINE.	DORINE.
Cleone a des appas, On te voit ſouvent avec elle, N'eſt-ce point une amour nouvelle Qui fait ton embaras?	Cléone a des appas, On te voit souvent avec elle, N'est-ce point une amour nouvelle Qui fait ton embarras?
Tu rougis?	Tu rougis?
tu ne réponds pas?	tu ne réponds pas?
ARCAS.	ARCAS.
Mon devoir prés du Roy m’appelle, Jl faut que je ſuive ſes pas.	Mon devoir près du Roi m'appelle, Il faut que je suive ses pas.
SCENE CINNQVIEDME.	SCÈNE CINQUIEDME.
DORINE ſeule.	DORINE seule.
’Eſt donc la tout le prix d’une amour trop ſincere.	’Est donc la tout le prix d'une amour trop sincère.
N’aimons jamais, ou n’aimons guere:	N'aimons jamais, ou n'aimons guère:
Il est dangereux d’aimer tant, Ce n’eſt pas le plus ſeur pour plaire.	Il est dangereux d'aimer tant, Ce n'est pas le plus sûr pour plaire.
Bien ſouvent on croit faire Vn Amant heureux & content, Et l’on ne fait qu’un Inconſtant.	Bien souvent on croit faire Un Amant heureux et content, Et l'on ne fait qu'un Inconstant.
SCENE SIXIESME.	SCÈNE SIXIÈME.
DeRerivi.	DeRivi.
teuples qu’on encend crier,	teuples qu'on encend crier,
PEVPLES.	PEUPLES.
Egnez, Heros indomptable;	Égnez, Héros indomptable;
N Regnez rendez, nous heureux.	 Negnez rendez, nous heureux.
DORINE.	DORINE.
Le Peuple vient icy.	Le Peuple vient ici.
Sa faveur est ſemblable Au tranſport des Cœurs amoureux;	Sa faveur est semblable Au transport des Cœurs amoureux;
L’ardeur des plus grands feux Ru ost puls vis polos coubrmote,	L'ardeur des plus grands feux Ru ost puls vis polos coubrmotte,
PEVPLES.	PEUPLES.
RegneZ, Heros indomptable, Rendee, rensde Mous Mcnrena.	Regnez, Héros indomptable, Rendee, rende Mous Mourena.
CENE SEPTIESME.	CÈNE SEPTIÈME.
THESE’E.	THÉSE'E.
Quatre Eſclaves qui portent Theſée.	Quatre Esclaves qui portent Thesée.
La Populace d'Athenes chantante.	La Populace d'Athène chantante.
Madelle de la Borde, & Madelle Baucreux, les ſieurs Marolle, & Lanneau Pages, Meſſieurs Beaumaviele, Ribon, Roſſignol, Taulet, Miracle, Deſchamps l’aiſné, Deſchants cadet, Foreſtier, Pulvigny, Buffequin, Demaſſe, Jolin, Lavernay, Servant, le Febvre, Godechot, Colin, & Liron.	Madelle de la Borde, et Madelle Baucreux, les sieurs Marole, et Lanneau Pages, Messieurs Beaumaviele, Ribon, Rossignol, Taulet, Miracle, Dêchamps l'aîné, Deschants cadet, Forestier, Pulvigni, Buffequin, Demasse, Jolin, Lavernay, Serai, Se Febvre, Godechot, Colin, et Liron.
Populace d’Amhenes dançante.	Populace d'Amhène dançante.
Quatre Hommes Grecs.	Quatre Hommes Grecs.
Les ſieurs Mayeu, Dolivet fils, Barazé, & Charlot.	Les sieurs Majeu, Dolivet fils, Barazé, et Charlot.
Quatre Femmes Grecques.	Quatre Femmes Grecques.
Les ſieurs Joubert, Leſtang Arnal & Boutville.	Les sieurs Joubert, Létang Arnal et Boutville.
Deux Vieillards dançants.	Deux Vieillards dançants.
Monſieur Dolivet, & le ſieur le Chantre.	Monsieur Dolivet, et le sieur le Chantre.
Deux Vieilles dançantes.	Deux Vieilles dançantes.
Les ſieurs Bonnard, & Magny.	Les sieurs Bonnard, et Magny.
A Populace d’Athenes ſe réjoüit de la ViVe l’on doit eſtre Vainqueur des plus grands Roys!	À Populace d'Athène se réjoüit de la ViVe l'on doit être Vainqueur des plus grands Rois!
Que l’on entende Chanter par tout ſes Exploits:	Que l'on entende Chanter par tout ses Exploits:
Ioignons nos voix.	Joignons nos voix.
Que toüjours il nous deffende, Qu’il triomphe, qu’il commande, Qu'il jouiſſe des douceurs De regner ſur tous les Cœurs.	Que toujours il nous défende, Qu'il triomphe, qu'il commande, Qu'il jouisse des douceurs De régner sur tous les Cœurs.
Meſſieurs Taulet, & Miracle.	Messieurs Taulet, et Miracle.
DOur le peu de bontemps qui nous reſte 2 Rien n'eſt ſi funeſte Qu'vn noir chagrin.	DOur le peu de bontemps qui nous reste 2 Rien n'est si funeste Qu'vn noir chagrin.
Le plaiſir ſe preſente, Chantons quand on chante, Vivons au gré du Deſtin.	Le plaisir se présente, Chantons quand on chante, Vivons au gré du Destin.
L’affreuſe Uieilleſſe Qui doit voir ſans ceſſe La Mort s'aprocher, Trouve aſſeZ la Triſteſſe Sans la chercher.	L'affreuse Uillesse Qui doit voir sans cesse La Mort s'approcher, Trouve assez la Tristesse Sans la chercher.
Erς3 Achevons nos vieux ans ſans allarmes;	Er3 Achevons nos vieux ans sans alarmes;
La Uie à des charmes D ij Juſqu'à la fin.	La Uie à des charmes D' aj Jusqu'à la fin.
Le plaiſir ſe preſente, Chantons quand on chante, Vivons au gré du Deſtin.	Le plaisir se présente, Chantons quand on chante, Vivons au gré du Destin.
L’affreuſe Uieilleſſe Qui doit voir ſans ceſſe La Mort s’aprocher, Trouve aſſeZ la Triſteſſe Sans la chercher.	L'affreuse Uillesse Qui doit voir sans cesse La Mort s'approcher, Trouve assez la Tristesse Sans la chercher.
Le Chœur.	Le Chœur.
Que la Victoire Le comble icy de gloire;	Que la Victoire Le comble ici de gloire;
Suivons, aimons ſes Loix.	Suivons, aimons ses Lois.
Que l’on entende Chanter par tout ſes Exploits:	Que l'on entende Chanter par tout ses Exploits:
Ioignons nos voix.	Joignons nos voix.
Que toûjours il nous deffende, Qu'il triomphe, qu'il commande, Qu’il jouiſſe des douceurs De regner ſur tous les Cœurs.	Que toujours il nous défende, Qu'il triomphe, qu'il commande, Qu'il jouisse des douceurs De régner sur tous les Cœurs.
THESE’E.	THÉSE'E.
l’Est aſſez, amis, c’eſt aſſez, AlleZ, & que chacun en bon ordre ſe rende Aux endroits qu’au beſoin il faudra qu’il deffende:	l'Est assez, amis, c'est assez, Allez, et que chacun en bon ordre se rende Aux endroits qu'au besoin il faudra qu'il défende:
AlleZ, je ſuis content de vos ſoins empreſſez, Si vous voulez que je commande, Allez, allez, obeïſſez.	Allez, je suis content de vos soins empressez, Si vous voulez que je commande, Allez, allez, obéissez.
Les Peuples ſe retirent.	Les Peuples se retirent.
Theſée veut entrer dans l’Appartement du Roy, Medée en ſort qui arreſte Theſée.	Thesée veut entrer dans l'Appartement du Roi, Medée en sort qui arrête Thesée.
SCENE HVITIESME.	SCÈNE HVITIESME.
MEDEE, IHESEE.	MÈDE, IHESEE.
2 MEDE’E.	2 MÈDE.
Heſee outourez-vous?	Hése outourez-vous?
que pretendeZ-vous faire?	que prétendez-vous faire?
IIIEJEL.	IIIEJEL.
mhercher le Roy, le voir, & calmer ſa colere.	mhercher le Roi, le voir, et calmer sa colère.
MEDE’E.	MÈDE.
Le Roy ſouffrira-til que vous donnieZ la loy?	Le Roi souffrira-til que vous donniez la loi?
THESE’E.	THÉSE'E.
Il n'aura pas tien de ſe plaindre, Si l’on a trop d’ardeur pour moy, C’eſt un feu que j’ay ſoin d’eſteindre.	Il n'aura pas tien de se plaindre, Si l'on a trop d'ardeur pour moi, C'est un feu que j'ai soin d'éteindre.
MEDE’E.	MÈDE.
Vous eſtes de trop bonne foy;	Vous êtes de trop bonne foi;
Quand on a fait trembler un Roy, ApreneZ qu’on en doit tout craindre.	Quand on a fait trembler un Roi, Aprenez qu'on en doit tout craindre.
THESEE.	THESEE.
Sans un charme puiſſant qui m'attache à ſa Cour I'irois chercher ailleurs une guerre nouvelle.	Sans un charme puissant qui m'attache à sa Cour J'irais chercher ailleurs une guerre nouvelle.
La Gloire m’enflama deZ que je vis le jour, Tout mon Cœur eſtoit fait pour elle;	La Gloire m'enflama deZ que je vis le jour, Tout mon Cœur était fait pour elle;
Mais dans un jeune Cœur, la Gloire la plus belle Puinunjomnaut place à l’Amour.	Mais dans un jeune Cœur, la Gloire la plus belle Puinunjomnaut place à l'Amour.
MEDE’E.	MÈDE.
Vn peu d’amoureuſe tendreſſe Sied bien aux plus fameux Vainqueurs;	Un peu d'amoureuse tendresse Sied bien aux plus fameux Vainqueurs;
Si l’Amour eſt une foibleſſe, C’eſt la foibleſſe des grands Cœurs.	Si l'Amour est une faiblesse, C'est la faiblesse des grands Cœurs.
TUDIUN, que rien ne vous allarme I'obligeray le Roy de vous tout accorder.	TUDIUN, que rien ne vous alarme J'obligerai le Roi de vous tout accorder.
THESE’E.	THÉSE'E.
C eſt, la pehe XEgle qui iit enarine, Elle eſt l’unique prix que je veux demander.	Ç est, la phe XÉgli qui jit enarine, Elle est l'unique prix que je veux demander.
MEDEL.	MÉDEL.
C’eſt Æglé?	C'est Glé?
dites-vous, Æglé, qui vous engage?	dites-vous, Églé, qui vous engage?
THESE’E.	THÉSE'E.
Ie ſçay que la Grandeur a pour vous des attraits, RegneZ avec le Roy, regnez, tous deux en paix, Æglé, l’aimable Æglé, n’eſt qu’un trop beau Pairse:	Je sais que la Grandeur a pour vous des attraits, Regnez avec le Roi, régnez, tous deux en paix, Églé, l'aimable Églé, n'est qu'un trop beau Pairse:
MEDE’E.	MÈDE.
Ie crains pour voſtre amour un obstacle fatal.	Je crains pour votre amour un obstacle fatal.
THESE’E.	THÉSE'E.
Si Medée eſt pour moy qui peut m’eſtre contraire?	Si Medée est pour moi qui peut m'être contraire?
MEDE’E.	MÈDE.
Vous aveZ le Roy pour Rival.	Vous avez le Roi pour Rival.
THESE’E.	THÉSE'E.
Malgre ſa foy promiſe, Ægle pourroit luy plaires	Malgré sa foi promise, Ægle pourroit lui plairez
MEDE’E.	MÈDE.
LaiſſeZ-moy voir Æglé, laiſſeZ-moy voir le Roy, Vous connoiſtrez, bien-toſt les ſoins que je vais AlleZ, allez, m’attendre, Et fieZ-vous a moy.	Laissez-moi voir Églé, laissez-moi voir le Roi, Vous connaîtrez, bientôt les soins que je vais Allez, allez, m'attendre, Et fiez-vous a moi.
prendre Theſée paſſe dans l’Appartement de Medée.	prendre Thesée passe dans l'Appartement de Medée.
SCENE NEVFIESME.	SCÈNE NEUFIESME.
MEDE’E.	MÈDE.
Seule.	Seule.
Epit mortel, Tranſport jaloux, D Je m’abandonne à vous.	Épit mortel, Transport jaloux, D Je m'abandonne à vous.
Et toy, meurs pour jamais, Tendreſſe trop fatale;	Et toi, meurs pour jamais, Tendresse trop fatale;
Que le barbare Amour, que j’avois creu ſi doux, Se change dans mon Cœur en Furie infernale.	Que le barbare Amour, que j'avais cru si doux, Se change dans mon Cœur en Furie infernale.
Dépit mortel, Tranſport jaloux, Ie m'abandonne à voüs.	Dépit mortel, Transport jaloux, Je m'abandonne à vus.
Ah!	Ah!
ſi l’Ingrat que j’aime échape à mon couroux, Au moins, n’épargnons pas mon heureuſe Rivale.	si l'Ingrat que j'aime échappe à mon courroux, Au moins, n'épargnons pas mon heureuse Rivale.
D'épit mortel, Tranſport jaloux, Ie m’abandonne a vous.	D'épit mortel, Transport jaloux, Je m'abandonne à vous.
*3	*3
Fin du ſecond Acte.	Fin du second Acte.
ACTE TROISIESME.	ACTE -TROISIÈME.
SCENE PREMIERE.	SCÈNE PREMIÈRE.
ÆGLE', C.	ÆGLE', Ç.
LEONE.	LEONE.
Vc CLEONE.	Vc CLÉONE.
Ous alleZ voir bien-toſt voſtre Amant dans ces Lieux.	Ous allez voir bientôt votre Amant dans ces Lieux.
{ ÆGLE'.	{ GLÉ.
Ie le verray Victorieux.	Je le verrai Victorieux.
Apres de mortelles allarmes Qu’un bien-heureux retour eſt doux pour les AXibaills.	Après de mortelles alarmes Qu'un bienheureux retour est doux pour les AXibaills.
L’Amour s’accroiſt par les tourments, Les piens quit ſait payer avec le plus de larmes N’en deviennent que plus charmants.	L'Amour s'accroît par les tourments, Les piens quit sait payer avec le plus de larmes N'en deviennent que plus charmants.
CLEONE.	CLÉONE.
Theſée eſt triomphãt, chacun le veut pour Maiſtre.	Thesée est triomphant, chacun le veut pour Maître.
ÆGLE'.	ÆGLE'.
Ne verray-je point paraiſtre Vn ſi glorieux Vainqueur?	Ne verrai-je point paraître Un si glorieux Vainqueur?
Il negligera peut-eſtré Au cortuuent de iluis cum.	Il négligera peut-être Au cortuent de iluis ;
CLEONE.	CLÉONE.
On n’eſt pas inconſtant pour aimer la Uictoire.	On n'est pas inconstant pour aimer la Uictoire.
Si le paſſage eſt beau de l.	Si le passage est beau de l.
Amour à la Gloire, Rien n’eſt ſi doux que le retour De la Gloire à l’Amour.	Amour à la Gloire, Rien n'est si doux que le retour De la Gloire à l'Amour.
ÆGLE'.	ÆGLE'.
Non, ſon amour n’eſt point extreſme:	Non, son amour n'est point extrême:
Faut-il qu’il trouve ailleurs tãt de ſoins importãts?	Faut-il qu'il trouve ailleurs tant de soins importants?
A ilignore pas que je vatme, Il doit ſonger que je l’attens.	À ilignore pas que je vatme, Il doit songer que je l'attends.
ÆGLE', & CLEONE.	ÉGLÉE, et CLÉONE.
La Gloire n’eſt que trop preſſante, Vn Heros doit la ſuivre avec empreſſement;	La Gloire n'est que trop pressante, Un Héros doit la suivre avec empressement;
Mas deZ que la Gloire eſt contente, L’Amour doit promptement Namener dn Amahr.	Mas deZ que la Gloire est contente, L'Amour doit promptement Namener dn Amahr.
SCENE SECONDE.	SCÈNE SECONDE.
ARCAS, ÆGLE', CLEONE.	ARCAS, ÇGLÉ, CLEONE.
ARCAS.	ARCAS.
E Roy m’ordonne de vous dire EQu’il vous fera bien-toſt regner:	E Roi m'ordonne de vous dire EQu'il vous fera bientôt régner:
Rien ne trouble plus ſon Empire.	Rien ne trouble plus son Empire.
Vous tremblez?	Vous tremblez?
voſtre cœur ſoüpire?	votre cœur soupire?
Le Roy tout vieux qu’il eſt n’eſt pas à deſdaigner.	Le Roi tout vieux qu'il est n'est pas à dédaigner.
Lorſque par le feu du bel âge Vn jeune Cœur ſe ſent preßé, Dans une ardente amour ſans effort on l’engage:	Lorsque par le feu du bel âge Un jeune Cœur se sent pressé, Dans une ardente amour sans effort on l'engage:
On triomphe bien davantage Quand on enflame un Cœur que les ans ont glacé,	On triomphe bien davantage Quand on enflamme un Cœur que les ans ont glacé,
ÆGLE'.	ÆGLE'.
Si tu connois, Arcas, te trouvie qui me preſſe, Ne va point deſcouvrir la peine ou tu me vois,	Si tu connais, Arcas, te trouvie qui me presse, Ne va point découvrir la peine ou tu me vois,
CLEONE.	CLÉONE.
Di lu cuaa n oem saEimceſe.	Dis lu cua nô n saEimcese.
Fay, s’il ſe peut par ton adreſſe Que te Roy tourne aiueurs fon choux.	Fais, s'il se peut par ton adresse Que te Roi tourne aiveurs son choux.
ARCAS.	ARCAS.
Tu me donnes toûjours d’aſſeZ faſcheux emplois.	Tu me donnes toujours d'asseZ fâcheux emplois.
ÆGLE', CLEONE, & ARCAS.	ÉGLÉE', CLÉONE, et ARCAS.
Il n’eſt point de grandeur charmante Sans l’Amour & ſans ſes douceurs:	Il n'est point de grandeur charmante Sans l'Amour et sans ses douceurs:
Rien ne plaiſt, rien n’enchante, Sans l’Amour & ſans ſes douceurs:	Rien ne plaît, rien n'enchante, Sans l'Amour et sans ses douceurs:
Rien ne contente Les jeunes Cœurs Sans l’Amour & ſans ſes douceurs:	Rien ne contente Les jeunes Cœurs Sans l'Amour et sans ses douceurs:
Il n’eſt point de grandeur charmante Sans l’Amour & ſans ſes douceurs.	Il n'est point de grandeur charmante Sans l'Amour et sans ses douceurs.
SCENE TROISIESME.	SCÈNE -TROISIÈME.
MEDE’E, DORINE, ÆGLE', CLEONE, ARCAD.	MÈDE, DORINE, ÊGLÉE, CLÉLEONE, ARCAD.
P MEDE’E.	 MEDE’E.
uiteſſe ſçavez-vous ce que peut ma colere Quand on l’oblige d’eſclatter?	uitesse sçavez-vous ce que peut ma colère Quand on l'oblige d'éclater?
ÆGLE'.	ÆGLE'.
Ie prebents ne Pen falre Qui vous doive irriter.	Je prébents ne Pen falère Qui vous doive irriter.
MEDEE.	MÈDE.
Et n’eſt-ce rien que de trop plaire?	Et n'est-ce rien que de trop plaire?
ÆGLE’.	ÆGLE’.
Ie renonce à l’hymen du Roy Si je luy plais, c'eſt malgré moy.	Je renonce à l'hymen du Roi Si je lui plais, c'est malgré moi.
Ce n’eſt point dans le Rang ſupreſme Qu'on trouve les plus doux appas, Et ſouvent un bonheur extreſme Eſt plus ſeur dans un rang plus bas.	Ce n'est point dans le Rang suprême Qu'on trouve les plus doux appas, Et souvent un bonheur extrême Est plus sûr dans un rang plus bas.
MEDE’E.	MÈDE.
Vous aimez donc Theſée?	Vous aimez donc Thesée?
ah!	ah!
n’en rougiſſez pas, Il n'eſt que trop digne qu’on l’aime.	n'en rougissez pas, Il n'est que trop digne qu'on l'aime.
Ie m'intereſſe en voſtre amour;	Je m'intéresse en votre amour;
ParleZ, vous connoiſtreZ mon cœur à voſtre tour.	Parlez, vous connaîtrez mon cœur à votre tour.
ÆGLE'.	ÆGLE'.
I'avois toûjours bravé l’Amour & ſa puiſſance.	J'avais toujours bravé l'Amour et sa puissance.
Avant que d’avoir veu ce glorieux Uainqueur;	Avant que d'avoir vu ce glorieux Uainqueur;
Mais la Gloire & l’Amour tous deux d’intelligence Ne ſont que trop puiſſans pour vaincre un jeune Cœur.	Mais la Gloire et l'Amour tous deux d'intelligence Ne sont que trop puissants pour vaincre un jeune Cœur.
Que voſtre ſoin au mien reſponde, I'eſpere que le Roy deviendra voſtre Eſpoux:	Que votre soin au mien réponde, J'espère que le Roi deviendra votre Époux:
Regnez, par ſon hymen dans une paix profonde, LaiſſeZ moy ce Heros, mon ſort eſt aſſeZ doux;	Regnez, par son hymen dans une paix profonde, Laissez moi ce Héros, mon sort est assez doux;
Quand vous poſſedertes tout l'Empire du monde, Mon cœur n’en ſeroit point jaloux.	Quand vous possédertes tout l'Empire du monde, Mon cœur n'en serait point jaloux.
MEDE’E.	MÈDE.
Mais enfin, ſi le Roy commande, Vous eſtes ſoümiſe à ſa Loy.	Mais enfin, si le Roi commande, Vous êtes soumise à sa Loi.
ÆGLE'.	ÆGLE'.
Ma vie eſt au pouvoir du Roy, Et je veux bien qu'elle en deſpende:	Ma vie est au pouvoir du Roi, Et je veux bien qu'elle en dépende:
Mais c'eſt en vain qu’il demande Vn Cœur qui n'est plus a moy.	Mais c'est en vain qu'il demande Un Cœur qui n'est plus à moi.
Le 2 Vous m’en avez trop dit, il eſt temps qu’entre nous La confidence ſoit égale.	Le 2 Vous m'en avez trop dit, il est temps qu'entre nous La confidence soit égale.
Il faut vous deſgager d’une chaiſne fatale.	Il faut vous dégager d'une chaîne fatale.
ÆGLE'.	ÆGLE'.
La mort, la ſeule mort rompra des nœuds ſi doux.	La mort, la seule mort rompra des nœuds si doux.
MEDE’E.	MÈDE.
Ie veux que dés demain le Roy ſoit voſtre Eſpoux?	Je veux que dès demain le Roi soit votre Époux?
Uous aimeZ un Heros qui ne peut estre à vous, Et Medée eſt voſtre Rivale;	Uous aimez un Héros qui ne peut être à vous, Et Medée est notre Rivale;
Prente (oin deſoner mon fineſte courois,s.	Prente (oin desoner mon fineste courais,s.
ÆGLE'.	ÆGLE'.
Nos deux Cœurs ſont unis par un amour fidelle.	Nos deux Cœurs sont unis par un amour fidèle.
MEDE’E.	MÈDE.
En dépit de l’Amour je les veux diviſer.	En dépit de l'Amour je les veux diviser.
La chaiſne qui nous lie eſt ſi forte & ſi belle.	La chaîne qui nous lie est si forte et si belle.
MEDEE.	MÈDE.
I'auray plus de plaiſir ſi je la puis briſer.	J'aurai plus de plaisir si je la puis briser.
ÆGLE'.	ÆGLE'.
Non, j'aime mieux la mort qu’une laſche inconstance, Tout l'Enfer à mes yeux n’aura rien de ſi noir;	Non, j'aime mieux la mort qu'une lâche inconstance, Tout l'Enfer à mes yeux n'aura rien de si noir;
Malgré Medée & ſa vengeance, Mon amour fera ſon devoir.	Malgré Medée et sa vengeance, Mon amour fera son devoir.
MEDE’E.	MÈDE.
Voyons ſi voſtre amour est tel qu’il veut paraiſtre, Puiſque vous le vouleZ vous allez me connaiſtre:	Voyons si votre amour est tel qu'il veut paraître, Puisque vous le voulez vous allez me connaître:
1e vais vous faire voir Ce que c’eſt que Medée & quel eſt ſon pouvoir.	1e vais vous faire voir Ce que c'est que Medée et quel est son pouvoir.
La Scene change, & repreſente un Deſert eſpouventable remply de Monſtres furieux.	La Scène change, et représente un Des épouventable rempli de Monstres furieux.
SCENE QUATRIESME.	SCÈNE QUATRIÈME.
ÆGLE’, CLEONE, ARCAS, DORINE.	ÉGLÉE', CLÉONE, ARCAS, DORINE.
ÆGLE', CLEONE, & ARCAS.	ÉGLÉE', CLÉONE, et ARCAS.
Ieux!	Jeux!
où ſommes nous!	où sommes nous!
LOBEGNE.	LOBEGNE.
Que d’objets horribles!	Que d'objets horribles!
ARCAS.	ARCAS.
Quels Monstres ferribles!	Quels Monstres ferribles!
ÆGLE'.	ÆGLE'.
Quel affreux couroux!	Quel affreux courroux!
ÆGLE', CLEONE, & ARCAS.	ÉGLÉE', CLÉONE, et ARCAS.
Dieux!	Dieux!
où ſommes nous!	où sommes nous!
ÆGLE'.	ÆGLE'.
MIe laiſſeZ-vons, cruede, Dans cette horreur mortelle?	MIe laissez-vons, crède, Dans cette horreur mortelle?
eis er trcne.	évis er treine.
ols pree tcerſes codo e.	ols prée terses codo eu.
ÆGLE', CLEONE, & ARCAS.	ÉGLÉE', CLÉONE, et ARCAS.
Dieux!	Dieux!
où ſommes nous?	où sommes nous?
SCENE CINQUIESME.	SCÈNE CINQUIÈME.
CLEONE, ARCAS, DORINE.	CLÉONE, ARCAS, DORINE.
CLEONE.	CLÉONE.
Ontre ce Monſtre qui m'allarme, Vien me deffendre Arcas.	Ontre ce Monstre qui m'alarme, Viens me défendre Arcas.
ARCAS.	ARCAS.
Ne crain rien avant mon treſpas.	Ne crain rien avant mon trépas.
O Ciel!	Ô Ciel!
on me deſarme!	on me désarme!
Un Fantoſme emporte en volant l’Eſpée d’Arcas.	Un Fantôme emporte en volant l'Espée d'Arcas.
Tu peux beaucoup icy, belle Dorine, helas!	Tu peux beaucoup ici, belle Dorine, hélas!
Ne l'abandonne pas.	Ne l'abandonne pas.
CLEONE, & ARCAS.	CLÉONE, et ARCAS.
Belle, Dorine, helas!	Belle, Dorine, hélas!
A m’abandonne L l’abandonne- pas.	À m'abandonne L 'abandonne- pas.
DORINE.	DORINE.
Il eſt bon d’eſtre neceſſaire;	Il est bon d'être nécessaire;
C’eſt un charme puiſſant pour plaire Où peu de Cœurs ont reſiſté:	C'est un charme puissant pour plaire Où peu de Cœurs ont résisté:
Un grand ſecours qu’on eſpere Eſt un grand trail de peaute.	Un grand secours qu'on espère Est un grand trail de peaute.
IRCAS.	JRCAS.
Ce n’eſt pas d’aujourd’huy que je te trouve belle.	Ce n'est pas d'aujourd'hui que je te trouve belle.
CLEONE.	CLÉONE.
Où pourroit-il voir plus d’attrais?	Où pourrait-il voir plus d'attrais?
DORINE.	DORINE.
It ſpuis trop coſere umour nouvelle.	It spuis trop cosere umour nouvelle.
ARCAS, & CLEONE.	ARCAS, et CLÉONE.
Non, non, je le promets, Non, je ne l’aimeray jamais.	Non, non, je le promets, Non, je ne l'aimerai jamais.
DORINE.	DORINE.
Pour ſe tirer de peine Chacun promet aſſez;	Pour se tirer de peine Chacun promet assez;
Mais Mais la promeſſe eſt vaine Qui pque tes pertis jont paſſeZ	Mais Mais la promesse est vaine Qui pque tes pertis jontis passés
ARCAS, & CLEONE.	ARCAS, et CLÉONE.
Eee Geure polins els ina promejes	Eee Geure polins éls ina promèjes
DORINE.	DORINE.
Non, je ne prétens point regagner deſormais D’un ſi volage Amant la trompeuſe tendreſſe;	Non, je ne prétends point regagne désormais D'un si volage Amant la trompeuse tendresse;
Non, non, je le promets;	Non, non, je le promets;
Non, je ne l’aimeray jamdis.	Non, je ne l'aimerai jamdis.
CLEONE, ARCAS, & DORINE.	CLÉONE, ARCAS, et DORINE.
Non, non, je le promets, Non, je ne l’aimeray jamais.	Non, non, je le promets, Non, je ne l'aimerai jamais.
SCENE SIXIESME.	SCÈNE SIXIÈME.
MEDE’E, CLEONE, ARCAS, DORINE.	MEDE’A, CLÉONE, ARCAS, DORINE.
MEDE’E.	MÈDE.
nomme morrououe poim, qu'on leur ouvre un 2 paſſage.	nomme morroue poim, qu'on leur ouvre un 2 passage.
C’eſt ſur d’autres que vous que doit tõber ma rage, FuyeZ de ce funeſte lieu.	C'est sur d'autres que vous que doit tomber ma rage, FuyeZ de ce funeste lieu.
CLEONE, & ARCAS.	CLÉONE, et ARCAS.
Adieu, Dorine, adieu.	Adieu, Dorine, adieu.
SCENE SEPTIESME.	SCÈNE SEPTIÈME.
Medée invoque les Habitans des Enfers.	Medée invoque les Habitants des Enfers.
La Rage.	La Rage.
Le ſieur Jolin.	Le sieur Jolin.
Le Deſeſpoir.	Le Désespoir.
Le ſieur le Febvre.	Le sieur le Febre.
Vingt-quatre Habitants des Enfers chantants.	Vingt-quatre Habitants des Enfers chantants.
Les ſieurs Deſtival, Baumont, Bony, Gillet, Rebel, Le Maire, Roſſignol, Miracle, Thaulet, Goudonneſche, Foreſtier, Ribon, Vaïſſe, Buffequin, Colin, Martial, Demaſſe, Deſchamps l’aiſné, Deſchants cadet, Lavernay, Liron, Seguin, Godechot, & Servant.	Les sieurs Destival, Baumont, Boni, Gillet, Rebel, Le Aire, Rossignol, Miracle, Thaulet, Goudonnesche, Forestier, Ribon, Vaïsse, Buffequin, Colin, Martial, Demasse, Déchamps l'aîné, Deschants cadet, Lavernay, Liron, Seguin, Godechot, et Servant.
Douze Lutins dançants.	Douze Lutins dançants.
Monfieur Bauchamp.	Monfieur Bauchamp.
Les ſieurs Favier l’aiſné, Favier cadet, De Leſtang Patire, Ivagny, joubert, rorgnart, emcaſſſieau, Des-Airs, De Benne, & Pecourt.	Les sieurs Favier l'aîné, Favier cadet, De Létang Patire, Ivagny, joubert, rorgnart, emcassieau, DésAirs, De Benne, et Pécourt.
Vn Fantoſme.	Un Fantôme.
Le ſieur Allard.	Le sieur Allard.
MEDE’E.	MÈDE.
Ortez, Ombres, ſortez de la Nuit eternelle.	Ortez, Ombres, sortez de la Nuit éternelle.
Q VoyeZ le jour pour le troubler.	Q VoyeZ le jour pour le troubler.
Hastez-vous d’obeir quand ma voix vous appelle, Que l’affreux Deſeſpoir, que la Rage cruelle Prennent jemn uit vous aſſembler.	Hâtez-vous d'obéir quand ma voix vous appelle, Que l'affreux Désespoir, que la Rage cruelle Prennent jemn ent vous assembler.
SorteZ, Ombres, ſorteZ de la Nuit eternelle.	Sortez, Ombres, sortez de la Nuit éternelle.
Sortons de la Nuit eternelle.	Sortons de la Nuit éternelle.
MEDE’E.	MÈDE.
VeneZ Peuple infernal, venez, AvanceZ malheureux Coupables, Soyez aujourd’huy deſchaiſnez:	VeneZ Peuple infernal, venez, Avancez malheureux Coupables, Soyez aujourd'hui déchaînez:
Gouſtez, l’unique bien des Cœurs infortuneZ Ne foyons pas ſeuls miſerables.	Goûtez, l'unique bien des Cœurs infortuneZ Ne soyons pas seuls misérables.
Le Chœur.	Le Chœur.
Goustons l’unique bien des Cœnrs infortuneZ Ne ſoyons pas ſeuls miſerables.	Goûtons l'unique bien des Cœnrs infortunés Ne soyons pas seuls misérables.
3	3
MEDE’E.	MÈDE.
RedoubleZ en ce jour le ſoin que vous prenez De mes vengeances redoutables.	Redoublez -en ce jour le soin que vous prenez De mes vengeances redoutables.
Le Chœur.	Le Chœur.
OrdonneZ, ordonnez.	Ordonnez, ordonnez.
MEDE’E.	MÈDE.
Ma Rivale m’expoſe à des maux effroyables;	Ma Rivale m'expose à des maux effroyables;
Qu'elle ait part au tourments qui vous ſont destinez:	Qu'elle ait part au tourments qui vous sont destinez:
Tous les Enfers impitoyables Auront peine à former des horreurs comparables Aux troubles qu'elle m’a donnez,:	Tous les Enfers impitoyables Auront peine à former des horreurs comparables Aux troubles qu'elle m'a donnez,:
Goustons l'unique bien des Cœurs infortuneZ, Ne ſoyons pas ſeuls miſerables.	Goûtons l'unique bien des Cœurs infortunés, Ne soyons pas seuls misérables.
Le Chœur.	Le Chœur.
Goustons l’unique bien des Cœurs infortune.	Goûtons l'unique bien des Cœurs infortune.
Ne ſoyons pas ſeuls miſerables.	Ne soyons pas seuls misérables.
HESEE Les Habitants des Enfers expriment la douceur qu’ils trouvent dans les ordres que Medée leur donne de donner des frayeurs, & de faire de la pomouiiegro	HÉSE Les Habitants des Enfers expriment la douceur qu'ils trouvent dans les ordres que Medée leur donne de donner des frayeurs, et de faire de la pomouiègro
Le Chœur.	Le Chœur.
N nout tourmente Sans ceſſe aux Enfers, Que l’on reſſente Nos feux & nos fers.	 Nout tourmente Sans cesse aux Enfers, Que l'on ressente Nos feux et nos fers.
Tout doit ſe troubler, Tout doit trembler.	Tout doit se troubler, Tout doit trembler.
La Colere Ne laiſſe jamais Nos Cœurs en paix;	La Colère Ne laisse jamais Nos Cœurs en paix;
Les plaintes qu’on peut faire Nous doivent toujours plaire, Et nous ne plaignons guere Les yeux qui ſont en pleurs:	Les plaintes qu'on peut faire Nous doivent toujours plaire, Et nous ne plaignons guère Les yeux qui sont en pleurs:
Dans la Rage, Les maux qu'on partage Ne ſont pas ſans douceurs.	Dans la Rage, Les maux qu'on partage Ne sont pas sans douceurs.
E3 On nous deſchaine, Suivons nos fureurs;	E3 On nous déchaine, Suivons nos fureurs;
Dans nostre peine Troublons tous les Cœurs.	Dans notre peine Troublons tous les Cœurs.
Un grand deſeſpoir Eſt doux a voir.	Un grand désespoir Est doux a voir.
La Colere Ne laiſſe jamais Nos Cœurs en paix;	La Colère Ne laisse jamais Nos Cœurs en paix;
Nous doivent toüjours plaire, Et nous ne plaignons guere Les yeux qui ſont en pleurs:	Nous doivent toujours plaire, Et nous ne plaignons guère Les yeux qui sont en pleurs:
Dans la Rage, Les maux qu’on partage Ne ſont pas ſans douceurs.	Dans la Rage, Les maux qu'on partage Ne sont pas sans douceurs.
SCENE HUITIESME.	SCÈNE HUITIÈME.
ÆGLE’, HABITANS DES ENFERS.	ÆGLE’, HABITANS DES ENFERS.
Es Habitans des Enfers eſpouvantent Æglé, Delle les fuit, & ils la ſuivent.	Es Habitants des Enfers épouvantent Églé, Delle les fuit, et ils la suivent.
Le Chœur.	Le Chœur.
Ve tout fremiſſe:	Ve tout frémisse:
Qu'avec nous tout gemiſſe:	Qu'avec nous tout gémisse:
Quelle douceur de voir ſouffrir!	Quelle douceur de voir souffrir!
ÆGLE'.	ÆGLE'.
Ah quel effroyable ſupplice!	Ah quel effroyable supplice!
Faites moy promptement mourir.	Faites -moi promptement mourir.
Le Chœur.	Le Chœur.
Que tout fremiſſe:	Que tout frémisse:
Qu'avec nous tout gemiſſe:	Qu'avec nous tout gémisse:
Quelle douceur de voir ſouffrir!	Quelle douceur de voir souffrir!
Fin du troiſieſme Acte.	Fin du troisième Acte.
ACTE QUATRIESME SCENE PREMIERE.	ACTE QUATRIÈME SCÈNE PREMIÈRE.
ÆGLE’, MEDE’E.	ÆGLE’, MÉDÉE.
ÆGLE'.	ÆGLE'.
Ruelle, ne voulez-vous pas Faire ceſſer ma peine?	Ruelle, ne voulez-vous pas Faire cesser ma peine?
Au moins acheveZ, Inhumaine, AcheveZ mon treſpas.	Au moins achevez, Inhumaine, Achevez mon trépas.
MEDE’E.	MÈDE.
Satisfaites le Roy, contenteZ mon envie, Si vous vouleZ ſortir de cét affreux ſejour.	Satisfaites le Roi, contentez mon envie, Si vous voulez sortir de cet affreux séjour.
ÆGLE.	ÆGLE.
Helas!	Hélas!
laiſſeZ-moy mon amour, a voite & prurojy nnex Ovc.	laissez-moi mon amour, a voite et pruroji nnex Ouc.
MEDE’E.	MÈDE.
Ma rage en vous perdant ne peut eſtre aſſouvie, C’eſt grace, c’eſt pitié de vous oſter le jour.	Ma rage en vous perdant ne peut être assouvie, C'est grâce, c'est pitié de vous ôter le jour.
ÆGLE'.	ÆGLE'.
Vouetrez beau me pourſuivre, Vous aurez beau m'allarmer,	Vouetrez beau me poursuivre, Vous aurez beau m'alarmer,
Que je puis ceſſer d’aimer.	Que je puis cesser d'aimer.
MEDE’E.	MÈDE.
Achevez, de ſçavoir dequoy je ſuis capable;	Achevez, de Savoir dequoy je suis capable;
La plus horrible mort n’a rien de comparable Au coûp qui vous menace en ce fatal inſtant:	La plus horrible mort n'a rien de comparable Au coup qui vous menace en ce fatal instant:
Moy-méme j'en fremis tant il eſt effroyable.	Moi-même j'en frémis tant il est effroyable.
ÆGLE'.	ÆGLE'.
Eſt-ce un crime ſi puniſſable D’avoir un cœur tendre & conſtant?	Est-ce un crime si punissable D'avoir un cœur tendre et constant?
MEDE’E.	MÈDE.
At tt eſt que trop aise de perter un tunr tenare, Toute ma rage enfin va paroiſtre à vos yeux.	At tt est que trop aise de perter un tun tenare, Toute ma rage enfin va paraître à vos yeux.
ÆGLE'.	ÆGLE'.
Quel ſpectacle vient me ſurprendre?	Quel spectacle vient me surprendre?
C’eſt Theſée endormy qu’on tranſporte en ces lieux.	C'est Thesée endormi qu'on transporte en ces lieux.
Theſée endormy deſcend conduit par des Spectres volafits.	Thesée endormi descend conduit par des Spectres volàfits.
SCENE SECONDE.	SCÈNE SECONDE.
MEDE’E, ÆGLE', THESE’E endormy.	MÈDE, ÆGLE', THESE’E endormi.
V MEDE’E.	V VÉDE'E.
Enez à mon ſecours implacables Furies.	Énez à mon secours implacables Furies.
Que le ſang innocent recommence à couler;	Que le sang innocent recommence à couler;
Il faut encor nous ſignaler	Il faut encor nous signaler
Par de nouvelles barbaries, Venez à mon ſecours implacables Furies.	Par de nouvelles barbaries, Venez à mon secours implacables Furies.
Les Furies ſortent tenant un Tiſon ardent d’une main, & un Couſteau de l’autre.	Les Furies sortent tenant un Tison ardent d'une main, et un Couteau de l'autre.
SCENE TROISIESME.	SCÈNE -TROISIÈME.
dDo da, ABOnn rnon L endormy, les Furies.	dDo da, ABOnf ron L endormi, les Furies.
ÆGLE’.	ÆGLE’.
Aut-il voir contre moy tous les Enfers armez?	Aut-il voir contre moi tous les Enfers armés?
MEDE’E.	MÈDE.
Tremvte Zen aprenant quet eſt voſtre ſuplice.	Tremute Zen apenant quet est votre suplice.
Voſtre Amant va perir, c’eſt vous qui m’animez, A m'en faire à vos yeux un affreux ſacrifice.	Votre Amant va périr, c'est vous qui m'animez, À m'en faire à vos yeux un affreux sacrifice.
ÆGLE'.	ÆGLE'.
Vous pouvez vouloir qu’il periſſe?	Vous pouvez vouloir qu'il périsse?
Et vous dites que vous l’aimeZ:	Et vous dites que vous l'aimez:
MEDE’E.	MÈDE.
Il faut voir qui des deux l’aimera davantage, Plutoſt que le cedder, j'aime mieux que la Mort En faſſe entre nous le partage, Et l’Amour n'en eſt que plus fort Quand il paſſe juſqu'a la rage.	Il faut voir qui des deux l'aimera davantage, Plutôt que le céder, j'aime mieux que la Mort En fasse entre nous le partage, Et l'Amour n'en est que plus fort Quand il passe jusqu'a la rage.
Elle parle aux Furies.	Elle parle aux Furies.
DépecheZ, acheveZ voſtre ſanglant ouvrage.	DépecheZ, achevez votre sanglant ouvrage.
Arreſtez,, retenez leurs coups, I'eſpouſeray le Roy, je ſuivray voſtre envie:	Arrêtez, retenez leurs coups, J'épouserai le Roi, je suivrai votre envie:
Ie cedde ce Heros, que ſon cœur ſoit à vous, Men ne im eſt ſl eber que ja ole.	Je cédède ce Héros, que son cœur soit à vous, Men ne im est sl eber que ja ole.
MEDE’E.	MÈDE.
Mais aurez-vous bien le pouvoir De luy paroiſtre ingrate, inſenſible, volage?	Mais aurez-vous bien le pouvoir De autre paraître ingrate, insensible, volage?
ÆGLE'.	ÆGLE'.
C eſt tuy falre un cruel olbrage, J’aimerois mieux ne le point voir.	Ç est tui falre un cruel olbrage, J'aimerais mieux ne le point voir.
MEDE’E.	MÈDE.
Non il faut luy montrer une ame deſloyale Qui l’immole ſans peine à la Grandeur Royale Ruiues oſine ja ſoindray dagir en du ſudeut:	Non il faut lui montrer une âme déloyale Qui l'immole sans peine à la Grandeur Royale Rues osine ja soindrai dagir en du sudeut:
Enfin je veux gagner ſon cœur Par le jecours de ma Ruale.	Enfin je veux gagner son cœur Par le jecours de ma Ruale.
ÆGLE'.	ÆGLE'.
Dieux!	Dieux!
quelle contrainte fatale!	quelle contrainte fatale!
MEDE’E.	MÈDE.
Pour le prix de ſes jours attirez ſes mépris, Ou je vais.	Pour le prix de ses jours attirez ses mépris, Ou je vais.
ÆGLE'.	ÆGLE'.
Non, qu’il vive, il n’importe à quel prix:	Non, qu'il vive, il n'importe à quel prix:
Ie veux tout, je puis tout pour ſauver ce que j’aime;	Je veux tout, je puis tout pour sauver ce que j'aime;
Mon amour vous promet de ſe trahir luy-meſme.	Mon amour vous promet de se trahir lui-même.
MEDE’E.	MÈDE.
CeſſeZ donc de trembler;	Cessez donc de trembler;
voyeZ en un moment Changer ces lieux affreux en un Sejour charmant.	voyez -en un moment Changer ces lieux affreux en un Séjour charmant.
Les Furies rentrent dans les Enfers, le Theatre change, & repreſente une Iſſe Enchantée.	Les Furies rentrent dans les Enfers, le Théâtre change, et représente une Isse Enchantée.
SCENE QUATRIESME.	SCÈNE QUATRIÈME.
MEDE’E, THESEE, ÆGLE'.	MÉDÉLA, THESEE, ÉGLÉ.
MEDE’E touchant Theſée de ſa Baguette Magique.	MÈDE touchant Thesée de sa Baguette Magique.
J'Oyez ce que j'ay ſoin de faire V Pour un trop malheureux Amant.	J'Oyez ce que j'ai soin de faire V Pour un trop malheureux Amant.
TIILOEBeveme ce rogardant diriabit magnifique & galant dont il eſt paré.	TIILOEBeême ce rogardant diriabit magnifique et galant dont il est paré.
Où ſuis-je?	Où suis-je?
& d’où me vient ce nouvel ornement?	et d'où me vient ce nouvel ornement?
MPEDEE.	MPEDE.
I'ay voulu vous aider à plaire.	J'ai voulu vous aider à plaire.
THESE’E ſe voyant ſans Eſpée.	THÉSE'E se voyant sans Épée.
Mon Espée!	Mon Espée!
ab rendez-la moy.	ab rendez-la moi.
MEDE’E.	MÈDE.
On va vous l’apporter.	On va vous l'apporter.
Si vous craignez le Roy, Ie ſeray vos plus fortes armes.	Si vous craignez le Roi, Je serai vos plus fortes armes.
THESE’E.	THÉSE'E.
Apres tout ce que je vous doy.	Après tout ce que je vous dois.
Il aperçoit Æglé.	Il aperçoit Æglé.
Eſt-ce vous?	Est-ce vous?
ma Princeſſe, eſt-ce vous que je voy?	ma Princesse, est-ce vous que je vois?
Mais où détournez-vous vos regards pleins de charmes?	Mais où détournez-vous vos regards pleins de charmes?
MEDE’E.	MÈDE.
Quoy?	Quoi?
vous ne toürnez pas les yeux Sur un Amant ſi glorieux?	vous ne tendrez pas les yeux Sur un Amant si glorieux?
THESE’E.	THÉSE'E.
Belle AEgie, dit&-moy, quet crime ay-je pufaires	Belle AÉgie, dit-moi, quet crime ai-je pufaires
MEDE’E.	MÈDE.
N’aprehendeZ vous point qu’on oſe ſe vanger?	N'appréhendez -vous point qu'on ose se venger?
THESE’E.	THÉSE'E.
vonr, cue dbvra veai Mumrraxer s Elle me ſera toûjours chere.	vonr, cue d' une Mumrraxer s Elle me sera toujours chère.
MEDE’E.	MÈDE.
Tant d’amour ne vous touche pas?	Tant d'amour ne vous touche pas?
Ingrate, croyez-vous qu’un Thrône ait ple d’appas?	Ingrate, croyez-vous qu'un Thrône ait ple d'appas?
THESE’E.	THÉSE'E.
Vous m’avieZ tant promis de n’eſtre point legere?	Vous m'aviez tant promis de n'être point légère?
MEDE’E.	MÈDE.
Dequoy ne vient point à bout Vn Roy qui veut plaire?	Dequoy ne vient point à bout Un Roi qui veut plaire?
La conſtance ne tient guere Contre un Amant qui peut tout.	La constance ne tient guère Contre un Amant qui peut tout.
Le Roy doit redouter que mon dépit n’éclate:	Le Roi doit redouter que mon dépit n'éclate:
Pour regagner ſon cœur, je vais encor le voir.	Pour regagner son cœur, je vais encor le voir.
Eſſayez, cependant, d’attendrir cette Ingrate?	Essayez, cependant, d'attendrir cette Ingrate?
Si tous nos ſoins unis ne peuvent l’émouvoir, Voſtre amour ſeul peut-eſtre aura plus de pouvoir.	Si tous nos soins unis ne peuvent l'émouvoir, Votre amour seul peut-être aura plus de pouvoir.
SCENE CINQUIESME.	SCÈNE CINQUIÈME.
AIIEDLE, IEGIE.	ÀIIEDLE, IEGIE.
THESE’E.	THÉSE'E.
Glé ne m’aime plus, & n’a rien à me dire?	Glé ne m'aime plus, et n'a rien à me dire?
Quavez vous fait des nœuds que l’Amour fit pour nous?	Quavez -vous fait des nœuds que l'Amour fit pour nous?
Quoy pour les briſer tous.	Quoi pour les briser tous.
Vn jour, un ſeul jour peut ſuffire?	Un jour, un seul jour peut suffire?
l’aurois abandonné le plus puiſſant Empire Pour garder des liens ſi doux.	l'aurais abandonné le plus puissant Empire Pour garder des liens si doux.
ÆGLE'.	ÆGLE'.
Ceſſte daimer une volâge;	Cesste daimer une volâge;
Servez-vous de voſtre courage Pour chercher un plus heureux ſort.	Servez-vous de votre courage Pour chercher un plus heureux sort.
THESE’E.	THÉSE'E.
Je ne m'en ſerviray que pour chercher la mort.	Je ne m'en servirai que pour chercher la mort.
Omumoeue dEgie m'eſt ravie Ie ne pretens plus rien:	Omumoève dÉgie m'est ravie Je ne prétends plus rien:
It pers lunique bien Qui m'auroit fait aimer la vie.	It pers unique bien Qui m'aurait fait aimer la vie.
Helas!	Hélas!
ÆGLE'.	ÆGLE'.
THESE’E.	THÉSE'E.
Ah!	Ah!
quel ſoûpir échape à voſtre Cœur?	quel soupir échappe à votre Cœur?
ÆGLE'.	ÆGLE'.
1 Juupin comupo mopa qque pon u Grandeur.	1 Juupin comupo mopa qque pon u Grandeur.
THESE’E.	THÉSE'E.
Pos veaux yeux repandent des larmess	Pos veaux yeux répandent des larmess
ÆGLE'.	ÆGLE'.
Non, non, ſans m’attendrir je verray vos douleurs.	Non, non, sans m'attendrir je verrai vos douleurs.
THESE’E.	THÉSE'E.
Vous vouleZ me cacher vos pleurs?	Vous voulez me cacher vos pleurs?
Pourquoy m'en dérober les charmes?	Pourquoi m'en dérober les charmes?
ÆGLE'.	ÆGLE'.
Ah!	Ah!
que vous me donneZ de mortelles allarmes?	que vous me donnez de mortelles alarmes?
On vous a peut-eſtre entendu Theſée, & vous eſtes perdu.	On vous a peut-être entendu Thesée, et vous êtes perdu.
THESE’E.	THÉSE'E.
On ne nous entend point, non, ma belle Princeſſe, Si vous m'aimeZ toujours ne craigneZ rie pourmoy.	On ne nous entend point, non, ma belle Princesse, Si vous m'aimez toujours ne craignez rie pourmoi.
ÆGLE.	ÆGLE.
Que nous payerons cher l’exceZ de ma tendreſſe?	Que nous payerons cher l'excès de ma tendresse?
Il y va de vos jours, j'espouſeray le Roy.	Il y va de vos jours, j'épouserai le Roi.
THESE’E.	THÉSE'E.
C’eſt trop aprehender que le Roy ne s’irrite.	C'est trop appréhender que le Roi ne s'irrite.
it jaut vons dire tont, termour men foniciie, Je ſuis fils du Roy,	it jaut vons dire tont, termour men foniciie, Je suis fils du Roi,
ÆGLE’.	ÆGLE’.
Vous, Seigneur!	Vous, Seigneur!
THESE’E.	THÉSE'E.
Je n’ay montré d’abord que ma ſeule Valeur, C’eſtoit à mon propre merite Que je voulois devoir ma gloire & voſtre cœur.	Je n'ai montré d'abord que ma seule Valeur, C'était à mon propre mérite Que je voulais devoir ma gloire et votre cœur.
ÆGLE'.	ÆGLE'.
Le Roy, le Mõde entier prendroiẽt en vain les armes, Il n’eſt rien de ſi fort que Medée, & ſes charmes, Nous ſommes les objets de ſes tranſports jaloux.	Le Roi, le Momme entier prendraient en vain les armes, Il n'est rien de si fort que Medée, et ses charmes, Nous sommes les objets de ses transports jaloux.
S’ils n’en vouloient qu’à moy je les braverois tous, Mais ils m’ont ſçeu fraper par ou je ſuis ſenſible.	S'ils n'en voulaient qu'à moi je les braverais tous, Mais ils m'ont sçeu frapper par ou je suis sensible.
a2 Quoy, le Roy ſera voſtre Epoux?	a2 Quoi, le Roi sera votre Époux?
AEGLE.	AEGLE.
Ie ne puis vous ſauver ſans cét hymen horrible.	Je ne puis vous sauver sans cet hymen horrible.
THESE’E.	THÉSE'E.
Laiſſez armer plûtoſt tout l’Enfer en couroux;	Laissez armer plutôt tout l'Enfer en courroux;
Le trépas eſt cent fois plus doux un fecours ſl lemtote, Vivez, pour moy, s’il eſt poßible, Ou laiſſez moy mourir pour vous.	Le trépas est cent fois plus doux un secours sl émtote, Vivez, pour moi, s'il est possible, Ou laissez moi mourir pour vous.
ÆGL’E, & THESE’E.	ÉGL'E, et THÉSE'E.
Quelle injuſtice!	Quelle injustice!
Que de tourments:	Que de tourments:
An quel ſuplice De briſer des nœuds ſi charmants!	An quel suplice De briser des nœuds si charmants!
SCENE SIXIESME.	SCÈNE SIXIÈME.
MEDE’E, T HESE’E, ÆGLE'.	MÈDE, T HESE’É, ÆGLE',
MEDE’E ſortant tout à coup d’un Nüage.	MÈDE sortant tout à coup d'un Nuage.
Iniſſez, vos regrets, c'ef mep, ugamep cous plaindre,	Inissez, vos regrets, c'ef mep, ugème cous plaindre,
THESE’E Je viens d’entẽdre tout il n’eſt plus temps de feindre.	THÈSE' Je viens d'entendre tout il n'est plus temps de feindre.
ÆGLE'.	ÆGLE'.
PardonneZ à l’Amour qui ne m’a pas permis De lenir ce que jay promia.	Pardonnez à l'Amour qui ne m'a pas permis De lenir ce que jay promia.
THESE’E.	THÉSE'E.
Vangez, vous ſur moy ſeul de noſtre amour extreſme.	Vengez, vous sur moi seul de notre amour extrême.
ÆGLE'.	ÆGLE'.
C’eſt par mon ſeul trépas qu’il faut nous de ſunir.	C'est par mon seul trépas qu'il faut nous de sunir.
AIIEJEL.	AIIEJEL.
Sa vie eſt la faveur que je veux obtenir.	Sa vie est la faveur que je veux obtenir.
ALGLE.	ÀLGLE.
Conſervez ce Heros, ſauveZ-le pour vous-meſme.	Conservez ce Héros, sauvez-le pour vous-même.
THESE’E, & ÆGLE'.	THÉSE'E, et ÆGLE'.
Epargnez, ce que j'aime, C’eſt moy, c’eſt moy qu’il faut punir.	Épargnez, ce que j'aime, C'est moi, c'est moi qu'il faut punir.
MEDE’E.	MÈDE.
Je vous aime, Theſée, & vous l’alleZ connaiſtre, Le crime enfin commence à me paraiſtre affreux, Ie respecte de ſi beaux nœuds, Ma rage a beau s’armer, vous en eſtes le maiſtre;	Je vous aime, Thesée, et vous l'allez connaître, Le crime enfin commence à me paraître affreux, Je respecte de si beaux nœuds, Ma rage a beau s'armer, vous en êtes le maître;
Voſtre vertu m’inspire un dépit genereux, Je rendray ce que j'aime heureux Puiſque mon amour ne peut l’eſtre.	Votre vertu m'inspire un dépit généreux, Je rendrai ce que j'aime heureux Puisque mon amour ne peut l'être.
THESE’E, &ÆGLE’.	THÉSE'E, etÆGLE’.
Quel bonheur ſurprenant pour nos Cœurs amoureux!	Quel bonheur surprenant pour nos Cœurs amoureux!
MEDE’E.	MÈDE.
MEDE’E.	MÈDE.
EſpereZ tout de mon ſecours.	Espérez tout de mon secours.
Vous pouvez reprendre vos armes.	Vous pouvez reprendre vos armes.
Theſée reprend ſon Eſpée.	Thesée reprend son Épée.
MEDE’E continuë.	MÈDE continue.
GardeZ vos tendres amours, Gouſtez-en les charmes, AAimteZ pans auarmes, Aimez-vous toujours.	Gardez vos tendres amours, Goûtez-en les charmes, AAimez pans auarmes, Aimez-vous toujours.
THESE’E, &ÆGLE'.	THÉSE'E, etÆGLE'.
G’ardons nos tendres amours, Gouſtons-en les charmes, Aimons ſans allarmes, Aimons-nous toujours.	G'ardons nos tendres amours, Goûtons-en les charmes, Aimons sans alarmes, Aimons-nous toujours.
MEDE’E.	MÈDE.
Habitans fortuneZ de ces Lieux ſi charmants;	Habitants fortuné de ces Lieux si charmants;
Commencez, les plaiſirs de ces heureux Amants.	Commencez, les plaisirs de ces heureux Amants.
SCENE SEPTIESME.	SCÈNE SEPTIÈME.
TITESEE, ÆGLE,IIABTTANS de l’Iſle Enchantée.	TITESE, ÆGLE,IABTANS de l'Île Enchantée.
Quatre Bergeres de l’Iſle Enchantée chantantes.	Quatre Bergères de l'Isle Enchantée chantes.
Meſdemoiſelles Des-Fronteaux, Bony, Verdier, & Pieſche.	Mesdemoiselles Des-Fronteaux, Boni, Verdier, et Pièche.
Deux Habitans de l’Iſle Enchantée chantants.	Deux Habitants de l'Île Enchantée chantants.
Les ſieurs Marolle, & Lanneau Pages.	Les sieurs Marole, et Lanneau Pages.
Vn Habitant de l’Iſle Enchantée.	Un Habitant de l'Île Enchantée.
Monſieur de la Grille chantant ſeul.	Monsieur de la Grille chantant seul.
QuatorZe Habitants de l’Iſle Enchantée chantants.	Quatorze Habitants de l'Île Enchantée chantants.
Les ſieurs Deſtival, Baumaviele, Langez, Roſſignol, Lavernay, Colin, Vaïſſe, Buffequin, Ribon, roreſtier Deſchãps l’aiſné, Deſchants cadet, Servant, & Godechot.	Les sieurs Destival, Baumaviele, Langez, Rossignol, Lavernay, Colin, Vaysse, Buffequin, Ribon, rorétier Deschãps l'né, Deschants cadet, Servant, et Godechot.
Doux e na hibois, Flutes e Cromones.	Doux e a hibois, Flutes e Romones.
Six Flutes.	Six Flutes.
Les ſieurs Philbert, Deſcotteaux, Martin Hotteterre, Jean Hotteterre, Jeannot Hotteterre, & Joſeph Pieſche.	Les sieurs Philbert, Descotteaux, Martin Hotterre, Jean Hotteterre, Jeannot Hotteterre, et Joseph Iesche.
Quuuré Irautvon.	Quuvré Irautuon.
Louis Tiottetene, coin Trotteterre, Dil Clos, Nleclas Moccecerre,	Louis Tiottetene, coin Trotteterre, Dil Clos, Nléclas Moccecerre,
Deux Cromones.	Deux Cromones.
Philidor l’aiſné, & Philidor cadet.	Philidor l'aîné, et Philidor cadet.
Douze Habitants de l’Iſle enchantée dançants.	Douze Habitants de l'Île enchantée dançants.
Six Hommes.	Six Hommes.
Les ſieurs Magny, Faüre, Foignart, Leſtang, La Pierre, & Favier l’aiſné.	Les sieurs Magny, Faüre, Foignart, Létang, La Pierre, et Favier l'aîné.
Six Femmes.	Six Femmes.
Les fieurs Noblet, enſcameau, Favier cadet.	Les sieurs Noblet, enscameau, Favier cadet.
Royer, Boutville, & Pecourt.	Royer, Boutville, et Pecourt.
Deux Bergeres chantent enſemble.	Deux Bergères chantent ensemble.
Meſdemoiſelles Des-Fronteaux, & Bony.	Mesdemoiselles Des-Fronteaux, et Boni.
Ve nos Prairies Seront fleuries!	Ve nos Prairies Seront fleuries!
Les Cœurs glacez, Pour jamais en ſont chaſſeZ.	Les Cœurs glacés, Pour jamais en sont chassés.
Ces Lieux tranquiles Sont les Aſiles Des doux Plaiſirs, Et des heureux Loiſirs:	Ces Lieux tranquiles Sont les Asiles Des doux Plaisirs, Et des heureux Loisirs:
La Terre eſt belle, La Fleur nouvelle Rit aux Zephirs.	La Terre est belle, La Fleur nouvelle Rit aux Zéphirs.
Que nos Prairies Seront fleuries!	Que nos Prairies Seront fleuries!
Les Cœurs glaceZ Pour jamais en ſont chaſſez.	Les Cœurs glacés Pour jamais en sont chassés.
C’eſt dans nos Bois Qu'Amour a fait ſes Loix:	C'est dans nos Bois Qu'Amour a fait ses Lois:
Leur vert feüillage Doit toüjours durer, Un Cœur ſauvage N'y doit point entrer.	Leur vert feuillage Doit toujours durer, Un Cœur sauvage N'y doit point entrer.
Que nos Prairies Doronupeuries!	Que nos Prairies Doronupeuries!
Les Cœurs glacez Pour jamais en ſont chaſſez.	Les Cœurs glacés Pour jamais en sont chassés.
La ſeule affaire D’une Bergere C’eſt de ſonge A l’amour de ſon Berger.	La seule affaire D'une Bergère C'est de songe À l'amour de son Berger.
Lors qu’il la meine, Bien qu'elle prenne De longs detours, Tous les chemins ſont courts:	Lors qu'il la mène, Bien qu'elle prenne De longs détours, Tous les chemins sont courts:
Sa Bergerie Eſt moins cherie Que ſes Amours.	Sa Bergerie Est moins chérie Que ses Amours.
La ſeule affaire D’une Bergere C’eſt de ſonger A l’amour de ſon Berger.	La seule affaire D'une Bergère C'est de songer À l'amour de son Berger.
Quand ſon Amant La quitte un ſeul moment, Nos Champs pour Elle N'ont plus d’autre bien, Elle en querelle Iuſques à ſon Chien.	Quand son Amant La quitte un seul moment, Nos Champs pour Elle N'ont plus d'autre bien, Elle en querelle Jusques à son Chien.
La ſeule affaire D’une Bergere C’eſt de ſonger A l’amour de ſon Berger.	La seule affaire D'une Bergère C'est de songer À l'amour de son Berger.
Meſdemoiſelles Verdier, & Pieſche.	Mesdemoiselles Verdier, et Pièche.
Imons, tout nous y convie, CXOn aime icy ſans danger, Il eſt permis de changer, Ehablis Y flit fon enuie.	Imons, tout nous y convie, CXOn aime ici sans danger, Il est permis de changer, Ehablis Y flit son envie.
Mais, heureux, cent, & cent fois, Vn Amant qui fait un choix Qui dure autant que ſa vie!	Mais, heureux, cent, et cent fois, Un Amant qui fait un choix Qui dure autant que sa vie!
Sont dans les ſombres Boccages.	Sont dans les sombres Boccages.
Ne craignons que les Jaloux Qui ſont encor plus ſauvages.	Ne craignons que les Jaloux Qui sont encor plus sauvages.
Les Habitans de l’Iſle Enchantée dançent ſur l’Air de la Chanſon des Bergeres, qui eſt joüé par des Inſtruments Champeſtres.	Les Habitants de l'Île Enchantée dançent sur l'Ans de la Chanson des Bergères, qui est joué par des Instruments Champtres.
Vn des Habitans de l’Iſle Enchantée chante au iliilſeu de tous les rxutres, qui s’auemblent autour de luy, pour chanter, & pour dançer.	Un des Habitants de l'Île Enchantée chante au iliilseu de tous les rxutres, qui s'avemblent autour de Seigneur, pour chanter, et pour dançer.
PRÆEMIERE CHANSON.	PRÆEMIERE CHANSON.
Chantée par Monſieur de la Grille, repreſentant un des Habitans de l’Iſle Enchantée.	Chantée par Monsieur de la Grille, représentant un des Habitants de l'Île Enchantée.
Vel plaiſir d’aimer Sans contrainte!	Vel plaisir d'aimer Sans contrainte!
Nous pouvons former Des Uœux ſans crainte.	Nous pouvons former Des Uœux sans crainte.
Le Chœur.	Le Chœur.
Quel plaiſir d’aimer Sans contrainte Nous pouvons former Des Uœux ſans crainte.	Quel plaisir d'aimer Sans contrainte Nous pouvons former Des Uœux sans crainte.
Un des Habitans de l’Iſle Enchantée.	Un des Habitants de l'Île Enchantée.
Iuſques aux langueurs, Et juſqu’aux larmes, Pour les tendres Coeurs Tout à des cnarmes.	Jusqu' aux langueurs, Et jusqu'aux larmes, Pour les tendres Coeurs Tout à des carmes.
Le Chœur.	Le Chœur.
Iuſques aux langueurs, Et juſqu’aux larmes, Pour les tendres Coeurs Tout a des charmes.	Jusqu' aux langueurs, Et jusqu'aux larmes, Pour les tendres Coeurs Tout a des charmes.
Un des Habitans de l’Iſle Enchantée.	Un des Habitants de l'Île Enchantée.
Si l’Amour paraiſt Tant à craindre, C’est que lors qu’il plaiſt On veut s’en plaindre.	Si l'Amour paraît Tant à craindre, C'est que lors qu'il plaît On veut s'en plaindre.
Le Chœur.	Le Chœur.
Si l’Amour paraiſt Tant à craindre, C’eſt que lors qu’il plaiſt On veut s’en plaindre.	Si l'Amour paraît Tant à craindre, C'est que lors qu'il plaît On veut s'en plaindre.
Un des Habitans de l’Iſle Enchantée.	Un des Habitants de l'Île Enchantée.
On dit les rigueurs De ſa Bergert, Mais pour les faveurs, On s’en doit taire.	On dit les rigueurs De sa Bergert, Mais pour les faveurs, On s'en doit taire.
Le Chœur.	Le Chœur.
On dit les rigueurs De ſa Bergere, Mais pour les faveurs, On s’en doit taire.	On dit les rigueurs De sa Bergère, Mais pour les faveurs, On s'en doit taire.
SBCONDE CHANSON.	SBCONDE CHANSON.
Chantée par Monſieur de la Grille, repreſentant un des Habitans de l’Iſle Enchantée.	Chantée par Monsieur de la Grille, représentant un des Habitants de l'Île Enchantée.
Amour plaiſt malgré ſes peines, L’Amour plaiſt aux Coeurs conſtants:	Amour plaît malgré ses peines, L'Amour plaît aux Coeurs constants:
M enleoero L’Amour plaiſt malgré ſes peines, L’Amour plaiſt aux Coeurs conſtants:	M enléoero L'Amour plaît malgré ses peines, L'Amour plaît aux Coeurs constants:
Un des Habitans de l’Iſle Enchantée.	Un des Habitants de l'Île Enchantée.
On ne peut porter ſes chaiſnes Aſſez toſt, ny trop long-témps,	On ne peut porter ses chaînes Assez tôt, ni trop longtemps,
Le Chœur.	Le Chœur.
On ne peut porter ſes chaiſnes AſſeZ toſt, ny trop long-temps,	On ne peut porter ses chaînes As tost, ni trop longtemps,
Un des Habitans de l’Iſle Enchantée.	Un des Habitants de l'Île Enchantée.
Sans amour, tout eſt ſans ame, Imour ſeul nous rend contents;	Sans amour, tout est sans âme, Imour seul nous rend contents;
Le Chœur.	Le Chœur.
Sans amour, tout eſt ſans ame, E XIIſIOMI jeut lions rerta contelts s	Sans amour, tout est sans âme, E XIsIOMI jeut lions rerta contelts s
Un des Habitans de l’Iſle Enchantée.	Un des Habitants de l'Île Enchantée.
On ne peut ſentir ſa flame Aſſez tõſt, ny trop long-temps.	On ne peut sentir sa flamme Assez tête, ni trop longtemps.
Le Chœur repete ces Vers, & tous les autres Habitans de l’Iſle Enchantée dançent au ſon des Inſtruments Champeſtres, qui jouent l’Air de cette Chanſon.	Le Chœur répète ces Vers, et tous les autres Habitants de l'Île Enchantée dançent au son des Instruments Champestres, qui jouent l'Air de cette Chanson.
Le Chœur.	Le Chœur.
Onun pous femrr ſu foie Aſſez toſt, ny trop long-temps.	Onun pous femtr su foie Assez tôt, ni trop longtemps.
Fin du quatrieſme Acte.	Fin du quatrième Acte.
ACTE	ACTE
ACTE CINQUIESME.	ACTE CINQUIÈME.
Le Theatre change & repreſente un Palais, que les Enchantements de Medée font paroiſtre, & où l’on voit les apreſts d’un ſuperbe Feſtin.	Le Theatre change et représente un Palais, que les Enchantements de Medée font paraître, et où l'on voit les apprêts d'un superbe Festin.
SCENE PREMIERE.	SCÈNE PREMIÈRE.
MEDE’E.	MÈDE.
H faut-il me vanger En perdant ce que j'aime!	H faut-il me venger En perdant ce que j'aime!
Que fais-tu ma fureur, ou vas-tu m'engager?	Que fais-tu ma fureur, ou vas-tu m'engager?
Punir ce Cœur ingrat c’est me punir moy-meſme, l'en mourray de douleur, je tremble d’y ſonger, Ah faut-il me vanger En perdant ce que j'aime!	Punir ce Cœur ingrat c'est me punir moi-même, l'en mourrai de douleur, je tremble d'y songer, Ah faut-il me vanger En perdant ce que j'aime!
Ma Rivale triomphe, & me voit outrager:	Ma Rivale triomphe, et me voit outrager:
Quoy, laiſſer ſon amour ſans peine, & ſans danger?	Quoi, laisser son amour sans peine, et sans danger?
Voir le ſpectacle affreux de ſon bonheur extreſme?	Voir le spectacle affreux de son bonheur extrême?
Non, il faut me vanger 12 Eesallin ve qne Juillae	Non, il faut me venger 12 Eésallin ve ine Juillae
DORINE, MEDE’E.	DORINE, MÉDÉE.
DORINE.	DORINE.
Ve Theſée est content de ſon bien-heureux ſort!	Ve Thesée est content de son bienheureux sort!
MEDE’E.	MÈDE.
Dorine, c’en est fait, tout est preſt pour ſa mort.	Dorine, c'en est fait, tout est prêt pour sa mort.
DORINE.	DORINE.
Quoy ce grand appareil eſt ſa mort qu’on prepare?	Quoi ce grand appareil est sa mort qu'on prépare?
Le Roy le doit choiſir icy pour Succeſſeur;	Le Roi le doit choisir ici pour Successeur;
Uoſtre ſoin pour luy ſe declare.	OUotre soin pour lui se déclare.
MEDE’E.	MÈDE.
J’ay caché mon depit ſous ma feinte douceur;	J'ai caché mon dépit sous ma feinte douceur;
La vengeance ordinaire est trop peu pour mon cœur, Ie la veux horrible & barbare.	La vengeance ordinaire est trop peu pour mon cœur, Je la veux horrible et barbare.
Ie m’eſloignois tantoſt expres pour tout ſçavoir.	Je m'éloignais tantôt exprès pour tout sçavoir.
Du ſecret de Theſée il faut me prevaloir, Le Roy l’ignore encor, & pour me ſatisfaire Contre un Fils inconnu j’arme ſon propre Pere:	Du secret de Thesée il faut me prévaloir, Le Roi l'ignore encor, et pour me satisfaire Contre un Fils inconnu jarme son propre Père:
I'immolay mes Enfants, j'oſay les eſgorger;	J'immolai mes Enfants, j'osai les égorger;
Ie ne puis me vanger A moins d’un parricide.	Je ne puis me venger À moins d'un parricide.
SCENE TROISIESME.	SCÈNE -TROISIÈME.
LE ROY, MEDE’E.	LE ROY, MÉDÉPE.
MEDE’E.	MÈDE.
IE Vaze par mes ſoins vient d’eſtre empoiſonné;	JE Vaze par mes soins vient d'être empoisonné;
Vous n’aurez qu’à l’offrir.	Vous n'aurez qu'à l'offrir.
Vous ſembleZ estonné?	Vous semblez étonné?
LENOI.	LENOI.
Ce Heros m’a ſervy, malgré moy je l’estime, Puis-je luy preparer un injuste trespas?	Ce Héros m'a servi, malgré moi je l'estime, Puis-je femme préparer un injuste trépas?
MEDE’E.	MÈDE.
L’eſpoir de vostre amour, la paix de vos Estats, Molob vvopomos or bibinoboncorro prbibe Oicsime.	L'espoir de votre amour, la paix de vos États, Molob vvopomos or bibinoboncorro prbibe Oicile.
Contre un Rival heureux faut-il qu’on vous anime?	Contre un Rival heureux faut-il qu'on vous anime?
La vengeance a bien des appas, Eſt-ce trop la payer s’il vous en couſte un crime?	La vengeance a bien des appas, Est-ce trop la payer s'il vous en coûte un crime?
DA ROY.	DA ROY.
Ie n’ay rien fait juſqu’à ce jour Qui puiſſe ternir ma memoire;	Je n'ai rien fait jusqu'à ce jour Qui puisse ternir ma mémoire;
Si prés de mon tombeau faut ie tranir ma gloire?	Si près de mon tombeau faut der tranir ma gloire?
Ne vaudroit-il pas mieux eſtouffer mon amour?	Ne vaudrait-il pas mieux étouffer mon amour?
Il faudra toujours l’eſloigner:	Il faudra toujours l'éloigner:
Voſtre Peuple pour luy n’aura que de la haine, Il adore Theſée, il veut le voir regner.	Votre Peuple pour lui n'aura que de la haine, Il adore Thesée, il veut le voir régner.
Laiſſerez-vous un Fils ſans nom, & ſans Empire, Tandis qu’un Eſtranger jouira de ſon Sort, Et peut-eſtre oſera s’aßûrer par ſa mort.	Laisserez-vous un Fils sans nom, et sans Empire, Tandis qu'un Étranger jouira de son Sort, Et peut-être osera s'assûrer par sa mort.
LE ROY.	LE ROY.
Ie cpεtς uee fontimnumo que bu Evuture inspire, Ie me rends, l’Amour ſeul n’eſtoit pas aſſez fort.	Ie cpεtς fontimnumo que bu Evuture inspire, Ie me rends, Amour Je c'était pas assez fort.
MEDE’E, & LE ROY.	MÈDE, et LE ROY.
Que la vengeance A d’attrais pour des Cœurs jaloux!	Que la vengeance A d'attrais pour des Cœurs jaloux!
N'espargnons point qui nous offence, Vangeons-nous, vangeons-nous, L’amour meſme, n'eſt pas plus doux Qne la Ubligcante.	N'épargnons point qui nous offense, Vengeons-nous, vengeons-nous, L'amour même, n'est pas plus doux Qne la Ubligcante.
SCENE QUATRIESME.	SCÈNE QUATRIÈME.
THESE’E, ÆGLE' LE ROY, MEDE’E, CLEONE, ARCAS, CHOEVR, & Troupe d’Atheniens.	THESE’-E, ÆGLE' LE ROY, MEDE'E, CLÉONE, ARCAS, CHOEUR, et Troupe d'Athéniens.
LEROY, & MEDE’E.	LEROY, et MEDE’E.
E craigneZ rien parfaits Amants NVLes plaiſirs ſuivront vos tourments.	E craignez rien parfaits Amants NULes plaisirs suivront vos tourments.
Le Chœur.	Le Chœur.
Ne craignez rien parfaits Amants Les praiſtrs fut oront vus tourments.	Ne craignez rien parfaits Amants Les praîtrs fut oront vus tourments.
LEROY, &MEDE’E.	LEROY, etMEDE’E.
Recevez, la recompencé De voſtre conſtance.	Recevez, la récompencé De votre constance.
Le Chœur.	Le Chœur.
CCGEIIRSee Pes Miranl Les plaiſirs ſuivront vos tourments.	CCGEIIRS Pe Miranl Les plaisirs suivront vos tourments.
LE ROY.	LE ROY.
Oublions le paßé, ma colere est finie;	Oublions le passé, ma colère est finie;
Puis qu’Athenes le veut je conſens qu’apres moy Ce Heros ſoit un jour ſon legitime Roy.	Puis qu'Athène le veut je consens qu'après moi Ce Héros soit un jour son légitime Roi.
Commençons la Ceremonie.	Commençons la Cèremonie.
Qu’on apprenne à ſervir Theſée en ſouverain.	Qu'on apprenne à servir Thesée en souverain.
PreneZ ce Uaze de ma main.	PreneZ ce Uaze de ma main.
THESE’E prenant le Vaze d’une main, & tirant ſon Eſpée de l’autre.	THÈSE prenant le Vaze d'une main, et tirant son Épée de l'autre.
Je jure ſur ce fer qui m’a comblé de gloire, Que je vous ſerviray contre vos Ennemis, Et que vous n’aureZ point de Sujet plus ſoumis.	Je jure sur ce fer qui m'a comblé de gloire, Que je vous servirai contre vos Ennemis, Et que vous n'aurez point de Sujet plus soumis.
Le Roy conidere avec eſtomement l’Eſpée de Theſée, & la reconnoiſt pour eſtre celle qu’il a laiſſée pour ſervir un jour à la reconnoiſſance de ſon Fils.	Le Roi conidère avec estomement l'Espée de Thesée, et la reconnaît pour être celle qu'il a laissée pour servir un jour à la reconnaissance de son Fils.
LE ROY empeſchant Theſée de porter le Vaze à ſa bouche.	LE ROY empêchant Thesée de porter le Vase à sa bouche.
Que voy-je?	Que vois-je?
quelle Eſpée!	quelle Espée!
ah qui l’auroit pù croire!	ah qui l'aurait pù croire!
O Ciel!	Ô Ciel!
j’allois perdre mon Fils!	j'allais perdre mon Fils!
l'avois laißé ce fer pour ta reconnoiſſance, Mon Tuis, anmunemer Pits, ou nous capoſois-tus	l'avais laisse ce fer pour ta reconnaissance, Mon Tuis, anmunemer Pits, ou nous caposais-tus
THESE’E.	THÉSE'E.
Ce fer euſt dans mes mains trahy voſtre esperance En vous mõtrant un Fils qui n’euſt point combattu, Sans prẽdre aucun ſecours d’une illuſtre Naiſſaice Ie voulois esprouver juſqu’où va la Uertu.	Ce fer eût dans mes mains trahi votre espérance En vous mõtrant un Fils qui n'eût point combattu, Sans prendre aucun secours d'une illustre Naissaice Je voulais éprouver jusqu'où va la Uertu.
Medée s’enfuït voyant Theſée reconnu par ſon Pere.	Medée s'enfuït voyant Thesée reconnu par son Père.
SCENE CINQUIESME.	SCÈNE CINQUIÈME.
EnNCOT, FIILODD, IGGED, CECUNE, ARCAS, CHOEVR, & Troupe d’Atheniens.	EnNCOT, FIILOD, IGGED, CECUNE, ARCAS, CHOEUR, et Troupe d'Athéniens.
LE ROY.	LE ROY.
H!	H!
perfide Medée!	perfide Medée!
Elle fuït l’inhumaine, AX Qu’õ la pourſuive, allez, ne la reſpecteZ plus;	Elle fuit l'inhumaine, AX Qu'on la poursuive, allez, ne la respecte plus;
Mais la pourſuité en ſera vaine, Elle ſçait des chemins qui nous ſont inconnus!	Mais la poursuité en sera vaine, Elle sait des chemins qui nous sont inconnus!
THESE’E.	THÉSE'E.
C'eſt aſſeZ d'eſviter ſa haine;	C'est assez d'éviter sa haine;
Soyons heureux, Seigneur:	Soyons heureux, Seigneur:
Noſtre parfait bonheur Suffira pour ſa peine.	Notre parfait bonheur Suffira pour sa peine.
LE ROY, THESE’E, & ÆGLE'.	LE ROY, THÈSE, et ÊGLÉ.
Noſtre parfait bonheur Suffira pour ſa peine.	Notre parfait bonheur Suffira pour sa peine.
LE ROY.	LE ROY.
Ie ſuis charmé de vos appas, Ie ne m’en deffens pas, Trop aimable Æglé, je vous aime;	Je suis charmé de vos appas, Je ne m'en défens pas, Trop aimable Églé, je vous aime;
Mais je veux eſtre heureux dans un Autre moymeſme;	Mais je veux être heureux dans un Autre moymesme;
Mon Rival m'eſt trop cher pour en eſtre jaloux, Ie reconnoy mon Fils à ſon amour extreſme, C’eſt le ſort de mon Sang de s’enflamer pour vous.	Mon Rival m'est trop cher pour en être jaloux, Je reconnais mon Fils à son amour extrême, C'est le sort de mon Sang de s'enflammer pour vous.
Que l’Hymen prepare Des nœuds pleins d’attraits Soyez, unis a jamais, Que l’Amour repare Tous les maux qu’il vous a faits Soyez, unis a jamais.	Que l'Hymen prépare Des nœuds pleins d'attraits Soyez, unis a jamais, Que l'Amour répare Tous les maux qu'il vous a faits Soyez, unis a jamais.
Le Chœur.	Le Chœur.
SoyeZ unis à jamais.	SoyeZ unis à jamais.
THESE’E, & ÆGLE'.	THÉSE'E, et ÆGLE'.
des plus cents esdipnes Couſtent des ſoüpirs;	des plus cents édipnes Coûtent des sourpirs;
Il faut paſſer par les peines Pour arriver aux plaiſirs.	Il faut passer par les peines Pour arriver aux plaisirs.
LE ROY, CLEONE, & ARCAS.	LE ROY, CLÉONE, et ARCAS.
Que l’Hymen prepare Des nœuds pleins d’attraits.	Que l'Hymen prépare Des nœuds pleins d'attraits.
Le Chœur.	Le Chœur.
Rojee tlirls er jelisats,	Roène tlirls er jélisats,
LE ROY, CLEONE, & ARCAS.	LE ROY, CLÉONE, et ARCAS.
Que l’Amour repare Tous les maux qu’il vous a faits.	Que l'Amour répare Tous les maux qu'il vous a faits.
Le Chœur.	Le Chœur.
Dojea aitrs a jamais,	Dojea aitrs à jamais,
SCENE SIXIESME.	SCÈNE SIXIÈME.
MEDE’E, LE ROY, THESE’E, ÆGLE', CLEONE, ARCAS, CHOEVR, & Troupe d’Atheniens.	MÈDE, LE ROY, THESE’E, ÊGLÉ, CLÉONE, ARCAS, CHOEUR, et Troupe d'Athéniens.
MEDE’E ſur un Char tiré par des	MÈDE sur un Char tiré par des
Dragons volans.	Dragons volants.
TOus n'eſtes pas encor délivrez de ma rage:	TOutOus n'êtes pas encor délivrez de ma rage:
Ie n’ay point preparé la pompe de ces Lieux Pour ſervir au bonheur d’un amour qui m’outrage;	Je n'ai point préparé la pompe de ces Lieux Pour servir au bonheur d'un amour qui m'outrage;
Ie veux que les Enfers deſtruiſent mon Quvrage, C’eſt ainſi qu’en partant je vous fais mes adieux.	Je veux que les Enfers détruisent mon Qurage, C'est ainsi qu'en partant je vous fais mes adieux.
Dans le temps que Medée fuït, le Palais paroiſt embraſé, & les Mets du Feſtin preparé ſe convertiſſent en des Animaux horribles.	Dans le temps que Medée fuit, le Palais paraît embrasé, et les Mets du Festin préparé se convertissent en des Animaux horribles.
SCENE SEPTIESME.	SCÈNE SEPTIÈME.
LE ROY, THESE’E, ÆGLE, CLEONE, ARCAS, Chœur, & Troupe d’Atheniens.	LE ROY, THESE’ E, CLÉ, CLEONE, ARCAS, Chœur, et Troupe d'Athéniens.
Le	Le
Le Chœur.	Le Chœur.
EcoureZ-nous, juſtes Dieux!	Écourez-nous, justes Dieux!
OQuelle flame espouventable!	OQuelle flamme épouventable!
Quels Ennemis furieux!	Quels Ennemis furieux!
Secourez-nous, juſtes Dieux!	Secourez-nous, justes Dieux!
Vne mort inévitable S’offre par tout à nos yeux!	Une mort inévitable S'offre par tout à nos yeux!
découreZ chous, ſuſtes Dienx :	décourez chous, sûtes Dienx :
SCENE HVITIESME.	SCÈNE HVITIESME.
MINERVE, Chœur de Divinitez qui accompagnent Minerve, LE ROY, THESEE, ÆGLE', CLEONE, ARCAS, Chœur, & Troupe d’Atheniens.	MINERVE, Chœur de Divinités qui accompagnent Minerve, LE ROY, THESEE, ÉGLÉE, CLEONE, ARCAS, Chœur, et Troupe d'Athéniens.
Six Flutes.	Six Flutes.
Les ſieurs Philbert, Deſcotteaux, Louis Hotteterre, Colin Hotteterre, Jean Hotteterre, & Jeannot Hotteterre.	Les sieurs Philbert, Descotteaux, Louis Hotterre, Colin Hotteterre, Jean Hotteterre, et Jeannot Hotteterre.
Deux Baſſes de Violon.	Deux Basses de Violon.
Les ſieurs Body,	Les sieurs Body,
Dente Theorbes.	Dente Theorbes.
Meſſieurs Dupré, & Grenerin.	Messieurs Dupré, et Grenerin.
Quatre Trompettes.	Quatre Trompettes.
Les Sieurs Dupré, Charvilhac,	Les Sieurs Dupré, Charvilhac,
La Plaine, & Barberay.	La Plaine, et Barbérai.
Cinq Déeſſes chantantes.	Cinq Déesses chantantes.
Meſdemoiſelles Des-Fron	Mesdemoiselles Des-Fron
teaux, Beaucreux, Bony, Caliote, & Pieſche.	teaux, Beaucreux, Boni, Caliote, et Pièche.
Quatre Dieux chantants.	Quatre Dieux chantants.
Meſſieurs Langeais, Ribon, Lavernay, & Godechot.	Messieurs Langeais, Ribon, Lavernay, et Godechot.
Vingt-ſix Muſiciens de la ſuite des Dieux.	Vingt-six Musiciens de la suite des Dieux.
Meſſieurs Deſtival, Baumont, Bony, Gillet, Rebel, Le Maire, Baumaviele, Roſſignol, Miracle, Thaulet, Goudonneſche, Regnier, Foreſtier, Deſchamps l’aiſné, Deſchants cadet, Martial, Buffequin, Vaïſſe, Jolain, Le Febvre, Doitiairt, bor vane, Eton, Colin, Du Meſnil, & Seguin.	Messieurs Destival, Baumont, Boni, Gillet, Rebel, Le Aire, Baumavie, Rossignol, Miracle, Thaulet, Goudonnesche, Regnier, Forestier, Dêchamps l'aîné, Deschants cadet, Martial, Buffequin, Vaïsse, Jolain, Le Fébre, Doitiairt, bor vane, Eton, Colin, Du Mesnil, et Scuin.
MINERVE dans la Gloire.	MINERVE dans la Gloire.
E Ciel veut eſcarter tout ce qui peut voꝰ nuire:	E Ciel veut écarter tout ce qui peut voù nuire:
CVoyez par mon pouvoir eſlever à l’inſtant Un Palais eſclattant Que l’Enfer n’oſera détruire.	CUoyez par mon pouvoir élever à l'instant Un Palais esclattant Que l'Enfer n'osera détruire.
Le Theatre change & repreſente un Palais magnifique & brillant.	Le Théâtre change et représente un Palais magnifique et brillant.
MINERVE, & le Chœur des Divinitez, uallu iu efolsor ViveZ, viveZ contents dans ces aimables Lieux:	MINERVE, et le Chœur des Divinité, uallu yu efolsor ViveZ, viveZ contents dans ces aimables Lieux:
Chœur d’Atheniens dans le Palais.	Chœur d'Athéniens dans le Palais.
Uivons, vivons contents dans ces aimables Lieux.	OUivons, vivons contents dans ces aimables Lieux.
MINERVE, & les Chœurs.	MINERVE, et les Chœurs.
Bien-heureux qui peut naiſtre Sous un Regne ſi glorieux!	Bienheureux qui peut naître Sous un Règne si glorieux!
Vivez, vivez Scontents dans ces aimables Lieux.	Vivez, vivez Scontents dans ces aimables Lieux.
Vivons, vivõs Vn Roy digne de l’estre Est le Don le plus grand des Cieux.	Vivons, vivõs Un Roi digne de l'être Est le Don le plus grand des Cieux.
Vivez, vivez contents dans ces aimables Lieux.	Vivez, vivez contents dans ces aimables Lieux.
Vivons, vivõs-	Vivons, vivons-
SCENE NEVFIESME,	SCÈNE NEUFIESME,
ET DERNIERE.	ET DERNIÈRE.
Outes les Voix, & tous les Inſtrumens T des deux Chœurs ſe réüniſſent.	Outes les Voix, et tous les Instruments T des deux Chœurs se réunissent.
Les plus conſiderables Courtiſans du Roy d’Athenes, environnez d’une Troupe d’Eſclaves, forment une eſpece de Feſte galante pour ſe réjoüir de la reconnoiſſance de Theſée;	Les plus considérables Courtisans du Roi d'Athènes, environnez d'une Troupe d'Esclaves, forment une espèce de Feste galante pour se réjouir de la reconnaissance de Thesée;
Arcas & Cleone chantent au milieu de leur Dançe.	Arcas et Cléone chantent au milieu de leur Dançe.
Vn grand Seigneur de la Cour d’Ægée.	Un grand Seigneur de la Cour d'Ægée.
Monſieur Bauchamp ſeul.	Monsieur Bauchamp seul.
Quatre Courtiſants.	Quatre Courtisants.
Les ſieurs Favier l’aiſné, Chicanneau, Faüre, & Magny.	Les sieurs Favier l'aîné, Chicanneau, Fauer, et Magny.
DouZe Eſclaves de la ſuite.	Douze Esclaves de la suite.
Les Sleuig rccoure, Surillai, roignart, Des-Airs, Peſant l’aiſné, Le Chantre, Cordu, Favre, Vagnard, Le Doux, Favier cadet, & Barazé.	Les Sleuig résoure, Surillai, rognard, Des-Airs, Pesant l'aîné, Le Chantre, Cordu, Favre, Vagnard, Le Doux, Favier cadet, et Barazé.
ARCAS, & CLEONE.	ARCAS, et CLÉONE.
E plus ſage LIS’enflame, & s'engage, Sans ſçavoir comment, La Fierté ſe deſment, Le Cœur le plus ſauvage Soüpire aiſément Dans un fatal moment.	E plus sage LIS’enflamme, et s'engage, Sans avoir comment, La Fierté se dément, Le Cœur le plus sauvage Soupire aisément Dans un fatal moment.
Le plus ſage S’enflame, & s’engage, Sans ſçavoir comment.	Le plus sage S'enflamme, et s'engage, Sa voir comment.
Contre un mal ſi doux, & ſi charmant Le plus grand Courage Combat foiblement.	Contre un mal si doux, et si charmant Le plus grand Courage Combat faiblement.
Le plus ſage D.	Le plus sage D.
Irimedostis.	Irimedostis.
Sans ſçavoir comment.	Sans savoir comment.
Quel dommage, Si l’on ne meſnage Les moments heureux!	Quel dommage, Si l'on ne ménage Les moments heureux!
Formons d’aimables nœuds;	Formons d'aimables nœuds;
Faiſons un doux uſage Du temps où les feux Suivront par tout nos Uœux.	Faisons un doux usage Du temps où les feux Suivront par tout nos Uœux.
Quel dommage Si l’on ne meſnage Les moments heureux!	Quel dommage Si l'on ne ménage Les moments heureux!
Qui n’eſt point dans l’Empire amoureux N’aura pour partage Que des ſoins faſcheux.	Qui n'est point dans l'Empire amoureux N'aura pour partage Que des soins fâcheux.
Quel dommage Si l’on ne meſnage Les moments heureux!	Quel dommage Si l'on ne ménage Les moments heureux!
Fin du cinquieſme, & dernier Acte.	Fin du cinquième, et dernier Acte.
