Acteurs du Prologue.	Acteurs du Prologue.
OLLON.	OLON.
ALES NEVF MVSES BACCHUS.	ALES NEUFS MUSES BACCHUS.
N.	N.
CHOEUR d’Ægipans & de Menades.	CHOEUR d'Ægipans et de Ménades.
CHOEUR de Bergers & de Bergeres.	CHOEUR de Bergers et de Bergères.
ACTEURS DE LA TRAGEDIE.	ACTEURS DE LA TRAGÉDIE.
TENOBEE, Veuve de Pretus, Roy d’Argos.	TENOBE, Veuve de Pretus, Roi d'Argos.
AMISODAR, Prince Lycien, Sçavant en Magie, Amoureux de Stenobée.	AMISODAR, Prince Lycien, Savant en Magie, Amoureux de Stenobée.
ARGIE, Confidente de Stenobée.	ARGIE, Confidente de Stenobée.
CITCRCIEICATEUR.	CITCRCIEICATEUR.
Miniſtre du Temple d’Apollon.	Ministre du Temple d'Apollon.
TROVPPE de Solymes.	TROUPPE de Solymes.
LA SCENE EST A PATARE CAPITALE du Royaume de Lycie.	LA SCÈNE EST A ATARE CAPITALE du Royaume de Lycie.
118 IRULOGVL Le Theatre repreſente une agreable Vallée, en forme de Coſteaux delicieux, au fond deſquels paroiſt le Mont-Parnaſſe à double ſommet, & entre les deux, la Source de la Fontaine d’Helicon.	118 JRULOGUL Le Théâtre représente une agréable Vallée, en forme de Costeaux délicieux, au fond desquels paraît le Mont-Parnasse à double sommet, et entre les deux, la Source de la Fontaine d'Helicon.
Apollon eſt aſſis au haut de cette Montagne, accompagné des Neuf-Muſes, qui ſont auſſi aſſiſes des deux coſtez.	Apollon est assis au haut de cette Montagne, accompagné des Neuf-Muses, qui sont aussi assises des deux côtés.
APOLLON.	APOLLON.
USES, preparons nos Concerts.	USES, préparons nos Concerts.
Le plus grand Roy de l’Univers S Uient d’aſſeurer le repos de la Terre, Sur cét heureux Vallon il répand ſes bien-faits.	Le plus grand Roi de l'Univers S Uient d'assurer le repos de la Terre, Sur cet heureux Vallon il répand ses bienfaits.
Aprés avoir chanté les fureurs de la Guerre, Chantons les douceurs de la Paix.	Après avoir chanté les fureurs de la Guerre, Chantons les douceurs de la Paix.
CHOEUR DES MUSES.	CHOEUR DES MUSES.
Aprés avoir chanté les fureurs de la Guerre, Chantons les douceurs de la Paix.	Après avoir chanté les fureurs de la Guerre, Chantons les douceurs de la Paix.
APOLLON.	APOLLON.
Par cét Auguſte Roy la diſcorde eſt bannie.	Par cet Auguste Roi la discorde est bannie.
Pour tous les Dieux ſa gloire a tant d’appas, Que Pan luy meſme oubliant nos debats Vient icy de nos Chants augmenter l’harmonie.	Pour tous les Dieux sa gloire a tant d'appas, Que Pan était même oubliant nos débats Vient ici de nos Chants augmenter l'harmonie.
Bacchus ainſi que luy vient ſe joindre avec nous, Pour rendre nos accords plus charmants & plus doux, Bacchus entre icy d’un coſté, accompagné d’Ægipans & de Menades, & Pan entre de l’autre, ſuivy de Beigers & de Bergeres.	Bacchus ainsi que nous vient se joindre avec nous, Pour rendre nos accords plus charmants et plus doux, Bacchus entre ici d'un côté, accompagné d'Ægipans et de Ménades, et Pan entre de l'autre, suivi de Béigers et de Bergères.
BACHUS.	BACHUS.
Du fameux bord de l'Inde, où toûjours la Victoire Rangea les Peuples ſous ma Loy, je viens prendre part à la gloire D'un Vainqueur auſſi grand que moy.	Du fameux bord de l'Inde, où toujours la Victoire Rangea les Peuples sous ma Loi, je viens prendre part à la gloire D'un Vainqueur aussi grand que moi.
PAN.	PAN.
I I’ay quitté les Foreſts ou je tiens mon Empire, Pour venir comme vous admirer ce Heros.	I J'ai quitté les Forêts ou je tiens mon Empire, Pour venir comme vous admirer ce Héros.
Nos Plaines & nos Bois luy doivent leur repos, C eſt par tny jeul que tout respire.	Nos Plaines et nos Bois fin doivent leur repos, Ç est par telni jeul que tout respire.
TOUS enſemble.	TOUS ensemble.
Chantons le plus grand des Mortels, Chantons un Roy digne de nos Autels.	Chantons le plus grand des Mortels, Chantons un Roi digne de nos Autels.
CHOEUR D’APOLLON, ET DES MUSES, Par luy tous nos champs reſteuriſſent.	CHOEUR D'APOLLON, ET DES MUS, Paryeux tous nos champs resteurissent.
CHOEUR Les tranquilles plaiſirs par luy ſont de retour.	CHOEUR Les tranquilles plaisirs par deux sont de retour.
CHOEUR d’Apollon & des Muſes.	CHOEUR d'Apollon et des Muses.
De ſon nom ſeul les Echos retentiſſent.	De son nom seul les Échos retentissent.
OTIOne le de buendu ce de l'au.	OTIOne le de buendu ce de l'au.
Si l’on ſoûpire encor, ce n’eſt plus que d’amour.	Si l'on soupire encor, ce n'est plus que d'amour.
CHOEUR d’Apollon & des Muſes.	CHOEUR d'Apollon et des Muses.
Tout rit bins nos bouves retraites.	Tout rit bins nos bouves retraites.
CHOEUR de Bachus & de Pan.	CHOEUR de Bachus et de Pan.
Rien ne vient plus troubler le ſon de nos Muſetes.	Rien ne vient plus troubler le son de nos Musètes.
TOUS enſemble.	TOUS ensemble.
Chantons le plus grand des Mortels, Chantons un Roy digne de nos Autels.	Chantons le plus grand des Mortels, Chantons un Roi digne de nos Autels.
Les Bergers & les Bergeres commencent icy une Entrée, aprés laquelle un Berger chante les deux couplets ſuivants, qui ſont entremeſlez de Dances.	Les Bergers et les Bergères commencent ici une Entrée, après laquelle un Berger chante les deux couplets suivants, qui sont entremêlés de Dances.
CHANSON d’un Berger.	CHANSON d'un Berger.
Pourquoy n’avoir pas le cœur tendre?	Pourquoi n'avoir pas le cœur tendre?
Rien n’eſt ſi doux que d’aimer.	Rien n'est si doux que d'aimer.
Peut-on aisément s’en deffendre?	Peut-on aisément s'en défendre?
Non, non, non, l'Amour doit tout charmer.	Non, non, non, l'Amour doit tout charmer.
Que ſert la fierté dans les Belles?	Que sert la fierté dans les Belles?
Tout aime enfin a ſon tour.	Tout aime enfin à son tour.
Voit-on des rigueurs eternelles?	Voit-on des rigueurs éternelles?
Non, non, non, rien n’échape à l’Amour.	Non, non, non, rien n'échappe à l'Amour.
Aprés cette Chanſon, les Ægipans & les Menades font une Entrée, laquelle eſtant finie, les Bergers & les Bergeres ſe meſlent evec eux, & ils danſent tous enſemble.	Après cette Chanson, les Ægipans et les Ménades font une Entrée, laquelle étant finie, les Bergers et les Bergères se mêlent évec eux, et ils dansent tous ensemble.
Cette derniere Danſe eſt luivié de ce Dialogue de Bacchns & de Pan.	Cette dernière Danse est luivié de ce Dialogue de Bacchs et de Pan.
A lande Tour eſt paiſible ſur la Terre, Voicy l’heureux temps des Amours.	À lande Tour est paisible sur la Terre, Voici l'heureux temps des Amours.
BACCHUS.	BACCHUS.
Ils n’ont plus à craindre la Guerre, Qui des Amants troubloit les plus beaux jours.	Ils n'ont plus à craindre la Guerre, Qui des Amants troublait les plus beaux jours.
PAN.	PAN.
Oiiti, Doguo saimez Bergeres, SuiveZ vos plus tendres deſirs.	Oiiti, Doguo saimez Bergères, Suivez vos plus tendres désirs.
BACCHUS.	BACCHUS.
Si l’Amour à des maux il a mille plaiſirs Qui rendent ſes peines legeres.	Si l'Amour à des maux il a mille plaisirs Qui rendent ses peines légères.
BACCHUS & PAN.	BACCHUS et PAN.
Si l’Amour à des maux, il a mille plaiſirs Qui rendent ſes pernes iegeres.	Si l'Amour à des maux, il a mille plaisirs Qui rendent ses pernes iegeres.
Quittez de ſi vaines Chanſons.	Quittez de si vaines Chansons.
Il faut par de plus nobles ſons Honorer en ce jour le Heros de la Frânce.	Il faut par de plus nobles sons Honorer en ce jour le Héros de la Frânce.
Transformons-nous en ce moment, Et dans un Spectacle charmant Celebrons à ſes yeux l’heureux Evenement, Que fuuis uu lurneſſe us uome ur miſſance.	Transformons-nous en ce moment, Et dans un Spectacle charmant Célébrons à ses yeux l'heureux Événement, Que fuis u lurnesse us ome ur missance.
Allons, pour ce grand Roy redoubleZ vos efforts, Preparez vos plus doux accords.	Allons, pour ce grand Roi redoublez vos efforts, Préparés vos plus doux accords.
TOUS enſemble.	TOUS ensemble.
Pour ce grand Roy redoublons nos efforts, Preparons nos plus doux accords.	Pour ce grand Roi redoublons nos efforts, Préparons nos plus doux accords.
PIN DO TROLOGUE.	PIN DO TROLOGUE.
DEELEROIIIOI TRAGEDIE.	DEELEROIIIOI TRAGÉDIE.
ACTE PREMIER.	ACTE PREMIER.
Le Theatre repreſente vne avant-court du Palais du Roy, au fond de laquelle paroiſt un grand Arc de Triomphe, & au delà, on découvre la Vile de Patare, Capitale du Royaume de Lycie.	Le Théâtre représente une avant-court du Palais du Roi, au fond de laquelle paraît un grand Arc de Triomphe, et au delà, on découvre la Vile de Patare, Capitale du Royaume de Lycie.
SCENE PREMIERE.	SCÈNE PREMIÈRE.
STENOBE’E, ARGIE.	STENOBE'E, ARGIE.
STENOBE’E.	STENOBE'É.
ON, les ſoulevemens d’vne Ville rebelle Ne m’ont point fait quitter Argos.	ON, les soulèvements d'une Ville rebelle Ne m'ont point fait quitter Argos.
C’eſt l’Amour ſeul fatal à mon repos, C’eſt le cruel Amour qui aans ces lieux m’appelle.	C'est l'Amour seul fatal à mon repos, C'est le cruel Amour qui a ces lieux m'appelle.
Pretus n’eſt plus, & deſormais ſa mort Me rend maistreſſe de mon ſort;	Prétus n'est plus, et désormais sa mort Me rend maîtresse de mon sort;
Ie puis donner un Diadéme, Et ouens en cetrt Gourjairt un uernier effort Sur le cœur d’un Ingrat que j’aime.	Je puis donner un Diadème, Et ouens en cetrt Gourjairt un uernier effort Sur le cœur d'un Ingrat que j'aime.
ARGIE.	ARGIE.
Quoy, de Bellerophon l’outrageante froideur Ne peut de cet amour dégager voſtre cœur?	Quoi, de Bellerophon l'outrageante froideur Ne peut de cet amour dégager votre cœur?
STENOBE’E.	STENOBE'É.
Malgré tous mes mal-heurs je ſerois trop heureuſe, Si les meſpris pouvoient guerir l’amour.	Malgré tous mes malheurs je serais trop heureuse, Si les mépris pouvaient guérir l'amour.
Ma fierté dés long-temps par vn juſte retour, Ml auron jail triompner de ma pame amoureuſe;	Ma fierté dès longtemps par un juste retour, Ml auron jail triompner de ma pame amoureuse;
Mais helas!	Mais hélas!
ma tendreſſe augmente chaque jour.	ma tendresse augmente chaque jour.
Malgré tous mes mal-heurs je ſerois trop heureuſe, Si les meſpris pouvoient guerir l’amour.	Malgré tous mes malheurs je serais trop heureuse, Si les mépris pouvaient guérir l'amour.
MNGIE.	MNGIE.
Contre Bellerophon voſtre aveugle colere Aux plus ſanglants effets devoit s’authoriſer;	Contre Bellerophon votre aveugle colère Aux plus sanglants effets devait s'autoriser;
L’amour vous le fait voir toûjours digne de plaire, C’eſt aſſez pour vous appaiſer.	L'amour vous le fait voir toujours digne de plaire, C'est assez pour vous apaiser.
STENOBEE.	STENOBE.
Helas!	Hélas!
à quel exceZ je portay ma vangeance!	à quel excès je portai ma vengeance!
Ie l’accuſay malgré ſon innocence De vouloir m’inspirer une coupable ardeur.	Je l'accusai malgré son innocence De vouloir m'inspirer une coupable ardeur.
Ce fut pour luy ravir & l’honneur & la vie, Que Pretus l’envoya chez le Roy de Lycie.	Ce fut pour lui ravir et l'honneur et la vie, Que Pretus l'envoya chez le Roi de Lycie.
Et quels troubles alors ne ſentit point mon cœur!	Et quels troubles alors ne sentit point mon cœur!
En vain, quand l’amour eſt extreſme, On veut perdre un Ingrat qui nous oſe outrager.	En vain, quand l'amour est extrême, On veut perdre un Ingrat qui nous ose outrager.
On prend dans ſes mal-heurs plus de part que luymeſme.	On prend dans ses malheurs plus de part que luymesme.
Helas!	Hélas!
quand il ſe faut vanger de ce qu’on aime, Qu'il en coûte pour ſe vanger!	quand il se faut venger de ce qu'on aime, Qu'il en coûte pour se venger!
ARGIE.	ARGIE.
Ne redoutez plus rien;	Ne redoutez plus rien;
ce Heros invincible Aux plus affreux perils tant de fois exposé, A ſa valeur a trouvé tout poſſible.	ce Héros invincible Aux plus affreux périls tant de fois exposé, À sa valeur a trouvé tout possible.
Quel triomphe pour vous s’il vous eſtoit aisé De rendre enfin ſon cœur ſenſible!	Quel triomphe pour vous s'il vous était aisé De rendre enfin son cœur sensible!
STENOBE’E.	STENOBE'É.
Du moins Bellerophon n’a jamais rien aimé, C’eſt à la gloire qu’il ſe donne, Et ſon cœeur peut eſtre charmé Par les offres de ma Couronne.	Du moins Bellerophon n'a jamais rien aimé, C'est à la gloire qu'il se donne, Et son cœeur peut être charmé Par les offres de ma Couronne.
Eſpoir, qui ſeduiſeZ les Amans mal-heureux, Pourquoy ſuſpendre ma vangeance?	Espoir, qui séduisez les Amants malheureux, Pourquoi suspendre ma vengeance?
Ie ſçay, je ſçay combien vous eſtes dangereux, Ie ſçay que vous allez entretenir mes feux, Et redoubler leur violence;	Je sais, je sais combien vous êtes dangereux, Je sais que vous allez entretenir mes feux, Et redoubler leur violence;
Cependant vous rentrez dans mon cœur amoureux, Et je ſens qu’avec vous il eſt d’intelligence.	Cependant vous rentrez dans mon cœur amoureux, Et je sens qu'avec vous il est d'intelligence.
Eſpoir, qui ſeduïſez les Amans mal-heureux, Pourqoy ſuſpendre ma vangeance?	Espoir, qui séduirsez les Amants malheureux, Pourq suspendre ma vengeance?
SCENEII.	SCENEII.
STENOBE’E, PHILONOE’, ARGIE.	STENOBE'E, PHILONONOE, ARGIE.
PHILONOE'.	PHILONOE.
Eyne, vous ſçaveZ qu’en ce jour Ie reçois un Eſpoux de la main de mon Pere.	Eyne, vous savez qu'en ce jour Je reçois un Époux de la main de mon Père.
I'attends le choix qu’il en doit faire Entre tous ces Amants qui rempliſſent ſa Cour.	J'attends le choix qu'il en doit faire Entre tous ces Amants qui remplissent sa Cour.
Obtenez qu’il n’en délibere Que de concert avec l’amour.	Obtenez qu'il n'en délibère Que de concert avec l'amour.
Qu’il eſt doux de trouver dans un Amant qu’on aime Un Espoux que l’on doit aimer!	Qu'il est doux de trouver dans un Amant qu'on aime Un Époux que l'on doit aimer!
Lors que te cœur à vnoiſi de luy-meſme Le ſeul Objet qui pouvoit l’enflamer, Qu’il eſt doux de trouver dans un Amant qu’on aime Un Espoux que l’on doit aimer!	Lors que te cœur à unaisi de Seigneur-même Le seul Objet qui pouvait l'enflammer, Qu'il est doux de trouver dans un Amant qu'on aime Un Éspoux que l'on doit aimer!
STENOBE’E.	STENOBE'É.
Quoy, Princeſſe, à l’amour vous auriez pû vous rendre?	Quoi, Princesse, à l'amour vous auriez pu vous rendre?
PHILONOE'.	PHILONOE.
En vain j’ay voulu m’en défendre.	En vain j'ai voulu m'en défendre.
STENOBE’E.	STENOBE'É.
Et qui donc aimeZ-vous?	Et qui donc aimez-vous?
PHILONOE'.	PHILONOE.
PHILONOE'.	PHILONOE.
Vn Heros que les Dieux Ont fait des Conquerans l’exemple glorieux.	Un Héros que les Dieux Ont fait des Conquérants l'exemple glorieux.
Eſtimé dans la paix, redouté dans la guerre, Il est, & la terreur, & l’amour de la Terre.	Estimé dans la paix, redouté dans la guerre, Il est, et la terreur, et l'amour de la Terre.
Si pour chercher à vaincre il court dans les haZards, d juapremitit emjEnnemis ſe rendent, Et s’il aime, il n’est point de cœurs qui ſe défendent De ſes premiers regards.	Si pour chercher à vaincre il court dans les hasards, d' juapremitit emjEnnemis se rendent, Et s'il aime, il n'est point de cœurs qui se défendent De ses premiers regards.
STENOBE’E.	STENOBE'É.
Ah!	Ah!
c’eſt Bellerophon.	c'est Belerophon.
PHILONOE' C’eſt luy, je le confeſſe, Ne condamnez point ma tendreſſe.	PHILONOE' C'est venir, je le confesse, Ne condamnez point ma tendresse.
Quand mille exploits fameux parlent pour un Amant, Peut-on reſiſter un moment?	Quand mille exploits fameux parlent pour un Amant, Peut-on résister un moment?
Aprés avoir vaincu deux Nations guerrieres, Bellerophon amemnt en ces lieux fortuneZ Les Amazones priſonnieres, Et les Solymes enchaiſneZ Il poſſede mon cœur, je puis tout ſur fon ame.	Après avoir vaincu deux Nations guerrières, Bellerophon âmemnt en ces lieux fortune Les Amazones prisonnières, Et les Solymes enchaisinés Il possède mon cœur, je puis tout sur son âme.
Reyne, favoriſez une ſi belle flame.	Reine, favorisez une si belle flamme.
CENE III.	CÈNE III.
STENOBE’E, ARGIE.	STENOBE'E, ARGIE.
STENOBE’E I je croyois qu'aucune ardeur E N’euſt jamais enflamé ſon cœur?	STENOBE'E I je croyais qu'aucune ardeur E N'eût jamais enflammé son cœur?
ARGIE.	ARGIE.
Un cœur qui paroiſt invincible Peut eſtre un temps ſans ſe laiſſer charmer;	Un cœur qui paraît invincible Peut être un temps sans se laisser charmer;
Mais on a beau ſe défendre d’aimer, Le moment vient d’eſtre ſenſible.	Mais on a beau se défendre d'aimer, Le moment vient d'être sensible.
STENOBE’E C’en eſt fait, l’outrage eſt trop grand.	STENOBE'E C'en est fait, l'outrage est trop grand.
Si ſes cruels refus faiſoient tort à ma gloire, Au moins il m’eſtoit doux de croire, Que mon cœur ſoûpiroit pour un Indifferent.	Si ses cruels refus faisaient tort à ma gloire, Au moins il m'était doux de croire, Que mon cœur soupirait pour un Indifférent.
Mais il aime, & c’eſt la ce qui me deſespere, Vne autre a fait ce que je n’ay pù faire.	Mais il aime, et c'est la ce qui me désespère, Une autre a fait ce que je n'ai pù faire.
Venez, haine, vangeance, & verſez dans mon cœur Voſtre poiſon le plus funeſte.	Venez, haine, vengeance, et versez dans mon cœur Votre poison le plus funeste.
Vous ne ſçaurieZ m’inspirer trop d’horreur Pour un Ingrat que je deteſte.	Vous ne sauriez m'inspirer trop d'horreur Pour un Ingrat que je déteste.
Suivons, ſuivons ce deſeſpoir, Il faut pour vanger mon outrage Qu'Amiſodar ſerve ma rage;	Suivons, suivons ce désespoir, Il faut pour venger mon outrage Qu'Amisodar serve ma rage;
Son Art dans les Enfers luy donne tout pouvoir, Il en peut évoquer quelque Monſtre effroyable Qui porte le vacage & ta ſamt entes ilelie, Il m'aime, & ſi ſur luy je veux jetter les yeux.	Son Art dans les Enfers ont donne tout pouvoir, Il en peut évoquer quelque Monstre effroyable Qui porte le vacage et ta samt entes ilelie, Il m'aime, et si sur deux je veux jeter les yeux.
nie alBo Le Roy vient, contraignez l’ennuy qui vous accable	nie alBo Le Roi vient, contraignez l'ennui qui vous accable
CENE IV.	CÈNE IV.
LE ROY, STENOBE’E, ARGIE, Suite.	LE ROY, STENOBE'E, ARGIE, Suite.
LE ROY.	LE ROY.
NOntre Bellerophon, j’ay fait juſqu’à ce jour Ce que Pretus pouvoit attendre De l’aveugle Zele d’un Gendre.	NOntre Bellerophon, j'ai fait jusqu'à ce jour Ce que Pretus pouvait attendre De l'aveugle Zèle d'un Gendre.
Vous voulieZ comme luy qu’il perît dans ma Cour.	Vous vouliez comme autre qu'il pérît dans ma Cour.
D’abord, ſans connoiſtre ſon crime, I'abandonnay ſa teste aux rigueurs de ſon ſort.	D'abord, sans connaître son crime, J'abandonnai sa tête aux rigueurs de son sort.
Pretus croyoit ſa perte legitime, C’eſtoit aſſeZ pour reſoudre ſa mort:	Prétus croyait sa perte légitime, C'était assez pour résoudre sa mort:
Mais enfin il eſt temps de vous ouvrir mon ame.	Mais enfin il est temps de vous ouvrir mon âme.
Aprés qu’il s’eſt rendu l’appuy de mes Eſtats, Ie dois me conſerver ſon bras:	Après qu'il s'est rendu l'appui de mes États, Je dois me conserver son bras:
Ma Fille eſt l’objet de ſa flâme, Aujourd’huy de ma main elle attend un Eſpoux, C’eſt luy que je choiſis.	Ma Fille est l'objet de sa flamme, Aujourd'hui de ma main elle attend un Époux, C'est ainsi que je choisis.
STENOBE’E.	STENOBE'É.
Ciel, que me dites-vous?	Ciel, que me dites-vous?
Choiſir Bellerophon!	Choisir Bellerophon!
& qui l’auroit pû croire?	et qui l'aurait pu croire?
LE ROI.	LE ROI.
Ses Exploits l’ont rendu digne de cette gloire.	Ses Exploits l'ont rendu digne de cette gloire.
STENOBEE.	STENOBE.
Donge Secous que Prerus vous demanda ſa mort?	Donge Secous que Prer vous ha sa mort?
LE ROY.	LE ROY.
Les Dieux ne m'ont point fait arbitre de ſon ſort.	Les Dieux ne m'ont point fait arbitre de son sort.
STENOBE’E.	STENOBE'É.
Quoy, vous ſoûteneZ un Coupable?	Quoi, vous soutenez un Coupable?
BEROT.	BEROT.
Quoy, vôtre haine eſt implacable?	Quoi, votre haine est implacable?
TOUS DEOX.	TOUS DEOX.
Ah!	Ah!
ceſſez de vous obſtiner.	cessez de vous obstiner.
LE ROY.	LE ROY.
MHalgré võtre jalouſe envie,	MHalgré vaître jalouse envie,
STENOBE’E.	STENOBE'É.
Malgré vos ſoins pour luy ſauver la vie,	Malgré vos soins pour ton sauver la vie,
Il merite le prix TOUS DEUX.	Il mérite le prix TOUS DEUX.
L la mort.	L la mort.
que je luy venx aonner.	que je était venx aonner.
On entend icy des Iimbales & des Trompettes.	On entend ici des Iimbales et des Trompettes.
STENOBE’E.	STENOBE'É.
A ce bruit éclatant je connois qu’il s’avance.	À ce bruit éclatant je connais qu'il s'avance.
Ie ne vous dis plus rien, mais vous devez ſonger, Que ſi vous negligez le ſoin de ma vangeance, Ie ſuis Reyne, & puis me vanger.	Je ne vous dis plus rien, mais vous devez songer, Que si vous négligez le soin de ma vengeance, Je suis Reine, et puis me venger.
Aprés que Stenobée eſt ſortie, on voit entrer vne Troupe d’Amazones, & de Solymes enchaînez, dont ceux qui les conduiſent portent les Arliest na Miarone que cette Troupe fait ſur le Theatre eſt une eſpece de Triomphe pour Bellerophon qui entre aprés que les Amazones & les Solymes ont paſſé devant le Roy, & pris leur place.	Après que Stenobée est sortie, on voit entrer quelque Troupe d'Amazones, et de Solymes enchaînés, dont ceux qui les conduisent portent les Arliest na Miarone que cette Troupe fait sur le Théâtre est une espèce de Triomphe pour Bellerophon qui entre après que les Amazones et les Solymes ont passé devant le Roi, et pris leur place.
SCENE V.	SCÈNE V.
LE ROI DDILINOTTON, Troupe d’Amazones, & de Solymes.	LE ROI DDILINOTON, Troupe d'Amazones, et de Solymes.
LE ROY.	LE ROY.
Y Enez, venez goûter les doux fruits de la gloire, V Qui dãs tout l’Vnivers vous fait tant de jaloux.	Y Énez, venez goûter les doux fruits de la gloire, V Qui dans tout l'Univers vous fait tant de jaloux.
BELLEROPHON.	BELLEROPHON.
Seigneur, quand on combat pour vous N'eſt-on pas ſeur de la victoire?	Seigneur, quand on combat pour vous N'est-on pas sûr de la victoire?
LE ROY.	LE ROY.
Aprés avoir rangé deux Peuples ſous mes Loix, Prince, voſtre rare vaillance Demeureroit ſans récompenſe Si ma Fille n’estoit le prix de vos exploits.	Après avoir rangé deux Peuples sous mes Lois, Prince, votre rare vaillance Demeurerait sans récompense Si ma Fille n'était le prix de vos exploits.
Vous l’aimez, elle vous aime, SoyeZ heureux, j’y conſens.	Vous l'aimez, elle vous aime, SoyeZ heureux, j'y consens.
BELLEROPHON.	BELLEROPHON.
Ah Seigneur!	Ah Seigneur!
puis-je encor me connoiſtre moy-meſme?	puis-je encor me connaître moi-même?
LE ROY.	LE ROY.
La valeur obtient tout des cœurs reconnoiſſans.	La valeur obtient tout des cœurs reconnaissants.
v n Teros que ia givire cieve N'eſt qu’a demy récompenſé, Et c’eſt peu ſi l’amour n’acheve Ce que la gloire a commencé.	viens n' Est que ja givire ciève N'est qu'a demi récompensé, Et c'est peu si l'amour n'ache Ce que la gloire a commencé.
BELLEROPHON.	BELLEROPHON.
Surpris de tant d’honneurs je ne puis que me taire.	Surpris de tant d'honneurs je ne puis que me taire.
Quel ſervice aſſeZ grand pou-voit les meriter.	Quel service assez grand poulait les mériter.
I'euſſe esté trop temeraire Si j’euſſe osé m'en flater, Moy qu’un Frere a chaſſé d’Ephyre, Ou mon Pere Glaucus avoit donné la Loy.	J'eusse été trop téméraire Si j'eusse osé m'en flatter, Moi qu'un Frère a chassé d'Éphyre, Ou mon Père Glaucus avait donné la Loi.
LE ROY.	LE ROY.
Estre l'appuy de mon Empire, C’est meriter aſſeZ d’y regner aprés moy.	Être l'appui de mon Empire, C'est mériter assez d'y régner après moi.
Qu’aucun ne garde icy des ſujets de triſteſſe.	Qu'aucun ne garde ici des sujets de tristesse.
A vos Captifs je rends la liberté.	À vos Captifs je rends la liberté.
BELLEROPHON, aux Amazones & aux Solymes.	BÉLEROPHON, aux Amazones et aux Solymes.
Faites tous voir vôtre allegreſſe En ſortant de captivité.	Faites tous voir votre allégresse En sortant de captivité.
Le Roy & Bellerophon eſtant ſortis, ceux qui ont Coridure ren Frinaones će les Goij meo y leur oſtent.	Le Roi et Bellerophon étant sortis, ceux qui ont Coridure ren Frinaones les Goij y leur ôtent.
les fers, & rendent l’eſpée aux unes, & la lance aux autres.	les fers, et rendent l'épée aux unes, et la lance aux autres.
AMAZONES.	AMAZONES.
Quand un Vainqueur eſt tout brillant de gloire Duel domt ese porter fes jers!	Quand un Vainqueur est tout brillant de gloire Duel dompt eze porter se rs!
SOLYMES.	SOLYMES.
Celuy qui nous ſoûmit commande à la Victoire, Il ſoûmetra tout l’Vnivers.	Celui qui nous soumit commande à la Victoire, Il soumetra tout l'Univers.
CHOEUR des Amazones & des Solymes.	CHOEUR des Amazones et des Solymes.
Diſons cent fois ce qu’on ne peut trop dire, Heureux qui vit ſous ſon Empire!	Disons cent fois ce qu'on ne peut trop dire, Heureux qui vit sous son Empire!
Les Amazones & les Solymes commencent icy leurs Danſes, & chantent enſuite les paroles ſuivantes, dont chaque couplet ſe chante aprés unc Entrée.	Les Amazones et les Solymes commencent ici leurs Danses, et chantent ensuite les paroles suivantes, dont chaque couplet se chante après un Entrée.
AMAZONES & SOLYMES.	AMAZONES et SOLYMES.
Faiſons ceſſer nos alarmes, Coûtons les biens que rend la liberté.	Faisons cesser nos alarmes, Coûtons -les biens que rend la liberté.
Celuy dont chacun craint les armes A fait finir noſtre captivité.	Celui dont chacun craint les armes A fait finir notre captivité.
Un ſort ſi plein de charmes Met nôtre gloire enfin en ſeureté.	Un sort si plein de charmes Met notre gloire enfin en sûreté.
128 Rompons le cours de nos larmes, Nos deplaiſirs ont aſſeZ éclaté Celuy dont chacun craint les armes A fait finir noſtre captivité.	128 Rompons le cours de nos larmes, Nos déplaisirs ont assez éclaté Celui dont chacun craint les armes A fait finir notre captivité.
Un ſort ſi plein de charmes	Un sort si plein de charmes
PIN DOTREMIER ACTE.	PIN DOTREMIÈR ACTE.
ACIE SLCOND.	ACIE SLCOND.
Le Theatre repreſente un Iardin delicieux, au milieu duquel paroiſt un Berçeau enforme de Dôme, ſoûtenu à l’entour de pluſieurs Termes:	Le Théâtre représente un Jardin délicieux, au milieu duquel paraît un Berçeau enforme de Dôme, soutenu à l'entour de plusieurs Termes:
Au travers de ce Berceau on decouvre trois Allées, dont celle du milieu eſt terminée par un ſuperbe Palais en éloigniement.	Au travers de ce Berceau on découvre trois Allées, dont celle du milieu est terminée par un superbe Palais en éloigniement.
Les deuA autres fiiient a perte de veuë.	Les devA autres fiient a perte de vue.
SCENE PREMIERE.	SCÈNE PREMIÈRE.
PHILONOE’, Deux Amazones.	PHILONOE', Deux Amazones.
L ¶ MOVR, mes vœux ſont ſatisſaits, Il m’eſt doux de porter tes chaiſnes, Et j’oublie aujourd’huy les peines Qui de mon cœur avoient troublé la paix, Cruelles inquietudes, Soûpirs languiſſans, Si j’ay ſouffert vos tourments les plus rudes, Ie n’ay pas trop payé les douceurs que je ſens.	L' est MOUR, mes vœux sont satissaits, Il m'est doux de porter tes chaînes, Et j'oublie aujourd'hui les peines Qui de mon cœur avaient troublé la paix, Cruelles inquiétudes, Soupirs languissants, Si j'ai souffert vos tourments les plus rudes, Je n'ai pas trop payé les douceurs que je sens.
I.	I.
AMAZONE.	AMAZONE.
Les douceurs que l’amour fait trouver dans ſes chaînes, Aux plus heureux Amans ont coûté des ſoüpirs.	Les douceurs que l'amour fait trouver dans ses chaînes, Aux plus heureux Amants ont coûté des soupirs.
1I.	1I.
AMAZONE.	AMAZONE.
Des piupfers eui nont point commencé par les peines, Ne ſont jamais de vrais plaiſirs.	Des piupfers eui nont point commencé par les peines, Ne sont jamais de vrais plaisirs.
PHILONOE’.	PHILONOE.
Chantez, chanteZ la valeur éclatante Du plus grand des Heros, Si la Lycie eſt triomphante, C’eſt à luy qu'elle doit ſa gloire & ſon repos.	Chantez, chantez la valeur éclatante Du plus grand des Héros, Si la Lycie est triomphante, C'est à lui qu'elle doit sa gloire et son repos.
I.	I.
AMALONE.	AMALONE.
Que de Lauriers ſur une ſeule teſte!	Que de Lauriers sur une seule tête!
Avec luy la Victoire a peine a reſpirer.	Avec lui a Victoire a peine a respirer.
1I.	1I.
AMAZONE.	AMAZONE.
De l'Vnivers entier il eût fait la conqueſte, Si ſon grand cœur n’eût ſçeu ſe moderer.	De l'Univers entier il eût fait la conquête, Si son grand cœur n'eût su se modérer.
Toutes deux.	Toutes deux.
Chantons, chantons la valeur éclatante Du plus grand des Heros;	Chantons, chantons la valeur éclatante Du plus grand des Héros;
Si la Lycie est triomphante, C’eſt à luy qu'elle doit ſa gloire & ſon repos.	Si la Lycie est triomphante, C'est à lui qu'elle doit sa gloire et son repos.
SCENE II.	SCÈNE II.
BELLEROPHON, PHILONOE', AMAZONES.	BÉLEROPHON, PHILONONO, AMAZONES.
BELLEROPHON.	BELLEROPHON.
DRinceſſe, tout conſpire à couronner ma flâme, Tout s’apreste pour mon bon-heur.	DRincesse, tout conspire à couronner ma flamme, Tout s'apprête pour mon bonheur.
SenteZ-vous les plaiſirs qui regnent dans mon ame, Et les meſmes tranſports charment-ils voſtre cœur?	Sentez-vous les plaisirs qui règnent dans mon âme, Et les mêmes transports charment-ils votre cœur?
PHILONOE', L’amour qui nous unit par de ſi douces chaînes A dés long-temps uny tous nos deſirs;	PHILONOE', L'amour qui nous unit par de si douces chaînes A dès longtemps uni tous nos désirs;
A vos ſoûpirs cent fois j’ay meſlé mes ſoupirs, Et ſi j’ay partagé vos peines, Ie dois partager vos plaiſirs.	À vos soupirs cent fois j'ai mêlé mes soupirs, Et si j'ai partagé vos peines, Je dois partager vos plaisirs.
BELLEROPHON Qu’un ſi doux aveu doit me plaire!	BÉLEROPHON Qu'un si doux aveu doit me plaire!
Qu’il rend mon deſtin glorieux!	Qu'il rend mon destin glorieux!
PHILONOE’.	PHILONOE.
Quand ma bouche pourroit ſe taire, L’Amourferoit parler mes yeux.	Quand ma bouche pourrait se taire, L'Amourferait parler mes yeux.
Tous deux Que tout parle à l'envy de nôtre amour extréme, A ſes tranſports abandonnons nos cœurs, Et pour goûter toûjours de nouvelles douceurs.	Tous deux Que tout parle à l'envi de notre amour extrême, À ses transports abandonnons nos cœurs, Et pour goûter toujours de nouvelles douceurs.
Diſons-nous cent fois;	Disons-nous cent fois;
je vous aime.	je vous aime.
PHILONOE', voyant Stenbbée.	PHILONONE', voyant Stenbbée.
Prince, Adieu;	Prince, Adieu;
mon devoir m'appelle auprés du Roy, Ie vous laiſſe le ſoin d’entretenir la Reyne.	mon devoir m'appelle auprès du Roi, Je vous laisse le soin d'entretenir la Reine.
BELLEROPHON.	BELLEROPHON.
Quel cruel ſupplice pour moy!	Quel cruel supplice pour moi!
SCENE III.	SCÈNE III.
STENOBE’E, BELLEROPHON, ARGIE.	STENOBE'E, BÉLEROPHON, ARGIE.
STENOBE’E.	STENOBE'É.
A preſence icy te fait peine.	À présence ici te fait peine.
M BELLEROPHON.	M MELLEROPHON.
Il eſt vray, je frémis lors que je vous revoy.	Il est vrai, je frémis lors que je vous revois.
Quel deſtin ennemy vous améne en Lycie?	Quel destin ennemi vous amène en Lycie?
Y venez vous chercher à troubler mon repos?	Y venez -vous chercher à troubler mon repos?
Vous m’avez fait bannir d’Argos, Ne verray-je jamais voſtre haine adoucie?	Vous m'avez fait bannir d'Argos, Ne verrai-je jamais vôtre haine adoucie?
STENOBE’E.	STENOBE'É.
S’il te ſouvient des maux que je t’ay faits, Qu’il te ſouvient auſſi de ma tendreſſe extreſme;	S'il te souvient des maux que je t'ai faits, Qu'il te souvient aussi de ma tendresse extrême;
Ne me reproche point ingrat que je te haïs, Ou reproche moy que je t’ayme.	Ne me reproche point ingrat que je te haïs, Ou reproche moi que je t'aime.
I'ay tâché de te perdre, & j’ay crû le vouloir, I'ay ſuivy les tranſports d’une aveugle vangeance;	J'ai tâché de te perdre, et j'ai cru le vouloir, J'ai suivi les transports d'une aveugle vengeance;
Mais plus à mon amour j’ay fait de violence, Plus ſur mon cœur il a pris de pouvoir, Et je ne t’ay jamais hai qu’en apparence.	Mais plus à mon amour j'ai fait de violence, Plus sur mon cœur il a pris de pouvoir, Et je ne t'ai jamais hai qu'en apparence.
BELLEROPHON.	BELLEROPHON.
Vous m’avez ſans relâche accablé de mal-heurs, Ie n’ay point reconnû l’amour dans vos fureurs.	Vous m'avez sans relâche accablé de malheurs, Je n'ai point reconnu l'amour dans vos fureurs.
Si l’amour quelque fois s’abandonne à la rage, Il eſt toüjours amour, meſme quand il outrage:	Si l'amour quelque fois s'abandonne à la rage, Il est toujours amour, même quand il outrage:
Mais vous toûjours conſtante à me perſecuter, Vous n’avez épargné ma gloire ny ma vie, Et je ne dois rien écouter De ma plus mortelle Ennemie,	Mais vous toujours constante à me persécuter, Vous n'avez épargné ma gloire toujours ma vie, Et je ne dois rien écouter De ma plus mortelle Ennemie,
SCENE IV STENOBE’E, ARGIE.	SCÈNE IV STENOBE'E, ARGIE.
T STENOBE’E.	 TTENOBE'ÉTE.
NU me quittes, cruel!	NU me quittes, cruel!
arreſte.	arrête.
Il fuit, helas!	Il fuit, hélas!
Mon amour voit ſa honte, & n’en profite pas Uous ne ſçauriez guerir le mal qui me tourmente, Foibles retours d’un impuiſſant dépit;	Mon amour voit sa honte, et n'en profite pas Uous ne sauriez guérir le mal qui me tourmente, Faibles retours d'un impuissant dépit;
Des meſpris d’un Ingrat ma flâme ſe nourit, Elle devroit s’éteïndre & devient plus ardente.	Des mépris d'un Ingrat ma flamme se nourrait, Elle devrait s'éteïndre et devient plus ardente.
L’amour trop heureux s’affoiblit, Pauie inmour mal-heureux s’augmente.	L'amour trop heureux s'affaiblit, Pavie inmour malheureux s'augmente.
ARGIE.	ARGIE.
Quoy, vous pourrez toûjours ſouffrir Qu'on vous brave, qu’on vous dédaigne?	Quoi, vous pourrez toujours souffrir Qu'on vous brave, qu'on vous dédaigne?
STENOBE’E.	STENOBE'É.
Non, il faut dans ſon ſang que mon amour s’eteigne, Perdons tout, faiſons tout perir.	Non, il faut dans son sang que mon amour s'éteigne, Perdons tout, faisons tout périr.
SCENE V STENOBE’E, AMISODAR, ARGIE.	SCÈNE V TENOBE, AMISODAR, ARGIE.
STENOBE’E.	STENOBE'É.
* Ous me jurez ſans ceſſe une amour éternelle.	* Ous me jurez sans cesse une amour éternelle.
* Croiray-je Amiſodar, croiray-je vos ſermens?	* Croirai-je Amisodar, croirai-je vos serments?
Me ſereZ-vous aſſez fidelle Pour ne refuſer rien à mes reſſentiments?	Me serez-vous assez fidèle Pour ne refuser rien à mes ressentiments?
AMISODAR.	AMISODAR.
Lors que l’amour vous aſſervit mon ame, Votre in ſenſible cœur devroit ſe contenter De ne pas reſpondre à ma flame;	Lors que l'amour vous asservit mon âme, Votre in sensible cœur devrait se contenter De ne pas répondre à ma flamme;
Pourquoy me faire encõr l’outrage d’en douter?	Pourquoi me faire encõr l'outrage d'en douter?
Vos froideurs, voſtre indifference, Me touchent moins que cette offenſe, Ie meurs pour vos divins appas, Et viens vous demander pour touté récompenſe Que vous n’en doutiez pas.	Vos froideurs, votre indifférence, Me touchent moins que cette offense, Je meurs pour vos divins appas, Et viens vous demander pour tout récompense Que vous n'en doutiez pas.
STENOBE’E, Bellerophon m’a fait une mortelle injure, Le Roy la connoiſt & l’endure, Il le choiſit pour Gendre au lieu de le punir.	STENOBE'E, Bellerophon m'a fait une mortelle injure, Le Roi la connaît et l'endure, Il le choisit pour Gendre au lieu de le punir.
Troublons l’Hymen qui fe prepare Par une vangeance barbare Dont le ſeul ſouvenir Faſſe trembler tout-l’avenir.	Troublons l'Hymen qui se prépare Par une vengeance barbare Dont le seul souvenir Fasse trembler tout-l'avenir.
AMISODAR.	AMISODAR.
Ie puis de la nuit infernale, Faire ſortir un Monſtre furieux:	Je puis de la nuit infernale, Faire sortir un Monstre furieux:
Mais vous-meſme tremblez d’exercer en ces lieux Vne vangeance ſi fatale.	Mais vous-même tremblez d'exercer en ces lieux Ve ngeance si fatale.
PrepareZ-vous à voir nos Peuples allarmez, Et nos Villes tremblantes.	Préparez-vous à voir nos Peuples alarmés, Et nos Villes tremblantes.
Le Monſtre couvrira de torrents enflamez Nos Campagnes fumantes Et nos champs ne ſeront ſemez Que des reſtes affreux de Victimes ſanglantes.	Le Monstre couvrira de torrents enflamés Nos Campagnes fumantes Et nos champs ne seront semés Que des restes affreux de Victimes sanglantes.
STENOBE’E.	STENOBE'É.
Que ce Spectacle ſera doux A la fureur qui me tranſporte!	Que ce Spectacle sera doux À la fureur qui me transporte!
Pauſtte cous 5 nuste Z(vous, De ſervir mon courroux, Faites ouvrir la terre, & que le Monſtre en ſorte.	Paustte cous 5 nuste Zwvous, De servir mon courroux, Faites ouvrir la terre, et que le Monstre en sorte.
Haſtez-vous, haſteZ-vous De ſervir mon courroux.	Hâtez-vous, hâtez-vous De servir mon courroux.
AMISODAR.	AMISODAR.
Iuſqu’au fond des Enfers je vay me faire entendre, Fuyez, Reyne, fuyez;	Jusqu'au fond des Enfers je vais me faire entendre, Fuyez, Reine, fuyez;
Vos yeux ſeroient trop effrayeZ De l’horreur qu'en ces lienames Onurmes cont répãdre.	Vos yeux seraient trop effrayeZ De l'horreur qu'en ces lienames Onurmes cont endre.
SCENE VI.	SCÈNE VI.
AMISODAR ſeul.	AMISODAR seul.
Ve ce Jardin ſe change en un Deſert affreux.	Ve ce Jardin se change en un Desert affreux.
Le Iardin diſparoiſt, & l’on voit en ſa place une eſpece de priſon horrible taillée dans les Rochers, & percée à perte de veuë, avec pluſieurs Chaînes, Cordages, & Grilles de fer qui la rempliſſent de toutes parts.	Le Jardin disparaît, et l'on voit en sa place une espèce de prison horrible taillée dans les Rochers, et percée à perte de vue, avec plusieurs Chaînes, Cordages, et Grilles de fer qui la remplissent de toutes parts.
Noirs Hſabitans du séjour tenebreux, Pour m'ecouter dans vos demeures ſombres;	Noirs Hsabitants du séjour ténébreux, Pour m'écouter dans vos demeures sombres;
Redoublez, s’il ſe peut, le ſilence des Ombres.	Redoublez, s'il se peut, le silence des Ombres.
Et vous à me ſervir employeZ tant de fois, Miniſtres de mon Art, accourez à ma voix.	Et vous à me servir employez tant de fois, Ministres de mon Art, accourez à ma voix.
Quatre Magiciens & quatre Magiciennes paroiſſent, & témoignent en dançant, l’ardeur avec laquelle ils ſe preparent à ſervir Amiſodar.	Quatre Magiciens et quatre Magiciennes paraissent, et témoignent en dançant, l'ardeur avec laquelle ils se préparent à servir Amisodar.
Apres cette Entrée, d’autres Magiciens, au nombre de quatorze, viennent faire avec luy la Scene ſuivante.	Après cette Entrée, d'autres Magiciens, au nombre de quatorze, viennent faire avec lui a Scène suivante.
CENE VII.	CÈNE VII.
AMISODAR, MAGICIENS.	AMISODAR, MAGICIENS.
MITGIOIENO.	MITGIOIENO.
D Arle, nous voilà preſts, tout nous ſera poſſible.	D Arle, nous voilà prêts, tout nous sera possible.
AMISODAR.	AMISODAR.
Faiſons ſortir un Monſtre horrible.	Faisons sortir un Mons horrible.
Pour l’évoquer employeZ l’Acheron, Le Cocyte, le Phlegeton;	Pour l'évoquer employez l'Acheron, Le Cocyte, le Phlégeton;
Faites que voſtre voix dans tout l’Enfer réſonne.	Faites que votre voix dans tout l'Enfer résonne.
C eſt moy qui vous l’ordonne.	Ç est moi qui vous l'ordonne.
Les Magiciens ſe jettent icy contre terre pour l’évocation.	Les Magiciens se jettent ici contre terre pour l'évocation.
MAGICIENS.	MAGICIENS.
Par ce preſſant commandement, T romprement, promprement, Que le Tenare s’ouvre, Que l'Enfer ſe découvre;	Par ce pressant commandement, T romprement, promprement, Que le Ténare s'ouvre, Que l'Enfer se découvre;
Cocyte, Phlegeton, il nous faut du ſecours, Pour nous entendre arrestez voſtre cours.	Cocyte, Phlégeton, il nous faut du secours, Pour nous entendre arrêtés votre cours.
AMISODAR.	AMISODAR.
Pourſuivez.	Poursuivez.
Que pour moy voſtre pouvoir éclate;	Que pour moi votre pouvoir éclate;
Par Cerbere & la triple Hécate;	Par Cerbère et la triple Hécate;
Parlez, preſſez, appellez, à grand bruit, Et la Mort & la Nuit.	Parlez, pressez, appelez, à grand bruit, Et la Mort et la Nuit.
Les Magiciens ſe jettent de nouveau contre terre.	Les Magiciens se jettent de nouveau contre terre.
MAGICIENS.	MAGICIENS.
Nuit, Mort, Cerbere, Hecate, Erebe, Averne, Deoute Reres uus oine, que lu pureur gouverne, EntendeZ nos cris, ſerveZ-nous, Nous travaillons pour vous.	Nuit, Mort, Cerbère, Hecate, Erebe, Averne, Deoute Rés oine, que lu pureur gouverne, EntendeZ nos cris, serveZ-nous, Nous travaillons pour vous.
AMISODAR.	AMISODAR.
Le Charme eſt fait, les Monſtres vont paroiſtre La Terre s’ouvre & me le fait connoiſtre.	Le Charme est fait, les Monstres vont paraître La Terre s'ouvre et me le fait connaître.
Rendons aux ſombres Deïtez Les honneurs que de nous elles ont meriteZ La Terre s’ouvre, & on en voit ſortir trois Monſtres qui s’élevent au deſſus de trois Bûchers ardens, l’un en forme de Dragon, l’autre de Lyon, & le dernier de Bouc.	Rendons aux sombres Deïtez Les honneurs que de nous elles ont mérits La Terre s'ouvre, et on en voit sortir trois Monstres qui s'élèvent au dessus de trois Bûchers ardents, l'un en forme de Dragon, l'autre de Lyon, et le dernier de Bouc.
Trois des Magiciens montent deſſus;	Trois des Magiciens montent dessus;
Aprés quoy, les quatre qui ont désja dancé font une nouvelle Entrée avec les quatre Magiciennes, pour marquer leur joye de ce que le Charme a reüſſi.	Après quoi, les quatre qui ont déjà dancé font une nouvelle Entrée avec les quatre Magiciennes, pour marquer leur joie de ce que le Charme a réussi.
Leur Dance eſtant finie, les trois Magiciens qui ſont ſur les Monſtres chantent alternativement les paroles ſuivantes avec les autres Magiciens.	Leur Dance étant finie, les trois Magiciens qui sont sur les Monstres chantent alternativement les paroles suivantes avec les autres Magiciens.
MAGICIENS.	MAGICIENS.
La Terre nous ouvre, Ses Gouffres profonds!	La Terre nous ouvre, Ses Gouffres profonds!
L’Enfer ſe découvre.	L'Enfer se découvre.
Chantons, triomphons On voit l’onde noire Pour nous s’arreſter.	Chantons, triomphons On voit l'onde noire Pour nous s'arrêter.
Victoire, Victoire, Victoire, Nous avons la gloire De tout ſurmonter.	Victoire, Victoire, Victoire, Nous avons la gloire De tout surmonter.
Triomphe, Victoire, Triomphe, Victoire, Nous avons la gloire De tout ſurmonter Non, non, rien ne peut nous reſister.	Triomphe, Victoire, Triomphe, Victoire, Nous avons la gloire De tout surmonter Non, non, rien ne peut nous résister.
AMISODAR.	AMISODAR.
Vn Monſtre ſeul cauſeroit plus d’effroy, Il faut unir ces trois Monstres en ſemble.	Vn Monsieur seul causerait plus d'effroi, Il faut unir ces trois Monstres en semble.
Par un Charme plus fort & plus digne de moy, Tuſfons qu'un feuucorps les aſſemble;	Par un Charme plus fort et plus digne de moi, Tusfons qu'un feucorps les assemble;
Quut on ouuu uoout deſcendons aux Enfers Les Gouffres nous en ſont ouverts.	Quut on ouuu uoout descendons aux Enfers Les Gouffres ut on sont ouverts.
Tout s’abyſme, & la Terre ſe referme.	Tout s'abîme, et la Terre se referme.
DU SECORDHOIEE	DU SECORDHOIE
ACTEIII.	ACTEIII.
Le Theatre repreſente le Veſtibule du Temple fameux, où Apollon rendoit ſes Oracles dans la Ville de l'atare.	Le Théâtre représente le Vestibule du Temple fameux, où Apollon rendait ses Oracles dans la Ville de l'atare.
Ce Temple paroiſt d’abord fermé dans le fond, & ne s’ouvre que lors que la Ceremonie commence à paroiſtre.	Ce Temple paraît d'abord fermé dans le fond, et ne s'ouvre que lors que la Cérémonie commence à paraître.
SCENE PREMIERE.	SCÈNE PREMIÈRE.
STENOBE’E, ARGIE.	STENOBE'E, ARGIE.
ARGIE.	ARGIE.
Ve vous faites couler & de ſang & de larmes Dans ces triſtes climats!	Ve vous faites couler et de sang et de larmes Dans ces tristes climats!
Tout tremble, tout en eſt en allarmes.	Tout tremble, tout en est en alarmes.
On voit regner par tout l’image du treſpas, Et le Monſtre animé par la force des Charmes Marque de mille morts la trace de ſes pas.	On voit régner par tout l'image du trépas, Et le Montre animé par la force des Charmes Marque de mille morts la trace de ses pas.
STENOBE’E Lieux deſolez, & remplis de carnage, Campagnes où le Monſtre a ſemé tant d’horreur, Ne me reprochez point ma jalouſe fureur, Dont voſtre embraſement eſt le fatal ouvrage;	STENOBE'E Lieux désolés, et remplis de carnage, Campagnes où le Monstre a semé tant d'horreur, Ne me reprochez point ma jalouse fureur, Dont votre embrasement est le fatal ouvrage;
L Amour deſeſpere qui regne dans mon cœur Vous vange aſſeZ de ce ravage.	L Amour désespère qui règne dans mon cœur Vous venge assez de ce ravage.
ARGIE.	ARGIE.
Quoy, vous ne goûtez point la ſecrette douceur D’avoir troublé l’Hymen qui vous outrage?	Quoi, vous ne goûtez point la secrète douceur D'avoir troublé l'Hymen qui vous outrage?
STENOBE’E.	STENOBE'É.
Impuiſſante vangeance!	Impuissante vengeance!
inutile ſecours!	inutile secours!
Dequoy peux-tu ſervir quand on aime toûjours?	Dequoy peux-tu servir quand on aime toujours?
Les plus cruels tranſports que la fureur inſpire Conſolent mal un amour outragé.	Les plus cruels transports que la fureur inspire Consolent mal un amour outragé.
Ce mal-heureux amour aprés s’eſtre vangé, N'en fait pas moins ſentir ſon tyrannique empire, Impuiſſante vangeance!	Ce malheureux amour après s'être vengé, N'en fait pas moins sentir son tyrannique empire, Impuissante vengeance!
inutile ſecours!	inutile secours!
Dequoy peux-tu ſervir quand on aime toûjours?	Dequoy peux-tu servir quand on aime toujours?
SCENE II.	SCÈNE II.
LE ROY, STENOBE’E, ARGIE.	LE ROY, STENOBE'E, ARGIE.
LE ROY.	LE ROY.
Ve de mal-heurs accablent la Lycie?	Ve de malheurs accablent la Lycie?
Si le Ciel luy gardoit de ſi funeſtes coups, Avant qu’il fit ſur elle éclater ſon courroux, Que ne m’a-t’il oſté la vie?	Si le Ciel avait gardait de si funestes coups, Avant qu'il fit sur elle éclater son courroux, Que ne m'a-t-il ôté la vie?
de ne vois en taus tieux que ues marques d’effroy, Que des objets qui m'épouvantent, Et je partage comme Roy Les maux que mes Sujets reſſentent.	de ne vois en taus tieux que ûes marques d'effroi, Que des objets qui m'épouvantent, Et je partage comme Roy Les maux que mes Sujets ressent.
STENOBE’E.	STENOBE'É.
Quand vous voyeZ vos Peuples abbatus, ReconnoiſſeZ du Ciel la juſtice ſupréme.	Quand vous voyeZ vos Peuples abattus, Reconnaisez du Ciel la justice suprême.
Vous n’avez pas vangé l’injure de Pretus, Il la vange luy-meſme.	Vous n'avez pas vengé l'injure de Pretus, Il la venge lui-même.
Bellerophon Uictorieux Cauſe tous les mal-heurs dont voſtre cœur ſoûpire, C’eſt contre luy ſeul que les Dieux Ont envoyé le Monſtre furieux, Qui déſole tout vostre Empire.	Bellerophon Uictorieux Causse tous les malheurs dont votre cœur soupire, C'est contrefois seul que les Dieux Ont envoyé le Monstre furieux, Qui désole tout vôtre Empire.
Que ſa valeur en délivre ces lieux.	Que sa valeur en délivre ces lieux.
Puis que ſon crime vous l’attire.	Puis que son crime vous l'attire.
SCENE III.	SCÈNE III.
LE ROY, BELLEROPHON.	LE ROY, BÉLLEROPHON.
BELLEROPHON.	BELLEROPHON.
J Ous venez conſulter l’Oracle d'Apollon?	 Jus venez consulter l'Oracle d'Apollon?
LE ROY.	LE ROY.
Ie ciens iny demander te iſi it jaut que j'eſpere;	Je ciens ini demander te izy it jaut que j'espère;
De mes Eſtats c’est le Dieu tutelaire, Il écoute ma voix, quand j’implore ſon nom.	De mes États c'est le Dieu tutélaire, Il écoute ma voix, quand j'implore son nom.
BELLEROPHON.	BELLEROPHON.
Ce Dieu qui cherit la Lycie Dans ſes mal-heurs voudra la ſecourir, Et l’encens qu’en ces lieux vous luy veneZ offrir Rendra du Ciel la colere adoucie;	Ce Dieu qui chérit la Lycie Dans ses malheurs voudra la secourir, Et l'encens qu'en ces lieux vous a vez offrir Rendra du Ciel la colère adoucie;
Mais quand le Monſtre immole à ſa fureur Tout le ſang qu’il trouve à répandre, Verray-je ſans rien entreprendre Que par luy dans ces lieux tout ſoit remply d’horreur?	Mais quand le Montre immole à sa fureur Tout le sang qu'il trouve à répandre, Verrai-je sans rien entreprendre Que par mieux dans ces lieux tout soit rempli d'horreur?
LE ROY.	LE ROY.
Ah!	Ah!
Prince, ſongeZ-vous que trois Monſtres enſemble, Sont unis dans ce Monstre affreux?	Prince, songez-vous que trois Monstres ensemble, Sont unis dans ce Monstre affreux?
A ſon aſpect il n’est rien qui ne tremble, De ſa brûlante haleine il pouſſe mille feux.	À son aspect il n'est rien qui ne tremble, De sa brûlante haleine il pousse mille feux.
BELLEROPHON.	BELLEROPHON.
BELLEROPHON.	BELLEROPHON.
Ces trois Monſtres unis n’ont rien qui m’épouvante?	Ces trois Monstres unis n'ont rien qui m'épouvante?
Plus le Combat coute au Uainqueur, Plus la victoire eſt éclatante, Et c’eſt ce qui flate vn grand Cœur.	Plus le Combat coute au Uainqueur, Plus la victoire est éclatante, Et c'est ce qui flatte un grand Cœur.
SCENE TV.	SCÈNE TU.
LE ROY, PHILONOE', BELLEROPHON.	LE ROY, PHILONONO, BELLEROPHON.
PHILONOE’.	PHILONOE.
Eigneur, à votre voix je vtens joindre la mienne, S Aux vœux que vous offrez je viẽs méler mes pleurs, Et demander au Ciel que la Lycie obtienne La fin de ſes mal-heurs.	Eigneur, à votre voix je vtends joindre la mienne, S Aux vœux que vous offrez je viens mêler mes pleurs, Et demander au Ciel que la Lycie obtienne La fin de ses malheurs.
LE ROY.	LE ROY.
Contre le Monſtre qui les cauſe Béllérophon vveut employer jon bras.	Contre le Montre qui les cause Béllérophon veut employer jon bras.
ConſentireZ-vous qu’il s’expoſe?	Consentirez-vous qu'il s'expose?
PHILONOE'.	PHILONOE.
Ah!	Ah!
vous-meſme Seigneur, vous n’y conſentez pas;	vous-même Seigneur, vous n'y consentez pas;
SouffrireZ-vous qu’il coure ou la mort eſt certaine?	Souffrirez-vous qu'il coure ou la mort est certaine?
BELLEROPHON.	BELLEROPHON.
On court à la Victoire en s’expoſant pour vous, royeZ-en l’ardeur qui m'entraîne.	On court à la Victoire en s'exposant pour vous, royez-en l'ardeur qui m'entraîne.
Helas!	Hélas!
ſans les frayeurs dont la Lycie est pleine, Ie ſerois désja vostre Eſpoux.	sans les frayeurs dont la Lycie est pleine, Je serais déjà votre Époux.
PHILONOE' Efpavens vons des miemve y a arotont orage Améne quelque fois le calme le plus doux.	PHILONOE' Efpavens vons des miemue y a arotont orage Amène quelque fois le calme le plus doux.
LE ROY.	LE ROY.
Le Temple s’ouvre;	Le Temple s'ouvre;
entrons, & par un juſte hommage Meritons que le Ciel appaiſe ſon couroux.	entrons, et par un juste hommage Méritons que le Ciel apaise son courroux.
Le Sacrificateur paroiſt avec ſes miniſtres;	Le Sacrificateur paraît avec ses ministres;
& un grand nombre de Peuple qui entre dans le Temple en dançant:	et un grand nombre de Peuple qui entre dans le Temple en dançant:
Aprés la premiere Dance, le Chœur du reuple enante les paroies qui ſuivent.	Après la première Dance, le Chœur du reuple enante les paroies qui suivent.
O Me LE ROY, BELLEROPHON.	Ô Me LE ROY, BÉLEROPHON.
PHILONOE' ACRIFICATEVR, MINISTRES du Temple, CHOEVR de Peuple.	PHILONOE' ACRIFICATEUR, MINISTRES du Temple, CHOEUR de Peuple.
CHOEUR de Peuple.	CHOEUR de Peuple.
E mal-heur qui nous accable E Demande un Dieu favorable:	E malheur qui nous accable E Demande un Dieu favorable:
Entens nous, grand Apollon, Par la défaite du Serpent Python;	Entends nous, grand Apollon, Par la défaite du Serpent Python;
Par l’eclat de la gloïre Qui ſuivit ta victoire Viens nous ſecourir;	Par l'éclat de la gloïre Qui suivit ta victoire Viens nous secourir;
Hâte-toy, ſauve-nous, où bien nous allons perir.	Hâte-toi, sauve-nous, où bien nous allons périr.
Il ſe fait icy une ſeconde Entrée, aprés laquelle le Peuple chante ce ſecond couplet.	Il se fait ici une seconde Entrée, après laquelle le Peuple chante ce second couplet.
Nos ſoûpirs te font connoiſtre Le mal-heur qui les fait naiſtre.	Nos soupirs te font connaître Le malheur qui les fait naître.
Entens-nous grand Apollon, Par la défaite du Serpent Python.	Entends-nous grand Apollon, Par la défaite du Serpent Python.
Lar veblal dt la ploire Qui ſuivit ta Victoire, Viens-nous ſecourir;	Lar veblal dt la ploire Qui suivit ta Victoire, Viens-nous secourir;
Hâte-toy, ſauve-nous, ou bien nous allons perir.	Hâte-toi, sauve-nous, ou bien nous allons périr.
SACRIFICATEUR.	SACRIFICATEUR.
Reçois grand Apollon, reçois ce Sacrifice, Fais que le Ciel nous ſoit propice.	Reçois grand Apollon, reçois ce Sacrifice, Fais que le Ciel nous soit propice.
CHOEUR de Peuple.	CHOEUR de Peuple.
D’un Cœur ſoumis nous t’adreſſons nos vœux, Eſcoute un Peuple mal-heurelix.	D'un Cœur soumis nous t'adressons nos vœux, Écoute un Peuple malheurelix.
ACRIFICATEUR verſant du vin ſur la teſte de la Victime.	ACRIFICATEUR versant du vin sur la tête de la Victime.
Par ce vin répandu fais ceſſer nos allarmes, Arreſte le cours de nos larmes.	Par ce vin répandu fais cesser nos alarmes, Arrête le cours de nos larmes.
Tu vois quel triſte ſort nous accable aujourd’huy;	Tu vois quel triste sort nous accable aujourd'hui;
Preſte-nous ton appuy.	Preste-nous ton appui.
Vous qu’à me ſeconder un zele ardent anime, AvanceZ, il eſt temps d’immoler la Uictime.	Vous qu'à me seconder un zèle ardent anime, Avance, il est temps d'immoler la Uictime.
Les Miniſtres du Temple s’avancent auprés du Scrificateur, & immolent la Victime.	Les Ministres du Temple s'avancent auprès du Scrificateur, et immolent la Victime.
CHOEUR de Peuple.	CHOEUR de Peuple.
Dieux, qui connoiſſeZ nos mal-heurs, Laiſſez-vous toucher de nos pleurs.	Dieux, qui connaissez nos malheurs, Laissez-vous toucher de nos pleurs.
SACRIFICATEUR monſtrant le cœur de la Victime.	SACRIFICATEUR montrant le cœur de la Victime.
Eſperons, je ne voy que Signes favcrables.	Espérons, je ne vois que Signes favables.
Nos vœux au Ciel doivent eſtre agreables.	Nos vœux au Ciel doivent être agréables.
Il jette le cœur & les entrailles dans le feu.	Il jette le cœur et les entrailles dans le feu.
CHOEUR de Peuple.	CHOEUR de Peuple.
Aprés un augure ſi doux, Tâchons de meriter que les Dieux ſoient pour nous.	Après un augure si doux, Tâchons de mériter que les Dieux soient pour nous.
Le Peuple dance icy à lentour du feu, & chante enſuite ce premier couplet.	Le Peuple dance ici à lentour du feu, et chante ensuite ce premier couplet.
Montrons nostre allegreſſe, Ne parlons plus do onigrint Renonçons à la triſteſſe, Nos mal-heurs vont prendre fin.	Montrons notre allégresse, Ne parlons plus do onigrint Renonçons à la tristesse, Nos malheurs vont prendre fin.
Quand le Ciel eſt propice à nos-vœux, Banniſſons l'ennuy qui nons preſſe, Nous allons tous eſtre heureux.	Quand le Ciel est propice à nos-vœux, Bannissons l'ennui qui nons presse, Nous allons tous être heureux.
Le Peuple continuë ſa dance, & chante ce ſecond couplet.	Le Peuple continue sa dance, et chante ce second couplet.
Le Ciel veut qu’on eſpere, Il adoucit ſon couroux.	Le Ciel veut qu'on espère, Il adoucit son courroux.
Noſtre hommage a ſçeu luy plaire, Tout s’eſt declaré pour nous.	Notre hommage a su lui plaire, Tout s'est déclaré pour nous.
RilinzJeiso cue jolipivado dae eselle,, Ne craignons plus rien de contraire, Nos maux ont touché les Dieux.	RilinzJeiso cue jolipivado dae eselle, Ne craignons plus rien de contraire, Nos maux ont touché les Dieux.
SACRIFICATEUR.	SACRIFICATEUR.
Tout m’aprend qu'Apollon dans nos vœux s’intereſſe, RedoubleZ à l’envy vos marques d’allegreſſe.	Tout m'apprend qu'Apollon dans nos vœux s'intégresse, Redoublés à l'envi vos marques d'allégresse.
Le Peuple commence une nouvelle Dance à l’entour du Feu, & chante les paroles qui ſuivent.	Le Peuple commence une nouvelle Dance à l'entour du Feu, et chante les paroles qui suivent.
Aſſez de pleurs Ont ſuivy nos mal-heurs;	Assez de pleurs Ont suivi nos malheurs;
De noſtre zele Voy l’ardeur fidelle.	De notre zèle Vois l'ardeur fidèle.
C’eſt en toy ſeul que nostre eſpoir est mis:	C'est en toi seul que notre espoir est mis:
Viens de nos maux adoucir les atteintes, Finis nos plaintes, Calme nos craintes:	Viens de nos maux adoucir les atteintes, Finis nos plaintes, Calme nos craintes:
Fléchy pour nous les Deſtins ennemis.	Fléchi pour nous les Destins ennemis.
L’Amour languit troublé de nos alarmes, Rapelle icy tous ſes charmes, Toy que ſes traits ont tant de fois ſoûmis.	L'Amour languit troublé de nos alarmes, Rapelle ici tous ses charmes, Toi que ses traits ont tant de fois soumis.
Vn Monſtre affreux Nous rend tous mal-heureux.	Un Monstre affreux Nous rend tous malheureux.
Fais de ſa rage Ceſſer le ravage.	Fais de sa rage Cesser le ravage.
C’eſt en toy ſeul que nostre eſpoir est mis.	C'est en toi seul que notre espoir est mis.
Viens de nos maux adoucir les atteintes, Finis nos plaintes, Calme nos craintes, Fléchy pour nous les Deſtins ennemis:	Viens de nos maux adoucir les atteintes, Finis nos plaintes, Calme nos craintes, Fléchi pour nous les Destins ennemis:
L Amour languit trouble de nos allarmes;	L Amour languit trouble de nos alarmes;
Rapelle icy tous ſes charmes, Toy que ſes traits ont tant de fois ſoûmis.	Rapelle ici tous ses charmes, Toi que ses traits ont tant de fois soumis.
SACRIFICATEUR.	SACRIFICATEUR.
Digne Fils de Latone & du plus grand des Dieux, Parle, & deigne regler le deſtin de ces lieux.	Digne Fils de Latone et du plus grand des Dieux, Parle, et deigne régler le destin de ces lieux.
L’Autel qui a paru s’enfonce, & la Pythie ſort de ſon antre les cheveux épars:	L'Autel qui a paru s'enfonce, et la Pythie sort de son antre les cheveux épars:
En meſme temps on entent de grands éclats de Tonnere:	En même temps on entent de grands éclats de Tonnere:
Le Temple tremble, & on le voit tout brillant d’éclairs.	Le Temple tremble, et on le voit tout brillant d'éclairs.
LA PYTHIE.	LA PYTHIE.
Gardez tous un ſilence extreſme, Apollon vous entent & va parler luy-meſme.	Gardez tous un silence extrême, Apollon vous entent et va parler lui-même.
Son approche des-ja fait briller les teimis;	Son approche déjà fait briller les teimis;
Entendez raiſonner le ſifflement des airs, Eſcoutez le bruit du Tonnerre, Voyez trembler & le Temple & la Terre, Il và paroiſtre, je le voy;	Entendez raisonner le sifflement des airs, Escoutez le bruit du Tonnerre, Voyez trembler et le Temple et la Terre, Il và paraître, je le vois;
A ſon aſpect, fremiſſeZ comme moy La Pytie ſe panche vers la Terre, tandis qu’Apollon paroiſt en Statuë d’or, & prononce l’Oracle qui ſuit,	À son aspect, frémissez comme moi La Pytie se penche vers la Terre, tandis qu'Apollon paraît en Statue d'or, et prononce l'Oracle qui suit,
APOLLON.	APOLLON.
Que voſtre crainte ceſſe.	Que votre crainte cesse.
Vn des Fils de Neptune appaiſera pour vous Le celeſte couroux.	Un des Fils de Neptune apaisera pour vous Le céleste courroux.
Pour l’en recompenſer, il faut que la Princeſſe Le prenne pour Eſpoux.	Pour l'en récompenser, il faut que la Princesse Le prenne pour Époux.
La Pytie s’enfonce dans l’Antre d’où elle eſt ſortie.	La Pytie s'enfonce dans l'Antre d'où elle est sortie.
Apollon diſparoiſt, & le Peuple ſe retire.	Apollon disparaît, et le Peuple se retire.
LE ROY A BELLEROPHON & A PHILONOE' pous pubes entenuu, ſe n'aptien u ouus dire, Ie plains vos déplaifirs, comme vous, j’en ſoupire;	LE ROY A BELLEROPHON et À PHILONONE pous pubes entenu, se n'aptien ouus dire, Ie plains vos déplaifirs, comme vous, en soupire;
Mais rien n’eſt preferable au repos de ces lieux:	Mais rien n'est préférable au repos de ces lieux:
Soümettons-nous aux Dieux.	Soumettons-nous aux Dieux.
SCENE VI.	SCÈNE VI.
BELLEROPHON, PHILONOE',	BÉLEROPHON, PHILONONO,
BELLEROPHON.	BELLEROPHON.
Ans quel accablement cét Oracle me laiſſe!	Ans quel accablement cet Oracle me laisse!
PHILONOE.	PHILONOE.
Ah!	Ah!
cruelle ſurpriſe!	cruelle surprise!
BELLEROPHON.	BELLEROPHON.
O funeſte revers!	Ô funeste revers!
Quoy?	Quoi?
je vous pers, belle Princeſſe?	je vous perd, belle Princesse?
PHILONOE' Quoy?	PHILONOE' Quoi?
Bellerophon, je vous pers?	Bellerophon, je vous perd?
TOUS DEUX.	TOUS DEUX.
Helas!	Hélas!
n’avons nous eù le desfin favorable, Que pour mieux reſſentir le coup qui nous accable?	n'avons nous éù le des favorable, Que pour mieux ressentir le coup qui nous accable?
BELLEROPHON.	BELLEROPHON.
Aneu damt uuuiouu epure vuntents	Aneu damt uuuiouu epure vuntents
PHILONOE' Iamais ſort n’euſt eſté plus heureux que le noſtre.	PHILONONE' Jamais sort n'eût été plus heureux que le nôtre.
TOUS DEUX.	TOUS DEUX.
Qui croiroit que deux cœurs ſi tendres, ſi conſtans, De fuſfeun pue uojemes, l’un pour l’autre?	Qui croirait que deux cœurs si tendres, si constants, De fusfeun pue uojemes, l'un pour l'autre?
BELLEROPHON.	BELLEROPHON.
Vous ne ſerez donc point à moy?	Vous ne serez donc point à moi?
Quel prix d’une ardeur ſi fidelle!	Quel prix d'une ardeur si fidèle!
PHILONOE’.	PHILONOE.
N'y penſons plus.	N'y pensons plus.
BELLEROPHON.	BELLEROPHON.
Quoy?	Quoi?
vous pourrez, cruelle, Engager ailleurs voſtre foy?	vous pourrez, cruelle, Engager ailleurs votre foi?
PHILONOE'.	PHILONOE.
PHILONOE'.	PHILONOE.
Briſez, briſeZ une fatale chaîne.	Brisez, briseZ une fatale chaîne.
Quand j’ay receu l’hommage de vos vœux, Ie croyois que le Ciel conſentiroit ſans peine Que l’Hymen nous rendiſt heureux, Et je n’attendois pas l’Oracle rigoureux Qui nous ſacrifie à ſa haine.	Quand j'ai reçu l'hommage de vos vœux, Je croyais que le Ciel consentirait sans peine Que l'Hymen nous rendît heureux, Et je n'attendais pas l'Oracle rigoureux Qui nous sacrifie à sa haine.
BELLEROPHON.	BELLEROPHON.
Non, non, quoy qu’il ayt ordonné, On ne verra jamais que mon amour s’éteigne, Ie n’examine point ce qu’il faut que je craigné De l’Oracle fatal qui vient d’eſtre donné:	Non, non, quoi qu’il ait ordonné, On ne verra jamais que mon amour s'éteigne, Je n'examine point ce qu'il faut que je craigné De l'Oracle fatal qui vient d'être donné:
Que le deſtin jatoux dune pame ſi'belle Me porte encor des coups plus rigoureux;	Que le destin jatoux dune pame si elle Me porte encor des coups plus rigoureux;
Au moins je puis eſtre fidelle, Si je ne ſçaurois eſtre heureux.	Au moins je puis être fidèle, Si je ne saurais être heureux.
PHILONOE'.	PHILONOE.
Se peut-il que le Ciel contre un amour ſi tendre Exerce toutes ſes rigueurs?	Se peut-il que le Ciel contre un amour si tendre Exerce toutes ses rigueurs?
BELLEROPHON.	BELLEROPHON.
De ſes ordres cruels l'Amour doit-il dépendre?	De ses ordres cruels l'Amour doit-il dépendre?
TOUS DEUX.	TOUS DEUX.
Animons-nous malgré nos mal-heurs, e n’eſt pas au Deſtin à ſeparer les cœurs.	Animons-nous malgré nos malheurs, eu n'est pas au Destin à séparer les cœurs.
FIN DU TROISIESME ACTE.	FIN DU TROISIÈME ACTE.
ACTE QATRIESME.	ACTE QATRIESME.
Des Rochers fort hauts & fort eſcarpez, couverts de Sapins & d’autres Arbres ſolitaires, font la Decoration de cét Acte.	Des Rochers fort hauts et fort escarpé, couverts de Sapins et d'autres Arbres solitaires, font la Décoration de cet Acte.
Au fond du Theatre paroiſt un Rocher de la meſme hauteur, & garny des meſmes rrepreorimcreperce par trois drotes, au travers deſquelles on découvre un Païſage à perte de veuë.	Au fond du Théâtre paraît un Rocher de la même hauteur, et garni des mêmes rrepreorimcreperce par trois drotes, au travers desquelles on découvre un Paysage à perte de vue.
SCENE PREMIERE.	SCÈNE PREMIÈRE.
AMISODAR.	AMISODAR.
VEL Spectacle charmant pour mon cœur amoureux!	VEL Spectacle charmant pour mon cœur amoureux!
es Morts de tous coſteZ étendus dans les plaines Me ſont de ſeurs garands de la fin de mes peines;	es Morts de tous côté étendus dans les plaines Me sont de sûr garands de la fin de mes peines;
Tout perit pour me rendre heureux.	Tout périt pour me rendre heureux.
Fontaines, tarriſſeZ;	Fontaines, tarrissez;
embraſeZ-vous, Montagnes, BruſleZ Foreſts, ſecheZ, Campagnes, Toutes les horreurs que je voy Sont autant de ſujets de triomphe pour moy.	embraseZ-vous, Montagnes, BrusleZ Forêts, séchez, Campagnes, Toutes les horreurs que je vois Sont autant de sujets de triomphe pour moi.
Quand on obtient ce qu’on aime, Qu'importe a quel prix?	Quand on obtient ce qu'on aime, Qu'importe à quel prix?
Que tout l’Univers ſurpris Condamne l’amour extreſme Qui couſte tant de ſang, de larmes, & de cris, Quand on obtient ce qu’on aime, Qu'importe à quel prix?	Que tout l'Univers surpris Condamne l'amour extrême Qui coûte tant de sang, de larmes, et de cris, Quand on obtient ce qu'on aime, Qu'importe à quel prix?
CENE II.	CÈNE II.
ARGIE, AMISODAR.	ARGIE, AMISODAR.
ARGIE.	ARGIE.
IL faut, pour contenter la Reyne, Rendre le Monſtre à l’eternelle nuit;	IL faut, pour contenter la Reine, Rendre le Monstre à l'éternelle nuit;
Bellerophon au deſespoir reduit S’apreſte à le combatre, & ſa perte eſt certaine;	Bellerophon au désespoir réduit S'apprête à le combattre, et sa perte est certaine;
Mais cette prompte mort finit trop toſt ſa peine.	Mais cette prompte mort finit trop tôt sa peine.
Quand un fatal Oracle eſt contraire à ſes vœux, S’il ne ſouffre long-temps, il n’eſt point mal-heureux.	Quand un fatal Oracle est contraire à ses vœux, S'il ne souffre longtemps, il n'est point malheureux.
Puis qu’un Fils de Neptune épouſe la Princeſſe, LaiſſeZ vivre l’Ingrat dans ſes jaloux tranſports;	Puis qu'un Fils de Neptune épouse la Princesse, Lais vivre l'Ingrat dans ses jaloux transports;
Voir aux mains d’un Rival l’Objet de ſa tendreſſe, C’eſt tous les jours endurer mille morts.	Voir aux mains d'un Rival l'Objet de sa tendresse, C'est tous les jours endurer mille morts.
AMISODAR.	AMISODAR.
Le laiſſer vivre!	Le laisser vivre!
O Dieux!	Ô Dieux!
que faut-il que je penſe?	que faut-il que je pense?
Ie voy pour luy la Reyne s’allarmer Lors que ſa mort eſt preſte à remplir ſa vangeance.	Je vois pour lui la Reine s'alarmer Lors que sa mort est prête à remplir sa vengeance.
Eſt-cé le hair ou l’aimer?	Est-cé le haïr ou l'aimer?
ARGIE.	ARGIE.
Monſtrez que voſtre cœur ne cherche qu’à luy plaire, Pourquoy penetrer dans le ſien?	Montrez que votre cœur ne cherche qu'à lui plaire, Pourquoi pénétrer dans le sien?
Quand l'Objet aimé parle, un Amant doit tout faire, Et n’examiner rien.	Quand l'Objet aimé parle, un Amant doit tout faire, Et n'examiner rien.
AMISODAR.	AMISODAR.
Non, non, que mon Rival periſſe, Eſt-ce à moy d’empeſcher qu’il ne perde le jour?	Non, non, que mon Rival périsse, Est-ce à moi d'empêcher qu'il ne perde le jour?
ARGIE.	ARGIE.
Il faut faire à la Reyne encor ce Sacrifice, Ou renoncer à voſtre amour.	Il faut faire à la Reine encor ce Sacrifice, Ou renoncer à votre amour.
VOIX derriere le Theatre.	VOIX derrière le Théâtre.
Tout eſt perdu, le Monſtre avance, Sauvons-nous, ſauvons-nous.	Tout est perdu, le Montre avance, Sauvons-nous, sauvons-nous.
AMISODAR.	AMISODAR.
Le Monſtre aproche, éloigneZ-vous.	Le Monstre approche, éloignez-vous.
ARGIE.	ARGIE.
Ciel, contre ſa fureur embraſſe ma défenſe.	Ciel, contre sa fureur embrasse ma défense.
SCENE III.	SCÈNE III.
VNE NAPE’E, ET VNE DRYADE enſemble.	VNE NAPE'E, ET VNE DRYADE ensemble.
9 Luignonss pagnono teomnux qui deſolent ces T lieux, Lec pleurs qu'us font couter tet protet touther les Dieux.	9 Luignons pagnono teomnux qui désolent ces T our, Lec pleurs qu'us font coûter tet protêt touther les Dieux.
DRYADE.	DRYADE.
Il n’est plus d’herbes dans les plaines.	Il n'est plus d'herbes dans les plaines.
NAPE’E.	NAPE.
Il n’eſt plus d’eaux dans les Fontaines.	Il n'est plus d'eaux dans les Fontaines.
DRIADE.	DRYADE.
Tout perit.	Tout périt.
NAPE’E.	NAPE.
d olb varie.	d olb varie.
DRYADE.	DRYADE.
Quel excés d’ennuis!	Quel excès d'ennuis!
NAPE’E.	NAPE.
Quelles peines!	Quelles peines!
NAPE’E & DRYADE.	NAPPE et DRYADE.
Plaignons, plaignons les maux qui déſolent ces lieux;	Plaignons, plaignons les maux qui désolent ces lieux;
Les pleurs qu’ils font couler devroiẽt toucher les Dieux.	Les pleurs qu'ils font couler devraient toucher les Dieux.
SCENE IV.	SCÈNE IV.
DIEVX des Bois, Vne NAPE’E & une DRYADE.	DIEUX des Bois, Une NAPE'E et une DRYADE.
DIEUX DES BOIS.	DIEUX DES BOIS.
Es Foreſts ſont en feu, le ravage s’augmente, C Ce n’eſt par tout qu’épouvante & qu’horreur.	Es Forêts sont en feu, le ravage s'augmente, Ç Ce n'est par tout qu'épouvante et qu'horreur.
NAPE’E & DRYADE.	NAPPE et DRYADE.
Du Monſtre, comme vous, nous ſentons la fureur, Voyez cette Plaine brulante.	Du Monstre, comme vous, nous sentons la fureur, Voyez cette Plaine brûlante.
DIEUX DES BOIS.	DIEUX DES BOIS.
Helas!	Hélas!
que ſont-ils devenus Ces Bois dont nous faiſions nos retraites tranquilles?	que sont-ils devenus Ces Bois dont nous faisions nos retraites tranquilles?
NAPE’E & DRYADE.	NAPPE et DRYADE.
Ces Eaux qui ferpentotent dans ces Plaines fertilles?	Ces Eaux qui ferpentotent dans ces Plaines fertilles?
Ces Eaux, helas!	Ces Eaux, hélas!
ne coulent plus.	ne coulent plus.
DIEOX DES BOIS.	DIEOX DES BOIS.
Que de triſtes allarmes!	Que de tristes alarmes!
NAPE’E & DRYADE.	NAPPE et DRYADE.
Que de ſujets de larmes!	Que de sujets de larmes!
Tous enſemble.	Tous ensemble.
Pour adoucir le Ciel qui cort tant at matcneurs, Ioignons nos ſoupirs & nos pleurs.	Pour adoucir le Ciel qui cort tant at matcneurs, Ioignons nos soupirs et nos pleurs.
CENE V LE ROY, BELLEROPHON.	CÈNE V LE ROY, BÉLEROPHON.
LE ROY.	LE ROY.
H Prince!	H Prince!
ou vous emporte une ardeur trop A guerriere?	ou vous emporte une ardeur trop A guerrière?
En vain à cent perils on vous a veu courir, En vain voſtre grand nom remplit la Terre entiere, Vous cherchez un Combat ou vous allez perir.	En vain à cent périls on vous a vu courir, En vain votre grand nom remplit la Terre entière, Vous cherchez un Combat ou vous allez périr.
BELLEROPHON.	BELLEROPHON.
Ie ne vay point combatre un Monſtre redoutable Pour remplir de mon nom l’Vnivers étonné, Ie vais, Amant infortuné, Finir un ſort trop déplorable.	Je ne vais point combattre un Monstre redoutable Pour remplir de mon nom l'Univers étonné, Je vais, Amant infortuné, Finir un sort trop déplorable.
Cent fois, juſqu’à ce triste jour a uy nuiunde min ore en encrenun ta victoire.	Cent fois, jusqu'à ce triste jour a ui nuiunde min ore en encrenun ta victoire.
Ce que j’ay fait animé par la gloire, Ne le pourrai-je faire animé par l’amour?	Ce que j'ai fait animé par la gloire, Ne le pourrai-je faire animé par l'amour?
LE ROY.	LE ROY.
Suivre un amour trop temeraire, C’eſt vous livrer vous-meſme au plus funeſte ſort.	Suivre un amour trop téméraire, C'est vous livrer vous-même au plus funeste sort.
BELLEROPHON.	BELLEROPHON.
Accablé de mal-heurs, puis-je craindre la mort?	Accablé de malheurs, puis-je craindre la mort?
LE ROY.	LE ROY.
MénageZ voſtre vie, elle m’eſt toûjours chere:	Ménagez votre vie, elle m'est toujours chère:
Par ces aymables nœuds Que je vous deſtinois avec mon Diadéme, Par la Princeſſe meſme.	Par ces aimables nœuds Que je vous destinais avec mon Diadème, Par la Princesse même.
Accordez, accordez quelque choſe à mes vœux.	Accordez, accordez quelque chose à mes vœux.
Ie vais faire à Neptune offrir un Sacrifice:	Je vais faire à Neptune offrir un Sacrifice:
Allons ſçavoir ſes volontez, Peut-estre il nous ſera propice.	Allons sçavoir ses volontés, Peut-être il nous sera propice.
BELLEROPHON.	BELLEROPHON.
En vain, Seigneur vous me flatteZ, Puis qu’a ſon Fils vous devez là Princeſſe, Au moins en combattant laiſſez-moy faire voir Que mon amour meritoit ſa tendreſſe.	En vain, Seigneur vous me flattez, Puis qu'a son Fils vous devez là Princesse, Au moins en combattant laissez-moi faire voir Que mon amour méritait sa tendresse.
LE ROY.	LE ROY.
Ah!	Ah!
que je crains pour vous ce fatal deſeſpoir!	que je crains pour vous ce fatal désespoir!
Adieu, quand le peril ne vous peut émouvoir;	Adieu, quand le péril ne vous peut émouvoir;
Ie dois vous cacher ma foibleſſe.	Je dois vous cacher ma faiblesse.
On commence à voir icy tout le Païſage de l’enfoncement du Theatre, remply de feu & de fumée, pour marquer le dégaſt que fait la Chimere dans le Païs.	On commence à voir ici tout le Paysage de l'enfoncement du Théâtre, rempli de feu et de fumée, pour marquer le dégât que fait la Chimère dans le Pays.
SCENE.	SCÈNE.
CENE VI.	CÈNE VI.
BELLEROPHON.	BELLEROPHON.
Eureuſe-mort, tu vas me ſecourir TT Dans mon mal-heur extréme Ie cours m’offrir au Monſtre aſſeuré de perir, Mauis ſe men faus un vien fupreme.	Euruse-mort, tu vas me secourir TT Dans mon malheur extrême Je cours m'offrir au Monstre assuré de périr, Mavis se men faus un viens suprême.
Quand on a perdu ce qu’on aime, Il ne reſte plus qu’a mourir.	Quand on a perdu ce qu'on aime, Il ne reste plus qu'a mourir.
On voit ley Panus daris un Cllar de Nüages du coſté droit, & en meſme-temps paroiſt un autre Char vuide qui deſcend juſques ſur le Theatre du coſte gauche.	On voit lei Panus daris un Cllar de Narages du côté droit, et en mêmetemps paraît un autre Char vid qui descend jusques sur le Théâtre du côte gauche.
SCENEVII.	SCENEVII.
PALLAS dans ſon Char, BELLEROPHON.	PALLAS dans son Char, BELLEROPHON.
PALLAS.	PALLAS.
Spere en ta valeur, Bellerophon, eſpere, E Pallas deſcend du Ciel pour t’ofrir ſon ſecours.	Spère en ta valeur, Belerophon, espère, CE Pallas descend du Ciel pour t'ofrir son secours.
H	H
BELLEROPHON.	BELLEROPHON.
Déeſſe, en vain tu prens ſoin de mes jours, Quand la mort ſeule peut me plaire.	Déesse, en vain tu prends soin de mes jours, Quand la mort seule peut me plaire.
PALLAS.	PALLAS.
Ton ſort eſt marqué dans les Cieux, Uiens, monte dans ce Char, & t’abandonne aux Dieux, Bellerophon monte dans le Char, & eſt enlevé ſur le Ceintre, avec Pallas.	Ton sort est marqué dans les Cieux, Uiens, monte dans ce Char, et t'abandonne aux Dieux, Bellerophon te dans le Char, et est enlevé sur le Cintre, avec Pallas.
Cependant on entend le Peuple qui exprime ſa deſolation par ces Vers.	Cependant on entend le Peuple qui exprime sa désolation par ces Vers.
CHOEUR DE PEUPLE derrier le Theatre.	CHOEUR DE PEUPLE derrier le Théâtre.
Quelle horreur!	Quelle horreur!
quel triste ravage!	quel triste ravage!
Le Monſtre redouble ſa rage.	Le Monstre redouble sa rage.
Pendant qu’on entend les cris des Peuples épouvantez, la Chimere paroiſt au fond du Theatre, & en meime-temps Bellerophon monte ſur Pegaſe, fond du haut de l’air, & aprés un premier Combat avec la Chimere, il ſe ſauve dans les airs, & traverſe tout le Theatre.	Pendant qu'on entend les cris des Peuples épouvantez, la Chimère paraît au fond du Théâtre, et en meimetemps Belerophon te sur Pégase, fond du haut de l'air, et après un premier Combat avec la Chimère, il se sauve dans les airs, et traverse tout le Théâtre.
CHOEUR DE PEUPLE derriere le Theatre, pendant le combat de Bellerophon.	CHOEUR DE PEUPLE derrière le Théâtre, pendant le combat de Bellerophon.
Vn Heros s’expoſe pour nous, Dieux, ſoütenez ſon bras, & conduiſez ſes coups.	Un Héros s'expose pour nous, Dieux, soütenez son bras, et conduisez ses coups.
Bellerophon fond une ſeconde fois ſur la Chimere, „ au millieu du Theatre & aprés qu’il a diſparu un moment en s’élevant ſur le Ceintre, il paroiſt pour la troiſiéme fois, deſcend ſur le devant du Theatre, attaque de nouveau la Chimere, la bleſſe à mort, & ſe ſauve en l’air, faiſant ſon vol en rond, & aprés trois tours, on le voit ſe perdre dans les nuës:	Bellerophon fond une seconde fois sur la Chimère, „ au millieu du Théâtre et après qu'il a disparu un moment en s'élevant sur le Cintre, il paraît pour la troisième fois, descend sur le devant du Théâtre, attaque de nouveau la Chimère, la blesse à mort, et se sauve en l'air, faisant son vol en rond, et après trois tours, on le voit se perdre dans les nues:
Cependant la Chimere tombe morte entre les Rochers;	Cependant la Chimère tombe morte entre les Rochers;
ce qui donne lieu à la joye que marque le Peuple par les Vers ſuivants.	ce qui donne lieu à la joie que marque le Peuple par les Vers suivants.
LV Mi	LV Mi
CHOEUR DE PEUPLE derriere le Theatre.	CHOEUR DE PEUPLE derrière le Théâtre.
Le Monstre eſt défait.	Le Monstre est défait.
Quelle gloire!	Quelle gloire!
Bellerophon remporte la victoire,	Bellerophon remporte la victoire,
ACTE CINQUIESME.	ACTE CINQUIÈME.
Le Theatre repreſente une grande avant-court d’un Palais qui paroiſt élevé dans la Gloire.	Le Théâtre représente une grande avant-court d'un Palais qui paraît élevé dans la Gloire.
On y monte par deux grands degrez qui forment les deux coſtez de cette Decoration eu ovale, & qui ſont enfermez par deux grands Baſtimens d’Architecture, d’une hauteur extraordinaire.	On y monte par deux grands degré qui forment les deux côtés de cette Décoration eu ovale, et qui sont enfermés par deux grands Bastiments d'Architecture, d'une hauteur extraordinaire.
Les deux Degrez & les Galleries qui les environnent, ſont remplis des Peuples de la Licye aſſemblez en ce lieu pour y recevoir Bellerophon, que Pallas doit ramener aprés la deraite de la Ciinere	Les deux Dégrés et les Galleries qui les environnent, sont remplis des Peuples de la Licye assemblés en ce lieu pour y recevoir Bellerophon, que Pallas doit ramener après la deraite de la Ciinere
SCENE PREMIERE.	SCÈNE PREMIÈRE.
LE ROY, PHILONOE', CHOEVR DE PEVPLE	LE ROY, PHILONO, CHOEUR DE PEUPLE
LE ROY.	LE ROY.
REPAREZ vos chants d’allegreſſe, Peuples, c’eſt en ce lieu que pour noſtre bon-heur Pallas doit ramener un illuſtre Vainqueur, Que le Ciel pour Eſpoux destine à la Princeſſe.	RÉPAREZ vos chants d'allégresse, Peuples, c'est en ce lieu que pour notre bonheur Pallas doit ramener un illustre Vainqueur, Que le Ciel pour Époux destine à la Princesse.
Enfin nos vœux ont reüſſi, Vn Oracle confus faiſoit nostre infortune;	Enfin nos vœux ont réussi, Un Oracle confus faisait notre infortune;
Mais cet Oracle est éclaircy, Bellerophon eſt le Fils de Neptune.	Mais cet Oracle est éclairci, Belerophon est le Fils de Neptune.
Pour nous le declarer, dans ſon Temple, à nos yeux, Ce Dieu des Mers vient de paroiſtre;	Pour nous le déclarer, dans son Temple, à nos yeux, Ce Dieu des Mers vient de paraître;
Luy-meſme pour ſon ſang a daigné reconnoiſtre Ce Heros glorieux.	Lui-même pour son sang a daigné reconnaître Ce Héros glorieux.
D’une Nymphe jalouſe il craignit la colere, Et quand Bellerophon reçût de luy le jour, Il voulut que Glaucus feigniſt d’eſtre ſon pere;	D'une Nymphe jalouse il craignit la colère, Et quand Bellerophon reçût de luile ur, Il voulut que Glaucus feignît d'être son père;
Il revient Triomphant, celebrez ſon retour.	Il revient Triomphant, célébrez son retour.
CHOEUR de Peuple.	CHOEUR de Peuple.
Viens, digne Sang des Dieux, jouir de ta victoire, Chacun eſt charmé de ta gloire, Et pour chanter tes grands exploits, Nous allons tous joindre nos voix.	Viens, digne Sang des Dieux, jouir de ta victoire, Chacun est charmé de ta gloire, Et pour chanter tes grands exploits, Nous allons tous joindre nos voix.
LE ROY.	LE ROY.
Et toy, ma fille, abandonne ton ame Aux transports de ta flâme.	Et toi, ma fille, abandonne ton âme Aux transports de ta flamme.
Bellerophon t’eſt donné pour Eſpoux.	Bellerophon t'est donné pour Époux.
PHILONOE'.	PHILONOE.
Aprés tant de rudes alarmes, Pouvons-nous trop goûter les charmes D’un changement ſi doux?	Après tant de rudes alarmes, Pouvons-nous trop goûter les charmes D'un changement si doux?
LE ROY.	LE ROY.
Qu'il eſt grand ce Heros, qui ne voit point d’obſtacles Que le Sort contre luy ne forme vainement!	Qu'il est grand ce Héros, qui ne voit point d'obstacles Que le Sort contre notre ne forme vainement!
PHILONOÉ.	PHILONO.
Pour tout vaincre, il ſuffit qu’un Heros ſoit Amant, La valeur & l’amour font toûjours des miracles.	Pour tout vaincre, il suffit qu'un Héros soit Amant, La valeur et l'amour font toujours des miracles.
TOUS DEUX.	TOUS DEUX.
La valeur & l'Amour, font toûjours des miracles,	La valeur et l'Amour, font toujours des miracles,
CHOEUR de Peuple.	CHOEUR de Peuple.
O jour pour la Lycie à jamais glorieux, Où le Sang de nos Rois s’unit au Sang des Dieux!	Ô jour pour la Lycie à jamais glorieux, Où le Sang de nos Rois s'unit au Sang des Dieux!
CENE II.	CÈNE II.
LEROY, STENOBEE, PHILONOE' ARGIE, CHOEVR de Peuple.	LEROY, STENOBE, PHILONOUE' ARGIE, CHOEUR de Peuple.
LE ROY.	LE ROY.
7 Enez-vous partager l’allegreſſe publique?	7 Enez-vous partager l'allégresse publique?
Enfin pour nous le Ciel s’explique, Neptune a reconnu Bellerophon pour Fils.	Enfin pour nous le Ciel s'explique, Neptune a reconnu Bellerophon pour Fils.
STENOBE’E.	STENOBE'É.
Ie ſçay tout.	Je sais tout.
Dieux cruels, vous l’avez donc permis?	Dieux cruels, vous l'avez donc permis?
LE ROY.	LE ROY.
Bellerophon cauſe-t’il cette plainte?	Bellerophon cause-t-il cette plainte?
STENOBE’E.	STENOBE'É.
C’est luy ſeul, il eſt vray, qui fait mon deſespoir.	C'est lui seul, il est vrai, qui fait mon désespoir.
Du plus ardent amour, j’eus pour luy l’ame atteinte, Et pour toucher ſon cœur j’ay manqué de pouvoir.	Du plus ardent amour, j'eus pour lui l'âme atteinte, Et pour toucher son cœur j'ai manqué de pouvoir.
Toûjours l’ingrat dédaigna ma tendreſſe;	Toujours l'ingrat dédaigna ma tendresse;
Preste à luy voir enfin épouſer la Princeſſe, I’ay voulu renverſer vos odieux projets.	Prête à lui voir enfin épouser la Princesse, J'ai voulu renverser vos odieux projets.
Amiſodar m’aimoit, j’ay fait agir ſes Charmes, Et le Monſtre par luy rempliſſant tout d’allarmes, Na cotrse que voar moy te fang devos Sujets.	Amodar m'aimait, j'ai fait agir ses Charmes, Et le Montre par autre remplissant tout d'alarmes, Na cotrse que voar moi te sang devos Sujets.
E ROY.	E ROY.
Le Traiſtre!	Le Traître!
qu’on l’arreſte.	qu'on l'arrête.
STENOBE’E.	STENOBE'É.
Il s’eſt mis par la fuite Meconcori cte oejene pounſdite;	Il s'est mis par la fuite Meconcori côte ojène pounsdite;
Mais il traiſne avec luy ſon crime & ſon amour.	Mais il traîne avec lui son crime et son amour.
LE ROY.	LE ROY.
Quoy, le Ciel ſouffre encor que vous voyieZ le jour?	Quoi, le Ciel souffre encor que vous voyiez le jour?
TENOBE’E.	TENOBE'E.
I’ay prevenu tout ce que peut ſa haïne.	J'ai prévenu tout ce que peut sa haine.
La juſtice que je me rends Ma fait par le poiſon mettre fin à ma peine.	La justice que je me rends Ma fait par le poison mettre fin à ma peine.
Ie le ſens, qui déja coule de veine en veine, Déja le jour ſe cache à mes regards mourans.	Je le sens, qui déjà coule de veine en veine, Déjà le jour se cache à mes regards mourants.
Vous, de qui la rigueur m’a toujours pourſuivie Avec ſes plus funeſtes traits, Dieux inhumains, j’abandonne la vie;	Vous, de qui la rigueur m'a toujours poursuivie Avec ses plus funestes traits, Dieux inhumains, j'abandonne la vie;
Estes-vous ſatisfaits ?	Êtes-vous satisfaits ?
Et toy, cruel Amour, reçois une hictime Que tu cherchois à t’immoler;	Et toi, cruel Amour, reçois une hictime Que tu cherchais à t'immoler;
Ie meurs pour expier le crime Des feux dont tu m’as fait bruſler.	Je meurs pour expier le crime Des feux dont tu m'as fait brûler.
Ie n’ay pû m’affranchir de ton barbare empire Qu'en renonçant au jour;	Je n'ai pu m'affranchir de ton barbare empire Qu'en renonçant au jour;
1 Dulue dimuis foupus s ipitoyable Amour, I'expire.	1 Dulve dimuis foupus s pitoyable Amour, J'expire.
FIIILONOE.	FIIILONOE.
Quel excés de fureur?	Quel excès de fureur?
On voit Pallas dans un Char, & Bellerophon avec elle.	On voit Pallas dans un Char, et Bellerophon avec elle.
Tandis qu’elle deſcend, le Peuple marque ſa Joye par le londes Pimbales, des Prompettes, & de tous les autres Inſtruments.	Tandis qu'elle descend, le Peuple marque sa Joie par le londes Pimbales, des Prompettes, et de tous les autres Instruments.
LE ROY.	LE ROY.
Sa mort en eſt le prix, Mais oublions & ſon crime & ſa peine, Voicy Bellerophon que Pallas nous raméne, Son Triomphe doit ſeul occuper nos eſprits.	Sa mort en est le prix, Mais oublions et son crime et sa peine, Voici Bellerophon que Pallas nous ramène, Son Triomphe doit seul occuper nos esprits.
SCENE III.	SCÈNE III.
PALLAS, LE ROY, BELLEROPHON, PHILONOE', COEVR de Peuple,	PALLAS, LE ROY, BELLEROPHON, PHILONONOE', EUR de Peuple,
PALLAS.	PALLAS.
OnnoiſſeZ le Fils de Neptune 3 Dans ce jeune Heros.	Onnaissez le Fils de Neptune 3 Dans ce jeune Héros.
A ſa ſeule valeur vous deveZ le repos Qui ſucceda à voſtre infortune.	À sa seule valeur vous deveZ le repos Qui succéda à votre infortune.
Pallas le raméne en ces lieux.	Pallas le ramène en ces lieux.
C’eſt luy qui doit épouſer la Princeſſe, Faites-en tous paroiſtre une entiere allegreſſe, Et rendez grace aux Dieux.	C'est prem qui doit épouser la Princesse, Faites-en tous paraître une entière allégresse, Et rendez grâce aux Dieux.
Bellerophon deſcend du Char, & Pallas eſt enPepeo rur le Conere.	Bellerophon descend du Char, et Pallas est enPepeo rur le Conère.
BELLEROPHON A PHILONOE'.	BÉLEROPHON À PHILONONO.
Enfin je vous revoy, Princeſſe incomparable.	Enfin je vous revois, Princesse incomparable.
PHILONOE’.	PHILONOE.
O changement à mes vœux favorable!	Ô changement à mes vœux favorable!
TOUS DEUX.	TOUS DEUX.
Quel plaiſir de voir en ce jour Le Deſtin ceder à l’Amour!	Quel plaisir de voir en ce jour Le Destin céder à l'Amour!
LE ROY.	LE ROY.
Iouiſſez des douceurs que l'Hymen vons prepare, ViveZ heureux, vivez toûjours Amants:	Jouissez des douceurs que l'Hymen vons prépare, ViveZ heureux, vivez toujours Amants:
Que tous vos moments Soient doux & charmants, Et qu’un bon-heur ſans fin répare Ce qu’un ſort rigoureux vous cauſa de tourments.	Que tous vos moments Soient doux et charmants, Et qu'un bonheur sans fin répare Ce qu'un sort rigoureux vous causa de tourments.
On entend icy les Timbales & les Trompettes, & tous les autres Inſtruments, dont le ſon ſe meſle aux acclamations du Peuple qui chante les Vers ſuivants.	On entend ici les Timbales et les Trompettes, et tous les autres Instruments, dont le son se mêle aux acclamations du Peuple qui chante les Vers suivants.
CHOEUR de Peuple.	CHOEUR de Peuple.
Le plus grand des Heros rend le calme à la Terre;	Le plus grand des Héros rend le calme à la Terre;
Il fait ceſſer les horreurs de la Guerre.	Il fait cesser les horreurs de la Guerre.
Iouiſſons à jamais Des douceurs de la Paix.	Jouissons à jamais Des douceurs de la Paix.
Neuf Lyciens ſe détachent, & font icy une Enuitoy aptés laquelle le Peuple chante les deux couplets qui ſuivent, au meſme ſon des Timbales, des Trompettes, & de tous les autres Inſtruments.	Neuf Lyciens se détachent, et font ici une Enuitoy après laquelle le Peuple chante les deux couplets qui suivent, au même son des Timbales, des Trompettes, et de tous les autres Instruments.
CHOEUR de Peuple.	CHOEUR de Peuple.
Les plaiſirs nous preparent leurs charmes, Ne ſongeons plus qu’à paſſer de beaux jours.	Les plaisirs nous préparent leurs charmes, Ne songeons plus qu'à passer de beaux jours.
Si le Ciel nous fit verſer des larmes, Vn heureux ſort en arreste le cours.	Si le Ciel nous fit verser des larmes, Un heureux sort en arrête le cours.
Puis qu’un Heros fait ceſſer nos allarmes, Cherchons les jeux, les ris & les amours.	Puis qu'un Héros fait cesser nos alarmes, Cherchons les jeux, les ris et les amours.
V Que la Paix qui ſuccéde à la peine, Fait aisément oublier les ſoûpirs!	V Que la Paix qui succède à la peine, Fait aisément oublier les soupirs!
Si le Ciel nous ſoumit à ſa haîne, Vn heureux ſort ſatisfait nos deſirs:	Si le Ciel nous soumit à sa haine, Un heureux sort satisfait nos désirs:
Dans les beaux jours qu’un Heros nous raméme.	Dans les beaux jours qu'un Héros nous ramème.
herchons les Ris, les leux, & les Plaiſirs.	herchons les Ris, les leux, et les Plaisirs.
PERMISSION POVRTENIR ACADEMIE ROTALE de Muſique, en faveur du Sieur de Lully.	PERMISSION POURTENIR ACADÉMIE ROTALE de Musique, en faveur du Sieur de Lully.
90 OUIS, par la Grace de Dieu, Roy de France & de Navarre;	90 OUÏS, par la Grâce de Dieu, Roi de France et de Navarre;
A tous preſens & à venir, SALUT.	À tous présents et à venir, SALUT,
Les Sciences & les Arts étant les Ornemeus les plus conſiderables des Eſtats;	Les Sciences et les Arts étant les Ornemeus les plus considérables des États;
Nous n’avons point eû de plus agreables Divertiſſemens, depuis que Nous avons donné la Paix à nos Peuples, que de les faire revivre, en appellant prés de Nous tous ceux qui ſe ſont acquis la reputation d’y exceller, non ſeulement dans l’étenduë de Nôtre Royaume;	Nous n'avons point eu de plus agréables Divertissements, depuis que Nous avons donné la Paix à nos Peuples, que de les faire revivre, en appelant près de Nous tous ceux qui se sont acquis la réputation d'y exceller, non seulement dans l'étendue de Notre Royaume;
mais auſſi dans les Païs Etrangers;	mais aussi dans les Pays Étrangers;
& pour les obliger d’avantage de s’y perfectionner;	et pour les obliger d'avantage de s'y perfectionner;
Nous les avons honorez des marques de nôtre eſtime & de nôtre bien-veillance:	Nous les avons honorés des marques de notre estime et de notre bienveillance:
Et comme entre les Arts Liberaux, la Muſique y tient un des premiers rangs, Nous aurions dans le deſſein de la faire reüſſir avec tous ces avantages, par nos Lettres Patentes du 28.	Et comme entre les Arts Libéraux, la Musique y tient un des premiers rangs, Nous aurions dans le dessein de la faire réussir avec tous ces avantages, par nos Lettres Patentes du 28.
Juin 1669.	Juin 1669.
accordé au Sieur Perrin une Permiſſion d’établir à nôtre bonne Ville de Paris, & autres de nôtre Royaume, des Academies de Muſique pour chanter en public des Pieces de Theatre, comme il ſe pratique en Italie, en Allemagne & en Angleterre, pendant l’eſpace de douze années:	accordé au Sieur Perrin une Permission d'établir à notre bonne Ville de Paris, et autres de notre Royaume, des Académies de Musique pour chanter en public des Pièces de Théâtre, comme il se pratique en Italie, en Allemagne et en Angleterre, pendant l'espace de douze années:
Mais avant eſté depuis informé que les peines & les ſoins que ledit Sieur Perrin a pris pour cet établiſſement n’ont pû ſeconder pleinement nôtre intention, & élever la Muſique au point que Nous nous l’étions promis;	Mais avant été depuis informé que les peines et les soins que ledit Sieur Perrin a pris pour cet établissement n'ont pu seconder pleinement notre intention, et élever la Musique au point que Nous nous l'étions promis;
Nous avons crû, pour y mieux reüſſir, qu’il étoit à propos d’en donner la conduite à une perſonne, dont l'experience & la capacité Nous fuſſent connuës, & qui eût aſſez de ſuffiſance pour fournir des eſleves, tant pour bien chanter & actionner ſur le Theatre, qu’à dreſſer des bandes de Violons, Fiûtes, & autres Inſtrumens.	Nous avons cru, pour y mieux réussir, qu'il était à propos d'en donner la conduite à une personne, dont l'expérience et la capacité Nous fussent connues, et qui eût assez de suffisance pour fournir des élèves, tant pour bien chanter et actionner sur le Théâtre, qu'à dresser des bandes de Violons, Fiûtes, et autres Intruments.
A CES CAUSES, bien informez de l’intelligence & grande connoiſſance que s’eſt acquis nôtre chet & bien amé Jean-Baptiſte Luily au fait de la Muſique, dont il Nous a donné & donne journellement de tres-agreables preuves depuis pluſieurs années qu’il s’eſt attaché à nôtre ſervice, qui Nous ont convié de l’honorer de la Charge de Sur-Intendant & Compoſiteur de la Muſique de nôtre Chambre;	À CES CAUSES, bien informés de l'intelligence et grande connaissance que s'est acquis notre chet et bien amé Jean-Baptiste Luily au fait de la Musique, dont il Nous a donné et donne journellement de très -agréables preuves depuis plusieurs années qu'il s'est attaché à notre service, qui Nous ont convié de l'honorer de la Charge de Sur-Tendant et Compositeur de la Musique de notre Chambre;
Nous avons audit Sieur Lully permis & accordé, permettons & accordons par ces preſentes ſignées de nôtre main, d’établir une Academie Royale de Muſique dans nôtre bonne Ville de Paris, qui ſera compoſée de rel nombre & qualité de perſonnes qu’il aviſera bon eſtre, que Nous choiſirons & arreſterons ſur le rapport qu’il Nous en fera pour faire des Repreſentations devant Nous, quand il nous plaira.	Nous avons audit Sieur Lully permis et accordé, permettons et accordons par ces présentes signées de notre main, d'établir une Académie Royale de Musique dans notre bonne Ville de Paris, qui sera composée de rel ombre et qualité de personnes qu'il avisera bon être, que Nous choisirons et arrêterons sur le rapport qu'il Nous en fera pour faire des Représentations devant Nous, quand il nous plaira.
des pieces de Muſique qui ſerout compoſées, tant en Vers François, qu’autres Langues étrangeres, pareilles & ſemblables aux Academies d’Italie;	des pièces de Musique qui serout composées, tant en Vers Français, qu'autres Langues étrangères, pareilles et semblables aux Academies d'Italie;
Pour en joüir ſa vie durant, & aprés luy, celuy de ſes enfans qui ſera pourveu & receu en ſurvivance de ladite Charge de Sur-Intendant de la Muſique de nôtre Chambre, avec pouvoir d’aſſocier avec luy qui bon luy ſemblera, pour l’établiſſement de ladite Academie, & pour le dédommager des grands frais qu’il conviendra faire pour leſdites Repreſentations, tantà cauſe des Theatres, Machines, Decorations, Habits, qu’autres choſes neceſſaires.	Pour en jouir sa vie durant, et après lui, celui de ses enfants qui sera pourvu et reçu en survivance de ladite Charge de Sur-Intendant de la Musique de notre Chambre, avec pouvoir d'associer avec m qui bon lui semblera, pour l'établissement de ladite Academie, et pour le dédommager des grands frais qu'il conviendra faire pour lesdites Représentations, tantà cause des Théatres, Machines, Decorations, Habits, D'autres choses nécessaires.
Nous luy permettons de donner au public toutes les pieces qu’il aura compoſées, meſme celles qui auront eſté repreſentées devant Nous, ſans neantmoins qu’il puiſſe ſe ſervir pour l’execution deſdites Pieces, des Muſiciens qui ſont à nos gages:	Nous y permettons de donner au public toutes les pièces qu'il aura composées, même celles qui auront été représentées devant Nous, sans néanmoins qu'il puisse se servir pour l'exécution dédites Pièces, des Musiciens qui sont à nos gages:
Comme auſſi de prendre telle ſomme qu’il jugera à propos, & d’établir des Gardes & autres gens neceſſaires aux portes des lieux où ſe feront leſdites Repreſentations:	Comme aussi de prendre telle somme qu'il jugera à propos, et d'établir des Gardes et autres gens nécessaires aux portes des lieux où se feront lesdites Représentations:
Faiſant tresexpreſſes inhibitions & deffenſes à toutes perſonnes de quelque qualité & condition qu’elles ſoient, meſme aux Officiers de nôtre Maiſon d’y entrer ſans payer:	Faisant tresexpresses inhibitions et défenses à toutes personnes de quelque qualité et condition qu'elles soient, même aux Officiers de notre Maison d'y entrer sans payer:
Comme auſſi de faire chanter aucune Piece entiere en Muſique, ſoit en Vers François, ou autres Langues, ſans la permiſſion par écrit dudit Sieur Lully, à peine de dix mil livres d’amende, & de confiſcation des Theatres, Machines, Decorations, Habits, & autres choſes, applicables un tiers à Nous, un tiers à l’Hoſpital General, & l’autre tiers audit Sieur Lully:	Comme aussi de faire chanter aucune Pièce entière en Musique, soit en Vers Français, ou autres Langues, sans la permission par écrit dudit Sieur Lully, à peine de dix mille livres d'amende, et de confiscation des Théatres, Machines, Décorations, Habits, et autres choses, applicables un tiers à Nous, un tiers à l'Hospital Général, et l'autre tiers audit Sieur Lully:
Lequel pourra auſſi etablir des Eſcoles particulieres de Muſique en nôtre bonne Ville de Paris, & par tout où il jugera neceſſaire pour le bien & l’avantage de ladite Academie Royale.	Lequel pourra aussi établir des Escoles particulières de Musique en notre bonne Ville de Paris, et par tout où il jugera nécessaire pour le bien et l'avantage de ladite Académie Royale.
Et d’autant que Nous érigeons ſur le pied de celles des Academies d’Italie, où les Gentils-hommes chantent publiquement en Muſique ſans déroger:	Et d'autant que Nous érigeons sur le pied de celles des Academies d'Italie, où les Gentils-hommes chantent publiquement en Musique sans déroger:
VOULONS ET NOUS PLAIST, que tous Gentils-hommes & Damoiſelles puiſſent chanter auſdites Pieces & Repreſentations de nôtre Academie Royale, ſans que pour ce ils ſoient cenſez déroger audit Titre de Nobleſſe, & à leurs Privileges, Charges, Droits & Immunitez:	VOULONS ET NOUS PLAÎT, que tous Gentilshommes et Damoiselles puissent chanter ausdites Pièces et Représentations de notre Académie Royale, sans que pour ce ils soient censé déroger audit Titre de Noblesse, et à leurs Privilèges, Charges, Droits et Imunités:
Revoquons, caſſons, & annullons par ceſdites Preſentes, tontes Permiſſions & Privileges que Nous peurrions avoir cy-devant données & accordées, meſme celuy dudit Perrin, pour raiſon deſdites Pieces de Theatre en Muſique, ſous quelques noms, qualitez, conditions & pretextes que ce puiſſe eſtre.	Revoquons, cassons, et annullons par cesdites Pressentes, tontes Permissions et Privilèges que Nous peurrions avoir cy-devant données et accordées, même celui dudit Perrin, pour raison dédites Pièces de Théâtre en Musique, sous quelques noms, qualité, ions et prétextes que ce puisse être.
SI DONNONS EN MANDEMENT à nos amez & feaux Conſeillers, les Gens tenans nôtre Cour de Parlement à Paris, & autres nos Juſticiers & Officiers qu’il appartiendra;	SI DONNONS EN MANDEMENT à nos âmez et féaux Conseillers, les Gens tenants notre Cour de Parlement à Paris, et autres nos Justiciers et Officiers qu'il appartiendra;
Que ces Preſentes ils ayent à faire lire, publier & enregiſtrer, & du contenu en icelles, raite jouit ce dret leuit Dapoiane preiemene & paiſiblement, ceſſant & faiſant ceſſer tous troubles & empeſchemens au contraire:	Que ces Présentes ils aient à faire lire, publier et enregistrer, et du contenu en icelles, raite jouit ce dret levit Dapoiane preiemene et paisiblement, cessant et faisant cesser tous troubles et empêchements au contraire:
CAR tel eſt nôtre plaiſir:	CAR tel est notre plaisir:
Et afin que ce ſoit choſe ferme & ſtable à toûjours, Nous avons fait mettre nôtre Scel à ceſdites Preſentes.	Et afin que ce soit chose ferme et stable à toujours, Nous avons fait mettre notre Scel à cesdites Pressentes.
DONNE' à Verſailles au mois de Mars, l’an de grace mil ſix cens ſoixante-douze:	DONNE' à Versailles au mois de Mars, l'an de grâce mil six cents soixante-douze:
Et de nôtre Regne le vingt-neufiéme.	Et de notre Reine le vingt-neume.
Signé, LOUIS.	Signé, LOUIS.
Et à coſté, Viſa, LOUIS.	Et à côté, Visa, LOUIS.
Et plus bas, Par	Et plus bas, Par
le Roy, COLBERT.	le Roi, COLBERT.
Et encore eſtécrit.	Et encore estécrit.
Egifurcee, ony ue Froumioun oenorau au ftoy, pour eſtre executées, N & joüir par l’Impetrant de l’effet & contenu en icelles ſelon leur forme & teneur, ſuivant l’Arreſt de ce jour.	Egifurée, on ue Froumioun oénorau au fûtoi, pour être exécutées, NEL et jouir par l'Impetrant de l'effet et contenu en icelles selon leur forme et teneur, suivant l'Arrest de ce jour.
A Paris en Parlement le vingt- ſeptiéme Iuin mil ſix cens ſoixante-douze.	À Paris en Parlement le vingt- septiême Juin mil six cens soixante-douze.
Signé ROBERT.	Signé ROBERT.
PRIVILEGE DU ROY.	PRIVILÈGE DU ROI.
OUIS par la grace de Dieu, Roy de France & de Navarre:	OUÏS par la grâce de Dieu, Roi de France et de Navarre:
LA nos amez & feaux Gonſeillers les Gens tenans nos Cours de Parlement, Maiſtre des Requeſtes ordinaire de nôtre Hoſtel & du Palais, Baillifs, Seneſchaux, leurs Prevoſts & Lieutenans.	LA nos âmez et féaux Gonseillers les Gens tenants nos Cours de Parlement, Maître des Requêtes ordinaire de notre Hôtel et du Palais, Baillifs, Sénéchaux, leurs Prévôts et Lieutenants.
& teus autres nos Juſticiers & Officiers qu’il appartiendra, SALUT.	et teus autres nos Justiciers et Officiers qu'il appartiendra, SALUT.
Nôtre bien amé Jean-Baptiſte Lully, Sur-Intendanr de la Muſique de nôtre Chambre, Nous a fait remontrer que les Airs de Muſique qu’il a cy-devant compoſez, ceux qu’il compoſe journellement par nos ordres, & ceux qu’il ſera obligé de compoſer à l’avenir pour les pieces qui ſeront repreſentées par l’academie Royale de Muſique, laquelle Nous luy avons permis d’établir en nôtre bonne Ville de Paris, & autres lieux de nôtre Royaume où bon luy ſemblera, étant purement de ſon invention.	Notre bien am Jean-Baptiste Lully, Sur-Intendanr de la Musique de notre Chambre, Nous a fait remontrer que les Airs de Musique qu'il a cy-devant composés, ceux qu'il compose journellement par nos ordres, et ceux qu'il sera obligé de composer à l'avenir pour les pièces qui seront représentées par l'académie Royale de Musique, laquelle Nous lui avons permis d'établir en notre bonne Ville de Paris, et autres lieux de notre Royaume où bon lui semblera, étant purement de son invention.
& de telle qualité que le moindre changement ou obmiſſion leur fait perdre leur grace naturelle;	et de telle qualité que le moindre changement ou obmission leur fait perdre leur grâce naturelle;
de ſorte que comme ſon eſprit ſeul les produit pour les appliquer aux ſujets qu’il y trouve proportionnez, nul autre ne peut ſi bien que luy rendre leſdits Ouvrages publics dans leur perfection, & avec l’exactitude qui leur eſt deuë.	de sorte que comme son esprit seul les produit pour les appliquer aux sujets qu'il y trouve proportionnez, nul autre ne peut si bien que sans rendre lesdits Ouvrages publics dans leur perfection, et avec l'exactitude qui leur est due.
Et d’ailleurs, il eſt juſte que ſi leur impreſſion doit apporter quelque avantage, il revienne plutoſt à l’Autheur pour le recompenſer de ſon travail, & de partie des frais qu’il avance pour l’execution des Deſſeins qu’il doit faire repreſenter par ladite Academie, qu’à de ſimples Copiſtes qui les imprimeroient ſous pretexte de Permiſſions generales ou particulieres qu’ils peuvent avoir obtenuës par ſurpriſes ou autrement;	Et d'ailleurs, il est juste que si leur impression doit apporter quelque avantage, il revienne plutôt à l'Auteur pour le recompenser de son travail, et de partie des frais qu'il avance pour l'exécution des Desseins qu'il doit faire représenter par ladite Académie, qu'à de simples Copistes qui les imprimaient sous prétexte de Permissions générales ou particulières qu'ils peuvent avoir obtenues par prises ou autrement;
ce qui l’oblige d’avoir recours à nos Lettres ſur ce neeeſſaires.	ce qui l'oblige d'avoir recours à nos Lettres sur ce nécessaires.
A CES CAUSES, voulans favorablement traiter l’Expoſant, Nous luy avons permis & accordé, permettons & accordons par ces Preſentes, de faire imprimer par tel Libraire ou Imprimeur, en tel Volume, Marge, Caractere, & autant de fois qu’il voudra, avec Planches & Figures tous & chacuns les Airs de Muſiques qui ſeront par luy faits;	À CES CAUSES, voulant favorablement traiter l'Exposant, Nous ç avons permis et accordé, permettons et accordons par ces Presentes, de faire imprimer par tel Libraire ou Imprimeur, en tel Volume, Marge, Caractère, et autant de fois qu'il voudra, avec Planches et Figures tous et chacuns les Airs de Musiques qui seront par même faits;
comme auſſi les Vers, Paroles, Sujets, Deſſeins & Ouvrages ſur leſquels leſdits Airs de Muſique auront eſté compoſez, ſans en rien excepter, & ce pendant le temps de trente années conſecutives, à commencer du jour que chacun deſdits Ouvrages ſeront achevez d’imprimer, iceux vendre & débiter dans tout nôtre Royaume, par luy ou par autre, ainſi que bon luy ſemblera, ſans qu’aucun trouble ny empeſchement quelconque luy puiſſe eſtre apporté, meſme par ceux qui pretendent avoir de Nous Privilege pour l’impreſſion des Airs de Muſique & Ballets, leſquels pour ce regard, en tant que beſoin eſt ou ſeroit, Nous avons revoqué & revoquons par ceſdites Preſentes;	comme aussi les Vers, Paroles, Sujets, Desseins et Ouvrages sur lesquels lesdits Airsont Encore auront encore composés, sans en rien excepter, et ce pendant le temps de trente années consécutives, à commencer du jour que chacun desdits Ouvrages seront achevez d'imprimer, iceux vendre et débiter dans tout notre Royaume, par même ou par autre, ainsi que bon lui semblera, sans qu'aucun trouble ici empêchement quelconque lui puisse chang apporté, même par ceux qui prétendent avoir de Nous Privilege pour l'impression des Airs de Musique et Ballets, lesquels pour ce regard, en tant que besoin est ou seroit, Nous avons revoqué et révoquons par cesdites Presentes;
Faiſant tres-expreſſes inhibitions & deffenſes à tous Libraires, Imprimeurs, Colporteurs, & autres perſonnes de quelque qualité qu’elles ſoient, d’imprimer, faire imprimer, vendre & diſtribüer leſdites Pieces de Muſique, Vers, Paroles, Deſſeins, Sujets, & generalement tout ce qui a eſté & ſera compoſé par ledit Lully, ſous quelque pretexte que ce ſoit, meſme d’impreſſion étrangere & autrement, ſans ſon conſentement ou de ſes ayans cauſe, ſur peine de confiſcation des Exemplaires contrefaits, dix mille livres d’amende, tant contre ceux qui les auront imprimez & vendus, que contre ceux qui s’en trouveront ſaiſis, & de tous dépens, dommages & intereſts;	Faisant très-expresses inhibitions et défenses à tous Libraires, Imprimeurs, Colporteurs, et autres personnes de quelque qualité qu'elles soient, d'imprimer, faire imprimer, vendre et distribuer lesdites Pièces de Musique, Paroles, Desseins, Desseins, Sujets, et généralement tout ce qui a été et sera composé par ledit Lully, sous quelque prétexte que ce soit, été d'impression étrangère et ment, sans son consentement ou de ses ayant cause, sur peine de confiscation des Exemplaires contrefaits, dix mille tant d'amende, tant contre ceux qui les avant imprimez et vendus, que contre ceux qui en trouveront saisis, et de tous dépens, dommages et intérêts;
à la charge d’en mettre deux Exemplaires en nôtre Bibliothéque publique, un en nôtre Cabinet des Livres de nôtre Chaſteau du Louvre, & un en celle de nôtre trescher & feal Chevalier Garde des Sceaux de France le Sieur d’Aligre, à peine de nullité des Preſentes.	à la charge d'en mettre deux Exemplaires en notre Bibliothéque publique, un en notre Cabinet des Livres de notre Château du Louvre, et un en celle de notre trêcher et féal Chevalier Garde des Sceaux de France le Sieur d'Aligre, à peine de nullité des Présentes.
Du contenu deſquelles, vous mandons & enjoignons faire joüir l’Expoſant & ſes ayans cauſe, pleinement & paiſiblement, ceſſant & faiſant ceſſer tous troubles & empeſchemens au contraire;	Du contenu desquelles, vous mandons et enjoignons faire jouir l'Exposant et ses ayant cause, pleinement et paisiblement, cessant et faisant cesser tous troubles et empêchements au contraire;
Voulons qu’en mettant au commencement ou à la fin defdites Lettres l’Extrait des Preſentes, elles ſoient tenuës deuëment ſignifiées, & qu’aux copies collationnées par l’un de nos amez feaux Secretaires, foy ſoit ajoûtée comme à l’Original.	Voulons qu'en mettant au commencement ou à la fin defdites Lettres l'Extrait des Présentes, elles soient tenues deuëment signifiées, et qu'aux copies collationnées par l'un de nos âmez féaux Secretaires, foi soit ajoutée comme à l'Original.
Mandons au premier nôtre Huiſſier ou Sergent, faire pour l’execution des Preſentes, toutes ſignifications, deffenſes, ſaiſies, & autres actes requis & neceſſaires, ſans pour ce demander autre permiſſion, nonobſtant oppoſitions ou appellations quelconques, dont ſi aucunes interviennent, Nous nous en reſervons & à nôtre Conſeil la connoiſſance, & icelle interdiſons & deffendons à tous autres Juges:	Mandons au premier notre Huissier ou Sergent, faire pour l'exécution des Présentes, toutes significations, défenses, saisies, et autres actes requis et nécessaires, sans pour ce demander autre permission, nonobstant oppositions ou appellations quelconques, dont si aucunes interviennent, Nous nous en réservons et à notre Conseil la connaissance, et icelle interdisons et défendons à tous autres Juges:
CAR tel eſt nôtre plaiſir.	CAR tel est notre plaisir.
DONNE à Verſailles le vingtiéme jour de Septembre, l’an de grace mil ſix cens ſoixante-douze;	DONNE à Versailles le vingtième jour de Septembre, l'an de grâce mille six cens soixante-douze;
& de uôtre Regne le trentiéme.	et de elle Règne le trentième.
Signé LOUIS:	Signé LOUIS:
Et plus bas, Par le Roy, COLBERT.	Et plus bas, Par le Roi, COLBERT.
Et ſcellé du'grand Sceau de cire jaune.	Et scelé dugrand Sceau de cire jaune.
