M.	M.
DC.	DC.
LXV.	LXV.
AVEC PERMISSION.	AVEC PERMISSION.
AV LECTEVR.	AU LECTEUR.
E ne ſçay ſi tu trouueras les Marquis Frians à ton gouſt.	E ne sais si tu trouveras les Marquis Friants à ton goût.
Peut-eſtre que ſi ie t’auois traitté à cinq ſeruices tu aurois pn uronner quelque choſe dans la diuerſité des mets, capable de te flater.	Peut-être que si ici t'avais traité à cinq services tu aurais p uronner quelque chose dans la diversité des mets, capable de te flatter.
Meſſieurs les Coſteaux m’en auoient appreſté beaucoup;	Messieurs les Costeaux m'en avaient apprêté beaucoup;
mais elles n’ont pû toutes entrer dans vn ſeruice, & que les vnes eſtoient bonnes pour les entrées, & les autres pour l’entremets:	mais elles n'ont pu toutes entrer dans un service, et que les unes étaient bonnes pour les entrées, et les autres pour l'entremets:
I’ay crû ne te deuoir pas ſeruir auec tant de confuſion, ie ne t'explique point ce que c’eſt que Coſteau;	J'ai cru ne te devoir pas servir avec tant de confusion, tu ne t'explique point ce que c'est que Costeau;
puiſqu’il eſt amplement expliqué dans la piece Pour ce qui regarde le ſujet, tu n peux pas trouuer beaucoup à redirt pource qu’il y en a fort peu, & que la piece n’eſt qu’vne conuerſation Elle eſt vn peu miſterieuſe, ce qui me fait eſperer qu’elle plaira à ceus qui connoiſſent les bonnes tables.	puisqu'il est amplement expliqué dans la pièce Pour ce qui regarde le sujet, tu n peux pas trouver beaucoup à redirt pource qu'il y en a fort peu, et que la pièce n'est qu'une conversation Elle est un peu mystérieuse, ce qui me fait espérer qu'elle plaira à ceus qui connaissent les bonnes tables.
PERMISSION DE MONSIEVR le Baillif du Palais.	PERMISSION DE MONSIEUR le Baillif du Palais.
L eſt permis à Gabriel Quinet MarEchand Libraire au Palais, d’imprimer, faire imprimer, vendre & debiter vne Comedie intitulé;	L est permis à Gabriel Quinet MarEchand Libraire au Palais, d'imprimer, faire imprimer, vendre et débiter une Comédie intitulé;
Les Coſteaux ou les Marquis Frians:	Les Costeaux ou les Marquis Friants:
Et deffences ſont faites à tout autre de l’imprimer vendre ny debiter, ſans le conſentement dudit Sieur, à peine de 500.	Et défenses sont faites à tout autre de l'imprimer vendre ici débiter, sans le consentement dudit Sieur, à peine de 500.
liu.	liv.
d’amande & de confiſcation des Exemplaires.	d'amande et de confiscation des Exemplaires.
Fait à Paris ce 28.	Fait à Paris ce 28.
Ianuier 1665.	Janvier 1665.
ACTEVRS.	ACTEURS.
THERSANDRE, homme de qualité, Amant de Lucille.	THÉRSANDRE, homme de qualité, Amant de Lucille.
MELINTE, Mere de Lucille.	MELINTE, Mère de Lucille.
CLIDAMANT, Marquis & Amant Lucille.	CLIDAMANT, Marquis et Amant Lucille.
LEANDRE, Comte.	LÉANDRE, Comte.
VALERE, Marquis.	VALÈRE, Marquis.
CRISPIN, Valet de Clidamant.	CRISPIN, Valet de Clidamant.
La Scene eſt dans vne ſalle, au logis de The ſaudre.	La Scène est dans une salle, au logis de The saudre.
toute lα lasa de ct pu βομιύνει ακμνονεο dαμς Qμιεv  deo parasisce De la Cud	toute l lasa de ct pu βομιύνει ακμνονεοdαμς Qμιεv deo re De la 
LES A LES VA MARQVIS FRIANS.	LES À LES VA MARÊQUIS FRIANS.
SCENE PREMIERE.	SCÈNE PREMIÈRE.
11 THERSANDRE DAMIS.	11 THÉRSANDRE DAMIS.
2 THERSANDRE.	2 THÉRSANDRE.
V me blaſmes à tort de ce que ie tiens table;	V me blâmes à tort de ce que Seigneur tiens table;
Apprens que des plaiſirs c’eſt le plus agreable Et ſi tu veux, enfin, que ie m’explique micux, Apprent que ce plaiſir plaît aux ambitieux;	Apprends que des plaisirs c'est le plus agréable Et si tu veux, enfin, que des plaisirs explique micux, Apprent que ce plaisir plaît aux ambitieux;
Que ie n’en trouue point aujourd’hoy qui l’égalle:	Que quelque n'en trouve point aujourd'hoi qui l'égale:
Qu’en l’aymant ie fais voir que j’ay l’amc Royalle, Et qu’en montrant par la ma gencroſité.	Qu'en l'aimant a fais voir que j'ai l'amc Roialle, Et qu'en montrant par la ma gencrosité.
De tous nos Courtiſans ie me vois reſpecté.	De tous nos Courtisans ie me vois respecté.
Tu ſçais qu’ils ont pour moy beaucoup de cõplaiſance.	Tu sais qu'ils ont pour moi beaucoup de complaisance.
Qu'en cent occaſions j’ay veu leur déferance;	Qu'en cent occasions j'ai vu leur déferance;
Our ie regne ſur eux, & qu’enfin cher Damis, Ils ne viennent chez moy qu’en Eſclaues ſouſmis;	Our ici règne sur eux, et qu'enfin cher Damis, Ils ne viennent chez moi qu'en Esclaues soumis;
Qu’aux moindres de mes gens ſans ceſſe ils font careſt	Qu'aux moindres de mes gens sans cesse ils font carest
DAMIS.	DAMIS.
On ne le peut nier, & meſme je confeſſe, Qu'ils font encore plus, mais aprés tout, Monſieur, Chez eux voſtre cuiſine eſt en fort bonne odeur, Et prés beaucoup de gens, tenant lieu de merite, Elle eſt cauſe, ſouuent, qu’ils vous rendent viſite.	On ne le peut nier, et même je confesse, Qu'ils font encore plus, mais après tout, Monsieur, Chez eux vôtre cuisine est en fort bonne odeur, Et prés beaucoup de gens, tenant lieu de mérite, Elle est cause, souvent, qu'ils vous rendent visite.
Ces Meſſieurs, bien inſtruits en l’art de deuiner, Se trouuent iuſtement à l’heure du diſner.	Ces Messieurs, bien instruits en l'art de deviner, Se trouvent justement à l'heure du dîner.
En loüant vos vertus, ils ſe mettent à Table:	En louant vos vertus, ils se mettent à Table:
Pendant tout le repas vous eſtes adorable.	Pendant tout le repas vous êtes adorable.
Puis le diſné finy, ces eſprits inconſtans, S’en vont en d’autres lieux railler à vos deſpens.	Puis le dîné fini, ces esprits inconstants, S'en vont en d'autres lieux railler à vos dépens.
THERSANDRE.	THÉRSANDRE.
Ie ſcayque.	Je scayque.
DAMIS.	DAMIS.
Vous m’auez permis de vous tout dire.	Vous m'avez permis de vous tout dire.
Ie vois ce qui ſe paſſe, & veux vous en inſtruire;	Je vois ce qui se passe, et veux vous en instruire;
Puiſque vous ne pouuez vous-meſme diſcerner, Vos amis, d’auec ceux qui viennent pour diſner.	Puisque vous ne pouvez vous-même discerner, Vos amis, d'avec ceux qui viennent pour dîner.
THERSANDRE.	THÉRSANDRE.
Ie ne connois que trop dequoy l’homme eſt capab Ie ſçay qu’on m’aime moins que l’on ne fait ma Tabl Mais voulant l’ignorer, ie n’examinc pas, Les diſcours que l’on tient en ſuitẽ du repas:	Je ne connais que trop dequoy l'homme est capab Je sais qu'on m'aime moins que l'on ne fait ma Tabl Mais voulant l'ignorer, je n'examinc pas, Les discours que l'on tient ens suitẽ du repas:
Suffit que tant qu’il duré vn chacon me reuere;	Suffit que tant qu'il duré un chacon me révère;
Que chacun ì l’enuy ſéforce de me plaire;	Que chacun âme l'envi séforce de me plaire;
Et que chacun, enfin, me paye ſonccot.	Et que chacun, enfin, me paie sonccot.
Par vn conte agrcable, ou par quelque bon moti Ce n'eſt pas qu'entre ceux qui viennent à ma Table, Ie ne puiſſe trouuer quelque amy veritable;	Par un conte agrable, ou par quelque bon moti Ce n'est pas qu'entre ceux qui viennent à ma Table, Je ne puisse trouver quelque ami véritable;
I’en connois deux ou trois, & les y fais venir, Pour auoir le plaiſir de lei entretenir.	J'en connais deux ou trois, et les y fais venir, Pour avoir le plaisir de lei entretenir.
DAMIS.	DAMIS.
Pour traitter des amis, fait-on tant de doſpence?	Pour traiter des amis, fait-on tant de dospense?
Et.	Et.
THERSANDRE Ie ſouſtien, par la l'eſclat de ma naiſſance, Et donnant à manger ſelon ma qualité.	THÉRSANDRE Je soutien, par la l'éclat de ma naissance, Et donnant à manger selon ma qualité.
Ie gouſte la douceur de me voir reſpegté.	Je goûte la douceur de me voir respégté.
DAMIS.	DAMIS.
Si voſtre amour dépence autam que voſtre Table, Ie croy voſtre ruine vn mal incuitable, Car enfin ie voy trop qu’auecque tant d’ardeur.	Si votre amour dépense autam que votre Table, Je crois votre ruine un mal incuitable, Car enfin quelque vois trop qu'avec tant d'ardeur.
THERSANDRE.	THÉRSANDRE.
I'auoüeray que Lacille à ſçeu gaigner mon cœur.	J'auoüeray que Lacille à su gagner mon cœur.
DAMIS.	DAMIS.
Mais ſi vous conſcruez tant d’ardeur dans voſtre ame;	Mais si vous conscruez tant d'ardeur dans votre âme;
I’arlez, & vous verrez approuuer voſtre flame, La Mere de Lucille;	J'arlez, et vous verrez approuver votre flamme, La Mère de Lucille;
cn apprenant.	Un apprenant.
THENSANDRE.	THÉNSANDRE.
Ie veux, Auant de lay parler faire approuuer mes vœux, Et qu’aux ardens tranſports de mon amour extréme:	Je veux, Avant de lay parler faire approuver mes vœux, Et qu'aux ardents transports de mon amour extrême:
La beauté que ie ſers ſe rende d’elle-meſme.	La beauté que ie sers se rende d'elle-même.
DAMIS.	DAMIS.
Mais ne ſçauez-vous pas, Monſieur, que Clidamant, Pour la meſme beauté ſoûpire ounertement, Et qu’on n’eſt pas long-temps ſans payer la tendreſſe, De ceux dont la naiſſance égale la richeſſe?	Mais ne savez-vous pas, Monsieur, que Clidamant, Pour la même beauté soupire ounertement, Et qu'on n'est pas longtemps sans payer la tendresse, De ceux dont la naissance égale la richesse?
THERSANDRE.	THÉRSANDRE.
Ce riual a du bien & de la qualité;	Ce rival a du bien et de la qualité;
Mais Damis aprés tout ce n’eſt qu’vn cſuenté.	Mais Damis après tout ce n'est qu'un csuenté.
Et quelque ardeur, enfin, qui regne dans ſon ame;	Et quelque ardeur, enfin, qui règne dans son âme;
Il merite trop peu pour allarmer ma flame.	Il mérite trop peu pour alarmer ma flamme.
Lucil le à trop d’eſprit pour approuuer ſon feu, Et iamais de ſa bouche il n’en aura l’aucu.	Lucil le à trop d'esprit pour approuver son feu, Et jamais de sa bouche il n'en aura l'aucu.
DAMIS.	DAMIS.
Quand Lueille ſeroit à ſa flame contraire, Ne la pouroit-il pas obtenir de ſa Mere?	Quand Lueille serait à sa flamme contraire, Ne la pourrait-il pas obtenir de sa Mère?
THERSANDRE.	THÉRSANDRE.
Ayant vn grand procez elle en veut voir la fin, Auant que de ſa fille, ordonner du deſtin.	Ayant un grand procès elle en veut voir la fin, Avant que de sa fille, ordonner du destin.
DAMIS.	DAMIS.
Vous la pourriez, Monſieur, ſeruir dans cette affaire.	Vous la pourriez, Monsieur, servir dans cette affaire.
THERSANDRE.	THÉRSANDRE.
Mon amour doit aſſez m’obliger à le faire, A ce charmant objet, ie l’ay deſia promis, Et quand il ſera temps ſ’employeray mes amis, Mals pour reſuer en paix à ſa beauté diuine, I'entre en mon cabinct juſqu’à ce que l’on diſne.	Mon amour doit assez m'obliger à le faire, À ce charmant objet, ie j'ai déjà promis, Et quand il sera temps s'emploierai mes amis, Mals pour rêver en paix à sa beauté divine, J'entre en mon cabinct jusqu'à ce que l'on dîne.
DAMIS.	DAMIS.
Les nobles affamez, qui dedans peu viendront, A l’heure du diſner vous en retireront.	Les nobles affamés, qui dedans peu viendront, A l'heure du dîner vous en retireront.
THERSANDRE.	THÉRSANDRE.
Ah!	Ah!
que ſi tu voulois aujourd’huy m’en défaire.	que si tu voulais aujourd'hui m'en défaire.
DAMIS.	DAMIS.
Mon eſprit ne ſçauroit comprendre ce myſtere, Ny deuiner pourquoy vous auex ordonné, Que l’on vous appreſtaſt vn ſuperbe diſné.	Mon esprit ne saurait comprendre ce mystère, Ni deviner pourquoi vous au ordonné, Que l'on vous apprêtât un superbe dîné.
THERSANDRE.	THÉRSANDRE.
Si tu ne le ſçais pas, apprends donc que Melinte;	Si tu ne le sais pas, apprends donc que Melinte;
Doit auec la beauté dont mon ame eſt atteinte, Venir diſner icy:	Doit avec la beauté dont mon âme est atteinte, Venir dîner ici:
Que ie leur dis hyer, Voyant de les ſeruir qu’elles m’alloient prier, Que ie n'écoutois point chez elle leur priere, Et voulois que ceans, elles la vinſſent faire, Et diſner auec moy deuant que d’en ſortir.	Que était leur dis hier, Voyant de les servir qu'elles m'allaient prier, Que ainsi n'écoutais point chez elle leur prière, Et voulais que céans, elles la vinssent faire, Et dîner avec moi devant que d'en sortir.
Voila dequoy i’ay crſ̂ te deuoir aduertir.	Voilà de quay j' ai cruoir avertir.
Par le petit degré, prens ſoin que l’on nous ſerue, Et que des ſuruenans ancun ne nous obſeruc.	Par le petit degré, prends soin que l'on nous serve, Et que des survenants ancun ne nous observuc.
Au reſte ie commence à voir que mon ardeur, Plaiſt aſſez à l’objet qui m’a rauy le cœur, Et ie me trompe fort, ou ie croy que ſa mere, Au bon-heur que j’attens ne ſera pas contraire, Si tu les vois venir tu m’en aduertiras.	Au reste ici commence à voir que mon ardeur, Plaît assez à l'objet qui m'a ravi le cœur, Et grande me trompe fort, ou tu crois que sa mère, Au bonheur que j'attends ne sera pas contraire, Si tu les vois venir tu m'en avertiras.
DAMIS.	DAMIS.
Repoſez-vous ſur moy, ie n’y manqueray pas.	Reposez-vous sur moi, une n'y manquerai pas.
SCENE II.	SCÈNE II.
DAMIS ſeul.	DAMIS seul.
Approuue le beau feu qui regne dans ſon ame, Puiſque Lucille eſt belle, & digne de ſa flame, Pour ſa mere elle l’aime vn peu trop tendrement, Mais cét amour leur nuit, & cét objet charmant, Contraignant par deuoir, ſon geſte & ſa parolle.	Approuve le beau feu qui règne dans son âme, Puisque Lucille est belle, et digne de sa flamme, Pour sa mère elle l'aime un peu trop tendrement, Mais cet amour leur nuit, et cet objet charmant, Contraignant par devoir, son geste et sa parole.
Fait croire qu’elle eſt vaine, & que ſa mere eſt folle.	Fait croire qu'elle est vaine, et que sa mère est folle.
SCENE III.	SCÈNE III.
4 DAMIS, ERGASTE.	4 DAMIS, ERGASTE.
ERGASTE.	ÉRGASTE.
M Elinte auccſa file.	M Elinte auccsa file.
DAMIS.	DAMIS.
Hé bien, fais les monter.	Hé bien, fais les monter.
ERGASTE.	ÉRGASTE.
I’y cours, mais les voicy.	J'y cours, mais les voici.
DAMIS, à part.	DAMIS, à part.
Contre de tels appas.	Contre de tels appas.
Qui pouroit reſiſter.	Qui pourrait résister.
SCENE IV.	SCÈNE IV.
MELINTE, LVCILLE, DAMIS.	MELINTE, LUCILLE, DAMIS.
MELINTE.	MELINTE.
NE puicje voir Therfandre?	NE puicje voir Therfandre?
DAMIS.	DAMIS.
Vous le verrez, Madame, & ie luy vais apprendre.	Vous le verrez, Madame, et ici ici vais apprendre.
Que vous eſtes icy.	Que vous êtes ici.
MELINTE.	MELINTE.
Vous nous obligerez.	Vous nous obligerez.
SCENE V.	SCÈNE V.
MELINTE LVCILLE.	MELINTE LUCILLE.
MELINTE.	MELINTE.
Ais dites-moy donc quand vous vous corti M gerez.	Ais dites-moi donc quand vous vous corti M gérez.
Elle ſe redreſſe elle-meſme.	Elle se redresse elle-même.
Tenez-vous droite là, c’eſt ainſi qu’il faut eſtre, Et ſi l’on n’a cẽt air, l’on ne ſçauroit paroiſtre.	Tenez-vous droite là, c'est ainsi qu'il faut être, Et si l'on n'a cẽt air, l'on ne saurait paraître.
LVCILLE.	LUCILE.
Mais qu oy faut-il.	Mais qu oi faut-il.
MELINTE.	MELINTE.
Ainſi vous eſtes cent fois mieux.	Ainsi vous êtes cent fois mieux.
Adouciſſez encor voſtre voix, & vos yeux:	Adoucissez encor votre voix, et vos yeux:
oruer touooomr vos eſpaules ſi hautes, Et ne retombez plus dans de pareilles fautes;	oruer touoomr vos épaules si hautes, Et ne retombez plus dans de pareilles fautes;
Mais qu’auec tout cela l’on voyc vn air poſé, Qui ne ſoit point contraint & qui paroiſſe aiſe.	Mais qu'avec tout cela l'on voisc un air posé, Qui ne soit point contraint et qui paraisse aise.
LVCILLE.	LUCILE.
Ie ne ſuis point contrainte, & ie la dois paroiſtre.	Je ne suis point contrainte, et ainsi la dois paraître.
Faiſant, par vos conſcils, tout ce qu’il faut pour l’eſtre, On nous ioüera Madame, & toutes ces façons.	Faisant, par vos conscils, tout ce qu'il faut pour l'être, On nous jouera Madame, et toutes ces façons.
MELINTE.	MELINTE.
Vous auez bonne grace à faire des leçons;	Vous avez bonne grâce à faire des leçons;
Voſtre eſprit, ſur ce point, manque bien de lumiere, Vous fais-je, dites-moy, faire vnc façonniere.	Votre esprit, sur ce point, manque bien de lumière, Vous fais-je, dites-moi, faire un façonniere.
Non, mais.	Non, mais.
LVCILLE.	LUCILE.
MELINTE.	MELINTE.
Qui vous oblige donc à vous faſcher.	Qui vous oblige donc à vous fâcher.
Dequoy vous plaignez-vous?	Dequoy vous plaignez-vous?
vous fais-je déhancher;	vous fais-je déhancher;
Ie fais tout le contraire, & quand ie vous oblige, D’eſtre bien droite, alors, mon diſcours vous afflige.	Je fais tout le contraire, et quand je vous oblige, D'être bien droite, alors, mon discours vous afflige.
LVCILLE.	LUCILE.
Madame, ie feray tout ce que vous voudrez.	Madame, Seigneur ferai tout ce que vous voudrez.
MELINTE.	MELINTE.
Vous ferez touſiours bien, quand vous m’obeyrez.	Vous ferez toujours bien, quand vous m'obérez.
LVCILLE.	LUCILE.
Ie ne puis ignorer que i’y ſuis obligée.	Je ne puis ignorer que j'y suis obligée.
MELINTE.	MELINTE.
Mais que vous paroiſſez aujourd'huy negligée;	Mais que vous paraissez aujourd'hui négligée;
Toutes vos actions marquent frop de langueur;	Toutes vos actions marquent frop de langueur;
Rien ne vous ſied du tout, & voſtre tein fait peur;	Rien ne vous sied du tout, et votre tein fait peur;
Vous n’auez point bon air, & ie ſuis fort ſurpriſe, Auec de tels habits de vous voir ſi mal miſe.	Vous n'avez point bon air, et Seigneur suis fort surprise, Avec de tels habits de vous voir si mal mise.
Renuerſez-vous ma fille, & faites des tetons.	Renversez-vous ma fille, et faites des tétons.
LVCILLE.	LUCILE.
Ie ſuiuray vos aduis, & dois les trouuer bons.	Je suivrai vos avis, et dois les trouver bons.
400 A uiij	400 A uiij
MELINTE.	MELINTE.
Dites-moy, cependant, voſtre cœar pour Therſandre.	Dites-moi, cependant, votre cœar pour Thersandre.
N’auroit-il point conçeu quelque ſentiment tendre?	N'aurait-il point conçu quelque sentiment tendre?
Ne me déguiſez rien, ie le croy voſtre amant.	Ne me déguisez rien, je le crois votre amant.
Et ie l’eſtime enfin, bien plus que Clidamant.	Et ici l'estime enfin, bien plus que Clidamant.
LVCILLE.	LUCILE.
Il m’aime ie l’auoüe, & le ſens que mon ame, Souhaite voſtre adueu pour repondre à ſa flame, Mais helas!	Il m'aime rien l'avoue, et le sens que mon âme, Souhaite votre aveu pour répondre à sa flamme, Mais hélas!
ie ſens bien qu’ayant dequoy charmer, Ie puis, en l’attendant commancer à l’aimer.	Ce sens bien qu'ayant dequoy charmer, Je puis, en l'attendant commencer à l'aimer.
Et i’apprens, quand ie cralns que mon cœur ne ſoûplre Qu'en amour ce qu’on craint eſt ce que l’on deſire.	Et j'apprends, quand je cralns que mon cœur ne souplère Qu'en amour ce qu'on craint est ce que l'on désire.
MELINTE.	MELINTE.
En vous voyant tous d’eux, i’auois dans voſtre cœur Connu, par vos regards, voſtre ſecrette ardeur;	En vous voyant tous d'eux, j'avais dans votre cœur Connu, par vos regards, votre secrète ardeur;
Gardez vous toutes fois, d’en faire trop paroiſtre;	Gardez vous toutes fois, d'en faire trop paraître;
Et faites s’il ſe peut qu’il n’en puiſe connoiſtre, Que ce qu’il en faudra pour le faire eſperer;	Et faites s'il se peut qu'il n'en puise connaître, Que ce qu'il en faudra pour le faire espérer;
Car bien que ſes vertus le faſſent admirer, Les hommes d’auiourd’huy, quelqu’ardeur qui les preſſs Veulent d’vne beauté meriter la tendreſſe;	Car bien que ses vertus le fassent admirer, Les hommes d'aujourd'hui, quelqu'ardeur qui les presss Veulent d'une beauté mériter la tendresse;
Et lors que l’on repond trop toſt à leurs ſouſpirs, Cette prompte victoire allentit leurs deſirs.	Et lors que l'on répond trop tôt à leurs soupirs, Cette prompte victoire allentit leurs désirs.
Ie croy, par ce conſeil, que c’eſt aſſez vous dire, Qu’auec plaiſir i’apprens que pour vous il ſouſpire, Comme il eſt fortement épris de vos attraits, Il nous ſeruira micux dedans noſtre procez;	Je crois, par ce conseil, que c'est assez vous dire, Qu'avec plaisir j'apprends que pour vous il soupire, Comme il est fortement épris de vos attraits, Il nous servira micux dedans notre procès;
Ie ne croy pourtant pas, quelque ardeur qui l’enflame Sa gencroſité moins grande que ſa flame, en ſe redreſſaut.	Je ne crois pourtant pas, quelque ardeur qui l'enflamme Sa gencrosité moins grande que sa flamme, en se redressaut.
Et.	Et.
Mais il vient.	Mais il vient.
Luciller	Luciller
LVCILLE.	LUCILE.
Hé bien ?	Hé bien ?
MELINTE.	MELINTE.
eu ſe redreſſaut entort.	eu se redressaut entort.
Songez à vous.	Songez à vous.
SCENE VI.	SCÈNE VI.
MELINTE, LVCILLE, THERSANDRE, ERGASTE, DAMIS.	MELINTE, LUCILLE, THÉRANDRE, ERGASTE, DAMIS.
THERSANDRE àE gaſti.	THÉRSANDRE à gâti.
J N cœur peut-il tenir contre des traits ſi doux.	 N cœur peut-il tenir contre des traits si doux.
LVCILLE, à ſa Mere.	LUCILE, à sa Mère.
Madame, croyez-vous, que toutes ces grimaces, Et que cẽt air contraint donnent beaucoup de graccy'	Madame, croyez-vous, que toutes ces grimaces, Et que cien air contraint donnent beaucoup de graccy'
MELINTE à Therſaudre.	MELINTE à Thersaudre.
Vous voyez que ie tiens tout ce que ie promets,	Vous voyez que personne tiens tout ce que je promets,
THERSANDRE.	THÉRSANDRE.
Par la de vos bontez, le connois les effets.	Par la de vos bontés, le connais les effets.
LVCILLE A part.	LUCILE A part.
Bien que i’ayme à le voir, le cœur me bat, ie tremble.	Bien que j'aime à le voir, le cœur me bat, Elle tremble.
THERSANDRE.	THÉRSANDRE.
Quand nous aurons diſné, nous fortirons enſemble, Et pour bien m’acquitter de ce que i’ay promis, I’iray ſolliciter, auec vous, mes amis.	Quand nous aurons dîné, nous sortirons ensemble, Et pour bien m'acquitter de ce que j'ai promis, J'irai solliciter, avec vous, mes amis.
LVCILLE.	LUCILE.
Cela ſe peut nommer ſeruir de bonne grace.	Cela se peut nommer servir de bonne grâce.
THERSANDRE.	THÉRSANDRE.
Ah!	Ah!
croyez qu’il n’eſt rien que pour vous ie ne faſſe.	croyez qu'il n'est rien que pour vous ie ne fasse.
MELINTE bas, à Lacille, eu ſe redreſſaut.	MELINTE bas, à Lacille, eu se redressaut.
Droite, Regardez-moy.	Droite, Regardez-moi.
LVCILLE, à part.	LUCILE, à part.
Qu'elle contrainte, 6 Dical	Qu'elle contrainte, 6 Dical
THERSANDRE.	THÉRSANDRE.
De peur des importuns, abandonnons ce licu;	De peur des importuns, abandonnons ce licu;
Nous ne pourons la haut eſtre veüs de perſonne,	Nous ne pourrons la hauts être veüs de personne,
MELINTHE.	MELINTHÉ.
C’eſt tout ce que ie veux, voſtre raiſon eſt bonne.	C'est tout ce que ici veux, votre raison est bonne.
THERSANDRE.	THÉRSANDRE.
Là de voſtre procez, nous pourons librement.	Là de votre procès, nous pourrons librement.
DAMIS.	DAMIS.
Montez-donc, car l’on va ſerulr dans vn moment.	Montez-donc, car l'on va sérulr dans un moment.
THERSANDRE, eu ſe retournaut.	THÉRSANDRE, eu se retournaut.
Des coureurs de repas, ſçauras tu me desfaire?	Des coureurs de repas, sauras tu me défaire?
DAMIS.	DAMIS.
Sans vous embaraſſer, Monſieur, l’aiſſez-moy faire.	Sans vous embarrasser, Monsieur, l'aissez-moi faire.
THERSANDRE.	THÉRSANDRE.
Ie t’en laiſſe le ſoin.	Je t'en laisse le soin.
SCENE VII.	SCÈNE VII.
DAMIS, ſeul.	DAMIS, seul.
IE vais ioüer vn tour, Dont on poura garder la memoire à la Cour.	JE vais ioüer un tour, Dont on pourra garder la mémoire à la Cour.
Ces beaux eſcoraifleurs qui vont icy paroiſtre, Ne ſe contentent pas de ruiner le maiſtre;	Ces beaux escoraifleurs qui vont ici paraître, Ne se contentent pas de ruiner le maître;
Ils font tort aux valets, & les font enrager, En ne leur laiſſant pas ſouuent dequoy manger.	Ils font tort aux valets, et les font enrager, En ne leur laissant pas souvent dequoy manger.
Il le faut auoüer, l’on eſt bien miſerable, Lors que l’on a pour maiſtre vn homme qui tient table Et l’on doit bien peſter contre les gens de Cour, Qui veulent, à diſné, manger pour tout le iour;	Il le faut auoüer, l'on est bien misérable, Lors que l'on a pour maître un homme qui tient table Et l'on doit bien pester contre les gens de Cour, Qui veulent, à dîné, manger pour tout le jour;
Cette mode me nuit, & ſouuent elle eſt cauſe, Que le vois auorter ce que ie me propoſe.	Cette mode me nuit, et souvent elle est cause, Que le vois auorter ce que ie me propose.
Dans ma chambre j’auois deux de mes amis hier, Et ie ne pûs iamais auoir vn plat entier, Ceux qui vintent, ayant ſuiuant leut deſtinée.	Dans ma chambre j'avais deux de mes amis hier, Et tu ne pus jamais avoir un plat entier, Ceux qui vintent, ayant suivant lut destinée.
Mange hier à diſné pour toute la iournéc.	Mange hier à dîné pour toute la iournéc.
Ie ne m’en plaindrois pas s’il nous laiſſoient en paix.	Je ne m'en plaindrais pas s'il nous laissaient en paix.
Mais ils font quereller officiers & valets, Il faut chercher leur gouſt, & non celuy du Maiſtre:	Mais ils font quereller officiers et valets, Il faut chercher leur goût, et non celui du Maître:
Mais quand meſme de tous, on le pouroit connoiſtre, Les ſatisferoit-on, s’il n’eſt point de ragouſts, Qui plaiſent à la fois à cent diferens gouts.	Mais quand même de tous, on le pourrait connaître, Les satisferait-on, s'il n'est point de ragoûts, Qui plaisent à la fois à cent diferents gouts.
Dans ce qu’vn ayme doux, l’autre veut de l’Eſpice.	Dans ce qu'un aime doux, l'autre veut de l'Espice.
SCENE VIII.	SCÈNE VIII.
DAMIS, ERGASTE.	DAMIS, ERGASTE.
ERGASTE.	ÉRGASTE.
Iies-moy, s’il vous plaiſt, iray-le dire au Suiſſe, L Qu'il r'ennoye tous ceux qui voudront voir Monſieur?	Jies-moi, s'il vous plaît, irai-le dire au Suisse, L 'il rennaie tous ceux qui voudront voir Monsieur?
DAMIS.	DAMIS.
Non, cat ie les veux voir.	Non, cat rendre les veux voir.
ERGASTE.	ÉRGASTE.
Mais.	Mais.
DAMIS.	DAMIS.
Hé quoy?	Hé quoi?
ERGASTE.	ÉRGASTE.
Que Monſicur ne me gronde.	Que Monsicur ne me gronde.
Mais i'ay peur	Mais j'ai peur
DAMIS.	DAMIS.
Ah!	Ah!
qu’on me laiſſe faire, Mais eſcoute, auec toy ie veux mener l’affaire;	qu'on me laisse faire, Mais écoute, avec toi Un veux mener l'affaire;
Tantoſt en querellant.	Tantôt en querellant.
Mais ie voy Clie mant, Pour m'en diuertir mieux ie le laiſſe vn moment.	Mais Elle vois Clie mant, Pour m'en divertir mieux ie le laisse un moment.
SCENE IX.	SCÈNE IX.
CLIDAMANT, ERGASTE.	CLIDAMANT, ERGASTE.
CLIDAMANT.	CLIDAMANT.
SEmuira-ronbien-toſt,	SEmuira-ronbien-tôt,
ERGASTE.	ÉRGASTE.
Ie n’en ſçay tien.	Je n'en sais tien.
CLIDAMANT.	CLIDAMANT.
Ie meur Si ie ne ſuis ſorty du Louvre à prés d’vnc heure, I’ay refuſé cent gens, qui vouloient m’entraiſner.	Je meur Si grande ne suis sorti du Louvre à près d'unc heure, J'ai refusé cent gens, qui voulaient m'entraîner.
Iugeant bien que ccans ie pourois micux diſner;	Jugeant bien que cécans ici pourrais micux dîner;
Mais ie ſuis bien ſurpris de n’y trouuer perſonnc.	Mais ie suis bien surpris de n'y trouver personnc.
ERGASTE.	ÉRGASTE.
Icy la compagnie eſt ſouuent aſſez bonne.	Ici la compagnie est souvent assez bonne.
Et.	Et.
mais ie vols quelqu’vn.	mais ici vols quelqu'vn.
SCENE X.	SCÈNE X.
CLIDAMANT, LEANDRE, ERGASTE.	CLIDAMANT, LÉANDRE, ERGASTE.
CLIDAMANT.	CLIDAMANT.
H!	H!
Comte, c’eſt donc toy?	Comte, c'est donc toi?
A t'on diſné ceans?	A t'-on dîné céans?
LEANDRE.	LÉANDRE.
CLIDAMANT.	CLIDAMANT.
Ta viens diſner ie croyt	Ta viens dîner On croit
Oüy ſans doute.	Oui sans doute.
LEANDRE,	LÉANDRE,
CLIDAMANT.	CLIDAMANT.
Tant mieux, nons diſnerons enſemble.	Tant mieux, nons dînerons ensemble.
ERGASTE, à part.	ÉRGASTE, à part.
Pour nous faire plaiſir la nobleſſe s’aſſemble.	Pour nous faire plaisir la noblesse s'assemble.
LEANDRE.	LÉANDRE.
Eſtant chez mes amis à l’heure du repas, Ie croirois les faſcher ſi ie n’y mangeois pas.	Étant chez mes amis à l'heure du repas, Je croirais les fâcher si ici n'y mangeais pas.
ERGASTE, àpart.	ERGASTE, àpart.
Allons trouuer d’Amis, car ic bruſſe d’apprendre, Ce que ie puis pour luy.	Allons trouver d'Amis, car ic brusse d'apprendre, Ce que je puis pour lui.
CLIDAMANT.	CLIDAMANT.
Que fit hier Leandre?	Que fit hier Léandre?
LEANDRE.	LÉANDRE.
Ie fus bier diſner chez vn de mes amis, Et mangeay d’vn potage aux oignons blancs farcus.	Je fus bier dîner chez un de mes amis, Et mangeai d'une potage aux oignons blancs sarcus.
CLIDAMANT.	CLIDAMANT.
Aux oignons blancs farcis!	Aux oignons blancs farcis!
peſte, il eſt admirablel Ten ap veur fauenteur.	peste, il est admirablel Ten ap eur faventeur.
LEANDRE.	LÉANDRE.
Il aymoit bien la table.	Il aimait bien la table.
CLIDAMANT.	CLIDAMANT.
Aux oignons blancs farcis!	Aux oignons blancs farcis!
LEANDRE.	LÉANDRE.
Tu les aymes ie croy?	Tu les aimes rien crois?
CLIDAMANT.	CLIDAMANT.
Ie puis bien les aymer, c’eſt vn manger de Roy.	Je puis bien les aimer, c'est un manger de Roi.
LEANDRE.	LÉANDRE.
Nous mangeaſmes encor certain canard ſauuage.	Nous mangeâmes encor certain canard sauvage.
Tout de bon.	Tout de bon.
CLIDAMANT.	CLIDAMANT.
Ouy.	Oui.
LEANDRE.	LÉANDRE.
CLIDAMANT.	CLIDAMANT.
Cela vaut mieux que le potage.	Cela vaut mieux que le potage.
LEANDRE.	LÉANDRE.
Tu Dieu, tu t’y connois, ils ſont tout à fait bons, Et l’on en trouue moins que l’on ne fait d’oignons.	Tu Dieu, tu t'y connais, ils sont tout à fait bons, Et l'on en trouve moins que l'on ne fait d'oignons.
CLIBAMANT.	CLIBAMANT.
Ie ne ſçay que trop bien, que l’on n'en trouue gueres,	Je ne sais que trop bien, que l'on n'en trouve guère,
LEANDRE.	LÉANDRE.
Vn homme ſeul en France a de ces canardieres, Ils luy viennent d’Holande.	Un homme seul en France a de ces canardières, Ils avait viennent d'Holande.
CLIDAMANT.	CLIDAMANT.
Ils ſont donc Holandois	Ils sont donc Holandais
LEANDRE.	LÉANDRE.
Oüy, mais en peu de temps, ils deuiennent François	Oui, mais en peu de temps, ils deviennent Français
CLIDAMANT.	CLIDAMANT.
Quand ils veulent venir, on les reçoit en Francet	Quand ils veulent venir, on les reçoit en Francet
oüy.	oui.
LEANDRE.	LÉANDRE.
CLIDAMANT.	CLIDAMANT.
Mais acheue moy ce diſné d’importance?	Mais achève moi ce dîné d'importance?
LEANDRE.	LÉANDRE.
Par des morceaux exquis le gouſt y fuſt flatié.	Par des morceaux exquis le goût y fût flattié.
Il y fuſt reueillé, chatouillé, delecté, Et pendant le repas, les plus friandes langucs Sur la bonté des mets firent mille harangues, Auec bien du plaiſir chacun les ſauoura, Auec eſtonnement chacun les admiraEt l’on fut moins ſurpris de la magnificence, Que de trouuer tant d’ordre auec tant d’abondance.	Il y fût réveillé, chatouillé, délecté, Et pendant le repas, les plus friandes langucs Sur la bonté des mets firent mille harangues, Avec bien du plaisir chacun les savoura, Avec étonnement chacun les admiraEt l'on fut moins surpris de la magnificence, Que de trouver tant d' a tant abondance.
Mais comme nous croyons voir ſinir ce repas, Nous viſmes tout à coup ſeruir de nouueaux plats, Tous remplis de ragouſts, à tel point delectables, Qu’on en ſert rarement ſur les meilleures tables.	Mais comme nous croyons voir sinir ce repas, Nous vîmes tout à coup servir de nouveaux plats, Tous remplis de ragoûts, à tel point délectables, Qu'on en sert rarement sur les meilleures tables.
Ce ſeruice nouucil ippetit excita, Ou pluſtoſt des ragouſts la ſaueur l’irrita;	Ce service nouvil ipétit excita, Ou plutôt des ragoûts la sauveur l'irrita;
Et ce friand repas nous fit aſſez connoiſtre, Qu’à traitter noſtre amy, deuoit eſtre vn grand Maiſtre Puiſque cent mets nouucaux, dont la bonté ſurprit, Firent naiſtre & mourir cent fois noſtre appetit.	Et ce friand repas nous fit assez connaître, Qu'à traiter notre ami, devait être grand Maître Puisque cent mets nouucaux, dont la bonté surprit, Firent naître et mourir cent fois notre appétit.
CLIDAMANT.	CLIDAMANT.
Les vins delicieux furent de la partie?	Les vins délicieux furent de la partie?
LEANDRE.	LÉANDRE.
Nous en buſmes de bon de la coſte roſtie, Et nous euſmes encor de pluſieurs autres vins, A qui l’on peut donner le ſurnom de diuins;	Nous en bûmes de bon de la côte rôtie, Et nous eûmes encor de plusieurs autres vins, À qui l'on peut donner le surnom de divins;
Mais des vins, ah!	Mais des vins, ah!
des vins;	des vins;
mais des vins agreables, Piquants, & delicats;	mais des vins agréables, Piquants, et délicats;
puiſſans & delectables.	puissants et délectables.
CLIDAMANT.	CLIDAMANT.
De chacun de ces vins dirois-tubien le nom?	De chacun de ces vins dirais-tubien le nom?
LEANDRE.	LÉANDRE.
Oüy-da, De Saint Laurent, d’Ays, & de Maſcon, De Saint Meſmin, d’Arbois, de Reim, de l’Hermitage.	Oui-dà, De Saint Laurent, d'Ais, et de Mascon, De Saint Mesmin, d'Arbois, de Reim, de l'Hermitage.
CLIDAMANT.	CLIDAMANT.
Tous ces vins valent mieux que ton canard ſauuage	Tous ces vins valent mieux que ton canard sauvage
LEANDRE.	LÉANDRE.
Ie ne croy pas qu’on puiſſe en boire de meilleurs, Enſuitte on nous donna quantité de liqueurs, L’on but d’vn hypocras;	Je ne crois pas qu'on puisse en boire de meilleurs, Ensuite on nous donna quantité de liqueurs, L'on but d'un hypocras;
mais dont le muſc & l’ambr Par leur ſubtile odeur parfumerent la chambre;	mais dont le musc et l'ambr Par leur subtile odeur parfumèrent la chambre;
Mais quoy par ce ſouris voudrois-tu le nier?	Mais quoi par ce souris voudrais-tu le nier?
CLIDAMANT.	CLIDAMANT.
e croy qu’il eſtoit bon s’il eſtoit de Renier, ians cela peuth.	Je crois qu'il était bon s'il était de Renier, ians cela peuth.
LEANDRE.	LÉANDRE.
Marquis il en eſtoit ſans doute, Et du meilleur qu’il cuſt.	Marquis il en était sans doute, Et du meilleur qu'il cût.
CLIDAMANT.	CLIDAMANT.
Il ſe peut.	Il se peut.
LEANDRE.	LÉANDRE.
Le vin d’Eſpagne eſtoit.	Le vin d'Espagne était.
Mais écoute.	Mais écoute.
CLIDAMANT.	CLIDAMANT.
Choiſi chez Boueingo.	Choisi chez Boueingo.
LEANDRE.	LÉANDRE.
On l’auoit fait venir exprez de Saint MaloIl eſtoit naturel, & ie croy que.	On l'avait fait venir exprez de Saint MaloIl était naturel, et ie croy que.
CLIDAMANT.	CLIDAMANT.
Mais Comte, Ne vois-ie pas Valere, auec le icune Oronte?	Mais Comte, Ne vois-je pas Valère, avec le icune Oronte?
SCENE XI.	SCÈNE XI.
CLIDAMANT, LEANDRE, VALERE, ORONTE.	CLIDAMANT, LÉANDRE, VALÈRE, ORONTE.
CLIDAMANT, à Vauire.	CLIDAMANT, à Vavire.
H!	H!
c’eſt donc toy, Marquis,	c'est donc toi, Marquis,
LEANDRE, A Oronte.	LÉANDRE, A Ronte.
Cheualier, c’eſt donc toy?	Chevalier, c'est donc toi?
Oüy.	Oui.
ORONTE.	ORONTE.
VALERE.	VALÈRE.
Pour diſner ceans, ie l’ameine auec moy;	Pour dîner céans, ie l'amène avec moi;
Cert es à l’entraiſner, i’ay bien eu de la peine, Ce icune Cheualier à l’humeur vn peu vaine, Et ne ſe peut laſſer de parler contre ceux, Qui, ſans eſtre priez, mangent hors de chez eux.	Cert es à l'entraîner, j'ai bien eu de la peine, Ce icune Chevalier à l'humeur un peu vaine, Et ne se peut lasser de parler contre ceux, Qui, sans être priez, mangent hors de chez eux.
Mais dequoy parliez-vous ne le peut-on apprendre?	Mais dequoy parliez-vous ne le peut-on apprendre?
CLIDAMANT.	CLIDAMANT.
Nous parlions d’vn repas que fit hier Leandre.	Nous parlions d'Hommes repas que fit hier Léandre.
VALERE.	VALÈRE.
Mais encor eſtiez-vous ſur des ragouſts nouueaux?	Mais encor étiez-vous sur des ragoûts nouueaux?
ORONTE.	ORONTE.
Clidamant s’entretient touſiours de bons morccaux,	Clidamant s'entretient toujours de bons morccaux,
CLIDAMANT.	CLIDAMANT.
Comme toy Cheualier, ie n’y ſuis pas Nouice, Tu connois la Becaſſe.	Comme toi Chevalier, je n'y suis pas Novice, Tu connais la Bécasse.
& tu ſçais que la cuiſſe En eſt le bon morceau;	et tu sais que la cuisse En est le bon morceau;
ependant, l’autre iour, Tu fis rire de toy quelques gens de la Cour;	eupendant, l'autre jour, Tu fis rire de toi quelques gens de la Cour;
B iij Quand, par vne façon de ſeruir blen nouuelle, Loin d’en ſeruir la cuiſſe, on t’en vit ſeruir l’aiſſe.	 Bij Quand, par une façon de servir blen nouvelle, Loin d'en servir la cuisse, on t'en vit servir l'aisse.
ORONTE.	ORONTE.
Ne diſois-Je pas bien, tu ſçals les bons morceaux.	Ne disais-Je pas bien, tu sçals les bons morceaux.
LEANDRE.	LÉANDRE.
Tu pourrois dire encor, qu’il ſçait les bons Coſteaux, A.	Tu pourrais dire encor, qu'il sait les bons Costeaux, A.
VALERE, Sa delicateſſe en tout eſt incroyable.	VALÈRE, Sa délicatesse en tout est incroyable.
ORONTE.	ORONTE.
Quand ton gouſt trouncroit vn cocq dainde admi rable, Tu le deſauoücrois, eſt-il pas vray Marquis?	Quand ton goût trouncrait un cocq dainde admi rable, Tu le desauoücrois, est-il pas vrai Marquis?
CLIDAMANT.	CLIDAMANT.
Mon gouſt ne connoiſt rien que des morceaux exquls, Et s’il ozoit vouloir de ſemblables viandes.	Mon goût ne connaît rien que des morceaux exquls, Et s'ils ozait vouloir de semblables viandes.
LEANDRE.	LÉANDRE.
Ces morceaux ſcroient bons pour des langues friandez Valere, qu’en dis-tu?	Ces morceaux scraient bons pour des langues friandés Valère, qu'en dis-tu?
VALERE.	VALÈRE.
Rien, ſinon que ie crois, Que les cocqy daindes ſont des ortolans Bourgeois.	Rien, sinon que ainsi crois, Que les coci daindes sont des ortolans Bourgeois.
CLIDAMANT.	CLIDAMANT.
Ce ſont des ortolans, où l’on a dequoy mordre.	Ce sont des ortolans, où l'on a dequoy mordre.
LEANDRE.	LÉANDRE.
Les Bourgeois ſculement qui ſont du dernier ordre, En mangent aujourd’huy.	Les Bourgeois sculement qui sont du dernier ordre, En mangent aujourd'hui.
ORONTE.	ORONTE.
Vous eſtes delicats, Et de ſi gros morceaux ne vous nouriroient pas.	Vous êtes délicats, Et de si gros morceaux ne vous nouriraient pas.
VALERE.	VALÈRE.
Les gens qui comme nous mangent aux bonnes tables N’entendent point parler de viandes ſemblables.	Les gens qui comme nous mangent aux bonnes tables N'entendent point parler de viandes semblables.
CLIDAMANT.	CLIDAMANT.
Ie ſçay comme on y ſert:	Je sais comme on y sert:
LEANDRE.	LÉANDRE.
Tu le ſçays?	Tu le sçays?
VALERE.	VALÈRE.
Ie le croy.	Je le crois.
LEANDRE.	LÉANDRE.
Vorons s’il le ſçait bien.	Vorons s'il le sait bien.
CLIDAMANT.	CLIDAMANT.
Ie le veux par ma foy.	Je le veux par ma foi.
Ariſton?	Ariston?
LEANDRE.	LÉANDRE.
Et de Liſandre?	Et de Lisandre?
VALERE.	VALÈRE.
CLIDAMANT.	CLIDAMANT.
D'Ariſton la table eſt raiſonnable.	D'Ariston la table est raisonnable.
CLIDAMANT.	CLIDAMANT.
Elle eſt tout à fait pitoyable.	Elle est tout à fait pitoyable.
Et de Criſpe?	Et de Crispe?
LEANDRE.	LÉANDRE.
ORONTE.	ORONTE.
Peut on ignorer ſon grepas.	Peut on ignorer son grepas.
CLIDAMANT.	CLIDAMANT.
Celuy-là tenoit table, & ne la tenoit pas;	Celui-là tenait table, et ne la tenait pas;
uoy qu’il traitaſt fortbien, il ſe donnoit au Diable, Qu’il n’auoit iamais eu deſſein de tenir table.	Uo qu’il traitât fortbien, il se donnait au Diable, Qu'il n'avait jamais eu dessein de tenir table.
Bien qu’aux honneſtes gens ſon logis fut ouuert, L’on ne trouuoit chez luy iamais plus d’vn couuerts Sa table, cependant, eſtoit tout à fait bonnc.	Bien qu'aux honnêtes gens son logis fut ouvert, L'on ne trouvait chez lui jours plus d'un couverts Sa table, cependant, était tout à fait bonnc.
chacun y mangeoit, ſans qu’il priaſt perſonne.	chacun y mangeait, sans qu'il priât personne.
Ckonimer VALERE.	Ckonimer VALÈRE.
CLIDAMANT.	CLIDAMANT.
On void peu chez luy de perdreaux:	On voit peu chez homme de perdreaux:
I n’en mange lamais alors qu’ils ſont nouueaux;	I n'en mange lamais alors qu'ils sont nouveaux;
il hait ceux de campagne, & n’en veut que de villt!	il hait ceux de campagne, et n'en veut que de villt!
amais en bons morceaux lieu ne fut ſi ſterile.	amais en bons morceaux lieu ne fut si stérile.
B iij	 Bijà
LEANDRE.	LÉANDRE.
Et des pois verds, nouuenex, en mange-t’ilt	Et des pois verds, nouvenex, en mange-t-ilt
CLIDAMANT.	CLIDAMANT.
Luy, bon, Il n’en mange jamais, qu’à cinq ſols le litron.	Lui, bon, Il n'en mange jamais, qu'à cinq sols le litron.
ORONTE.	ORONTE.
Les nouucautez chez-luy n’eſtans pas en vſage:	Les nouucautez chez-lui n'étants pas en usage:
Par la, mon cher Marquis, il fait voir qu’il eſt ſage.	Par la, mon cher Marquis, il fait voir qu'il est sage.
CLIDAMANE.	CLIDAMANE.
Ceux qui les mangent chers paſſent donc pour des ſous.	Ceux qui les mangent chers passent donc pour des sous.
ORONTE.	ORONTE.
Ie croy qu’ils valent moins à cent francs qu’à cinq ſous Les pois precipitez naiſent de pourriture, Et l’art les fait venit plaſtoſt que la nature.	Je crois qu'ils valent moins à cent francs qu'à cinq sous Les pois précipités naisent de pourriture, Et l'art les fait venit plastost que la nature.
CLIDAMANT.	CLIDAMANT.
D'euſſent-ils dans mon corps ſe pourir mille fois, Ie pretens en manger auant tous les Bourgeois.	D'eussent-ils dans mon corps se pourir mille fois, Je prétends en manger avant tous les Bourgeois.
ORONTE.	ORONTE.
Les repas de grand prix, ſont bien plus agreables, Et la cherté des mets les rend plus delectables,	Les repas de grand prix, sont bien plus agréables, Et la cherté des mets les rend plus délectables,
VALERE.	VALÈRE.
A ce plaiſant diſcours, que reſpons-tu Marquis?	À ce plaisant discours, que réponds-tu Marquis?
CLIDAMANT.	CLIDAMANT.
Que ie ne veux iamais diſner à iuſte prix.	Que ici ne veux jamais dîner à juste prix.
LEANDRE.	LÉANDRE.
Voila d’vn vray Marquis le parfait caractere.	Voilà d'un vrai Marquis le parfait caractère.
CLIDAMANT.	CLIDAMANT.
Pour le bien ſouſtenir, ie fais touſiours grand chere.	Pour le bien soutenir, On fais toujours grand chère.
ORONTE.	ORONTE.
Tu la fais, il eſt vray, ſans deſpencer ton bien.	Tu la fais, il est vrai, sans dépenser ton bien.
CLIDAMANT.	CLIDAMANT.
L’on a double plaiſir quand on diſne pour rien, Tous ceux chez qui ie mange ont vne ioye extrême, Par là ie les oblige, & m’oblige moy-meſme.	L'on a double plaisir quand on dîne pour rien, Tous ceux chez qui ie mange ont une joie extrême, Par là -même les oblige, et m'oblige moi-même.
LEANDRE.	LÉANDRE.
Megaſte traitte mieux que tous ceux d’auiourd'huy.	Mégaste traite mieux que tous ceux d'aujourd'hui.
CLIDAMANT.	CLIDAMANT.
Oüy, mais les gens d’eſprit ne mangent point chez Ei¬;	Oui, mais les gens d'esprit ne mangent point chez Ei¬;
VALERE.	VALÈRE.
De Filante à bon droit, la table eſt eſtimée.	De Filante à bon droit, la table est estimée.
I'y mangcay, l’autre iour, d’vne ſauce gommée Auecque des dindons.	J'y mangcai, l'autre jour, d'une sauce gommée Avec des dindons.
CLIDAMANT.	CLIDAMANT.
D'où?	D'où?
VALERE.	VALÈRE.
Du Pré ſaint Geruais.	Du Pré saint Gervais.
CLIDAMANT.	CLIDAMANT.
Ah!	Ah!
que n’eſtois-je là, ie n'en trouue iamais.	que n'étais-je là, une n'en trouve jamais.
LEANDRE.	LÉANDRE.
Chez Clearque dit-on, la table eſt ſans pareilley	Chez Cléparque dit-on, la table est sans pareillei
CLIDAMANT.	CLIDAMANT.
Chacun void ſonbuffet ainſi qu'vne merueille, Son linge eſt admirable, il traitte proprement.	Chacun voi sonbuffet ainsi qu'une merveille, Son linge est admirable, il traite proprement.
Mais le diſné contraint de manger ſobrement.	Mais le dîné contraint de manger sobrement.
VALERE.	VALÈRE.
Ormain, traitte-t’il bien?	Ormain, traite-t-il bien?
CLIDAMANT.	CLIDAMANT.
De tres mauuaiſe grace, Et les chappons, chez luy, ſentent fort la bẽcaſſe.	De très mauvaise grâce, Et les chapons, chez Seigneur, sentent fort la biencasse.
VALERE.	VALÈRE.
Ie le croy, Mais parlons du fameux Arimant.	Je le crois, Mais parlons du fameux Arimant.
CLIDAMANT.	CLIDAMANT.
L’on mange & boit chez luy delicieuſement.	L'on mange et boit chez Seigneur délicieusement.
Il a bion du merite.	Il a bion du mérite.
VALERE.	VALÈRE.
ORONTE.	ORONTE.
Il veut auoir des Gardes, Qui puiſſent ſe dit-I à coups de hallebardes, Chaſſer ceux qui chez luy viennent ſouuent diſner, Ayans aſſez de bien pour en pouuoir donner.	Il veut avoir des Gardes, Qui puissent se dit-Y à coups de hallebardes, Chasser ceux qui chez jour viennent souvent dîner, Ayants assez de bien pour en pouvoir donner.
ORONTE.	ORONTE.
Mais écouſte Marquis, ſçais-tu bien que Therſandre, Pout te mettre dehors auroit raiſon d’en prendre, Que chacun dit tout haut, que tu fais aſſez mal, De venir ſi ſouuent manger chez ton riual, Et que t’on procedé qu’on peut nommer étrange.	Mais écoute Marquis, sais-tu bien que Thersandre, Pout te mettre dehors aurait raison d'en prendre, Que chacun dit tout haut, que tu fais assez mal, De venir si souvent manger chez ton rival, Et que t'on procédé qu'on peut nommer étrange.
CLIDAMANT.	CLIDAMANT.
Puis qu’il eſt mon riual, il faut que ie le mange, Et ie ne trouue pas qu’on s’en doiue eſtonner.	Puis qu'il est mon rival, il faut que sans le mange, Et personne ne trouve pas qu'on s'en doive étonner.
VALERE.	VALÈRE.
Mais i’apperçois Damis.	Mais j'aperçois Damis.
SCENE XII.	SCÈNE XII.
CLIDAMANT, ORONTE, VALERE, LEANDRE, DAMIS.	CLIDAMANT, ORONTE, VALÈRE, LÉANDRE, DAMIS.
HEbieni n l'on diface?	HÉ bien n'on diace?
DAMIS.	DAMIS.
Ie ne le puis ſçauoir, car ie viens de la ville.	Je ne le puis savoir, car ainsi viens de la ville.
LEANDRE.	LÉANDRE.
Ie ſens déja la faim qui m’eſchauffe la bille.	Je sens déjà la faim qui m'échauffe la bille.
VALERE.	VALÈRE.
Depuis long-temps Therſandre, eſt de mes grand amis.	Depuis longtemps Thersandre, est de mes grand amis.
C’eſt va homme d’honneur, & le croy que Damis.	C'est va homme d'honneur, et le crois que Damis.
CLIDAMANT.	CLIDAMANT.
Ma foy ſon Cuiſinier eſt vn homme admlrable, Et dedans ſon meſtier il eſt incomparable:	Ma foi son Cuisinier est un homme admlrable, Et dedans son métier il est incomparable:
Peſte qu’il entend bien à faire vn bon ragouſt,	Peste qu'il entend bien à faire un bon ragoût,
ORONTE.	ORONTE.
Il doit bien trauailler s’il contente ton gouſt.	Il doit bien travailler s'il contente ton goût.
DAMIS.	DAMIS.
Ie ſuis rauy de voir ſi bonne compagnic.	Je suis ravi de voir si bonne compagnic.
Auiourd'huy ſa cuiſine eſt aſſez bien garnie, Les ragouſts qu’il fera ne vous deſplairont pas, Et vous ne vous pourrez plaindre de ce repas.	Aujourd'hui sa cuisine est assez bien garnie, Les ragoûts qu'il fera ne vous déplairont pas, Et vous ne vous pourrez plaindre de ce repas.
CLIDAMANT.	CLIDAMANT.
Appreſtons nous Meſſieurs à faire bonne chere.	Apprêtons nous Messieurs à faire bonne chère.
DAMIS leprauiir vηà pat.	DAMIS lepraviir vηà pat.
Il faut bien-toſt tirer le plaiſir que i'eſpere.	Il faut bientôt tirer le plaisir que j'espère.
Adicu ie m’en vais voir ou le diſner en eſt.	Adicu autre m'en vais voir ou le dîner en est.
VALERE.	VALÈRE.
Tu nous aduertiras ſi-toſt qu’il ſera preſt.	Tu nous avertiras sitôt qu'il sera prêt.
SCENE XIII.	SCÈNE XIII.
CLIDAMANT, LEANDRE, VALERE, ORONTE.	CLIDAMANT, LÉANDRE, VALÈRE, ORONTE.
LEANDRE.	LÉANDRE.
E croy qu’en eſtimant la Table de Therſandre, I'Et celle de Leonte, on ne peut ſe meſprendre.	E crois qu'en estimant la Table de Thersandre, J'Et celle de Léonte, on ne peut se méprendre.
Ceſtm Coſteu, VALERE.	Cestm Côteu, VALÈRE.
ORONTE.	ORONTE.
Marquis qui ſont donc ces Coſteau	Marquis qui sont donc ces Costeau
VALERE.	VALÈRE.
Ce font gens deficats aimans les bons morceaux, Et qui les connoiſſans, ont par experiance, Le gouſt le plus certain & le meilleur de France.	Ce font gens déficats aimants les bons morceaux, Et qui les connaissants, ont par expériance, Le goût le plus certain et le meilleur de France.
Des friands d’auiourd’huy, c’eſt l’eſlite & la fleur, En voyant du gibier, ils diſent à l’odeur, De quel païs il vient.	Des friands d'aujourd'hui, c'est l'élite et la fleur, En voyant du gibier, ils disent à l'odeur, De quel pays il vient.
Ces hommes admirables;	Ces hommes admirables;
Ces palets delicats, ces vrais amis des Tables, Et qu’on en peut nommer les dignes ſouuerains Sçauent tous les Coſteaux ou croiſſent les bons vins, Et leur gouſt leur ayant acquis cette ſcience, Du grand nom de Coſteaux on les appelle en France,	Ces palets délicats, ces vrais amis des Tables, Et qu'on en peut nommer les dignes souverains Savent tous les Costeaux ou croissent les bons vins, Et leur goût leur ayant acquis cette science, Du grand nom de Costeaux on les appelle en France,
CLIDAMANT.	CLIDAMANT.
Si l’on donne ce nom à tous les delicats, Qui ſçauent auec art gouſter les bons repas, Le nombre enſcra grand.	Si l'on donne ce nom à tous les délicats, Qui savent a pt goûter les bons repas, Le nombre enscra grand.
LEANDRE.	LÉANDRE.
Oüy, ſans doute.	Oui, sans doute.
ORONTE.	ORONTE.
Mais ComeVous auiez commancé de parler de Leonte.	Mais ComeVous aviez commencé de parler de Léonte.
CLIDAMANT.	CLIDAMANT.
Leonte eſt honneſte homme, on diſne bien chez luy, Eſt c’eſt le plus friand des friands d’auiourd' huy:	Léonte est honnête homme, on dîne bien chez lui, Est c'est le plus friand des friands d'aujourd' hui:
C’eſt vn homme d’honneur, va homme raiſonnable Et de qui le cœur eſt auſſi grand que la table.	C'est un homme d'honneur, va homme raisonnable Et de qui le cœur est aussi grand que la table.
Il ſçait certain moulin, où l’on prend des Pigeons;	Il sait certain moulin, où l'on prend des Pigeons;
Mais ce ſont des Pigeons, des Pigeons, mais ſi bons, Que dans toute la Prance, ils n’ont point de ſemblable Et qu’aux plus frians mets, ie les croy preferabless Il connoiſt les fermiersoù ſont les bons poulcts, Et s’il eſtoit trahy par meſſieurs ſes valets, Illeur feroit paſſer de bien meſchantes heures.	Mais ce sont des Pigeons, des Pigeons, mais si bons, Que dans toute la Préance, ils n'ont point de semblable Et qu'aux plus friants mets, je les crois préférabless Il connaît les fermiersoù sont les bons poulcts, Et s'il était trahi par messieurs ses valets, Illeur ferait passer de bien méchantes heures.
1112 Il ſçait de quel quartier les Perdris ſont meilleures, Et vous dira d’abord, comme il a le gouſt fin, 25 Si telle eſt de Complegne, ou bien de ſaint Germain.	1112 Il sait de quel quartier les Perdris sont meilleures, Et vous dira d'abord, comme il a le goût fin, 25 Si telle est de Complegne, ou bien de saint Germain.
LEANDRE.	LÉANDRE.
Qu’il à l’eſprit profond.	Qu'il à l'esprit profond.
VALERE.	VALÈRE.
Qu’il eſt couuert de gloire.	Qu'il est couvert de gloire.
CLIDAMANT.	CLIDAMANT.
Il ne ſçait ce que c’eſt que de viande noire;	Il ne sait ce que c'est que de viande noire;
Comme elle n’eſt pas ſaine il n’en veut iamais voir.	Comme elle n'est pas saine il n'en veut jamais voir.
Et ſes gens ſur ce point, font fort bien leur deuoir.	Et ses gens sur ce point, font fort bien leur devoir.
Ce n’eſt pas tout encor.	Ce n'est pas tout encor.
Cét homme incomparable, Qui ſçait ſi bien ioüir des plaiſirs de la Table, Va, pour gouſter les vins, luy meſme en tous les lieux Où l’on en peut trouuer des plus delicieux;	Cet homme incomparable, Qui sais si bien jouir des plaisirs de la Table, Va, pour goûter les vins, lui -même en tous les lieux Où l'on en peut trouver des plus délicieux;
Et puis par des bontez qui n’ont point de pareillęs aait en la preienee empuir force bouteilles, Les met dans ſon caroſſe, & d’vn air tout ioyeux Conduit à ſon logis ce bucin precieux.	Et puis par des bontés qui n'ont point de pareillęs aait en la preienee empuir force bouteilles, Les met dans son carrosse, et d'Un air tout joyeux Conduit à son logis ce bucin précieux.
VALERE.	VALÈRE.
D'y voir ſouuent Damon, c’eſt à tort qu’on s’eſtonne.	D'y voir souvent Damon, c'est à tort qu'on s'étonne.
Il ne doit pas quitter vne Table ſi bonnc.	Il ne doit pas quitter une Table si bonnc.
LEANDRE.	LÉANDRE.
Crois qu’il n’en fera riens puis qu’il eſt de ces gens Qui ne mangent chez eux qu’vne fois en dix ans, E qui iamais enfin ne concurent l’enuie De donner vn repas vne fois en leur vie.	Crois qu'il n'en fera riens puis qu'il est de ces gens Qui ne mangent chez eux qu'une fois en dix ans, E qui jamais enfin ne conçurent l'envie De donner un repas une fois en leur vie.
CLIDAMANT.	CLIDAMANT.
Pour Timante il en donne & meſme de grand cœur;	Pour Timante il en donne et même de grand cœur;
Mais il priſe ſa Table auecque trop d’ardeur, Et fait connoiſtre aſſez qu’il à l’eſprit malade, En loüant tout chez luy iuſques à la ſalade.	Mais il prise sa Table auecque trop d'ardeur, Et fait connaître assez qu'il à l'esprit malade, En louant tout chez lui jusqu' à la salade.
ORONTE.	ORONTE.
Quoy traitter ainſi ceux dont vous mangez le bien Rougiſſez vne fois d’vn pareil entretien, Faraſites d'honneur, qui dans la France entiere.	Quoi traiter ainsi ceux dont vous mangez le bien Rougissez une fois d'un pareil entretien, Farites d'honneur, qui dans la France entière.
Ne trouuez pas aſſez dequoy vous ſatisfaire.	Ne trouvez pas assez dequoy vous satisfaire.
Il n’eſt que deux Coſteaux dont vous aymiez le vin:	Il n'est que deux Costeaux dont vous aimiez le vin:
D'vn endroit ſculement vous eſtimez le pain;	D'un endroit sculement vous estimez le pain;
D'vn tel ce ſont les fruits, d’vn autre la viande:	D'un tel ce sont les fruits, d'un autre la viande:
Voſtre delicateſſe en toute choſe eſt grande;	Votre délicatesse en toute chose est grande;
Mais vous deuriez ſçauoir que dedans vn repas, L’on ne doit point blaſmer ce qu’on ne paye pas:	Mais vous devriez sçauoir que dedans un repas, L'on ne doit point blâmer ce qu'on ne paye pas:
Que de ceux où l’on mange on ne doit point medire, Et que c’eſt mal agir d’en faire vne ſatire.	Que de ceux où l'on mange on ne doit point médire, Et que c'est mal agir d'en faire une satire.
Cependant vos diſcours me font paroiſtre aſſez Que parlà, ſeulement, vous les recompenſez;	Cependant vos discours me font paraître assez Que parlà, seulement, vous les récompensez;
Mais pourquoy mal parler des gens qu’on voit paroiſtre Et chez qui dés ce ſoir vous mangerez peut eſtre?	Mais pourquoi mal parler des gens qu'on voit paraître Et chez qui dès ce soir vous mangerez peut être?
Hé faut-il de parbieu qu’apres tant de repas.	Hé faut-il de parbieu qu'après tant de repas.
CLIDAMANT.	CLIDAMANT.
Iure-donc tout a fait ou bien ne iure-pas;	Jure-donc tout a fait ou bien ne jure-pas;
Quand on iure à demy l’on à mauuaiſe grace, Et chacun connoiſt bien que ce n'eſt que grimace.	Quand on jure à demi l'on à mauvaise grâce, Et chacun connaît bien que ce n'est que grimace.
Puiſque loins défrayer, I’on fait ſouuent pitié Lors que d’vn lurement on coupe la moicié:	Puisque loins défrayer, J'on fait souvent pitié Lors que d'un lurement on coupe la moicié:
Cela fait toct aux mots, & gaſte noſtre languc.	Cela fait toujours aux mots, et gâte notre languc.
ORONTE.	ORONTE.
En te remerciant de ta belle harangue.	En te remerciant de ta belle harangue.
LEANDRÉ.	LÉANDRE.
Mais perſonne ne vient, il eſt temps de diner.	Mais personne ne vient, il est temps de dîner.
VALERE.	VALÈRE.
A la fin tout cecy commence à m’eſtonner,	À la fin tout ceci commence à m'étonner,
CLIDAMANT.	CLIDAMANT.
C long retardement cache quelque myſtere.	Ç long retardement cache quelque mystère.
VALERE.	VALÈRE.
Sçachez qu'vn diner maigre eſt bien long cempaà calte,	Sachez qu'Han dîner maigre est bien long cempaà calte,
CLIBAMANT.	CLIBAMANT.
Il eſt maigre, la peſte.	Il est maigre, la peste.
ORONTE.	ORONTE.
Ayme-tu Ie Poiſſon,	Aime-tu Je Poisson,
CLIDAMANT.	CLIDAMANT.
En me voyant faſché tu peux iuger que non	En me voyant fâché tu peux juger que non
VALERE.	VALÈRE.
Moyraym le imbot	Moiraim le imbot
LEANDRE.	LÉANDRE.
Moy i’ayme la Baibos,	Moi j'aime la Baibos,
CLIDAMANT.	CLIDAMANT.
Sans donte Cheualier tu tiens pour la Moluë, Auecque le Cocq-dainde, on peut l’appareiller,	Sans donc Chevalier tu tiens pour la Molue, Auecque le Cocquedainde, on peut l'appareiller,
VALERE.	VALÈRE.
Auec bien de l’eſprit Clidamant ſçait railler.	Avec bien de l'esprit Clidamant Sait railler.
SCENE XIV.	SCÈNE XIV.
CLIDAMANT, VALERE, LEANDRE.	CLIDAMANT, VALÈRE, LÉANDRE.
ORONTE, DAMIS, ERGASTE.	ORONTE, DAMIS, ERGASTE.
ERGASTE en fuyant deuant Damis.	ERGASTE en fuyant devant Damis.
VOus me bartre.	VOus me bartre.
DAMIS.	DAMIS.
I'en ay le pouuoir de Therſandre.	J'en ai le pouvoir de Thersandre.
CLIDAMANT en arreſtant Damis.	CLIDAMANT en arrêtant Damis.
Qu’à fait ce mal-heureux ne le peut-on apprendre?	Qu'a fait ce malheureux ne le peut-on apprendre?
DAMIS.	DAMIS.
Ie veux le chaſtier & meſme deuant vous.	Je veux le châtier et même devant vous.
LEANDRE.	LÉANDRE.
Pardonne-luy de grace.	Pardonne-lui de grâce.
VALERE.	VALÈRE.
Et pour l’amour de nous	Et pour l'amour de nous
DAMIS.	DAMIS.
Non, ſa faute eſt trop grande, & n'eſt pas pardonnabl Illuy doune vu coup.	Non, sa faute est trop grande, et n'est pas pardonnabl Illui doune vu coup.
Afaut -.	Afaut -.
Ah!	Ah!
ERGASTE.	ÉRGASTE.
ORONTE.	ORONTE.
Que t’a fait ce pauure miſerable?	Que t'a fait ce pauvre misérable?
VALERE.	VALÈRE.
Quoy Damis, deuant-nous le mal-traitter ainſi!	Quoi Damis, devant-nous le mal-traitter ainsi!
DAMIS.	DAMIS.
Si vous luy pardonnez le luy pardonne auſſi.	Si vous y pardonnez le vôtre pardonne aussi.
ERGASTE.	ÉRGASTE.
Si i’auois à deſſein	Si j'avais à dessein
DAMIS.	DAMIS.
N’échauffe pas ma bille.	N'échauffe pas ma bille.
Lors que vous m’auez veu reuenir de ia ville, L’on ne m’auoit pas dit que l’on auoit diné Imme diatement apres midy ſonné.	Lors que vous m'avez vu revenir de ja ville, L'on ne m'avait pas dit que l'on avait diné Imme diatement après midi sonné.
Comme aucc quelques gens Therſandre auoit affaire.	Comme aucc quelques gens Thersandre avait affaire.
Il a voulu manger pluſtoſt qu’à l’ordinaire;	Il a voulu manger plutôt qu'à l'ordinaire;
Ce traiſtre eſtoit chargé de vous en aduertir Et.	Ce traître était chargé de vous en avertir Et.
ERGASTE.	ÉRGASTE.
I’auois oublié.	J'avais oublié.
DAMIS.	DAMIS.
Ta m'oſes reparcis.	Ta m'oses réparcis.
Diſ-tu vray?	Dis-tu vrai?
LEANDRE.	LÉANDRE.
DAMIS.	DAMIS.
Tout cela n'eſt que trop veritable.	Tout cela n'est que trop véritable.
ORONTE, à part.	ORONTE, à part.
Qu'iriontiaipimtantrois.	Qu'iriontiaipimtantrais.
VALERE.	VALÈRE.
La choſe eſt vray ſemblable.	La chose est vrai semblable.
CLIDAMANT.	CLIDAMANT.
Ce boureau de Valet nous a ioüé ce tour?	Ce boureau de Valet nous a joué ce tour?
DAMIS.	DAMIS.
Vous le voyez Monſieur, c’eſt vn Laquais de Cour, Le meilleur n’en vaut rien.	Vous le voyez Monsieur, c'est un Laquais de Cour, Le meilleur n'en vaut rien.
CLIDAMANT.	CLIDAMANT.
Nous von anm jouez.	Nous von anm jouez.
Par vn tel perſonnage	Par un tel personnage
DAMIS.	DAMIS.
De bon cœur i’en enrage.	De bon cœur j'en enrage.
Et ſi de mon depit vous ſçauiez la moitié Ieut-eſtre aurois-ie part dedans voſtre amitié.	Et si de mon dépit vous saviez la moitié Jeut-être aurais-je part dedans votre amitié.
à Ergaſte.	à Érgaste.
Sors de deuant mes yeux, où ma iuſte colere.	Sors de devant mes yeux, où ma juste colère.
Ergaſte ſort.	Ergaste sort.
CLIDAMANT.	CLIDAMANT.
Ton amitié Damis me paroiſt bien ſincere.	Ton amitié Damis me paraît bien sincère.
VALERE, Mais allons donc chercher à diner autre-part,	VALÈRE, Mais allons donc chercher à dîner autre-part,
CLIDAMANT.	CLIDAMANT.
Pour en pouuoir trouuer il eſt vn peu bien tard.	Pour en pouuoir trouver il est un peu bien tard.
LEANDRE eu preuant ſa mouſtre.	LÉANDRE eu prévant sa moutre.
Voyons quelle heure il eſt	Voyons quelle heure il est
CLIDAMANT eu regardant auee luy.	CLIDAMANT eu regardant aveie lui.
Hé bien Comte qu’elle heure?	Hé bien Comte qu'elle heure?
LEANDRE.	LÉANDRE.
Plus d’vne heure & demie,	Plus d'une heure et demie,
CLIDAMANT.	CLIDAMANT.
Ah!	Ah!
c’eſt trop ou ie meuro.	c'est trop ou rien meuro.
ORONTE à Clidamant.	ORONTE à Clidamant.
Vn coc-dainde à preſent ne te fcroit pas peur;	Un coc-dainde à présent ne te fallait pas peur;
C iij Mais te fait-on ainſi ſouuent diner par cœur,	Ç Cij Mais te fait-on ainsi souvent dîner par cœur,
CLIDAMANT.	CLIDAMANT.
Quoy que tard, ie pretens dinet bien I mon aiſe Iſtes-vous en caroſſe?	Quoi que tard, ie pretens dinet bien I mon aise Istes-vous en carosse?
ORONTE.	ORONTE.
Ouy.	Oui.
CLIDAMANT.	CLIDAMANT.
Moy ie ſuis en chaiſe.	Mo ie suis en chaise.
LEANDRE.	LÉANDRE.
Et moy pareillement.	Et moi pareillement.
VIALERE.	VIALÈRE.
I faut donc qu'en ce lleu Puis que le temps eſt cher, nous vous diſions adicu.	I faut donc qu'en ce lu Puis que le temps est cher, nous vous disions adicu.
DAMIS 2 part.	DAMIS 2 part.
Quel plaiſir de les voir que i’ayme à les entendre;	Quel plaisir de les voir que j'aime à les entendre;
Mais allons de ce tour faire part à Therſandre.	Mais allons de ce tour faire part à Thersandre.
SCENE XV.	SCÈNE XV.
CLIDAMANT, LEANDRE,	CLIDAMANT, LÉANDRE,
CLIDAMANT.	CLIDAMANT.
Vant que de partir ſongeons où nous irons, A Et puis apres cclà Comte nous ſortirons.	Vant que de partir songeons où nous irons, À Et puis après cclà Comte nous sortirons.
Marquin LEANDRE,	Marquin LÉANDRE,
CLIDAMANT.	CLIDAMANT.
Sçais-tu quelqu’vn ?	Sais-tu quelqu'un ?
LEANDRE.	LÉANDRE.
Allons chez Cleromene;	Allons chez Cleromène;
CLIDAMANT.	CLIDAMANT.
L'on ne mange chez luy que trois fois la ſemaine.	L'on ne mange chez lui que trois fois la semaine.
Et ie ne ſçay que trop que ce n’eſt pas ſon iour.	Et ici ne sais que trop que ce n'est pas son jour.
LEANDRE.	LÉANDRE.
Qui diable introduiſit cette mode à la Cour.	Qui diable introduisit cette mode à la Cour.
Il nous faut donc aller chez le beau Theomenc.	Il nous faut donc aller chez le beau Théomenc.
CLIDAMANT.	CLIDAMANT.
Mais i’ay mangé chez luy toute cette ſemaine, Ie voudrois m'en pouuoir empeſcher auiourd’huy.	Mais j'ai mangé chez avoir toute cette semaine, Je voudrais m'en pouvoir empêcher aujourd'hui.
LEANDRE.	LÉANDRE.
Pour moy ie pourois bien aller diner chez luy;	Pour moi ici pourrais bien aller dîner chez te;
Toutesfois ſi Doris.	Toutefois si Doris.
CLIDAMANT.	CLIDAMANT.
I’ignore ſa demeure, Car il eſt delogé.	J'ignore sa demeure, Car il est délogé.
Mais ſçache qu’à cette heure On a diné par tout.	Mais sache qu'à cette heure On a diné par tout.
LEANDRE.	LÉANDRE.
Qu'eſt-ce que nous ferons?	Qu'est-ce que nous ferons?
CLIDAMANT.	CLIDAMANT.
Il faut dés à preſent voir où nous ſoûperons.	Il faut dès à présent voir où nous souperons.
Mais i’enrage.	Mais j'enrage.
LEANDRE.	LÉANDRE.
D'où vient la douleur qui t’accable?	D'où vient la douleur qui t'accable?
CLIDAMANT.	CLIDAMANT.
Ie ſonge que le ſoir peu de gens tiennent Table.	Je songe que le soir peu de gens tiennent Table.
LEANDRE.	LÉANDRE.
A la fin tout cecy commence à m’affliger.	À la fin tout ceci commence à m'affliger.
Mais ſi chez toy.	Mais si chez toi.
CLIDAMANT.	CLIDAMANT.
Chez moy, ſeul ie n’y puis manger,	Chez -moi, seul Elle n'y puis manger,
LEANDRE.	LÉANDRE.
Mais ie pretens aller t’y tenir compagnie.	Mais ici prétends aller t'y tenir compagnie.
CLIDAMANT.	CLIDAMANT.
Ah ſortons, car ce lieu rend ma peine infinie.	Ah sortons, car ce lieu rend ma peine infinie.
LEANDRE.	LÉANDRE.
Attens vn peu.	Attends un peu.
Sçais-tu Marquis où nous irons ?	Sais-tu Marquis où nous irons ?
Allons chez vn Traitteur, & nous y dinerons, On y ſert à toute heure.	Allons chez un Traiteur, et nous y dînerons, On y sert à toute heure.
CLIDAMANT.	CLIDAMANT.
Il eſt vray:	Il est vrai:
mais eſcout On ne peut, en ce lleu, manger ſans qu’il en couſt Et ie n’ay point d’argent.	mais escout On ne peut, en ce leu, manger sans qu'il en coût Esprit ie n'ai point d'argent.
LEANDRE.	LÉANDRE.
uoy.	uoy.
CLIDAMANT.	CLIDAMANT.
C’eſt la verité.	C'est la vérité.
LEANDRE.	LÉANDRE.
C’eſt vn mal ordinaire aux gens de qualité Ie n’en ay point non plus, & ie perdis hicr.	C'est un mal ordinaire aux gens de qualité Je n'en ai point non plus, et personne perdis hicr.
CLIDAMANT.	CLIDAMANT.
Manger à nos deſpens nous ſeroit vne honte.	Manger à nos dépens nous serait une honte.
Allons iuſques au ſoir cauſer en d’autres lieux, Comte, Si nous ne dinons point nous en ſouperons mieux.	Allons jusques au soir causer en d'autres lieux, Comte, Si nous ne dînons point nous en souperons mieux.
SCENE XVI.	SCÈNE XVI.
THERSANDRE MELINTE, LVCILLE, DAMIS.	THÉRSANDRE MELINTE, LUCILE, DAMIS.
THERSANDRE.	THÉRSANDRE.
Nfin ils ſont ſortis & ie te dois apprendre LQue ce tour trop piquant à droit de me ſurprendic :	Nfin ils sont sortis et ici te dois apprendre LQue ce tour trop piquant à droit de me surprendic :
Ie ne l’attendois pas, & tu dois auoüer Quë de ton procede ie doi peu me loüer.	Je ne l'attendais pas, et tu dois auoüer Quue de ton procède ie dois peu me louer.
Ie ne i’auois pas dit d’en vſer de la ſorte, Ils ont licu de ſe plaindre & la piece eſt trop forte.	Je ne j'avais pas dit d'en user de la sorte, Ils ont licu de se plaindre et la pièce est trop forte.
MELINTE.	MELINTE.
Mais que vois-ie?	Mais que vois-je?
SCENE XVII.	SCÈNE XVII.
THERSANDRE, MELINTE.	THÉRSANDRE, MELINTE.
LVCILLE, CLIDAMANT, DAMIS.	LUCILE, CLIDAMANT, DAMIS.
CLIDAMANT.	CLIDAMANT.
V'on ſouffre auecque les valets, Ie n’ay porteurs icy, galoches, ny laquais.	V'on souffre auecque les valets, Je n'ai porteurs ici, galoches, Seigneur laquais.
Ah!	Ah!
fant-il qu’en ce licu plus long-temps ie demeure.	fant-il qu'en ce licu plus longtemps où demeure.
En apporceuaut Tberſaudre, plcliute & Laille.	En apporcevaut Tbersaudre, plclivte et Laille.
Mais vous auiez raiſon de diner de bonne heure, Vos yeux eſtoient charmez pendant ce doux repas Damis à fort bien dit & ne s’abuſoit pas, Auec de tels obiets l’on peut auoir affaire.	Mais vous aviez raison de dîner de bonne heure, Vos yeux étaient charmés pendant ce doux repas Damis à fort bien dit et ne s'abusait pas, Avec de tels objets l'on peut avoir affaire.
THERSANDRE.	THÉRSANDRE.
Sçichez que.	Sichez que.
CLIDAMANT.	CLIDAMANT.
Vous croyez que ie ſois encolere Quand ie me réyoüis de ce qu’enfin mon cœur, Trouue vn iuſte ſujet d’eſtoufer ſon ardeur;	Vous croyez que je sois encolère Quand on me réyoüis de ce qu'enfin mon cœur, Trouve . juste sujet d'étouffer son ardeur;
Il adoroit Lucille auec trop de conſtance.	Il adorait Lucille avait trop de constance.
MELINTE.	MELINTE.
L’on ſe trompe ſouuent, & comme l’apparence.	L'on se trompe souvent, et comme l'apparence.
CLIDAMANT.	CLIDAMANT.
Ie me veux tromper moy, m’en empeſcherez vous!	Je me veux tromper moi, m'en empêcherez -vous!
si.	si.
THERSANDRE.	THÉRSANDRE.
CLIDAMANT.	CLIDAMANT.
Ie pretend ceſſer de faire les yeux doux :	Je prétend cesser de faire les yeux doux :
Les exemples d’autruy doiuent me rendreſage, Et de peur d’accident ie fuis le mariage;	Les exemples d'autrui doivent me rendresage, Et de peur d'accident me fuis le mariage;
Car s’il m’en arrinoit les critiques du temps Pouroient impanément railler à mes deſpens.	Car s'il m'en arrinait les critiques du temps Pouraient impanément railler à mes dépens.
SCENE XVIII.	SCÈNE XVIII.
THERSANDRE,MELINTE, LVCILLE, CLIDAMANT, DAMIS, CRISPIN.	THÉRSANDRE,MELINTE, LUCILLE, CLIDAMANT, DAMIS, CRISPIN.
CRISPIN.	CRISPIN.
V Os porteurs ſont lì bas & vous pouuez deſcendres	V Os porteurs sont lì bas et vous pouvez descendrez
CLIDAMANT.	CLIDAMANT.
Adieu car ie craindrois de les trop faire attendre.	Adieu car beau craindrais de les trop faire attendre.
SCENE XIX.	SCÈNE XIX.
THERSANDRE, MELINTE,LVCILLE, DAMIS.	THÉRSANDRE, MELINTE,LUCILLE, DAMIS.
MELINTE.	MELINTE.
A fille ne perd rien en perdant cét amant, MEt e eſt gagner beaucoup que perdre Clidamant.	À fille ne perd rien en perdant cet amant, MEt eût est gagner beaucoup que perdre Clidamant.
THER SANDRE.	THÉR SANDRE.
Apres vn tel aucu puis-ie croire Madame.	Après un tel aucu puis-je croire Madame.
MELINTE Pour Lucille, i’ay ſçeu voſtre ſecrette flime, Et ſi quand nous aurons finy noſtre procez, Vous ſoûpirez encor pour ſes ieunes attraits, Nous pourrons en ce temps parler d’vn Hymenée.	MELINTE Pour Lucille, j'ai su votre secrète flamme, Et si quand nous aurons fini notre procès, Vous soupirez encor pour ses jeunes attraits, Nous pourrons en ce temps parler d'un Hyménée.
THERSANDRE.	THÉRSANDRE.
Que ie dois auiourd’huy loüer ma deſtinée;	Que ici dois aujourd'hui louer ma destinée;
A force de bon-heur elle me rend confus.	À force de bonheur elle me rend confus.
MELINTE.	MELINTE.
Ne perdons point le temps en diſcours ſuperflus, Il nous preſſe, fortons.	Ne perdons point le temps en discours superflus, Il nous presse, sortons.
THERSANDRE, à LCille.	THÉRSANDRE, à LCille.
Puis-je eſperer Madame.	Puis-je espérer Madame.
LVCILLE.	LUCILE.
Oüy, puis qu’aucc plaiſir i’ay connu voſtre flîme.	Oui, puis qu'aucc plaisir j'ai connu votre flamme.
FIN.	FIN.
Et ſi quand nous aurons finy noſtre procez, Vous ſoûpirez encor pour ſes ieunes attraits, Nous pourrons en ce temps parler d’vn Hymenée.	Et si quand nous aurons fini notre procès, Vous soupirez encor pour ses jeunes attraits, Nous pourrons en ce temps parler d'un Hyménée.
THERSANDRE.	THÉRSANDRE.
Que ie dois auiourd’huy loüer ma deſtinée;	Que ici dois aujourd'hui louer ma destinée;
A force de bon-heur elle me rend confus.	À force de bonheur elle me rend confus.
MELINTE.	MELINTE.
Ne perdons point le temps en diſcours ſuperflus, Il nous preſſe, fortons.	Ne perdons point le temps en discours superflus, Il nous presse, sortons.
THERSANDRE, à LCille.	THÉRSANDRE, à LCille.
Puis-je eſperer Madame.	Puis-je espérer Madame.
LVCILLE.	LUCILE.
Oüy, puis qu’aucc plaiſir i’ay connu voſtre flîme.	Oui, puis qu'aucc plaisir j'ai connu votre flamme.
FIN.	FIN.
