M.	M.
DC.	DC.
XLII.	XLII.
Source gallicabntfr ( Bibliothèque nationale de France M AR grace & Priuilege du Roy, en datte du 3.	Source gallicabntfr ( Bibliothèque nationale de France M AR grâce et Privilège du Roy, en datte du 3.
jour de May 164I.	jour de May 164I.
ſigné par le Roy, en lon Conſeil le Brun, Il eſt permis à ANTOINE DE SOMMAVILLE Marchand Libraire à Paris, d’In primur où faſreimprimer vne piece de Theatre intitulée PHALANTE TRAGEDIE, & ce durant le temps de cinq ans:	signé par le Roi, en lon Conseil le Brun, Il est permis à ANTOINE DE SOMAUILLE Marchand Libraire à Paris, d'In primur où fasreimprimer une pièce de Théâtre intitulée PHALANTE -TRAGÉDIE, et ce durant le temps de cinq ans:
Et deffence ſont faictes à tous autres de quelque qualité & çondition qu’ilſoient d’en vendre d’autres que de celle qu’aura faict imprimer ledit de Sommauille, ſur les peiries portées par leſoites lettres.	Et défense sont faites à tous autres de quelque qualité et çondition qu'ilsaient d'en vendre d'autres que de celle qu'aura fait imprimer ledit de Sommaville, sur les péiries portées par lesaites lettres.
1 ----------- --- -- .	1 --on -ce- -ce- .
.	.
I .	I .
.	.
.	.
.	.
.	.
i la  .	y la .
a * *	a * *
HELENE, Reyne de Corinthe.	HELENE, Reine de Corinthe.
PHALANTE, Prince eſtranger.	PHALANTE, Prince étranger.
PHILOXENE, Prince de Corinthe.	PHILOXENE, Prince de Corinthe.
ARBANTE, Confident de Phalante.	ARBANTE, Confident de Phalante.
CLEONE, AMINTE, - .	CLÉONE, AMINTE, - .
Demoiſelles de la Reyne.	Demoiselles de la Reine.
.	.
–-	–-
ETCAVEE 8 M LRIXGEDIE	ETCAVE 8 M RIXGEDIE
A SCLNE L I TREMIERE, PHILOXENE, HELENE dans ſa chambre.	À SCLNE I TREMIERE, PHILOXENE, HELENE dans sa chambre.
PHILOXENE.	PHILOXENE.
ES regards enflammés que lancent vos beaus yeus, Ne ſont que des eſclairs pour cet audacieus, Et ſa preſomption a merité la foudre, Dont ils s’arment deſia pour le reduire en poudre.	ES regards enflammés que lancent vos beaus yeus, Ne sont que des éclairs pour cet audacieus, Et sa présomption a mérité la foudre, Dont ils s'arment déjà pour le réduire en poudre.
o.	ô.
*Ouy;	Oui;
Aſadame, il eſt iuſte, & voſtre Majeſté Me doit enfin punir de ma temerité;	Asadame, il est juste, et votre Majesté Me doit enfin punir de ma témérité;
Tabuſe inſolemment des bontés de ma Reine, Du reſpect qu'vn vaſſal doit à ſa Souueraine, Et dans ma paßion ie ne recognoy pas, Et combien elle eſt haute, & combien te ſuis bas.	Tabuse insolemment des bontés de ma Reine, Du respect qu'un vassal doit à sa Souveraine, Et dans ma passion nous ne reconnais pas, Et combien elle est haute, et combien te suis bas.
Aon audace a rendu ma faute irremiſsible, Mla flamme eſt criminelle en tant qu'elle eſt viſible, Auſsi n'ay-je peché qu'en vous la deſcouurant, Et te deuois mourir, & me taire en mourant:	Aon audace a rendu ma faute irrémissible, Mla flamme est criminelle en tant qu'elle est visible, Aussi n'ai-je péché qu'en vous la découvrant, Et te devais mourir, et me taire en mourant:
Mais quelque paſsion qui rompe mon ſilence, Ne m'en accuſeZ point, on me fait violence, Et ce Tyran des Dieux, d’vn inſolent pouuoir, Dans mon aueuglement eſtouffe mon deuoir, Ma paſsion l’emporté auëc trop d’auantage, Es ceux à qui vos yeux laiſſent encor l’vſage.	Mais quelque passion qui rompe mon silence, Ne m'en accusez point, on me fait violence, Et ce Tyran des Dieux, d'un insolent pouvoir, Dans mon aveuglement étouffe mon devoir, Ma passion l'emporté auec trop d'avantage, Es ceux à qui vos yeux laissent encor l'usage.
Æl aetirteztoijpance es dis ihijounentenz, Quelques prudens qu’ils ſoient, manquent de iugement, Si l'on brêloit pour vous d’vne flamme commune	Æl aetirteztoijpance es dis ihijounentenz, Quelques prudents qu'ils soient, manquent de jugement, Si l'on brêloit pour vous d'une flamme commune
FTELENE.	FTELENE.
Philoxene il ſuffit, ce diſcours m'importune, Laſſés-vous a la fin de me perſecuter, Comme ma patience eſt laſſe, d’eſcouter.	Philoxène il suffit, ce discours m'importune, Lassez-vous a la fin de me persécuter, Comme ma patience est lasse, d'écouter.
PHILOXENE.	PHILOXENE.
Si pour vons adorer i'ay pu commettre vn crime, .	Si pour vonds adorer j'ai pu commettre un crime, .
.	.
4- 2	4- 2
HELENE.	HELENE.
Ce n’eſt pas que ie ne vous eſtime Philoxene je ſçay ce que vous meritez Et pour voſtre naiſſance & pour vos qualite?	Ce n'est pas que ici ne vous estime Philoxène je sais ce que vous méritez Et pour votre naissance et pour vos qualité?
Mais quelques ſentimens que l’eſtime me donne Voſtre amour me deſplaiſt plus que voſtre perſonne Et te vvous reatrayphijque vonsm yforces, Que vous deués guerirſi vous vous cognoiſſés.	Mais quelques sentiments que l'estime me donne Votre amour me déplaît plus que votre personne Et te vvous reatraiphijque vonsm yforces, Que vous devez guériri vous -vous connaissez.
PHILOXENE.	PHILOXENE.
Ie me cognois Madame, & ceſte amour extréme, Qui m'a preſque en naiſſant detaché de moy-meſme, Ne m'aueugle pas tant, que pour comble d’ennuys Ie ne puiſſe iuger qui j’ayme & qui ie ſuis, Si de vous adorer la gloire eſt interdite, A ceux que la grandeur, le ſang & le merite, Ne rendent point egaux à voſtre Majeſté, Qui ſe pourrà vanter de l’auoir merité?	Je me connais Madame, et cette amour extrême, Qui m'a presque en naissant détaché de moi-même, Ne m'aveugle pas tant, que pour comble d'ennuis Je ne puisse juger qui j'aime et qui ie suis, Si de vous adorer la gloire est interdite, À ceux que la grandeur, le sang et le mérite, Ne rendent point égaux à votre Majesté, Qui se pourra vanter de auoir mérité?
Mais ſi parles ardeurs d’vne flame eternelle Par vn profond reſpect, par vn feu pleinde zele, Par des preuues d'amour, de conſtance & de foy On le peut eſperer, qui le doit mieux que moy?	Mais si parles ardeurs d'une flamme éternelle Par un profond respect, par un feu pleinglé zèle, Par des preuves d'amour, de constance et de foi On le peut espérer, qui le doit mieux que moi?
Touſiours vos volontés ont fait mes deſtinées, Ie vous ay dedié mes premieres années.	Toujours vos volontés ont fait mes destinées, Je vous ai dédié mes premières années.
Naiſſant ie vous ſeruis, & les Dieux ſont teſmoins Que le Sceptre a vos loix m'aſſujetit le moins, ----- --- ---	Naissant ici vous servis, et les Dieux sont témoins Que le Sceptre à vos lois m'assujet le moins, -- -- --
Que mon cœur aſſeruy du plus bas de mon âge, Sans contrainte à vos pieds rẽdit vn double hõmage, Et ne meſla iamais dans ſes ſainctes ardeurs, A l’intereſt d’amour l’intereſt des grandeurs:	Que mon cœur asservi du plus bas de mon âge, Sans contrainte à vos pieds rẽdit un double hommage, Et ne mêla jamais dans ses sainctes ardeurs, A l'intérêt d'amour l'intérêt des grandeurs:
Ie fus deux fois ſubject, vous deux fois Souueraine, Et viuant auec gloire, eſclaue de ma Reyne, I’eus dés vos jeunes ans, eſleué pres de vous, Et des bon-heurs plus grands, & des momens plus Vous excuſieZ pour lors ma paſsion naiſſante, (dous.	Je fus deux fois sujet, vous deux fois Souveraine, Et vivant avec gloire, esclave de ma Reine, J'eus dès vos jeunes ans, élevé pres de vous, Et des bonheurs plus grands, et des moments plus Vous excusieZ pour lors ma passion naissante, (dous.
Qui vous entretenoit d’vn amour innocente, Voſtre eſprit jeune encor differoit mon treſpas, Et me pleignoit d’vn mal qu’il ne cognoiſſoit pas.	Qui vous entretenait d'un amour innocente, Votre esprit jeune encor différait mon trépas, Et me pleignait d'un mal qu'il ne connaissait pas.
Mais helas!	Mais hélas!
que le Ciel a mis de difference A la ſuitte d’vn bien ſi grand dans ſa naiſſance?	que le Ciel a mis de différence A la suitte d'un bien si grand dans sa naissance?
Mon cœur ne changea point, mais le voſtre changea, Si-toſt que ſous vos loix Corinthe ſe rangea:	Mon cœur ne changea point, mais le vôtre changea, Sitôt que sous vos lois Corinthe se rangea:
Quand voſtre dignité s'accrut auec voſtre aage, Et que la majeſté qui brille en ce viſage, Receut d’vne couronne vn eſclat tout nouueau, Toute mon eſperance entra dans le tombeaut, Vous ne cogneuſtes plus le pauure Philoxene, Son amour ſeulement fit naiſtre voſtre haine, Et ce reſſentiment qui vous peut animer Ne vous le fait hair que pour vous trop aymer.	Quand votre dignité s'accrut avec votre âge, Et que la majesté qui brille en ce visage, Recut d'une couronne un éclat tout nouveau, Toute mon espérance entra dans le tombeaut, Vous ne connûtes plus le pauvre Philoxène, Son amour seulement fit naître votre haine, Et ce ressentiment qui vous peut animer Ne vous le fait haïr que pour vous trop aimer.
HELENE.	HELENE.
Si ie vous haïſſois autant que vous le dites, Ie me garantirois de toutes vos viſites.	Si ici vous haïssais autant que vous le dites, Je me garantirais de toutes vos visites.
.	.
.	.
.	.
.	.
–.	§.
.	.
Et ne preferant point voſtre repos au mien, Ie me deliurerois d’vn facheux entretien, Suffit que ie vous ſoufre & que trop indulgente,	Et ne préférant point votre repos au mien, Je me délivrerais d'un fâcheux entretien, Suffit que je vous souffre et que trop indulgente,
SCENE II.	SCÈNE II.
CLEONE, HELENE, PHILOXENE, VN HVISSIER.	CLEONE, HELENE, PHILOXENE, VN HVISSIER.
CLEONE.	CLÉONE.
Adame, quelqu’vn vient.	Adame, quelqu'un vient.
HVISSIER.	HVISIER.
C’eſt le Prince Phalante	C'est le Prince Phalante
Pa Ii.	Pa Ii.
d.	d.
le Me j Qu’ilentre, le cruelreuient pour m'affliger, Mais non pas pour me plaindre ou pour me ſoulager, Ahil l’ingrat, le voicy, cache vn peu ta foibleſſe.	le Me j 'ilentre, le cruelrevient pour m'affliger, Mais non pas pour me plaindre ou pour me soulager, Ahil l'ingrat, le voici, cache un peu ta faiblesse.
PHILOXENE.	PHILOXENE.
Qu’il arriue à propos, cher amy ie vous laiſſe, Ma vie eſt en vos mains & i atiens tout de vous.	Qu'il arrive à propos, cher ami je vous laisse, Ma vie est en vos mains et y atiens tout de vous.
.	.
.	.
t-:	t-:
L	L
SCENE III.	SCÈNE III.
FTELENE, PIIALANIE.	FTELENE, PIIALANIE.
HELENE.	HELENE.
Epuis que vos malheurs ſont des bon-heurs D pour nous, Et que nous beniſſons le ſuccés de ces guerres, Qui pour nous viſiter vous, font quitter vos terres, Treuuez vous parmy nous vn diuertiſſement Qui puiſſe ſoulager voſtre banniſſement, curupres les grandeurs qu’il euſt dans ſa prouince, Ma Cour eſt vn exil pour vn ſibraue Prince.	Epuis que vos malheurs sont des bonheurs D pour nous, Et que nous bénissons le succès de ces guerres, Qui pour nous visiter vous, font quitter vos terres, Trevez vous parmi nous un divertissement Qui puisse soulager votre bannissement, curuprès les grandeurs qu'il eût dans sa province, Ma Cour est un exil pour un sibrave Prince.
Mais pourtant vn exil qui peut estre adoucy, Par l’abſ olu pouuoir que vous auezicy.	Mais pourtant un exil qui peut être adouci, Par l'abs olu pouuoir que vous avezici.
PHALANTE.	PHALANTE.
Madame, vos bonteZ ſont pourmoy ſans limites Et m’ayant honoré par deſſus mes meriies, Vos faueurs m’ont faittort, m’ayant mis eneſtat;	Madame, vos bontés sont pourmoi sans limites Et m'ayant honoré par -dessus mes mériies, Vos faveurs m'ont faittort, m'ayant mis enétat;
Ou de mourir pourvous, on de mourir ingrat, (re Que peut vn mal-heureux que les Dieux & la guerFont errer fugitif de ſa natale terre?	Ou de mourir pourvous, on de mourir ingrat, (ré Que peut un malheureux que les Dieux et la guerFont errer fugitif de sa natale terre?
Et qui deuoit perir ſi voſtre Mareſté N'eut ſoulage ſa perte auec tant de bonté.	Et qui devait périr si votre Maresté N'eut soulage sa perte avec tant de bonté.
Certes de tous les maux dont le Ciel perſecute .	Certes de tous les maux dont le Ciel persécute .
.	.
.	.
.	.
.	.
4 Celuy que ſon courroux ſemble auoir pris eh butte.	4 Celui que son courroux semble avoir pris eh butte.
La plus viue douleur qu’il pouuoit receuoir, C'est de vous deuoir tant & de ne rien pouuoir:	La plus vive douleur qu'il pouvait recevoir, C'est de vous devoir tant et de ne rien pouvoir:
Vous aueZ releué ma dignité panchante, Recueilly les debris de ma fortune errante.	Vous avez relevé ma dignité penchante, Recueilli les débris de ma fortune errante.
Et par mille faueurs & par mille bien-faits Vous m'aueZ mis plus haut que ie ne fus iamais, Auſsi de quelque aigreur dont la fortune auerſe Dans mes plus beaux deſſeins ſans ceſſe me trauerſe, Ie la voudrois benir & tous mes ennemis, De l’eſtat glorieux où leur rage m'a mis.	Et par mille faveurs et par mille bienfaits Vous m'avez mis plus haut que sans ne fus jamais, Aussi de quelque aigreur dont la fortune averse Dans mes plus beaux desseins sans cesse me traverse, Je la voudrais bénir et tous mes ennemis, De l'état glorieux où leur rage m'a mis.
Si de tant de bon-heur dont vous eſtes la ſource, Vn ſenſible regret ne trauerſoit la courſe, Vnregret qui me tue, & qui fera perir, Ce qu'en vain vos bontez ont daïgné ſecourir;	Si de tant de bonheur dont vous êtes la source, Un sensible regret ne traversait la course, Unregret qui me tue, et qui fera périr, Ce qu'en vain vos bontés ont daïgné secourir;
Pardonnez vn diſcours que la douleur arrache,	Pardonnez un discours que la douleur arrache,
HELENE.	HELENE.
Ce n'eſt pas tout Phalante, il faut que ie le ſçache, Et ſi par mon credit il ſe peut ſoulager, Ie ne refuſe rien qui vous puiſſe obliger, Souffrez ma confidence, & receuez mon ayde.	Ce n'est pas tout Phalante, il faut que sans le sache, Et si par mon crédit -il se peut soulager, Je ne refuse rien qui vous puisse obliger, Souffrez ma confidence, et recevez mon aide.
PHALANTE.	PHALANTE.
De vous ſeule depend le mal & le remede Et voſtre charité du tombeau tirera Et l’amy qui ſe meurt, & l’amy qui moura.	De vous seule dépend le mal et le remède Et votre charité du tombeau tirera Et l'ami qui se meurt, et l'ami qui moura.
Ce n'eſt pas d’auiourd’huy que ma bouche importiss:	Ce n'est pas d'aujourd'hui que ma bouche importiss:
L-----:	L-:
	
Regrette à vos genous ſa mauuaiſe fortune.	Regrette à vos genous sa mauvaise fortune.
Et qu'affligé d’vn mal que ie ſouffre à demy Ie demande à vos pieds le ſalut d’vn amy.	Et qu'affligé d'une mal que sans souffre à demi -Je demande à vos pieds le salut d'Han ni.
Certes ſi la pitié peut attendrir vne ame, Et ſi quelque rayon de la plus belle flame, Dont le cœur d’vn amant fut iamais embraſé, Peut toucher de ſon mal celle qui la cauſé, Vous eſtes obligee à ſoulager la peine Qu’on voit ſouffrir pour vous au pauure Philoxene.	Certes si la pitié peut attendrir une âme, Et si quelque rayon de la plus belle flamme, Dont le cœur d'un amant fut jamais embrasé, Peut toucher de son mal celle qui la causé, Vous êtes oblige à soulager la peine Qu'on voit souffrir pour vous au pauvre Philoxène.
Iamais cœur ne bruſla dans vn ſi grand reſpect, Et bien que l’amitié me peut rendre ſuſpect, I'atteſte des grands Dieux la puiſſance ſu préme Que iamais vn mortel n'ayma comme il vous ayme:	Jamais cœur ne brûla dans un si grand respect, Et bien que l'amitié me peut rendre suspect, J'atteste des grands Dieux la puissance su me Que jamais un mortel n'aima comme il vous aime:
C’eſt de ceſte pitié que naiſſent tous mes ſoins, Et cet eſtroit lien dõt nos eſprits ſont joints.	C'est de cette pitié que naissent tous mes soins, Et cet étroit lien dont nos esprits sont joints.
me face Quelque bien, quelque mal, quelque honneur qu'on M'a rendu mal-heureux dans ſa ſeule diſgrace,	me face Quelque bien, quelque mal, quelque honneur qu'on M'a rendu malheureux dans sa seule disgrâce,
HELENE.	HELENE.
Belle & digne amitié d’vn cœur ſi genereus, Que dans tous les malheurs Philoxene eſt heureus, D’auoir fait vn amy dont la vertu trop haute, Compatit à ſes maus, & ſouffre pour ſa faute.	Belle et dis amitié d'une cœur si généreus, Que dans tous les malheurs Philoxène est heureus, D'avoir fait un ami dont la vertu trop haute, Compatit à ses maus, et souffre pour sa faute.
Mais puis qu’vne ſi forte & ſi rare amitie, Vous a pour ſon malheur donné quelque pitié, Et que vous reſſentez la peine qu’il merite, Pour ſon ambition trop douce & trop petité, Donnez lu y deſormais le conſeil de guerir.	Mais puis qu'une si forte et si rare amitié, Vous a pour son malheur donné quelque pitié, Et que vous ressentez la peine qu'il mérite, Pour son ambition trop douce et trop petité, Donnez lu y désormais le conseil de guérir.
Puis- Puiſque ce cœuringrat ne le peut ſecourir.	Puis- Puisque ce cœuringrat ne le peut secourir.
C’eſt, quoy que ſon erreur luy face encor pretendre, L’office le meilleur que vous luy puißieZ rendre;	C'est, quoi que son erreur Seigneur face encor prétendre, L'office le meilleur que vous Seigneur pussy rendre;
Il vous croira ſans doute, & par raiſonnement Il ſe retirera de ſon aueuglement:	Il vous croira sans doute, et par raisonnement Il se retirera de son aveuglement:
Employe (-y vos ſoins.	Emploie (y vos soins.
PHALANTE.	PHALANTE.
O ciel!	Ô ciel!
eſt-il poſsible Qu'à tant de paſsion voſtre cœur inſenſible A cét Amant fidele ordonne le treſpas, Puis que ſans ce remẽde il ne guerira pas?	est-il possible Qu'à tant de passion votre cœur insensible À cet Amant fidèle ordonne le trépas, Puis que sans ce rement il ne guérira pas?
Ceux qui peuuent ſentir les atteintes mortelles Dont vos yeux ont bleſſé les ames les plus belles, Quoy que faſſent pour eux le temps & la raiſon, Dans la mort ſeulement treuuent leur gueriſon:	Ceux qui peuvent sentir les atteintes mortelles Dont vos yeux ont blessé les âmes les plus belles, Quoi que fassent pour eux le temps et la raison, Dans la mort seulement trouvent leur guérison:
Certes ſi vous pouuieZ ſans mépris ou ſans haine Conſiderer les maux du pauure Philoxene.	Certes si vous pouvez sans mépris ou sans haine Considérer les maux du pauvre Philoxène.
Et voir le triſte eſtat où vous l’auez reduit Depuis qu’il vous adore auec ſi peu de fruit, Vous verrieZ qu'vn conſeil d’vne telle nature, Au lieu de l’adoucir aigriroit ſa bleſſure.	Et voir le triste état où vous l'avez réduit Depuis qu'il vous adore avec si peu de fruit, Vous verriez qu'un conseil d'une telle nature, Au lieu de l'adoucir aigrirait sa blessure.
Helas combien de fois paſle & ſans mouuement, Ses yeux deuers le ciel eſleuez lentement, Ses yeux à qui des pleurs la courſe continué, Auroit preſque rauy l’vſage de la veue, L’ay-je veu demander pour un dernier ſecours La fin de vos rigueurs dans la fin de ſes jours?	Hélas combien de fois pâle et sans mouvement, Ses yeux devers le ciel élevez lentement, Ses yeux à qui des pleurs la course continué, Aurait presque ravi l'usage de la vue, L'ai-je vu demander pour un dernier secours La fin de vos rigueurs dans la fin de ses jours?
.	.
o ---.	ô --.
Il eſt vray, ſes douleurs faiſoient naistre les miennes, Mes larmes, ie l’auouë, accompagnoient les ſiennes, Mon ame par pitie blâmoit voſtre rigueur, Et ſes ardans ſouſpirs me touchoiẽt juſqu'au cœur.	Il est vrai, ses douleurs faisaient naître les miennes, Mes larmes, assez l'avoue, accompagnaient les siennes, Mon âme par pitié blâmait votre rigueur, Et ses ardans soupirs me touchaient jusqu'au cœur.
Ce fut cette pitié qui me fit temeraire, Et bien que le reſpect m'obligeât à me taire, Cette compaſsion me le fit violer, Et pour le ſecourir me força de parler, Mais Dieux!	Ce fut cette pitié qui me fit téméraire, Et bien que le respect m'obligeât à me taire, Cette compassion me le fit violer, Et pour le secourir me força de parler, Mais Dieux!
que mes diſcours ont eu peu d’eficace, Mes importunitez augmentent ſa diſgrace, Et redoublent le mal qui l’accable aujourd’huy, Parce qu’vn mal-heureux intercede pour luy.	que mes discours ont eu peu d'eficace, Mes importunités augmentent sa disgrâce, Et redoublent le mal qui l'accable aujourd'hui, Parce qu'être malheureux interce pour lui.
HELENE.	HELENE.
Faut-il que ce diſcours ſi viuement me touche, Et que pour Philoxene il ſorte de ſa bouche:	Faut-il que ce discours si vivement me touche, Et que pour Philoxène il sorte de sa bouche:
O Dieux!	Ô Dieux!
qui l’eſcoutez, puis qu’il s adreſſe à moy, Que ne permetteZ-vous qu’il le faſſe pour ſoy?	qui l'écoutez, puis qu'il s adresse à moi, Que ne permettez-vous qu'il le fasse pour soi?
Mais c’eſt trop endurer, haſte ta deſtinée, Force ce dur ſilence où tu t'es condamnée, Et puis que ton braſier ne ſe peut plus cacher Eſprouue la bonté d’vn ennemy ſi cher, Il n'eſt point inſenſible, & ce viſage aymable N’eſt point ſorty des flancs d’vne ourſe impitoyable, S’il n’eſt plus endurcy qu'vn tronc ou qu'vnrocher:	Mais c'est trop endurer, hâte ta destinée, Force ce dur silence où tu t'es condamnée, Et puis que ton brasier ne se peut plus cacher Éprouve la bonté d'H ennemi si cher, Il n'est point insensible, et ce visage aimable N'est point sorti des flancs d'une ourse impitoyable, S'il n'est plus endurci qu'un tronc ou qu'vnrocher:
Tes yeux ont des attraits qui le pourront toucher, Force cette pudeur qui te fait violence.	Tes yeux ont des attraits qui le pourront toucher, Force cette pudeur qui te fait violence.
Ah!	Ah!
pardon, ma vertu,	pardon, ma vertu,
PHALANTE.	PHALANTE.
La princeſſe balance, Sans doute mes diſcours auront fait quelque fruit.	La princesse balance, Sans doute mes discours auront fait quelque fruit.
Ah!	Ah!
cruauté du ciel où m'auez vous reduit?	cruauté du ciel où m'avez -vous réduit?
Faut-il que ie pourſuiue auecque tant d’enuie, Dans le bien d’vn amy la perte de ma vie?	Faut-il que venir poursuive avec tant d'envie, Dans le bien d'un ami la perte de ma vie?
e it uonnt cununcinmus one tx tumitie, Ou que n'obtenant rien te meure de pitié.	 eit çonnut cuncinmus one t umitie, Ou que n'obtenant rien te meure de pitié.
HELENE.	HELENE.
Ma vertu, ma pudeur, mon action vous bleſſe, Mais à ma paßion pardonnez ma foibleſſe, Ma flame eſt innocente & n’a point de penſer, Pure & chaſte qu’elle eſt, qui vous puiſſe offenſer, Ie peche ſeulement contre la bien-ſeance, Et ne vous choque point qu’en forçant le ſilence.	Ma vertu, ma pudeur, mon action vous blesse, Mais à ma passion pardonnez ma faiblesse, Ma flamme est innocente et n'a point de penser, Pure et chaste qu'elle est, qui vous puisse offenser, Je pèche seulement contre la bienséance, Et ne vous choque point qu'en forçant le silence.
Phalante, pardonneZ mon inciuilité Aux mouuemens diuers d’vn eſprit agité;	Phalante, pardonnez mon incivilité Aux mouvements divers d'un esprit agité;
Mon ame dans l’eſtat où vous l’auez reduite.	Mon âme dans l'état où vous l'avez réduite.
Par les puiſſants efforts d’vne ardante pourſuite, Faiſoit reflexion a tant de qualitez, Et d’actes de vertu dont vous nous enchantez:	Par les puissants efforts d'une ardante poursuite, Faisait réflexion a tant de qualités, Et d'actes de vertu dont vous nous enchantez:
Et certes Philoxene a bien plus d’auantage Ayant receu du ciel ce glorieux partage, D'vn amy vertueux & braue comme vous, Que ie n'en ay d’vn Sceptre, & d’vn regne aſſe;	Et certes Philoxène a bien plus d'avantage Ayant reçu du ciel ce glorieux partage, D'un ami vertueux et brave comme vous, Que je n'en ai d'un Sceptre, et d'un règne asse;
Außi voſtre merite & ce que ie defere, Au vouloir d’vn amy dont la vertu m'eſt chere, Produiroient dans mon cœur de plus puiſſans effets, Que ſon affection n'en produira jamais:	Aussi votre mérite et ce que ici defère, Au vouloir d'un ami dont la vertu m'est chère, Produiraient dans mon cœur de plus puissants effets, Que son affection n'en produira jamais:
Si muon ame deſia n'eſtoit préoccupée, Et ſi le coup mortel dont ie la ſens frappée, Me laiſſoit de mon cœur diſpoſer vn moment;	Si muon âme déjà n'était préoccupée, Et si le coup mortel dont ie la sens frappée, Me laissait de mon cœur disposer un moment;
Afin de ſatisfaire vn amy ſi charmant;	Afin de satisfaire un ami si charmant;
Helas!	Hélas!
j’en ay trop dit, & vous pouuez connoiſtre, Ce que ma paßion malgré moy fait paroiſtre, Eſpargnez a ma honte vne confeſsion, Que ie ne vous feray quà ma confuſion:	j'en ai trop dit, et vous pouvez connaître, Ce que ma passion malgré moi fait paraître, Épargnez à ma honte une confession, Que je ne vous ferai quà ma confusion:
Car bien que mon eſprit ſoit ſans tache & ſans crime, Gempaneaboutemuſuimupadeur imprime Sur mon front innocent, m'a deſtare proche, Qu’il en falloit rougir ainſi quę d’vn peché:	Car bien que mon esprit soit sans tache et sans crime, Gempaneaboutemusuimupadeur imprime Sur mon front innocent, m'a destare proche, Qu'il en fallait rougir ainsi qu 'un péché:
En fin Fhalante, i ayme, ò Dieu!	En fin Fhalante, y aime, Dieu!
ce mot me tuë.	ce mot me tue.
PHALANTE.	PHALANTE.
Doncques pour mon amy l’eſperance eſt perduë Quoy vous aymez Madame, & ſon gele & ſa foy	Donc pour mon ami l'espérance est perdue Quoi vous aimez Madame, et son gèle et sa foi
HELENE.	HELENE.
Croyez que ſon repos ne depend plus de moy, Et confeſſez außi qu'encette confidence, Philoxene teſmoigne vne haute imprudence:	Croyez que son repos ne dépend plus de moi, Et confessez aussi qu'encette confidence, Philoxène témoigne haute imprudence:
Tour gaigner ſurmon cœur beaucoup plus qu’il n'a fait, *.	Tour gagner surmon cœur beaucoup plus qu'il n'a fait, *.
* Il ſe deuoit paſſer d’vn amy ſi parfait, Raiſonner dans ce choix s’il en eſtoit capable, Iuger qui de vous deux eſtoit le plus aymable, Et pour donner l’employ qu’il vous donne aujourd’huy, Prendre vn interceſſeur qui le fut moins que luy.	* Il se devait passer d'une ami si parfait, Raisonner dans ce choix s'il en était capable, Juger qui de vous deux était le plus aimable, Et pour donner l'emploi qu'il vous donne aujourd'hui, Prendre un intercesseur qui le fut moins que sans.
O Dieux!	Ô Dieux!
ma honte icy n’eſt que tropmanifeſte, Phalante i'en dis trop, diſpenſez moy du reſte, Et ne me forceZ point contre ce que ie doy, A vous faire vn adueu trop indigne de moy:	ma honte ici n'est que tropmanifeste, Phalante j'en dis trop, dispensez moi du reste, Et ne me forcez point contre ce que je dois, À vous faire un aveu trop indigne de moi:
LiſeZ-le dans mes yeux & deſſus mon viſage, Ata ent partent que tropamon ut ſuamantage:	Lisez-le dans mes yeux et dessus mon visage, Ata ent partent que tropamon ut suamantage:
Ils ſont aſſeZ changeZ par la honte qu’ils ont, Et paroiſſent confus de l’office qu'ils font.	Ils sont assez changés par la honte qu'ils ont, Et paraissent confus de l'office qu'ils font.
PHALANTE.	PHALANTE.
O Dieux!	Ô Dieux!
que deuiendray-je?	que deviendrai-je?
ah!	ah!
Madame.	Madame.
	
HELENE.	HELENE.
De grace, De quoy que mon deſtin me flatte ou me menace, Faites, reflection encore un peu de temps, Auant que prononcer l’arrest que i’en attends.	De grâce, De quoi que mon destin me flatte ou me menace, Faites, reflection encore un peu de temps, Avant que prononcer l'arrêt que j'en attends.
Et que pour mon repos voſtre bonté permette, Qu'apres ce grand effort mon ame ſe remette:	Et que pour mon repos votre bonté permette, Qu'après ce grand effort mon âme se remette:
Elle est toute troublée en cette extremité, Adieu pardonneZ-moy cette inciuilité.	Elle est toute troublée en cette extrémité, Adieu pardonnez-moi cette incivilité.
Biii	Bii
SCENE IV HELENE.	SCÈNE IV HELENE.
AMINTE.	AMINTE.
HELENE.	HELENE.
Eſtes d’vne pudeur laſchement offenſée, Dignité de mon Sceptre indignement bleßée, Manes de mes parens, noble ſuite d’ayeux, De qui l’illuſtre ſang ſortit du ſang des Dieux, Vous que i'offence tous d’vne mortelle injure, PardonneZ-moy ma faute, amour vous en conjure, Et cet Imperieux par ſon authorité La veut rendre excuſable à la poſterité.	Êtes d'une pudeur lâchement offensée, Dignité de mon Sceptre indignement blessée, Manes de mes parents, noble suite d'aïeux, De qui l'illustre sang sortit du sang des Dieux, Vous que j'offense tous d'une mortelle injure, Pardonnez-moi ma faute, amour vous en conjure, Et cet Impérieux par son autorité La veut rendre excusable à la postérité.
I'ay peché par contrainte, & mon ame eſperduë, Auant que de ceder s’eſt long-temps defendué.	J'ai péché par contrainte, et mon âme éperdue, Avant que de céder s'est longtemps défendué.
Ma vertu mille fois m'a mis deuant les yeux, Le ſoin de mon honneur, monrang & mes ayeux, M’a cent fois remonſtré le tort irre parable Que mon ſang receuoit d’vn feu ſi condamnable, Que ma faute outrageoit les viuans & les morts, Et contre ce Tyran a fait de vains efforts.	Ma vertu mille fois m'a mis devant les yeux, Le soin de mon honneur, monrang et mes aïeux, M'a cent fois remonstré le tort irre parable Que mon sang recevait d'un feu si condamnable, Que ma faute outrageait les vivants et les morts, Et contre ce Tyran a fait de vains efforts.
O pretexte honteux dont mon ame s’abuſe, I’ay failly, j'ay failly, mon front meſme m’accuſe.	Ô prétexte honteux dont mon âme s'abuse, J'ai failli, j'ai failli, mon front même m'accuse.
Si ie n’eſtois coupable, il ne rougiroit point, Vous, que ma paßion outrage au dernier poinct,	Si personne n'étais coupable, il ne rougirait point, Vous, que ma passion outrage au dernier point,
Honneur, couronne, ayeux, n’excuſez plus mia faute, Ie deuois maintenir cette Majeſte haute, Conſeruer l’aſſeurance à ce front couronné, Et mourir dans le rang que vous m'auez donné, Ie deuois eſtouffer vne naiſſante flame, Et ſi le ciel jaloux ne me pourueut d’vne ame Digne de ma naiſſance & du rang que ie tiens, Pour refuſer vn joug & d’indignes liens, Ie deuois pour le moins me faire violence, Cacher vn feu honteux, mourir dans mon ſilence, Et m’arracher pluſtoſt ce vil & laſche cœur, Qu'implorer la mercy d’vn inſolent vainqueur:	Honneur, couronne, aïeux, n'excusez plus mia faute, Je devais maintenir cette Majeste haute, Conserver l'assurance à ce front couronné, Et mourir dans le rang que vous m'avez donné, Je devais étouffer une naissante flamme, Et si le ciel jaloux ne me pourvut d'une âme Digne de ma naissance et du rang que je tiens, Pour fuser un joug et d'indignes liens, Je devais pour le moins me faire violence, Cacher un feu honteux, mourir dans mon silence, Et m'arracher plutôt ce vil et la cœur, Maimplorer la ce v insolent vainqueur:
Que ſçay-je ſi deſia cette eſtrange ouuerture Aura fait a ma gloire vne mortelle injure?	Que sais-je si déjà cette étrange ouverture Aura fait à ma gloire une mortelle injure?
Si l’ingrat l’a receuë auecque du meſpris, Et ſi ſans le combat il dedaigne le prix, Peut eſtre que deſia tes flames importunes Paſſent dans ſon eſprit pour ſes moindres fortunes, Et qu’il conte vne Reyne entre mille beautés, De qui la paſsion flatte ſes vanités:	Si l'ingrat l'a reçue auecque du mépris, Et si sans le combat il dédaigne le prix, Peut être que déjà tes flammes importunes Passent dans son esprit pour ses moindres fortunes, Et qu'il conte une Reine entre mille beautés, De qui la passion flatte ses vanités:
Ah!	Ah!
ſi tu ſoupirois pour vn mal volontaire, Helene tu deuois ou mourir ou le taire:	si tu soupirais pour un mal volontaire, Hélène tu devais ou mourir ou le taire:
Estaindre pour iamais, ou cacher ton flambeau, Et ne le pouuant plus l’eſtouffer au tombeau.	Étaindre pour jamais, ou cacher ton flambeau, Et ne le pouvant plus l'étouffer au tombeau.
O protecteur des Roys & Demon tutelaire, Et vous grand Dieu des mers que Corinthe reuere, Vous qui luy fiſtes voye, & viſtes ſes vaiſſeaux Pourquoy pour le ſalut de cette infortunée, N’auez-vous de nos bords deſtourné cét Enee, Qui deſia dans mon ame à ma confuſion, Allume vn plus grand feu que celui d’Ilion.	Ô protecteur des Rois et Démon tutélaire, Et vous grand Dieu des mers que Corinthe révère, Vous qui lui fîtes voie, et et ses vaisseaux Pourquoi pour le salut de cette infortunée, N'avez-vous de nos bords destourné cet Énée, Qui déjà dans mon âme à ma confusion, Allume un plus grand feu que celui d'Ilion.
Si ie deuois bruſler pourquoy dedans ſon ame N'allumiez-vous de meſme.	Si ici devais brûler pourquoi dedans son âme N'allumiez-vous de même.
AMINTE.	AMINTE.
Eſperez-le Madame, Banniſſez cette crainte, & recognoiſſez mieux, Cet amour qui triomphe & brille dans vos yeux:	Espérez-le Madame, Bannissez cette crainte, et reconnaissez mieux, Cet amour qui triomphe et brille dans vos yeux:
Si l’on n’en doit iuger que ſelon l’apparance,	Si l'on n'en doit juger que selon l'apparance,
HELENE.	HELENE.
Dans cette affection i’ay bien peu d’eſperance:	Dans cette affection j'ai bien peu d'espérance:
Et j’ay d’vn mal prochain cent preſages mauuais:	Et j'ai d'être mal prochain cent presages mauvais:
Cent triſtes viſions, cent ſonges que i'ay faits, Menacent cest amour d’vne funeste iſſuë, Grãds Dieux ſi dans ma peurie ne ſuis point deceüe, Et ſi vous haïſſez vn feu qui me fait tort, Enuoyez moy bien-tost le remede ou la mort.	Cent tristes visions, cent songes que j'ai faits, Menacent cet amour d'une funeste issue, Grands Dieux si dans ma peurie ne suis point déçue, Et si vous haïssez un feu qui me fait tort, Envoyez moi bientôt le remède ou la mort.
.	.
.	.
.	.
.	.
.	.
	
ACTE	ACTE
1I A L F2 SCENE PREMIERE, TIMANDRE, PHALANTE, PHILOXENE.	1I À L F2 SCÈNE PREMIÈRE, TIMANDRE, PHALANTE, PHILOXENE.
TIMANDRE.	TIMANDRE.
OVS ſerions tropingrats à tant de bons offices, &Dont vous aueZ deſia preuenu nos ſeruices, Si nous ne vous preſsions pour apprendre de vous La cauſe d’vn chagrin qui nous afflige tous, Vous eſtes tout changé d’humeur & de viſage, Et ie cognois trop bien ce genereux courage, Qui s’eſt touſiours muny d’vne haute vertu, Et que tant de reuers ont en vain combatu, Pour craindre que des maux de ſi peu d’importance, En puiſſent esbranler l’inuincible conſtance:	OUS serions tropingrats à tant de bons offices, eTDont vous avez déjà prévenu nos services, Si nous ne vous pressions pour apprendre de vous La cause d' chagrin qui nous afflige tous, Vous êtes tout changé d'humeur et de visage, Et ie Tognais trop bien ce généreux courage, Qui s'est toujours muni d'une haute vertu, Et que tant de revers ont en vain combattu, Pour craindre que des maux de si peu d'importance, En puissent ébranler l'invincible constance:
Si des rebellions ont troublé voſtre Eſtat, --- -----------.	Si des rébellions ont troublé votre État, -bel-elle --.
2	2
Si vons auez perdu voſtre premier eſtat, Et s’il vous faut ceder au malheur d’vne guerre, Qui vous fait eſloigner de voſtre ingrate terre:	Si vons avez perdu votre premier état, Et s'il vous faut céder au malheur d'une guerre, Qui vous fait éloigner de votre ingrate terre:
Pour le moins voſtre ſort me paroist aſſez doux Dans le port aſſeuré qu’il vous offre chez nous Icy tout vous adore & jamais autre prince, Ne fut plus reueré dans ſa propre prouince, Voſtre vertu d’abord à produit mille effets, Vous a gaigné des cœurs, vous a fait des ſubjets Vous a fait ſurmonter & l’enute & la haine, Et vous aſi bienmis dans l’eſprit de la Reyne, Que pour cette bonté qui les oblige tous, Les Princes du pays n'ont plus recours qu'à vous;	Pour le moins votre sort me paraît assez doux Dans le port assuré qu'il vous offre chez nous Ici tout vous adore et jamais autre prince, Ne fut plus révéré dans sa propre province, Votre vertu d'abord à produit mille effets, Vous a gagné des cœurs, vous a fait des sujets Vous a fait surmonter et l'enute et la haine, Et vous azy bienmis dans l'esprit de la Reine, Que pour cette bonté qui les oblige tous, Les Princes du pays n' vous plus recours qu'à vous;
Meſmes vos intereſts l’ont ſi fort animée, Qu'elle rompt l’alliance, & forme vn corps d’armée:	Mesmes vos intérêts l'ont si fort animée, Qu'elle rompt l'alliance, et forme un corps d'armée:
Vous donnant le ſecours qu’elle vous a promis, Pour vous aller ſeruir contre vos ennemis.	Vous donnant le secours qu'elle vous a promis, Pour vous aller servir contre vos ennemis.
Phalante ces raiſons me font aſſez cognoiſtre, – Que ce nouueau chagrin que vos yeux font paroiſtre:	Phalante ces raisons me font assez con, Que ce na chagrin que vos yeux font re,
Et la viue douleur qui vous change à ce poinct, On eſueveno dumnequejenemuemaue me jpunons points Si l’amitié jurée, & quelque experience, Ont merité l’honneur de voſtre confidence, Ne dißimulez-plus à des amis diſcrets, Vos ſoings plus importans, & vos maux plus ſecrets.	Et la vive douleur qui vous change à ce point, On esueveno dumnequejenemuemaue me jpunons points Si l'amitié jurée, et quelque expérience, Ont mérité l'honneur de votre confidence, Ne dissimulez-plus à des amis discrets, Vos soings plus importants, et vos maux plus secrets.
PHILOXENE.	PHILOXENE.
Quelques vaines raiſons que ſa froideur m’oppoſe, Si Phalante pouuoit me cacher quelque choſe, I'aurois ſubjet de plainté, & croirois deſormais, N’en eſtant plus aymé qu’il ne m’ayma jamais.	Quelques vaines raisons que sa froideur m'oppose, Si Phalante pouvait me cacher quelque chose, J'aurais sujet de plainté, et croirais désormais, N'en étant plus aimé qu'il ne m'aima jamais.
Ie vous coniure donc par toute la franchiſe, Et toute l’amitié que vous m’aisez promiſé, De ne me cacher plus ce qui me fait mourir, Et pour vous ſoulager s’il ne faut que perir, S’il ne faust prodiguer que mon ſang & ma vie, Joyes fres-aſpenre qiees enomſte d ennte, Et que pour vous ſeruir i embraſſeray la mort.	Je vous conjure donc par toute la franchise, Et toute l'amitié que vous m'ayez promisé, De ne me cacher plus ce qui me fait mourir, Et pour vous soulager s'il ne faut que périr, S'il ne faût prodiguer que mon sang et ma vie, Joyes fres-sipenre qières enste d ennte, Et que pour vous servir y embrasserai la mort.
PHALANTE.	PHALANTE.
C’eſt aſſez, cher amy, ce penſer me fait tort:	C'est assez, cher ami, ce penser me fait tort:
Et vous aueZ bleſſé l’amitié qui nous lie En ſouffrant ce ſoupçon de ma melancholie, Mon cœur vous eſt ouuert les Dieux m'en ſont teſmoings:	Et vous avez blessé l'amitié qui nous lie En souffrant ce soupçon de ma mélancolie, Mon cœur vous est ouvert les Dieux m'en sont témoins:
Mais c’eſt vostre malheur qui cauſeras mes ſoings, Voſtre ſeul deſplaiſir fait naiſtre ma triſteſſe, Et dans vos paſsions mon ame s’intereſſe, Et reſſent vos ennuys auec tant de douleur Que vos moindres ſoucis me touchent iuſqu’au cœur, Ie meurs du deſplaiſir de vous estre inutile, De prier-vainement vn eſprit- indocile;	Mais c'est votre malheur qui causeras mes soings, Votre seul déplaisir fait naître ma tristesse, Et dans vos passions mon âme s'intéresse, Et ressent vos ennuis ssez tant de douleur Que vos moindres soucis me touchent jusqu'au cœur, Je meurs du déplaisir de vous être inutile, De prier-vainement un esprit- indocile;
Et de voir qu’en l’eſtat où vous eſtes reduit I'intercede pour vous auec ſi peu de fruit;	Et de voir qu'en l'état où vous êtes réduit J'interçède pour vous avec si peu de fruit;
Si la Reyne agreoit vos fideles ſeruices, Mon ame en vous ſeruant gouſteroit ſes delices, a----------------	Si la Reine agréait vos fidèles services, Mon âme en vous servant goûterait ses délices, a-
Et preferant ainſi vos intereſts aux miens, Elle oublieroit ſes maux pour reſſentir vos biens:	Et préférant ainsi vos intérêts aux miens, Elle oublierait ses maux pour ressentir vos biens:
De tous mes deſplaiſirs voila la ſeule cauſe, Pour m'affliger ſi fort mes maux ſont peu de choſe, Et ie n'ay reſſenty que des coups bien legers, En perdant des honneurs & des biens paſſagers:	De tous mes déplaisirs voilà la seule cause, Pour m'affliger si fort mes maux sont peu de chose, Et quelque n'ai ressenti que des coups bien légers, En perdant des honneurs et des biens passagers:
Quoy qu'ayt fait contre moyla fortune outrageuſe La mienne au pres de vous eſt trop auantageuſe, T'aime trop Philoxene & l’amitié des ſiens Pour regretterencor la perte de mes biens:	Quoi qu'ait fait contre moila fortune outrageuse La mienne au pres de vous est trop avantageuse, T'aime trop Philoxène et l'amitié des siens Pour regrettercor la perte de mes biens:
Ce lien qui nous joint d’vne amitié parfaite A de tant de bon-heur honoré ma retraite, Que ie croirois mon ſort plus heureux que jamais, Si pour vous le bon-heur ſecondoit mes ſouhaits, Et ſi de vos malheürs mon ame combatuë.	Ce lien qui nous joint d'une amitié parfaite A de tant de bonheur honoré ma retraite, Que ie croirais mon sort plus heureux que jamais, Si pour vous le bonheur secondait mes souhaits, Et si de vos malheürs mon âme combattues.
Ne reſſentoit pour vous,	Ne ressentait pour vous,
PHILOXENE.	PHILOXENE.
Ah!	Ah!
ce diſcours me tuë:	ce discours me tue:
Iuſte ciel falloit-il pour comble de douleur, Qu'vn innocent amy partageât mon malheur, Et que n’ayans qu'vn cœur & qu’vne ame commune, Nous ne deuſsions auoir qu’vne meſme fortune?	Juste ciel fallait-il pour comble de douleur, Qu'une innocent ami partageât mon malheur, Et que n'ayants qu'un cœur et qu'une âme commune, Nous ne devons avoir qu'une seule fortune?
Certes, de tous les coups de mon ſort rigoureux C’eſt là le plus ſenſible & le plus douloureux, Et mon mal ne pouuoit venir au poinct extreme, Qu'en ſe communtquant à cet autre moy-meſme.	Certes, de tous les coups de mon sort rigoureux C'est là le plus sensible et le plus douloureux, Et mon mal ne pouvait venir au point extrême, Qu'en se communtquant à cet autre moi-même.
Malheureux Philoxene, Amant infortuné, Regarde à quelle fin le ciel t'a deſtiné, Voy de quelle rigueur ſa cholere t’accable, Il fait de ta miſere vn autre miſerable:	Malheureux Philoxène, Amant infortuné, Regarde à quelle fin le ciel t'a destiné, Vois de quelle rigueur sa colère t'accable, Il fait de ta misère un autre misérable:
Et punit de ta faute vn innocent amy, Pour voir perir vntout qui ſouffroit à demy.	Et punit de ta faute un innocent ami, Pour voir périr untout qui souffrait à demi.
Ah!	Ah!
Phalante, c’'eſt trop, & ie hay trop ma vie, Dans les maux eternels dont ie la voy ſiiute, Pour ſouhaitter encor qu'elle duré a ce prix, Laiſſons, laiſſons Helene auecque ſes mépris:	Phalante, ç'est trop, et iepray trop ma vie, Dans les maux éternels dont ie la voyons siivte, Pour souhaiter encor qu'elle duré à ce prix, Laissons, laissons Hélène auecque ses mépris:
S’ils ne m'ont pû guerir que la mort m’en deliure, Mon amour l’importune & ie ſuis las de viure.	S'ils ne m'ont pu guérir que la mort m'en délivre, Mon amour l'importune et ie suis las de et.
Philoxene au tombeau n'importunera plus La Reyne & ſonamy par des ſoins ſu perflus, Et le profond repos qu’il gouſtera luy-meſme, Dans vn meſme repos mettra tout ce qu'il aymne.	Philoxène au tombeau n'importunera plus La Reine et sonami par des soins su perflus, Et le profond repos qu'il goûtera avait-même, Dans un moment repos mettra tout ce qu'il aimène.
TIMANDRE.	TIMANDRE.
La Reyne le mepriſe auec peu de raiſon, Elle doit mieux traitter vne illuſtre maiſon:	La Reine le méprise avec peu de raison, Elle doit mieux traiter une illustre maison:
Et juger quelque rang qu’vn changement nous donne, Qu’autrefois nos ayeulx ont porté ſa couronne, Ie ſuis ſubjet, mais Prince, & ſon pere en mourant Fit de noſtre maiſon vn cas bien different, Et mettant en mes mains ſon Sceptre & ſa famille, Il me nomma Regent & Tuteur de ſa fille:	Et juger quelque rang qu'une changement nous donne, Qu'autrefois nos aieulx ont porté sa couronne, Je suis sujet, mais Prince, et son père en mourant Fit de notre maison un cas bien différent, Et mettant en mes mains son Sceptre et sa famille, Il me nomma Regent et Tuteur de sa fille:
Quelque faiſte d’honneur où ie fuſſe monté, --	Quelque faîte d'honneur où tu fusse monté, --
C iij Ie n’abuſayjamais de cette authorité.	Ç Cij à n'abusaijamais de cette autorité.
Ie pouuois au deſpens d’vne foible jeuneſſe, Agrandir ma maiſon des biens que ie luy laiſſe:	Je pouvais au dépens d'une faible jeunesse, Agrandir ma maison des biens que ielui laisse:
Et me rendre ſi grand qu’elle eut bien ſouhaitté, Celuy qu'elle rejette auec.	Et me rendre si grand qu'elle eut bien souhaité, Celui qu'elle rejette auec.
indignité, Mais le cielm'eſt teſmoin qu'e ma charge importune, Ie ne conſideray ny moy ny ma fortune:	indignité, Mais le cielm'est témoin qu'e ma charge importune, Je ne considéra y moiurs ma fortune:
Et quoy que ce pays deuſt beaucoup à mes ſoins, Que de tous mes voiſins i'y profitay le moins, Certes ſa Majeſté le deuroit mieux cognoiſtre Depimbe grumcomuproiuuuonons ſuit paroiſtrt Et mieux-conſiderer le merite & le ſang, De ceux qui dans l’Eſtat tiennent le premier rang.	Et quoi que ce pays dût beaucoup à mes soins, Que de tous mes voisins j'y profitay le moins, Certes sa Majesté le devrait mieux connaître Dépimbe grumcomuproiuuuonons suit paraîtrait Mieux mieux -considérer le mérite et le sang, De ceux qui dans l'Estat tiennent le premier rang.
PHALANTE.	PHALANTE.
Il m’eſt encor reſte quelque peu d’eſperance, Qu'on la pourra gaigner par la perſeuerance;	Il m'est encor reste quelque peu d'espérance, Qu'on la pourra gagner par la persévérance;
Et je croy qu'à la finſon ame ſe rendra, Du moins pour vous ſeruir Phalante ſe perdra:	Et je crois qu'à la finson âme se rendra, Du moins pour vous servir Phalante se perdra:
Et quand pour ce deſſein il donneroit ſa vie, I'l la croira toujours heureuſement raute, Si le cielluy permet de la perdre pour vous;	Et quand pour ce dessein il donnerait sa vie, J'l la croira toujours heureusement raute, Si le ciellui permet de la perdre pour vous;
PHILOXENE.	PHILOXENE.
O Dieu!	Ô Dieu!
qu’e mes malheurs ce ſouuenir m’eſt doux, Et que j’ay de bonheur parmy tant de diſgrace, D'au oirfait vn amy ---- - -	qu'e mes malheurs ce souvenir m'est doux, Et que j'ai de bonheur parmi tant de disgrâce, D'au oirfait un ami -- -ur
PHALANTE.	PHALANTE.
Souffrez que ie vous chaſſe:	Souffrez que je vous chasse:
A dieu laiſſez moy ſeul y reuer vn moment, Vous trouuerez la Reyne en ſon appartement.	À dieu laissez -moi seul y rêver moment, Vous trouverez la Reine en son appartement.
SCENE II.	SCÈNE II.
ARBANTE, PHALANTE.	ARBANTE, PHALANTE.
ARBANTE.	ARBANTE.
Eigneur de quelque ſoing que vostre ame agitée, Déguiſe la douleur dont elle eſt tourmentée, Ie voy bien au trauers de ce déguiſement, Ce qu’à ma paßion vous cacheZ vainement.	Eigneur de quelque soin que votre âme agitée, Déguise la douleur dont elle est tourmentée, Je vois bien au travers de ce déguisement, Ce qu'à ma passion vous cachez vainement.
Pardonnez-moy Seigneur, ſi ie vous importune, Mais vous n’aureZ jamais de mauuaiſé fortune, Que momnipouvommonoppemne amce doits, Si pours en décharger vn maldeuient pliss doux, Et ſi vous conſerueZ encor quelque memoire, D'vne fidelité qui fut toute ma gloire, RecompenſeZ Seigneur, ces preuues de ma foy.	Pardonnez-moi Seigneur, si je vous importune, Mais vous n'aurez jamais de mauvaisé fortune, Que momnipouvommonoppemne amce doits, Si pours en décharger un maldeuient pliss doux, Et si vous conservez encor quelque mémoire, D'une fidélité qui fut toute ma gloire, RecompenseZ Seigneur, ces prévues de ma foi.
PHALANTE.	PHALANTE.
Ie n’ay rien à te dire, Arbante laiſſe m oy,	Je n'ai rien à te dire, Arbante laisse m oi,
PHALANTE ſeul.	PHALANTE seul.
Nfin ie reſte ſeul, & cette ingrate flame, QQui ſans aucuneſpoir tiranniſe mon âme, Peut enfin éclater à la clarté de cieux, Chers teſmoins de mon mal, triſtes & ſombres lieux, Vous que i’ay ſeuls jugeZ capables d’vn ſilence, Digne de monſecret & de ma confidence:	Nfin iemme seul, et cette ingrate flamme, QQui sans aucunespoir tyrannise mon âme, Peut enfin éclater à la clarté de cieux, Chers témoins de mon mal, tristes et sombres lieux, Vous que j'ai seuls jugés capables d'un silence, Digne de monsecret et de ma confidence:
Puis qu'à vous ſeulement t'éuente mes regrets, De grace en ma faueur ſoyez touſiours ſecrets;	Puis qu'à vous seulement t'évente mes regrets, De grâce en ma faveur soyez toujours secrets;
Et ne parlez jamais de ce malheur extreme, Que mon ame a regret d’auouer a ſoy-meſme.	Et ne parlez jamais de ce malheur extrême, Que mon âme a regret d'avouer a soi-même.
Ciel qui penetreZ ſeul mes plus cachez ennuis, Vis-tu jamais vn homme en l’eſtat où ie ſuis?	Ciel qui penetreZ seul mes plus cachés ennuis, Vis-tu jamais un homme en l'état où tu suis?
Et toy, dont les rayons eſclairent tout le monde, Cognois-tu de fortune à la mienne ſeconde?	Et toi, dont les rayons éclairent tout le monde, Connais-tu de fortune à la mienne seconde?
Dans l’eſtat de plorable où mon deſtin m'amis, Ie ſuis le plus cruel de tous mes ennemis.	Dans l'état de plorable où mon destin m'amis, Je suis le plus cruel de tous mes ennemis.
I'ayme, & ie ſuis aymé, mais mon malheur extreme Me vient de mon amour, me vient de ce qu’on m'ayme, Et ie ne ſerois pas malheureux à ce point Si l’on ne m'aymois pas & ſi ie n'aymois point.	J'aime, et je suis aimé, mais mon malheur extrême Me vient de mon amour, me vient de ce qu'on m'aime, Et apprendre ne serais pas malheureux à ce point Si l'on ne m'aimais pas et si je n'aimais point.
L’amitié ----.	L'amitié --elle.
.	.
.	.
	
L’amitié m’areduit à ce point de miſere, Que dans ma paſsion j’ay plus que ie n'eſpere.	L'amitié m'arduit à ce point de misère, Que dans ma passion j'ai plus que sans n'espère.
Mais me ſacrifiant pour le ſalut d’autruy, I'ay ce que ie ſouhaitte, & t'ay ce que ie fuy:	Mais me sacrifiant pour le salut d'autrui, J'ai ce que femme souhaite, et t'ai ce que ie Ami:
Cet amour qui deja tient mon ame captiue, Si ie ne ſuis aymé ne veut pas que ie vtté.	Cet amour qui déjà tient mon âme captive, Si tu ne suis aimé ne veut pas que votre vtté.
On m’ayme, & dans ce bien qui me doit conſeruer Ie rencontre la mort au lieu de me ſauuer.	On m'aime, et dans ce bien qui me doit conserver Je rencontre la mort au lieu de me sauver.
Ces ſoins où ie m'attache auecque tant d’enuie, 25 Seruent moins mon amy qu’ils n'attaquent ma vie, Et faiſant ſurmon ame vn pitoyable effort, En cherchant ſon ſalut ie demande ma mort.	Ces soins où tu m'attache auecque tant d'envie, 25 Servent moins mon ami qu'ils n'attaquent ma vie, Et faisant surmon âme un pitoyable effort, En cherchant son salut un demande ma mort.
Ah!	Ah!
Phalante, ennemy du ſalut de Phalante, Laiſſe, laiſſe en repos ton ame languiſſante, Et deuenant plus doux ne perſecute plus Phalante que tu perds par tes ſoins ſuperflus.	Phalante, ennemi du salut de Phalante, Laisse, laisse en repos ton âme languissante, Et devenant plus doux ne persécute plus Phalante que tu perds par tes soins superflus.
Ce que ton amitié pour Philoxene eſſaye, Ne ſert point tonamy, mais rengrege ta playe, Et t'animant toy-meſme à te perſecuter.	Ce que ton amitié pour Philoxène essaye, Ne sert point tonamy, mais rengrége ta plaie, Et t'animant toi-même à te persécuter.
Tu le rends odieux au lieu de l’aſsiſter.	Tu le rends odieux au lieu de l'assister.
Les interests d’autruy deffendent-ils les noſtres, Et ſe doit-onhair pour bienaymer les autres?	Les intérêts d'autrui défendent-ils les nôtres, Et se doit-onhair pour bienaimer les autres?
Ton amy ſatisfait des preuues de tafoy Ne peux-tu pas auoir quelque amitié pour toy?	Ton ami satisfait des prévues de tafoi Ne peux-tu pas avoir quelque amitié pour toi?
Puis que tous ſes deuoirs ne touchent point la Reyne, Et que pour ſon repos tonaßiſtance est vaine, Pourquoy ton amitiés obſtine deſormais Sans fruit & ſans eſpoir de le ſeruir jamais?	Puis que tous ses devoirs ne touchent point la Reine, Et que pour son repos tonassistance est vaine, Pourquoi ton amitiés obstine désormais Sans fruit et sans espoir de le servir jamais?
2u Crainis-tu que ton amy luy-meſme ne t’excuſe, Qu’il ne te cede point vn bien qu'onluy refuſe, Et qu’il ne ſoit content de te voir poſſeder Ce que ton amitié ne luy peut accorder.	2u Crainis-tu que ton amy luy-même ne t'excuse, Qu'il ne te cède point un bien qu'onlui refuse, Et qu'il ne soit content de te voir posséder Ce que ton amitié ne le peut accorder.
Ah!	Ah!
pardon, amitié mortellement bleſſee;	pardon, amitié mortellement blessée;
Vne ſi criminelle & ſi laſche penſée, Quoy que ma paßion pour elle ait combatu, Eſt indigne d’vn Prince & dément ma vertuLaſcheté qui me tuë & qui me deshonore, Qus oy tu pourras trahir vn amy qui t’adore, Et ſans conſiderer ta vie & ton honneur, Tu pourras ſur ſa perte eſtablir tonbon-heur?	Une si criminelle et si lâche pensée, Quoi que ma passion pour elle ait combattu, Est indigne d'un Prince et dément ma vertuLascheté qui me tue et qui me déshonore, Qus ois tu pourras trahir ain si qui t'adore, Et sans considérer ta vie et ton honneur, Tu as sur sa perte établir tonbon-heur?
Donc ce fidele amy n’aura dans taretraitte, Honoré ton abord d’vne amitié parfaitte, Et ſans autre intereſt que de l’affection;	Donc ce fidèle ami n'aura dans taretraite, Honoré ton abord d'une amitié parfaite, Et sans autre intérêt que de l'affection;
N’aura pris tant de part dans ton affliction, Doncques dans tonmalheur & le fils & le pere;	N'aura pris tant de part dans ton affliction, Doncques dans tonmalheur et le fils et le père;
N’auront de tous leurs biens aßiſté ta miſere, Thonorans cõme vn Dieu dans leur propre maiſon, Que pourſe voir payez par vne trahiſon:	N'auront de tous leurs biens assisté ta misère, Thonorants comme un Dieu dans leur propre maison, Que pourse voir payez par une trahison:
O de tant de bien-faits indigne recompenſe!	Ô de tant de bienfaits indigne récompense!
Beaux effets de tes ſoins & de ton-aſsiſt ance, C’eſt ce qu’ilattendoit de tes nobles deſſeins, Lors qu’ilmit l’innocent, ſa vie entre tes mains, Et qu’il t’ouurit ſon ame auec tant de franchiſe.	Beaux effets de tes soins et de ton-assît ance, C'est ce qu'ilattendait de tes nobles desseins, Lors qu'ilmit l'innocent, sa vie entre tes mains, Et qu'il t'ouvrît son âme auec tant de franchise.
Sur l’eſpoir deceuant d’vne amitié promiſe, Il reſte ſeulement que de ta propre main,	Sur l'espoir décevant d'une amitié promise, Il reste seulement que de ta propre main,
Et portes dans ſon cœur mille atteintes mortelles, Pour ſuiure en liberté tes flames criminelles.	Et portes dans son cœur mille atteintes mortelles, Pour suivre en liberté tes flammes criminelles.
C’eſt le plus doux pour luy, car enfin n'attends pas Qu'il en puiſſe eſtre quitte à moins que du treſpas;	C'est le plus doux pour moins, car enfin n'attends pas Qu'il en puisse être quitte à moins que du trépas;
Que ſe voyant trahy par vn autre ſoy-meſme, Que voyant à ſes yeux enlener ce qu’il ayme:	Que se voyant trahi par un autre soi-même, Que voyant à ses yeux enlener ce qu'il aime:
Quoy que ſa vertu faſſe auec tous ſes efforts, Ce malheureux Amant ne ſouffre mille morts.	Quoi que sa vertu fasse auec jours ses efforts, Ce malheureux Amant ne souffre mille morts.
Ah!	Ah!
ne reueneZ plus lâche, lâche pensee, Fuyez d’vne vertu que vous aueZ bleſſée:	ne reueneZ plus lâche, lâche pensée, Fuyez d'une vertu que vous avez blessée:
L’amour & Philoxene ont partagé mon cœur, Mais l’amour eſt vaincu, Philoxene vainqueur, L’amour ſeul eſt trop foible, & quoy qu’il me prepare, Enfin pour mon amy ma vertu ſe declare:	L'amour et Philoxène ont partagé mon cœur, Mais l'amour est vaincu, Philoxène vainqueur, L'amour seul est trop faible, et quoi qu'il me prépare, Enfin pour mon ami ma vertu se déclare:
Il eſt aſſez puiſſant l’ayant de ſon party.	Il est assez puissant l'ayant de son parti.
Ce que ma paſsion peut contre mon amy, Malgré ſa violence, & ſon pouuoir ſupreme, Ma vertu qui le ſert le fait contre elle-meſme:	Ce que ma passion peut contre mon ami, Malgré sa violence, et son pouvoir suprême, Ma vertu qui le sert le fait contre elle-même:
Philoxene reuien, amy tu m'as vaincu, Et ſi pourton repos j’ay deſia trop veſcu, Si ma preſence nuit à tabonne fortune, Ie ſçauray retrancher vne vie importune, Auant que mon amour t'oblige à me hair, Et que ce meſme amour me force à te trahir.	Philoxène revien, ami tu m'as vaincu, Et si pourton repos j'ai déjà trop vécu, Si ma présence nuit à tabonne fortune, Je saurai retrancher une vie importune, Avant que mon amour t'oblige à me haïr, Et que ce même amour me force à te trahir.
Mais j'apperçois la Reyne, ô rencontre cruelle!	Mais j'aperçois la Reine, ô rencontre cruelle!
Que dois-je deuenir, dois-je m'eſloigner d'elle?	Que dois-je devenir, dois-je m'éloigner d'elle?
Euite ſon abord, fuy miſerable fuy	Euite son abord, fui misérable fui
Dij	Dij
SCENE IV HELENE, CLEONE, PHALANTE.	SCÈNE IV HELENE, CLEONE, PHALANTE.
HELENE.	HELENE.
E vois-je pas Phalante?	E vois-je pas Phalante?
CLEONE.	CLÉONE.
Oüy Madame, c’eſt luy.	Oui Madame, c'est lui.
PHALANTE.	PHALANTE.
Mais ie ſuis découuert, ah!	Mais ici suis découvert, ah!
deffends toy, mon ame, Arme toy de vertu, cache, cache ta flame, Et ne relâche point de tes premiers deſſeins,	défends toi, mon âme, Arme toi de vertu, cache, cache ta flamme, Et ne relâche point de tes premiers desseins,
22Eu a leus.	22Eu a lus.
Quoy tu trembles mõ cœur!	Quoi tu trembles mon cœur!
quoy mon ame tu crains!	quoi mon âme tu crains!
Et ſembles redouter la mortelle ſentence:	Et sembles redouter la mortelle sentence:
Mais le voicy l’ingrat, arme toy de conſtance.	Mais le voici l'ingrat, arme toi de constance.
PHALANTE.	PHALANTE.
Ie craignois d’approcher de voſtre Majeſté, Et m'allois retirer dans ce bois eſcarté, Pour n'interrompre point vos ſecrettes penſees.	Je craignais d'approcher de votre Majesté, Et m'allais retirer dans ce bois écarté, Pour n'interrompre point vos secrètes pensées.
.	.
*---- --- t--	*- -on- t-
HELENE.	HELENE.
Ah!	Ah!
Phalante, à vous ſeul elles ſont adreſſees, Et ſi la ſolitude a pour moy rien de doux, Ie l’ayme ſeulement pour mieux ſonger à vous.	Phalante, à vous seul elles sont adresse, Et si la solitude a pour moi rien de doux, Je l'aime seulement pour mieux songer à vous.
De puis que pour vous ſeul mon eſprit eſt malade, Ie gouſte des douceurs dans cette promenade, Qui me font oublier le ſoing de mes eſtats, Pour trouuer du repos loing de tant d’embarras, C’eſt icy que ie cherche a reſuer & me plaindre, Et ce n'eſt que pour vous, il n’est plus temps de feindre.	De puis que pour vous seul mon esprit est malade, Je goûte des douceurs dans cette promenade, Qui me font oublier le soing de mes états, Pour trouver du repos loin de tant d'embarras, C'est ici que un cherche a rêver et me plaindre, Et ce n'est que pour vous, il n'est plus temps de feindre.
I’ay tout franchy Phalante, & ie vous ay fait voir, Malgré l’honneur du ſexe, & malgré mon deuoir, Forçant mon naturel, monſilence & ma crainte, De quelle paßion mon ame eſtoit atteinte:	J'ai tout franchi Phalante, et je vous ai fait voir, Malgré l'honneur du sexe, et malgré mon devoir, Forçant mon naturel, monsilence et ma crainte, De quelle passion mon âme était atteinte:
Ie n'en ay que trop dit, & quelque affection Qui puiſſe anthoriſer vne indigne action, Ie deuois conſeruerce pouuoir ſur mon ame, De ſouffrir ſans parler, ou de mourir ſans blâme:	Je n'en ai que trop dit, et quelque affection Qui puisse anthoriser une indigne action, Je devais conserverce pouvoir sur mon âme, De souffrir sans parler, ou de mourir sans blâme:
I'ay fait vne baſſe indigne de mon rang, Qui bleſſe ma beauté, mon courage & mon ſang, Et vous donne ſans doute vne injuſte croyance, D'vne facilité dont ma vertu s’offence.	J'ai fait une basse indigne de mon rang, Qui blesse ma beauté, mon courage et mon sang, Et vous donne sans doute une injuste croyance, D'une facilité dont ma vertu s'offense.
Mais ſi vous le pouuez apres l’impreßion Qu’aura fait ſur vostre ame vne telle action, Ne ſouffrez point de grace vn penſer qui m’outrage, Et ne ſoupçonneZ rien à mon deſauantage, ---– - - - --–	Mais si vous le pouvez après l'impression Qu'aura fait sur votre âme a telle action, Ne souffrez point de grâce un penser qui m'outrage, Et ne soupçonnez rien à mon désavantage, - - - - -
Je vous ayme, & mon mal vous eſt aſſeZ connu:	Je vous aime, et mon mal vous est assez connu:
Mais à quelque degré qu’il ſoit déja venu, Quelque tranſport eſtrange, & quelque violence, Qui contre mon deuoir ayt rompu mon ſilence, La plus haute vertu ne ſe peut offencer, De mon plus criminel & plus laſche penſer, Et ie puis eſperer ſans reproche & ſans blâme, Le remede du mal, & le repos de l’ame:	Mais à quelque degré qu'il soit déjà venu, Quelque transport étrange, et quelque violence, Qui contre mon devoir ait rompu mon silence, La plus haute vertu ne se peut offenser, De mon plus criminel et plus lâche penser, Et ainsi puis espérer sans reproche et sans blamè, Le de du mal, et le repos de l'âme:
Eſtant ſi bien inſtruit de mon intention, ue ne reſpondeZ-vous à mon affection, Que ne m’appreneZ-vous ce que i’en puis attendre, nopne prente, o Dieumonimo be pum trop comprendre, Vous en eſtes confus, vous rougiſſez pourmoy, Et ce diſcours muët m'apprend ce que ie doy.	Étant si bien instruit de mon intention, ue ne répondez-vous à mon affection, Que ne m'appreneZ-vous ce que j'en puis attendre, nopne prente, ô Dieumonimo be pum trop comprendre, Vous en êtes confus, vous rougissez pourmoy, Et ce discours muet m'apprend ce que ie doy.
PHALANTE.	PHALANTE.
Que voſtre Majeſte ne trouue point estrangé, Si par vn tel diſcours mon viſage ſe change, Et ſi ie fais paroistre en cette occaſion, Et mon eſtonnement & ma confuſion.	Que votre Majeste ne trouve point estrangé, Si par un tel discours mon visage se change, Et si je fais paraître en cette occasion, Et mon étonnement et ma confusion.
Ie ſuis ſurpris, Madame, il faut que ie l’auoüe, Et celuy dont le Sort inceſſamment ſe ioüe, En le precipitant dans des aduerſitez, Dont il eſt ſoulagé par vos ſeules bontez, Quoy qu’il receut de vous des graces tres-inſignes, N'attẽdoit pas vn biẽ dont les Dieux ſont indignes.	Je suis surpris, Madame, il faut que ainsi l'auoüe, Et celui dont le Sort incessamment se joue, En le précipitant dans des adversité, Dont il est soulagé par vos seules bontés, Quoi qu'il reçut de vous des grâces très-insignes, N'attendait pas un bien un te Dieux sont indignes.
Cet honneur m'ébloüit, & ie ne le reçoy, Indigne que i'en ſuis que comme ie le doy.	Cet honneur m'ébloüit, et ainsi ne le reçois, Indigne que j'en suis que comme ie le dois.
.	.
.	.
.	.
Vn Dieu rechercheroit ceſte bonne fortune.	Un Dieu rechercheroit cette bonne fortune.
	
CLEONE.	CLÉONE.
Arate es Cleomede.	Arate ô Clomède.
HELENE.	HELENE.
O ſur priſe umportune, Ces gardes ont failly, ie l’auois deffendu.	Ô sur prise omportune, Ces gardes ont failly, tu l'avais défendu.
PHALANTE.	PHALANTE.
Helas!	Hélas!
ſans ce ſecours Phalante eſtoit perdu.	sans ce secours Phalante était perdu.
SCEALVO HELENE.	SCELVO HELENE.
CLEOMEDE.	CLÉOMEDE.
HELENE.	HELENE.
PHalante vne autre fois vous me direZ le reſte, I I'en attends le ſuccez fauorable ou funeſte.	PHalante autre fois vous me direz le reste, I J'en attends le succès favorable ou funeste.
CLEOMEDE.	CLÉOMEDE.
Madame pardonnez noſtre importunité, On n’attend au conſeil que vostre Majesté, Et l’affaire qu'on traitte est aſſeZ importante Pour diuertir vn peu, - .	Madame pardonnez notre importunité, On n'attend au conseil que votre Majesté, Et l'affaire qu'on traite est assez importante Pour divertir un peu, - .
.	.
	
HELENE.	HELENE.
Vous en ſerez, Phalante.	Vous en serez, Phalante.
PHALANTE.	PHALANTE.
Vous me comblez d'hnoneur.	Vous me comblez d'honneur.
HELENE.	HELENE.
Venez, donc auec nous.	Venez, donc auec nous.
Ie ne veux rien oüir ny reſoudre ſans vous.	Je ne veux rien ouïr ni résoudre sans vous.
.	.
–	
Fin du ſecond Acte.	Fin du second Acte.
ACTE	ACTE
A SCENE 2 LMA PREMIERE.	À SCÈNE 2 LMA PREMIÈRE.
PHILOXENE, CLEONE.	PHILOXENE, CLÉONE.
PHILOXENE.	PHILOXENE.
A Refne ayme Phalâne,	À Reine aime Phalâne,
CLEONE.	CLÉONE.
Oüy Seigneur.	Oui Seigneur.
PHILOXENE.	PHILOXENE.
Ab!	Ab!
Cleone, Regarde la douleur que ce diſcours me donne, Et ſi ton amitié ne me peut ſecourir, Du moins n’inuente rien qui me faſſe mourir:	Cléone, Regarde la douleur que ce discours me donne, Et si ton amitié ne me peut secourir, Du moins n'invente rien qui me fasse mourir:
Tu lances ſur ma vie vne mortelle fousdre,  J -------	Tu lances sur ma vie une mortelle fousdre, JOUR --
CLEONE.	CLÉONE.
Aſſeurez vous, Seigneur, qu’auãt que m'y reſoudre, Ie n'ay point épargné ma peine ny mes ſoins, I'ay tout ozé pour vous, les Dieux m’ensõt témoins:	Assurez -vous, Seigneur, qu'avant que m'y résoudre, Je n'ai point épargné ma peine ni os soins, J'ai tout zé pour vous, les Dieux m'ensez témoins:
Et que pour destourner le coup qui vous menace, Ie n’ay point redouté d’encourir ſa diſgracé, I'ay forcé le reſpect & la diſcretion Pour condamner cent fois ſa folle paßion:	Et que pour détourner le coup qui vous menace, Je n'ai point redouté d'encourir sa disgracé, J'ai forcé le respect et la discrétion Pour condamner cent fois sa folle passion:
Et cent fois m'oppoſant à cette amour naiſſante, Contre mes ſentimens i'ay médit de Phalante.	Et cent fois m'opposant à cette amour naissante, Contre mes sentiments j'ai médit de Phalante.
PHILOXENE.	PHILOXENE.
Tu m'offençois Cleone, & quoy que mon ſalut,	Tu m'offensais Cléone, et quoi que mon salut,
CLEONE.	CLÉONE.
Croyez qu'en mes diſcours j’auois v nautre but;	Croyez qu'en mes discours j'avais vautre nautre but;
Et que ie trauaillois à forcer ſon caprice, Qui le luy rend aymable à voſtre preiudice.	Et que ici travaillais à forcer son caprice, Qui le sens rend aimable à votre préjudice.
Ie voulois qu’à ſes yeux il paruſt moins parfait, Et luy repreſentant le tort qu'elle ſe fait, D’aymer vn Eſtranger, & rechercher un Prince, Dépouillé de ſes biens, chaſſé de ſa prouince:	Je voulais qu'à ses yeux il parût moins parfait, Et tu représentant le tort qu'elle se fait, D'aimer un Étranger, et rechercher un Prince, Dépouillé de ses biens, chassé de sa province:
A qui pour toutrecours il ne reſtoit plus rien, Qu’vn refuge chez elle, & d’appuy que le ſien.	À qui pour toutrecours il ne restait plus rien, Qu'un refuge chez elle, et d'appui que le sien.
Ie luy repreſentots vos fideles ſeruices, Le rang que vous teneZ, & mille bons offices, te dans ſes jeunes ans ſa foibleſſe receut, TœDes ſoins de voſtre pere en la charge qu’il eut:	Je te représentots vos fidèles services, Le rang que vous teneZ, et mille bons offices, te dans ses jeunes ans sa faiblesse reçut, TœDes soins de votre père en la charge qu'il eut:
Mais Seigneur ces diſcours ont redoublé ſa flame, Et cette reſiſtance ayant picqué ſoname, Elle s'eſt obstinée auec trop de mé pris, Et contre la raiſon, & contre mes auis.	Mais Seigneur ces discours ont redoublé sa flamme, Et cette résistance ayant piqué sonme, Elle s'est obstinée avec trop de mé pris, Et contre la raison, et contre mes avis.
Et Phalante, IIIIECIEERSDE	Et Phalante, IIIECIERSDE
CLEONE.	CLÉONE.
Ie croy qu’il n’eſt pas inſenſible, Et que sten est formt de nature impaßible, S’il n'a les duretez, d’vn arbre ou d'vn rocher, La Reyne a des appas qui le doiuent toucher.	Je crois qu'il n'est pas insensible, Et que sten est formt de nature impassible, S'il n'a les duretés, d'un arbre ou d'un rocher, La Reine a des appas qui le doivent toucher.
–	
PHILOXENE.	PHILOXENE.
C’eſt aſſeZ, iuſte ciel!	C'est assez, juste ciel!
CLEONE.	CLÉONE.
Gardez moy le ſilence, Vous me perdrieZ, Seigneur.	Gardez -moi le silence, Vous me perdriez, Seigneur.
PHILOXENE.	PHILOXENE.
Vy dan bourcoſfonrunos, Et preuiens cet eſprit de tes bonnes leçons, Mais entrons, ie veux mieux éclaircir mes ſoupçons.	Vi dan bourcosfonrunos, Et préviens cet esprit de tes bonnes leçons, Mais entrons, Seigneur veux mieux éclaircir mes soupçons.
.	.
i- ----- –	y-est --ce
E ii	E ji
SCENE II.	SCÈNE II.
PHALANTE.	PHALANTE.
HELENE dans ſa chambre.	HELENE dans sa chambre.
PHALANTE.	PHALANTE.
Es Dieux me ſont teſmoins que mon ame troublée, De ces exceZ d’honneur dont vous l’auez comblée, N'a pas ſi fort perdu tout ſon raiſonnement, Qu'il ne luy reſte encore aſſeZ de jugement:	Es Dieux me sont témoins que mon âme troublée, De ces excès d'honneur dont vous l'avez comblée, N'a pas si fort perdu tout son raisonnement, Qu'il ne lui reste encore assez de jugement:
Pour cognoiſtre en ce point où ſa gloire s'acheue, A quel faiſte d’honneur voſtre bonté l’éleue, Außi le receuant ainſi que ie le doy, Ce n’eſt pas comme vn bien trop releué pour moy:	Pour connaître en ce point où sa gloire s'achève, À quel faîte d'honneur votre bonté l'éleue, Aussi le receuant ainsi que je le dois, Ce n'est pas comme un bien trop relevé pour moi:
Mais commé vne faueur dont les grandeurs ſupremes, Dont les Dieux immortels ſont indignes eux meſmes, C’eſt la moninfortune, & c'eſt là que je voy Que la haine du ciel eſclate contre moy, Me donnant d’vn bon-heur dont ilm'offre la veuë, Vne eſperance esteinte außi-toſt que conceuë, Sa rigueur me l’offrant me deffend d’en jouir, Et ne me le monſtrant qu’afin de m’esbloüir,	Mais commé une faveur dont les grandeurs suprêmes, Dont les Dieux immortels sont indignes eux -mêmes, C'est la moninfortune, et c'est là que je vois Que la haine du ciel éclate contre moi, Me donnant d'vn d'heur dont ilm'offre la vue, Vé rance éteinte aje-tôt que conçue, Sa rigueur me l'offrant me défend d'en jouir, Et ne me le montrant qu'afin de m'esbloüir,
Par la grandeur du prix il m'en oſte l’enuie, Puis qu’il faut l’acheter par vne chere vie:	Par la grandeur du prix il m'en ôte l'envie, Puis qu'il faut l'acheter par une chère vie:
Car enfin ce treſor ne peut estre pour moy, Qu'en bleſſant ma vertu, qu'en violant ma foy.	Car enfin ce trésor ne peut être pour moi, Qu'en blessant ma vertu, qu'en violant ma foi.
Qu’en noyant l’amitié dans vne lâche haine, Et portant mille morts au ſein de Philoxene.	Qu'en noyant l'amitié dans une lâche haine, Et portant mille morts au sein de Philoxène.
Dure condition qu’il met à mon bon-heur, N’en pouuois-je iouir ſans me perdre d’honneur?	Dure condition qu'il met à mon bonheur, N'en pouvais-je jouir sans me perdre d'honneur?
Sans faire vn parricide & ſouiller ma memoire, Par vne lâcheté ſi ſanglante & ſi noire, Qu'ont fait contre le ciel deux fideles amis:	Sans faire un parricide et souiller ma mémoire, Par un lâcheté si sanglante et si noire, Qu'ont fait contre le ciel deux fidèles amis:
Et pourquoy maintenant ne m'eſt-il pas permis, De payer les bontez d’vne ſi grande' Reyne, 37 Au prix de tout mon ſang, & ſauuer Philoxene?	Et pourquoi maintenant ne m'est-il pas permis, De payer les bontés d'une si grande Reine, 37 Au prix de tout mon sang, et sauver Philoxène?
Ah!	Ah!
Madame, mon front ex prime ma douleur, Et vous pouueZ iuger que ie parle du cœur;	Madame, mon front ex prime ma douleur, Et vous pouvez juger que personne parle du cœur;
Ie vous l’ouure, Madame, & deſſus mon viſage, Vos yeux en peuuent voir la veritable image:	Je vous l'ouvre, Madame, et dessus mon visage, Vos yeux en peuvent voir la véritable image:
Ie ne ſuis point ingrat à vos rares bontez, Ie n'ay point l’œil mauuais ny les ſens hebeteZ, Et de tous les coſtez ie voy bien l’auantage, Dont m'acgordant la veuë on me deffend l’vſage, Mais Dieux!	Je ne suis point ingrat à vos rares bontés, Je n'ai point l'œil mauvais sans les sens hébetés, Et de tous les côtés a voir bien l'avantage, Dont m'acgordant la vue on me défend l'usage, Mais Dieux!
à quoy me ſert cet inſigne bon-heur, S’il m'oſte le repos, & la vie & l’honneur?	à quoi me sert cet insigne bonheur, S'il m'ôte le repos, et la vie et l'honneur?
S’il faut qu'vn amy meure auant que i'en joüiſſe, Et que pour m'eſleuer Philoxene periſſe?	S'il faut qu'un ami meure avant que j'en jouisse, Et que pour m'élever Philoxène périsse?
Ah!	Ah!
Madame, plutoſt parexcez de bonté,	Madame, plutôt parexcès de bonté,
E iij Et puis que ſon repos eſtablit mes delices, Donncz-le a ma priere autant qu'à ſes ſeruices:	 iij à puis que son repos établit mes délices, Donncès-le à ma prière autant qu'à ses services:
C’eſt le plus grand effet de bonne volonté Que ie puiſſe eſperer de voſtre Majeſté, Et ſi voſtre pitié s’accorde à mon enute, En ſauutant mon amy vous me ſauuez la vie.	C'est le plus grand effet de bonne volonté Que je puisse espérer de votre Majesté, Et si votre pitié s'accorde à mon envte, En savutant mon ami vous me sauvez la vie.
HELENE.	HELENE.
Ingrat, ce mot eſchape à cette viue ardeur, Que vous reconnoiſſeZ auec tant de froideur.	Ingrat, ce mot échappe à cette vive ardeur, Que vous reconnaissez auec tant de froideur.
Ingrat, pouuez-vous bien vous oſtiner encore A me perſecuter pour celuy que j abhorre, Et traiter vne Reyne auectant de mépris, En dedaignant vn cœur que vous ſeul aueZ pris.	Ingrat, pouvez-vous bien vous ôtiner encore À me persécuter pour celui que j' abhorre, Et traiter une Reine auectant de mépris, En dédaignant un cœur que vous seul avez pris.
Quoy mon affection eſt donc ſi peu de choſe, Qu'en faueur d’vn amy voſtre ſoinen diſpoſe:	Quoi mon affection est donc si peu de chose, Qu'en faveur d'un ami votre soinen dispose:
Et que vous rejettez comme indigne de vous, Vn plus digne ſujet, d’vn traitement plus doux, Vous croyez m’honorer, m’offrant à Philoxene, Ah!	Et que vous rejettez comme indigne de vous, Un plus digne sujet, d'un traitement plus doux, Vous croyez m'honorer, m'offrant à Philoxène, Ah!
i'en cognois la cauſe, & ſouffre cette peine, Comme le juſte prix d’vne facilité, Que vous deueZ traitter auec indignité Voſtre cœur mé priſant vne gloire fleſtrie, Dedaigne iuſtement vne Amante qui prie, Et par ce traitement m'enſeignant mon deuoir, A la honte pour moy que ie deuois auoir I'ay failly, ie l’auoüe, & puis que ma foibleſſe N’auoit peu reſiſter a ce coup qui me bleſſe Et qu'vn Dieu trop puiſſant me cõtraignit d’aymer, Ma flame pour le moins me deuoit conſommer.	j'en connais la cause, et souffre cette peine, Comme le juste prix d'une facilité, Que vous devez traiter avec indignité Votre cœur mé prisant une gloire flétrie, Dedaigne justement une Amante qui prie, Et par ce traitement m'enseignant mon devoir, À la honte pour moi que ie devais avoir J'ai failly, je l'auoüe, et puis que ma faiblesse N'avait pu résister à ce coup qui me blesse Et qu'un Dieu trop puissant me cõtraignit d'aimer, Ma flamme pour le moins me devait consommer.
Ouy te deuois ſans doute ou mourir ou me taire:	Oui te devais sans doute ou mourir ou me taire:
Mais puis que mon mal-heurfut vn mal neceſſaire, Et que malgré mon rang, mon ſexe, & mon honneur Ma paßion parut en trahiſſant mon cœur.	Mais puis que mon malheurfut un mal nécessaire, Et que malgré mon rang, mon sexe, et mon honneur Ma passion parut en trahissant mon cœur.
Ie ſçauray bien leuer cette honteuſe tache, Qui par mon imprudence à ma gloire s'attache, Et punir ce cœur bas de lauoir entrepris, Et par ſa lâcheté merité vos mépris.	Je saurai bien lever cette honteuse tache, Qui par mon imprudence à ma gloire s'attache, Et punir ce cœur bas de lavoir entrepris, Et par sa lâcheté mérité vos mépris.
PHALANTE.	PHALANTE.
Ah!	Ah!
Madame ceſſez vn diſcours qui me tuë, Pleust à Dieu viſsieZ-vous moname toute nuë, Et vous ferieZ ſans doute vniugement plus doux, Des nobles ſenttmes qu'elle eut touſiours pour vous:	Madame cessez un discours qui me tue, Plût à Dieu vissiez-vous monme toute nue, Et vous feriez sans doute imiugement plus doux, Des nobles sentmes qu'elle eut toujours pour vous:
Si de quelque amitié voſtre bonté m’honore, Loing de la mé priſer, Madame ie l’adore, Et monreſſentiment la voudroit meriter, Parle plus noble prix qui la puiſſe acheter.	Si de quelque amitié votre bonté m'honore, Loing de la mé priser, Madame ie l'adore, Et monressentiment la voudrait mériter, Parle plus noble prix qui la puisse acheter.
Mais ſi voſtre bonté me donne la licence De redire à vos pieds deux mots en ma deffence, Conſi dereZ Madame en l’eſtat où ie ſuis, Et tout ce que ie dois, & tout ce que ie puis.	Mais si votre bonté me donne la licence De redire à vos pieds deux mots en ma défense, Consi dereZ Madame en l'état où je suis, Et tout ce que je dois, et tout ce que je puis.
Suis-je priué du ſens, & croyez vous qu’vn prince Refugié chez vous, chaſſé de ſa prouince, Sans bien & ſans appuy, que vos ſeules bontez, Put refuſer l’honneur que vous luy preſentez?	Suis-je privé du sens, et croyez -vous qu'un prince Refugié chez vous, chassé de sa province, Sans bien et sans appui, que vos seules bontés, Pût refuser l'honneur que vous avez présentez?
T ---.	TIENS -à-.
–-	–-
Si pour ſeruir d’obſtacle a ſa bonne fortune, Il n’auoit de raiſon qu’vne raiſon commune, Et pouuoit paruenir à ce dernier bon-heur, Sans perdre Philoxene & ſe perdre d’honneur, ConſidereZ vn peu le nœüd qui nous aſſemble, Que par vn meſme coup nous perirons enſemble, Et qu'vne inuiolable & parfaite amitié, N’en a formé qu’vn tout, dont il eſt la moitié, Outre ce beau lien qui joignit nos deux ames, A moy ſeul il fia le ſecret de ſes flames, Et ce parfait amy commit tout a ma foy.	Si pour servir d'obstacle à sa bonne fortune, Il n'avait de raison qu'une raison commune, Et pouvait parvenir à ce dernier bonheur, Sans perdre Philoxène et se perdre d'honneur, Considèrez un peu le nœud qui nous assemble, Que par un même coup nous périrons ensemble, Et qu'une inviolable et parfaite amitié, N'en a formé qu'un tout, dont il est la moitié, Outre ce beau lien qui joignit nos deux âmes, À moi seul il fia le secret de ses flammes, Et ce parfait ami commit tout à ma foi.
N’attendant ſon ſalut que de vous & de moy.	N'attendant son salut que de vous et de moi.
IugeZ ſi vous pourrieZ me conſeiller vous meſme, De violer ma foy, trahir celui qui m'aime, Et contre ma parole, & contre l’amitié, Maſſacrer mon amy ſans honte & ſans pitié.	Jugez si vous pourriez me conseiller vous -même, De violer ma foi, trahir celui qui m'aime, Et contre ma parole, et contre l'amitié, Massacrer mon ami sans honte et sans pitié.
Ah!	Ah!
Madame apres tout, vous aymez trop la gloire Pour approuuer vous-meſme vne actionſi noire:	Madame après tout, vous aimez trop la gloire Pour approuver vous-même un actions noire:
Et pour m'aymer encor ſi j'auois merité L’honneur que vous m'offrez par vne lâcheté;	Et pour m'aimer encor si j'avais mérité L'honneur que vous m'offrez par une lâcheté;
Certes pour eſtre aymé d’vne ſi grande Reyne, Il faut eſtre ſans tache, & tel que Philoxene, Lu'y feul a merité l’honneur de vous ſeruir, Lu y ſeulmerite vnbien qu’on ne luy peut rauir, Et vous ne pouuez plus ſans faire vne iniustice, Luy refuſer le prix qu’on doit à ſon ſeruice.	Certes pour être aimé d'une si grande Reine, Il faut être sans tache, et tel que Philoxène, Lub'y feu a mérité l'honneur de vous servir, Lu y seulmerite unien qu'on ne lui peut ravir, Et vous ne pouvez plus sans faire une injustice, Lu refuser le prix qu'on doit à son service.
HELE.	HÉLÉ.
HELENE.	HELENE.
Ces diſcours ſu perflus M’aigriſſent contre luy, bien, bien, n’en parlons plus, Deportez-vous d’vn ſoin qui n'est plus neceſſeure;	Ces discours su perflus M'aigrissent contre M, adem, bien, n'en parlons plus, Déportez-vous d'un soin qui n'est plus nécesseure;
Cet importun me nuit, ie ſçauray m'en deffaire, Et le chaſſer ſi loin qu’auant que me reuoir, Peut-eſtre on le verra rentré dans ſon deuoir.	Cet importun me nuit, ie ncaurai m'en défaire, Et le chasser si loin qu'avant que me revoir, Peut-être on le verra rentré dans son devoir.
PHALANTE.	PHALANTE.
Ah!	Ah!
Madame, ſongez.	Madame, songez.
HELENE.	HELENE.
SongeZ pluſtoſt vous-meſme.	Songez plutôt vous-même.
PHALANTE.	PHALANTE.
RE	RE
HELENE.	HELENE.
& Qu'Helene vous ayme.	et Qu'Hélène vous aime.
PHALAREE.	PHALARE.
Le lairrez-vous perir?	Le lairrez-vous périr?
HELENE.	HELENE.
VerreZ-vous mon treſpas?	Verrez-vous mon trépas?
A *- –	À *- -
PHALANTE.	PHALANTE.
Pouuez-vous l’oublier 7 --e	Pouvez-vous l'oublier 7 -
HELENE.	HELENE.
Ne l’oublierez-vous pas?	Ne l'oublierez-vous pas?
PHALANTE.	PHALANTE.
Prieray-je ſans eſpoir?	Prierai-je sans espoir?
HELENE.	HELENE.
PriereZ-vous pour vn autre?	PriereZ-vous pour un autre?
TLIMEANTE.	TLIMEANTE.
L’intereſt que i’y prends.	L'intérêt que j'y prends.
HELENE.	HELENE.
Esteindra-il le voſtre?	Éteindra-il le vôtre?
PHALANTE.	PHALANTE.
Celuy de mon amy ſera touſiours le mien, Le bien qu’on luy fera ſera mon propre bien, Et ſi vous l’honorez d’vne amour parfaite, Vous me rendeZ heureux au poinct que ie ſouhaite;	Celui de mon ami sera toujours le mien, Le bien qu'on lui fera sera mon propre bien, Et si vous l'honorez d'une amour parfaite, Vous me rendez heureux au point que sans souhaite;
C’eſt moy qui ſentiray l’effet de vos bontez, L empeſchant de mourir vous me reſſuſcitez, Et l’eleuant au poinct de ſa gloire ſu preme, A ce dernier bonheur vous m'eleuez moy-meſme.	C'est moi qui sentirai l'effet de vos bontés, L empêchant de mourir vous me ressuscitez, Et l'eleuant au point de sa gloire su preme, À ce dernier bonheur vous m'élevez moi-même.
HELENE.	HELENE.
De portez-vous enfin de ce cruël deſſein, .	De portez-vous enfin de ce cruel dessein, .
*2-	*2-
Ou mẽ porteZ vous-meſme vn poignard dans le ſein.	Ou mon portez -vous-même un poignard dans le sein.
Ce traittement de vous ſera plus ſupportable Que l’outrageux meſpris dont vous eſtes coupable, A cauſe qu’il me nuit vos ſoins officieux A ce cœur irrité le rendent odieux, Autrefois ie l’ay veu ſans meſpris & ſans haine, Maintenant ie meſpriſe, & ie hay Philoxene, Et ſi cet inſolent m’en vient entretenir, De ſa preſompiton ie te ſçauray punir, Et luy faire cognoistre	Ce traitement de vous sera plus supportable Que l'outrageux mépris dont vous êtes coupable, À cause qu'il me nuit vos soins officieux À ce cœur irrité le rendent odieux, Autrefois ainsi l'ai vu sans mépris et sans haine, Maintenant ie apprise, et ainsi ha Philoxène, Et si cet insolent m'en vient entretenir, De sa présompiton ie te saurai punir, Et lui faire connaître
FHALANTE.	FHALANTE.
Ah!	Ah!
Madame.	Madame.
HELENE.	HELENE.
Ah!	Ah!
Phalante.	Phalante.
PHALANTE.	PHALANTE.
Hoffaon pas Jecourir	Hoffaon pas Jécourir
.	.
	
HELENE.	HELENE.
Vne Reyne mourante.	Une Reine mourante.
PHALANTE.	PHALANTE.
Ie fais ce que ie dois	Je fais ce que vertu dois
HELENE.	HELENE.
Ie fais ce que ie puis.	Je fais ce que Que puis.
– --- ---	– --- ---
7	7
PHALANTE.	PHALANTE.
Iusgez de mon deuoir.	Jusgez de mon devoir.
.	.
.	.
HELENE.	HELENE.
Et voyez qui ie ſuis.	Et voyez qui personne suis.
PHALANTE.	PHALANTE.
Vous eſtes en merite enbeauté, grande Reyne, Vn chef-d’œuure du ciel, mais i’ayme Philoxene, Et parma propre mort ie le dois ſecourir, Sauuez-le par pitié.	Vous êtes en mérite enbeauté, grande Reine, Un chef-d'œuvre du ciel, mais j'aime Philoxène, Et parma propre mort ie le dois secourir, Sauvez-le par pitié.
HELENE.	HELENE.
Ie ne puis ſans mourir, Et ſans m’aſſaſsiner vous ne pouueZ encore AH entreiemraelul.	Je ne puis sans mourir, Et sans m'assassiner vous ne pouueZ encore AH entreiemraelul.
PHALANTE.	PHALANTE.
Madame il vous adore.	Madame il vous adore.
HELENE.	HELENE.
Et i’adore Phalante.	Et j'adore Phalante.
PHALANTE.	PHALANTE.
Il meurt.	Il meurt.
HELENE.	HELENE.
Ie meurs auſsi.	Je meurs aussi.
PHALANTE.	PHALANTE.
Que fais-tu miſerable!	Que fais-tu misérable!
eſloigne toy d’icy, Ne perſecute plus vne Reyne qui t'ayme, Ne perds point ton amy, ne te perds point toy-meſme, Amant infortuné, mal-heureux confident, Et ſauue ta vertu d’vn naufrage euident, Elle rend les abois.	éloigne toi d'ici, Ne persécute plus quelque Reine qui t'aime, Ne perds point ton ami, ne te perds point toi-même, Amant infortuné, malheureux confident, Et sauve ta vertu d'un naufrage évident, Elle rend les abois.
HELENE, Enfin l’ingrat balance, Amour en ma faueur témoigne ta puiſſance:	HELENE, Enfin l'ingrat balance, Amour en ma faveur témoigne ta puissance:
Fay grand Dieu quelque effort ſurce cœur endurcy.	Fais grand Dieu quelque effort surce cœur endurci.
PHALANTE, Ie prends congé, Madame, & m'eſloigne d’icy, Pour regretter ailleurs ma mauuaiſe fortune, Qurcote cend mon diſcours Ce me eremrpertare.	PHALANTE, Je prends congé, Madame, et m'éloigne d'ici, Pour regretter ailleurs ma mauvaise fortune, Qurcote cend mon discours Ce mère eremrpertare.
SCENE III	SCÈNE III
HELENE.	HELENE.
J A cruël, va plus loin ſignaler ta rigueur, VEt ſors de ma preſence ainſi que de mon cœur, Je ne veux plus aymer vn ingrat qui me tuë, Contre ma paßion ma vertu s’éuertuë, Et me tirant enfin de mon aueuglement, Fait ceder mon amour à mon reſſentiment, Tes meſpris inſolens ont attiré ma baine, I'ay veſcu, ie veux viure, & veux mourir en Reyne, Et reprendre l’eclat de cette dignité Que ie deshonorois par vne laſcheté.	J' AI cruël, va plus loin signaler ta rigueur, VEt sors de ma présence ainsi que de mon cœur, Je ne veux plus aimer un ingrat qui me tendre, Contre ma passion ma vertu s'évertue, Et me tirant enfin de mon aveuglement, Fait céder mon amour à mon ressentiment, Tes mépris insolents ont attiré ma baine, J'ai vécu, Seigneur veux vivre, et veux mourir en Reine, Et prendre l'éclat de cette dignité Que avoir déshonorais par une lâcheté.
Ce n'eſt qu’en ta faueur que ie me ſuis trahie, Parce que ie t’aymois cruël, tu m’as haie, Receuant vn amour auecque du meſpris, Qui de mille trauaux deuoit eſtre le prix:	Ce n'est qu'en ta faveur que sans me suis trahie, Parce que ici t'aimais cruël, tu m'as haie, Recétant un amour avec du mépris, Qui de mille travaux devait avoir le prix:
Cent Princes mes voiſins, dont la haute puïſſance A cent peuples ſouſmis ſous leur obeiſſance, Plus releuez que toy de merite & de rang.	Cent Princes mes voisins, dont la haute puissance À cent peuples sousmis sous leur obéissance, Plus relevez que toi de mérite et de rang.
La voudroient acheter au prix de tout leur ſang.	La voudraient acheter au prix de tout leur sang.
Ie n'aymois rien que toy, tu m'as ſeul meſpriſée, Ie te donnois mon ame, & tu l’as refuſée, Estimant peu le bien qu'on t'auoit preſenté,	Je n'aimais rien que toi, tu m'as seul méprisée, Je te donnais mon âme, et tu l'as refusée, Estimant peu le bien qu'on t'avait presenté,
Parce qu’on te l’offroit ſans l’auoir merité:	Parce qu'on te l'offrait sans l'avoir mérité:
Mais ne t’abuſe plus monſtre d’ingratitude, I'ay briſe cette laſche & vile ſeruitude, Vn moment m'a guerie, & mon cœur ſatisfait, Pour reparer ſa faute, abhorre qui le hait.	Mais ne t'abuse plus montre d'ingratitude, J'ai brise cette lâche et vile servitude, Un moment m'a guérie, et mon cœur satisfait, Pour réparer sa faute, abhorre qui le hait.
C’eſt par aueuglement que te fus embraſée!	C'est par aveuglement que te fus embrasée!
Ie te treuuois aymable, & i'eſtois abuſée.	Je te trouvais aimable, et j'étais abusée.
Ma raiſon qui reuient fait voir à mon eſprit, 47 Luy monſtrant tes deffaux, l’erreur qui le ſurprit.	Ma raison qui revient fait voir à mon esprit, 47 Lui montrant tes défauts, l'erreur qui le surprit.
La cognoiſſance enfin de mon ame t'efface, L’aueuglement t’y mit, & laraiſon t’enchaſſe, Te rendant odieux à cet eſprit remis Plus que le plus cruël,de tous mes ennemis, Foibles raiſonnemens dont ie me fortifie, RetireZ-vous de moy, l’inſolent m’en défie, En vain voſtre ſecourseme le rend odieux, Et ſi-toſt que l’ingrat reuient deuant mes yeux, Quelque reſſentiment dont ie ſois animée, Foibles raiſonnemens vous alleZ en fumée.	La connaissance enfin de mon âme t'efface, L'aveuglement t'y mit, et laraison t'enchasse, Te rendant odieux à cet esprit remis Plus que le plus cruël,de tous mes ennemis, Faibles raisonnements dont quelque me fortifie, RetireZ-vous de moi, l'insolent m'en défie, En vain votre secourseme le rend odieux, Et sitôt que l'ingrat reuient deuant mes yeux, Quelque ressentiment dont je sois animée, Faibles raisonnements vous allez en fumée.
Pardonne, cher Phalante, à ma temerité, Crois que ie me repens de l’auoir attenté, Et ſi dans mon tranſport i’ay fait quelque blaſpheme, Que mon reſſentiment l’a fait contre moy-meſme.	Pardonne, cher Phalante, à ma témérité, Crois que je me repens de l'avoir attenté, Et si dans mon transport j'ai fait quelque blâme, Que mon ressentiment l'a fait contre moi-même.
Ie t’ayme tout cruël & tout mécognoiſſant, Et cette viue ardeur que mon ame reſſent, Quelque exceZ de malheur dont elle ſoit ſuiuie, Ne treuisera de fin qu'en celle de ma vie.	Je t'aime tout cruel et tout méconnaissant, Et cette vive ardeur que mon âme ressent, Quelque excès de malheur dont elle soit suivie, Ne treuisera de fin qu'en celle de ma vie.
En vain de ces deſdains tu t’armes contre moy, Ce cœur ſi mal traité n’à brûlé que pour toy,  Rien ne peut partager vne ame toute entiere, Et ſa premiere ardeur doit eſtre la derniere.	En vain de ces dédains tu t'armes contre moi, Ce cœur si mal traité n'à brûlé que pour toi, Rien ne peut partager une âme toute entière, Et sa première ardeur doit être la dernière.
Helene, pauure Helene, a quoy te reſous-tu?	Hélène, pauvre Hélène, à quoi te résous-tu?
Songes à ce que tu fais, r'appelles ta vertu, Et par des actions fatales à ta gloire Ne deshonore point vne illuſtre memoire, Reuien à ton deuoir, ſonge à ce que tu fus, Ah!	Songes à ce que tu fais, rappelles ta vertu, Et par des actions fatales à ta gloire Ne déshonore point une illustre mémoire, Revien à ton devoir, songe à ce que tu fus, Ah!
raiſon, ah!	raison, ah!
deuoir, ne m’importuneZ plus, De vos foibles conſeils mon ame eſt incapable, 1.	devoir, ne m'importunez plus, De vos faibles conseils mon âme est incapable, 1.
Et pour vous eſcouter Phalante eſt trop aymable.	Et pour vous écouter Phalante est trop aimable.
Ie l’ayme, ma raiſon, & ie le veux aymer, Enfin c’eſt vn buſcher qui me doit conſommer:	Je l'aime, ma raison, et Seigneur le veux aimer, Enfin c'est un bûcher qui me doit consommer:
C’eſt vn feu qui me plaist, & ie ſerois marrie Si du mal qu’il me fait mon ame eſtoit guerie.	C'est un feu qui me plaît, et ainsi serais marrie Si du mal qu'il me fait mon âme était guérie.
.	.
L.	L.
SCENE	SCÈNE
SCENE IV.	SCÈNE IV.
Y FITEOXENE, AMINTE, HELENE.	Y FITEOXENE, AMINTE, HELENE.
PHILOXENE.	PHILOXENE.
Ve fait la Reyne, Aminte?	Ve fait la Reine, Aminte?
AMINTE.	AMINTE.
Elle eſt triſte.	Elle est triste.
PHILOXENE.	PHILOXENE.
Et de quoy.	Et de quoi.
HELENE.	HELENE.
Ah!	Ah!
que mal à propos l’importun vient a moy, Ie luy montreray bien qu’il deſplaist à la Reyne, Et du mal qu’il me fait il portera la peine.	que mal à propos l'importun vient a moi, Je lui montrerai bien qu'il déplaît à la Reine, Et du mal qu'il me fait il portera la peine.
PHILOXENE.	PHILOXENE.
Puis-je bien approcher de voſtre Majeſté, Et diuertir ſes ſoins ſans importunité?	Puis-je bien approcher de votre Majesté, Et divertir ses soins sans importunité?
Quelque nouueau chagrin paroiſt ſur ſon viſage, Pleuſt aux Dieux que ie peuſſe en tirer auantage, Et que cette douleur dont ie ſens la moitié.	Quelque nouveau chagrin paraît sur son visage, Plût aux Dieux que prendre peusse en tirer avantage, Et que cette douleur dont ie sens la moitié.
Fut dans voſtre belle ame vn effet de pitié.	Fut dans votre belle âme un effet de pitié.
HELENE.	HELENE.
Ceſt plutoſt vn effet de cholere & de haine, Souuenez vous enfin que ie ſuis vostre Reyne, Au que dens depsmumen ges pans ſuperpies, Vous deueZ vous cognoiſtre, & ne me facher plus.	Cest plutôt un effet de colère et de haine, Souuenez vous enfin que je suis votre Reine, Au que dents dépsmumen gez pans superpies, Vous devez vous connaître, et ne me fâcher plus.
PHILOXENE, Bien que ie me cognoiſſe, & que dans voſtre eſtime Ma paßion aueugle ait paſſe pour vn crime, Ie ne ſuis pas ſorty des termes du deuoir, Et ſi vostre bonté m'en donne le pouuoir, Ie vous diray Madame auec quelque licence, Que cette paßion ne vous fait point d’offence.	PHILOXENE, Bien que sans me connaisse, et que dans votre estime Ma passion aveugle ait passe pour un crime, Je ne suis pas sorti des termes du devoir, Et si votre bonté m'en donne le pouvoir, Je vous dirai Madame avec quelque licence, Que cette passion ne vous fait point d'offense.
Bien que ie ſois ſujet, on ſçait aſſez mon rang, Que parmy vos vaſſaux ie ſuis prince du ſang.	Bien que ici sois sujet, on sait assez mon rang, Que parmi vos vassaux ie a prince du sang.
Qu'autresfois mes ayeulx ont porté la couronne, Et qu'en me regardant ie ne cognoy perſonne De ceux que la naiſſance a mis ſous voſtre l'oy, Qui de ſang & de biens ne ſoit plus bas que moy.	Qu'autrefois mes aieulés ont porté la couronne, Et qu'en me regardant ici ne connais personne De ceux que la naissance a mis sous votre l'oi, Qui de sang et de biens ne soit plus bas que moi.
Mais ce n'eſt point par là que mon cœur ſe propoſe De pouuoir pres de vous meriter quelque choſe, Mon amour ſeulement m'a donné cest eſpoir, Et depuis que ie ſers par vn double deuoir, Dans vne paßion ſi ſainte & ſi fidele, Ie vous ay témoigné tant d’ardeur & de zele.	Mais ce n'est point par là que mon cœur se propose De pouvoir pres de vous mériter quelque chose, Mon amour seulement m'a donné cette espoir, Et depuis que je sers par un double devoir, Dans notre passion si sainte et si fidèle, Je vous ai témoigné tant d'ardeur et de zèle.
Et ſans enmurmurer i’ay tant ſouffert pour vous, Que j'ay creu meriter vn trattement plus doux, Accordez-le, Madame, à ma perſeuserance:	Et sans enmurmurer j'ai tant souffert pour vous, Que j'ai cru mériter un trattement plus doux, Accordez-le, Madame, à ma perseuserce:
El aolat spui pinte.	Él aolat spui pinte.
HELENE.	HELENE.
Perdez-en l’eſperance.	Perdez-en l'espérance.
Et ſi par mes bontez vous en auez conçeu, Croyez que juſqu'icy vous vous eſtes deçeu, Si c’eſt par des deuoirs que voſtre amour eſpere, Sçachez qu’il n'a riẽ fait que vous ne deußieZ faire, Que ie ſouffre vos ſoins, mais que ie les reçoy, Non pas comme il vous plaiſt, mais comme ie le doy:	Et si par mes bontés vous en avez conçu, Croyez que jusqu'ici vous vous êtes déçu, Si c'est par des devoirs que votre amour espère, Sçachez qu'il n'a rienne fait que vous ne deviez faire, Que ie souffre vos soins, mais que sans les reçois, Non pas comme il vous plaît, mais comme il le dois:
Ne parleZ donc jamais d’vne amour qui m'offence, Et ſi vous oſez plus enfreindre ma deffence, Soyez tres-aſſeuré que ie vous feray voir Et quelle est voſtre faute, & quel eſt mon pouuoir.	Ne parlez donc jamais d'une amour qui m'offense, Et si vous osez plus enfreindre ma défense, Soyez très -asseuré que je vous ferai voir Et quelle est votre faute, et quel est mon pouvoir.
PHILOXENE.	PHILOXENE.
Vostre pouuoir eſt grand, & ma faute eſt plus grãde;	Votre pouuoir est grand, et ma faute est plus grãde;
Mais ſi pour l’expier, c’eſt mon ſang qu'on demande, I'eſpargneray la peine à vostre Majeſté, De me faire punir de ma temerité.	Mais si pour l'expier, c'est mon sang qu'on demande, J'épargnerai la peine à votre Majesté, De me faire punir de ma témérité.
Cent fois en vous ſeruant on me l’a veu répandre, Et puis que ceſt arrest me le fait trop comprendre, Et que dans vos diſcours ie voy voſtre deſir, Mon ame obeyſſante y court auec plaiſir, Ie quitte ſans regret vne vie importune,	Cent fois en vous servant on me l'a vu répandre, Et puis que cet arrêt me le fait trop comprendre, Et que dans vos discours ie voy quelque désir, Mon âme obéissante y court avec plaisir, Je quitte sans regret une vie importune,
G	G
Ma perte ſeulement eſtablit ma fortune, Et ie meurs tropheureux puis que dans mon treſpas Ie vous rends vn deuoir qui ne vous déplaiſt pas:	Ma perte seulement établit ma fortune, Et ainsi meurs tropheureux puis que dans mon trépas Je vous rends un devoir qui ne vous déplaît pas:
Pour le moins ce bonheur dont mamort eſt ſuiuie, M’’eſt plus aduantaguex que tous ceux de ma vie, Viuant ie vous dé pleus, ie vous plais en mourant, Et ie vous rends encore vn ſeruice aſſez grand, Puis que par mon treſpas i'aſſeure les delices, De celuy qui reçoit le prix de mes ſeruices:	Pour le moins ce bonheur dont mamort est suivie, M'est plus avantaguex que tous ceux de ma vie, Vivant je vous de pleus, je vous plais en mourant, Et ie vous rends encore service assez grand, Puis que par mon trépas j'assure les délices, De celui qui reçoit le prix de mes services:
Ie porte le reſpect dans vne extremité, Où par vos traitemens ie ſuis precipité, Et mon reſſentiment me force de vous dire Qu un autre plux neureux ate que ie defire:	Je porte le respect dans une extrémité, Où par vos traitements je suis précipité, Et mon ressentiment me force de vous dire un autre plux neureux ate que je désire:
Et malgré mon amour, ma conſtance & ma foy, Emporte le beau prix qui n'estoit deu qu'à moy,	Et malgré mon amour, ma constance et ma foi, Emporte le beau prix qui n'était deu d'à moi,
HELENE.	HELENE.
OſeZ-vous me parler auec tant d’inſolence?	Osez-vous me parler auec tant d'insolence?
Sortez audacieux, ſortez de ma preſence, Et n’importunez plus vn eſprit irrité, Aupumnon empimdoſane temerite.	Sortez audacieux, sortez de ma présence, Et n'importunez plus esprit irrité, Aupumnon empimdosane témérité.
Mais ſçachez pour borner voſtre inutile attente, vos ſoupçons ſont vrais, que i'adore Phalante, Et que vous auriez eu des traitemens plus doux, En me parlant pour lu y comme il parle pour vous.	Mais sachez pour borner votre inutile attente, vos soupçons sont vrais, que j'adore Phalante, Et que vous auriez eu des traitements plus doux, En me parlant pour lu y comme il parle pour vous.
	
PHILOXENE.	PHILOXENE.
Phalante, ah.	Phalante, ah.
le perfide.	le perfide.
HELENE.	HELENE.
Euitez ma cholere, Et ſi voſtre fureur vous porte à luy dé plaire, Sçachez que ie l’appuye, & que i'ay le pouuoir De punir vn ſubjet quiſort de ſon deuoir.	Euitez ma cholère, Et si votre fureur vous porte à Made maire, Sachez que éclair l'appuie, et que j'ai le pouvoir De punir vn sujet quisort de son devoir.
Fin du Troiſieſme Acte.	Fin du Troisième Acte.
A SCENE & E M PREMIERE.	À SCÈNE et E M PREMIÈRE.
CLEOMEDE.	CLÉOMEDE.
ARATE.	ARATE.
TIMANDRE.	TIMANDRE.
HELENE.	HELENE.
CLEOMEDE.	CLÉOMEDE.
Nfin ce ſont les vœux de toute la prouince, Vos fideles ſujets vous demandent vn prince, Et d’vn commun accord vous prient par ma voix, De faire viure en vous la race de nos Roys.	Nfin ce sont les vœux de toute la province, Vos fidèles sujets vous demandent un prince, Et d'H commun accord vous prient par ma voix, De faire vivre en vous la race de nos Rois.
Ce n’eſt pas qu'en effet le peuple & la nobleſſe Treuuent en voſtre regne aucun trait de foibleſſe, Et que l’on n’y remarque auec eſtonnement Les plus heureux ſuccez d'vn bon gouuernement:	Ce n'est pas qu'en effet le peuple et la noblesse Trouvent en votre règne aucun trait de faiblesse, Et que l'on n'y remarque avec étonnement Les plus heureux succès d'un bon gouvernement:
	
On ne regna jamais auec plus de iuſtice, Et jamais Souuerain ne maintint ſa police Auec plus de prudence, & plus d’authortté, Qu’on la voit maintenir à voſtre Majeſté:	On ne régna jamais avec plus de justice, Et jamais Souverain ne maintint sa police Avec plus de prudence, et plus d'authortté, Qu'on la voit maintenir à votre Majesté:
Depuis le bon ſucceZ de nos dernieres guerres, Vous aueZ eſtably le repos.	Depuis le bon succès de nos dernières guerres, Vous avez établi le repos.
dans vos terres, Et par vne honorable & glorieuſe paix, Vous leur aueZ donne le calme pour jamais.	dans vos terres, Et par une honorable et glorieuse paix, Vous leur avez donne le calme pour jamais.
Tout le monde l’admire en ce ſexe, en cet aage, Et toutes ces raiſons m'animent dauantage, A vous importuner & vous prier pour tous De nous donner vn jour des Roys ſortis de vous,	Tout le monde l'admire en ce sexe, en cet âge, Et toutes ces raisons m'animent davantage, À vous importuner et vous prier pour tous De nous donner un jour des Rois sortis de vous,
ARATE.	ARATE.
De vos predeceſſeurs la recente memoire Vit encor dans nos cœurs auecque tant de gloire, Et laiſſe dans Corinthe vn ſi beau ſouuenir, Que la ſuité des ans ne l’en ſçauroit bannir:	De vos prédécesseurs la récente mémoire Vit encor dans nos cœurs avec tant de gloire, Et laisse dans Corinthe un si beau souvenir, Que la suité des ans ne l'en saurait bannir:
Le feu Roy voſtre pere, & tous vos bons Anceſtres, Que ce Royaume illuſtre à cogneu pourfes Maiſtres, Bien qu'ils ſoient morts pournous ont laiſſé deſormats Vn amour parmy nous qui ne mourra jamais.	Le feu Roi votre père, et tous vos bons Ancêtres, Que ce Royaume illustre à connu pourfes Maîtres, Bien qu'ils soient morts pournous ont laissé désormats Un amour parmi nous qui ne mourra jamais.
Ce ſacré ſouuenir, Madame, vous oblige A conſeruer en vous le reste d’vne tige, De qui le ſang illuſtre à la poſterité A regné parmy nous auec tant de bonté.	Ce sacré souvenir, Madame, vous oblige À conserver en vous le reste d'une tige, De qui le sang illustre à la postérité A régné parmi nous avec tant de bonté.
ConſidereZ les vœux d’vn peuple qui deſire, Qu'à jamais voſtre ſang gouuerne cet Empire, Et qui ne verra point ſans mourir mille fois, Au tronc bereditaut eſteuer à atres Roys.	Considérez les vœux d'un peuple qui désire, Qu'à jamais votre sang gouverne cet Empire, Et qui ne verra point sans mourir mille fois, Au tronc bereditaut esteuer à âtres Rois.
TIMANDRE.	TIMANDRE.
Lors que par vn mary vous ſerez ſoulagée, De ce peſant fardeau, voſtre ame dégagée, Dans vn calme profond goustera le repos, Qu'vn ſoing continuel luy trouble à tout propos, D’vn peuple ſatisfait vous ſerez reuerée, Et d’vn prince obligé vous ſerez adorée:	Lors que par un mari vous serez soulagée, De ce pesant fardeau, votre âme dégagée, Dans calme profond goûtera le repos, Qu'un soing continuel lui trouble à tout propos, D'un peuple satisfait vous serez révérée, Et d'un prince obligé vous serez adorée:
Qui trouuant à vos pieds vn empire plus doux, Tmettra le bandeau qu’il receura de vous.	Qui trouvant à vos pieds un empire plus doux, Tmettra le bandeau qu'il recevra de vous.
Dont uonnerez vn Roy de qui vous ſerez Reyne, Il vous reconnoiſtra comme ſà Souueraine:	Dont ouvonnerez un Roi de qui vous serez Reine, Il vous reconnaîtra comme sà Souveraine:
Et conſeruant le rang & l’eſtat d’aujourd’huy, Plus que ſur vos ſujets vous regnereZ ſurluy.	Et conservant le rang et l'état d'aujourd'hui, Plus que sur vos sujets vous regnereZ surlui.
HELENE.	HELENE.
I'approuué vos ſouhaits, & vous veux ſatisfaire, Mais aſſez d’importance est jointe a cette affaire, Pour vouloir qu'on y ſonge encore vn peu de temps, Adieu, dans peu de jours ie vous rendray contens.	J'approuvé vos souhaits, et vous veux satisfaire, Mais assez d'importance est jointe à cette affaire, Pour vouloir qu'on y songe encore un peu de temps, Adieu, dans peu de jours ie vous rendrai contents.
TIMANDRE.	TIMANDRE.
Dieux!	Dieux!
rendeZ ſon deſſein tel que ie le deſire.	rendez son dessein tel que je le désire.
SCENE	SCÈNE
SCENE II.	SCÈNE II.
LAELENE IIMANDNU.	LALENE IIMANDNU.
HELENE.	HELENE.
Imandre demeurez, i’ay deux mots à vous dire.	Imandre demeurez, j'ai deux mots à vous dire.
TIMANDRE.	TIMANDRE.
Quel eſpoir pour mon fils cache tes ſentimens, Voulez,-vous m’honorer de vos commandemens?	Quel espoir pour mon fils cache tes sentiments, Voulez,-vous m'honorer de vos commandements?
HELENEIe vous veux aduertir de la haute inſolence De voſtre Philoxene.	HÉLENEIe vous veux avertir de la haute insolence De votre Philoxène.
2	2
TIMANDRE.	TIMANDRE.
O Dieux!	Ô Dieux!
HELENE.	HELENE.
Son imprudence Na pas craint aujourd’huy de me deſobliger:	Son imprudence Na pas craint aujourd'hui de me désobliger:
Mais ſans voſtre reſpect ie m'en ſçaurois vanger.	Mais sans votre respect Seigneur m'en saurais venger.
d ---- ---t.	dès --est -est-t.
Do.	Do.
» 30 C’eſt vous ſeul que i’eſtime & que ie conſidere, Et la fauté du fils ie la pardonne du pere, Sans crainte & ſans reſpect, l’inſolent à mes yeux A menacé Phalante, a fait le furieux, Et m'a fait, l’imprudent, vn reproche à moy-meſeise 7.	" 30 C'est vous seul que j'estime et que sans considère, Et la fauté du fils ie la pardonne du père, Sans crainte et sans respect, l'insolent à mes yeux A menacé Phalante, a fait le furieux, Et m'a fait, l'imprudent, un reproche à moi-meseise 7.
Que j’ay ſouffert de luy parce que ie vous ayme.	Que j'ai souffert de même parce que je vous aime.
TIMANDRE.	TIMANDRE.
Il a tort de dé plaire à voſtre Majeſté, Mais dans le deſeſpoir où vous l’aueZ jetté.	Il a tort de dé plaire à votre Majesté, Mais dans le désespoir où vous l'avez jeté.
Par les cruels effets d’vne rigueurextreme, Il ne recognoit plus ſon deuoir ny ſoy-meſme:	Par les cruels effets d'une riguurextreme, Il ne reconnaît plus son devoir ton soi-même:
L’aueuglé dans l’eſtat où vous l’auez reduit.	L'aveuglé dans l'état où vous l'avez réduit.
Receura mes leçons auec fort peu de fruit:	Receura mes leçons était fort peu de fruit:
Et ne recouurera ſa ſageſſe premiere Q'au funeſte moment qu’il perdra la lumiere.	Et ne recouvrera sa sagesse première QU'au funeste moment qu'il perdra la lumière.
Helas!	Hélas!
qu'ay-je commis dans vn gouuernement, Oü j'ay conſidere voſtre bien ſeulement?	qu'ai-je commis dans un gouvernement, Oui j'ai considère votre bien seulement?
Qu’ay-je fait contre vous pour plonger ma vieilleſſe Dans vneſi ſenſible & mortelle triſteſſe, Pour me priuer d’vn fils dont l’appuy m’eſt ſi doux, Et de qui tout le crime est de mourir pour vous?	Qu'ai-je fait contre vous pour plonger ma vieillesse Dans unesi sensible et mortelle tristesse, Pour me priver d'un fils dont l'appui m'est si doux, Et de qui tout le crime est de mourir pour vous?
Vn feu plein de reſpect le rend-il ſi coulpable?	Un feu plein de respect le rend-il si coulpable?
Peche-t’il d’adorer vn ſu jet adorable?	Peche-t-il d'adorer un su jet adorable?
Et ſa conditton le met-elle ſi bas, Qu'e ſa preſomption ſoit digne du treſpas?	Et sa conditton le met-elle si bas, Qu'e sa présomption soit digne du trépas?
Ah!	Ah!
vous cognoiſſez mieux ſon rang & ſa naiſſance, L’amour d’vn tel ſujet ne vous fait point d’offence.	vous connaissez mieux son rang et sa naissance, L'amour d'un tel sujet ne vous fait point d'offense.
Et meſme le feu Roy dans voſtre âge plus bas, En vid les fondemens qu’il ne condamna pas, On ne peut mépriſer ſonſang ny ſa perſonne, Et ſon deffaut enfin n'eſt que d’vne couronne.	Et même le feu Roi dans votre âge plus bas, En vit les fondements qu'il ne condamna pas, On ne peut mépriser sonsang ni sa personne, Et son défaut enfin n'est que d'une couronne.
HELENE.	HELENE.
Timandre c’est aſſeZ, ce diſcours me dé plaiſt, Et ie le hay tout Prince & tout braue qu’il eſt:	Timandre c'est assez, ce discours me dé plaît, Et tu le hais tout Prince et tout brave qu'il est:
Sa derniere action, & ſa haute inſolence, M'ont aſſeZ témoigné qu’il perd la cognoiſſante:	Sa dernière action, et sa haute insolence, M'ont assez témoigné qu'il perd la connaissante:
Mais s’il ne ſe remet dans ſon premier deuoir, Quelque Prince qu’il ſoit, il verra mon pouuoir.	Mais s'il ne se remet dans son premier devoir, Quelque Prince qu'il soit, il verra mon pouvoir.
Deuant moy l’orgueilleux a menacé Phalante, Vous ſçaueZ ſon caprice & ſon humeur boüillante, Gardez, qu’il ne s'attaque à ce Prince estranger Puis queetele prorege, & leſſatray, venger	Devant moi l'orgueilleux a menacé Phalante, Vous savez son caprice et son humeur boüillante, Gardez, qu'il ne s'attaque à ce Prince étranger Puisque queetele protège, et lessatrai, venger
SEEMMT	SEEMMT
PHILOXENE.	PHILOXENE.
Eſte d’vne amitié, que le traiſtre a bleſſee, Vains reſtes d’amitié, ſortez de ma penſee, Et ne tourmentez point, ſouuenirs ſu perflus, Vn cœur deſeſperé qui ne vous cognoiſt plus.	Este d'une amitié, que le traître a blessée, Vains restes d'amitié, sortez de ma pensée, Et ne tourmentez point, souvenirs su perflus, Un cœur désespéré qui ne vous connaît plus.
Malheureuſe amitié dans nos ames eſteinte, Va retrouuer Phalante, & luy faire ta plainte, Ce traiſtre le premier a violé ſa foy, Et ie ſuis le dernier qui peche contre toy, Quitte donc pour jamais vne ame deſolée, Et ne l’accuſe point de t'auoir violée, Cet eſprit innocent ne ſe ſent point touché Par le moindre remords d’vn ſemblable peché, Et pour te témoigner comme il te fut fidelle, Amitié violée il prendra ta querelle:	Malheureuse amitié dans nos âmes éteinte, Va retrouver Phalante, et lui faire ta plainte, Ce traître le premier a violé sa foi, Et ie sans le dernier qui pèche contre toi, Quitte donc pour jamais une âme désolée, Et ne l'accuse point de t'avoir violée, Cet esprit innocent ne se sent point touché Par le moindre remords d'autre semblable péché, Et pour te témoigner comme il te fut fidèle, Amitié violée il prendra ta querelle:
Il perdra la lumiere, ou punira l’ingrat, Qui de tes ſaintes loix a fait ſi peu d’eſtat, Et ſans craindre l’horreur dont ſa faute eſt ſuiuie, T’a le premier enfrainte aux dépens de ma vie.	Il perdra la lumière, ou punira l'ingrat, Qui de tes saintes lois a fait si peu d'état, Et sans craindre l'horreur dont sa faute est suivie, T'a le premier enfrainte aux dépens de ma vie.
Monſtre d’ingratitude & d’infidelité, Regarde en quel eſtat tu m'as precipité?	Montre d'ingratitude et d'infidélité, Regarde en quel état tu m'as précipité?
Regarde deſloyal de combien de ſupplices, Ou de combien de morts tu payes mes ſeruices?	Regarde déloyal de combien de supplices, Ou de combien de morts tu payes mes services?
Mais ne te vante pas, monſtre de cruauté, De m'arracher la vie auec impunité:	Mais ne te vante pas, montre de cruauté, De m'arracher la vie avec impunité:
Perfide en quelque endroit que le Soleil t’éclaire, Rien ne te peut rauir à ma juſte cholere:	Perfide en quelque endroit que le Soleil t'éclaire, Rien ne te peut ravir à ma juste colère:
Cherche pourton ſalut cent aZiles diuers, Ou monte dans les cieux;	Cherche pourton salut cent aZiles divers, Ou monte dans les cieux;
ou deſcens aux enfers.	ou descens aux enfers.
Le ciel, ny les enfers, ny laterre, ny l’onde, 61 Te deuſſent-ils cacher aux yeux de tout le monde, Ne te ſçauroient cacher a mon iuſte courroux;	Le ciel, Seigneur les enfers, ni ncterre, ni l'onde, 61 Te dussent-ils cacher aux yeux de tout le monde, Ne te sauraient cacher à mon juste courroux;
I'arracheray ce cœur percé de mille coups, Et gouſtant dans ſa veuë vne derniere joye, Ie mourray ſatisfait, pourueit que ie le voye.	J'arracherai ce cœur percé de mille coups, Et goûtant dans sa vue une dernière joie, Je mourrai satisfait, pourvit que personne le voie.
Que ie puiſſe à ce cœur noircy de lâchetez, Re procher en mourant ſes infideliteZ Et lauer dans ton ſang la faute que i’ay faite, D'honorer vn ingrat d’vne amitié parfaite, :	Que personne puisse à ce cœur noirci de lâchetés, Re procher en mourant ses infidélité Et lauer dans ton sang la faute que j'ai faite, D'honorer un ingrat d'une amitié parfaite, :
SCENE I T.	SCÈNE I T.
PHALANTE.	PHALANTE.
ARBANTE.	ARBANTE.
PHILOXENE.	PHILOXENE.
PHALANTE.	PHALANTE.
AiſſeZ-moy ſeul, Arbante?	Aissez-moi seul, Arbante?
PHILOXENE.	PHILOXENE.
O grands Dieux ie le voy.	Ô grands Dieux Dieux le vois.
13	13
ARBANTE.	ARBANTE.
Ie vous ſuiuray, Seigneur.	Je vous suivrai, Seigneur.
PHALANTE.	PHALANTE.
Arbante laiſſe moy.	Arbante laisse -moi.
PHILOXENE, Il faut mourir perfide.	PHILOXENE, Il faut mourir perfide.
PHALANTE.	PHALANTE.
O Dieux -- .	Ô Dieux -- .
.	.
	
PHILOXENE.	PHILOXENE.
Deffends toy traiſtre, Cette confuſion que tu me fais paroiſtre, Eſt vn effet leger du remords que tu ſens, Mais il en faut mourir.	Défends toi traître, Cette confusion que tu me fais paraître, Est un effet léger du remords que tu sens, Mais il en faut mourir.
1	1
Amy?	Ami?
PHALANTE.	PHALANTE.
Eſtes-vous hors du ſens	Êtes-vous hors du sens
PHILOXENE.	PHILOXENE.
Quitte ce nom que ton crime viole, Homme ſans cœur, ſans foy, ſans honneur, ſans parole, Ce nom ne t’eſt plus deu.	Quitte ce nom que ton crime viole, Homme sans cœur, sans foi, sans honneur, sans parole, Ce nom ne t'est plus dev.
L	L
PHALANTE.	PHALANTE.
Bons Dieux!	Bons Dieux!
ie ſuis confus, Philoxene, atu amurt,ue mregueis-tu plus?	Ne suis confus, Philoxène, atu amurt,ue mégueis-tu plus?
–	
PHILOXENE.	PHILOXENE.
Ouy ie tecognois trop, & cette cognoiſſance Arme ce bras vangeur.	Oui ici tecgnais trop, et cette connaissance Arme ce bras vengeur.
PHALANTE.	PHALANTE.
Contre moninnocence.	Contre moninnocence.
.	.
	
PHILOXENE.	PHILOXENE.
Ton innocence traiſtre, ah!	Ton innocence traître, ah!
c’eſt eſtre innocent, De violer ſa foy, de trahir vn abſent, Et d’oſter lâchement parhaine ou par enuie, A ſon meilleur amy le repos & la vie;	c'est être innocent, De violer sa foi, de trahir un absent, Et d'ôter lâchement parhaine ou par envie, À son meilleur ami le repos et la vie;
C’eſt là ton innocence, & c'eſt trop diſcourir, Reſous toy deſloyal à tuer oü mourir.	C'est là ton innocence, et c'est trop discourir, Résous toi déloyal à tuer ou mourir.
PHALANTE.	PHALANTE.
A mourir ie ſuis preſt, mais ce danger extreme Ne m'armera jamais contré vn autre moy-meſme, Et tu verras ce fer ſe tourner contre moy, Plutost que ton amy s'en ſerue contre toy.	À mourir quelque suis prêt, mais ce danger extrême Ne m'armera jamais contré un autre moi-même, Et tu verras ce fer se tourner contre moi, Plutôt que ton ami s'en serve contre toi.
Mon amitié perſiſte inuiolable & ſainte, Bien que ton action ne l’ait que trop enfreinte, Et que ce traitement ſoit bien rude pour moy, Mais ſouffrant d’vn amy ie fay ce que ie doy:	Mon amitié persiste inviolable et sainte, Bien que ton action ne l'ait que trop enfreinte, Et que ce traitement soit bien rude pour moi, Mais souffrant d'un amy ie fais ce que je crois:
Et puts que de mon ſang ton ame est alterée, Ta vengeance dé ja n’eſt que trop differée.	Et puts que de mon sang ton âme est altérée, Ta vengeance dé j 'est que trop différée.
Et tu peux ſans ohſtacle acheuer ton deſſein, Puis que pour t’y ſeruir ie te tendray le ſein.	Et tu peux sans ohstacle achever ton dessein, Puis que pour t'y servir ie te tendrai le sein.
Frappe cet estomac, perce ce cœur perfide, Croy que mon amitié t’abſout d’vn parricide, Et que malgré l’erreur qui te rend inhumain, Ie ne mourray jamais d'vne plus chere main:	Frappe cet estomac, perce ce cœur perfide, Crois que mon amitié t'absout d'un parricide, Et que malgré l'erreur qui te rend inhumain, Je ne mourrai jamais d'une plus chère main:
Mais auant qu’en ma mort ton cœur ſe ſatisfaſſe, Accorde pour le moins cette derniere grace ----- -- .	Mais avant qu'en ma mort ton cœur se satisfasse, Accorde pour le moins cette dernière grâce -- -- .
	
Au Au ſouuenir d’vn bien de ton ame effacé, De ne me cacher plus en quoy t’ay-je offencé, Eiſre eſt queique errem oin pommee ctemeure.	Au Au souvenir d'être bien de ton âme effacé, De ne me cacher plus en quoi t'ai-je offensé, Eistère est queique errem oin pommée commeure.
PHILOXENE.	PHILOXENE.
Ouy, perfide il eſt iuſte, & deuant que ie meure, Ie te veux reprocher vne infidelite Qui te rend deteſtable à la posterité, Ie t’auois donc fié le ſecret de ma flame, A toy ſeul, deſloyal, j'auois ouuert mon ame, Pour trahirma franchiſe, & rechercher pour toy Vn bien que tu feignois de ſouhaitter pour moy:	Oui, perfide il est juste, et devant que sans meure, Je te veux reprocher une infidélité Qui te rend détestable à la postérité, Je t'avais donc fié le secret de ma flamme, A toi seul, déloyal, j'avais ouvert mon âme, Pour trahirma franchise, et rechercher pour toi Un bien que tu feignais de souhaiter pour moi:
C’eſt oit donc l’amitié que tu m’auois promiſe, C’eſt ce que ta bonté rendoit à ma franchiſe, Et ce que tu deuois à toüte ma maiſon, Se deuoit donc payer parcette trahiſon?	C'est oit donc l'amitié que tu m'avais promise, C'est ce que ta bonté rendait à ma franchise, Et ce que tu devais à tête ma maison, Se devait donc payer parcette trahison?
Tu t’acquitois, ingrat, enm'enleuant Helene, Et portant mille morts	Tu t'acquitais, ingrat, enm'enlevant Hélène, Et portant mille morts
PHALANTE.	PHALANTE.
C’eſt aſſez Philoxene, Ie t’entends, mais les Dieux, iuges de tous mes ſoins, Sont de mon proceder veritables teſmoins:	C'est assez Philoxène, Je t'entends, mais les Dieux, juges de tous mes soins, Sont de mon procéder véritables témoins:
Que leur courroux éclate, & que d’vn coup de foudre A cette heure à tes yeux ils me mettent en poudre, Si ie ne t'ay ſeruy dans cette occaſion ---------- Auec plus de franchiſe & plus d’affection Que pamats vn amy.	Que leur courroux éclate, et que d'un coup de foudre A cette heure à tes yeux ils me mettent en poudre, Si grande ne t'ai servi dans cette occasion -- Auec plus de franchise et plus affection Que pamats amy.
PHILOXENE.	PHILOXENE.
Ie n’en ſuis plus en doute, Cherche pour t’excuſer un autre qui t’écoute, Deffends-toy ſeulement:	Je n'en suis plus en doute, Cherche pour t'excuser un autre qui t'écoute, Défends-toi seulement:
quoy tu manques de cœur?	quoi tu manques de cœur?
Ah!	Ah!
laſche deffends-toy, ie te perdray d’honneur, Et feitſant d-ta glotre vne eternelle Tache, Ie publiray par tout	lâche défends-toi, on te perdrai d'honneur, Et fitsant dût-là glotre éternelle Tache, Je publirai par tout
PHALANTE.	PHALANTE.
Ah!	Ah!
ie ne ſuis point lâche, Tu le ſçais Philoxene, & tus m'as veu ſouuent Dans de plus grands-perils engagé trop aauant, Pour conſerger de moy cette indigne creance.	Ne ne suis point lâche, Tu le sais Philoxène, et tus m'as vu souvent Dans de plus grands-périls engagé trop aavant, Pour conserger de moi cette indigne créance.
Si d’autres me faiſoient une ſemblable offence Ie la repouſſerois an lieu demexou ſer, Tu le deurois cognoiſtre au lieu d’en abuſer, Et dans vn proceder qui te dbit ſatisfaire.	Si d'autres me faisaient une semblable offense Je la répousserais an lieu de ser, Tu le devrais connaître au lieu d'en abuser, Et dans un procéder qui te dit satisfaire.
Voir que ie fais poux toy plus que ie ne dois faire.	Voir que ici fais poux toi plus que je ne dois faire.
PHILOXENE.	PHILOXENE.
Tu dois mourir perſide, ah!	Tu dois mourir perside, ah!
c’eſt trop'écouter.	c'est trop'écouter.
A pres des inahiſons dent ieine puis doûterI'en ſais tropbien inſtruit, mets toy donc en deffence.	À pres des inahisons dent amine puis douterI'en sais tropbien instruit, mets toi donc en défense.
Et témoignea ta mortu pou dereſiſtance;	Et témoignea ta mortu pou deresistance;
a113d i.	a13d y.
n Bien que ma mainrefiſte, & s’arme contre t - ----- ---a.	 Bien que ma mainrefiste, et s'arme contre t -elle -est-à --a.
.	.
.	.
v;	vit;
Sçache que tous les coups s’adreſſeront à moy:	Sache que tous les coups s'adresseront à moi:
Et que tu me contraints de tirer vne eſpée Que umisnabupropre fuus (agepamjasremipee.	Et que tu me contraints de tirer une épée Que umisnabupropre fuus (agepamjasremipee.
PHALANTE.	PHALANTE.
Les Dieux me ſont teſmoins que i’ay ſouffert de toy Plus que tu n'eſperois & plus que ie ne doy, Et que ſans reſſentir vne douleur extreme Ie ne puis me pertencontre vn homme que i'ayme:	Les Dieux me sont témoins que j'ai souffert de toi Plus que tu n'espérais et plus que ie ne dois, Et que sans ressentir une douleur extrême Je ne puis me pertencontre un homme que j'aime:
Mais puis qu’il faut venir à cette extremité, Cherchons pousr t’aſſouuir vn lieu plus eſcarté, On nous peut deſcouurir du quartier de la Reyne, Ce bois eſt plus commode, entrons-y Philoxene.	Mais puis qu'il faut venir à cette extrémité, Cherchons pousr t'assouvir un lieu plus écarté, On nous peut découvrir du quartier de la Reine, Ce bois est plus commode, entrons-y Philoxène.
DCEAV L V TIMANDRE, ARBANTE, CLEOMEDE.	DCEU L V IMANDRE, ARBANTE, CLEMEDE.
TIMANDRE.	TIMANDRE.
Ieux!	Jeux!
que mon fils eſt prompt, & que ſa folle humeur A ſes meilleurs amis vacauſer de douleur!	que mon fils est prompt, et que sa folle humeur À ses meilleurs amis vacauser de douleur!
Dans les bouillans tranſports d’vné aueugle cholere, Il n'eſcoute raiſon, ny conſeil, ny priere.	Dans les bouillants transports d'uné aveugle cholère, Il n'écoute raison, ni conseil, notre prière.
Et ſuit de ſa fureur l’aueugle mouuement:	Et suit de sa fureur l'aveugle mouvement:
O ieune bomme inſenſé!	Ô jeune bomme insensé!
.	.
	
CLEOMEDE.	CLÉOMEDE.
Courons-y promptement, Icy la diligence eſt aſſez importante, Arbante en quei endroit as-tu laiſſé Phalante s	Courons-y promptement, Ici la diligence est assez importante, Arbante en quei endroit as-tu laissé Phalante s
ARBANTE.	ARBANTE.
Preſque en ce meſme lieu, mais à mon grand regret, Liſant dans ſon viſage vn deplaiſir ſecret, Que ſes yeux & ſon teint ne font que trop paraiſtre, I'ay bien veu Philoxene approcher de mon maiſtre.	Presque en ce même lieu, mais à mon grand regret, Lisant dans son visage un déplaisir secret, Que ses yeux et son teint ne font que trop paraître, J'ai bien vu Philoxène approcher de mon maître.
	
CLEOMEDE.	CLÉOMEDE.
N’as-tu rien entendu?	N'as-tu rien entendu?
ARBANTE.	ARBANTE.
nepenis trop eſloigné, Et mon maistre en partant ne m’a rien témoigné Qui me fiſt redouter de les laiſſer enſemble, Eſtans ſi bons amis, ie croyois	népenis trop éloigné, Et mon maître en partant ne m'a rien témoigné Qui me fît redouter de les laisser ensemble, Étant si bons amis, elle croyais
TIMANDRE.	TIMANDRE.
Cieux ie tremble!	Cieux grands tremble!
Courons, ah!	Courons, ah!
que ie crains que ce ne ſoit trop tard, Grands Dieux !	que ici crains que ce ne soit trop tard, Grands Dieux !
guideZ mes pas.	guidez mes pas.
.	.
CLEOMEDE.	CLÉOMEDE.
Courez d’vne autre part.	Courez d'une autre part.
.	.
	
SCENE VI.	SCÈNE VI.
PHILOXENE.	PHILOXENE.
PHALANTE.	PHALANTE.
PHILOXENE bleſſé à mort & tombant.	PHILOXENE blessé à mort et tombant.
A iuſtice des Dieux en ta faueuréclate, Et leur courroux enfin punit vne ame ingrate,	À justice des Dieux en ta faueuréclate, Et leur courroux enfin punit toujours âme ingrate,
Philoxene.	Philoxène.
.	.
.	.
.	.
PHALANT 10	PHALANT 10
PHILOXENE.	PHILOXENE.
Ic mehrs, eo ma femerire Reçoit enfin le prix qu’elle auoit merité, Ie meurs, mais d’vne mort qui n'eſt pas aſſez rude Pour punir ceſt ingrat de ſon ingratitude.	Ic mehrs, eut ma femnerire Reçoit enfin le prix qu'elle avait mérité, Je meurs, mais d'une mort qui n'est pas assez rude Pour punir cet ingrat de son ingratitude.
.	.
L.	L.
	
PHALANTE.	PHALANTE.
Helas!	Hélas!
ie reculois e ie parois tes coups, Et toy ſeul tranſporté d’vn trop boüillant courroux, Meſpriſant vne eſpee à ſon maiſtre infidelle, Tu t'es prectpité dans ſa pointé mortelle.	Les reculais eo ie parais tes coups, Et toi seul transporté d'un trop bouillant courroux, Mesprisant une espée à son maître infidèle, Tu t'es prectpité dans sa pointé mortelle.
22- 1.	22- 1.
.	.
t---	t-
I tu -	I tu -
PHILOXENE.	PHILOXENE.
Phalante, les Dieux ſeuls m'ont mis en cẽt eſtat Mais ſi tu peux encore eſcouter vn ingrat, Et ſi le ſouuenir d’vne amitié paſſéé 2 Me peut encor laiſſer vn lieu dans ta penſée, Pardonne, cher Phalante, à mon reſſentiment, Ie reconnois mon crime & mon aueuglement, I'eus tont de ſoupçonner gme vertu ſi haute, 1.	Phalante, les Dieux seuls m'ont mis en cent état Mais si tu peux encore écouter un ingrat, Et si le souvenir d'une amitié passé 2 Me peut encor laisser un lieu dans ta pensée, Pardonne, cher Phalante, à mon ressentiment, Je reconnais mon crime et mon aveuglement, J'eus tont de soupçonner garde vertu si haute, 1.
i di'.	y di.
Mais puis que ie recoy la peine de ma faute, Et laue de mon ſang, le mal que i'ay commis, Souffre qu'a mon treſpas nous demeurions amis, Et que rien ne ſepare vne amitie ſi ſainte, Ie lay par mon erreur indignement enfreinte, Mais croy s’il m’est permis apres ce que i’ay fait, Que mourant ton amy, ie mourrayſatisfait.	Mais puis que ici reçois la peine de ma faute, Et laue de mon sang, le mal que j'ai commis, Souffre qu'a mon trépas nous demeurions amis, Et que rien ne sépare une amitié si sainte, Je lai par mon erreur indignement enfreinte, Mais crois s'il m'est permis après ce que j'ai fait, Que mourant ton ami, je mourraisatisfait.
PHALANTE.	PHALANTE.
Quelque viue douleur que mon viſage exprime, N'eſpere point de moy que i'excuſemon crime, Et que parma douleur ou par quelque raiſon I'mplore ta bonté pour auoir vn pardon.	Quelque vive douleur que mon visage exprime, N'espère point de moi que j'excusémon crime, Et que parma douleur ou par quelque raison J'mplore ta bonté pour avoir un pardon.
Ie cognois trop ma faute;	Je connais trop ma faute;
& ceſte main barbare A fait vne action qu'il, faut qu'elle repare.	et cette main barbare A fait une action qu'il, faut qu'elle répare.
Elle a verſé ton ſang & demande lemien, L'amitié qui joignit mon cœur auec le tien De liens eternels nos deux ames aſſemble, * Et veut qu'apres la mort noüs demeurions enſemble, --- ---------- Ie repare mon crime & ſuis ſon mouuement, L'vn & l’autre ſe peut par ma mort ſeulement.	Elle a versé ton sang et demande lemien, L'amitié qui joignit mon cœur avec le tien De liens éternels nos deux âmes assemble, * Et veut qu'après la mort nôtres demeurions ensemble, -- -- Ie repare mon crime et suis son mouuement, L' et autre se peut par ma mort seulement.
I'embraſſe donc la mort,& ie ne la differe, Que par la volonté de te mieux ſatisfaire:	J'embrasse donc la mort, ie ne la diffère, Que par la volonté de te mieux satisfaire:
Eſcoute donc amy, ſi ce nomm'eſt, permus;	Écoute donc ami, si ce nomm'est, permus;
A pres l’aſſaßinat que ma main a commis, Eſcoute.	À pres l'assassinat que ma main a commis, Escoute.
Philoxene, eſcoute ma priere, Et croy que ſans regret ie perdray là lümiere, Si i’obtiens en mourant cefté grãce de toy, Croy que iamais ce cœur ne t’a manqué de foy, Et que ie veux ſouffrir les peines eternelles Qui geſnent aux enfers les ames criminelles, Si ie n'ay jait pour top dans ma commißibn Tout ce que ma promeſſe & ton affection Ont iamais demandé d’vne amitié parfaite.	Philoxène, écoute ma prière, Et crois que sans regret jours perdrai là lumière, Si j'obtiens en mourant ceté grande de toi, Crois que jamais ce cœur ne t'a manqué de foi, Et que sans veux souffrir les peines éternelles Qui gênent aux enfers les âmes criminelles, Si ici n'ai jait pour top dans ma commiibn Tout ce que ma promesse et ton affection Ont Ç demandé d'une amitié parfaite.
T.	T.
PHILOXEN.	PHILOXEN.
Helas!	Hélas!
de ce costé mon ame eſt ſatisfaite, Vous n’aueZ que trop fait;	de ce côté mon âme est satisfaite, Vous n'avez que trop fait;
mats puiſque par pitié Vous me gardez encorcette entiere amitié, Qui ſi peu meritée & ſi mal recogneué Dans l’offence & le ſang s’eſt touſiours maintenué, Ne me refuſez point pour mon ſoulagement.	mats puisque par pitié Vous me gardez encorcette entière amitié, Qui si peu méritée et si mal recogneué Dans l'offense et le sang s'est toujours maintenué, Ne me refusez point pour mon soulagement.
Ma derniere requeſte a mon dernier moment.	Ma dernière requête à mon dernier moment.
Ie ne puis plus douter qu'Helene ne vous ayme, Ie le ſçauois d’ailleurs & l’ay ſceu d’elle-meſme.	Je ne puis plus douter qu'Hélène ne vous aime, Je le savais d'ailleurs et l'ai su d'elle-même.
Vous le ſçaueZ außt, quoy que voſtre vertu Pour vn indigne amy contre elle ayt combatis.	Vous le savez aussi, quoi que votre vertu Pour Un indigne ami contre elle ai combatis.
l Viuez pour la ſeruir, puis que les destinées Trenchent pour ſon repos le cours de mes années, Faites luy deſormais vn traitement plus doux, Vous eſtes digne d’elle, elle eſt digne de vous, Et i’eſtois criminel en mettant quelque obstacle.	 Livez pour la servir, puis que les destinées Trenchent pour son repos le cours de mes années, Faites avait désormais un traitement plus doux, Vous êtes digne d'elle, elle est digne de vous, Et j'étais criminel en mettant quelque obstacle.
SCENE VII.	SCÈNE VII.
ARBANTE.	ARBANTE.
CLEOMEDE, TIMANDRE.	CLÉOMEDE, TIMANDRE.
PHALANTE.	PHALANTE.
PHILOXENE.	PHILOXENE.
	
Aulſb Mala Pe.	Aulsb Mala Pe.
Ous arriuons trop tard.	Ous arrivons trop tard.
CLEOMEDE.	CLÉOMEDE.
Dieux, le triſte ſpectacle?	Dieux, le triste spectacle?
TIMANDRE.	TIMANDRE.
Acheue, acheue ingrat, apres ta trabiſon, Et te ſoüille du ſang de touté ma maiſon, Meurs ou me fais mourir.	Achève, achève ingrat, après ta trabison, Et te souille du sang de touté ma maison, Meurs ou me fais mourir.
3	3
PHALANTE.	PHALANTE.
2 Il eſt iuste Timandre.	2 Il est juste Timandre.
.	.
.	.
.	.
	
Voicy.	Voici.
Voicy, voicy le ſang que vous deuez répandre, Ie ſuis ce deſloyal, ce cruel, cet ingrat, Qui ſurvis laſchement à cet aſſaßinat, I'ay trahy vostre fils, & l’ay priué de vie, Ne differez donc plus d’accomplir voſtre enuie.	Voici, voici le sang que vous devez répandre, Je suis ce déloyal, ce cruel, cet ingrat, Qui survis lâchement à cet assinat, J'ai trahi votre fils, et l'ai privé de vie, Ne différez donc plus d'accomplir votre envie.
Regardez voſtre fils, vangez-le, vangés vous, PerceZ, perceZ ce cœur indigne de vos coups, mont ui vous õppoſeZ à ſa iuſte cholere, Pourquoyretenés-vous lesmouuemens d'vn pere.	Regardez votre fils, vengez-le, vengez -vous, Percez, percez ce cœur indigne de vos coups, mont jui vous onpposez à sa juste colère, Pourquoyretenés-vous lesmouuemens d'un père.
Retirés-vous Arbante.	Retirez-vous Arbante.
PHILOXENE.	PHILOXENE.
Ah!	Ah!
mon pere, deux mots, Et ſi vous deſirés que ie meure en repos, Ayez plus de reſpect pour vn autre moy-meſme, Traictés mieux mon amy.	mon père, deux mots, Et si vous désirez que Elle meure en repos, Ayez plus de respect pour un autre moi-même, Traités mieux mon ami.
TIMANDRE.	TIMANDRE.
Quoy, tu veux que ie l’ayme, eurfqumdocouptagnangu indignement, Ce meurtrier de mon fils.	Quoi, tu veux que ainsi l'aime, eurfqumdocouptagnangu indignement, Ce meurtrier de mon fils.
PHILOXENE.	PHILOXENE.
An.	An.
it meurs uonpiemenf.	it meurs uonpiemenf.
TIMANDRE.	TIMANDRE.
Ce monſtre, ce cruel.	Ce montre, ce cruel.
¬·	¬·
PHALANTE.	PHALANTE.
Encore plus Timandre, Cetraiſtre, ce bonrren e	Encore plus Timandre, Cetraistre, ce bonren e
PHILOXENE.	PHILOXENE.
Me vouleZ-vous entendre Mon Pere?	Me voulez-vous entendre Mon Père?
par ce nom & ſi cher & ſi doux, Par la clarté du jour que ie receus de vous, Et qui dans vn moment me doit eſtre rauie Dans les bras de celuy de qui ie tiens la vie, Aymés, aymés Phalante, autant ou plus que moy, C’eſt vn amy ſans tache.	par ce nom et si cher et si doux, Par la clarté du jour que je reçus de vous, Et qui dans un moment me doit être ravie Dans les bras de celui de qui était tiens la vie, Aimés, aimez Phalante, autant ou plus que moi, C'est un ami sans tache.
Eleſia Il t’a manqué de foy, 4 airanf, Palhe .	Elesia Il t'a manqué de foi, 4 airanf, Palhe .
PHILOXENE.	PHILOXENE.
Ce deſeſpoir m'offence.	Ce désespoir m'offense.
PHALANTE.	PHALANTE.
Non, non, ſi ce diſcours retarde ſa vangeance, S’il a ſi peu de cœur & ſi peu d’amitié, Que d’eſpargner vn traiſtre indigne de pitié, Ie ſupplée au deffaut d’vn Pere impitoyable, Ceſte main qui me reſte en eſt deſia capable, M’ayant peu de ma vie enleuer la moitié - .	Non, non, si ce discours retarde sa vengeance, S'il a si peu de cœur et si peu d'amitié, Que d'épargner un traître indigne de pitié, Je supplée au défaut d'un Père impitoyable, Cette main qui me reste en est déjà capable, M'ayant peu de ma vie enlever la moitié - .
.	.
.	.
Penſesetu que pourt autre eue ayt pius de pities	Pensesetu que pourt autre eue ait pius de pitiés
TIMANDRE.	TIMANDRE.
Aanemen puyuuppuyauepvieilleſſe, Seul eſpoir de mes jours, crois-tu que je te laiſſe?	Aanmen puyuuppuyauepvieillesse, Seul espoir de mes jours, crois-tu que je te laisse?
CLEO.	CLEO.
MEDE.	MÈDE.
Il n’eſt plus temps de plaindre, il le faut ſecourir, Emportons-le chez voüs, il peut encor guerir.	Il n'est plus temps de plaindre, il le faut secourir, Emportons-le chez voüs, il peut encor guérir.
Arbante aßiſteZ nous.	Arbante assistés nous.
PHALANTE.	PHALANTE.
O pitoyable office, Helas auec quel cœur te rends-je ce ſeruice!	Ô pitoyable office, Hélas avec quel cœur te rends-je ce service!
Cher & noble fardeau d’vn mal-heureux amy Dans ce reſte d’eſpoir dois-je viure à demy --.	Cher et noble fardeau d'un malheureux ami Dans ce reste d'espoir dois-je vivre à demi -mo-.
V V--d	V Vit
A R A SCENE PREMIERE PHA LANTE ſeul.	À R À SCÈNE PREMIÈRE PHA NTE seul.
Sprit d’vn cher amy que ma main meurtriere, Pour me priuer de vie, a priué de lumiere, Belle ombre qui là bas errante ſans ſoucy, Es exempte des maux que ie reſſens icy, Si des reſtes d’amour t’ont defendu de boire L’onde qui pour tamais enleue la memoire, Leue les yeux amy pour voir le triſte eſtat Ou l’horreur de ſon crime a reduit cet ingrat, Voy ce profond ſilence, & voy quelles tenebres 123 Accompagnent mon deüil & mes deuoirs funebres, -.	Sprit d'un cher ami que ma main meurtrière, Pour me priver de vie, a privé de lumière, Belle ombre qui là bas errante sans souci, Es exempte des maux que ie ressens ici, Si des restes d'amour t'ont défendu de boire L'onde qui pour tamais enlève la mémoire, Leue les yeux ami pour voir le triste état Ou l'horreur de son crime a réduit cet ingrat, Voi ce profond silence, et vois quelles ténèbres 123 Accompagnent mon deüil et Pour ces devoirs, -.
.	.
·-	·-
Miracle de beauté, Princeſſe infortunée, Que ie pleure ton ſort, pleurant ma deſtinée, Fcy tout retiré de la Cour & du bruit, Ie me couure auec toy d’vne eternelle nuit, Et fuyant la clarté que ma main t’a rauie, Ie traiſne à ton cercueil vne mourante vie, Iuſqu’à ce que mon deüil en retranche le cours, Et que ie te rejoigne au dernter de mes iours:	Miracle de beauté, Princesse infortunée, Que ie pleure ton sort, pleurant ma destinée, Fcy tout retiré de la Cour et du bruit, Je me couvre avec toi d'une éternelle nuit, Et fuyant la clarté que ma main t'a ravie, Je traîne à ton cercueil vne mourante vie, Jusqu'à ce que mon deuil en retranche le cours, Et que ie te rejoigne au dernter de mes jours:
Regrets, iuſtes regrets, repentire legitimes, Ah!	Regrets, justes regrets, repentire légitimes, Ah!
que vous eſtes lents à la peine des crimes, Que vous m'eſtes cruels me paroiſſans ſi doux, Et que vous differez ce que i’attends de vous:	que vous êtes lents à la peine des crimes, Que vous m'êtes cruels me paraissants si doux, Et que vous différez ce que j'attends de vous:
Mais tu ſouffres encor remords lent, remords laſche, Qu'vne autre paßion a mon ame s’attache, Et que dans les tombeaux, le ſilence, & l’horreur, L’amour ſe meſle encore auecque la douleur, Helas dans vn cercueil où mon-amy m’appelle, Ne me tourmente plus paſsion criminelle!	Mais tu souffres encor remords lent, remords lâche, Qu'une autre passion a mon âme s'attache, Et que dans les tombeaux, le silence, et l'horreur, L'amour se mêle encore avec la douleur, Hélas dans un cercueil où mon-mi m'appelle, Ne me tourmente plus passion criminelle!
Fay place à ma douleur, fay place a ma raiſon, Amour, ingrate amour, tu n’es plus de ſaiſon, Ce n’eſt point dans ces lieux ſolitaires & ſombres, Le ſiege de la mort, & le ſejour des ombres, Où tant de paſsions-tyranniſent mon cœur, Que tu cherches vn troſne enuironne d’horreur:	Fais place à ma douleur, fais place à ma raison, Amour, ingrate amour, tu n'es plus de saison, Ce n'est point dans ces lieux solitaires et sombres, Le siège de la mort, et le séjour des ombres, Où tant de passions-tyrannisent mon cœur, Que tu cherches un trône environne d'horreur:
Icy le deſeſpoir s’eſtablit & te chaſſe, La terreur, le remords ont occupé ta place, Et te laiſſant choiſir des Empires meilleurs, Ils te diſent Amour que tu regnes ailleurs.	Ici le désespoir s'établit et te chasse, La terreur, le remords ont occupé ta place, Et te laissant choisir des Empires meilleurs, Ils te disent Amour que tu règnes ailleurs.
Et que ie reſſens bien que le Ciel fut cruel D’embraſer nos deux cœurs d’vn amour mutuel.	Et que ici ressens bien que le Ciel fut cruel D'embraser nos deux cœurs d'un amour mutuel.
Et par la ſimpathie exciter dans nos ames De pareils mouuemens & de pareilles flames:	Et par la sympathie exciter dans nos âmes De pareils mouvements et de pareilles flammes:
S’il n’allumoit en nous ce funeſte flambeau, Que pour en eſclairer ta perte & mon tombeaut, Donc pour paroiſtre amy iuſques dans la mort meſme, Il faut que ie te fuye encore que ie t’ayme, Et qu’abhorrant monbien & ton contentement Ie face le cruel contre mon ſentiment.	S'il n'allumait en nous ce funeste flambeau, Que pour en éclairer ta perte et mon tombeaut, Donc pour paraître ami jusques dans la mort même, Il faut que je te fuie encore que tu t'aime, Et qu'abhorrant monbien et ton contentement Je face le cruel contre mon sentiment.
Faudroit-il quand le ciel n’aurcit mis dans mon ame Pour vn ſi digne object vne ſi belle flame, Que ie paruſſe ingrat aux bonnes volontés Dont tu m'as ſoulage dans mes aduerfités?	Faudrait-il quand le ciel n'aurcit mis dans mon âme Pour un si digne objét une si belle flamme, Que ie parusse ingrat aux bonnes volontés Dont tu m'as soulage dans mes aduerfités?
Tu m’offres tes Eſtats, tu m'offres ta Couronne, Et ce qui m'eſt plus cher, tu m'offres ta perſonne.	Tu m'offres tes États, tu m'offres ta Couronne, Et ce qui m'est plus cher, tu m'offres ta personne.
Et ne deſdaignant point de te donner à moy, Tu faits de ton captif ton eſpoux & ton Roy.	Et ne dédaignant point de te donner à moi, Tu faits de ton captif ton époux et ton Roi.
Cependant pour le prix d’vne bonté ſi rare, Ie ſuis ingrat, cruel, inhumain & barbare, Et malgré mon amour, & la ciuilité, Ie te traicte, ma Reine, auec indignité, I'ay ſi mal ſatisfait ta derniere viſite Et mes diſcours glacez t’ont ſi fort interdite.	Cependant pour le prix d'une bonté si rare, Je suis ingrat, cruel, inhumain et barbare, Et malgré mon amour, et la civilité, Je te traite, ma Reine, avec indignité, J'ai si mal satisfait ta dernière visite Et mes discours glacés t'ont si fort interdite.
Que demeurant confus de ton ſoudain dé part.	Que demeurant confus de ton soudain dé part.
I’ay leu ton deſeſpoir dans ton dernier regard.	J'ai lu ton désespoir dans ton dernier regard.
Malgré toy tes beaux yeux ont verſé quelques larmes, - *---- Et ce Tygre l’a veu ſans mettre bas les armes.	Malgré toi tes beaux yeux ont versé quelques larmes, - Et- Et ce Tigre l'a vu sans mettre bas les armes.
Ceſte ame de rocher, ce courage endurcy, A veu couler tes pleurs ſans en reſpandre außi.	Cette âme de rocher, ce courage endurci, À veu couler tes pleurs sans en répandre aussi.
Ah!	Ah!
Phalante, c’eſt trop, il eſt temps de ſe rendre, Deſormais ta valeur n'eſt plus à te deffendre, Ton amour juſqu’icy cede à ton amitié, Bien reſiſte à l’amour, mais cede à la pitié.	Phalante, c'est trop, il est temps de se rendre, Désormais ta valeur n'est plus à te défendre, Ton amour jusqu'ici cède à ton amitié, Bien résiste à l'amour, mais cède à la pitié.
Ouy, ſauue par pitié ceſte adorable Reyne, Tu le peux deſormais ſans nuire à Philoxene, Tu le peux deſormais ſans troubler ſon repõs, Meſme s’il t’en ſouuient ce ſont ſes derniers mots, Et cet amy fidele en perdant la lumiere, En te diſant adieu, t’a fait cette priere.	Oui, sauve par pitié cette adorable Reine, Tu en peux désormais sans nuire à Philoxène, Tu le peux désormais sans troubler son réponds, Même s'il t'en souvient ce sont ses derniers mots, Et cet amy fidèle en perdant la lumière, En te disant adieu, t'a fait cette prière.
Contente ton deuoir, contente ton amy, Et puis qu’il l’avoulu, vy pour Helene, vy, Ton amy te l’ordonne il faut l’aymer& viure;	Contente ton devoir, contente ton ami, Et puis qu'il l'avoulu, vis pour Hélène, vi, Ton ami te l'ordonne il faut l'aimer Seigneur;
O laſche mouuement, meurs pluſtoſt pour le ſuiure, Philoxene n’eſt plus, mais tu l’as fait mourir, Fuy le jour, fuy la honte, & ſonge à te guerir.	Ô lâche mouvement, mûrs plustost pour le suivre, Philoxène n'est plus, mais tu l'as fait mourir, Fui le jour, fui la honte, et songe à te guérir.
Quoy tu pourras ſouffrir que tout le monde die Que Phalante eſt heureux par vne perfidie?	Quoi tu pourras souffrir que tout le monde die Que Phalante est heureux par une perfidie?
Qu'il joüit de ſon crime & qu'il perca le ſein:	Qu'il jouit de son crime et qu'il perça le sein:
A ſonmeilleur amy pour ce laſche deſſein.	À sonmeilleur ami pour ce lâche dessein.
Pardon, cher Philoxene, ame illuſtre, ame chereIl eſt comme Un eſclair dans mon ame paſſe Il ſe formoit à peine & tu l’as effacé, Mais ie ſçay qu'il t’offence & merite ta haine.	Pardon, cher Philoxène, âme illustre, âme chèreIl est comme Un éclair dans mon âme passe Il se formait à peine et tu l'as effacé, Mais ainsi sais qu'il t'offense et mérite ta haine.
SCENE II.	SCÈNE II.
ARBANTE, PHALANTE, AMINTE.	ARBANTE, PHALANTE, AMINTE.
ARBANTE.	ARBANTE.
Minte vous vient voir de la part de la Reyne.	Minte vous vient voir de la part de la Reine.
PHALANTE.	PHALANTE.
Cruel redoublement à mes viues douleurs, Reyne pour qui je crains, Reyne pour qui ie meurs, Quel ſoin te peut encorreſterd’vne ame ingrate.	Cruel redoublement à mes vives douleurs, Reine pour qui je crains, Reine pour qui je meurs, Quel soin te peut encorrêterd'une âme ingrate.
AMINTE.	AMINTE.
Encor ce mouuement de quelque eſpoirme flate, Il parle de la Reyne, ô Dieux changez ce cœur!	Encore ce mouvement de quelque espoirme flatte, Il parle de la Reine, ô Dieux changez ce cœur!
PHALANTE.	PHALANTE.
Aminte quel deſſein.	Aminte quel dessein.
AMIN – - 7	AMIN - 7
AMINTE.	AMINTE.
Vous me voyez Seigneur A'mie comamanuemenr a vne Reſne aſſigce.	Vous me voyez Seigneur A'mie comamanuement à une Rêne assigce.
PHALANTE.	PHALANTE.
Dieux, pourquoy par ma mort n’eſt-elle ſoulagée?	Dieux, pourquoi par ma mort n'est-elle soulagée?
Et ie la ſouffrirois auec tant de plaiſir.	Et ici la souffrirais avec tant de plaisir.
S.	S.
AMINTE.	AMINTE.
Seigneur dans ce papier vous verrés ſon deſir.	Seigneur dans ce papier vous verrez son désir.
LETIREDHELENE A PHALANTE.	LETIREDHÉLENE A PHALANTE.
Phalante lit.	Phalante lit.
Itout ce que i’ay faict n’a pû vous eſmouuoir, Souffrés à mon treſpas que ie me ſatisface, Et que vous demandant le bon-heur de vous voir, Pour la derniere fois i'obtienne ceſte grace;	Itout ce que j'ai fait n'a pu vous émouvoir, Souffrez à mon trépas que femme me satisface, Et que vous demandant le bonheur de vous voir, Pour la dernière fois j'obtienne cette grâce;
Je n'attens plus que vous pour partir de ce lieu, Que ie ne puis quitter ſans vous dire vn adieu.	Je n'attends plus que vous pour partir de ce lieu, Que je ne puis quitter sans vous dire un adieu.
PHALANTE continuë.	PHALANTE continue.
Il eſt iuſte, il eſt temps que la mort nous ſepare, Mais toute ſa rigueur n’eſt que pour ce barbare, Ma Reyne, ton eſcrit m'enſeigne mon deuoir, C’eſt le plus doux arreſt que i en puis receuoir, .	Il est juste, il est temps que la mort nous sépare, Mais toute sa rigueur n'est que pour ce barbare, Ma Reine, ton écrit m'enseigne mon devoir, C'est le plus doux arrêt que y en puis recevoir, .
T -a .	 Ta .
.	.
T.	T.
	
Allons dire vi adieu qui finit ma diſgrace.	Allons dire vi adieu qui finit ma disgrâce.
Il eſt iuſte, il eſt temps que ie te ſatisfaſſe.	Il est juste, il est temps que Seigneur te satisfasse.
SCENE III.	SCÈNE III.
gaekalt lals e nuee Mauas AMsasRn dans ſa chambre aſſiſe ſur ſom lis venant de prendre du poiſoa.	gaedal lals é nuée Mavas AMsasRn dans sa chambre assise sur som lis venant de prendre du poisoa.
L ARATE.	 LRATE.
A!	À!
Madame, voyez nos ſenſibles regrets, Helas!	Madame, voyez nos sensibles regrets, Hélas!
que vous ont fait vos fideles ſujects, Qui vous puiſſe obliger par vn exceZ de haine A les faire mourir dans la mortlde leur Reyne?	que vous ont fait vos fidèles sujets, Qui vous puisse obliger par un excès de haine À les faire mourir dans la mortlde leur Reine?
Ouy Madame mourir, voſtre Empire eſt ſi doux;	Oui Madame mourir, votre Empire est si doux;
Que ce Royaume entier doit perir auec vous:	Que ce Royaume entier doit périr avec vous:
Et quand par ceſte mort vous leur ſerez rauie, Ce cou penleuera leur repos & leur vie.	Et quand par cette mort vous leur serez ravie, Ce cou penlevera leur repos et leur vie.
C’eſt ce qu’à leurs- ſouhaits vous auiez donc promis, C’eſt le ſanglant arreſt que vous auiez remis, Et vos rigueurs, Madame, à leur douce ſemonce Deſtinoient ceſte ingrate!	C'est ce qu'à leurs- souhaits vous aviez donc promis, C'est le sanglant arrêt que vous aviez remis, Et vos rigueurs, Madame, à leur douce semonce Destinaient cette ingrate!
& cruelle reſponce.	et cruelle réponse.
Helas!	Hélas!
conſiderez à quelle extremité Vous nous reduiſez tous par ceſte cruauté, Et ſi vous dédaignez vn peuple qui vous ayme, ConſidereZ quel tort vous faites à vous meſme, ----- Combien onblâmera ce deſſein furieux, Combien ce deſeſpoir irritera les Dieux:	considérez à quelle extrémité Vous nous réduisez tous par cette cruauté, Et si vous dédaignez un peuple qui vous aime, Considèrez quel tort vous faites à vous même, -- Combien onblâmera ce dessein furieux, Combien ce désespoir irritera les Dieux:
Et de quelle importance est vne telle injure, Ercomte tes granas MDichx &s comnela Nafure.	Et de quelle importance est une telle injure, Ercomte tes granas MDichx ets comnela Nafure.
CLEOMEDE.	CLÉOMEDE.
D'eſtruirez-vous ainſi leur chef-d’œuure plus beau, Et par vos propres mains mettrez-vous au tombeau La plus grande, plus juſte, & plus belle perſonne, Qui parmy les mortels nous ayt, porté la couronné.	D'étruirez-vous ainsi leur chef-d'œuvre plus beau, Et par vos propres mains mettrez-vous au tombeau La plus grande, plus grande, et plus belle personne, Qui parmi les mortels nous ait, porté la couronné.
Madame, par pitié ſongeZencore à vous, Vos fideles ſubjects vous en conjurent tous.	Madame, par pitié songezencore à vous, Vos fidèles sujets vous en conjurent tous.
Ah!	Ah!
ue refuſez plus leur priere & leur ayde, Un peut encore au mal donner quelque remede, Peut eſire ce poiſon n'eſt pas ſi violent Qu'on n'y puiſſe apporter.	Que refusez plus leur prière et leur aide, Un peut encore au mal donner quelque remède, Peut ire ce poison n'est pas si violent Qu'on n'y puisse apporter.
	
HELENE.	HELENE.
Helas!	Hélas!
ileſt troplent, Et le cruel ſeruant mon ingrate fortune, Laiſſe par trop-durer vne vie importune:	ilest troplent, Et le cruel servant mon ingrate fortune, Laisse par trop-durer une vie importune:
Mais bien qu’ilſoit ſi lent à ſeruir ma douleur, Ie ſens bien mes amis qu’il approche du cœur, Qu'il gaigne ceſte noble & derniere partie, Et que deſia mon ame eſt prés de ſa ſortie.	Mais bien qu'ilsait si lent à servir ma douleur, Je sens bien mes amis qu'il approche du cœur, Qu'il gagne cette noble et dernière partie, Et que déjà mon âme est prés de sa sortie.
Ne reſpandez donc plus tant d’inutiles pleurs, Et ne me donnez point par vos viues douleurs Gelle de vous quiiter, & ceste preune inſigne c.	Ne répandez donc plus tant d'inutiles pleurs, Et ne me donnez point par vos vives douleurs Gelle de vous quiiter, et cette préune insigne ç.
.	.
.	.
L 2–– ---.	 L224 --.
D’vne fidelité dont ie me ſens indigne, Ne me regretteZ point trop fideles ſujects, Ma derniere action condamne vos regrets.	D'une fidélité dont ) me sens indigne, Ne me regrettez point trop fidèles sujets, Ma dernière action condamne vos regrets.
Et par des laſchetés dont le remords m’accable, Du rang que i'ay tenu, ie me rends incapable:	Et par des lâchetés dont le remords m'accable, Du rang que j'ai tenu, une me rends incapable:
Celle qui du deuoir a fait ſi peu d’eſtat, Et qui s'eſt abaiſſée à prier vn ingrat, Soubmettant à ſes pieds ſon Sceptre & ſa perſonne, Eſt indigne a iamais de porterla Couronne, Et de regner encor ſur des gens comme vous, A pres des laſcheteZ qui les offencent tous.	Celle qui du devoir a fait si peu d'état, Et qui s'est abaissée à prier un ingrat, Soubmettant à ses pieds son Sceptre et sa personne, Est indigne a jamais de porterla Couronne, Et de régner encor sur des gens comme vous, A pres des lâchetés qui les offensent tous.
Ceſte ſeule raiſon m'a ſans doute pouſſée A vanger par ma mort ma dignité bleſſée, Et ſatisfaire ainſi mon peuple & mon deuoir, Pluſt oſt par la raiſon que par le deſeſpoir.	Cette seule raison m'a sans doute poussée A venger par ma mort ma dignité blessée, Et satisfaire ainsi mon peuple et mon devoir, Plut ost par la raison que par le désespoir.
Ce n'est point mes amis vne amour qui me porte A donner de mon deüil vne preuue ſi forte, Si ie mourois pour luy, l’ingrat ſeroit trop vain, Et i'ay dans mon treſpas vn plus iuſte deſſein, Ie meurs pour me donner la peine qui m'eſt deuë, Et ne ſurviure point à ma gloire perdué.	Ce n'est point mes amis une amour qui me porte A donner de mon deüil point prévue gloire forte, Si éclat serait trop vain, l'ingrat serait trop vain, Et j'ai dans mon trépas un plus juste dessein, Je mûrs pour me donner la peine qui m'est due, Et ne survivre point à ma gloire perdué.
Heureuſe en mon treſpas, ſi de voſtre penſer La cauſe de ma mort ſe pouuoit effacer, Et s’il peut parmy vous ſauuer la renommée De celle qu'autresfois vous auez tant aymée, I'ay voulu mes amis vous voir tous en ce lieu, Pour vous en ſupplier, & pour vous dire adieu.	Heureuse en mon trépas, si de votre penser La cause de ma mort se pouvait effacer, Et s'il peut parmi vous sauver la renommée De celle qu'autrefois vous avez tant aimée, J'ai voulu mes amis vous voir tous en ce lieu, Pour vous en supplier, et pour vous dire adieu.
Vn Roy digne de vous, & qui vous ſatisface Par ſa protection & parmille bien-faits Aununa qommommumoumoouua pen ſutisfaits,	Un Roi digne de vous, et qui vous satisface Par sa protection et parmille bienfaits Auna qommommumoumoouua pen sutisfaits,
ARATE.	ARATE.
Ah!	Ah!
diſcours qui me bleſſe au plus vif de mon ame.	discours qui me blesse au plus vif de mon âme.
DERNIERE SCENE FTIALANTESIIELEtTE, ARBANTE, CLEONE, ARATE, CLEOMEDE, AMINTE.	DERNIÈRE SCÈNE FTIALANTESIELETTE, ARBANTE, CLEONE, ARATE, CLEMEDE, AMINTE.
ATTALANTE.	ATTALANTE.
l detrangeppeaatle s.	l' detrangeppeaatle s.
CLEONE.	CLÉONE.
Ah!	Ah!
ie meurs.	Elle meurs.
CLEOMEDE Ah!	CLÉOMEDE Ah!
Madame, Vous pouués-vous reſoudre à nous quitter ainſi?	Madame, Vous pépé-vous résoudre à nous quitter ainsi?
Eh bien, nous vous ſuiurons.	Eh bien, nous vous suivrons.
.	.
HELENEO grands Dieux le voicy & ---	HÉLENEO grands Dieux le voic et --
L'itt	L'itt
86 Ah!	86 Ah!
Ie cruel, mon cœur fremit à ceſte veuë, Et d’vn object ſi chermoname retenué, Bien que cet inhumain la preſſede partir, S’arreſte ſur le bord toute preſte à ſortir.	Je cruel, mon cœur frémit à cette vue, Et d'un object si chermoname retenué, Bien que cet inhumain la presse partir, S'arrête sur le bord toute prête à sortir.
ApprocheZ-vous Phalante, & ſi dans voſtre haine Vous eſtes inſenſible aux malheurs d’vne Reyne, Que voſire cruaute met en ce triſte eſtat, Par ce funeſte object ſoulez ce cœur ingrat.	Approchez-vous Phalante, et si dans votre haine Vous êtes insensible aux malheurs d'une Reine, Que vosire cruauté met en ce triste état, Par ce funeste object soûlez ce cœur ingrat.
Ie vous ay fait ſortir de ces demeures ſombres, Oùvous vous occupeZ à l’entretien des ombres, Pour donner a vos yeux vn diuertiſſement, Qui doit à vos douleurs ſeruir d’allegement, Pour reparer ma faute & ſouler voſtre haine, Ie vay dans les enfers redire à Philoxene l'ar quel traits de conſtance ou d’inhumanité, Vous ſignaleZ encor voſtre fidelité, Puis que par mon trepas ie reſpare mon crime, Et qu’il reçoit de vous vne telle, victime;	Je vous ai fait sortir de ces demeures sombres, Où vous occupés à l'entretien des ombres, Pour donner à vos yeux un divertissement, Qui doit à vos douleurs servir d'allégement, Pour réparer ma faute et soûler votre haine, Je vais dans les enfers redire à Philoxene l'ar quel traits de constance ou d'inhumanité, Vous signaleZ encor votre fidélité, Puis que par mon trépas avoir répare mon crime, Et qu'il reçoit de vous un telle, victime;
S’il conſerue pour nous quelque reſte de foy Il ſera ſatisfait & de vous & de moy.	S'il conserve pour nous quelque reste de foi Il sera satisfait et de vous et de moi.
* Pour vous, bien qu’il me reſte vn ſuject aſſés ample, D’accuſer en mourant des rigueurs ſans exemple, nu pujminmentt uvhulaivemvno plis uouse;	* Pour vous, bien qu'il me reste un suject assez ample, D'accuser en mourant des rigueurs sans exemple, nu pujminment uvhulaivemvno plis uouse;
I'euſſe quelque raiſon de me plaindre de vous, Pne, Les Dieux me ſont teſmoins que ie vous voy sãs haiEt que de mon erreur ie vais ſouffrir la peine, En demandant au Cielpour dernieres faueurs, Qu'il face proſperer l’ingrat pour qui ie meurs;	J'eusse quelque raison de me plaindre de vous, Pine, Les Dieux me sont témoins que je vous vois sãs hait que de mon erreur Seigneur vais souffrir la peine, En demandant au Cielpour dernières faveurs, Qu'il face prospérer l'ingrat pour qui ie meurs;
Viuez dans le repos où ma mort vous fait viure, Les importuniteZ dont elle vous deliure Ne viendront plus troubler vostre tranquillité Et n’esbranleront plus vostre fidelité.	Vivez dans le repos où ma mort vous fait vivre, Les importunités dont elle vous délivre Ne viendront plus troubler votre tranquillité Et n'ébranleront plus votre fidélité.
I'ay pris pour ce deſſein vn poiſon ſalutaire, Qui doit lauer ma faute, & vous doit ſatisfaire, Vous faiſant auouer que ie meurs à propos, Pour l’honneur qui me reste & pour voſtre repos.	J'ai pris pour ce dessein un poison salutaire, Qui doit lauer ma faute, et vous doit satisfaire, Vous faisant avouer que je meurs à propos, Pour l'honneur qui me reste et pour votre repos.
Ce pendant ſi ie puis apres tant de prieres Croire que vos bontez exaucent les dernieres, Accordez moy ce bien quelque amour qu’il ayt eu De croire que mon cœur adoroit la vertu, Et que iamais peut estre vne plus ſaincte flame, .	Ce pendant si grands puis après tant de prières Croire que vos bontés exaucent les dernières, Accordez moi ce bien quelque amour qu'il ait eu De croire que mon cœur adorait la vertu, Et que jamais peut -être plus sainte flamme, .
2 Ny de plus beaux deſſeins n’allumerent vne ame, omn ouertucommtumuimloſte grace de vous Dans mon dernier moment mon ſort ſera plus doux, Et mon ame aux enfers ira tres-ſatisfaite, En ayant obtenu tout ce que ie ſouhaite.	2 Ni de plus beaux desseins n'allumèrent une âme, omn ouertucommtumuimloste grâce de vous Dans mon dernier moment mon sort sera plus doux, Et mon âme aux enfers ira très-satisfaite, En ayant obtenu tout ce que sans souhaite.
PHALANTE.	PHALANTE.
Eſprit de mon amy pleind’amour & de foy, Toy qui ſçais maintenant ce que i'ay fait pourtoy.	Esprit de mon ami pleind'amour et de foi, Toi qui sais maintenant ce que j'ai fait pourtoi.
Si de mes actions la derniere t'offence, Pardonne à ceste amour qui me fait violence, Puis que ne l’auouant qu'a ceſte extremité, Ma mort vare parer mon infidelité.	Si de mes actions la dernière t'offense, Pardonne à cette amour qui me fait violence, Puis que ne l'avouant qu'à cette extrémité, Ma mort vare parer mon infidélité.
Et vous Maiſtres des Roys, diuinités ſu prem c5.	Et vous Maîtres des Rois, divinités su prem c5.
Qui ſçauez nos deſſeins beaucoup mieux que nous meſmes.	Qui savez nos desseins beaucoup mieux que nous mêmes.
t :	t :
.	.
.	.
	
58 Vous fuſtes ſeuls teſmoins de mon affection, Soyés-le außi grands Dieux de ma confeßion, Et lancés ſi ie ments ſur ma teſte coulpable Ce que voſtre cholere a de plus redoutable.	58 Vous fûtes seuls témoins de mon affection, Soyez-le aussi grands Dieux de ma confession, Et lancez si grande mens sur ma tête coulable Ce que votre colère a de plus redoutable.
Chef d’œuure le plus beau qui de la main des Dieux Fut iamais enuoyé pourbriller à nos yeux, Lumiere de nos iours & que i'ay ſeul eſteinte Par vne de plorable & cruelle contrainte, Grande Reyne l’amour de tout ceſt Vniuers, Beauté que j'idolâtre & beauté que ie perds, Tournez de vos beaux yeux la lumtere mourante, Et voyez à vos pieds le deſolé Phalante Preſt à vous ſatisfaire auecce meſme cœur, Qui s’arma contre vous d’vne fauſſe rigueur;	Chef d'œuvre le plus beau qui de la main des Dieux Fut jamais envoyé pourbriller à nos yeux, Lumière de nos jours et que j'ai seul éteinte Par une de plorable et cruelle contrainte, Grande Reine l'amour de tout cest Vnivers, Beauté que j'idolâtre et beauté que ie perds, Tournez de vos beaux yeux la lumère mourante, Et voyez à vos pieds le désolé Phalante Prêt à vous satisfaire auecce même seul, Qui s'arma contre vous d'une fausse rigueur;
Dans ces extremiteZ il n’eſt plus temps de feindre L’eſtat ou ie vous voy me permet de me plaindre, Et de vous declarer ce que ce cœur noircy, A tout le monde entier à caché iuſqu' icy.	Dans ces extrémité il n'est plus temps de feindre Létat ou je vous vois me permet de me plaindre, Et de vous déclarer ce que ce cœur noirci, À tout le monde entier à caché iusqu' temps.
Quoy que ma paßion cedat à ma contrainte, Iamais ame ne fut ſi viuement attainte, Et ne bruſla d’vn feu ſi parfait & ſi beau Que celuy qui m'enflame, & me guide au tombeais;	Quoi que ma passion cédât à ma contrainte, Jamais âme ne fut si vivement attainte, Et ne brûla d'un feu si parfait et si beau Que celui qui m'enflamme, et me guide au tombe;
Bien qu’il ſouffrît pour vous d’vne ardeur violente;	Bien qu'il souffrît pour vous d'une ardeur violente;
Philoxene luy meſme aymoit moins que Phalante;	Philoxène lui était aimait moins que Phalante;
Vn mal qu’il deſcouuroit eſtoit beaucoup plus doux, Il vous aymoit, Madame, & ie mourois pour vous, Les Dieux, les bois, les fleurs, & les choſes ſans ame Ont eſté ſeulement confidens de ma flame,	Un mal qu'il découvrait était beaucoup plus doux, Il vous aimait, Madame, et notre mourais pour vous, Les Dieux, les bois, les fleurs, et les choses sans âme Ont esté seulement confidents de ma flamme,
Et ſeu–	Et seu–
Et ſeulement aux Dieux;	Et seulement aux Dieux;
à des fleurs, à des bois Ce cœur deſeſperé s’eſt ouuert mille fois, Depuis le premier iour mon ame vous adore, La paßion qu'elle eut ce qui lu y reſte encore, Preuint l’affection que vous euſtes pourmoy, Mais auant mon amour i’auois donne ma foy.	à des fleurs, à des bois Ce cœur désespéré s'est ouvert mille fois, Depuis le premier jour mon âme vous adore, La passion qu'elle eut ce qui lu y reste encore, Prévint l'affection que vous eûtes pourmoi, Mais avant mon amour j'avais donne ma foi.
Ma foy que mon mal’heur indignement viole, Ouy i'eſtois engage d’hõneur & de parole, Et ie deuois ſeruir iuſqu a l’extremité, Vn amy vertueux:	Ma foi que mon malheur indignement viole, Oui j'étais engage d'honneur et de parole, Et ie deuois servir jusqu a 'extrémité, Votre ami vertueux:
Ie m’en ſuis acquité, Ou pourle moins i'ay fait ce que ié pouuois faire, Pour garder ma parole & pour le ſatisfaire, Et i’ay pour le ſeruir trahy monſentiment, Sacrifiant ma uie à ſon contentement, Ie l’ay deu, ie l’ay fait, ò ſouuenir funeſte!	Je m'en suis acquité, Ou pourle moins j'ai fait ce que j' ai faire, Pour garder ma parole et pour le satisfaire, Et j'ai pour le servir trahi monsentiment, Sacrifiant ma son contentement, Ie ay , ie ay fait, souuenir funeste!
Vous le ſçaueZ Madame, & vous verreZ le reſte, En vain pour mon àmy i'ay fait ce que i'ay peu, Vous verrez, ſi pour vous i’ay fait ce que i’ay deu.	Vous le savez Madame, et vous verrez le reste, En vain pour mon ami j'ai fait ce que j'ai peu, Vous verrez, si pour vous j'ai fait ce que j'ai devez.
Mon mal’heur m'arendu cruel à ce que i’ayme, 30 Ie l’ay perdu, vous perds, & me perdray moy-méme, Ce coulpable innocent a peché par malheur, Son amy pardonna ſoncrime à ſa douleur, Il vit ſon deſeſpoir & creut ſon innocence, Mais ie dois autrement reparer mon offence.	Mon malheur m'artendu cruel à ce que j'aime, 30 Je l'ai perdu, vous perds, et me perdrai moi-même, Ce coulpare innocent a péché par malheur, Son ami pardonna soncrime à sa douleur, Il vit son désespoir et crut son innocence, Mais ie fo autrement réparer mon offense.
Et vos bontés en vainme voudroient pardonner, Puiſque par tout mon ſang ie ne puis redonner A Timandre ſon fils à ce peuple ſa Reyne, Que ie ſuis vn object d’horreur, d’effroy, de hayne,	Et vos bontés en vainme voudraient pardonner, Puisque par tout mon sang ils ne puis redonner A Timandre son fils à ce peuple sa Reine, Que je suis un object d'horreur, d'effroi, de haine,
Pagination incorrecte - date Incorrecte NF Z 43-120-12	Pagination incorrecte - date Incorrecte NAUT Z 43-120-12
Et que moy ſeul, ô Dieux!	Et que moi seul, ô Dieux!
ay mis dans le tombeau, Ce que pour moy la terre eut d’aymable & de beau.	ai mis dans le tombeau, Ce que pour moi la terre eut d'aimable et de beau.
I'ay perdu l’vn & l’autre;	J'ai perdu l'vn et l'autre;
& les veux ſatisfaire, Vous peuple à quii enleue vne Reyne ſi chere, Su ject infortuné de qui le deuil profond, Comme il eſt dans vos cœurs ſe lit ſur vôſtre front, En deteſtant l’ingrat qui vous l’aura:	et les veux satisfaire, Vous peuple à qui enlève int Reine si chère, Su ject infortuné de qui le deuil profond, Comme il est dans vos cœurs se lit sur vôtre front, En détestant l'ingrat qui vous l'aura:
rauie, Conſi derez außi les malheurs de ſa vte.	ravie, Consi derez aussi les malheurs de sa vite.
Et vous reſſouuenez, que pour vous contenter Vos yeux deſſus ce fer l'ont veu precipiter, Et que ſa mort eſt douce enreparant ſoncrime.	Et vous ressouvenez, que pour vous contenter Vos yeux dessus ce fer l'ont vu précipiter, Et que sa mort est douce parant soncrime.
HELENE.	HELENE.
O'reparation qui n'eſt plus legitime, Ab!	O'réparation qui n'est plus légitime, Ab!
Phalanté.	Phalanté.
ARBANTE.	ARBANTE.
Ah!	Ah!
mon Maiſtre, ô malheur de mes iours!	mon Maître, ô malheur de mes jours!
Helas Jaßiſtés-moy.	Hélas Jassistés-moi.
PHALANTE.	PHALANTE.
I'abhorre ton ſecours.	J'abhorre ton secours.
HELENE.	HELENE.
Ah!	Ah!
cruel à moyſeule, & non pas à toy-meſme, Qui te donnes la mort a cauſe que ie t’ayme, Pourme perdre deux fois, faiſant vn double effort, Et cruel dans ta vie, & cruel dans ta mort ---.	cruel à moiseule, et non pas à toi-même, Qui te donnes la mort a cause que sans t'aime, Pour perdre deux fois, faisant un double effort, Et cruel dans ta vie, et cruel dans ta mort --.
.	.
–– .	§ .
Acheue, acheue ingrat, & s’il te reſte encore Vnrayon de pitié pour celle qui t'adore, Finis ton homicide & preſte en ma faueur Et ton fer e ta main pour en percer ce cœur, C’eſt la qu’il faut donner la derniere bleſſure, Et que tu dois percer ta viuante figure, Ta derniere retraite eſt dans cette priſon Cnerche toy la, cruel, & preuien le poiſon, Il eſt laſche, il eſt lent, ſuppleons,	Achève, achève ingrat, et s'il te reste encore Unraion de pitié pour celle qui t'adore, Finis ton homicide et prête en ma faveur Et ton fer a main pour en percer ce cœur, C'est la qu'il faut donner la dernière blessure, Et que tu dois percer ta vivante figure, Ta dernière retraite est dans cette prison Cnerche toi la, cruel, et preuien le poison, Il est lâche, il est lent, suppléons,
PHALANTE.	PHALANTE.
Ah!	Ah!
Madame, De grace ence moment ous ie voüs rends vne ame Toute pleine de zele & d’amour & de foy, Ne me condamnez poirt, ie fay ce que ie doy, Le plus iuſte regret dont mamort eſt ſuiuie, C'eſt que pour m'aquiter te ne perds qu'vnenie, Et qu’ayant fait mourir ma Reyne & mon amy, Ie ne puis en mourant les payer qu'à demy.	Madame, De grâce ence moment ous avoir verts rends une âme Toute pleine de zèle et d'amour et de foi, Ne me condamnés poir, je fais ce que je dois, Le plus juste regret dont mamort est suivie, C'est que pour m'aquitter te ne perds qu' sallie, Et qu'ayant fait mourir ma Reine et mon ami, Je ne puis en mourant les payer qu'à demi.
Ie perds la voix, adieu receuez	Je perds la voix, adieu recevez
HELENE.	HELENE.
ARBANTE.	ARBANTE.
D--	D-
HELENE.	HELENE.
Il eſt mort, & moy ie ſuis viuante:	Il est mort, et moi on suis vivante:
Et l’effort du poiſon eſt ſi foible & ſi lent, Pour me faire mourir d’vn coup plus violent, Bien que par ton moyen mamort ſoit aſſeurée, Ie te maudis cruel qui l’as tant differée, Et qui par ton ſecours me pourrois garantir Du regret qui me tuë auant que de partir.	Et l'effort du poison est si faible et si lent, Pour me faire mourir d'un coup plus violent, Bien que par ton moyen mamort soit assurée, Je te maudis cruel qui l'as tant différée, Et qui par ton secours me pourrais garantir Du regret qui me tue avant que de partir.
Ah!	Ah!
ie ſens ſonapproche, vne mortelle glace Gagne deſia mon cœur & l’ame qu’elle chaſſe, Và rejoindrr Phalante au partir de ce lieu, Adieu mes chers amis ne pleurez plus, Adieu.	Les sens sonproche, une mortelle glace Gagne déjà mon cœur et l'âme qu'elle chasse, Và rejoindrr Phalante au partir de ce lieu, Adieu mes chers amis ne pleurez plus, Adieu.
.	.
C - L	Ç - Ç
HELENE.	HELENE.
Il eſt mort, & moy ie ſuis viuante:	Il est mort, et moi on suis vivante:
Et l’effort du poiſon eſt ſi foible & ſi lent, Pour me faire mourir d’vn coup plus violent, Bien que par ton moyen mamort ſoit aſſeurée, Ie te maudis cruel qui l’as tant differée, Et qui par ton ſecours me pourrois garantir Du regret qui me tuë auant que de partir.	Et l'effort du poison est si faible et si lent, Pour me faire mourir d'un coup plus violent, Bien que par ton moyen mamort soit assurée, Je te maudis cruel qui l'as tant différée, Et qui par ton secours me pourrais garantir Du regret qui me tue avant que de partir.
Ah!	Ah!
ie ſens ſonapproche, vne mortelle glace Gagne deſia mon cœur & l’ame qu’elle chaſſe, Và rejoindrr Phalante au partir de ce lieu, Adieu mes chers amis ne pleurez plus, Adieu.	Les sens sonproche, une mortelle glace Gagne déjà mon cœur et l'âme qu'elle chasse, Và rejoindrr Phalante au partir de ce lieu, Adieu mes chers amis ne pleurez plus, Adieu.
.	.
C - L	Ç - Ç
