MARQUIS LO DE DIS ſur la ſellette, CRIMINEL examiné en jugement par L’EUROPE & ſes filles, ſes interrogats, ſes reponſes, & enfin ſa Sentence portée par l’Europe.	MARQUIS LO DE DIS sur la sellette, CRIMINEL examiné en jugement par L'EUROPE et ses filles, ses interrogats, ses réponses, et enfin sa Sentence portée par l'Europe.
Louvois à l’inſtant de ſa mort.	Louvais à l'instant de sa mort.
A 2 Les ordres n’eſtoient rien ſi je n’euſ ſe dit ouy Où ſont donc mes laquais?	A 2 Les ordres n'étaient rien si je n'eus se dit ou Iù sont donc mes laquais?
mes pages mes flatteurs?	mes pages mes flatteurs?
Hola?	Holà?
où étes-vous tous mes adorateurs?	où êtes-vous tous mes adorateurs?
12 Caron au bord du Stix, Tout beau, qui étes vous Monſicu le fanfaron?	12 Caron au bord du Stix, Tout beau, qui êtes vous Monsicu le fanfaron?
11001 Je vous apprendrai bien à reſpecte Caron.	11001 Je vous apprendrai bien à respecte Caron.
On ne trouve icy bas ny pages n Laquais, ll a Ia D’abord qu’on y eſt entré l'on n'er ſort jamais.	On ne trouve ici bas ni ages n Laquais, ll a y EST entré l'on y est entré l'on n'er sort jamais.
Icy tout eſt egal, le berger, le Mo narque Entre famlereniiene, ſe premie dans ma barque.	Ici tout est égal, le berger, le Mo narque Entre famlereniène, se premie dans ma barque.
Parle donc, mon amy, ſans tarde davantage.	Parle donc, mon ami, sans tarde davantage.
Dy moy?	Dis -moi?
quel eſt ton nom, qu 21 eſt ton perſonnage?	quel est ton nom, qu' 21 est ton personnage?
C’eſt Louvois qui te parle, & ce ſeul nom ſuffit, De ma condition tu es aſſez inſtruit.	C'est Louvais qui te parle, et ce seul nom suffit, De ma condition tu es assez instruit.
VIVII * Caron.	VIVII * Caron.
I¶103 Ouy de par Pluton on te connoit icy.	J103 Oui de par Pluton on te connaît ici.
ein o La flue mognan Dame Europe t’attend avec un  grand ſoucy;	ein ô La flue mognan Dame Europe t'attend avec un grand souci;
Et ſelon que j’apprens ſes filles avec 91elle, iaomil Iegom  T’ont icy preparé une groſſe queelle n iO Elle a fait un recueil, dit on, en a bregé, De tes concuſſions le tout para, b, c.	Et selon que j'apprends ses filles avec 91elle, jaomil Iegom T'ont ici préparé une grosse queelle n' Ô Elle a fait un recueil, dit on, en a brégé, De tes concussions le tout para, b, ç.
comment juſtifier toutes tes incendies ?	comment justifier toutes tes incendies ?
n aal Je quel voile couvrir toutes tes perfidies?	 nal Je quel voile couvrir toutes tes perfidies?
i devois amener le Parlement de Mets ouhoih 10	j' ai amener le Parlement de Mets ouhoih 10
Si fertile en raiſons ſi fecond en arreſts, Prenant ta cauſe en main, l’Europe avec ſes filles Ne pouvoient alleguer que raiſons inutilles.	Si fertile en raisons si fécond en arrêts, Prenant ta cause en main, l'Europe avec ses filles Ne pouvaient alléguer que raisons inutilles.
D'un parfait ſcelerat & d’un vra turbulent Il eût icy prouvé que tu es innocent Meſme il euſt pû te faire eriger des autels;	D'un parfait scélérat et d'un vra turbulent Il eût ici prouvé que tu es innocent Même il eût pu te faire ériger des autels;
Te mettre dans le rang des homme immortels.	Te mettre dans le rang des homme immortels.
Ce fameux Parlement, ces Illuſtre perſonnes, Qui decident en chef des Roys & des Couronnes, Qui ſans rompre une treve ont trouvé le ſecret De prendre impunément les villes, les foreſts, Auroient facilement entrepris t deffenſe, Couvert tes trahiſons du nom de bienſeance.	Ce fameux Parlement, ces Illustre personnes, Qui décident en chef des Rois et des Couronnes, Qui sans rompre une treve ont trouvé le secret De prendre impunément les villes, les forêts, Auraient facilement entrepris t' défense, Couvert tes trahisons du nom de bienséance.
41 Ah!	41 Ah!
que tu vas ſouffrir un jugement terrible!	que tu vas souffrir un jugement terrible!
Tu paſſeras, Marquis, bientôt de crible en crible.	Tu passeras, Marquis, bientôt de crible en crible.
A propos les voicy, car le bruit de ta mort Eſt arrivé déja ſans doute à l’autre bord.	À propos les voici, car le bruit de ta mort Est arrivé déjà sans doute à l'autre bord.
Allons done, approchons, vîte ſur la ſellette:	Allons donce, approchons, vite sur la sellette:
C’eſt enmi ou n'iaut que ta grandeur ſe mette.	C'est enmi ou n'iaut que ta grandeur se mette.
Europe toute dechirée.	Europe toute déchirée.
Caron?	Caron?
Caron.	Caron.
Madame?	Madame?
Europe.	Europe.
& bien, as-tu ſuivi mes ordres?	et bien, as-tu suivi mes ordres?
10177 As-tu bien garrotté ce metteur de deſordres?	10177 As-tu bien garrotté ce metteur de désordres?
Caron.	Caron.
Madame, le voicy, il ne peut Dnmomaper.	Madame, le voici, il ne peut Dnmomaper.
3414IE Europe à ſes filles.	3414IE Europe à ses filles.
Que chacune, à ſon tour, ſe diſpoſe à parler.	Que chacune, à son tour, se dispose à parler.
Europe à Caron.	Europe à Caron.
Donne ordre cependant à Cerbere ton Chien Qu’il arrête ſans bruit pour un tems ce qui vient	Donne ordre cependant à Cerbère ton Chien Qu'il arrête sans bruit pour un temps ce qui vient
Europe à Louvois.	Europe à Louvais.
Te voila donc!	Te voilà donc!
aproche, infame  Boutefeu.	approche, infâme Boutefeu.
Me reconnois-tu bien?	Me reconnais-tu bien?
quoy, tu fais le honteux!	quoi, tu fais le honteux!
Apres avoir reduit les miens à la beſace, tu Tu n’oſes, ſcelerat, me regarder en face.	Après avoir réduit les miens à la besace, tu Tu n'oses, scélérat, me regarder en face.
20H190 Ob cron Vois-tu bien mes habits;	20H190 Ob cron Vois-tu bien mes habits;
tous ces mechans haillons q 20 ſont les triſtes effets de tes corruptions.	tous ces méchants haillons q 20 sont les tristes effets de tes corruptions.
ibdoi on	ibdoi on
Europe à ſes filles.	Europe à ses filles.
erbodlem eoy 9b voiois Ca, mes filles, venez, quand je vous conſidere, Je doute en verité ſi je ſuis vôtre merc.	erbodém oi 9b voiois Ca, mes filles, venez, quand je vous considère, Je doute en vérité si je suis votre merc.
OI NOI (Ml C2)1 Vous, ma fille, en * ſabots, vous en nol pure i chemlſe,  Ce triſte changement augmente ma  ſurpriſe.	ÔI NOI (Ml C2)1 Vous, ma fille, en * sabots, vous en nol pure y jemlse, Ce triste changement augmente ma surprise.
o Et depuis quand vous donc portezovous des J menottes?	ô Et depuis quand vous donc portezovous des J menottes?
Quittez moy ce fandeau, vous n’étés que des ſottes;	Quittez -moi ce fandeau, vous n'êtes que des sottes;
Parce qu’elles ſont d’or en étés vous plus braves?	Parce qu'elles sont d'or en été vous plus braves?
Non, car vous étés toujours d’illuſtres eſclaves.	Non, car vous estez toujours d'illustres esclaves.
A 5 BriLaFrance.	A 5 BriLaFrance.
Fle palatinat.	Fle palatinat.
Lla Suede & le Dannemars.	Lla Suède et le Dannemars.
Briſez moy ces Liens, mettes vous hors de peines.	Brisez -moi ces Liens, mettes vous hors de peines.
Dittes, n’étes-vous pas houteuſes de vos chaiſnes ?	Dittes, n'êtes-vous pas houteuses de vos chaînes ?
10 Vous pleurez, ah!	10 Vous pleurez, ah!
ce coup redouble mes tendreſſes.	ce coup redouble mes tendresses.
Ceſſez, ceſſez vos pleurs malhureuſes Deeſſes.	Cessez, cessez vos pleurs malheureuses Déesses.
Voicy de vos malheurs le fatal in10 ſtrument  Que je vous abandonne à vôtre jugement.	Voici de vos malheurs le fatal in10 strument Que je vous abandonne à votre jugement.
Faites luy ſon procez, prononcez ſa qu êt Sentence.	Faites -lui son procès, prononcez sa qu' e Sentence.
*19.	*19.
Sin M.	Sin M.
0 Conſultez pour temoins ſa ſeule  oconſcience.	0 Consultez pour temoins sa seule  oconscience.
Voyez comme il palit, & comme ſes remords Lui font desja ſouffrir plus de dix La mille morts.	Voyez comme il palit, et comme ses remords Lui font déjà souffrir plus de dix La m morts.
vOm  vousdevez commencer drop aveu gle Angleterre:	vOm vousdevez commencer drop aveu gle Angleterre:
Car vous avez cauſé cette funeſte guerre.	Car vous avez causé cette funeste guerre.
uo1 0	uo1 0
14 A OVslolocoul „ o mment muulur.	14 A USlolocoul „ ô mument muulur.
L'AnIl eſt vray je pouvois dans ſon premier principe, Arrêter ſa fureur & ſon cours trop rapide.	L'AnIl est vrai je pouvais dans son premier principe, Arrêter sa fureur et son cours trop rapide.
Je pouvois de Louys borner les grands projets, Si mon fils † euſt connu ſes propres interêts;	Je pouvais de Louis borner les grands projets, Si mon fils âme eût connu ses propres intérêts;
Mais ce traitre & Louys pour mieux jouer leur farces, Lui avoit envoyé une troüppe de garces.	Mais ce traître et Louis pour mieux jouer leur farces, Lui avait envoyé une troupe de garces.
Mon miſerable ainé avalla ce venin.	Mon misérable ainé avalla ce venin.
Portsmouth le luy donna, tout remede fut vain, Pour pouvoir le guerir de l’aſſoupiſment Que luy avont cauie un ponon ſi charmant.	Portsmout le lui donna, tout remède fut vain, Pour pouvoir le guérir de l'assoupisment Que mou ront cavie un pon si charmant.
Elle ſceut l’endormir tandis que Luxembourg A 6 Fut	Elle sut l'endormir tandis que Luxembourg A 6 Fut
1 Charles Second.	1 Charles Second.
* Premiere Maiſtreße deCharles Second.	* Première Maistresse deCharles Second.
Fut pris, & que Louys eut ſurpris Philisbourg.	Fut pris, et que Louis eut surpris Philisbourg.
Luy qu’on avoit choiſi pour le Mediateur De tous les differends des Roys, de l'Empereur;	Lui qu'on avait choisi pour le Médiateur De tous les différents des Rois, de l'Empereur;
Luy qui devoit tenir les Princes en 22 concorde, Fut celuy qui les mit preſque tous 61 en diſcorde, lance, Il la laiſſa pancher du côté de la France;	Lui qui devait tenir les Princes en 22 concorde, Fut celui qui les mit presque tous 61 en discorde, lance, Il la laissa pencher du côté de la France;
Puis étant infidele aux autres Poten11111 tats, Il ſe trahit ſoy-même & ſes propres 3 Etats:	Puis étant infidèle aux autres Poten111111 tats, Il se trahit soi-même et ses propres 3 Etats:
Enfin ce Fils mourut & je crus que ſon Frere, 2 Qui paroiſſoit pieux, doux, bon & debonnaire, Feroit executer religieuſement La treve qu’on avoit conclé pouvingt ans a LoiTu ſceus le pervertir, & ſelon tes maximes, Tu le rendis bien tôt complice de tes crimes.	Enfin ce Fils mourut et je crus que son Frère, 2 Qui paraissait pieux, doux, bon et débonnaire, Ferait exécuter religieusement La trouve qu'on avait conclé pouvingt ans a LoisTu sceus le pervertir, et selon tes maximes, Tu le rendis bien tôt complice de tes crimes.
D’un garand de la paix, il devint un parjure:	D'un garant de la paix, il devint un parjure:
Un traitre aux alliez, & puis ta creature;	Un traître aux alliés, et puis ta créature;
Et ſous cet éclatant pretexte de la Fo Tu en as fait, perfide, un ſujet de ton Roy Contredy ſi tu peux à cette verité.	Et sous cet éclatant prétexte de la Fo Tu en as fait, perfide, un sujet de ton Roi Contredi si tu peux à cette vérité.
N'avoit-il pas conclu avec toy un traitté?	N'avait-il pas conclu avec toi un traité?
Par où tu promettois le faire independant, Ainſy que tonLouys l’eſt de ſonParlement ?	Par où tu promettais le faire indépendant, Aini que tonLouis l'est de sonParlement ?
Aſſuré que tu fus de ce Roy trop credule, 1141 De tout piller, brûler, tu ne fis plus ſcrupule.	Assuré que tu fus de ce Roi trop crédule, 1141 De tout piller, brûler, tu ne fis plus scrupule.
On	On
14 On n’entendit parler que de reünions.	14 On n'entendit parler que de réunions.
On fit aux Païs-bas dix mille extor.	On fit aux Pays-bas dix mille extor.
ſions;	sions;
Puis l’Avocat Talon dans des papies moiſis D'un Caractere antique & ronge des ſouris Trouva que la Comté de Chiny choſe étrange!	Puis l'Avocat Talon dans des papies moisis D'un Caractère antique et ronge des souris Trouva que la Comté de Chiny chose étrange!
S’etendoit dans la Chyne & par delit le Gange Tu fis venir par tout les Maires des villages Et les curez à Mets au Roy prêtee hommage.	S'étendait dans la Chyne et par délit le Gange Tu fis venir par tout les Maires des villages Et les curés à Mets au Roi prêtee hommage.
* Sautrier, ce genereux Abbé Cu mandataire, En Flandre grand Seigneur que que fils de notaire Somma de par Louys le Châteaudi Namur Ou qu’il euſt à ſe rendre ou demols ſes murs;	* Sautrier, ce généreux Abé Cu mandataire, En Flandre grand Seigneur que que fils de notaire Somma de par Louis le Châteaudi Namur Ou qu'il eût à se rendre ou démols ses murs;
Inienuaut a tmit oumont & Meuſe.	Inienvaut a tit oumont et Meuse.
Puis qu’étant dependant du Comté de Chiny Il étoit bien feant qu’il luy fût reuny.	Puis qu'étant dépendant du Comté de Chiny Il était bien séant qu'il lui fût réuni.
Liege en étoit auſſi parce qu’un Roi Pepin Devoit avoir tenu à Juppille ſon train;	Liège en était aussi parce qu'un Roi Pépin Devait avoir tenu à Juppille son train;
Et puis ce Parlement ſe mit en fantaiſie De forger un nouveau Royaume d’Auſtrafie, Dont les bornes auroient contenu tout le Rhin, La Meuſe, & la Moſelle & n’eût pas  eu de fin.	Et puis ce Parlement se mit en fantaisie De forger un nouveau Royaume d'Autrafie, Dont les bornes auraient contenu tout le Rhin, La Meuse, et la Moselle et n'eût pas eu de fin.
Je ne te parle pas du feu Prince de Galles, Je ne dis rien encor de tes autres Caballes.	Je ne te parle pas du feu Prince de Galles, Je ne dis rien encor de tes autres Caballes.
Tu ne peux ignorer que le Milord Preſton A trahit le ſecret pour avoir ſon pardon.	Tu ne peux ignorer que le Milord Preston A trahit le secret pour avoir son pardon.
44 Au reſte, je n’en veux d’autres te moins que toy	44 Au reste, je n'en veux d'autres te moins que toi
Lou	Lou
Madame, tout eſt vray, mais en ſe vant mon Roy, Je creus inſolemment que tout me toit licite Et que c’étoit vertu de faire l’Hype crite.	Madame, tout est vrai, mais en se vant mon Roi, Je crus insolemment que tout me toit licite Et que c'était vertu de faire l'Hype crite.
Richelieu, Mazarin, mes deux Pr deceſſeurs 141 Avoient preſcrit ces loix à tous le Succeſſeurs;	Richelieu, Mazarin, mes deux Pr écesseurs 141 Avaient prescrit ces lois à tous le Successeurs;
Qu’il falloit ſe ſervir de la Religion Pour mettre vos Etats dans la deſt,  nionMig l Et que pour maintenir les Franço nen concorde, Il falloit que par tout on ſſemaſt l moi diſcorde.	Qu'il fallait se servir de la Religion Pour mettre vos États dans la dest, nionMig l Et que pour maintenir les Franço nen concorde, Il fallait que par tout on ssemât l' moi discorde.
Je reuſſis tres-bien, & s’il ne faut plu feindre;	Je réussis très-bien, et s'il ne faut plu feindre;
Je fis un feu chez vous que je ne pur 2 22 iéteindre Même on deut ſe ſer vir pour cat mer l’incendie D'un D'un Heros que j’avois joué en Comedie;	Je fis un feu chez vous que je ne pur 2 22 iteindre Même on deut serai ser vir pour cat mer l'incendie D'un D'un Héros que j'avais joué en Comédie;
Que j’avois fait citer au Parlement de Mets;	Que j'avais fait citer au Parlement de Mets;
Comme s’il eût été quelqu’un de mes ſujets.	Comme s'il eût été quelqu'un de mes sujets.
L’orage fut plus grand qu’on ne l’avoit preveu, On ne peut l’appaiſer comme on auroit voulu.	L'orage fut plus grand qu'on ne l'avait prévu, On ne peut l'apaiser comme on aurait voulu.
Le Prince avecꝰ ſa femme & toute ſa famille Fut obligé chez nous de chercher un azile.	Le Prince avec sa femme et toute sa famille Fut obligé chez nous de chercher un asile.
22110 Cependant je tentay par beaucoup de machines De fomenter chez vous des guerres inteſtines.	22110 Cependant je tentai par beaucoup de machines De fomenter chez vous des guerres intestines.
Je menageay ſous main de lâches trahiſons Et mes trames, enfin, furent des AVOILOIIS.	Je ménageai sous main de lâches trahisons Et mes trames, enfin, furent des AVOILOIS.
Cette confeſſion meriteroit ma grace.	Cette confession mériterait ma grâce.
4	4
L’An	L'An
Le Roy Jacques.	Le Roi Jacques.
Ouy ſi le repentir avoit icy ſi place.	Oui si le repentir avait ici si place.
Ce Heros que ton Roi citoit com.	Ce Héros que ton Roi citait com.
me un ſujet, Pour repondre en perſonne au Par.	me un sujet, Pour répondre en personne au Par.
lement de Metz, Eſt de tous mes Etats le ſeul libera.	lement de Metz, Est de tous mes États le seul libéra.
teur.	teur.
C’eſt un petit Bourgeois qui vaut ton grand Seigneur.	C'est un petit Bourgeois qui vaut ton grand Seigneur.
Où a-t-on jamais veu, le manant * de Verſailles Le piſtolet en main au milieu de batailles?	Où a-t-on jamais vu, le manant * de Versailles Le pistolet en main au milieu de batailles?
S'expoſer aux perils comme a fait mon Heros, Pour procurer aux ſiens un ſolict repos.	S'exposer aux périls comme a fait mon Héros, Pour procurer aux siens un solict repos.
A-t-il jamais receu la moindre égratignure Dans tous ſes grands exploits, ny la moindre bleſſure?	A-t-il jamais reçu la moindre égratignure Dans tous ses grands exploits, ni la moindre blessure?
D	D
Louys quatorze.	Louis quatorze.
Dy moy?	Dis -moi?
pourquoy Louys qu’on nomme l’Immortel Ne vient-il pas en Flandre attaquer un mortel ?	pourquoi Louis qu'on nomme l'Immortel Ne vient-il pas en Flandre attaquer un mortel ?
Pourquoi ce faineant demeuré en ien Royaume?	Pourquoi ce fainéant demeuré en yen Royaume?
A-tei peur des ciprits.	A-tei Ajour des ciprits.
Louvois.	Louvais.
Ouy il ſçait que Guillaume Eſt un ſpectre fatal à toutes ſes conquêtes;	Oui il sait que Guillaume Est un spectre fatal à toutes ses conquêtes;
Que juſques à preſent ma perfidie a faites.	Que jusques à présent ma perfidie a faites.
Comme il ſçait qu’il ne craint ny bombes, ny canons, Qu’il a tâché en vain ſe ſervir de poiſon.	Comme il sait qu'il ne craint ici bombes, ni canons, Qu'il a tâché en vain se servir de poison.
il crume que cee eiprit qu’il nomme temeraire Ne luy faſſe à ſon tour une fâcheuſe affaire	il crume que ece éjprit qu'il nomme téméraire Ne lui fasse à son tour une fâcheuse affaire
L’AnIl pourroit arriver.	L'AnIl pourrait arriver.
mais voiey ton amic.	mais voiei ton amic.
H0 810.	H0 810.
La France.	La France.
Dites plutoſt, ma Sœur, ſa mortelle ennemie.	Dites plutôt, ma Sœur, sa mortelle ennemie.
Ce traitre m’à reduit à mes de rners gigots:	Ce traître m'à réduit à mes de moi gigots:
Il me fera porter pour ſouliers des ſabots.	Il me fera porter pour souliers des sabots.
Par tout je porterai le noin d’une Bl.	Par tout je porterai le noin d'une Bl.
ALI.	ALI.
infidelle;	infidèle;
* AUIH Mij Et n’en ſeray-je pas l’ennemie mor.	À AUIH Ij à n'en serai-je pas l'ennemie mór.
telle?	telle?
Je ne pretens en rien luy être rede vaule , Moy-même je ſeray ſon juge impre toyable.	Je ne prétends en rien était être rede vaule , Moi-même je serai son juge impré toyable.
DB M.	DB M.
1	1
u0 Louvois.	u0 Louvois.
Vos conquêtes, Madame, en augmentant mes biens, N’as-tu pas, ſcelerat, depouillé tous les miens ?	Vos conquêtes, Madame, en augmentant mes biens, N'as-tu pas, scélérat, dépouillé tous les miens ?
Ne les as-tu pas mis preſque tous en chemiſe?	Ne les as-tu pas mis presque tous en chemise?
N’as-tu pas depouillé juſques à mes Egliſes?	N'as-tu pas dépouillé jusques à mes Églises?
A Ciboires, Chandeliers, Encenſoirs & Calices, Tout ce dont on ſe ſert dans les Saints Sacrifices, 21.	À Ciboires, Chandeliers, Encensoirs et Calices, Tout ce dont on se sert dans les Saints Sacrifices, 21.
Tous ces vaſes Sacrés convertis en monnoie, AOMTIMI Sont à preſent du Turc l’abominable proie, Et puis oſes-tu bien appeller mes conquetes Des choſes que tes lâches trahiſons ont faittes?	Tous ces vases Sacrés convertis en monnoie, AOMTIMI Sont à présent du Turc l'abominable proie, Et puis oses-tu bien appeler mes conquêtes Des choses que tes lâches trahisons ont faites?
MoaLC in Tu n’aurois eu garde d’attaquer Philisbourg Tu n’aurois pas ozé regarder Lu11 xembour :	MoaLC in Tu n'aurais eu garde d'attaquer Philisbourg Tu n'aurais pas ozé regarder Lu1 xembour :
rivage;	rivage;
1	1
Si l’Empire occupé contre les Ot.	Si l'Empire occupé contre les Ot.
thomans, Avoit eu ſur le Rhin ſes braves Al.	thomans, Avait eu sur le Rhin ses braves Al.
lemans.	lemands.
Dy moy?	Dis -moi?
quand tu les vis devav Bonne & Majance, Que firent mes François pour mon ſtrer leur vaillance?	quand tu les vis devav Bonne et Majance, Que firent mes Français pour mon strer leur vaillance?
Ainſi que les brebis fuient devan les Loups, On vid tous mes François s’enfuit de peur des coups.	Ainsi que les brebis fuient devan les Loups, On vit tous mes Français s'enfuit de peur des coups.
La Campagne paſſée, Monſieurle Dauphin Oza-t il attaquer Baviere ſur leRhint Ce Prince accoûtumé à faire des de gaſts, A-t-il jamais paru au milieu des com bats;	La Campagne passée, Monsieurle Dauphin Oza-t -il attaquer Bavière sur leRhint Ce Prince accoutumé à faire des de gâts, A-il jamais paru au milieu des com bats;
Et cette année encor que le Due des Saxons, A ſceu franchir le Rhin avec ſe s Eſcadrons, Vit-on un ſeul François occuperl Qui oſaſt un moment diſputer ſon paſſage?	Et cette année encor que le Due des Saxons, A su franchir le Rhin avec se s Cadrons, Vit-on un seul Français occuperl Qui osât un moment disputer son passage?
Où donc étoient alors tous mes fameux guerriers;	Où donc étaient alors tous mes fameux guerriers;
C’étoit un bel endroit, pour cûeillir des Lauriers.	C'était un bel endroit, pour cueillir des Lauriers.
Saxe les pourſuivit pour leur livrer bataille, Mon Marechal s’enfuit en parfaite canaille, Et traverſant le pont dreſſé à Philisbourg Fut dans le Wirtember quelque Bourg.	Saxe les poursuivit pour leur livrer bataille, Mon Marechal s'enfuit en parfaite canaille, Et traversant le pont dressé à Philisbourg Fut dans le Irtember quelque Bourg.
,ravager Sont-ce là les exploits, ſont-ce là les conquêtes, Que mes lâches François cette compagne ont faittes?	Çavager Sont-ce là les exploits, sont-ce là les conquêtes, Que mes lâches Français cette compagne ont faites?
Mon Amiral en mer n’a fait que le pirate.	Mon Amiral en mer n'a fait que le pirate.
Et enfin il a deu ſe ſauver à la hâte, Si comme l’an paſſé il eût eu des amis, euſt aſſurément cherché les ennemis.	Et enfin il a dev se sauver à la hâte, Si comme l'an passé il eût eu des amis, eût assurément cherché les ennemis.
Les miens abatardis par tes lâche pratiques, N'ont rien de la valeur de mes Gar lois antiques.	Les miens abâtardis par tes lâche pratiques, N'ont rien de la valeur de mes Gar lois antiques.
Ils ſe mettent en fuitte à la moind.	Ils se mettent en fuite à la moind.
action, Quand il n’y entre pas de conſpintion.	action, Quand il n'y entre pas de conspintion.
Le ſiege de Cony celuy de Mone melian, dibſIS) Où Catinat n’a peu trouve aucun Marchand, Font voir de mes François que le eſt la lâchetté, Et de leurs ennemis la generoſite Si comme à Nice on eût trouy quelque Couſin, 01 Qui promptement euſt fait ſauter Magaſin,  IATHAI Si comme à Mons on eût trouvé!	Le siège de Coni celui de Mone mélian, dibsIS) Où Catinat n'a peu trouve aucun Marchand, Font voir de mes Français que le est la lâcheté, Et de leurs ennemis la générosité Si comme à Nice on eût trou quelque Cousin, 01 Qui promptement eût fait sauter Magasin, JATHAI Si comme à Mon on eût trouvé!
Garniſon, & IlEIIL Si pauvre qu’elle fit au Roy cor paſſion, Mes François vaillamment euſe forcé ces villes, 2111 Mais leurs brigues, malheur, y furent inutiles, Les Bourgeois mutinés & ces Predicateurs N’y purent comme ailleurs braver leurs Gouverneurs.	Garnison, et IlEIIL Si pauvre qu'elle fit au Roi cor passion, Mes Français vaillamment euse forcé ces villes, 2111 Mais leurs brigues, malheur, y furent inutiles, Les Bourgeois mutinés et ces Prédicateurs N'y purent comme ailleurs braver leurs Gouverneurs.
Quand eſt-ce que mes gens avec forces égalles, Ont montré qu’ils avoient des ames Martialles?	Quand est-ce que mes gens avec forces égalles, Ont montré qu'ils avaient des âmes Martialles?
L’ennemy tout par tout moindre en Cavallerie, A fait évidemment voir leur poltronnerie.	L'ennemi tout par tout moindre en Cavallerie, A fait évidemment voir leur poltronnerie.
Onfuit en Allemagne, & en Flandre on n’a pû Attirer au combat mon coyon de Boſſu.	Onfuit en Allemagne, et en Flandre on n'a pu Attirer au combat mon coyon de Bossu.
a Il ſçait que le manant Roy d’Irlande & d’Ecoſſe Paiint do.	a Il sais que le manant Roi d'Irlande et d'Écosse Paiint do.
Denys y luy rabamier là boſſe.	Denis y avait rabamier là bosse.
B Ca	 Ca
a Le Duc de Luxembeurg.	à Le Duc de Luxembeurg.
b La bataille de St.	b La bataille de St.
Denys.	Denis.
Catinat en Piemont de crainte d’ur aſſaut, Avec tout ſon bagage a repaſſé le Et Mr.	Catinat en Piémont de crainte d'ur assaut, Avec tout son bagage a repassé le Et Mr.
de Saint-Ruth chef des miſ ſionnaires, 1 Qui a tant converti de religionnaires, A crouve qu’en Trlande un ſeul coup de canon A bien-tôt termine toute la miſſion As-tu donc à cecy quelque choſe a redire?	de Saint-Ruth chef des mis sionnaires, 1 Qui a tant converti de religionnaires, À crouve qu'en Trlande un seul coup de canon A bientôt termine toute la mission As-tu donc à ceci quelque chose a redire?
21	21
11228 Louvois.	11228 Louvais.
L2 JIIIO c109 Madame, je voudrois en vain vous contredire.	L2 JIIIO c109 Madame, je voudrais en vain vous contredire.
La France.	La France.
1 2 Ai filli Et les ſoûmiſſions que le Roy Tres.	1 2 Ai filli Et les soumissions que le Roy Ires.
Chrétien,  Comme un lâche a deu faire au traitre Algerien.	Chrétien, Comme un lâche a dev faire au traître Alger.
Ces bombes, ces boulets qui luy coûtent ſi cher, Pour avoir bombardé inſolemment Alger, Dont une ſeule coûte un quart de million, Autrement mon Louys n’euſt pas eu ſon pardon.	Ces bombes, ces boulets qui lui coûtent si cher, Pour avoir bombardé insolemment Alger, Dont une seule coûte un quart de million, Autrement mon Louis n'eût pas eu son pardon.
Cette Ligue offenſive avec les Otthomans.	Cette Ligue offensive avec les Othomans.
L’Allemagne.	L'Allemagne.
Alte, ma bœur, cecy touche les Oi1 Allemans.	Alte, ma bœur, ceci touche les Oi1 Allemands.
La France.	La France.
Vous m’obligez, ma Sœur, & reprenant ma place, Vous ne me faites pas une petite grace.	Vous m'obligez, ma Sœur, et reprenant ma place, Vous ne me faites pas une petite grâce.
La honte s’emparoit déja de mon viſage, Voyant que mes François ont ſi peu de courage.	La honte s'emparait déjà de mon visage, Voyant que mes Français ont si peu de courage.
B 2 L'AlleDites ouvertement, qu’ils n’on point de parolles 190U Que d’infidelité ce ſont de vrays ſymboles, Que dans leurs actions ce n’eſt que perfidie, Que leur Foy, leur ſerment eſt pu re hypocriſie.	 2 L'AlleDites ouvertement, qu'ils n'on point de paroles 190 Que d'infidélité ce sont de vrais symboles, Que dans leurs actions ce n'est que perfidie, Que leur Foi, leur serment est pu rejet hypocrisie.
à Louvois.	à Louvais.
Au reſte, quand des Turcs Vier fut aſſiegée, ACCII Que faiſoit ſur le Rhin une ſi grande armée ?	Au reste, quand des Turcs Vier fut assiégée, ACY Que faisait sur le Rhin une si grande armée ?
C’eſt ce qui m’embaraſſe, & je voudrois ſçavoir, Ce que ton grand Louys y preten.	C'est ce qui m'embarrasse, et je voudrais sçavoir, Ce que ton grand Louis y preten.
doit avoir.	doit avoir.
Venoit-il ſecourir peut-eſtre l’Empereur?	Venait-il secourir peut-être l'Empereur?
Rien moins, que pretendoit donc cet Uſurpateur?	Rien moins, que prétendait donc cet Usurpateur?
Vouloit-il aſſiſter les Princes de l’Empire?	Voulait-il assister les Princes de l'Empire?
O.	Ô.
CH Encor moins au contraire, il penſoit les detruire.	CH Encor moins au contraire, il pensait les détruire.
Tu ſçais tous ces ſecrets, ça, Marquis, repons moy, Dy nous ingenûment, que pretendoit ton Noy	Tu sais tous ces secrets, ça, Marquis, réponds moi, Dis nous ingénument, que prétendait ton Noi
Louvois.	Louvais.
210 Il ne vouloit rien moins, Madame, que l’Empire.	210 Il ne voulait rien moins, Madame, que l'Empire.
C’étoit un accord fait avec le grand aule Vizir;	C'était un accord fait avec le grand aule Vis;
Tout étoit partagé, le rebelle Tekely Avoit eſté déja par avance étably Vice.	Tout était partagé, le rebelle Tekely Avait été déjà par avance établi Vice.
Roy de la haute & de la baſſe Hongrie, Et Prince hereditaire en la Tranſylvanie.	Roi de la haute et de la basse Hongrie, Et Prince héréditaire en la Transylvanie.
Depuis long-temps Louys menageoit ce rebelle, Comme une piece utile à ſuſciter querelle.	Depuis longtemps Louis ménageait ce rebelle, Comme une pièce utile à susciter querelle.
B 8 VieViene, Pruſſe, Louys payoit?	 8 VieVène, Prusse, Louis payait?
Mahomet Tous les fraiz de la guerre, & même l’interêt.	Mahomet Tous les fraisés de la guerre, et même l'intérêt.
L’un auroit poſſedé la haute & baſſe Hongrie, L’autre eût eu pour ſa part l’Auſtri.	L'un aurait possédé la haute et basse Hongrie, L'autre eût eu pour sa part l'Autri.
che & la Styrie;	che et la Styrie;
Et pour executer ſes ſuperbes deſ.	Et pour exécuter ses superbes des.
ſeins, Il eût fait couronner ſon fils Roy des Romains.	seins, Il eût fait couronner son fils Roi des Romains.
Il eût alors reglé Meſſieurs les E.	Il eût alors réglé Messieurs les É.
Don lecteurs, 020bu 0 Comme il fait à Paris tous les plus grands Seigneurs.	Donc lecteurs, 020bu 0 Comme il fait à Paris tous les plus grands Seigneurs.
Ce qui eſt electif eût eſté neceſſaire, Et l’Empire aux Bourbons eſtoit hereditaire.	Ce qui est électif eût été nécessaire, Et l'Empire aux Bourbons était héréditaire.
Suede, Dannemarq, Holſtein, & Brandebourg,1 Hannover, Baviere, Mayence, Lunebourg, Saxe, Viene, Munſter, ces autres Republiques, 7O OUIHOJ Dites communément villes Anſeatiques, Et tous ces Souverains puiſſans comme des Roys, Seroient tous devenus les ſujets des François.	Sude, Dannemarq, Holstein, et Brandebourg, Hannover, Bavions, Mayence, Lunebourg, Saxe, Viene, Munster, ces autres Républiques, 7O OUIHO Dites communément villes Anseatiques, Et tous ces Souverains puissants comme des Rois, Seraient tous devenus les sujets des Français.
Je ne deguhe Iey rienden vernte.	Je ne déguhe Jei rienden vernte.
L’Allemange.	L'Allemange.
On aura quelque égard à ta ſincerité;	On aura quelque égard à ta sincérité;
Mais acheve.	Mais achève.
Louvois.	Louvais.
Les Turcs à Viene étant battus, Les projets de Louys furent tous abattus.	Les Turcs à Viene étant battus, Les projets de Louis furent tous abattus.
Il n’eſperoit pas qu’une armée ſi puiſſante Seroit miſe en deroute, & prendroit l’épouvante.	Il n'espérait pas qu'une armée si puissante Serait mise en deroute, et prendrait l'épouvante.
Il s’étoit figuré que l’Empire en balance, Il	Il s'était figuré que l'Empire en balance, Il
B 4 Il faudroit implorer bien-tôt ſon aſſiſtance;	 4 Il faudrait implorer bientôt son assistance;
Mais Louys fut trompé l’Ange Ex.	Mais Louis fut trompé l'Ange Ex.
terminateur Avoit pris la deffenſe en main de l’Empereur.	terminateur Avait pris la défense en main de l'Empereur.
Cette illuſtre Maiſon que nous penſions detruire Par nos lâches trames, & luy ôter l’Empire, Cette illuſtre Maiſon que durant ſa diſgrace, Nous avions fait depeindre avec une beſace, Va ſe rendre immortelle, & contre noſtré attente, Nous avons travaillé à la rendre puiſſante.	Cette illustre Maison que nous pensions détruire Par nos lâches trames, et et ôter l'Empire, Cette illustre Maison que durant sa disgrâce, Nous avions fait dépeindre avec une besace, Va se rendre immortelle, et contre nostré attente, Nous avons travaillé à la rendre puissante.
L’Allemangne.	L'Allemangne.
Sincere aveu.	Sincère aveu.
pourſuy	poursui
Louune main inviſible Conduiſoit les deſſeins de ce Prince invincible.	Louune main invisible Conduisait les desseins de ce Prince invincible.
Tant plus pour ſa ruïne étoient grands nos efforts, Plus elle rebraſſoit contre nous nos reſſorts, Toutes nos cruautés, tous nos embraſemens, Ne firent qu’irriter vos braves Allemans.	Tant plus pour sa ruine étaient grands nos efforts, Plus elle rebrassait contre nous nos ressorts, Toutes nos cruautés, tous nos embrasements, Ne firent qu'irriter vos braves Allemands.
On les vid tous s’unir & nos chers emiſſaires Ne purent plus chez vous embrouillel les affalles.	On les vit tous s'unir et nos chers émissaires Ne purent plus chez vous embrouillel les affalles.
L Aliemagne.	 Léliemagne.
Que diſoit lors Louys?	Que disait lors Louis?
Louvots.	Louvots.
Louys crevoit de rage;	Louis crevait de rage;
Aieuio	Aieuio
Louys crevoit de rage.	Louis crevait de rage.
Mais il ne perdit pas pour ce ſujet courage.	Mais il ne perdit pas pour ce sujet courage.
Il eut recours aux Turcs comme aux Algeriens;	Il eut recours aux Turcs comme aux Algeriens;
S'unit même avec eux contre tous les Chretiens, Permit à ces derniers que dedans tous ſes havres, Ils pourroient amener ſurement leurs eſclaves.	S'unit même avec eux contre tous les Chretiens, Permit à ces derniers que dedans tous ses havres, Ils pourraient amener sûrement leurs esclaves.
Il fit toucher aux Turcs beaucoup de millions, Des ſoldats, de l’argent, & des munitions, Quatre mille Cadets tirés hors de Douay, De Charlemont, Dinan, Valenciennes, Tournay, Beaucoup d’Ingenieurs, quantité d’Officiers, Même des Generaux, juſques aux Bombardiers, Pour que les infideles ſceuſſent la methode, De vous faire la guerre à la nouvelle mode.	Il fit toucher aux Turcs beaucoup de millions, Des soldats, de l'argent, et des munitions, Quatre mille Cadets tirés hors de Douai, De Charlemont, Dinan, Valenciennes, Tournai, Beaucoup d'Ingénieurs, quantité d'Officiers, Même des Généraux, jusques aux Bombardiers, Pour que les infidèles sceussent la méthode, De vous faire la guerre à la nouvelle mode.
L’Allemagne.	L'Allemagne.
Tu dis vray, du depuis tant de braves Cadets Prés de Salankemen ont été tout defaits.	Tu dis vrai, du depuis tant de braves Cadets Prés de Salankemen ont été tout défaits.
On les entendoit tous crier quartier mein Heer, Lors qu’on vous les ſabroit, en 2 Hongrois, d’un bel air, Pour evicer les coups ils ſe diſoient Chretiens.	On les entendait tous crier quartier mein Hér, Lors qu'on vous les sabroit, en 2 Hongrais, d'un bel air, Pour euvicer les coups ils se disaient Chretiens.
Louvois.	Louvais.
En avoit-on pitié?	En avait-on pitié?
L'allemagne.	L'allemagne.
pitié comme des Chiens, Les Turcs Orientaux & les Occidentaux, 1012 Furent	pitié comme des Chiens, Les Turcs Orients et les Occidents, 1012 Furent
B 6 Furent dans ce combat tous traittés en égaux.	 6 Furent dans ce combat tous traités en égaux.
Le grand Vizir, ſon fils, l’Age des Janiſſaires, Les troupes de l’Aſie & les Auxiliaires;	Le grand Vizir, son fils, l'Age des Janissaires, Les troupes de l'Asie et les Auxiliaires;
Même le Tefterdar, quantité de Bachas Et vingt-cinq mille Turcs y paſſarent le pas:	Même le Tefterdar, quantité de Bachas Et vingt-cinq mille Turcs y passarent le pas:
Puis ce qui peut échaper la fureur des coups, Fut boire dans la Save à grands traits tout ſon ſaoul.	Puis ce qui peut échapper la fureur des coups, Fut boire dans la Save à grands traits tout son saoul.
Louvois.	Louvais.
Louys eſperoit mieux des armes Otthomanes.	Louis espérait mieux des armes Othomanes.
72	72
L'Allemagne.	L'Allemagne.
Etant ſecondées des armes Gallicar nes.	Étant secondées des armes Galicar nés.
Mon a Louys dont le tien par un embraſement, A brulé le Pays pour plaire à Solyman.	Mon a Louis dont le tien par un embrasement, À brulé le Pays pour plaire à Solyman.
Va-t-en, parfait Heros, tout couronné de Gloire, Rendre ſon nom fameux pour jamais dans l’Hiſtoire.	Va-t-en, parfait Héros, tout couronné de Gloire, Rendre son nom fameux pour jamais dans l'Histoire.
On ne dira jamais, qu’il s’eſt rendu fameux, Par de lâches trames ny par de triſtes feux.	On ne dira jamais, qu'il s'est rendu fameux, Par de lâches trames yeux par de tristes feux.
Ses belles actions ne ſeront pas ternies, Ny par de triſtes feux ny par des incendies.	Ses belles actions ne seront pas ternies, Ni par de tristes feux Seigneur par des incendies.
La victoire gagnée ſur les Otthomans Se doit à ſa valeur & à mes Allemans.	La victoire gagnée sur les Othomans Se doit à sa valeur et à mes Allemands.
Ce Prince par trois fois perdu dans Ia IIICIeC Affronta les perils au milieu de l’armée;	Ce Prince par trois fois perdu dans Ja IICIeCIeC Affronta les périls au milieu de l'armée;
Et	Et
a Louis de Rale, Et le ſabre à la main ſans crainde les hazards, Se fit jour au travers des Turcs ( toutes parts.	à Louis de Rale, Et le sabre à la main sans crainde les hasards, Se fit jour au travers des Turcs ( toutes parts.
Puis prenant aux cheveux la victo re incertaine, En fit ſa priſonniere, en vaillant Capitaine.	Puis prenant aux cheveux la victo re certaine, En fit sa prisonnière, en vaillant Capitaine.
Voilà des actions & non pas de intrigues Que la valeur conduit ſans melan ge de brigues, On doit à ce Heros eriger des au tels, Ranger ſon nom Illuſtre avec le Immortels.	Voilà des actions et non pas de intrigues Que la valeur conduit sans melan ge de brigues, On doit à ce Héros ériger des au tels, Ranger son nom Illustre avec le Immortels.
Il ne gagera pas la plume d’un flat teur, Pour faire ſon eloge & chanter ſe valeur, 111 Et s’il a fait parler de ſoy dans l’O rient 11 Il en fera de même en bref dans l'Oc cident.	Il ne gagera pas la plume d'un flat teur, Pour faire son éloge et chanter se valeur, 111 Et s'il a fait parler de soi dans l'Ô rient 11 Il en fera de même en bref dans l'Oc cident.
Louys ne craint-il pas que mon Louys de Bade, Ne Ne luy vienne à ſon tour donner la Serenade ?	Louis ne craint-il pas que mon Louis de Bade, Ne Ne lui vienne à son tour donner la Serenade ?
Sait-il bien que ce Prince a borné ſon deſtin;	Sait-il bien que ce Prince a borné son destin;
Pour venir commander les troupes ſur le Rhin?	Pour venir commander les troupes sur le Rhin?
Pour venger les affronts à luy faits par Louys, Renverſant ſes chateaux & brulant ſon pays;	Pour venger les affronts à ) faits par Louis, Renversant ses châteaux et brûlant son pays;
Dans le tems que ce Prince en faveur des Chretiens S’alloit ſacrifier abandonnant les ſiens.	Dans le temps que ce Prince en faveur des Chretiens S'allait sacrifier abandonnant les siens.
Fy, quelle Lâcheté, tandis que ce Heros, Combat pour les Chretiens, & cherche leur repos, Ton Roy qui ne veut être à nul autre pareil, .	Fi, quelle Lâcheté, tandis que ce Héros, Combat pour les Chretiens, et cherche leur repos, Ton Roi qui ne veut être à nul autre pareil, .
80 Qui s’erige luy-même, en un autre Soleil, Brule ſon Marquiſat, ſans laiſſer un village, Où l’on ne puiſſe voir les marques de ſa rage.	80 Qui s'erige lui-même, en un autre Soleil, Brule son Marquisat, sans laisser un village, Où l'on ne puisse voir les marques de sa rage.
Dis	Dis
Dis-tu rien à cela?	Dis-tu rien à cela?
L'Ptalie.	L'Ptalie.
Que diroit-il, ma Sœur!	Que dirait-il, ma Sœur!
De ce que vous dites, n'en eſt-i pas l’Autheur?	De ce que vous dites, n'en est-cy pas l'Auteur?
Louys faiſoit-il rien ſans le gré de ce traître,  Qui vouloit s’ériger en Souverain, en Maître?	Louis faisait-il rien sans le gré de ce traître, Qui voulait s'ériger en Souverain, en Maître?
N'a-t-il pas fait aller un Lavardin.	N'a-t-il pas fait aller un Lavardin.
Rome, Pour y faire braver un Pontife un Saint-homme?	Rome, Pour y faire braver un Pontife un Saint-homme?
Il fit ſon entrée le piſtolet en main Suivi d’un attirail de quatre cens coquins, De gens determinés & propres aux carnages, 1 Qui furent ſes valets, ſes eſtafiers de Pagco, Il voulut ſe mêler de regler la Police, El	Il fit son entrée le pistolet en main Suivi d'un attirail de quatre cens coquins, De gens déterminés et propres aux carnages, 1 Qui furent ses valets, ses estafiers de Pagco, Il voulut se mêler de régler la Police, Él
a Ambaſſadeur de France à Fiene.	a Ambassadeur de France à Fiene.
Et pour dire, en un mot, abolir la Juſtice.	Et pour dire, en un mot, abolir la Justice.
Si le Pape d’alors avoit été timide, Où nous auroit reduit, croyezvous, ce perfide?	Si le Pape d'alors avait été timide, Où nous aurait réduit, croyezvous, ce perfide?
Il vouloit que l’Hotel, où ſes Ambaſſadeurs, Reſidoient, ſervit de refuge à des voleurs, Et pour y établir ſes damnables maximes, ly ouitt serger enpreccccear des crimes.	Il voulait que l'Hotel, où ses Ambassadeurs, Résidaient, servit de refuge à des voleurs, Et pour y établir ses damnables maximes, li ouit serger enpreccccear des crimes.
à Leuvois.	à Leuvais.
Dy moy ne fus-tu pas en tout cecy complice, Ou parle, où je feray augmenter	Dis -moi ne fus-tu pas en tout ceci complice, Ou parle, où je ferai augmenter
Louvois.	Louvais.
Comme juſqu’à preſent par mes confeſſions, Vos Vos Sœurs peuvent avoir la ſatie faction, Qu’elles deſiroient tant pour l'e clairciſſement, De la cauſe pourquoy je ſuis en jue gement.	Comme jusqu'à présent par mes confessions, Vos Vos Sœurs peuvent avoir la satie faction, Qu'elles désiraient tant pour l'e claircissement, De la cause pourquoi je suis en jue gement.
Je ne veux rien celer à vôtre Sei  gneurie, Quoy qu’elle ſoit icy mon juge &̀  ma partie.	Je ne veux rien celer à votre Sei gneurie, Quoi qu'elle soit ici mon juge et ma partie.
Louys vouloit chez vous ſe fairt Souverain.	Louis voulait chez vous se fairt Souverain.
Il avoit acheté Cazal à ce deſſein Son Marquis la vendit pour quel ques millions, Pour pouvoir aſſouvir ſes diſſoluti.	Il avait acheté Casal à ce dessein On Marquis la vendit pour quel ques millions, Pour pouvoir assouvir ses dissoluti.
ons.	ons.
Ne ſe ſouvenant pas qu’étant ui fief d’Empire, Sans crime il ne pouvoit le vendre pour luy nuire.	Ne se souvenant pas qu'étant ui fief d'Empire, Sans crime il ne pouvait le vendre pour lui nuire.
Même on ne ſçait comment il n troqua Mantoue, Car de neceſſité, faut-il que le Du Joue.	Même on ne sait comment il n troqua Mantoue, Car de nécessité, faut-il que le Du Joue.
On s’étonna pourtant que tous ces petits Princes, Qui comme Souverains gouvernent vos Provinces, Ne s’oppoſerent pas à ce rude eſclavage;	On s'étonna pourtant que tous ces petits Princes, Qui comme Souverains gouvernent vos Provinces, Ne s'opposèrent pas à ce rude esclavage;
70 Que leur alloit cauſer ce méchant voiſinage.	70 Que leur allait causer ce méchant voisinage.
31 Gennes, Parme, Florence, & les Venitiens Voyoient qu’on leur alloit preparer des liens.	31 Gennes, Parme, Florence, et les Venitiens Voyaient qu'on leur allait préparer des liens.
Les Etats de l’Egliſe & du Duc de Modene lol.	Les Lès de l'Église et du Duc de Modene lol.
Parurent pour un temps n’en être pas en peine.	Parurent pour un temps n'en être pas en peine.
Même le Milanois parut indifferent, Et ſe plaignit tout bas de ce grand changement.	Même le Milanais parut indifférent, Et se plaignit tout bas de ce grand changement.
Tous ces Princes pourtant ont aperceu trop tard, uels maux leur cauſeroit un ſi grand boulevart.	Tous ces Princes pourtant ont aperçu trop tard, uels maux leur causerait un si grand boulevart.
On s’étoit aſſuré du Prince de Piemont, Qu’on	On s'était assuré du Prince de Piémont, Qu'on
Coyonni!	Coyonni!
L'Italie.	L'Italie.
6.	6.
10	10
qnLouvois.	qnLouvais.
1011199 patience, alors Mont meliut Qui juſques à preſent nous coüt ttant de ſang, Se fuſt bien-toſt trouvé ſans aucun 1deffenſe.	1011199 patience, alors Mont meliut Qui jusques à présent nous coût ttant de sang, Se fût bientôt trouvé sans aucun 1defense.
45 La Savoye & Geneve euſt entré dans la danſe.	45 La Savoie et Génève eut entré dans la danse.
Les Suiſſes que Louys craint & qu’il n’ayme pas, Eſtoient au trebuchet tous pris comme des rats.	Les Suisses que Louis craint et qu'il n'aime pas, Étaient au trébuchet tous pris comme des rats.
Les montagnes auroient ſervi d’une priſon 22 IIUS QIVE VIIT Où l’on euſt enfermé mes comperes Griſons.	Les montagnes auraient servi d'une prison 22 IIUS QIVE VIT Où l'on eût enfermé mes compères Grisons.
Tous ces petits Etats ſi prés les uns des autres, Imperceptiblement fuſſent devenus noſtres.	Tous ces petits États si près les uns des autres, Imperceptiblement fussent devenus nôtres.
*6 4 Mantoue eſtoit à nous & le Duc de Modene.	*6 4 Mantoue était à nous et le Duc de Modene.
Enrageoit qu’il n’entraſt déja dans cette ſcene.	Enrageait qu'il n'entrât déjà dans cette scène.
Parme, le Boulonnois, Ferrare, Vicentin, Gennes, le Milanois & tout le Florentin, Les Etats de Veniſe & tous les pantalons Auroient dû ſe ſoûmettre à meſſieurs les Bourbons Et Et le coqorgueilleux, dont le cœu eſt de pierre, Hini ni kM Une feconde fois auroit fait pleure Pierre.	Parme, le Boulonnais, Ferrare, Vicennes, Gennes, le Milanais et tout le Florentin, Les États de Venise et tous les pantalons Auraient dû se soumettre à messieurs les Bourbons Et Et le coqorgueilleux, dont le cœu est de pierre, Hinini kM Une féconde fois aurait fait pleure Pierre.
HIED	HIÉD
L’Italie.	L'Italie.
oiſt,ni linoiius conbidom Beaux avis aux Lecteurs, voic bien des affaires, Aun HOIIU A quoy de par le Diable on ne s’at C11I tendoit gueres.	Ut,ni linoiius conbidom Beaux avis aux Lecteurs, voi bien des affaires, Aun HOIIU A quoi de par le Diable on ne s'at C1I tendait guère.
222 200 Ces éclairciſſemens me ſeront for 220 utiles, 1 nomiduqq Et j’en vais avertir les plus nobles CIIVI On a Mol d’oijoiu familles.	222 200 Ces éclaircissements me seront for 220 utiles, 1 nomiduq Et j'en vais avertir les plus nobles CIVI On a Mol d'oijoive familles.
Tous mes Princes, mes Ducs, de qu 2120 les interêts 1 ILIO IOCTI Sont de s’unir enſemble & borne vos projets, 211 Louys n’euſt-il pas fait un Ponti à ſa guiſe?	Tous mes Princes, mes Ducs, de qu' 2120 les intérêts 1 ILIO ICTI Sont de s'unir ensemble et borne vos projets, 211 Louis n'eût-il pas fait un Ponti à sa guise?
1 2.	1 2.
P0HH.	P0HH.
Louvois.	Louvais.
Sans doute Furſtemberg euſt go verné l’Egliſe;	Sans doute Furstemberg eût go verné l'Église;
TDI lomme c'eſt un eſprit de paix & d’union, Qu’il vous en faut un tel dans la Religion, Il euſt adroitement par ſecretes pratiques Reüni les eſprits des Princes Catholiques.	TDI lomme c'est un esprit de paix et d'union, Qu'il vous en faut un tel dans la Religion, Il eût adroitement par secrètes pratiques Réuni les esprits des Princes Catholiques.
3011111 à Louvois.	3011111 à Louvais.
L’Italie.	L'Italie.
2411 Dy qu’il les eût plûtôt tous brouillés	2411 Dis qu'il les eût plutôt tous brouillés
Je l’accorde.	Je l'accorde.
L’Italie.	L'Italie.
Pourquoy donc l’appeller un eſprit de concorde?	Pourquoi donc l'appeler un esprit de concorde?
Tu ſçais que ce brouillon traître à ſon Souverain, A manqué de livrer à ton Roy tout le Rhin;	Tu sais que ce brouillon traître à son Souverain, A manqué de livrer à ton Roi tout le Rhin;
aprés avoir trahi Strasbourg & livré Bonne, Il vouloit debuſquer l’Empereur d ſon thrõne.	après avoir trahi Strasbourg et livré Bonne, Il voulait débusquer l'Empereur d son trône.
C’étoit pour ce ſujet que ce Pertur.	C'était pour ce sujet que ce Pertur.
bateur Briguoit par tout les voix pour ſe faire Electeur.	bateur Briguait par tout les voix pour se faire Électeur.
C’eſtoit pour ce ſujet qu’à Liege vouloit eſtre Prince, Chef des fermiers, le Sou verain, le Maître, Et chaſſant comme un fol deux lie vres à la Fois, il no rue rlecteur ny Prince de Llegcois.	C'était pour ce sujet qu'à Liège voulait être Prince, Chef des fermiers, le Sou verain, le Maître, Et chassant comme un fol deux lie vres à la Fois, il nô rue rlecteur était Prince de Llegcois.
N’eſt-il pas vray?	N'est-il pas vrai?
Louvois.	Louvais.
Trop vray,car ce fut le bonheu De tous vos Alliés & de voſtre En pereur.	Trop vrai,car ce fut le bonheu De tous vos Alliés et de votre En pereur.
S’il avoit été fait Electeur de C logne, On vous auroit à tous taillé de beſogne.	S'il avait été fait Élécteur de Ç logne, On vous aurait à tous taillé de besogne.
On étoit aſſuré de quatre Electorats.	On était assuré de quatre Electorats.
Cologne, Mayence, Tréves, Palatinat.	Cologne, Mayence, Trèves, Palatinat.
Les autres n’avoient peu reſiſter à la force.	Les autres n'avaient peu résister à la force.
Il euſt fallu ſe rendre à mon Louys- quatorze.	Il eût fallu se rendre à mon Louis- quatorze.
Le Parlement de Metz juge des Souverains Auroit incontinent fait un Roy des Romains Qui de meſme qu’au temps de Diocletian Dans Rome auroit vécu, tel qu’il eſt, en Tyran.	Le Parlement de Metz juge des Souverains Aurait incontinent fait un Roi des Romains Qui de même qu'au temps de Diocletan Dans Rome aurait vécu, tel qu'il est, en Tyran.
Voilà, Madame, enfin le recueil du projet Avec Louys & moy fait dans le Cabinet.	Voilà, Madame, enfin le recueil du projet Avec Louis et moi fait dans le Cabinet.
L’Italie.	L'Italie.
Pour m’avoir avoüé le tout ingenûment, Je diminueray, Marquis, ton châtiment;	Pour m'avoir avoué le tout ingénument, Je diminuerai, Marquis, ton châtiment;
Auſſi-bien tes reſſorts, tes conſeils tes avis, Bien loin de nous grever font du mal à Louys.	Aussi-bien tes ressorts, tes conseils tes avis, Bien loin de nous grever font du mal à Louis.
Mon Duc de mes conſeils faiſant un bon uſage;	Mon Duc de mes conseils faisant un bon usage;
Se voyant gourmandé, voulut ſortir de page.	Se voyant gourmandé, voulût sortir de page.
Louvois.	Louvais.
Louys pour le venger lura pils quelque place inu GnO	Louis pour le venger lura pils quelque place in NO
L’Italie.	L'Italie.
Il auroit plus perdu, s’il eût eſtéen.	Il aurait plus perdu, s'il eût estéen.
grace, 4140 Le ſecours arrivé dedans le Piedmontois 1 Va faire retire r bien vîte tes François.	grâce, 4140 Le secours arrivé dedans le Piedmontais 1 Va faire retire r bien te tes Français.
Bayiere les conduit, ce Prince tout de feu, En En Turquie connu ſous le nom du Roy bleu, Dont le nom immortel par ſes grandes victoires, Doit eſtre éterniſé dans toutes les Hiſtoires;	Bayiere les conduit, ce Prince tout de feu, En En Turquie connu sous le nom du Roi bleu, Dont le nom immortel par ses grandes victoires, Doit être éternisé dans toutes les Histoires;
Qui s’eſt rendu fameux devant Bude & Belgrade;	Qui s'est rendu fameux devant Bude et Belgrade;
A qui les grands combats ſont des jours de parade.	À qui les grands combats sont des jours de parade.
Ce Duc qui ne ſçait fuir, qui ſur le bord du Rhin Preſenta tant de fois le combat au Daufin Vient en vaillant Heros de prendre Carmagnol, Chaſſer ton Catinat juſques ſous Pignerol;	Ce Duc qui ne sait fuir, qui sur le bord du Rhin Presenta tant de fois le combat au Daufin Vient en vaillant Héros de prendre Carmagnol, Chasser ton Catinat jusques sous Pignerol;
Qui n’oſant ſe commettre avec ce grand Guerrier, Fuit comme un lievre fait quand il ſent le levrier;	Qui n'osant se commettre avec ce grand Guerrier, Fuit comme un lièvre fait quand il sent le lévrier;
Et connoiſſant déja le bras de ſon vainqueur,	Et connaissant déjà le bras de son vainqueur,
A Apprehende un combat ainſi qu’un grand malheur.	A Appréhende un combat ainsi qu'un grand malheur.
Tellement que ton chef avec tous ſes François, S'enfuit comme un poltron devant mes Piemontois;	Tellement que ton chef avec tous ses Français, S'enfuit comme un poltron devant mes Piémontais;
Car ayant au plûtot repaſſé les montagnes Il n’a garde d’ozer occuper mes Campagnes.	Car ayant au plûtot repassé les montagnes Il n'a garde d'oser occuper mes Campagnes.
On n’avoit entendu que ſes rodemontades, Il eſtoit temps de voir l’effet de ſes bravades;	On n'avait entendu que ses rodemontades, Il était temps de voir l'effet de ses bravades;
Il devoit aſſieger ou bombarder Thurin.	Il devait assiéger ou bombarder Thurin.
On l’aſſiege luy-meſme & s’enfuit à la fin.	On l'assiège avait-même et s'enfuit à la fin.
On n’eſt pas ſatisfait en prenant Carmagnol, On va meſme à ſes yeux bombarder Pignerol.	On n'est pas satisfait en prenant Carmagnol, On va Seigneur à ses yeux bombarder Pignerol.
T1 91 Ainſi par tout ailleurs les François trop coüards N’oſeroient d’un combat éprouver les hazards.	T1 91 Ainsi par tout ailleurs les Français trop coüards N'oseraient d'un combat éprouver les hasards.
Lout Pourtant il court un bruit qui vient de ſe répandre, Que Luxembourg avoit battu l’armée en Flandres.	Lout Pourtant il court un bruit qui vient de se répandre, Que Luxembourg avait battu l'armée en Flandres.
Si ce bruit eſt certain, & que les Hollandois.	Si ce bruit est certain, et que les Hollandais.
La Hollande.	La Hollande.
Tu ments impunément, lâche comme un François, Luxembourg ayant pris trentedeux eſcadrons, En attaqua quatorze en trés-vaillans poltrons.	Tu mens impunément, lâche comme un Français, Luxembourg ayant pris trentedeux escadrons, En attaqua quatorze en très-vaillans poltrons.
Il avoit fait l’élite entre tous ſes ſoldats De tout ce qu’il croyoit intrepide aux combats Et ces precautions, pour venir au pillage Battre une arriere-garde & ſurprendre un bagage Ton Ton Eſope accourut, on attaqua les miens, S’il en défit pluſieurs, on en défit ( des ſiens.	Il avait fait l'élite entre tous ses soldats De tout ce qu'il croyait intrépide aux combats Et ces précautions, pour venir au pillage Battre une arrière-garde et surprendre un bagage Ton Ton Esope accourut, on attaqua les miens, S'il en défit plusieurs, on en défit ( des siens.
Quantité d’Officiers, trois de tes Generaux, Que nous avons tués quoy que fort inégaux.	Quantité d'Officiers, trois de tes Généraux, Que nous avons tués quoi que fort inégaux.
Tant de ſoldats bleſſés de la Maiſon du Roy, Que mes vaillans ſoldats ont miſe en deſarroy.	Tant de soldats blessés de la Maison du Roi, Que mes vaillants soldats ont mise en désarroi.
Des miens un Colonel, & pluſieurs Capitaines, Des Officiers beaucoup, des ſoldats a centaines.	Des miens un Colonel, et plusieurs Capitaines, Des Officiers beaucoup, des soldats a centaines.
Huit cens en tout trouvés tûés de part & d’autre Font voir évidement ſi la victoire eſt voſtre;	Huit cens en tout trouvés tués de part et d'autre Font voir évidement si la victoire est votre;
Et ſi ſans ſe ſervir de mille gaſconnades, On en peut à la Cour faire tant de bravades.	Et si sans se servir de mille gasconnades, On en peut à la Cour faire tant de bravades.
Si les voſtres ont pris quelques drapeaux des nôtres, Les Les nôtres en ont pris auſſi pluſieurs des vôtres.	Si les vôtres ont pris quelques drapeaux des nôtres, Les Les nôtres en ont pris aussi plusieurs des vôtres.
Encor a-t-il fallu que ton Duc attendiſt, Que pour les attaquer Guillaume fuſt paiti.	Encor a-t-il fallu que ton Duc attendît, Que pour les attaquer Guillaume fait paiti.
21 S’il avoit eu du cœur, il euſt pris ſa ravanche D’un Roy qui le battit étant Prince d’Orange.	21 S'il avait eu du cœur, il eût pris sa ravanche D'un Roi qui le battit étant Prince d'Orange.
Les troupes en campagne, & tout étant égal, L’attaquant il euſt fait un coup de General;	Les troupes en campagne, et tout étant égal, L'attaquant il eût fait un coup de Général;
Mais, venir attaquer trois mille avec huit Perdre ſon plus beau monde, & puis ſe mettre en fuite, C’eſt le fait d’un coüard & d’un parfait poltron  601 Qui ne veut pas riſquer un combat tout de bon.	Mais, venir attaquer trois mille avec huit Perdre son plus beau monde, et puis se mettre en fuite, C'est le fait d'un couard et d'un parfait poltron 601 Qui ne veut pas risquer un combat tout de bon.
Et pour tromper un peuple on veut luy faire accroire Qu’il avoit remporté une entiere 114 victoire, C4 C’eſt C'eſt agreablement entretenir de ſonges;	Et pour tromper un peuple on veut lui faire accroire Qu'il avait remporté une entière 114 victoire, C4 C'est C'est agréablement entretenir de songes;
Des ſujets aveuglez par plus de cent menſonges.	Des sujets aveuglez par plus de cent mensonges.
On en impoſe bien à tant de pauvres gens;	On en impose bien à tant de pauvres gens;
On leur dit pour certain que les fiers Otthomans Batent les Allemans en deſroute en Hongrie, Que Tekely eſt entré dans la Traſylvanie;	On leur dit pour certain que les fiers Othomans Battent les Allemands en déroute en Hongrie, Que Tetely est entré dans la Trasylvanie;
Que pour ce qu’on écrit des Turcs dernierement, Les nôtres ont battu un ſeul détachement;	Que pour ce qu'on écrit des Turcs dernièrement, Les nôtres ont battu un seul détachement;
Que l’Empereur de loin nous groſſit les objets, Et qu’enfin il n’eſt rien de tous ſes grands progrés;	Que l'Empereur de loin nous grossit les objets, Et qu'enfin il n'est rien de tous ses grands progrès;
Et puis adroittement renverſant la Medaille 1 On fait ſçavoir aux Turcs le gain d’une bataille, On dit qu’on a battu les Alliés en Flandre,  Qu’ils QQu’ils ſont tous hors d’état de pouvoir ſe défendre;	Et puis adroittement renversant la Médaille 1 On fait savoir aux Turcs le gain d'une bataille, On dit qu'on a battu les Alliés en Flandre, Qu'ils QQu'ils sont tous hors d'état de pouvoir se défendre;
Que le Printemps prochain nous n’aurons en Campagne, Ny Troupes, ny le Roy de la grande Bretagne.	Que le Printemps prochain nous n'aurons en Campagne, Ni Troupes, ni le Roi de la grande Bretagne.
Monſieur de Châteauneuf remontre avec prudence D'un ſi ſanglant combat la grande conſequence.	Monsieur de Châteauneuf remontre avec prudence D'un si sanglant combat la grande conséquence.
Ce Miniſtre aſſez fin pour ſes ſeuls intereſts, Fait avec le Sultan d’agreables projets.	Ce Ministre assez fin pour ses seuls intérêts, Fait avec le Sultan d'agréables projets.
Il fait venir beaucoup de troupes ſur le Rhin.	Il fait venir beaucoup de troupes sur le Rhin.
Ylaiſſe un Camp volant pour garder le terrain.	Ylaisse un Camp volant pour garder le terrain.
Il reprend aujourd’huy Bude, demain Caniſe, Aprés demain Siget, l’autre jour Cinq-Eghies.	Il reprend aujourd'hui Bude, demain Canise, Après demain Siget, l'autre jour Cinq-Éghies.
Il ne rencontre rien qui s’oppoſe à ſes armes.	Il ne rencontre rien qui s'oppose à ses armes.
Il répand tout par tout de terribles allarmes.	Il répand tout par tout de terribles alarmes,
Il replace à Mongatz, Mâdame Ragoſtky :	Il replace à Mongatz, Mâdame Ragôtki :
Fait en Hongrie agir ſon Mary Tekely.	Fait en Hongrie agir son Mari Tekely.
Albe Royale, Eſſeck, Neuhauſel & Comorre Presbourgh, ce ſont les lieux que des yeux il devore.	Albe Royale, Esseck, Neuhausel et Comorre Presbourgh, ce sont les lieux que des yeux il dévore.
Il les prend cependant, & déja triomphant Il vient aſſieger Vienne & proteſte au Sultan, Qu’il repaiſt à plaiſir de ces ſottes chimeres, Que ces villes ſeront ſans doute ſes frontieres.	Il les prend cependant, et déjà triomphant Il vient assiéger Vienne et proteste au Sultan, Qu'il repaît à plaisir de ces sottes chimères, Que ces villes seront sans doute ses frontières.
Eohodis.	Eohodis.
C’eſt trop promettre,	C'est trop promettre,
La Hollande.	La Hollande.
Oüi ſi ton Louys le grand.	Oui si ton Louis le grand.
De De tout ce qu’il promet devoit être garant.	De De tout ce qu'il promet devait être garant.
Que n’a-t-il pas promis à ſon Illuſtre page, Que ſes conſeils ont mis dans un rude eſclavage.	Que n'a-t-il pas promis à son Illustre page, Que ses conseils ont mis dans un rude esclavage.
Son Seigneur le devoit faire aſſeoir à ſa dextrè, a Et l’on le voit toûjours rampant à ſa ſeneſtre.	Son Seigneur le devait faire asseoir à sa dextré, à Et l'on le voit toujours rampant à sa senestre.
Son glaive ne devoit, rentrer dans ſon fourreau, Qu’il ne viſt l’ennemi de ſes pieds l’eſcabeau, b Il devoit engager ſon Sceptre ſa Couronne, Pour faire remonter ce Prince ſur le Thrône.	Son glaive ne devait, rentrer dans son fourreau, Qu'il ne vît l'ennemi de ses pieds l'escabeau, Il devait engager son Sceptre sa Couronne, Pour faire remonter ce Prince sur le Trône.
Il devoit au milieu de tous ſes ennemis, Regner en Souverain & les voir tous ſoûmis.	Il devait au milieu de tous ses ennemis, Regner en Souverain et les voir tous soumis.
2 1 6 II a Dixit Laus.	2 1 6 II a Dixit Laus.
D*' meo ſede a dextris meis, b Donec ponam inimicos tuos ſcabellum pedum iuorum.	D* meo sede a dextris meys, b Onec ponam inimicos tuos scabellum pedum ivorum.
Il a dit mille fois qu’il ſeroit rethrone.	Il a dit mille fois qu'il serait rethrone.
Ou qu’il ſeroit luy-même à la fin déthroné.	Ou qu'il serait avoir-même à la fin déthroné.
Louys l’avoit juré, il s’en eſt repenti;	Louis l'avait juré, il s'en est repenti;
Voyant qu’il en auroit bien-tôt le démenty,  Mais dis-moy, le Roy Jaque eſt-il en grande eſtime, aluples du grand Eouys?	Voyant qu'il en aurait bientôt le démenti, Mais dis-moi, le Roi Jaque est-il en grande estime, aluples du grand Éouis?
Louvois.	Louvais.
Non, car c’eſt la maxime, Du Roy de n’aimer rien que ſes ſeuls intereſts, De ſes propres amis, en faire les objets, De ſa haine auſſi-tôt qu’il les voit hors détat, 2 De pouvoir le ſervir dans tous ſes attentats.	Non, car c'est la maxime, Du Roi de n'aimer rien que ses seuls intérêts, De ses propres amis, en faire les objets, De sa haine aussitôt qu'il les voit hors détat, 2 De pouvoir le servir dans tous ses attentats.
Egon a Jaravit Lner, & nou penitebit enm.	Egon a Jaravit Lner, et nou venitebit enm.
Egon de Furſtemberg, fameux dans l’Occident, Autant que Tekely l’eſt dans tout l’Orient, Se trouve dans Paris comme un homme inutile.	Egon de Furstemberg, fameux dans l'Occident, Autant que Tekely l'est dans tout l'Orient, Se trouve dans Paris comme un homme inutile.
Il y eſt regardé comme dans une azile.	Il y est regardé comme dans une asile.
S’il a des penſions, s’il a des benefices, Le Roy profitera ſeul des biens des Egliſes.	S'il a des pensions, s'il a des bénéfices, Le Roi profitera seul des biens des Églises.
Ses niéces, & neveux ne profiteront pas, Ny de tous ſes threſors ny de tous ſes amas.	Ses nièces, et neveux ne profiteront pas, Ni de tous ses trésors ici de tous ses amas.
Louys ſeul heritier ſans aucuns concurrens, N’aura pas de la peine à partager ſes biens.	Louis seul héritier sans aucuns concurrents, N'aura pas de la peine à partager ses biens.
Le Roy Jaque depuis que l’Irlande eſt perduë, Que Galloway eſt priſe & Lymmerick rendue, Ne pouvant profiter des débris de ce Ro 2 Louys Louys ſouhaiteroit qu’il fuſt bien loin de ſoy.	Le Roy Jaque depuis que l'Irlande est perdue, Que Galloway est prise et Lymérick rendue, Ne pouvant profiter des débris de ce Ro 2 Louis Louys souhaiterait qu'il fût bien loin de soi.
Il voudroit que le Pape & les Prin.	Il voudrait que le Pape et les Prin.
ces Chrétiens Fourniſſent ce qu’il faut pour tous leurs entret iens Enfin qu’il s’en allaſt ſans luy faire connoître, Gueſant de Cour en Cour chercher une autre maitre.	ces Chrétiens Fournissent ce qu'il faut pour tous leurs entret yen Enfin qu'il s'en allât sans lui faire connaître, Guesant de Cour en Cour chercher une autre maître.
La Hollande.	La Hollande.
Pauvre Prince, eſt-il vray, ſeras-tu la victime, Et de ta lâcheté & de ton propre crime?	Pauvre Prince, est-il vrai, seras-tu la victime, Et de ta lâcheté et de ton propre crime?
Errant & vagabond tu quittes tes états, Et ton cher allié ne te protege pas.	Errant et vagabond tu quittes tes états, Et ton cher allié ne te prote pas.
Tu t’es abandonné pour affermir ſon thrône, Et ce Roy orgueilleux, eſt las de ta perſonne;	Tu t'es abandonné pour affermir son trône, Et ce Roi orgueilleux, est las de ta personne;
Cauſe auſe de ton malheur d’un ſerment violé egne ou tu gemis, & tu es exilê.	Cause ause de ton malheur d'un serment violé égne ou tu gémis, et tu es exiller.
Louvois.	Louvais.
Madame, puis-je dire un mot?	Madame, puis-je dire un mot?
La Hollande.	La Hollande.
Tant que tu veux:	Tant que tu veux:
Tu es en jugement deffens-toy ſi tu peux.	Tu es en jugement défens-toi si tu peux.
Louvois.	Louvais.
Le Roy Jaque ſeroit encor dans ſon Royaume, Si vous euſſiez borné les projets de Guillaume.	Le Roy Jaque serait encor dans son Royaume, Si vous eussiez borné les projets de Guillaume.
Il y avoit long-temps qu’il ménageoit ſous main, Un party qui vouluſt ſeconder ſon deſſein.	Il y avait longtemps qu'il ménageait sous main, Un parti qui voulût seconder son dessein.
2212 Vous Vous le ſceuſtes, Madame, & Me ſieurs vos Etats, A tout cet appareil ne s’oppoſere pas.	2212 Vous Vous le sceustes, Madame, et Me sieurs vos États, À tout cet appareil ne s'opposère pas.
Pour mieux joüer ſon jeu, onl fit des avances, Il puiſa largement dans toutes v finances, Et tout cela ſe fit avec tant de ſe cret, Qu’à peine le ſceut-on chez no quand tout fut fait.	Pour mieux jouer son jeu, on fit des avances, Il puisa largement dans toutes v finances, Et tout cela se fit avec tant de se cret, Qu'à peine le sut-on chez nô quand tout fut fait.
Le Comte d’Avaux même avec tou tes ſes brigues.	Le Comte d'Avaux même avec tou tes ses brigues.
Ne peut, quoy qu’un Argus, de couvrir vos intrigues.	Ne peut, quoi qu'un Argus, de couvrir vos intrigues.
Vous deviez empêcher, Madame ce deſordre, Un mot en confidence, on et lehivi vos oldleo.	Vous deviez empêcher, Madame ce désordre, Un mot en confidence, on et lehivi vos oldo.
La Hollande.	La Hollande.
Nous devions empêcher, Marqui  tous les deſſeins, Qui comme l’on à veu ne buttoient à rien moins.	Nous devions empêcher, Marqui tous les desseins, Qui comme l'on à vu ne butaient à rien moins.
Aprés tant de malheurs que les miens ont ſoufferts, Que de les engager pour toûjours dans tes fers;	Après tant de malheurs que les miens ont soufferts, Que de les engager pour toujours dans tes fers;
Dy, qu’avons-nous fait que tu n’euſſes commencé?	Dis, qu'avons-nous fait que tu n'eusses commencé?
Tu voulus tout brouiller, nous t’avons devancẽ.	Tu voulus tout brouiller, nous t'avons devancence.
Aſſiegeant Philisbourg tu ſignas de ta main, Le ſort de l’Angleterre & de ſon Souverain.	Assiègeant Philisbourg tu signas de ta main, Le sort de l'Angleterre et de son Souverain.
Ce ſiege à contre-tems fut un coup de partie.	Ce siège à contre-tems fut un coup de partie.
Le Roy Jaque y perdit Sceptre, Thrône, & patrie, Si l’on euſt de ce Roy aimé les intereſts, Siegeant Maſtrich, tu euſſes arrêté nos projets Et Guillaume auroit deu ſuſpendant ſes deſſeins, Accourir au plûtoſt défendre mes confins.	Le Roi Jaque y perdit Sceptre, Thrône, et patrie, Si l'on eût de ce Roi aimé les intérêts, Siègeant Mastrich, tu eusses arrêté nos projets Et Guillaume aurait dû suspendant ses desseins, Accourir au plus défendre mes confins.
Lou	Lou
On ne l’avoit preveu que trop, mau ſa Hauteſſe Importunoit Louys ſon allié ſans ceſſe, D’effectuer bien-tõſt ce qu’il avoit promis, Qu’il ſe declareroit contre ſes ennemis.	On ne l'avait prévu que trop, mau sa Hautesse Importunait Louis son allié sans cesse, D'effectuer bien-tõst ce qu'il avait promis, Qu'il se déclarerait contre ses ennemis.
Ce coup ſe devoit faire avec un grand éclat.	Ce coup se devait faire avec un grand éclat.
On vint en Allemagne, où l’on ſe declara;	On vint en Allemagne, où l'on se déclara;
Aſſiegeant Philisbourg & le Prince d’Orange Prit toute l’Angleterre & l’Ecoſſe en échange Et du thrône où le ſang l’avoit fait élever 90 Jaque par mon Louys s’eſt veu pre.	Assiègeant Philisbourg et le Prince d'Orange Prit toute l'Angleterre et l'Écosse en échange Et du trône où le sang l'avait fait élever 90 Jaque par mon Louis s'est vu prévoir.
cipiter;	cipiter;
Tellement que ce Roy va de la ſervitude Se faire pour long-temps une triſte habitude;	Tellement que ce Roi va de la servitude Se faire pour longtemps une triste habitude;
Et comme chancellant de ſa chute étonné, lethoncer aux grandeurs où il fut deſtine.	Et comme chancelant de sa chute étonné, lethoncer aux grandeurs où il fut destine.
La Hollande.	La Hollande.
Il faut mieux eſperer Louys luy a promis De le faire marcher ſur tous ſes ennemis.	Il faut mieux espérer Louis lui avait promis De le faire marcher sur tous ses ennemis.
Il ſemera par tout ſa crainte & ſes allarmes Rien ne peut eſtre exempt de l’effroy de ſes armes Les ennemis du Roy ne ſont pas invincibles.	Il sèmera par tout sa crainte et ses alarmes Rien ne peut être exempt de l'effroi de ses armes Les ennemis du Roi ne sont pas invincibles.
Ses Louys trouveront des amis fort flexibles, Et Guillaume n’eſt pas tranquille poſſeſſeur.	Ses Louis trouveront des amis fort flexibles, Et Guillaume n'est pas tranquille possesseur.
Louvois.	Louvais.
Et Louys du plus grand de tous ſes ennemis, En feroit le premier de ſes plus grands amis.	Et Louis du plus grand de tous ses ennemis, En ferait le premier de ses plus grands amis.
Il exileroit même en Prince fort cruel, Comme ſon pere fit lors que re gnoit Cromwel, Et Jaque & tout ce qui reſte de ſi famille, Si cette cruauté pouvoit luy êtreſ utile.	Il exilerait même en Prince fort cruel, Comme son père fit lors que re gînait Cromwel, Et Jaque et tout ce qui reste de si famille, Si cette cruauté pouvait pu maîtres utile.
Oui il ſe ligueroit avec Guillaume même, Et luy premetteroit l’author té ſupreme.	Oui il se liguerait avec Guillaume même, Et deux premetterait l'autor té suprême.
Il chaſſeroit de France & de tous ſes Etats, Jaque & tous ſes amis, ſa.	Il chasserait de France et de tous ses États, Jaque et tous ses amis, sa.
La Hollande.	La Hollande.
Je ne le crois pas.	Je ne le crois pas.
Jous le verriez.	Jous le verriez.
La Hollande.	La Hollande.
Comſent, apres avon juré?	Comsent, après avon juré?
Louvois.	Louvais.
Le n’eſt pas d’aujourd’huy qu’on l’aveu parjuré.	Le n'est pas d'aujourd'hui qu'on l'aveu parjuré.
le graid Louys irelt pas ciclave d’un ſerment.	le graid Louis irelt pas ciclave d'un serment.
L'Eſpagne.	L'Espagne.
e ne le ſçay que trop, à mon grand detriment.	Je ne le sais que trop, à mon grand détriment.
Oüy depuis que ma ſereniſſime Infante, Comme un gage aſſuré d’une amitié conſtante, Sortit de mes Etats pour épouſer ſon Roy,	Oui depuis que ma servenissime Infante, Comme un gage assuré d'une amitié constante, Sortit de mes États pour épouser son Roi,
Il ſembla n’avoir plus d’autre ennemy que moy.	Il sembla n'avoir plus d'autre ennemi que moi.
Sont-ce là les effets d’un ſermen ſolemnel Juré ſur les Canons & ſigné ſul'autel ?	Sont-ce là les effets d'un sermen solennel Juré sur les Canons et signé sul'autel ?
D'être éternellement amy de ſon beau-pere, Et de joindre avec luy une amitiéſ ſincere;	D'être éternellement ami de son beau-père, Et de joindre avec lui une amitiés sincère;
Et dans le même inſtant qu’il ſi gnoit cette paix, Il armoit contre luy ſes ſujets Por.	Et dans le même instant qu'il si gînait cette paix, Il armait contre nô ses sujets Por.
ſe tugais, Violoit le ſerment qu’il venoit de prêter;	se tugais, Violait le serment qu'il venait de prêter;
Cachoit ſes trahiſons ſous un traîtret.	Cachait ses trahisons sous un traîtret.
baiſer;	baiser;
Nourriſſoit dans ſon ſein pluſieur milliers d’intriguës, Et tâchoit contre luy de faire autant de brigues.	Nourrissait dans son sein plusieur milliers d'intrigues, Et tâchait contre lui de faire autant de brigues.
Louvois.	Louvais.
Cela ſe fit du tems de mon prede ceſſeur, Le e crime eſt perſonnel, puniſſezen l’autheur.	Cela se fit du temps de mon préde cesseur, Le e crime est personnel, punissez l'auteur.
ouys pour vôtre fils, Madame, étoit trop fin, luy joüa pour lors un tour de Mazarm.	ouïs pour votre fils, Madame, était trop fin, lui joua pour lors un tour de Mazarm.
ppellez s’il vous plaiſt un peu dans la memoire, e que ſur ce ſujet en raconte l’Hiſtoire.	ppelez s'il vous plaît un peu dans la mémoire, est que sur ce sujet en raconte l'Histoire.
Quand Philippe & Louys dans I’Iſle des Faiſands trouverent tous deux, & que par leurs ſermens urez ſur les Canons & les Saincts Evangiles, n preſence de Dieu & de gens plus de mille, e tous deux à la meſſe eurent communiés une hoſtie à deſſein rompue’ en deux moitiés;	Quand Philippe et Louis dans J'Île des Faisands trouvèrent tous deux, et que par leurs serments urez sur les Canons et les Saints Évangiles, n présence de Dieu et de gens plus de mille, eu tous deux à la messe eurent communiés une hostie à dessein rompue en deux moitiés;
s promirent dés lors une union ſincere, le qu’elle devoit être entre fils & Pere, De Et que pour mettre obſtacle à de nouveaux debats, Les Roys voulurent bien ſigner leurs concordats, Par où Louys juroit en termes bien exprés, Qu’il renonçoit dés lors ſans fraude à tous les droits, Que de l’Infante & luy l’illuſtre mariage, Pourroit un jour luy faire échoir en heritage.	s promirent dès lors une union sincère, le qu'elle devait être entre fils et Père, De Et que pour mettre obstacle à de nouveaux débats, Les Rois voulurent bien signer leurs concordats, Par où Louis jurait en termes bien exprès, Qu'il renonçait dès lors sans fraude à tous les droits, Que de l'Infante et tant l'illustre mariage, Pourrait un jour lu faire échoir en héritage.
Souvenez-vous qu’alors par une promptitude, Qui parmy les François paſſe pour habitude, Louys jura ſi vîte, & dit les mots ſi bas, Que Philippe preſent ne s’en appet ceut pas;	Souvenez-vous qu'alors par une promptitude, Qui parmi les Français passe pour habitude, Louis jura si vite, et dit les mots si bas, Que Philippe présent ne s'en appet ceut pas;
Tellement que ce Roy ayant prête le ſien, Sur les ſacrés canons que ſon gran Chapelain Luy preſenta, il dit que ſi le Ro Louys Avo Avoit juré ou non, il ne l’avoit oüy, Si bien que Louys fit le ſigne de la croix, Et prêta le ſerment une ſeconde  1010.	Tellement que ce Roi ayant prête le sien, Sur les sacrés canons que son gran Chapelain Lui présenta, il dit que si le Ro Louis Av Ait juré ou non, il ne l'avait oui, Si bien que Louis fit le signe de la crois, Et prêta le serment une seconde 1010.
L’Eſpagne.	L'Espagne.
Et bien, où pretens-tu que feu ton Cardinal, Euſt peu me faire un tour qui me fuſt plus fatal?	Et bien, où prétends-tu que feu ton Cardinal, Eut pu me faire un tour qui me fût plus fatal?
Dy-moy ſi tu dis vray, ou bien ſi tu te moques, Louys dans ſon ſerment uſa-t-il d’equivoque ?	Dis-moi si tu dis vrai, ou bien si tu te moques, Louis dans son serment usa-t-il d'équivoque ?
Dy-moy, auroit-il eu quelque reſtricton, cur facilité ſon abſolution?	Dis-moi, aurait-il eu quelque restricton, cur facilité son absolution?
Il jura comme moy, même il jura deux fois.	Il jura comme moi, même il jura deux fois.
D	D
LouLouvois.	LouLouvais.
Ah!	Ah!
Madame, il falloit le faire jure trois, Comme dans le Latin deux ſeules negatives, Dans la même oraiſon font une affirmativc, Ainſi dans le François deux affirmations, Auront fait à ſon compte une negation.	Madame, il fallait le faire jure trois, Comme dans le Latin deux seules négatives, Dans la même oraison font une affirmativ, Ainsi dans le Français deux affirmations, Auront fait à son compte une négation.
Ergo donc mon Louys ayant juré deux fois, N'en auroit juré nulle, entendei.	Ergo donc mon Louis ayant juré deux fois, N'en aurait juré nulle, entendei.
vous, François?	vous, Français?
L'Espagne.	L'Espagne.
Quoy ſi mon fils mouroit ſans aucun Succeſſeur, .	Quoi si mon fils mourait sans aucun Successeur, .
110 Comme en effet j’en ay une trés.	110 Comme en effet j'en ai une très.
grande peur .	grande peur .
1 Louys donc pretendroit d’unir tous mes Etats	1 Louis donc prétendrait d'unir tous mes États
Mes Royaumes, mes biens, aux ſiens?	Mes Royaumes, mes biens, aux siens?
Con ovis.	Con ouïs.
mt pourquoy pas?	mt pourquoi pas?
L’Eſpagne.	L'Espagne.
La Hollande rebelle à ſes vrays Souverains, Tomberoit donc encor un jour entre ſes mains?	La Hollande rebelle à ses vrais Souverains, Tomberait donc encor un jour entre ses mains?
Quoy de ſi beaux pays, la Flandre qui la joint, De ſi beaux ports de mer perdus?	Quoi de si beaux pays, la Flandre qui la joint, De si beaux ports de mer perdus?
.	.
Louvois.	Louvais.
Et pourquoy point?	Et pourquoi point?
L’Espagne.	L'Espagne.
Quoy donc le Portugal, la maiſon de Bragance,	Quoi donc le Portugal, la maison de Bragance,
Ne	Ne
D 2 Ne ſeroit pas chez elle encor en aſſurance ?	 2 Ne serait pas chez elle encor en assurance ?
Louys pretendroit donc reünir quoi qui coûte, Les Etats autrefois mes ſujets?	Louis prétendrait donc réunir quoi qui coûte, Les Etats autrefois mes sujets?
Europe.	Europe.
Qui en doute.	Qui en doute.
L’Espagne.	L'Espagne.
Quoy, ma maiſon d’Auſtriche à cetſ12210 te heure regnante, Cette famille Auguſte autrefois ſi puiſſante, 110 Seroit dans le fieanit, ce Louys de Bourbon, A cauſe de l’Infante auroit tout?	Quoi, ma maison d'Autriche à cets1210 te heure régnante, Cette famille Auguste autrefois si puissante, 110 Serait dans le fieanit, ce Louis de Bourbon, A cause de l'Infante aurait tout?
Louvois.	Louvais.
Pourquoy non?	Pourquoi non?
L’Espagne.	L'Espagne.
Pourquoy pas, pourquoy point, 1 pourquoy non, qui en doute?	Pourquoi pas, pourquoi point, 1 pourquoi non, qui en doute?
I Je ſuis embaraſſée, Marquis, quand je t’écoute, Tu me fais voir icy pluſieurs grangrandes affaires, Qu’on tenoit à couvert ſans beaucoup de myſteres.	I Je suis embarrassée, Marquis, quand je t'écoute, Tu me fais voir ici plusieurs grangrandes affaires, Qu'on tenait à couvert sans beaucoup de mystères.
Quoy que mon ennemy, je te ſçay fort bon gré, De m’avoir découvert icy tout le ſecret;	Quoi que mon ennemi, je te sais fort bon gré, De m'avoir découvert ici tout le secret;
Tu ſçais combien de fois par tout le Pays-bas, Tu es venu du Roy diſpoſer tout les pas;	Tu sais combien de fois par tout le Pays-bas, Tu es venu du Roi disposer tout les pas;
Tu ſçais bien que je puis te faire reſſentir, Dans ces lieux tant de maux que tu m’as fait ſouffrir.	Tu sais bien que je puis te faire ressentir, Dans ces lieux tant de maux que tu m'as fait souffrir.
On m’a juſqu’à preſent fait croire bien des choſes, Qu'a ma perte je vois avoir eſté tres-fauſſes.	On m'a jusqu'à présent fait croire bien des choses, Qu'a ma perte je vois avoir été très-fausses.
Si tu veux obtenir dans le grand châtiment, Que tu as merité quelque amoindriſſement.	Si tu veux obtenir dans le grand châtiment, Que tu as mérité quelque amoindrissement.
D D I Di-moy ſans me flatter, mais ne me trompe pas, N’eſt-ce rien comme on dit de tous mes Pays-bas?	 I Dis-moi sans me flatter, mais ne me trompe pas, N'est-ce rien comme on dit de tous mes Pays-bas?
Louvois.	Louvais.
A preſent ce n’eſt rien, Madame, ou peu de choſe Pour vous, mais de Louys, c’eſt la plus belle roſe, C’eſt le plus beau joyau dont brille ſa Couronne, Et qui le rend ſi- fier maintenant ſur le Thrône.	À présent ce n'est rien, Madame, ou peu de chose Pour vous, mais de Louis, c'est la plus belle rose, C'est le plus beau joyau dont brille sa Couronne, Et qui le rend si- fier maintenant sur le Thrône.
Je me ſuis étonné moy-même mille fois De vous voir inſenſible aux progrés des François, De voir vos Gouverneurs s’ériger en marchans, Vendre Villes, Châteaux, Foreſts au plus offrans;	Je me suis étonné moi-même mille fois De vous voir insensible aux progrès des Français, De voir vos Gouverneurs s'ériger en marchants, Vendre Villes, Châteaux, Forêts au plus offrants;
Et loin d’en informer ayant fait leur campagne, On les recompenſoit les faiſant Grands d’Eſpagne;	Et loin d'en informer ayant fait leur campagne, On les récompensait les faisant Grands d'Espagne;
Combien de millions n’ay-je pas financé, Pour des certains projets que j’ayois commencés, Qu’il falloit achever avec quelques piſtolles, Qui font la paſſion de la race Eſpagnoles.	Combien de millions n'ai-je pas financé, Pour des certains projets que j'ayais commencès, Qu'il fallait achever avec quelques pistoles, Qui font la passion de la race Espagnoles.
L’Espagne.	L'Espagne.
Nomme moy ces fripons, ces traitres, ſcelerats.	Nomme moi ces fripons, ces traîtres, scélérats.
Louvois.	Louvais.
Madame, approchez-vous, je les dirai tout oas.	Madame, approchez-vous, je les dirai tout oas.
Vous avez tout gâté changeant les Gouverneurs.	Vous avez tout gâté changeant les Gouverneurs.
1 La Flandre dans ſon ſein portoit ſes deffenſeurs.	1 La Flandre dans son sein portait ses défenseurs.
Tant qu’ils ont gouver né leurs Etats & leurs villes,	Tant qu'ils ont gouver né leurs États et leurs villes,
Nos	Nos
D 4 Nos efforts pour leur nuire y furent inutiles;	 4 Nos efforts pour leur nuire y furent inutiles;
Mais depuis que vos gens plus maigres que herons, Sont retournés chez vous gras comme des c’hapons, Que comme des ſangſuës, ils ont ſuccé le ſang De vos meilleurs ſujets & de tout le Brabant;	Mais depuis que vos gens plus maigres que hérons, Sont retournés chez vous gras comme des c'hapons, Que comme des sangsues, ils ont succé le sang De vos meilleurs sujets et de tout le Brabant;
On vous a filouté des Provinces enticres;	On vous a filouté des Provinces enticres;
Des Pays-bas Louys en a fait es Frontieres.	Des Pays-bas Louis en a fait es Frontières.
Il vous reſte Nieuport, Oſtende, Anvers, Louvain, Bruxelles, Bruges, Ath, le reſte ce n’eſt rien.	Il vous reste Nieuport, Ôtende, Anvers, Louvain, Bruxelles, Bruges, Ath, le reste ce n'est rien.
Si de ces villes-cy vous perdez la premiere, La Mer ne pourra plus vous ſervir de barriere, Pour borner les projets du corporal Louys, Madame, il ira voir, vôtre fils à Madrit.	Si de ces villes-cy vous perdez la première, La Mer ne pourra plus vous servir de barrière, Pour borner les projets du corporal Louis, Madame, il ira voir, votre fils à Madrit.
L’EspaNe ſe ſouviendra-t-il jamais de ſon ſerment?	L'EspaNe se souviendra-t-il jamais de son serment?
Louvois.	Louvais.
Il en eſt dés long-temps abſous du Parlement.	Il en est dès longtemps absous du Parlement.
Avez-vous veu l’écrit fait par Pierre du Puis, Qui dit que l’Italie appartient à Louys ?	Avez-vous vu l'écrit fait par Pierre du Puis, Qui dit que l'Italie appartient à Louis ?
Avez-vous veu celuy d’un certain d’Arõeu ?	Avez-vous vu celui d'un certain d'Arõeu ,
Il dit que l’Arragon devroit luy étre écheu.	Il dit que l'Aragon devroit devrait avoir écheu.
Voyez-moy d’Auberry & Monſieur de Caſſan, Madame, vous verrez que tout le Caſtillan, L’Empire & les Etats qui confinent la France, Luy ſont tout dévolus par droit de bienſeance.	Voyez-moi d'Auberri et Monsieur de Cassan, Madame, vous verrez que tout le Castillan, L'Empire et les États qui confinent la France, Lui sont tout dévolus par droit de bienséance.
Un autre livre mis par Talon en lumiere, Entreprend de prouver d’une maniere clairè, Que l’Europe apartient, quoy qu’en penſent leurs Roys.	Un autre livre mis par Talon en lumière, Entreprend de prouver d'une manière clairète, Que l'Europe appartient, quoi qu’en pensent leurs Rois.
Depuis prés de mille ans aux perfides François.	Depuis près de mille ans aux perfides Français,
Et ſi ce grand Hableur en compoſe quelqu’autre, Vous verrez l’Amerique & l’Aſie être nôtres.	Et si ce grand Hableur en compose quelqu'autre, Vous verrez l'Amérique et l'As être nôtres.
L’Espagne.	L'Espagne.
Quel remede à mes maux, allons conſeille-moy.	Quel remède à mes maux, allons conseille-moi.
Dy?	Dis?
Louvois.	Louvais.
Faites Grand d’Eſpagne au plûſtoſt vôtre Roy.	Faites Grand d'Espagne au plûstost votre Roi.
Madame, ce qui fait ſon malheur lus qu’extréme, C’eſt C’eſt que ſes ſujets ſont plus riches que luy-même;	Madame, ce qui fait son malheur lus qu'extrême, C'est C'est que ses sujets sont plus riches que lui-même;
Que Roy ſur tant d’Etats, il ne poſſede rien, Qu’il n’y peut commander en parfait Souverain.	Que Roi sur tant d'États, il ne possède rien, Qu'il n'y peut commander en parfait Souverain.
S’il veut ſe conformer à mes petits avis, Qu’il tâche d'imiter ſon beau-frere Louys;	S'il veut se conformer à mes petits avis, Qu'il tâche d'imiter son beau-frère Louis;
Que le Printems prochain il ſe mette en campagne, Et qu’il mene avec ſoy ſa nobleſſe d’Eſpagne.	Que le Printems prochain il se mette en campagne, Et qu'il mene avec soi sa noblesse d'Espagne.
Si pour faire du monde il n’a pas de l’argent, 11il 2 10 Que chacun de ſes grands luy faſſe un Regiment;	Si pour faire du monde il n'a pas de l'argent, 11il 2 10 Que chacun de ses grands sens fasse un Régiment;
Qu’il les oblige encor à les entrenir, Ce ſera le moyen de tous les appauvrir;	Qu'il les oblige encor à les entrenir, Ce sera le moyen de tous les appauvrir;
Qu'il leur reproche à tous ces lâches exercices, De croupir dans la Cour au milieu des delices;	Qu'il leur reproche à tous ces lâches exercices, De croupir dans la Cour au milieu des délices;
D 6 Qu’il	 6 Qu'il
Qu’il ne faut pas pourrir derriere une muraille.	Qu'il ne faut pas pourrir derrière une muraille.
Qu’il faut ie faire voir dans un champ de bataille;	Qu'il faut rien faire voir dans un champ de bataille;
Que c’eſt dans ces lieux-là que leurs Predeceſſeurs, Se ſont rendus fameux, ont acquis leurs honneurs;	Que c'est dans ces lieux-là que leurs Prédecesseurs, Se sont rendus fameux, ont acquis leurs honneurs;
Que lors qu’on peut paroître au milieu des hazards, Les grands cœurs ſont honteux de garder des remparts.	Que lors qu'on peut paraître au milieu des hasards, Les grands cœurs sont honteux de garder des remparts.
Comme vos Eſpagnols ſont amateurs de gloire, Ils voudront ſe placer quelque part dans l’Hiſtoire.	Comme vos Espagnols sont amateurs de gloire, Ils voudront se placer quelque part dans l'Histoire.
110 Et de ces faineans, vous verrez des ſoldats, Qui ſe ſignaleront pour luy plaire, aux combats;	110 Et de ces faineans, vous verrez des soldats, Qui se signaleront pour lui plaire, aux combats;
que s’ils ſont curieux d’avoir un autre maître Ils ne l’ignorent pas le François le veut être.	que s'ils sont curieux d'avoir un autre maître Ils ne l'ignorent pas le Français le veut être.
L'EffpaTu-as raiſon, Marquis, le peuple, qui ſe plaint,1 uit tous haut dans Madrit que mon Roy n eit pas crdille.	L'EffaTu-as raison, Marquis, le peuple, qui se plaint,1 uit tous haut dans Madrit que mon Roi n it pas crédille.
Louvois.	Louvais.
Il eſt trop vray, Madame, & vous devés tout craindre, D'un peuple maene qui commnence à ſe plaindre.	Il est trop vrai, Madame, et vous devez tout craindre, D'un peuple maene qui commenence à se plaindre.
1L1HOIOI L’Eſpagne.	1L1HOIOI L'Espagne.
** 460 Depuis que mes Etats panchent ſur leur declin, DM Mon fils ouvre ſes yeux un peu tard à la fin.	** 460 Depuis que mes États penchent sur leur déclin, DM Mon fils ouvre ses yeux un peu tard à la fin.
Ils étoient en effet reduits dans leurs O1 ſyſtemes, TO LLEIIDI Et leurs maux ne pouvoient même 11 être plus extrémes.	Ils étaient en effet réduits dans leurs O1 systèmes, TO LEIDI Et leurs maux ne pouvaient même 11 être plus extrêmes.
u 80 On l’a veu du depuis reformer les abus, Retrancher quelques frais qui étoient ſuperflus, Caſſer des penſions, ſupprimer des emplois, Qui mangeoient pour le moins la mortié de ſes droits.	Çu 80 On l'a vu du depuis réformer les abus, Retrancher quelques frais qui étaient superflus, Casser des pensions, supprimer des emplois, Qui mangeaient pour le moins la mortié de ses droits.
C’eſt dommage en ce temps qu’il  nous eſt neceſſaire, Que ce Prince toûjours ſoit vale.	C'est dommage en ce temps qu'il nous est nécessaire, Que ce Prince toujours soit vale.
tudinaire.	tudinaire.
Ah!	Ah!
s’il avoit la force égale à ſon courage, Ton Louys n’oſeroit le morguer davantage;	s'il avait la force égale à son courage, Ton Louis n'oserait le morguer davantage;
Mais je que croy du Ciel la juſtice infinie, Pourra ſe declarer contre la Tyrannie;	Mais je que crois du Ciel la justice infinie, Pourra se parer contre la Tyrannie;
Et que laſſé de voir des ſermens vioés Mon jeune Roy trahy, mes Etats deſolés, Laſſé, dis-je, de voir répandre tant de ſang 7 Vieniendra rendre à chacun ſon legitime rang.	Et que lassé de voir des serments vioés Mon jeune Roy trahi, mes États désolés, Lassé, dis-je, de voir répandre tant de sang 7 Viendra rendre à chacun son légitime rang.
Louvois.	Louvais.
muulue eiperer , aianaie,	muulue eiperer , aianaie,
L’Eſpagne.	L'Espagne.
Ouy la juſtice Le veut, ou de Louys le Ciel même eſt complice.	Oui la justice Le veut, ou de Louis le Ciel même est complice.
Qui je diray que Dieu le nom du quel je jure, Eſt protecteur du crime, authoriſe un parjure, Je diray que.	Qui je dirai que Dieu le nom du quel je jure, Est protecteur du crime, autorise un parjure, Je dirai que.
11100 Caron a l’Europe.	11100 Caron a l'Europe.
Madame, avez-vous achevé?	Madame, avez-vous achevé?
Il y a depuis peu bien du monde arrivê;	Il y a depuis peu bien du monde arrivêmes;
Et ſi vous ne venez en perſonne y mettre ordre, Je ne puis plus moy ſeul empêcher le deſordre.	Et si vous ne venez en personne y mettre ordre, Je ne puis plus moi seul empêcher le désordre.
EIoid	EIoid
Trois Generaux François avec de la canaille, Jurent qu’ils ont gagné la derniere bataille, Entre les Alliés, quantité d’Oſſciers, Jurent que les François ont fuïles premiers, Et ces Meſſieurs bottez, monté comme Saint George, Pourront.	Trois Généraux Français avec de la canaille, Jurent qu'ils ont gagné la dernière bataille, Entre les Alliz, quantité d'Ossciers, Jurent que les Français ont fuilles premiers, Et ces Messieurs bottés, monté comme Saint George, Pourront.
en verité je crain qu’ils ne s’égorgent.	en vérité je crain qu'ils ne s'égorgent.
Un certain de Saint-Ruth Saint diaboliſé, Jure qu’en l’autre monde il fut ca noniſé.	Un certain de Saint-Ruth Saint diabolisé, Jure qu'en l'autre monde il fut ca nonisé.
Il dit qu’il s’eſt battu en vaillant Champion, Pour l’Egliſe de Dieu & ſa Religion Qu’étant un défenſeur de la foi Catholique, Il pretend bien icy d’être un Saint Authentique;	Il dit qu'il s'est battu en vaillant Champion, Pour l'Église de Dieu et sa Religion Qu'étant un défenseur de la foi Catholique, Il prétend bien ici d'être un Saint Authentique;
Et pour êtré traitté ſelon ſon gran merite, Il veut qu’on le reçoive avec de l'eau-benite.	Et pour êtré traité selon son gran mérite, Il veut qu'on le reçoive avec de l'eau-bénite.
a des cadets qui viennent de Hongrie, Qui ſe ſont fait ſabrer pour la Saſnte Turquie, Ils ſe ſont immolez pour Monſieur Mahomet, Et veulent qu’on leur diſcoù cet impoſteur eſt.	a des cadets qui viennent de Hongrie, Qui se sont fait sabrer pour la Sânte Turquie, Ils se sont immolés pour Monsieur Mahomet, Et veulent qu'on leur discoù cet imposteur est.
Ils parlent bon François quoy qu’ornés de turbans, Et ſe font diſtinguer d’avec les Otthomans.	Ils parlent bon Français quoi qu'ornès de turbans, Et se font distinguer d'avec les Othomans.
Comme pour obeïr aux ordres de leur Roy, Ils ſe ſont fait tuer pour cette Sainte Loy;	Comme pour obéir aux ordres de leur Roi, Ils se sont fait tuer pour cette Sainte Loi;
is pretendent auſſi d’avoir le Paradis, Que Maître Mahomet promit à ſes amis.	Ois prétendent aussi d'avoir le Paradis, Que Maître Mahomet promit à ses amis.
Europe à Caron.	Europe à Caron.
Va, dy leur qu’ils auront l’effet de leur demande, Et Et di à même temps à Saint-Ruil qu’il attende;	Va, dis leur qu'ils auront l'effet de leur demande, Et Et di à même temps à Saint-Ril qu'il attende;
ay quelque choſe à dire à ce bon Hypocrite, Qui vaudra pour le monis autant que Penu osinte.	ai quelque chose à dire à ce bon Hypocrite, Qui vaudra pour le monis autant que Penu ôte.
Europe à ſes filles.	Europe à ses filles.
Mes Dames, achevez, prononcez la Sentence, Que vous jugez la plus conforme à ſon offenſe, Vous avez entendu dans ſes confeſſions, u’il eſt plus criminel que nous ne le penſions;	Mes Dames, achevez, prononcez la Sentence, Que vous jugez la plus conforme à son offense, Vous avez entendu dans ses confessions, il est plus criminel que nous ne le pensions;
ue chacune t ien tour diſe ſon ſentiment, jelouſſigne déja à vorre jugement.	Que chacune t yen tour dise son sentiment, jeloussigne déjà à vorre jugement.
L’Angleterre.	L'Angleterre.
Que Madame prononce à ſa diſcretion, pourrois-je inventer pour ſa punition ?	Que Madame prononce à sa discrétion, pourrais-je inventer pour sa punition ?
ous les maux qu’il m’a faits ont ſigné mon bon-heur, rrois-je condamner mon propre bienfaiteur;	ous les maux qu'il m'a faits ont signé mon bonheur, rois-je condamner mon propre bienfaiteur;
uy-même m’a donné de ſa main un Guillaume, Pour regler mes Etats, redreſſer mon Royaume.	Oui-même m'a donné de sa main un Guillaume, Pour régler mes États, redresser mon Royaume.
je ne ſçaurois jamais pour tout ce quimiinul fait, l'ayer d’ingratitude un lembiable bienfait.	je ne saurais jamais pour tout ce quimiinul fait, l'ayer d'ingratitude un lémbiable bienfait.
La France.	La France.
e me conformeray au ſentiment des autres, L’eſt plus leurs interêts d’en juger que les nôtres.	Je me conformerai au sentiment des autres, L'est plus leurs intérêts d'en juger que les nôtres.
L’Allemagne.	L'Allemagne.
Je ne puis condamner que ſon intention, de	Je ne puis condamner que son intention, de
Et je crois luy avoir de l’obligation De m’avoir ſuſcité quantité d’enne.	Et je crois Seigneur avoir de l'obligation De m'avoir suscité quantité d'enne.
mis, Qu’aprés avoir dompté, à la fin j’a ſoûmis.	mis, Qu'après avoir dompté, à la fin j'a soumis.
Ses trahiſons m’ont fait connoître mes rebelles, Qui dans tous mes Etats ſuſcitoient des querelles.	Ses trahisons m'ont fait connaître mes rebelles, Qui dans tous mes États suscitaient des querelles.
Un perfide en Horgrie, un autre ſur le Rhin.	Un perfide en Horgrie, un autre sur le Rhin.
Diſpoſoient à plaiſir déja de tout mon bien.	Disposaient à plaisir déjà de tout mon bien.
Tous deux ſont exilés, proſcrits de mes Etats;	Tous deux sont exilés, proscrits de mes États;
Je n’ay plus crainte deux ny de leurs attentats.	Je n'ai plus crainte deux ici de leurs attentats.
Ils ſe ſont chatiés eux-mêmes de leurs crimes, Et pourront de la guerre être un jour les victimes.	Ils se sont chatiés eux-mêmes de leurs crimes, Et pourront de la guerre être un jour les victimes.
L’Jtalie ma ſœur qui n’eſt pas peu lezée, Qui fut du grand Louys tant de fois offenſée, a Tekely.	L'Jtalie ma sœur qui n'est pas peu lésée, Qui fut du grand Louis tant de fois offensée, à Tekely.
b Furſtemberg.	 Barstemberg.
Doit oit donner des arreſts qui ſoient les plus conformes.	Doit oit donner des arrêts qui soient les plus conformes.
Atous ſes attentats & ſes crimes eHorineo.	Attous ses attentats et ses crimes eHorineo.
L'ftalie.	L'ftalie.
Et de grace comment voudriez-vous que je fiſſe?	Et de grâce comment voudriez-vous que je fisse?
le repreſente icy ma chere ſœur l’Egliſe;	le représente ici ma chère sœur l'Église;
Vous ſçavez qu’indulgente, elle abhorre le ſang e ne puis, pour juger, m’aſſeoir en jugement.	Vous avez qu'indulgente, elle abhorre le sang ne puis, pour juger, m'asseoir en jugement.
ARome Lavardin fut reputé pour ſot, Tout excommunié, il faiſoit le bigot.	ARome Lavardin fut réputé pour sot, Tout excommunié, il faisait le bigot.
Odeſcalley zelé ſucceſſeur de Saint Pierre, 11 Ne fit que ſe joüer de ſon humeur altiere;	Odescaley zélé successeur de Saint Pierre, 11 Ne fit que se jouer de son humeur altière;
Qu’il tâche d’obtenir du Prince de Piemont, 'il veuille enteriner ſa grace, & ſon pardon.	Qu'il tâche d'obtenir du Prince de Piémont, 'il veuille entériner sa grâce, et son pardon.
La	La
La Hollande doit donc prononces la Sentence.	La Hollande doit donc prononces la Sentence.
La Hollande.	La Hollande.
Oui je la porterois s’il m’euſt fait quelque offenſe, Depuis plus de vingt-ans que je ſouffre la guerre, Dites qu’ay-je perdu, ny par mer ny par terre;	Oui je la porterais s'il m'eût fait quelque offense, Depuis plus de vingt-ans que je souffre la guerre, Dites qu'ai-je perdu, ni parmer ni par terre;
Si on me prit Maſtrick, Louys mel le rendit, Il acheta ſa paix alors à ce haut orix;	Si on me prit Mastrick, Louis mel le rendit, Il acheta sa paix alors à ce haut oryx;
Et puis des millions qu’on me don na ſous main, Pour ne pas allarmer les autres ſouss verains.	Et puis des millions qu'on me don na sous main, Pour ne pas alarmer les autres sous vérains.
Si nous ſommes entrés en nouveaux differens, y n’ay encor perdu que fort peu de mes gens, Louys n’occupe encor aucune de mes places, Quel intereſt ay-je, quelles ſont mes diſgraces?	Si nous sommes entrés en nouveaux différents, y n'ai encor perdu que fort peu de mes gens, Louis n'occupe encor aucune de mes places, Quel intérêt ai-je, quelles sont mes disgrâces?
De quoy me plaindre moy, ſi Madame L’Eſpagne, A payé juſqu’icy l’écôt de la CamPaglie.	De quoi me plaindre moi, si Madame L'Espagne, A ayé jusqu'ici l'écôt de la CamPaglie.
L’Eſpagne.	L'Espagne.
12 I Vous avez bien manqué, Madame la rebelle, De voir net comme moy le fond de u vôtre écuelle.	12 I Vous avez bien manqué, Madame la rebelle, De voir net comme moi le fond de ès votre écuelle.
N’avez-vous pasété à deux doits du tombeau?	N'avez-vous pasété à deux doits du tombeau?
Vous n’êtes pas encor hors d’inſultes, tout beau;	Vous n'est pas encor hors d'insultes, tout beau;
Si on euſt pris encor deux ou trois de mes places,  Vous étiez comme moy dans les mêmus disgraces.	Si on eût pris encor deux ou trois de mes places, Vous étiez comme moi dans les mêmus disgrâces.
Mes Pays-bas perdus, vous étiez aux abois, ll falloit obeïr a Meſſieurs les Frantois Il y avoit long-tems qu’on crioit vîte à l’eau, Avez-vous accouru aveque vôtre ſeau ?	Mes Pays-bas perdus, vous étiez aux abois, l' allait obéir à Messieurs les Frantois Il y avait longtemps qu'on criait vite à l'eau, Avez-vous accouru avèque votre seau ?
Non, pour un intereſt que je ne puis trouver, Vous étiez ſpectatrice & laiſſiez tout brûler, Tellement que je crus ſans aucune injuſtice, Pouvoir laiſſer perir vôtre propre edifice, Vous étes accouruë à la fin;	Non, pour un intérêt que je ne puis trouver, Vous étiez spectatrice et laissiez tout brûler, Tellement que je crus sans aucune injustice, Pouvoir laisser périr votre propre édifice, Vous êtes accourue à la fin;
mais trop tard Aiant veu que le feu gagnoit de tou te part Et quand vous avez fait quelque choſe pour nous, 2 Ce fut lors qu’il y eut trop à craindre 2 pour vous.	mais trop tard Ajant vu que le feu gagnait de tou te part Et quand vous avez fait quelque chose pour nous, 2 Ce fut lors qu'il y eut trop à craindre 2 pour vous.
Dependulley inere bon que nous ſor tions d’affaire, Il eſt tems de finir, nous laſſons nôtre mere.	Dépendullei inère bon que nous sot tions d'affaire, Il est temps de finir, nous lassons notre mère.
Eurepe.	Eurpe.
Europe.	Europe.
Mes filles en effet vous me feriez plaiſir, D’achever au plûtôt, ou je m’en vais ſortir.	Mes filles en effet vous me feriez plaisir, D'achever au plûtôt, ou je m'en vais sortir.
L’Eſpagne.	L'Espagne.
Madame de mes ſeurs le ſilence muët, Veut que vous prononciez vous même cet arrêt, Quoy qu’elles ſoient icy toutes intereſſées, Elles ne ſont pas peu certes embaraſſées, D’une le jugement ſeroit contraire à l’autre, Vous les ſatisferiez toutes avec le votre, Pour moy quoy que j’aye dit de luy être indulgente, Tous les maux qu’il me fit je veux qu’il les reſſente.	Madame de mes sûrs le silence mut, Veut que vous prononciez -vous même cet arrêt, Quoi qu'elles soient ici toutes intéressées, Elles ne sont pas peu certes embarrassées, D'une le jugement serait contraire à l'autre, Vous les satisferiez toutes avec le vôtre, Pour moi quoi que 'aie dit de lui notre indulgente, Tous les maux qu'il me fit je veux qu'il les ressente.
Et ſi pour l’attacher au funeſte poteau On ne pouvoit cy-bas rencontrer de bourreau, Je veux en bonne amie le conduire au ſupplice, Et luy rendre à la fin ce charitable office.	Et si pour l'attacher au funeste poteau On ne pouvait cy-bas rencontrer de bourreau, Je veux en bonne amie le conduire au supplice, Et avoir rendre à la fin ce charitable office.
Muupe à Louvois.	Muupe à Louvais.
ça Marquis que Dis-tu, A leurs objections?	ça Marquis que Dis-tu, À leurs objections?
Louvois.	Louvais.
ay déja répondu.	ai déjà répondu.
Europe.	Europe.
Dans tous les attentats qu’ils furent tes complices?	Dans tous les attentats qu'ils furent tes complices?
Louvois.	Louvais.
Loujo authierneie toutes mes injuſtices.	Loujo authierne toutes mes injustices.
Europe.	Europe.
Ecrivez donc greffier;	Écrivez donc greffier;
Louys contre tout droit, Authoriſoit tout ce que le Marquis faiſoit, Je veux bien eſperer que nous voirons le jour, Que ce Louys quatorze aura auſſi ſon tour.	Louis contre tout droit, Autorisait tout ce que le Marquis faisait, Je veux bien espérer que nous voirons le jour, Que ce Louis quatorze aura aussi son tour.
Et cette ngne mame avec les Otz thomans?	Et cette ngne mame avec les Ots thomans?
Qui la ſigna?	Qui la signa?
Louvois.	Louvais.
Louys.	Louis.
Eu	Eu
991 el Europe.	991 elle Europe.
Ecrivés promptement.	Écrivez promptement.
Louys ſigna la ligue avec les ennemis De la Religion.	Louis signa la ligue avec les ennemis De la Religion.
& ce par ton avis?	et ce par ton avis?
om 2	om 2
Oüy.	Oui.
Louvois.	Louvais.
Europe.	Europe.
Qui a fait fauſſer le ferment au Dauphin, Aprés s’être engagé aux habitans du Rhin D’êtré le protecteur du beau Palatinat Louys fit-il encor rompre ce conCordate.	Qui a fait fausser le ferment au Dauphin, Après s'être engagé aux habitants du Rhin D'êtré le protecteur du beau Palatinat Louis fit-il encor rompre ce conCordate.
Louvois.	Louvais.
Comment donc.	Comment donc.
Ecrivez contre la foy promiſe, Louys a ſaccagé une Province acquiſe, Traîné femmes, enfans dans un rude eſclavage, Donné à ſes ſoldats ce pays au pillage.	Écrivez contre la foi promise, Louis a saccagé une Province acquise, Traîné femmes, enfants dans un rude esclavage, Donné à ses soldats ce pays au pillage.
Qiuu encouteur de cette Tyranne;	Quive encouteur de cette Tyranne;
Moy Madame.	Moi Madame.
Louvois.	Louvais.
Europe.	Europe.
Ecrivez ce que dit cette impie.	Écrivez ce que dit cette impie.
Il fut executeur des volontés du Roy Rendit ſuſpecte à tous de ſon Dauphin la foy, Fit ce Prince parjure & déja deteſtable, E 3 Devant Devant qu’on le connût, dis-moy abominable?	Il fut exécuteur des volontés du Roi Rendit suspecte à tous de son Dauphin la foi, Fit ce Prince parjure et déjà détestable, EVA 3 Devant Devant qu'on le connût, dis-moi abominable?
Qui conſeilla au Roy d’envoyer Lavardin, A Rome en grand Gaſçon inſulter un grand Saint?	Qui conseilla au Roi d'envoyer Lavardin, À Rome en grand Gasçon insulter un grand Saint?
De grace, qu’avoit fait ce Pontife à lon maitre:	De grâce, qu'avait fait ce Pontife à lon maître:
Louvois.	Louvais.
anceole muicrou reomea Louys vouloit l’être.	anceole muicrou reomea Louys vouloit l’être.
Europe.	Europe.
Ecrivez que Louys voulut dans Rome même, Avoir comme à Paris l’authorité ſuprenie, Et de cet attentat tu fus le ſeul autheur?	Écrivez que Louis voulût dans Rome -même, Avoir comme à Paris l'autorité suprenie, Et de cet attentat tu fus le seul auteur?
Oüy Madame.	Oui Madame.
Louvois.	Louvais.
EuroAjoûtez que ce perturbateur, Ne pouvant attaquer Dieu même dans le ciel, A contre ſon vicaire envoié tout ſon fiel, Mais encor, dans Paris, entre Lours & luy 7 Qui étoit ſouverain, qui étoit maître?	EuroAjoutez que ce perturbateur, Ne pouvant attaquer Dieu même dans le ciel, A contre son vicaire envoyé tout son fiel, Mais encor, dans Paris, entre Lours et lui 7 Qui était souverain, qui était maître?
Louvois.	Louvais.
Moy.	Moi.
Europe.	Europe.
Vîte écrivez qu’il s’eſt érigé en tyran, Plus inhumain cent fois qu’aucun Mahomet an Mais, qu’elle gloire eus-tu d’accabler la foibleſſe, E 4 D’un D'un Prince extenué par ſa propre vieilleſſe;	Vite écrivez qu'il s'est érigé en tyran, Plus inhumain cent fois qu'aucun Mahomet an Mais, qu'elle gloire eus-tu d'accabler la faiblesse, E 4 D'un D'un Prince extenué par sa propre vieillesse;
D'un peuple ſans vigueur & preſque inanimé, Qui pleure encor ſon ſort, & n’étoit pas armé.	D'un peuple sans vigueur et presqu' animé, Qui pleure encor son sort, et n'était pas armé.
Dis, ne ſçauroit-on plus vivire dans l’unvers, Sans connoître Louys & le port de ſes fers, Que luy avoient donc fait ſes couſins les Liegcois ?	Dis, ne saurait-on plus vivire dans l'unvers, Sans connaître Louis et le port de ses fers, Que avait avaient donc fait ses cousins les Liegcois ?
Pour y mettre en ingrat le feu en cent endroits.	Pour y mettre en ingrat le feu en cent endroits.
Avoit-il oublié que venant en Hôllande, On luy ſubminiſtra, pain, vin, foin, & viande?	Avait-il oublié que venant en Hôllande, On lui subministra, pain, vin, foin, et viande?
Scais-tu que tu ſerois encor à Saint Germain, Si tu n’eus attaqué le martyr de Pepin?	Sais-tu que tu serais encor à Saint Germain, Si tu n'eus attaqué le martyr de Pépin?
Ce Saint qui de tes Roys fut la triſte victime, Pour les avoir repris d’un grand crime, ſaintement Les Les Liegeois protéges par ce noble Patron, Furent bien-tôt vengés, tu pays la rançon.	Ce Saint qui de tes Rois fut la triste victime, Pour les avoir repris d'un grand crime, sainte Les Les Iègeois protèges par ce noble Patron, Furent bientôt vengés, tu pays la rançon.
Louvois.	Louvais.
Il m’en ſou vient encor, ſi c’étoit à refairc.	Il m'en sou vient encor, si c'était à refairc.
Europe.	Europe.
Toueces i,tlomanii, ront tous Scauie ſi en l’air.	Toueces -y,tlomani, ront tous Scavie si en l'air.
Louvois.	Louvais.
Je les hayſſois trop, ſi j’eus pü les détruire, Je n’eus rien épargné, il eſt vray, pour leur nuire, Auſſy j’avois donné mes ordres à Bouflers D’y allumer le feu en cent endroits diyers,	Je les hais trop, si j'eus pu les détruire, Je n'eus rien épargné, il est vrai, pour leur nuire, Auss j'avais donné mes ordres à Boufflers D'y allumer le feu en cent endroits diers,
D’abD’abbatre le palais, & de la Cathedrale, En laiſſer la memoire aux Chanoines fatale.	D'abD'abattre le palais, et de la Cathédrale, En laisser la mémoire aux Chanoines fatale.
Europe.	Europe.
Ecrivez que Louvois tout écumant de rage, Fit ſur Liege ſes gens fondre comme un orage, Que pour étre fidelle à ſon vray ſouverain, Il traitta cette ville en Turc, en inhumain;	Écrivez que Louvais tout écumant de rage, Fit sur Liège ses gens fondre comme un orage, Que pour être fidèle à son vrai souverain, Il traita cette ville en Turc, en inhumain;
Qu’en cette embraſement tous ſes plus grands amis, Furent enveloppez avec ſes ennemis, Et que pour ſatisfaire à ſa hayne implacable, S’il n’euſſe peu luy-même, ſe fût ſervi du Diable.	Qu'en cette embrasement tous ses plus grands amis, Furent enveloppez avec ses ennemis, Et que pour satisfaire à sa haine implacable, S'il n'eusse pu lui-même, se fût servi du Diable.
Eſt-ce tout?	Est-ce tout?
LouLouvois.	LouLouvais.
A peu prés, la fatale Atropos, Au milieu du Conſeil me prit mal à propos.	À peu prés, la fatale Atropos, Au milieu du Conseil me prit mal à propos.
J’avois avec les Czars ménagé des affaires, Qui avoient bon beſoin de beaucoup de miſteres, Seul, j’avois empêché que durant la Campagne, Ils fiſſent quelque choſe utile à l’Allemagne, Enfin ſi j’eus vêcu quatre mois davantage, J’alois aux Alliés tailler bien de l’ouvrage.	J'avais avec les Césars ménagé des affaires, Qui avaient bon besoin de beaucoup de misères, Seul, j'avais empêché que durant la Campagne, Ils fissent quelque chose utile à l'Allemagne, Enfin si j'eus vécu quatre mois davantage, J'allais aux Alliés tailler bien de l'ouvrage.
Europe.	Europe.
Ecrivez promptement que les Sieurs Moſcovites, Inſtiguez de Louvois, firent les hypocrites, E 6 Qu'aQu’avec nos ennemis même d'intelligence, Ils n’auroient jamais rien fait pour noſtre défenſe;	Écrivez promptement que les Sieurs Moscovites, Instigués de Louvais, firent les hypocrites, É 6 Qu'aQu'avec nos ennemis même d'intelligence, Ils n'auraient jamais rien fait pour notre défense;
Que tout leur attirail, leurs armes.	Que tout leur attirail, leurs armes.
leurs canons, N’étoient que fourberies, & des illuſions, As-tu fait?	leurs canons, N'étaient que fourberies, et des illusions, As-tu fait?
Louvois.	Louvais.
Ouy Madame.	Oui Madame.
2 L'Europe.	2 L'Europe.
Y a-t-il des ſupplices, Aſſez grands pour punir toutes cès injuſtices?	Y a-t-il des supplices, Assez grands pour punir toutes cès injustices?
Ennemy des mortels, violateur des Loix, Neron reſuſcité, déthrôneur de mes Roys, Ta memoire a jamais dans l’Hiſtoire execrable, Te fera deteſter & rendre abominable, Incendiaire affreux, chef de ces inhumains Qu’on vit courir par tout les flambeaux dans les mains;	Ennemi des mortels, violateur des Lois, Neron ressuscité, déthrôneur de mes Rois, Ta mémoire a jamais dans l'Histoire exécrable, Te fera détester et rendre abominable, Incendiaire affreux, chef de ces inhumains Qu'on vit courir par tout les flambeaux dans les mains;
Qu’on vit mettre le feu dans une paix profonde, Comme des enragés à la moitié du monde, Sçauroit-on meſurer ta condamnation, Qu’à la peine qu’on dit étre du talion ?	Qu'on vit mettre le feu dans une paix profonde, Comme des enragés à la moitié du monde, Saurait-on mesurer ta condamnation, Qu'à la peine qu'on dit être du talion ?
Ecoute ſcelerat ta propre conſcience, Dira ſi je prononce une injuſteſentence.	Écoute scélérat ta propre conscience, Dira si je prononce une injustesentence.
SEN	SEN
Nous Europe aſſemblée avec mes triſtes filles Qui ont veu ſaccager la plus-part de leurs villes, Seante en jugement pour ſelon la juſtice Abſoudre l’innocent & condamner le vice, Aprés avoir oüy les depoſitions, De mes filles lezées ſans contradictions, Les griefs impoſés au Marquis de Louvois, Par cy-devant Miniſtre & Tyran des François, Par où il eſt conſtant quin fut incendiaire, Sacrilege, parjure, & concuſſionnaire;	Nous Europe assemblée avec mes tristes filles Qui ont vu saccager la plus-part de leurs villes, Seante en jugement pour selon la justice Absoudre l'innocent et condamner le vice, Après avoir oui les dépositions, De mes filles lezées sans contradictions, Les griefs imposés au Marquis de Louvais, Par cy-devant Ministre et Tyran des Français, Par où il est constant quin fut incendiaire, Sacrilège, parjure, et concussionnaire;
Qu’avec les ennemis de la Religion, Il fit impunément une infame union, Que voulant abolir la Foy des Allemans, Il y voulut placer celle des Otthomans, Mettre dans mes états un pur Mahometiſme, Exiler les Chétiens & le Chriſtianiſme;	Qu'avec les ennemis de la Religion, Il fit impunément une infâme union, Que voulant abolir la Foi des Allemans, Il y voulut placer celle des Othomans, Mettre dans mes états un pur Mahométisme, Exiler les Chétiens et le Christianisme;
Qu’il voulut convertir mes Temples en Moſquées, Profaner en un mot les choſes plus ſacrées.	Qu'il voulut convertir mes Temples en Mosquées, Profaner en un mot les choses plus sacrées.
Ayant même avoüé dans ſes confeſſions, Qu’il avoit envoyé beaucoup de millions, Quantité de ſoldats aux Turcs nos ennemis, Brouillé tout l’univers avec ſon grand Louys.	Ayant même avoué dans ses confessions, Qu'il avait envoyé beaucoup de millions, Quantité de soldats aux Turcs nos ennemis, Brouillé tout l'univers avec son grand Louis.
Le tout bien averé, redigé par écrit.	Le tout bien averé, rédigé par écrit.
Nous Nous avons prononcé cet arrêt qui s’enſuit.	Nous Nous avons prononcé cet arrêt qui s'ensuit.
APRES tres-meurement avoir conſideré, Les crimes par Louvois commis & averez, Ne pouvant le punir aſſez ſeverement, Nous avons bien voulu choiſir un châtiment, Et tâché d’inventer des ſupplices conformes, A ſes impietés & ſes crimes enormes.	ÂPRES très -meurement avoir considéré, Les crimes par Louvais commis et avérez, Ne pouvant le punir assez sévèrement, Nous avons bien voulu choisir un châtiment, Et tâché d'inventer des supplices conformes, À ses impiétés et ses crimes énormes.
Pour avoir exilé comme un vray ſcelerat, Ses propres habitans hors du Palatinat, Il ſera exilé & banny à toûjours.	Pour avoir exilé comme un vrai scélérat, Ses propres habitants hors du Palatinat, Il sera exilé et banni à toujours.
De nos Champs-Elizées & de leurs beaux ſejours.	De nos Champs-Elizées et de leurs beaux séjours.
Comme pour amaſſer de l’argent  à foiſon, Il n’étoit pas content de la ſeule toiſon;	Comme pour amasser de l'argent à foison, Il n'était pas content de la seule toison;
Mais arrachoit les peaux de ſes pauvres brebis;	Mais arrachait les peaux de ses pauvres brebis;
On en fera de même avec le Sieur Marquis.	On en fera de même avec le Sieur Marquis.
Ecrivez nous voulons, & telle eſt la juſtice, Qu’on luy oſte la peau en grillant ſa chemiſe, Qu’on l’écorche tout vif & baigné dans ſon ſang, Qu’il ſoit vîte jetté au milieu de l’étang;	Écrivez nous voulons, et telle est la justice, Qu'on y ôte la peau en grillant sa chemise, Qu'on l'écorche tout vif et baigné dans son sang, Qu'il soit vite jeté au milieu de l'étang;
Où le ſoufre & le feu luy faſſe refſentir, Ce que luy-même fit à tant d’autres ſoufrir.	Où le souffre et le feu Seigneur fasse ressentir, Ce que tu-même fit à tant d'autres souffrir.
Il ſe pleut dans le feu & dedans le carnage, Que les flammes, les feux ſoient auſſi ſon partage, Qu’on nous garde ſa peau, nous voulons par arrêt, Que la moitié s’employe à en faire un ſoufflet.	Il se pleut dans le feu et dedans le carnage, Que les flammes, les feux soient aussi son partage, Qu'on nous garde sa peau, nous voulons par arrêt, Que la moitié s'emploie à en faire un soufflet.
Dont Dont on ſe ſervira à allumer les braiſes, Dans nos lieux ſoûterains & toutes nos fournaiſes;	Dont Dont on se servira à allumer les braises, Dans nos lieux souterains et toutes nos fournaises;
Dans le monde il ne fit qu’allumer des tiſons, Soufler à l'un & l'autre aveque ſes eſpions, Faire un feu ſi cuiſant, exciter tant d’orages, Qu’il n’y a pas un lieu exempt de ſes ravages.	Dans le monde il ne fit qu'allumer des tisons, Soufler à l'un et l'autre avèque ses épions, Faire un feu si cuisant, exciter tant d'orages, Qu'il n'y a pas un lieu exempt de ses ravages.
Enfin pour empêcher que dedans le Chaos, Je ne puiſſe jamais avoir aucun reOS;	Enfin pour empêcher que dedans le Chaos, Je ne puisse jamais avoir aucun reOS;
Nous avons ordonné & voulons à ce jour, Que de l’autre moitié on en faſſe un tambour, Qui touché ne fera qu’exciter des allarmes, Faire couler des pleurs, des ſouſpirs & des l’armes.	Nous avons ordonné et voulons à ce jour, Que de l'autre moitié on en fasse un tambour, Qui touché ne fera qu'exciter des alarmes, Faire couler des pleurs, des soupirs et des l'armes.
Tandis qu’il fut au monde, il n' eut plus de paix.	Tandis qu'il fut au monde, il n' eut plus de paix.
Plus Plus d’accords, plus d’amis, tout gemit ſous le faix De cent diviſions, d’une ſanglante guerre, Qui a tout ravagé & par mer & par terre;	Plus Plus d'accords, plus d'amis, tout gémit sous le faix De cent divisions, d'une sanglante guerre, Qui a tout ravagé et par mer et par terre;
On vit regner par tout la ſeule impieté, Plus de Loy, nulle Foy, enfin plus d’amitiẽ, Il en juſte je croy que ſi durant ſa vie Il haît le repos auſſi par ſympathie, Sa peau dans ces cachos faſſe un même exercice;	On vit régner par tout la seule impiété, Plus de Loi, nulle Foi, enfin plus d'amition, Il en juste je crois que si durant sa vie Il haît le repos aussi par sympathie, Sa peau dans ces cachos fasse un même exercice;
Que de ſon bruit affreux tout icy recentiſſe.	Que de son bruit affreux tout ici recentisse.
Telle eſt nôtre ſentence, & voulons promptement, Qu’on faſſe ſans tarder noſtre commandement.	Telle est notre sentence, et voulons promptement, Qu'on fasse sans tarder notre commandement.
Europe a ſes filles.	Europe a ses filles.
Pourrai-je me flatter que vous ſoiez contentes?	Pourrai-je me flatter que vous soyez contentes?
C1OU C 21	C1OU Ç 21
Ce juſte châtiment répond à nos attentes.	Ce juste châtiment répond à nos attentes.
Europe.	Europe.
Signez-la donc.	Signez-la donc.
Preſens, la France, l’Allemagne, La Hollande, l’Italie, l’Angleterre, l'Eſpagne.	Presens, la France, l'Allemagne, La Hollande, l'Italie, l'Angleterre, l'Espagne.
