A MONSEIGNEVR LE CARDINAL DE RICHELIEV.	À MONSEIGNEUR LE CARDINAL DE RICHELIEU.
te ſorte de plaiſirs ſemble eſtre plus legitime, & qu’il est vray que la grandeur de voſtre courage & de voſtre eſprit, occupe auiourd’huy la bouche de tous les hommes, à vous donner la gloire d’auoir mis la France en eſtat de ne craindre plus de Tragedies.	te sorte de plaisirs semble être plus légitime, et qu'il est vrai que la grandeur de votre courage et de votre esprit, occupe aujourd'hui la bouche de tous les hommes, à vous donner la gloire d'avoir mis la France en état de ne craindre plus de Tragédies.
Ce Poëme a receu la vie au temps que vous traüailliez à l’oſter à nos ennemis, & la parfaitte cognoiſſance que i’ay touſiours euë de vostre iugement, a fait que i’ay ſi peu douté du ſuccez de vos entrepriſes, que i'ay commencé de contribuer quelque choſe aux contentements qui deuoient ſuiure vos triomphes, lors meſmes que les autres ne faiſoient que les eſperer.	Ce Poème a reçu la vie au temps que vous trajailliez à l'ôter à nos ennemis, et la parfaite connaissance que j'ai toujours eue de votre jugement, a fait que j'ai si peu douté du succès de vos entreprises, que j'ai commencé de contribuer quelque chose aux contentements qui devaient suivre vos triomphes, lors mêmes que les autres ne faisaient que les espérer.
J’auouë, Monſeigneur, que le ſeul eſclat de voſtre fortune m'a iuſqu’icy deſtourné de vous conſacrer mes ouurages:	J'avoue, Monseigneur, que le seul éclat de votre fortune m'a jusqu'ici détourné de vous consacrer mes ouvrages:
vne certaine foumeur, qui pourtant ne s'accorde pas fort bien auecque l’eſtat où ie ſuis, m'a touſiours fait condamner ces eſprits laſches et mercenaires, qui meſlants vn ſale intereſt en toutes choſes, ſe laiſſent legerement emporter au vent de la faueur, & penſent que la vertu, comme la plus part des femmes du temps, ne peut paroiſtre que ſous l’eſclat des Diamants & des perles:	une certaine foumeur, qui pourtant ne s'accorde pas fort bien avec l'état où votre suis, m'a toujours fait condamner ces esprits lâches et mercenaires, qui meslants un sale intérêt en toutes choses, se laissent légèrement emporter au vent de la faveur, et pensent que la vertu, comme la plus part des femmes du temps, ne peut paraître que sous l'éclat des Diamants et des perles:
De ſorte, Monſeigneur, que ſi l'excez de voſtre merite ne ſe fuſt trouué ſans comparaiſon au deſſus de tous les biens qui ſeruent d’obiect à l’ambition des hommes, ie n'euſſe iamais rompu mon ſilence, de crainte de noircir ce peu que i’ay acquis d’eſtime dans le monde, par le blaſme que meritent les flatteurs & les impudents.	De sorte, Monseigneur, que si l'excès de votre mérite ne se fût trouvé sans comparaison au dessus de tous les biens qui servent d'objet à l'ambition des hommes, Seigneur n'eusse jamais rompu mon silence, de crainte de noircir ce peu que j'ai acquis d'estime dans le monde, par le blâme que méritent les flatteurs et les impudents.
Agreez donc, Monſeigneur, cette Paſtoralle que ie vous preſente, où mon eſprit s'eſt diuerti .	Agréez donc, Monseigneur, cette Pastorale que je vous présente, où mon esprit s'est diverti .
bien pluſtoſt pour delaſſer quelquefoi le voſtre, que pour croire meriter ia mais l’honneur d’eſtre cogneu de vous & trouuez bon, qu'en finiſſant ma lettre, ie vous faſſe rire de la rencontre d’vn Eſtranger, qui me demanda ſi vous eſtieZ vn Geant, m'ayant ouy dire que vous eſtiez le plus grand homme de noſtre ſiecle.	bien plutôt pour délasser quelque le vôtre, que pour croire mériter ia mais l'honneur d'être connu de vous et trouvez bon, qu'en finissant ma lettre, je vous fasse rire de la rencontre d'un Étranger, qui me demanda si vous étiez un Géant, m'ayant ouï dire que vous étiez le plus grand homme de notre siècle.
MONSEIGNEVR.	MONSEIGNEUR.
je ſuis	je suis
Voſtre tres-humble & tresobeïſſant ſeruiteur BARO.	Votre très-humble et tresobeïssant serviteur BARO.
12	12
AV LECTEVR.	AU LECTEUR.
VISQVE vne ſecrette fatalité, ordonne que toutes mes fautes ſoient publiques, & que bien loing de pouuoir cacher ce que ie fay, il ſemble qu’il ne me ſoit pas ſeulement permis de celer mes penſées;	VISQVE une secrète fatalité, ordonne que toutes mes fautes soient publiques, et que bien loin de pouvoir cacher ce que je fais, il semble qu'il ne me soit pas seulement permis de celer mes pensées;
ie te prie, cher Lecteur, de voir de bon œil ces Bergeries:	Les te prie, cher Lecteur, de voir de bon œil ces Bergeries:
que ſi tu ne iuges mon trauail digne de ton eſtime & de ta faueur, tu ſeras barbare ſi tu n’accordes l’vn & l’autre aux merites de celuy à qui ie l’ay conſacré.	que si tu ne juges mon travail digne de ton estime et de ta faveur, tu seras barbare si tu n'accordes l'un et l'autre aux mérites de celui à qui tu l'ai consacré.
Ce n’a pas eſté mon intention de rendre ſon nom immortel par mes Ouurages, tant de rares eſprits donnent leurs veilles à ce deſſein qu’en leur comparaiſon mſ foibleſſe luy - ---- .	Ce n'a pas été mon intention de rendre son nom immortel par mes Ouvrages, tant de rares esprits donnent leurs veilles à ce dessein qu'en leur comparaison mois faiblesse lui - -- .
1-– ſeroit deſaduantageuſe, & ne pourroit qu’accroiſtre ma honte, & diminuer l’eſclat de ſes grandes actions;	1-jour serait désavantageuse, et ne pourrait qu'accroître ma honte, et diminuer l'éclat de ses grandes actions;
mais ie veux que la Poſterité ſçache que i’ay veſcu dans le temps où ſes conſeils, & la valeur de mon Roy, ont rendu communs les Prodiges & les Miracles, & ont fait grauer iuſques dans le cœur de nos marbres des exploicts qui n’eurent iamais d’exemple, & que nos Neveux ne pourront lire ſans en eſtre rauis d’eſtonnement.	mais ie veux que la Postérité sache que j'ai vécu dans le temps où ses conseils, et la valeur de mon Roi, ont rendu communs les Prodiges et les Miracles, et ont fait graver jusques dans le cœur de nos marbres des exploits qui n'eurent jamais d'exemple, et que nos Neveux ne pourront lire sans en était ravis d'étonnement.
Ie ne doute point, cher Lecteur, que ſi tu lis attentiuement cette Paſtoralle, il ne te reſte apres cela quantité de choſes à deſirer;	Je ne doute point, cher Lecteur, que si tu lis attentivement cette Pastorale, il ne te reste après cela quantité de choses à désirer;
ie confeſſe que i’ay mis trop peu de temps à la polir, & bien que ie ſois aſſuré que pour en paſſier les defauts cette excuſe n’eſt pas aſſez pertinente, ie ſeray pourtant bien aiſe que tu les imputes pluſtoſt à mon peu de patience qu’à mon peu de iugement.	Les confesse que j'ai mis trop peu de temps à la polir, et bien que je sois assuré que pour en passier les défauts cette excuse n'est pas assez pertinente, ie serai pourtant bien aise que tu les imputes plutôt à mon peu de patience qu'à mon peu de jugement.
Mon premier deſſein eſtoit de prendre dans l’Aſtrée de Monſieur d'yrfe, l’hiſtoire de Celion & ------ - -- - de Bellinde:	Mon premier dessein était de prendre dans l'Astrée de Monsieur d'yrfe, l'histoire de Celion et -- -à -- - de -lynde:
mais la voulant accommoder au Theatre ie me ſuis veu comme forcé d’y ioindre tant de choſes, qu’enfin i’en ay voulu changer les noms, aymant bien mieux qu’on m’accuſe de luy auoir deſrobé quelques accidents, que d’a, uoir eu la vanité d’adiouſter quelque grace à ſes riches inuentions.	mais la voulant accommoder au Théâtre ainsi me suis vu comme forcé d'y joindre tant de choses, qu'enfin j'en ai voulu changer les noms, aimant bien mieux qu'on m'accuse de lui avoir dérobé quelques accidents, que d'a, uoir eu la vanité adiouster quelque grace ses riches inventions.
Au reſte ie t’aduertis que les pieces que tu verras de moy en ce genre d’eſcrire n’auront iamais d’Arguments, ie ne les trouue pas ſeulement inutiles, mais i’oſerois dire qu’on les deuroit abſolument condamner:	Au reste ici t'avertis que les pièces que tu verras de moi en ce genre d'écrire n'auront jamais d'Arguments, je ne les trouve pas seulement inutiles, mais j'oserais dire qu'on les devrait absolument condamner:
ma raiſon eſt, qu’on ne doibt pas traitter d’autre ſorte celuy qui lit, que celuy qui eſcoute.	ma raison est, qu'on ne doibt pas traiter d'autre sorte celui qui lit, que celui qui écoute.
Et iamais on n’a veu qu’au recit d’vn Poëme, on ait preoccupé les ſpectateurs par la cognoiſſance du ſuject;	Et jamais on n'a vu qu'au récit d'Han Poëme, on ait préoccupé les spectateurs par la connaissance du suject;
autrement, il ſeroit impoſſible qu’ils reſſentiſſent les paſſions qu’on leur veut inſpirer:	autrement, il serait impossible qu'ils ressentissent les passions qu'on leur veut inspirer:
& leur eſprit eſloigné de cette agreable ſuſpenſion où il doibt eſtre entretenu iuſqu’à la Cataſtrophe, ne demeureroit pas meſmes dans la - - ------- - ---- ------- ---- -- liberté de iuger du merite d’vn Ouurage, & ſi l’Autheur ſe ſeroit bien ou mal expliqué.	et leur esprit éloigné de cette agréable suspension où il doibt être entretenu jusqu'à la Catastrophe, ne demeurerait pas mêmes dans la -mêmes -elle --à - -- -- -- -- loi de g du merite n Ouurage, et si Autheur se seroit bien ou mal expliqué.
Ie ne pretends pas toutesfois, que mon ſentiment paſſe pour vne loy;	Je ne prétends pas toutefois, que mon sentiment passe pour une loi;
ie ſçay trop bien qu’il y-a de la difficulté à eſtouffer vne mauuaiſe habitude:	ie sçay trop bien qu'il y-a de la difficulté à étouffer une mauvaise habitude:
ie ſuis faſché ſeulement dequoy ceux qui ont eu la meſme penſée que i’ay, n’ont pas eu aſſez de reſolution pour la ſuiure, & ont mieux aimé ſe laiſſer emporter à la couſtume, que non pas à la raiſon.	Ne suis fâché seulement dequoy ceux qui ont eu la même pensée que j'ai, n'ont pas eu assez de résolution pour la suivre, et ont mieux aimé se laisser emporter à la coutume, que non pas à la raison.
Pour ce qui regarde les Chœurs, i’aduouë qu’encore qu’ils ne ſoient pas tout à fait neceſſaires, ils ſont extremement bien-ſeants:	Pour ce qui regarde les Chœurs, j'avoue qu'encore qu'ils ne soient pas tout à fait nécessaires, ils sont extrêmement bienséants:
& ie n’aurois pas oublié de donner cet ornement à ma Paſtoralle, ſi vne cauſe qui ne peut eſtre cogneuë que de moy, n’en auoit rendu l’impreſſion vn peu trop precipitée.	et petit n'aurais pas oublié de donner cet ornement à ma Pastorale, si une cause qui ne peut être connue que de moi, n'en avait rendue l'impression un peu trop précipitée.
Au pis aller ta bonté peut ſuppleer à ce manquement:	Au pis aller ta bonté peut suppléer à ce manquement:
& ma Cloriſe ſe pourra vanter de ne porter point d’enuie aux plus beaux Chœurs du monde, ſi tu me fais l’honneur de luy donner le tien.	et ma Clorise se pourra vanter de ne porter point d'envie aux plus beaux Chœurs du monde, si tu me fais l'honneur de Seigneur donner le tien.
Adieu.	Adieu.
12	12
Marialer an limge dierij.	Marialer an limge dierj.
AR grace & Priuilege de ſa Majeſté donné à Paris le 3.	AR grâce et Privilège de sa Majesté donné à Paris le 3.
iour de Septembre 1631.	jour de Septembre 1631.
Signé, Par le Roy en ſon Conſeil, Conrard, & ſeellé du grand Seau, il eſt permis à François Pomeray, marchand Libraire & Imprimeur à Paris, d’imprimer, vendre & diſtribuer vn Liure intitulé, LA CLORISE DV SIEVR BARO, PASTORALE, pendant le temps de ſix ans entiers, auec deffences à tous autres Libraires & Imprimeurs de l’imprimer, vendre ny en debiter d’autre impreſſion que de celle qu’r aura faict ou faict faire ledit Pomeray à peine de confiſcation des exemplaires contrefaicts & de quinze cens liures d’amende, deſpens, dommages & intereſts, voulant ſadite Majeſté qu’en mettant le preſent extraict au commencement ou à la fin dudit liure, il ſoit tenu pour deüemẽt ſignifié à tous qu’il appartiendra, ainſi qu’il eſt plus amplement porté par ledit Priuilege.	Signé, Par le Roi en son Conseil, Conrard, et seellé du grand Seau, il est permis à Français Pomerai, marchand Libraire et Imprimeur à Paris, d'imprimer, vendre et distribuer un Livre intitulé, LA LORISE DU SIEUR BARO, PASTORALE, pendant le temps de six ans entiers, avec défenses à tous autres Libraires et Imprimeurs de l'imprimer, vendre ni en débiter d'autre impression que de celle qu'r ou fait ou fait faire ledit Pomeray peine de rai des laires contrefaicts et de quinze cens liures a, dépens, dommages et ires, voulant sadite Majesté en mettant le présent extraict au commencement ou la fin dudit re, il soit tenu pour deüemẽt signifié tous il appartiendra, ainsi il est plus amplement porté par ledit Priuilege.
Acheué d’imprimer le dernier Nouembre mil ſix cens trente vn.	Achevé d'imprimer le dernier Novembre mille six cens un homme.
ACTEVRS.	ACTEURS.
PHEDON.	PHÉDON.
Pere de Cloriſe.	Père de Clorise.
NICANDRE.	NICANDRE.
Pere d’Eraſte.	Perce d'Éraste.
ERASTE.	ERASTE.
ALIDOR.	ÀLIDOR.
2 T PHILIDAN.	2 T HILIDAN.
Freres.	Frères.
LA RI.	LA RI.
LI OVS BARO	LI OUS BARO
ACTE PREMIER.	ACTE PREMIER.
SCENE PREMIERE.	SCÈNE PREMIÈRE.
PHEDON.	PHÉDON.
RII	RII
Le deſir des grandeurs rarement l’importune, Il tient comme en des fers ce Monſtre de fortune Dont l’inſtabilité par vn effort puiſſant Pour en eſleuer vn, en abbaiſſera cent.	Le désir des grandeurs rarement l'importune, Il tient comme en des fers ce Monstre de fortune Dont l'instabilité par un effort puissant Pour en élever un, en abaissera cent.
Tel depuis fort long temps ie vis dans ce Bocage, La guerre eut autrefois le plus beau de mon Mais auiourd’huy mõ bras, laßé de tãt de maux A peine l’entretient contre les Animaux.	Tel depuis fort long temps ie vis dans ce Bocage, La guerre eut autrefois le plus beau de mon Mais aujourd'hui mon bras, lassé de tendre de maux À peine l'entretient contre les Animaux.
Ie ne recherche icy ny treſor ny coronne, Tout ce dont i’ay beſoin la Terre me le donne;	Je ne recherche ici ici trésorgez coronne, Tout ce dont j'ai besoin la Terre me le donne;
Ce fertile Climat a pour moy des appas Que meſme pour regner ie ne quitterois pas, Et i’ayme mieux veiller ſur mes champs & mes vignes Que remporter ailleurs des victoires inſignes.	Ce fertile Climat a pour moi des appas Que même pour régner ie ne quitterais pas, Et j'aime mieux veiller sur mes champs et mes vignes Que remporter ailleurs des victoires insignes.
Or puiſque la ſaiſon m'appelle à ce trauail, Saiſon ou chaque fleur eſt couuerte d’eſmail, Saiſon, ou le Printemps au leuer de l’Aurore Conte tous les baiſers de Zephire & de Flore;	Or puisque la saison m'appelle à ce travail, Saison ou chaque fleur est couverte d'émail, Saison, ou le Printemps au lever de l'Aurore Conte tous les baisers de Zéphire et de Flore;
Ie vay voir ſi mon bled que la neige a couuert Deſchargé de ce faix, eſclatte d’vn beau vert.	Je vais voir si mon bled que la neige a couvert Deschargé de ce faix, éclatte d'H beau vert.
Außi bien le Soleil dans les lieux les plus ſombres Fait deſia recognoiſtre & les corps & les ombres.	Aussi bien le Soleil dans les lieux les plus sombres Fait déjà reconnaître et les corps et les ombres.
SCENE DEVXIESME.	SCÈNE DEUXIÈME.
PHEDON NICANDRE.	PHÉDON NICANDRE.
AIS quelqu’vn vient icy, c'eſt NiM candre,autrefois Eſleué comme moy dans la Cour de nos Rois, Et qui traitté du ſort auec ingratitude Vint chercher le repos en cette ſolitude:	AIS quelqu'un vient ici, c'est NiM candre,autrefois Élevé comme moi dans la Cour de nos Rois, Et qui traité du sort avec ingratitude Vint chercher le repos en cette solitude:
Quelque profond penſer occupe ſes esprits, N’y penſeZ plus, Nicandre?	Quelque profond penser occupe ses esprits, N'y panés plus, Nicandre?
NICANDRE.	NICANDRE.
Ah vous m’auez ſurpris:	Ah vous m'avez surpris:
PHEDON.	PHÉDON.
Vous me croyiez plus loing ne mentons point.	Vous me croyiez plus loing ne mentons point.
A ij	À ij
NICANDRE.	NICANDRE.
Ie meure, Ie vous croyois encor dedans voſtre demeure:	Je meure, Je vous croyais encor dedans votre demeure:
PHEDON.	PHÉDON.
Par ainſi loing du corps comme du ſouuenir	Par ainsi loing du corps comme du souvenir
NICANDRE.	NICANDRE.
Non iamais ce malheur ne ſçauroit auenir, Le deſtin qui retient nos ames enlaſſees Peut ſeparer nos corps & non pas nos penſees;	Non jamais ce malheur ne saurait avenir, Le destin qui retient nos âmes enlacées Peut séparer nos corps et non pas nos pensées;
Que ſi vous en douteZ, ie n’ay pour le preuuer Qu'à dire le ſuiet qui me faiſoit reſuer:	Que si vous en doutez, ici n'ai pour le preuver Qu'à dire le sujet qui me faisait rêver:
PHEDON.	PHÉDON.
Duuory puo quomduuquoouemue amenen bne, La ioye, ou la douleur, nous doibt eſtre commune.	Duori puo quomduuquoouemue amen bonne, La joie, ou la douleur, nous doibt être commune.
NICANDRE.	NICANDRE.
Vous ſçauez que deſlors qu’vn genereux effort Nous ſauua du naufrage & nous mit dãs ce port Mes deſirs, eſprouuants vne autre deſtinee, Se ſouſmirent aux loix d’vn heureux Hymenee;	Vous savez que délors qu'une généreux effort Nous sauva du naufrage et nous mit dans ce port Mes désirs, éprouvants une autre destinée, Se soumirent aux lois d'un heureux Hymène;
I'espouſay Clorenice, & neuf mois ſeulement Pouuoient auoir ſuiuy cét aymable moment,	J'épousai Clorénice, et neuf mois seulement Pouvaient avoir suiuy cet aimable moment,
Quand Eraſte naſquit, & que le Ciel proſpere Fit ceder tous mes maux au plaiſir d’eſtre Pere.	Quand Éraste nasquit, et que le Ciel prospère Fit céder tous mes maux au plaisir d'être Père.
Depuis ſi i’ay manqué ny d’amour ny de ſoings Pour eſleuer ce fils, les Dieux m’en ſont teſmoins, Ie l’ay tenu touſiours en eſtat de les craindre, Et certes cher Phedon i’aurois tort de m’en plaindre Son naturel facile à toutes mes humeurs N’a point encor failly contre les bonnes mœurs:	Depuis si j'ai manqué ni d'amour ni de soings Pour élever ce fils, les Dieux m'en sont témoins, Je l'ai tenu toujours en état de les craindre, Et certes cher Phédon j'aurais tort de m'en plaindre Son naturel facile à toutes mes humeurs N'a point encor failly contre les bonnes mœurs:
Mais ie crains l’aduenir, cette Ieuneſſe promte Ne ſçait pas diſtinguer l’honneur d’auec la hõte, Son eſprit aueuglé court aux contentements, Et ſans conſiderer l’importance d’vn crime, Quelque action qu’il faſſe il la croit legitime.	Mais ainsi crains l'avenir, cette Jeunesse promte Ne sait pas distinguer l'honneur d'avec la honte, Son esprit aveuglé court aux contentements, Et sans considérer l'importance d'un crime, Quelque action qu'il fasse il la croit légitime.
Or pour mieux l’obliger à faire ſon deuoir I'ay creu que le plus ſeur eſtoit de le pouruoir;	Or pour mieux l'obliger à faire son devoir J'ai cru que le plus sûr était de le pourvoir;
Et que pour arreſter les chaleurs de ſon âge La chaiſne la plus douce eſtoit le mariage:	Et que pour arrêter les chaleurs de son âge La chaîne la plus douce était le mariage:
Pour cela, ſi vos veux ſe conformoient aux miens, Eſtants eſgaux deſia de naiſſance & de biens, Nous pourrions, mariant mon fils à voſtre fille, Comme nos volonteZ vnir noſtre famille.	Pour cela, si vos veux se conformaient aux miens, Étant égaux déjà de naissance et de biens, Nous pourrions, mariant mon fils à votre fille, Comme nos volontés Hommes notre famille.
Voila ma reſuerie;	Voilà ma rêverie;
PHEDON.	PHÉDON.
Agreable vrayment:	Agréable vraiment:
Neceſſaire, l3 IeARo neut	Nécessaire, l3 JeARo neut
PHEDON.	PHÉDON.
Adiouſtez à mon contentement.	Ajoutez à mon contentement.
NLCANDRE.	NLCANDRE.
Quoy vous y conſentez	Quoi vous y consentez
PHEDON, Ony ui toute mon ame;	PHÉDON, Oni ui toute mon âme;
NICANDRE.	NICANDRE.
Eraſte n’aura donc que Cloriſe pour femme	Erâte n'aura donc que Clorise pour femme
PHEDON.	PHÉDON.
Et reciproquement ie iure comme vous Que Cloriſe n’aura qu'Eraſte pour eſpoux, Trop heureuſe, de voir ſes volontez captiues Sous la foy d’vn Berger le plus beau de nos riues.	Et réciproquement ierouvre comme vous Que Clorise n'aura qu'Eraste pour époux, Trop heureuse, de voir ses volontés captives Sous la foi d'un Berger le plus beau de nos rives.
Mais ne differons point, quand le Soleil haußé Marquera que le iour eſt à moitié paßé Ie reuiendray cheZ moy, penſeZ à vous y rendre:	Mais ne différons point, quand le Soleil haussé Marquera que le jour est à moitié passé Je reviendrai chez moi, pensez à vous y rendre:
NICARDRE.	NICARDRE.
Ie n’y manqueray pas,	Je n'y manquerai pas,
THEDON.	THÉDON.
Iuſqu’aureuoir, Nicandre.	Jusqu'aurevoir, Nicandre.
NICANDRE.	NICANDRE.
Me voila ſatisfait, Grand Dieu qui dans tes mains Tournes comme il te plaiſt le deſtin des humains Que d’extremes faueurs ta bonté me teſmoigne:	Me voilà satisfait, Grand Dieu qui dans tes mains Tournes comme il te plaît le destin des humains Que d'extrêmes faveurs ta bonté me témoigne:
Mais ut faut empefener qu'Eraſte ne s’eſloigne.	Mais ut faut empefener qu'Éraste ne s'éloigne.
Mon fils?	Mon fils?
Eraſte?	Eraste?
vn mot.	un mot.
A iiij	À jijà
SCENE TROISIESME, ERMIEJ RIGARDICEC	SCÈNE -TROISIÈME, ERMIE RIGARDICEC
ERASTE.	ERASTE.
Vous voila de retour	Vous voilà de retour
NICANDRE.	NICANDRE.
Comme vn Aſtre qui vient t’annoncer vn beau tour Ijau pe deſormais aux plaiſirs tu t'appreſtes;	Comme un Astre qui vient t'annoncer un beau tour Ijau pe désormais aux plaisirs tu t'apprêtes;
La cauſe?	La cause?
ERASTE.	ERASTE.
NICANDRE.	NICANDRE.
Vn bon ſucces,	Un bon succès,
ERASTE.	ERASTE.
Et lequel?	Et lequel?
TTIANDRE.	TTIANDRE.
Tu m'arreſtes Va ne m’entretiens point de diſcours ſuperflus, Enuiron le Midy tu ſcauras le ſurplus	Tu m'arrêtes Va ne m'entretiens point de discours superflus, Environ le Midi tu sauras le surplus
ERASTE.	ERASTE.
Ie ne ſçaurois dans l'exces de ſa ioye Lire quel eſt ce bien que le Ciel nous enuoye I'en demeure confus, & voy que mes esprits Sont de cette nouuelle infiniment ſurpris.	Je ne saurais dans l'excès de sa joie Lire quel est ce bien que le Ciel nous envoie J'en demeure confus, et vois que mes esprits Sont de cette nouvelle infiniment surpris.
Qu'importe d’y reſuer, ſon amour non cõmune N’a iamais respiré que ma bonne fortune, Et ie dois preſumer qu'en ce dernier project Il n'arien que ſa gloire & mon bien pour obiect.	Qu'importe d'y rêver, son amour non commune N'a jamais respiré que ma bonne fortune, Et ie dois présumer qu'en ce dernier project Il n'arien que sa gloire et mon bien pour objet.
Peut eſtre' qu'Alidor ſçaura ce qui ſe paſſe Mais de m'en enquerir i’aurois mauuaiſe grace Il eſt triste, & c'eſt mal ſcauoir prẽdre ſon temps Que de parler de rire auec les meſcontents.	Peut être qu'Alidor sçaura ce qui se passe Mais de m'en enquérir j'aurais mauvaise grâce Il est triste, et c'est mal savoir prendre son temps Que de parler de rire auec les mécontents.
SCENE QUATRIESME.	SCÈNE QUATRIÈME.
ALIDOR & THILIDAN, Ieres.	ÀLIDOR et THILIDAN, Jères.
ALIDOR.	ÀLIDOR.
Idelle confident de toutes mes penſees I Qui ſçais mes maux preſents & mes peines paſſees, Toy qui dans mon eſtime obtiens le premier rang Mieux frere d’amitié que tu ne l’es de ſang;	Idelle confident de toutes mes pensées I Qui sais mes maux présents et mes peines passées, Toi qui dans mon estime obtiens le premier rang Mieux frère d'amitié que tu ne l'es de sang;
Regarde à quel deſtin mon ame eſt aſſeruie, Combien auec regret ie respire la vie, Depuis que cet obiect, le chef d’œuure des Cieux Par vn arreſt fatal m’a banni de ſes yeux.	Regarde à quel destin mon âme est asservie, Combien avec regretaires respire la vie, Depuis que cet objet, le chef d'œuvre des Cieux Par un arrêt fatal m'a banni de ses yeux.
Il eſt vray i’ay failli luy diſant que ie l’ayme, Ie deuois mieux cacher ma paßion extreme, Mais en cet accident qui me rend malheureux Pouuois-ie eſtre bien ſage eſtant bien amoureux:	Il est vrai j'ai failli luy disant que sans l'aime, Je devais mieux cacher ma passion extrême, Mais en cet accident qui me rend malheureux Pouvais-je être bien sage étant bien amoureux:
Tu deuois, ô Cloriſe, ô fille inexorable, Pour eſtre moins aymee eſtre vn peu moins aymable, Et ne t’offenſer pas de ma temerité Puiſque ſi i’ay failly c’eſt par neceßité;	Tu devais, ô Clorise, ô fille inexorable, Pour été moins aimée être peu moins aimable, Et ne t'offenser pas de ma témérité Puisque si j'ai failly c'est par necessité;
I’ay failly par deuoir ton merite en eſt cauſe Ie ne puis m'exempter de la loy qu’il m'impoſe Et qui ſgaurd ma faute & mon matinſint Blaſmera ta raiſon de m'auoir trop puni.	J'ai failly par devoir ton mérite en est cause Je ne puis m'exempter de la loi qu'il m'impose Et qui ségaurd ma faute et mon matinste Blasmera ta raison de m'avoir trop puni.
PHILIDAN.	PHILIDAN.
A ce conte ie voy que pour mieux eſtre freres Le Ciel confond en nous le ſang & les miſeres Vous ſçaueZ qu’Eliãte a pour moy des meſpris Capables d’esbranler les plus fermes esprits.	À ce conte ie vois que pour mieux avoir frères Le Ciel confond en nous le sang et les misères Vous savez qu'Eliãte a pour moi des mépris Capables d'ébranler les plus fermes esprits.
Ie fay ce que ie puis pour forcer l’iniuſtice Dont l’ingratte auiourd’huy cõſpire mõ ſupplice, Mais bien loin de pouuoir ſoulager ma lãgueur Chaque moment accroiſt mõ mal & ſa rigueur.	Je fais ce que je puis pour forcer l'injustice Dont l'ingratte aujourd'hui conspire mon supplice, Mais bien loin de pouvoir soulager ma langueur Chaque moment accroît mon mal et sa rigueur.
Cettenje fes uiejauns, car il eſt impoßible Que pour quelqu'autre obiet elle ne ſoit ſenſible, Et ſi mon iugement ne m'a point abusé Vous faittes dela peine à cet espritrusé.	Certenje fes uiejauns, car il est impossible Que pour quelque autre objet elle ne soit sensible, Et si mon jugement ne m'a point abusé Vous faites déla peine à cet espritrusé.
Moy?	Moi?
ALIDOR.	ÀLIDOR.
PHILIDAN.	PHILIDAN.
Vous meſme	Vous -même
MLIBCR.	MLIBCR.
Et comment?	Et comment?
PHILIDAN.	PHILIDAN.
Ie ne le ſçaurois dire Il ſuffit qu'a tous coups ie la voy qui ſouſpire Et que touſiours ſes yeux ſont arreſtez ſur vous.	Je ne le saurais dire Il suffit qu'a tous coups il la vois qui soupire Et que toujours ses yeux sont arrêtés sur vous.
ALIDOR.	ÀLIDOR.
On ne peut eſtre Amant ſans eſtre vn peuialoux.	On ne peut être Amant sans être un peuialoux.
PHILIDAN.	PHILIDAN.
Iamais cette fureur ne regna dans mon ame, Mais ſi pour moy Cloriſe auoit autant de flame, Il faudroit, pour nous rendre heureux en meſme iour 11 Changer elles d’Amants ou nous autres d’amour.	Jamais cette fureur ne régna dans mon âme, Mais si pour moi Clorise avait autant de flamme, Il faudrait, pour nous rendre heureux en même jour 11 Changer elles d'Amants ou nous autres d'amour.
ALIDOR.	ÀLIDOR.
Que nous perdons de tẽps en ces diſcours friuoles Le vent, auec la poudre emporte nos paroles,	Que nous perdons de temps en ces discours frivoles Le vent, avec la poudre emporte nos paroles,
Cherchons quelque moyen plus propre à nous guerir Tu peux par ton ſecours m'empeſcher de perir, Ce papier glorieux d’aller voir tãt de chârmes Eſt le meſme ou i’ay peint mes feux auec des titeles larmes C’eſt icy qu’en faueur de ce diuin obiect Deux contraires ſont veus en vn meſme ſuiect.	Cherchons quelque moyen plus propre à nous guérir Tu peux par ton secours m'empêcher de périr, Ce papier glorieux d'aller voir tendre de châtrmes Est le même ou j'ai peint mes feux avec des titeles larmes C'est ici qu'en faveur de ce divin objet Deux contraires sont vus en un autre sujet.
Effect prodigieux, miracle qui deriue De la beauté qui tient ma liberté captiue, Charge toy de le rendre vſe de ton pouuoir Et fay que ſa pitié le daigne receuoir:	Effet prodigieux, miracle qui derive De la beauté qui tient ma liberté captive, Charge toi de le rendre vuse de ton pouvoir Et fais que sa pitié le daigne recevoir:
Dy luy, cher Philidan, qu’au milieu de mes geines Ie plains encore mieux ſon peché que mes peines, Que les Dieux dont le bras vange les innocents La puniront vn iour des douleurs que ie ſens, Que pour moy ſes rigueurs ne sõt plus legitimes, Et qu'en fin, quand i’aurois le cœur tout noir de crimes I'en ſerois trop puny d’auoir pu ſeulement Viure loin de ſes yeux l’espace d’vn moment.	Dis -moi, cher Philieu, qu'au milieu de mes geines Je plains encore mieux son péché que mes peines, Que les Dieux dont le bras venge les innocents La puniront un jour des douleurs que je sens, Que pour moi ses rigueurs ne sont plus légitimes, Et qu'en fin, quand j'aurais le cœur tout noir de crimes J'en serais trop puni d'avoir pu seulement Vivre loin de ses yeux l'espace d'un moment.
PHILIDAN.	PHILIDAN.
C eſt aſſez eſpargneZ ma memoire	Ç est assez épargnez ma mémoire
ALIDOR.	ÀLIDOR.
qjun fera toute magloire.	Oqjun fera toute magloire.
Va	Va
a fleloan I'y vay de ce pas,	a fléloan J'y vay de ce pas,
ALIDOR.	ÀLIDOR.
Haſte toy, mais reuien M’annoncer promptement ou mon mal ou mon bien, Ces arbres que l’hyuer deſpoüilla de verdure Et qui ſemblent renaiſtre auecque la Nature Me preſteront leur ombre afin de repoſer dan s’en Attendant ton retour.	Hâte toi, mais revien M'annoncer promptement ou mon mal ou mon bien, Ces arbres que l'hiver dépouilla de verdure Et qui semblent renaître auecque la Nature Me prêteront leur ombre afin de reposer an s'en Attendant ton retour.
* Ie me ſens dispoſer penfart A gouſter le ſommeil, car de trois nuits entieres lettredis Ce pere du repos n’a fermé mes paupieres Si Cloriſe me doit traitter en criminel Infiets.	* Je me sens disposer penfart A goûter le sommeil, car de trois nuits entières lettredis Ce père du repos n'a fermé mes paupières Si Clorise me doit traiter en criminel Infiets.
Dieux faittes moy dormir d’vn ſommeil eternel.	Dieux faites -moi dormir d'un sommeil éternel.
LAISME,	LAISME,
ELIANTE.	ÉLIANTE.
Y penſons plus mon ame il eſt temps que IV ie taſche De chercher vn remede à ce mal qui me faſche, Et que pour mieux forcer ma premiere priſon Ie recoure aux conſeils que donne la raiſon.	Y pensons plus mon âme il est temps que IV ie tâche De chercher un remède à ce mal qui me fâche, Et que pour mieux forcer ma première prison Je recoure aux conseils que donne la raison.
Ne le reuoyons plus, peut eſtre que l’abſence Eſtouffera ma flame au point de ſa naiſſance Et qu’ayant dans mon cœur ſon Empire eſtably Au lieu de tant d’amour ell' y mettra l’oubly:	Ne le revoyons plus, peut être que l'absence Étouffera ma flamme au point de sa naissance Et qu'ayant dans mon cœur son Empire établi Au lieu de tant d'amour ell' a mettra l'oubli:
Außi bien tous les traits que mon œil luy deſcoche, Semblent de petits vents qui baiſent vne Roche, Et iamais il ne prend que pour ciuilité Les preuues qu’il reçoit de ma fidelité.	Aussi bien tous les traits que mon œil lui décoche, Semblent de petits vents qui baisent une Roche, Et jamais il ne prend que pour civilité Les preuves qu'il reçoit de ma fidélité.
Mille fois mes penſers ont remis à ma bouche Le ſoing de luy parler du tourment qui me touche,	Mille fois mes pensers ont remis à ma bouche Le soing de lui parler du tourment qui me touche,
Mais ce traiſtre respect tyran pernicieux A mille fois remis cét office à mes yeux, De ſorte qu’impuiſſante à luy mõtrer ma flame Il me fuyt l’inſenſible & moy ie le reclame.	Mais ce traître respect tyran pernicieux À mille fois remis cet office à mes yeux, De sorte qu'impuissante à lui Notrer ma flamme Il me fût l'insensible et mo ie le réclame.
Alidor aueugle n’aymeras-tu iamais?	Alidor aveugle n'aimeras-tu jamais?
Prends exemple à ce cœur qu’en tes mains ie remets Et donne moy l’honneur de te pouuoir ſouſmettre.	Prends exemple à ce cœur qu'en tes mains ie remets Et donne moi l'honneur de te pouvoir sousmettre.
Mais le hazard preſente à mes yeux vne lettre, Quelque Berger ſans doute außi bleßé que moy Aura de peint icy ſon martyre & ſa foy;	Mais le hasard présente à mes yeux une lettre, Quelque Berger sans doute aussi blessé que moi Aura de peint ici son martyre et sa foi;
Curieuſe aſſouuy le deſir qui t'emporte Mais tout mõ ſang s’eſmeut, ma main tremble, il n’importe Ouurons-le;	Curieuse assouvi le désir qui t'emporte Mais tout mon sang s'émut, ma main tremble, il n'importe Ouvrons-le;
toutesfois ce deſſein indiſcret Offenſe les reſpects que l’on doibt au ſecret, C'eſt tout vn acheuons de plaire à mon enuie onurei.	toutefois ce dessein indiscret Offense les respects que l'on doibt au secret, C'est tout un achevons de plaire à mon envie onurei.
Couppons* quand ce ſeroit le filet de ma vie.	Coupons* quand ce serait le filet de ma vie.
LETTRE	LETTRE
ACTE PREMIER.	ACTE PREMIER.
LETTRE d’Alidor à Cloriſe.	LETTRE d'Alidor à Clorise.
LORISE il eſt temps que ton cœur OS’appreſte à me rendre Iuſtice, Et qu’il accepte mon ſeruice, Malgré l’effort de ſa rigueur:	LORISE il est temps que ton cœur OS'apprête à me rendre Justice, Et qu'il accepte mon service, Malgré l'effort de sa rigueur:
Conſidere, belle inhumaine, Que la naiſſance de ta hayne M’arendu l’horreur de nos bois;	Considère, belle inhumaine, Que la naissance de ta haine M'arendu l'horreur de nos bois;
Que mes cris ſont toutes mes armes, Et que iay noyé mille fois Mon offenſe dedans mes larmes.	Que mes cris sont toutes mes armes, Et que noyé mille fois Mon offense dedans mes larmes.
Toutefois, aymable beauté, Si ta rigueur n’eſt aſſouuie Et ſi la perte de ma vie Doit contenter ta cruauté;	Toutefois, aimable beauté, Si ta rigueur n'est assouuie Et si la perte de ma vie Doit contenter ta cruauté;
Ie ſuis preſt, ie n’attends que l’heure Dy comme tu veux que ie meure Ie iure que ie le feray:	Je suis prêt, Madame n'attends que l'heure Dis comme tu veux que personne meure Je jure que ie le ferai:
Ce qui te plaiſt m'eſt agreable, Mais ſouuiens toy que ie mourray En Amant, non pas en coupable.	Ce qui te plaît m'est agréable, Mais souviens toi que tu mourrai En Amant, non pas en coupable.
Alidor.	Alidor.
C’eſt luymeſme.	C'est luymesme.
Ah cruelc'eſt aſſez Ie cognois le ſuiect de tes mespris paſſez A tort ie t’ay nommé tant de fois inſenſible, Ton cœur eſt allumé d’vne flame viſible, Tu bruſles pour Cloriſe, & ſes yeux m’ont oſté L’honneur d’aſſuiettir ton courage indompté.	Ah cruelc'est assez Je connais le sujet de té mépris passez A us ie t'ai nommé tant de fois insensible, Ton cœur est allumé d'une flamme visible, Tu brûles pour Clorise, et ses yeux m'ont ôté L'honneur d'assuiettir ton courage indompté.
Mais d’ou vient que ces ſoings broüillent ma fantaiſie?	Mais d'ou vient que ces soings brouillent ma fantaisie?
Faut-il à mon amour ioindre la ialouſie?	Faut-il à mon amour joindre la jalousie?
Dieux!	Dieux!
il n’eſt que trop vray, ie ne le puis celer;	il n'est que trop vrai, je ne le puis celer;
Ie ſens cette fureur qui me vient bourreler, Elle eſchauffe mon ſang, ſon iniure me preſſe:	Je sens cette fureur qui me vient bourreler, Elle échauffe mon sang, son injure me presse:
Quoy!	Quoi!
ie ſuis ſon eſclaue vne ttre cje ſa maiſtreſſe, Et pour ſouffrir en l’ame vn affront plus mortel Ie ſuis donc ſa victime, vne autre eſt ſon Autel?	On suis son esclave une ttre cje sa maîtresse, Et pour souffrir en l'âme un affront plus mortel Je suis donc sa victime, une autre est son Autel?
Eſtranges loix du ſort, qui voulez que i’expire Deſſous le ioug peſant d’vn ſi faſcheux Empire, Ay-ie offenſe le ciel?	Étranges lois du sort, qui voulez que j'expire Dessous le joug pesant d'un si fâcheux Empire, Ai-je offense le ciel?
quel crime ay ie commis Pour auoir Alidor & les Dieux ennemis?	quel crime a ie promis Pour avoir Alidor et les Dieux ennemis?
Ah laiſſez moy ſortir de ce honteux ſeruage, Donnez-m'en le pouuoir, car i’en ay le courage;	Ah laissez moi sortir de ce honteux servage, Donnez-m'en le pouvoir, car j'en ai le courage;
Oſe donc Eliante & penſe pour le moins A faire que ton mal n’ait iamais de teſmoins* vEn Mais n'apperçois-ie pas vn Berger qui ſom-Aid meille?	Ose donc Éliante et pense pour le moins À faire que ton mal n'ait jamais de témoins* vEn Mais n'apperçois-je pas un Berger qui som-Aid meille?
C’eſt Alidorluy meſme, ah Dieux!	C'est Alidorlui même, ah Dieux!
quelle merueille, Cette grande beauté montre bien qu’on a tort De nommer le ſommeil l’image de la mort.	quelle merveille, Cette grande beauté montre bien qu'on a tort De nommer le sommeil l'image de la mort.
Courage vãgeons nous eſueillons le, ah craintiue Pourquoy luy laiſſes-tu le bien dont il te priue?	Courage vengeons nous éveillons le, ah crainive Pourquoi était laisses-tu le bien dont il te prive?
Berger à mon dommage vn peu trop amoureux Puiſque tu dors ſi bien tu n'es pas malheureux, Ton repos à ce coup dement ton eſcriture.	Berger à mon dommage un peu trop amoureux Puisque tu dors si bien tu n'es pas malheureux, Ton repos à ce coup dément ton écriture.
Son ſilence eſt commun à toute la Nature, Ie n’entends aucun bruit, le Roßig nol caché Penſe que le Soleil estencore couché, Et dans tout le ſeiour de cette ſolitude Mon esprit ſeulement a de l’inquietude, Ah Berger!	Son silence est commun à toute la Nature, Je n'entends aucun bruit, le Roglig ol caché Pense que le Soleil estencore couché, Et dans tout le séjour de cette solitude Mon esprit seulement a de l'inquiétude, Ah Berger!
il s'eſueille	il s'éveille
ALIDOR.	ÀLIDOR.
Helas qui te retient Cher frere, & quel ſuiet loin de moy t’entretient.	Hélas qui te retient Cher frère, et quel sujet loin de moi t'entretient.
N'es-tu pas de retour?	N'es-tu pas de retour?
ELIANTE.	ÉLIANTE.
Ouy	Oui
ALIDOR.	ÀLIDOR.
Que dit ma Bergere?	Que dit ma Bergère?
ELIANTE.	ÉLIANTE.
Ce cœur eſt tout à vous	Ce cœur est tout à vous
ALIDOR.	ÀLIDOR.
Ta bouche menſongere Me flatte en ce diſcours allegué fauſſement, N’importe tu m'auras trompé bien doucement	Ta bouche mensongère Me flatte en ce discours allégué faussement, N'importe tu m'auras trompé bien doucement
ELIANTE.	ÉLIANTE.
Il eſt temps de ſortir de cette reſuerie,	Il est temps de sortir de cette rêverie,
ALIDOR.	ÀLIDOR.
Non ſa douceur me plaiſt, parle encor ie te prie Et ne t’offenſe pas ſi ie n’ouure mes yeux I'ay peur de te chaſſer Demon fallacieux:	Non sa douceur me plaît, parle encor ie te prie Et ne t'offense pas si apprendre n'ouvre mes yeux J'ai peur de te chasser Démon fallacieux:
At-elle veu ma lettre?	At-elle vu ma lettre?
ELIANTE.	ÉLIANTE.
Elle la baiſe encore Mais elle ſent depuis vn feu qui ladeuore,	Elle la baise encore Mais elle sent depuis un feu qui ladévore,
De colere?	De colère?
ALADOR.	ÀLADOR.
ELIANTE.	ÉLIANTE.
d’Amour	d'Amour
ALIDOR.	ÀLIDOR.
Tu te mocques de moy Ahc'eſt trop me flatter Demon retire toy.	Tu te moques de moi Ahc'est trop me flatter Démon retire toi.
ELIANTE.	ÉLIANTE.
Il ſe r’endort, helas que i’ay peu de courage Qu'vne fille ſçait mal prendre ſon aduantage, Et qu’il eſt malaisé d’offencer la vertu:	Il se rendort, hélas que j'ai peu de courage Qu'une fille sait mal prendre son avantage, Et qu'il est malaisé d'offenser la vertu:
Mais il releue en fin ſon esprit abbatu Fuiray-ie?	Mais il relève en fin son esprit abattu Fuirai-je?
nullement attendons qu’il nous voye.	nullement attendons qu'il nous voit.
ALIDOR.	ÀLIDOR.
Te voyla diſparu faux obiect de ma ioye B iij Au point de mon reſueil tu t’es perdu trompeur Comme au ſoleil ſe perd vne foible vapeur.	Te voilà disparu faux objet de ma joie B ij Au point de mon réveil tu t'es perdu trompeur Comme au soleil se perd ait faible vapeur.
Que Philidan est long, mais ie vois Eliante Qui s'approche de moy	Que Philidan est long, mais ainsi vois Éliante Qui s'approche de moi
ELIANTE.	ÉLIANTE.
Berger Pan te contente Ie ne demande pas quel eſt ton entretien Car it jody qa vn esprirpteſse comme tetien N'a d’obiect plus preſent que celui de ſes peines.	Berger Pan te contente Je ne demande pas quel est ton entretien Car it jodi qa un éprirptesse comme tetien N'a d'objet plus présent que celui de ses peines.
ALIDOR.	ÀLIDOR.
Mon frere me l’apprend eſclaue dans vos u Priſonnier miſerable à qui voſtre pitié Deuroit auoir montré quelques traits d’amitié.	Mon frère me l'apprend esclave dans vos Prisonnier misérable qui vôtre pitié Deuroit auoir montré quelques traits amitié.
ELIANTE.	ÉLIANTE.
Si i’ay mal recogneu ſa longue ſeruitude Tu n'es pas accusé de moindre ingratitude;	Si j'ai mal reconnu sa longue servitude Tu n'es pas accusé de moindre ingratitude;
Vne ieune beauté que i’ayme comme moy M'a faict depuis deux iours quelques plaintes de toy.	Une jeune beauté que j'aime comme moi M'a fait depuis deux jours quelques plaintes de toi.
Lacauſe?	Lacause?
ALIDOR.	ÀLIDOR.
ELIANTE.	ÉLIANTE.
Ta ſrotdeur.	Ta srotdeur.
ALIDOR.	ÀLIDOR.
Qu'elle me la pardonne Mon ama iuſqu’icy n’a bruſlé pour perſonne.	Qu'elle me la pardonne Mon ama jusqu'ici n'a brûlé pour personne.
Dſairaei n Dißimulé menteur	Dsairaéi ni Dissimulé menteur
ALIDOR.	ÀLIDOR.
Se peut elle nommer?	Se peut -elle nommer?
ELIANTE.	ÉLIANTE.
Ouy ſi tu me promets	Oui si tu me promets
ALIDOR.	ÀLIDOR.
17	17
ELIANTE.	ÉLIANTE.
De la bien aymer.	De la bien aimer.
tout	tout
ALIDOR.	ÀLIDOR.
Puiſque de l’auenir ie ne ſuis pas le maiſtre Quand ie l’aurois promis i’y manquerois peus eſtre.	Puisque de l'avenir ici ne suis pas le maître Quand Je l'aurais promis j'y manquerais peus être.
ELIANTE.	ÉLIANTE.
Ie veux ſuſpendre vn peu ton eſprit curieux, Taſche de la cognoistre, à ma mine, à mes yeux.	Je veux suspendre un peu ton esprit curieux, Tâche de la connaître, à ma mine, à mes yeux.
B.	B.
iiij	jijà
ALIDOR.	ÀLIDOR.
Ce port ne m’aprend rien ſinon que ſa ſtructure Eſt vn des beaux effets qu’ait produits la nature Et dans ces yeux, Amour regne comme vnvainqueur	Ce port ne m'apprend rien sinon que sa structure Est un des beaux effets qu'ait produits la nature Et dans ces yeux, Amour règne comme vnvainqueur
ELIANTE.	ÉLIANTE.
Il en deuroit ſortir pour entrer dans ton cœur.	Il en devrait sortir pour entrer dans ton cœur.
ALIDOR.	ÀLIDOR.
Bergere vne autre fois i’en ſçauray dauantage Le ſoing de mon trouppeau me r’appelle au village.	Bergère était autre fois j'en saurai davantage Le soing de mon troupeau me rappelle au village.
ELIANTE.	ÉLIANTE.
Alidor ie te prie arreſte vn ſeul moment, Mon mal-heur eſt eſgal a ton aueuglement Veux tu ſçauoir ſon nom?	Alidor ie te prie arrête un seul moment, Mon malheur est égal à ton aveuglement Veux tu savoir son nom?
helas!	hélas!
c’eſt Eliante Nomme moy ſi tu veux criminelle inſolente I'ay failly, quoy berger tu ſembles tout ſurpris Ton ſilence profond parle de ton mespris Mais ſi tacruauté ſe laſſe de ma vie Ordonne moy la mort:	c'est Éliante Nomme moi si tu veux criminelle insolente J'ai failly, quoi berger tu sembles tout surpris Ton silence profond parle de ton mépris Mais si tacruauté se lasse de ma vie Ordonne moi la mort:
ALIDOR.	ÀLIDOR.
Ce n'est pas mon enuie Mais ie ſens vn regret qui m'afflige au mourir, C’eſt dequoy ie vous bleſſe & ne vous puis guerir.	Ce n'est pas mon envie Mais je sens un regret qui m'afflige au mourir, C'est de quoi vous blesse et ne vous puis guérir.
ELIANTE.	ÉLIANTE.
Cruel quelle raiſon peut produire tes glaces Manquay-ie de beauté de merite ou de graces?	Cruel quelle raison peut produire tes glaces Manquai-je de beauté de mérite ou de grâces?
ALIDOR.	ÀLIDOR.
Nvon, mala i'dy fait vn vœu den'aymer iamais rien,	Névon, mala j'y fait un vœu d'aimer jamais rien,
ELIANTE Foible excuſe, l’Amour t'en diſpenſeroit bien	ELIANTE Foible excuse, l'Amour t'en dispenserait bien
ALIDOR.	ÀLIDOR.
Ie tiens mâuoum puueners ſu inEmpire,	Je tiens masuoum puveners su inEmpire,
ELIANTE.	ÉLIANTE.
Ie ſpay pourtant l'obiect ou ton deſiraſpire,	Je sais pourtant l'objet ou ton désiraspire,
ALIDOR.	ÀLIDOR.
Ie vous iure que non	Je vous jure que non
ELIANTE.	ÉLIANTE.
Ly ces vers inhumain Et ne dements iamais ta flame ny ta main	Li ces vers inhumain Et ne déments jamais ta flamme ni ta main
ALIDOR.	ÀLIDOR.
Dieux qui m'aura trahy voyla mon eſcriture,	Dieux qui m'aura trahi voilà mon écriture,
ELIANTE.	ÉLIANTE.
Et bien n'ay-ie pas droit de te nommer pariure?	Et bien n'ai-je pas droit de te nommer parjure?
ALIDOR.	ÀLIDOR.
PardonneZ mon ſilence à ma diſcretion.	Pardonnez mon silence à ma discrétion.
ELIANTE.	ÉLIANTE.
Mais toy, Berger, pardonne à mon affection Et ſi quelque pitié dans ton cœur trouue place Sois comme la ſaiſon incapable de glace, Deſiſte de pourſuiure vne ingratte qui fuit Et prends part aux douleurs de celle qui te ſuit Change change d’amour	Mais toi, Berger, pardonne à mon affection Et si quelque pitié dans ton cœur trouve place Sois comme la saison incapable de glace, Désiste de poursuivre un ingrate qui fuit Et prends part aux douleurs de celle qui te suit Change change d'amour
ALIDOR.	ÀLIDOR.
Pluſtoſt vn coup de foudre Ne fera de ce corps qu’vne maſſe de poudre, Ce que vous propoſeZ n’eſt pas en mon pouuoir.	Plutôt un coup de foudre Ne fera de ce corps qu'une masse de poudre, Ce que vous proposeZ n'est pas en mon pouvoir.
ELIARIE.	ÉLIARIE.
Tu veux donc comme moy manquer à ton de.	Tu veux donc comme moi manquer à ton de.
uoir?	uoir?
ALIDOR.	ÀLIDOR.
La loy de mon deuoir veut que ma flame dure Meſme au deladu temps preſcrit à la Nature.	La loi de mon devoir veut que ma flamme dure Même au déladu temps prescrit à la Nature.
4	4
ELIANTE.	ÉLIANTE.
Et la loy d’vn Tyran barbare comme toy, Fait tourner ma fureur, & ce fer contre moy;	Et la loi d'être Tyran barbare comme toi, Fait tourner ma fureur, et ce fer contre moi;
Adorable Vertu, reçoy cette Victime Qui va donner du ſang à l’exces de ſoncrime Et toy cruel;	Adorable Vertu, reçois cette Victime Qui va donner du sang à l'excès de soncrime Et toi cruel;
ALIDOR.	ÀLIDOR.
Tout beau,	Tout beau,
ELIANTE.	ÉLIANTE.
Laiſſe moy contenter La rigueur qui te pouſſe à me perſecuter:	Laisse -moi contenter La rigueur qui te pousse à me persécuter:
ALIDOR.	ÀLIDOR.
Laſchez moy ce couſteau,	Lâchez -moi ce coûteau,
ELIANTE.	ÉLIANTE.
Dejuus inma vie?	Déjuus inma vie?
Mon iuſte deſespoir s’oppoſe à ton enuie, Ie veux en ce moment la mort, ou ta pitié:	Mon juste désespoir s'oppose à ton envie, Je veux en ce moment la mort, ou ta pitié:
ALIDOR.	ÀLIDOR.
Changeons ce nom d’amour en celuy d’amitié Veuillez eſtre ma ſœur:	Changeons ce nom d'amour en celui d'amitié Veuillez être ma sœur:
ELIANTE.	ÉLIANTE.
non non laiſſe moy faire Ennemy de ma flame impiteux Auerſaire, Tu caches le poiſon deſſous cette douceur Qui ſe remarque aux noms & de frere & de ſœur:	non non laisse moi faire Ennemi de ma flamme impiteux Aversaire, Tu caches le poison dessous cette douceur Qui se remarque aux noms et de frère et de sœur:
Ie veux ie veux mourir.	Je veux ici veux mourir.
ALIDOR.	ÀLIDOR.
Dieux vn peu d’aßiſtance,	Dieux , peu d'assistance,
ELIANTE.	ÉLIANTE.
Ma force & ma fureur vaincront ta reſiſtãce;	Ma force et ma fureur vaincront ta résistance;
ALIDOR.	ÀLIDOR.
Vous trauaillez en vain ie ne vous quitte pas Si vous voulez mourir auancez mon treſpas.	Vous travaillez en vain On ne vous quitte pas Si vous voulez mourir avancez mon trépas.
PHILIDAN.	PHILIDAN.
chercher Quelle iniure ay-ie faitte à ſa flame deceuë, Voicy le meſme endroit ou ie l’auois receue Mais qu'eſt-ce que ie voy?	chercher Quelle injure ai-je faitte à sa flamme déçue, Voici le même endroit ou du l'avais reçue Mais qu'est-ce que je vois?
mon frere ſe desbat Couune,	mon frère se débat Couune,
ALIDOR.	ÀLIDOR.
Accours Philidan viens finir ce combat Arrache ce couſteau	Accours Philidan viens finir ce combat Arrache ce coûteau
ELIANTE.	ÉLIANTE.
Tu veux donc que ie viue Loin de ce doux eſpoir dont ta rigueur me priue?	Tu veux donc que on vive Loin de ce doux espoir dont ta rigueur me prive?
nus fi ie ne croyois en auoir ma raiſon Ie ioindrois à ce fer, les feux & le poiſon.	nus fi grands ne croyais en avoir ma raison Je joindrais à ce fer, les feux et le poison.
ALIDOR.	ÀLIDOR.
Approtne Puilidan &y que le l’entreiienne Mais oſtons nous d’icy ie crains qu’elle reuiẽne.	Approtne Puilidan eti que le l'entreiienne Mais ôtons nous d'ici aux crains qu'elle revienne.
PHILIDAN.	PHILIDAN.
Cette ingratte deuoit pour plaire à mon deſſein Mettre au lieu de ce fer mõ amour dans ſon ſein.	Cette ingrate devait pour plaire à mon dessein Mettre au lieu de ce fer mon amour dans son sein.
ACTE SECON SCENE PREMIERE,	ACTE SECON SCÈNE PREMIÈRE,
CLORISE.	CLORISE.
VRE Loy, que l’honneur impe aux belles ames, E nc!	VRE Loi, que l'honneur impe aux belles âmes, E ç!
Qui te plais d’oppoſer mon deuoir mes flames, Pourquoy ne permets-tu que ſans me dementir Ie puiſſe dire vn mal comme le reſſentir?	Qui te plais d'opposer mon devoir mes flammes, Pourquoi ne permets-tu que sans me démentir Je puisse dire un mal comme le ressentir?
Ton respect ſeulement fait que ie dißimule Aux yeux de l’Vniuers le beau feu dõt ie bruſle, Et que par le ſecours d’vne fauße rigueur Ie me cache à celuy qui regne dans mon cœur.	Ton respect seulement fait que ainsi dissimule Aux yeux de l'Univers le beau feu dont ie brûle, Et que par le secours d'une fausse rigueur Je me cache à celui qui règne dans mon cœur.
Tu dis bien, que la foy des Bergers eſt muable	Tu dis bien, que la foi des Bergers est muable
Que s’aſſurer en eux c’eſt baſtir ſur le ſable, Et que malgré les Dieux qu’ils inuoquent ſouuent Nous donnant leur parolle ils nous donnent du vent;	Que s'assurer en eux c'est bâtir sur le sable, Et que malgré les Dieux qu'ils invoquent souvent Nous donnant leur parole ils nous donnent du vent;
Mais ſur quelque raiſon que tõ diſcours ſe fonde, Alidor ne tient rien ny du vent, ny de l’onde, Sinon quand le penſer de ſes longues douleurs Luy deſrobe pour moy des ſouſpirs & des pleurs, Depuis plus de deux ans ſa peine m'eſt cogneuë, I'ay veu deſſus ſon front ſon ame toute nuë Qui parmy les langueurs d’vne dure priſon Eſt capable de tout ſinon de trahiſon.	Mais sur quelque raison que to discours se fonde, Alidor ne tient rien Seigneur du vent, ni de l'onde, Sinon quand le penser de ses longues douleurs Lui dérobe pour moi des soupirs et des pleurs, Depuis plus de deux ans sa peine m'est connue, J'ai vue dessus son front son âme toute nue Qui parmi les langueurs d'une dure prison Est ance de tout sinon de trahison.
Cependant mon humeur enuers luy trop ingratte Ne luy permet iamais aucun bien qui le flatte, Et ie prends du plaiſir à voir ſa loyauté Disputer de l’exces auec ma cruauté.	Cependant mon humeur envers était trop ingrate Ne ren permet jamais aucun bien qui le flatte, Et Hé ends du plaisir à voir sa loyauté Disputer de l'excès était ma cruauté.
Or le meſme poiſon qu'à cette heurt rejuante Eſt entré par les yeux dans le cœur d’Eliante, De ſorte qu’elle vient d’implorer mon ſecours Pour immoler ma gloire au repos de ſes iours;	Or le même poison qu'à cette heurt réjuante Est entré par les yeux dans le cœur d'Éliante, De sorte qu'elle vient d'implorer mon secours Pour immoler ma gloire au repos de ses jours;
Contrainte qui me tuë, & dont la violence Me fera deſormais accuſer mon ſilence, Et condamner en moy cette iniuſte pitié Qui fait ceder l’amour aux loix de l’amitié,	Contrainte qui me tue, et dont la violence Me fera désormais accuser mon silence, Et condamner en moi cette injuste pitié Qui fait céder l'amour aux lois de l'amitié,
SCENE DEVXIESME.	SCÈNE DEUXIÈME.
CLORISE, PHILIDAN.	CLORISE, PHILIDAN.
IVT PHILIDAN.	IUT PHILIDAN.
Ejuurge freneſie	Ejurge frénésie
CLORISE.	CLORISE.
Quelque nouueau malheur brouille ſa fantaiſie	Quelque nouveau malheur brouille sa fantaisie
PHILIDAN.	PHILIDAN.
Bruſler pres d’vne glace & geler pres d’vn feu Certes le Ciel fait voir qu’il nous ayme bien peu;	Brûler pres d'une glace et geler pres d'un feu Certes le Ciel fait voir qu'il nous aime bien peu;
Autrement, ennemy de tant de tyrannies, Il rendroit a la fin, nos volontez vnies.	Autrement, ennemi de tant de tyrannies, Il rendrait à la fin, nos volontés unies.
CLORISE.	CLORISE.
Il parle d'Eliante.	Il parle d'Éliante.
PHILIDAN	PHILIDAN
PHILIDAN.	PHILIDAN.
Helas que mes ſouspirs Se meſlent vainement auecque les Zephirs.	Hélas que mes soupirs Se mêlent vainement auecque les Zéphirs.
Ah Bergere pardon, ainſi les Deſtinees Cõblent de leurs bien-faits le cours de vos annees.	Ah Bergère pardon, ainsi les Destinées Comblent de leurs bienfaits le cours de vos années.
CLORISE.	CLORISE.
En eſchange du bien que vous me ſouhaitteZ Le Ciel vous donne außi ce que vous meriteZ:	En échange du bien que vous me souhaitez Le Ciel vous donne aussi ce que vous méritez:
Mais berger quel deſſein en ce lieuvous ameine?	Mais berger quel dessein en ce lieuvous âme?
PHILIDAN.	PHILIDAN.
Celuy de conſulter vos appas, inhumaine, Et de ſolliciter au ſecours d’vn Amant Ce cœur que vous ouurez aux rigueurs ſeulement.	Celui de consulter vos appas, inhumaine, Et de solliciter au secours d'un Amant Ce cœur que vous ouvrez aux rigueurs seulement.
Alidor ce cher frere à qui voſtre puiſſance Semble vouloir preſcrire vne eternelle abſence Vous coniure par moy de ne permettre pas Qu'il baiſe plus, ſans vous, les marques de vos pas:	Alidor ce cher frère à qui votre puissance Semble vouloir prescrire une éternelle absence Vous conjure par moi de ne permettre pas Qu'il baise plus, sans vous, les marques de vos pas:
Cruelle, contentez ſon amoureuſe enuie, AcheueZ auiourd’huy ſon exil ou ſa vie, Et ne conſentez plus qu’en ſon iuſte courroux Il nomme les Lyons moins farouches que vous.	Cruelle, contentez son amoureuse envie, Achevez aujourd'hui son exil ou sa vie, Et ne consentez plus qu'en son juste courroux Il nomme les Lyons moins farouches que vous.
CLORISE.	CLORISE.
Qu'il ne ſe plaigne pas, quelque mal qu’il endure Sa faute meritoit vne peine plus dure.	Qu'il ne se plaigne pas, quelque mal qu'il endure Sa faute méritait une peine plus dure.
MATEIDIIRV.	MATEIDIRV.
Eſt-ce vn crime qu’auoir beaucoup d’affection?	Est-ce un crime qu'avoir beaucoup d'affection?
CLORISE.	CLORISE.
Le dire pour le moins c’eſt indiſcretion.	Le dire pour le moins c'est indiscrétion.
PHILIDAN.	PHILIDAN.
Quelle iuſtice veut qu'on deffende la plainte?	Quelle justice veut qu'on défende la plainte?
CLORISE.	CLORISE.
La Iuſtice permet qu’on puniſſe vne feinte.	La Justice permet qu'on punisse une feinte.
PHILIDAN.	PHILIDAN.
Helas depuis le temps que vous l’auez chaſsé Ce funeſte ſoupçon deuroit eſtre effacé;	Hélas depuis le temps que vous l'avez chassé Ce funeste soupçon devrait être effacé;
Les ruiſſeaux vont meſlant, touchez de ſes al larmes, Le courant de leurs eaux à celuy de ſes larmes;	Les ruisseaux vont mêlant, touchés de ses al armes, Le courant de leurs eaux à celui de ses larmes;
Morne, deffiguré, ſans force ſans couleur Il montre clairement l’eſtat de ſa douleur, On ne le peut guerir, il n'eſt point de remede Qu'il vouluſt appliquer au mal qui le poſſede;	Morne, défiguré, sans force sans couleur Il montre clairement l'état de sa douleur, On ne le peut guérir, il n'est point de remède Qu'il voulût appliquer au mal qui le possède;
En fin durant le cours d’vn ſi faſcheux ehnuy Proprement c’eſt mourir que viure comme luy.	En fin durant le cours d'une si fâcheux éhnui Proprement c'est mourir que vivre comme lui.
CLORISE.	CLORISE.
Ie ne croiray iamais que le mal qui le touche pou ſe grand en jon tau quu test en voſtre bouche.	Je ne croirai jamais que le mal qui le touche pou se grand en jon tau quu test en votre bouche.
PHILIDAN.	PHILIDAN.
Plus encore beaucoup, on ne peut l’exprimer, Mais ne vouleZ vous pas vous reſoudre a l’ay	Plus encore beaucoup, on ne peut l'exprimer, Mais ne voulez -vous pas vous résoudre à l'ai
mer?	mer?
CLORISE.	CLORISE.
A l'aymer?	À l'aimer?
Ah ce mot me desplait à l’extreme,	Ah ce mot me déplaît à l'extrême,
THTEIDAN.	THTEIDAN.
Et bien ne l’aymez pas mais ſouffrez qu’il vous ayme;	Et bien ne l'aimez pas mais souffrez qu'il vous aime;
CLORISE.	CLORISE.
Ie ne puis l’empeſcher,	Je ne puis l'empêcher,
PHILIDAN.	PHILIDAN.
Quand vous plaiſt-il le voir?	Quand vous plaît-il le voir?
CLORISE.	CLORISE.
Außi toſt qu’il ſera rentré dans ſondeuoir,	Aussi tôt qu'il sera rentré dans sondevoir,
h	h
PHILIDAN.	PHILIDAN.
Vous luy pardonnez donc?	Vous avez pardonnez donc?
CLORISE.	CLORISE.
Ouy pourueu qu’il s’expoſe A ſuiure obeiſſant quelques loix que i’impoſe.	Oui pourvu qu'il s'expose A suivre obéissant quelques lois que j'impose.
PIIEIDAN.	PIIEIDAN.
A ce matin chargé d’vn petit mot d’écrit	À ce matin chargé d'une petit mot d'écrit
LORTSE.	LORTSE.
I'en ay deſiabien ſceu le ſucces	J'en ai desiabien su le succès
PHILIDAN.	PHILIDAN.
Qui l’a dit?	Qui l'a dit?
Eliante CLORISE.	Éliante CLORISE.
PHILIBAN.	PHILIBAN.
Ah l’ingrate.	Ah l'ingrate.
Adieu c'eſt iniuſtice De laiſſer plus long temps Alidor au ſupplice, Ie m'en vay de ce pas le tirer de ſoucy:	Adieu c'est injustice De laisser plus long temps Alidor au supplice, Je m'en vais de ce pas le tirer de souci:
CLORISE.	CLORISE.
Vous le ramenerez s’il eſt proche d’icy.	Vous le ramènerez s'il est proche d'ici.
Laſche & foible Raiſon, faut-il qu’vn peude honte L’emporte par deſſus vn Dieu qui me ſurmonte?	Lâche et faible Raison, faut-il qu'un peude honte L'emporte par -dessus un Dieu qui me surmonte?
Tyrannique raiſon, eh pourquoy me dis-tu Qu'obliger mon amour c’eſt trahir ma vertu?	Tyrannique raison, eh pourquoi me dis-tu Qu'obliger mon amour c'est trahir ma vertu?
Toutefois ie n'ay plus de diſcours qui me ſerue, Puiſque ie l’ay promis il faut que ie l’obſerue, L’intereſt d’Eliante eſt plus fort que le mien, Il faut en ſa faueur dispoſer de mon bien;	Toutefois je n'ai plus de discours qui me serve, Puisque tu l'ai promis il faut que quelque l'observe, L'intérêt d'Élivante est plus fort que le mien, Il faut en sa faveur disposer de mon bien;
Dure neceßité, d’autant moins ſupportable Qu'vn ſort iniurieux la rend ineuitable.	Dure necessité, d'autant moins supportable Qu'un sort injurieux la rend inévitable.
Mais elle vienticy.	Mais elle vientici.
SCENE TROISIESME.	SCÈNE -TROISIÈME.
ELIANTE CLORISE.	ÉLIANTE CLORISE.
Faut-il hors de propos Ve ie vienne touſiours troubler voſtre repos;	Faut-il hors de propos Ve ie vienne toujours troubler votre repos;
C iij Ie croy que ma douleur ne ſe rend violente  pam tomtfiger & me faire inſolente;	Ç Cij à crois que ma douleur ne se rend violente pam tomptiger et me faire insolente;
CLORISE.	CLORISE.
Les amis peuuent tout,	Les amis peuvent tout,
ELIANTE.	ÉLIANTE.
Dittes la verité I'vſe mal enuers vous de leur authorité, Pardonnez cette faute à mon ame bleſſee, Mais changeos de diſcours, quette vonne penſee Occupoit voſtre eſprit?	Dites la vérité J'une mal envers vous de leur autorité, Pardonnez cette faute à mon âme blessée, Mais changeos de discours, quette vonne pensée Occupait votre esprit?
CLORISE.	CLORISE.
Celle de vostre mal,	Celle de votre mal,
ELIANTE.	ÉLIANTE.
Ie penſe qu’il nous est eſgallement fatal Laiſſons la feinte a part:	Je pense qu'il nous est également fatal Laissons la feinte à part:
CLORISE.	CLORISE.
Ie n'en ſcay pas l’vſage,	Je n'en sais pas l'usage,
ELIANTE.	ÉLIANTE.
Ie voy quelque regret peint ſur voſtre viſage;	Je vois quelque regret peint sur votre visage;
CLORISE.	CLORISE.
Les maux de nos amis ſont tous contagieux Le voſtre, eſt dans mon cœur mieux peint que dans mes yeux:	Les maux de nos amis sont tous contagieux Le vôtre, est dans mon cœur mieux peint que dans mes yeux:
ELIANTE.	ÉLIANTE.
Ma compagne de nom, mais non pas de fortune, C’eſt trop prendre de part à ma peine importune;	Ma compagne de nom, mais non pas de fortune, C'est trop prendre de part à ma peine importune;
Le Ciel, pour me traitter bien plus cruellement Veut par voſtre douleur m’affliger doublement:	Le Ciel, pour me traiter bien plus cruellement Veut par votre douleur m'affliger doublement:
Toutefois s’il eſt vray qu’au mal qui me poſſede Ie doiue quelque iour attendre du remede, Ie ne regrette pas qu’vn exces d’amitié, Ait exposé vostre ame aux traits de la pitié.	Toutefois s'il est vrai qu'au mal qui me possède Je doive quelque jour attendre du remède, Je ne regrette pas qu'une excès d'amitié, Ait exposé notre âme aux traits de la pitié.
Cloriſe hastez donc cette faueur promiſe Obtenez qu'Alidor accepte ma franchiſe, Et que ce cœur de Tygre en fin deuenu doux Ne ſoit iamais pour moy moins ſenſible que vous.	Clorise hâtez donc cette faveur promise Obtenez qu'Alidor accepte ma franchise, Et que ce cœur de Tigre en fin devenu doux Ne soit jamais pour moi moins sensible que vous.
Ma requeſte eſt iniuſte autant que temeraire, Ie ſçay qu'elle merite vne peine exemplaire Mais vous l’authoriſez, car voſtre vollonté A produit, mieux que moy, ce deſſein effronté.	Ma requête est injuste autant que téméraire, Je sais qu'elle mérite une peine exemplaire Mais vous l'autorisez, car votre volonté A produit, mieux que moi, ce dessein effronté.
CLORISE.	CLORISE.
Touſiours chere compagne vne loüable enuie Me fera preferer voſtre bien à ma vie;	Toujours chère compagne une louable envie Me fera préférer votre bien à ma vie;
Toute choſe s’appreſte à vos contentements I'en ay ietté deſia les meilleurs fondements:	Toute chose s'apprête à vos contentements J'en ai jeté déjà les meilleurs fondements:
Bien-toſt ce beau vainqueur amoureux de vos charmes Pour ſes refus paſſez vous donnera des larmes, Il prouuera par vous, s’il a quelque raiſon, Que l’on peut rencontrer vne belle priſon.	Bientôt ce beau vainqueur amoureux de vos charmes Pour ses refus passez vous donnera des larmes, Il provera par vous, s'il a quelque raison, Que l'on peut rencontrer une belle prison.
Cependant il eſt bon qu’vn peu de vigilance Luy cache le ſecret de noſtre intelligence, Son frere en peu de temps me le doit amener, Mais afin qu’il n’ait point ſuiect de ſoupçonner, Soudain qu’il paroiſtra couurez vous du fueillage Ou ces petits oyſeaux font vn ſi doux ramage.	Cependant il est bon qu'int peu de vigilance Lui cache le secret de notre intelligence, Son frère en peu de temps me le doit amener, Mais afin qu'il n'ait point sujet de soupçonner, Soudain qu'il paraîtra couvrez -vous du fueillage Ou ces petits oiseaux font un si doux ramage.
Le voicy gliſſez vous ſoubs ces arbres eſpaix.	Le voici glissez -vous sous ces arbres espaix.
SCENE QVATRIESME.	SCÈNE QUATRIÈME.
PHILIDAN, ALIDOR, CLORISE, ELIANTE.	PHILIDAN, ALIDOR, CLORISE, ÉLIANTE.
PHILIDAN.	PHILIDAN.
J Oicy le lieu preſcrit à faire voſtre paix, V Meſnagez bien le temps, pour moy ie me contente De rencontrer vn arbre au deffaut d’Eliante, Car au triſte diſcours de mon cruel ennuy Ie la trouue außi ſourde & plus dure que luy.	 Jici le lieu prescrit à faire votre paix, V Mesnagez bien le temps, pour moi quelque me contente De rencontrer un arbre au défaut d'Eliante, Car au triste discours de mon cruel ennui Je la trouve aussi sourde et plus dure que sans.
ALIDOR.	ÀLIDOR.
Saiſi d’eſtonnement, de merueille, & de crainte, Ie ne viens pas icy pour vous faire ma plainte, Ie ſcaurois mieux mourir que non pas murmurer Des maux que vos rigueurs m'umciem jait endurer;	Saisi d'étonnement, de merveille, et de crainte, Je ne viens pas ici pour vous faire ma plainte, Je saurais mieux mourir que non pas murmurer Des maux que vos rigueurs m'umciem jait endurer;
Ainſi ne craigneZ pas que ie vous importune Du recit ennuyeux de ma triſte fortune, Sinon pour vous montrer que dans l’eſtat qu'elle eſt Ie l’ayme doublement pour ce qu’elle vous plaiſt:	Ainsi ne craignez pas que je vous importune Du récit ennuyeux de ma triste fortune, Sinon pour vous montrer que dans l'état qu'elle est Je l'aime doublement pour ce qu'elle vous plaît:
Toutes mes actions en ſont vn teſmoignage, Echo dans ces Rochers a parlé mon langage, Et ces eaux, dont le cours roule continuel, Ont cogneu voſtre cœur & l’ont nommé cruel.	Toutes mes actions en sont un témoignage, Écho dans ces Rochers a parlé mon langage, Et ces eaux, dont le cours roule continuel, Ont connu votre cœur et l'ont nommé cruel.
Cependant ie veux bien que l’eſclat d’vn tõnerre Ouure pour m’abyſmer le centre de la terre, Si i’ay fait ſeulement vn effort du penſer Pau uracher les traits qui me ſceurent bleſſer.	Cependant esprit veux bien que l'éclat d' tõnerre Ouvre pour m'abîmer le centre de la terre, Si j'ai fait seulement un effort du penser Pau vracher les traits qui me scurent blesser.
ELIANTE.	ÉLIANTE.
Tu me l’as bien montré	Tu me l'as bien montré
ALIDOR.	ÀLIDOR.
I'ayme trop ma bleſſure Et pluſtoſt on verra la fin de la Nature Que la fin de mes feux;	J'aime trop ma blessure Et plutôt on verra la fin de la Nature Que la fin de mes feux;
ELIANTE.	ÉLIANTE.
Ny celle de mon mal	Ni celle de mon mal
CLORISE.	CLORISE.
L’homme à ce qu’on m'a dit eſt vn traiſtre Animal;	L'homme à ce qu'on m'a dit est un traître Animal;
Quand il veut triompher d’vne fille imprudente Sa bouche ne dit rien que ſon cœur ne demente, Le vice le plus grand luy tient lieu de vertu,	Quand il veut triompher d'une fille imprudente Sa bouche ne dit rien que son cœur ne démente, Le vice le plus grand sens tient lieu de vertu,
ALIDOR.	ÀLIDOR.
Cette feinte regarde vn courage abbatu, Mais l’homme genereux deſpoüillé de malice Chaſſe bien loin de ſoy le fard & l’artifice;	Cette feinte regarde un courage abattu, Mais l'homme généreux dépouillé de malice Chasse bien loin de soi le fard et l'artifice;
Meſme afin qu'on te voye & le cognoiſſe mieux Il n'aiamais le cœur moins ouuert que les yeux.	Même afin qu'on te voie et le connaisse mieux Il n'aiamais le cœur moins ouvert que les yeux.
CLORISE.	CLORISE.
Estes vous de ce nombre?	Êtes -vous de ce nombre?
ALIDOR.	ÀLIDOR.
Ancfue cette demande Fait a ma paßion vne iniure bien grande, V ous n'en ſcauriez douter ſans me deſesperer;	Ancue cette demande Fait à ma passion une injure bien grande, V ous n'en sauriez douter sans me désespérer;
CLORISE.	CLORISE.
Ie n’ay point de ſuiet de m’en trop aſſurer:	Je n'ai point de sujet de m'en trop assurer:
ALIDOR.	ÀLIDOR.
Si durant vos mespris mõ amour n’eſt pas morte En vouleZ vous chercher vne preuue plus forte?	Si durant vos mépris mon amour n'est pas morte En voulez -vous chercher une preuve plus forte?
Et ſans que ie recoure aux accidents paſſeZ Vous aueZ de mon teint tous les traits effaceZ, La douleur qui ſe lit ſur mon viſage bleſme Montre combien ie ſouffre, & combien ie vous ayme;	Et sans que ici recoure aux accidents passés Vous avez de mon teint tous les traits effacés, La douleur qui se lit sur mon visage blême Montre combien ce souffre, et combien ces vous aime;
Que ſi vostre ſoupçon m’oblige à vous fournir Vn exemple tiré des choſes à venir, Que ne feray ie pas, commandeZ que i'expire, Que i'aille de ce pas eſcorcher vn Satyre, Affronter vn Sanglier, ou combattre des Loups, Il n'eſt rien que mon bras n'entreprenne pour vous.	Que si votre soupçon m'oblige à vous fournir Ou exemple tiré des Loups venir, Que ne ferai ie pas, commandez que j'expire, Que j'aille de ce pas écorcher un Satyre, Affronter un Sanglier, ou combattre des Loups, Il n'est rien que mon bras n'entreprenne pour vous.
ELIANTE.	ÉLIANTE.
uuui fuiy uume tiens-tu cet amoureux langage?	uuui fui ume tiens-tu cet amoureux langage?
CLORISE.	CLORISE.
y om piomellex deahconp,	y om piomellex deahconp,
ALIDOR.	ÀLIDOR.
Ie ferois dauantage.	Je ferais davantage.
PHILIDAN.	PHILIDAN.
Cét Ormeau pour le moins aura la vanité De parler d’Eliante à la Poſterité.	Cet Ormeau pour le moins aura la vanité De parler d'Éliante à la Postérité.
CLORISE.	CLORISE.
Si deſſus vos deſirs ma puiſſance eſt extreme Ie veux que, mais qui vient?	Si dessus vos désirs ma puissance est extrême Je veux que, mais qui vient?
Eliante, elle meſme.	Éliante, elle -même.
ALIDOR.	ÀLIDOR.
Que ie ſuis malheureux	Que ie suis malheureux
PHILIDAN.	PHILIDAN.
Vous venez à propos Pour voir combien Amour me laiſſe de repos, Liſez ce peu de vers:	Vous venez à propos Pour voir combien Amour me laisse de repos, Lisez ce peu de vers:
ALIDOR.	ÀLIDOR.
Adieu belle incredule perEt laiſſez vous toucher aux flames dõt ie bruſle.	Adieu belle incrédule perEt laissez vous toucher aux flammes dont ici brûle.
CLORISE.	CLORISE.
Quoy nous quitter ainſi?	Quoi nous quitter ainsi?
mon eſprit irrité Ne pardonneroit pas cette inciuilité, DemeureZ, nous auons quelque choſe à vous dire.	mon esprit irrité Ne pardonnerait pas cette incivilité, Demeurez, nous avons quelque chose à vous dire.
Mais approchons,	Mais approchons,
ELIANTE.	ÉLIANTE.
Bel Arbre	Bel Arbre
CLORISE.	CLORISE.
Elle commence à lire.	Elle commence à lire.
ELIANTE.	ÉLIANTE.
Bel Arbre permets ie te prie Qu’icy par des traits innocents Ie faſſe admirer aux paſſants Le ſuiet de ma reſuerie:	Bel Arbre permets après te prie Qu'ici par des traits innocents Je fasse admirer aux passants Le sujet de ma rêverie:
Et ſi tu vois cét œil vainqueur Dont mes ſens ont cogneu la force Dy luy qu'Amour eſt dans mon cœur Mieu-grant que ſur ton eſcorce.	Et si tu vois cet œil vainqueur Dont mes sens ont connu la force Dis toujours qu'Amour est dans mon cœur Mieu-grant que sur ton écorce.
Mais pour qui ſont ces vers?	Mais pour qui sont ces vers?
PHILIDAN.	PHILIDAN.
Pour vous,	Pour vous,
ELIANTE.	ÉLIANTE.
S’ils ſont pour moy Accepte les berger ie les addreſſe à toy.	S'ils sont pour moi Accepte les berger On les adresse à toi.
4	4
ALIDOR.	ÀLIDOR.
C’eſt donc pour m’obliger à leur donner encore L'honneur d'eſtre acceptez de celle que i'adore.	C'est donc pour m'obliger à leur donner encore L'honneur d'être acceptez de celle que j'adore.
CLORISE.	CLORISE.
Ie ne m’enrichis pas des deſpoüilles d’autruy,	Je ne m'enrichis pas dé pouillés d'autrui,
ALIDOR.	ÀLIDOR.
Ie ne les veux donc point,	Je ne les veux donc point,
ELIANTE.	ÉLIANTE.
Ny moy non plus que luy,	Ni -moi non plus que Seigneur,
PHILIDAN.	PHILIDAN.
C eſt en quoy ton mespris ingratte ſe contemple,	Ç est en quoi ton mépris ingrate se contemple,
ELIANTE.	ÉLIANTE.
Ie ne ſçaurois faillir apres vn tel exemple;	Je ne saurais faillir après un tel exemple;
PHILIDAN.	PHILIDAN.
Quelque iour.	Quelque jour.
ELIANTE.	ÉLIANTE.
Mais perger pourquoy ne veux-tu point Que ton conſentement a ma flame ſoit ioint?	Mais perger pourquoi ne veux-tu point Que ton consentement à ma flamme soit joint?
ALIDOR.	ÀLIDOR.
Pourquoy ne voulez vous que Philidan obtiẽne Les faueurs dõt voſtre ame importune la miẽne?	Pourquoi ne voulez -vous que Philidan obtine Les faveurs dont notre âme importune la mienne?
ELIANTE.	ÉLIANTE.
Pouret que no, es prits n'ont point de liaiſon,	Prouret que nô, ès prits n'ont point de liaison,
ALIDOR.	ÀLIDOR.
Ie vous pourrois payer de la meſme raiſon.	Je vous pourrais payer de la même raison.
CLORISE.	CLORISE.
De ſexe differente ell' a de l’auantage	De sexe différente elle a de l'avantage
ALE CR.	ALE CR.
Ouy, mais non pas aſſeZ pour me rẽdre volage, I'ayme tant vos beautez que pluſtoſt que chãger Ie perdray le nom d’homme, & celuy de Berger.	Oui, mais non pas assez pour me rendre volage, J'aime tant vos beautés que plutôt que chãger Je perdrai le nom d'homme, et celui de Berger.
CLORISE.	CLORISE.
Il faut puiſqu'vn ingrat eſt digne de ſupplice Aymer qui nous cherit,	Il faut puisqu'un ingrat est digne de supplice Aimer qui nous chérit,
ALIDOR.	ÀLIDOR.
Faittes moy donc Iuſtice.	Faites -moi donc Justice.
CLORISE.	CLORISE.
Non, ie dis qu’ayant pu ma compagne enflamdiiei) Puis qu'elle vous cherit vous la deuez aymer.	Non, Seigneur dis qu'ayant pu ma compagne enflamdiie) Puis qu'elle vous chérit vous la devez aimer.
ALIDOR.	ÀLIDOR.
C’eſt me vouloir contraindre à faire l’impoßible,	C'est me vouloir contraindre à faire l'impossible,
CLORISE.	CLORISE.
Certes à ſa beauté ne paroiſtre ſenſible Eſt vn crime en amour puniſſable de mort:	Certes à sa beauté ne paraître sensible Est un crime en amour punissable de mort:
Pourquoy?	Pourquoi?
ALIDOR.	ÀLIDOR.
CLORISE.	CLORISE.
Son charme eſtgrand,	Son charme estgrand,
ALIDOR.	ÀLIDOR.
Mais le voſtre eſt plus fort.	Mais le vôtre est plus fort.
PHI	PHI
PHILIDAN.	PHILIDAN.
Ingratte, s’il est vray que mes flames plus viues Ne puiſſent ſurmonter vos froideurs exceßiues.	Ingratte, s'il est vrai que mes flammes plus vives Ne puissent surmonter vos froideurs excessiues.
Redonnez moy mon cœur;	Redonnez -moi mon cœur;
ELIANTE.	ÉLIANTE.
Si i’ay perdu le mien Oupenſesiaotrger que le trenne lehen Cloriſe*	Si j'ai perdu le mien Oupenséiaotrger que le trenne lehen Clorise*
CLORISE.	CLORISE.
Ah quel Arreſt faut-il que ie prononce!	Ah quel Arrêt faut-il que . prononce!
Alidor?	Alidor?
parle à moy, mais fay que ta responce Ne m'exprime ſinon ton propre ſentiment, Comme quoy cheris tu Cloriſe?	parle à moi, mais fais que ta réponse Ne m'exprime sinon ton propre sentiment, Comme quoi chéris tu Clorise?
ALIDOR.	ÀLIDOR.
Infiniment.	Infiniment.
CLORISE.	CLORISE.
De ſorte qu'elle peut deſſus toy toute choſe?	De sorte qu'elle peut dessus toi toute chose?
ALIDOR.	ÀLIDOR.
Il eſt vray, quelques loix que ſa beauté m'impoſe Ie les obſerueray, deuſſay-ie de ce pas M'ouurir en ſa faueur les portes du treſpas.	Il est vrai, quelques lois que sa beauté m'impose Je les observerai, dussai-je de ce pas M'ouvrir en sa faveur les portes du trépas.
CLORISE.	CLORISE.
Ce diſcours de ta foy m’oblige & me contente, Mais i’en veux vn eſſay;	Ce discours de ta foi m'oblige et me contente, Mais j'en veux un essai;
voy-tu bien Eliante Elle bruſle pour toy d’vn deſir le plus ſaint Dont le cœur d’vn mortel puſt iamais eſtre atteint;	vois-tu bien Éliante Elle brûle pour toi d'un désir le plus saint Dont le cœur d'un mortel pût jamais être atteint;
Ayme-la, ie le veux, & ie te le commande.	Aime-la, Seigneur le veux, et Seigneur te le commande.
ALIDOR.	ÀLIDOR.
Ah ne mimpoſez pas vne peine ſi grande:	Ah ne mimposez pas une peine si grande:
Bergere,	Bergère,
CLORIUE.	CLORIUE.
C’en eſt fait, reſous toy deſormais Si tu ne m'obeu ton me rotriamais.	C'en est fait, résous toi désormais Si tu ne m'obeu ton me rotriamais.
PHILIDAN.	PHILIDAN.
Innumame vn ſeut mot:	Inumame un seut mot:
ELIANTE.	ÉLIANTE.
Adieu.	Adieu.
ALIDOR.	ÀLIDOR.
Tu fuys cruelle Apres auoir rendu ma douleur eternelle?	Tu fuis cruelle Apres avoir rendu ma douleur éternelle?
Apres m'auoir preſcrit afin de me hayr Vne néceßité de te deſobeyr Barbare ou penſes-tu qu’vn deſeſpoir m'empor, te?	Après m'avoir prescrit afin de me haïr Ne nécessité de te désobéir Barbare ou penses-tu qu'un désespoir m'empor, te?
Oſes-tu preſumer que mon amour ſoit forte Iuſqu'a ne trouuer point de ſecours aſſeZ fort Ny dans le changement ny meſme dans la mort?	Oses-tu présumer que mon amour soit forte Jusqu'a ne trouver point de secours assez fort Ny dans le changement ni mesme dans la mort?
Ah vaine opinion iniuſtement conceuë Ie ſens deſia dans l’ame vn regret qui me tuë Dequoy ny mes ardeurs ny la ſuitte des ans N’ont purompre le cours de mes ennuis preſents.	Ah vaine opinion injustement conçue Je sens déjà dans l'âme un regret qui me tue Dequoy toujours mes ardeurs ni la suitte des ans N'ont purompre le cours de mes ennuis présents.
PHILIDAN.	PHILIDAN.
Quelque mal qui nous faſſe eſtimer miſerables, On ſe peut conſoler quand on a des ſemblables.	Quelque mal qui nous fasse estimer misérables, On se peut consoler quand on a des semblables.
ALIDOR.	ÀLIDOR.
Au contraire, mon ſort tire de ton malheur Vn eſtrange moyen d’accroiſtre ma douleur;	Au contraire, mon sort tire de ton malheur Un étrange moyen d'accroître ma douleur;
Outre que de nos maux la cauſe eſt differente, Car tu n’as contre toy que le cœur d’Eliante, Au lieu que ie remarque à ma perte conioint Ce que i'ayme, & de plus ce que ie n’aymepoint.	Outre que de nos maux la cause est différente, Car tu n'as contre toi que le cœur d'Éliante, Au lieu que de marque à ma perte conjoint Ce que j'aime, et de plus ce que je n'aimepoint.
PHILIDAN.	PHILIDAN.
Qui voudroit les punir d’vne eternelle honte Deuroit de leur mespris ne tenir point de compte, Et par le ſouuenir des outrages ſoufferts Secouer de leur ioug les chaiſnes & les fers.	Qui voudrait les punir d'une éternelle honte Deurait de leur mépris ne tenir point de compte, Et par le souvenir des outrages soufferts Secouer de leur joug les chaînes et les fers.
ALIDOR.	ÀLIDOR.
Dieux qu’il est difficile!	Dieux qu'il est difficile!
& qu’en cette penſee Toname ſe fait voir bien laſche, ou peu bleßee;	et qu'en cette pensée Toname se fait voir bien lâche, ou peu blessee;
Iamais vn esprit fort aux perils ne ſe rend, Il recherche la gloire ou le combat eſt grand, Et plus vne action ſemble eſtre dangereuſe.	Jamais un esprit fort aux périls ne se rend, Il recherche la gloire ou le combat est grand, Et plus une action semble être dangereuse.
Plus elle eſt agreable a l’ame genereuſe.	Plus elle est agréable a l'âme généreuse.
Mais l’eſtat ou ie ſuis a deux extremitez Dont ie ne puis forcer les contrarieteZ;	Mais l'état ou autre suis à deux extrémités Dont apprendre ne puis forcer les contrariétés;
Commandement iniuſte, & dont la tyrannie Eſtablit dans mon ame vne peine infinie.	Commandement injuste, et dont la tyrannie Établit dans mon âme toujours peine infinie.
Ie dois en meſme temps aymer & n'aymer pas, Ah c’eſt vouloir vnir la vie & le trespas, La nuict & le Soleil, la chaleur & la glace:	Je dois en même temps aimer et n'aimer pas, Ah c'est vouloir unir la vie et le trépas, La nuit et le Soleil, la chaleur et la glace:
Cloriſe, quelque effort que ta colere faſſe Tu n’y paruiendras point, le ſeco urs de ma main Aſſouuira pluſtost ton courage inhumain.	Clorise, quelque effort que ta colère fasse Tu n'y parviendras point, le seco urs de ma main Assouvira plutôt ton courage inhumain.
Mais ingratte reuiens, puis qu’il faut que ie meure Ie mourray plus content ſi ie meurs de bonne heure;	Mais ingrate reviens, puis qu'il faut que sans meure Je mourrai plus content si appris meurs de bonne heure;
Reuien pour prononcer en ce fatal ſeiour Par quel genre de mort ie dois perdre le iour.	Revien pour prononcer en ce fatal séjour Par quel genre de mort ie dois perdre le jour.
Ahc’eſt fait, ma douleur preuient ma violence, Voicy de mon deſtin la derniere inſolence, Ie n’en puis plus, Adieu cher frere & ſouuien toy D'aymer malgré ma mort Cloriſe autant que moy.	Ahc'est fait, ma douleur prévient ma violence, Voici de mon destin la dernière insolence, Je n'en puis plus, Adieu cher frère et souvien toi D'aimer malgré ma mort Clorise autant que moi.
PHILIDAN.	PHILIDAN.
D’où prouient ce tranſport?	D'où prouient ce transport?
cher frere ie te prie Oppoſe ton courage a cette reſuerie.	cher frère Je te prie Oppose ton courage à cette rêverie.
Ie croy qu’il eſt deſia priué de ſentiment, Il a pourtant au cœur vn peu de mouuement Quelle prompte faueur nous tirera de peyne;	Je crois qu'il est déjà privé de sentiment, Il a pourtant au cœur un peu de mouvement Quelle prompte faveur nous tirera de peine;
I apperçois vn Paſteur qui trauerſe la plaine, Paſteur?	I aperçois un Pasteur qui traverse la plaine, Pasteur?
approche vn peu.	approche un peu.
SCENE CINQVIESME.	SCÈNE CINQUIÈME.
DORILAS, PHILIDAN, ALIDOR,	DORILAS, PHILIDAN, ALIDOR,
DORILAS.	DORILAS.
Que veux tu?	Que veux tu?
PHILIDAN.	PHILIDAN.
Pour ce berger qui va finir ſes iours.	Pour ce berger qui va finir ses jours.
DORILAS.	DORILAS.
Qui l'a traitté ſi mal?	Qui l'a traité si mal?
PHILIDAN.	PHILIDAN.
Amour,	Amour,
DORILAS.	DORILAS.
Amour.	Amour.
PHILIDAN.	PHILIDAN.
Luy-meſme;	Lui-même;
DORILAS.	DORILAS.
Eſt-ce quelque ennemy?	Est-ce quelque ennemi?
PHILIDAN.	PHILIDAN.
Ton innocence extreme mint feroieug redote en queique aure ſaijon, Mais va querir de l’eau Paſteur,	Ton innocence extrême mint feraient redote en queique aure saisjon, Mais va quérir de l'eau Pasteur,
DORILAS.	DORILAS.
c'est la raiſon Vous pouuez librement vſerde mon ſeruice,	c'est la raison Vous pouvez librement userde mon service,
TlAIDARV.	TlAIDARU.
Le creux de ton chappeau ſuffit à cetofice.	Le creux de ton chapeau suffit à cetofice.
diuuurieponamoy.	diuuurieponamoy.
DORILAS.	DORILAS.
Voicy ce qu’il nous faut,	Voici ce qu'il nous faut,
PHILIDAN.	PHILIDAN.
Laiſſe-la moy ietter,	Laisse-la moi jeter,
DORILAS.	DORILAS.
Tout va bien, il treſſaut;	Tout va bien, il tressaut;
Courage beau berger?	Courage beau berger?
ô l’action perfide Il faut que nous faßions punir cet homicide.	ô l'action perfide Il faut que nous passions punir cet homicide.
D uij	 Duij
PHILIDAN.	PHILIDAN.
C’eſt vnDieu qui l’afait, on ne s en peut vanger.	C'est unDieu qui l'afait, on ne s en peut venger.
DORILAS.	DORILAS.
Les Dieux ſont ils meſchants?	Les Dieux sont ils méchants?
tu blaſphemes berger.	tu blasphèmes berger.
ALIDOR.	ÀLIDOR.
Quel eſtrange deſtin, quelle main importune Oppoſe ſon ſecours a ma bonne fortune?	Quel étrange destin, quelle main importune Oppose son secours à ma bonne fortune?
D’où vient que ie reſpire?	D'où vient que ici respire?
& que i’ouure mon œil A de moindres horreurs que celles du cercueil?	et que j'ouvre mon œil A de moindres horreurs que celles du cercueil?
Ah Philidan c’eſt toy, dont l’amitié funeſte Entretient malgre moy la vigueur qui me reſte;	Ah Philidan c'est toi, dont l'amitié funeste Entretient malgré moi la vigueur qui me reste;
Mais tu deuois pluſtoſt, afin de me guerir, Ayder mon deſespoir à me faire perir;	Mais tu devais plutôt, afin de me guérir, Ayder mon désespoir à me faire périr;
Außi bien tu verras, puis qu’il faut que ie meure, Que tu n'as differé mon treſpas que d’vne heure:	Aussi bien tu verras, puis qu'il faut que ie vivre, Que tu n'as différé mon trépas que d'une heure:
Ma fureur, que mes maux font changer en raiſon, Me preſente le fer, les feux, & le poiſon;	Ma fureur, que mes maux font changer en raison, Me présente le fer, les feux, et le poison;
Et pour mieux terminer ma peine ſans ſeconde, Lignon à leur defaut me preſtera ſon onde, Qui ne ſçauroit faillir de noyer mes douleurs Quand elle aura receu le ſecours de mes pleurs.	Et pour mieux terminer ma peine sans seconde, Lignon à leur défaut me prêtera son onde, Qui ne saurait faillir de noyer mes douleurs Quand elle aura reçu le secours de mes pleurs.
PHILIDAN.	PHILIDAN.
Il s’eſchappe, grands Dieux deſtournez cet orage	Il s'échappe, grands Dieux détournez cet orage
DORILAS.	DORILAS.
A peine pourra-ton diuertir ſon courage, Mais dans ſon deſeſpoir ie le trouue peu fin I'aymerois mieux noyer mes douleurs dans le vin.	À peine pourra-ton divertir son courage, Mais dans son désespoir ie un trouve peu fin J'aimerais mieux noyer mes douleurs dans le vin.
ACTE TROISIESME.	ACTE -TROISIÈME.
SCENE PREMIERE.	SCÈNE PREMIÈRE.
ALIDOR.	ÀLIDOR.
Er 2 N fin pour euiter vne iniuſte pourſuitte Ma fureur a trouue on ſalut en ma fuitte, Deſormais i’obtiendray, ſi ce n’eſt de guerir, Au moins la liberté de plaindre, & de mourir.	Er 2 N fin pour éviter une injuste poursuite Ma fureur a trouve on salut en ma fuite, Désormais j'obtiendrai, si ce n'est de guérir, Au moins la liberté de plaindre, et de mourir.
Fauorable Rocher dont les pointes cornuës Surpaſſent en hauteur la region des Nuës, Ouure moy tes deſtours, ie te viens conſulter E Sur le deſſein que i'ay de me precipiter, 12	Favorable Rocher dont les pointes cornues Surpassent en hauteur la région des Nuës, Ouvre moi tes détours, Seigneur te viens consulter E Sur le dessein que j'ai de me précipiter, 12
Et vous qui mespriſant la colere des Ondes Habitez auiourd’huy ces cauernes profondes, Ours, Sangliers, & ſerpents, teſmoings de mon treſpas, De ce corps diuisé ne faittes qu’vn repas;	Et vous qui méprisant la colère des Ondes Habités aujourd'hui ces cavernes profondes, Ours, Sangliers, et serpents, témoings de mon trépas, De ce corps divisé ne faites qu'un repas;
Vne ingratte, pour plaire à ſon humeur barbare Vous donne ce feſtin, & ie vous le prepare:	Une ingrate, pour plaire à son humeur barbare Vous donne ce festin, et votre vous le prépare:
Comme elle triomphez de mes malheurs paſſez, VoyeZ auec plaiſir mes membres fracaſſez, Et deuant qu’engloutir mes os dans vos entrailles Auec des hurlements faittes mes funerailles.	Comme elle triomphez de mes malheurs passés, VoyeZ avec plaisir mes membres fracassés, Et devant qu'engloutir mes os dans vos entrailles Avec des hurlements faites mes funérailles.
Ou pluſtost animé d’vn plus noble deſſein Lignon reçoy mon corps & mes feux dans ton ſein;	Ou plutôt animé d'une plus noble dessein Lignon reçois mon corps et mes feux dans ton sein;
Senſible à la pitié tends moy tes bras humides, Mais afin que les yeux qui ſont mes homicides Puiſſent faire vn miracle ou ie fay mõ tombeau, Laiſſe durer ma flame au milieu de toneau.	Sensible à la pitié tends moi tes bras humides, Mais afin que les yeux qui sont mes homicides Puissent faire un miracle ou ainsi fais mon tombeau, Laisse durer ma flamme au milieu de toneau.
Guencli apperçoy deſia l’horreur des precipices Toute preſtez finir celle de mes ſupplices;	Guencli aperçois déjà l'horreur des précipices Toute prêtez finir celle de mes supplices;
Ie ſuis monté ſi haut, qu’a mes yeux;	Je suis monté si haut, qu'a mes yeux;
ces foreſts N'õt pas plus de hauteur que l'herbe des mareſts	ces forêts N'ont pas plus de hauteur que l'herbe des marêts
Lignon n'a plus qu'vn pas qui ſepare ſes riues, On ne void plus le cours de ſes ondes fuytiues, Et les Nymphes des eaux ne me cognoiſsant point Comparent ma grandeur auec celle d’vn point.	Lignon n'a plus qu'Hommes pas qui sépare ses rives, On ne voit plus le cours de ses ondes suives, Et les Nymphes des eaux ne me connaissant point Comparent ma grandeur Sei celle d'un point.
Que Cloriſe a preſcrit au mal qui me poſſede, Icy ie dois changer par vn dernier effort Les bleſſures d’Amour à celles de la Mort.	Que Clorise a prescrit au mal qui me possède, Ic ie dois changer par un dernier effort Les blessures d'Amour à celles de la Mort.
Mais pourquoy differer ce deſſein legitime?	Mais pourquoi différer ce dessein légitime?
En l’eſtat ou ie ſuis ma pareſſe eſt vn crime;	En l'état ou belle suis ma paresse est un crime;
Cauſe de mes douleurs belle ingratte vien voir Combien tes cruautez ont ſur moy de pouuoir, Afin que ce moment, le dernier de ma vie, M'aſſure pour le moins de tahayne aſſouuie.	Cause de mes douleurs belle ingrate viens voir Combien tes cruautés ont sur moi de pouvoir, Afin que ce moment, le dernier de ma vie, M'assure pour le moins de tahaine assurie.
Mais tu ne viendras point, Grands Dieux pour m’obliger AddreſſeZ iuſqu'icy quelque ſimple berger, Qui, fidelle teſmoing des ſouſpirs que i’eſuante Luy faſſe le diſcours de ma fin violente, Luy reproche ſon crime, & la faſſe fremir Au recit des horreurs que ie voy fans bleſmir.	Mais tu ne viendras point, Grands Dieux pour m'obliger Adressez jusqu'ici quelque simple berger, Qui, fidèle témoin des soupirs que j'esuante Lui fasse le discours de ma fin ente, Lui reproche son crime, et la fasse frémir Au récit des horreurs que ie vo fans frémir.
Mais ou mon œil me trompe, ou ma iuſte requeſte A trouué dans le Ciel vne aßiſtance preſte;	Mais ou mon œil me trompe, ou ma juste requête A trouvé dans le Ciel toujours assistance prête;
Ie ne ſuis point deceu quelqu'vn paroiſt en bas, Deſcendons, autrement il ne me verroit pas.	Je ne suis point déçu quelqu'autre paraît en bas, Descendons, autrement il ne me verrait pas.
Ceſt Eliante!	Cest Éliante!
CENE DEVXIESME.	CÈNE DEUXIÈME.
ELIANTE ALIDOR.	ÉLIANTE ALIDOR.
ELIANTE.	ÉLIANTE.
HElast à quoy meſertlaplainte Si de nulle pitié ſon ame n’eſt atteinte, Si ie n’ay ſceu le voir durant vn ſeul moment Depuis l’arreſt donné de ce commandement.	HElast quoi mesertlaplainte Si de nulle pitié son âme est atteinte, Si ie ay sceu le voir HÉlât à seul moment Depuis mes donné de ce commandement.
Ah que ma paßion doit eſtre criminelle Puiſque meſme l'espoir s'eſt declaré contre elle;	Ah que ma passion doit être criminelle Puisque même l'espoir s'est déclaré contre elle;
Bergere?	Bergère?
ALIDOR.	ÀLIDOR.
ELIANTE.	ÉLIANTE.
Qu'ay ie ouy?	Qu'a ie oui?
ALIDOR.	ÀLIDOR.
haſte toy d’approcher Pour la derniere fois ce funeſte rocher.	hâte toi d'approcher Pour la dernière fois ce funeste rocher.
LLIANIE.	LLIANIE.
Eſt-ce toy beau berger?	Est-ce toi beau berger?
ALIDOR.	ÀLIDOR.
Ouy c’eſt moy qui t’appelle,	Oui c'est moi qui t'appelle,
ELIANTE.	ÉLIANTE.
Arbitres des humains que ma fortune eſt belle, Sans doute il a regret de voir qu’a mon ennuy Ces rochers ont paru plus ſenſibles que luy.	Arbitres des humains que ma fortune est belle, Sans doute il a regret de voir qu'a mon ennui Ces rochers ont paru plus sensibles que lui.
ALIDOR.	ÀLIDOR.
Bergere, ainſi le Ciel tes ſouhaits accompliſſe, Arreſte & prends bien garde à mon dernier ſupplice;	Bergère, ainsi le Ciel tes souhaits accomplisse, Arrête et prends bien garde à mon dernier supplice;
Fay que Cloriſe ſcache en quel estat tu vois Vn berger qui ſe plaint de ſes iniuſtes loix, Et qui ne pouuant pas ſe reſoudre à les ſuiure A bien pu ſe reſoudre à ne vouloir plus viure.	Fais que Clorise sache en quel état tu vois n berger qui se plaint de ses injustes lois, Et qui ne pouvant pas se résoudre à les suivre A bien pu se résoudre à ne vouloir plus vivre.
Reproche à ſa beauté que mon feu vehement Meritoit aupres d’elle vn meilleur traittement, Dy luy que ce rocher est moins coupable qu'elle;	Reproche à sa beauté que mon feu véhément Méritait auprès d'elle un meilleur traitement, D lui que ce rocher est moins coupable qu'elle;
Et toy, qui voulus rompre vne amitie ſi belle Vante toy ſi ta gloire en a quelque beſoin Da que de mu mort ia tanſe, & te teſmoin, Adieu.	Et toi, qui voulus rompre une amitié si belle Vante toi si ta gloire en a quelque besoin Da que de mu mort ja tanse, et te témoin, Adieu.
ELIANTE.	ÉLIANTE.
Berger arreſte.	Berger arrête.
ah Dieux!	ah Dieux!
quelle manie, D’vn ſaut il s’affranchit de noſtre tyrannie, Il s'eſt precipité;	quelle manie, D'un saut il s'affranchit de notre tyrannie, Il s'est précipité;
ce precieux treſor S’eſt caché dans Lignon, ſon onde en rid encor;	ce précieux trésor S'est caché dans Lignon, son onde en rid encor;
Glorieuſe d’auoir vne beauté ſi rare.	Glorieuse d'avoir une beauté si rare.
Contre ſon ordinaire elle paroiſt auare, Autrement quelquefois il reuiendroit ſur l’eau;	Contre son ordinaire elle paraît avare, Autrement quelquefois il reviendrait sur l'eau;
Mais ie ne le voy plus, ce liquide tombeau De crainte de me rendre vne fois ſon image Apres l’auoir receuë, à fermé ſon paſſage.	Mais personne ne le vois plus, ce liquide tombeau De crainte de me rendre une fois son image Après l'avoir reçue, à fermé son passage.
Que feray-ie chetiue?	Que ferai-je chétive?
en quelle extremité Ne me doit pas ietter mon courageirrité?	en quelle extrémité Ne me doit pas jeter mon courageirrité?
Faut-il que ie le ſuiue?	Faut-il que venir le suive?
ouy ma fureur m’y pouſſes Mais ne le faiſons pas cette mort est trop douce, I'offencerois ſa hayne, & le Ciel ne veut pas Que ie ſois iointe à luy meſme dans le treſpas.	oui ma fureur m'y pousses Mais ne le faisons pas cette mort est trop douce, J'offenserais sa haine, et le Ciel ne veut pas Que personne sois jointe à lui même dans le trépas.
Mais vous qui puniſſez les actions perfides, Qui cognoiſſez mon crime eſgal aux parricides, Grands Dieux, qu'attendez vous d’apprester mes tourments?	Mais vous qui punissez les actions perfides, Qui connaissez mon crime égal aux parricides, Grands Dieux, qu'attendez -vous d'apprêter mes tourments?
Faittes iurer ma perte a tous les Elements, Que la Terre a l’inſtant par vn trait de Iuſtice S’ouure deſſous mes pieds, & qu’elle m'engloutiſſe;	Faites jurer ma perte a tous les Éléments, Que la Terre a l'instant par un trait de Justice S'ouvre dessous mes pieds, et qu'elle m'engloutisse;
Que ie ſois miſe au Feu, que l’Air pour me punir Refuſe à mes poulmons dequoy s’entretenir, Et ſi l’Eau ne tenoit mon Berger hors du monde, Ie voudrois m’expoſer à la fureur de l’onde.	Que quelque sois mise au Feu, que l'Air pour me punir Refuse à mes poulons dequoy s'entretenir, Et si l'Eau ne tenait mon Berger hors du monde, Je voudrais m'exposer à la fureur de l'onde.
Mais que ma plainte eſt folle, & que mes cris ſont vains, Le Deſtin qui ſe iouë auecque les humains Interdit ce remede à mes maux deplorables:	Mais que ma plainte est folle, et que mes cris sont vains, Le Destin qui se joue avec les humains Interdit ce remède à mes maux déplorables:
Doncques à ſon deffaut Monſtres espouuantables Ours, Viperes, Demons, ie vous inuocque tous Qui retient vos fureurs?	Donc à son défaut Monstres épouvantables Ours, Vipères, Demons, toujours vous invocque tous Qui retient vos fureurs?
pourquoy m'eſpargneZ vous?	pourquoi m'épargnez -vous?
Venez ioindre a mes mains l’effort de voſtre rage Pour deſchirer ce ſein, ces cheueux, ce viſage.	Venez joindre à mes mains l'effort de votre rage Pour déchirer ce sein, ces cheveux, ce visage.
SCENE TROISIESME.	SCÈNE -TROISIÈME.
CLORISE, ELIANTE.	CLORISE, ÉLIANTE.
CLORISE.	CLORISE.
VR vn ſoupçon douteux qui me trouble en O effect, Triſte i’accours aux cris que ma compagne fait;	VR un soupçon douteux qui me trouble en Ô effet, Triste j'accours aux cris que ma compagne fait;
D'où vient que ie la trouue à moitié deſcoiffee?	D'où vient que ici la trouve à moitié décoiffe?
Que dans ſon eſtomach ſa voix eſt eſtouffee?	Que dans son estomac sa voix est estouffee?
Et que par des ſanglots coup ſur coup eſlanceZ Elle imite la rage ou ſont les inſenſeZ:	Et que par des sanglots coup sur coup élancez Elle imite la rage ou sont les insensés:
Il s’en faut eſclaircir, douteuſe, i’apprehende Eliante d’ou vient vne fureur ſi grande?	Il s'en faut éclaircir, douteuse, j'appréhende Éliante d'ou vient une fureur si grande?
ELIANTE.	ÉLIANTE.
Ah ne m'approchez pas, qu’auecque le deſſein De plonger vn couſteau dans ce coupable ſein.	Ah ne m'approchez pas, qu'avec le dessein De plonger un couteau dans ce coupable sein.
CLORISE.	CLORISE.
Ie tremble à ce diſcours,	Je tremble à ce discours,
ELIANTE.	ÉLIANTE.
I’ay commis vne iniure Embturturt vorrible à toute la Nature.	J'ai commis sez injure Embturturt vorrible à toute la Nature.
CLORISE.	CLORISE.
Ne la ſçauray-ie point?	Ne la saurai-je point?
ELTANTE.	ÉLTANTE.
Ah ie vous ay rauy Vn bien que mon trespas deuroit auoir ſuiuy.	Ah ici vous ai ravi Vn bien que mon trépas devrait avoir suivi.
CLORISE.	CLORISE.
Ce propos me remet en de nouuelles peines, De frayeur tout mon ſang ſe fige dans mes veines;	Ce propos me remet en de nouvelles peines, De frayeur tout mon sang se fige dans mes veines;
Ma cõpagne eſloignons tant de mots ſuperflus, Dittes tout hardiment.	Ma cõpagne éloignons tant de mots superflus, Dittes tout hardiment.
ELIANTE.	ÉLIANTE.
Dieux Alidor n’eſt plus	Dieux Alidor n'est plus
Qui l'a tué?	Qui l'a tué?
CLORISE.	CLORISE.
ELIANTE.	ÉLIANTE.
C’eſt moy, mon iniuſte priere Eſt cauſe que ſes yeux ont perdu la lumiere, Et que, precipité du haut de ce Rocher, Lignon a triomphé de ce gage ſi cher.	C'est moi, mon injuste prière Est cause que ses yeux ont perdu la lumière, Et que, précipité du haut de ce Rocher, Lignon a triomphé de ce gage si cher.
CLORISE.	CLORISE.
Deplorable accident!	Déplorable accident!
mais qui l’a veu?	mais qui l'a vu?
ELIANTE.	ÉLIANTE.
Moy-meſme, Contrainte de ceder à ce malheur extreme, Car i'en eſtois ſi loing qu'a peine iuſqu'a luy Pouuois-ie faire aller ma voix & mon ennuy.	Moi-même, Contrainte de céder à ce malheur extrême, Car j'en étais si loin qu'a peine jusqu'a avait Pouvais-je faire aller ma voix et mon ennui.
CLORISE.	CLORISE.
Que ie plains Philidan que ſa douleur me touche	Que ici plains Philidan que sa douleur me touche
ELIANTE.	ÉLIANTE.
I'ay trouué le moyen de luy fermer la bouche	J'ai trouvé le moyen de Seigneur fermer la bouche
E ij Car ie le vangeray, mais le voicy qui vient	 Ej Car ie le vengerai, mais le voici qui vient
SCENE QVATRIESME.	SCÈNE QUATRIÈME.
PHILIDAN, CLORISE, ELIANTE.	PHILIDAN, CLORISE, ÉLIANTE.
PHILIDAN.	PHILIDAN.
Ergeres quel diſcours vos esprits entreD tient?	Ergères quel discours vos esprits entreD tient?
CLORISE.	CLORISE.
Laperte d aiudor,	Laperte d aiudor,
PHILIDAN.	PHILIDAN.
Depuis quand auenuë?	Depuis quand avenue?
CLORISE.	CLORISE.
Qu'elle te la raconte, elle ſeule l’a veuë	Qu'elle te la raconte, elle seule l'a vue
PHILIDAN.	PHILIDAN.
Hienenuonte plus, Destins malicieux!	Hienenuonte plus, Destins malicieux!
I'en voy toute l’hiſtoire eſcrite dans ces yeux:	J'en vois toute l'histoire écrite dans ces yeux:
O Ciel!	Ô Ciel!
eh que faut-il que ta faueur m'octroye, Ne m'ayant plus laißé de matiere de ioye;	Eh que faut-il que ta faveur m'octroie, Ne m'ayant plus laisse de matière de joie;
Malheureux que ie ſuis!	Malheureux que Seigneur suis!
ELIANTE.	ÉLIANTE.
Berger conſole toy, Ou pluſtoſt dans ton mal ne querelle que moy;	Berger console toi, Ou plutôt dans ton mal ne querelle que moi;
Le trespas d’Alidor ioint à ta ſeruitude Me condamne enuers toy de double ingratitude, Ie recognois ma faute, & ſcay bien que ie doibs Pour ce double peché mourir plus d’vne fois.	Le trépas d'Alidor joint à ta servitude Me condamne envers toi de double ingratitude, Je reconnais ma faute, et sais bien que je doibs Pour ce double péché mourir plus d'une fois.
Permets donc ô berger que ma fin auancee Tire vn double pardon de ton ame offenſee, Adieu, i ay rencontre dedans mon ſouuenir Dequoy te ſatisfaire & dequoy me punir.	Permets donc ô berger que ma fin avancée Tire un double pardon de ton âme offensée, Adieu, j' ai rencontre dedans mon souvenir Dequoy te satisfaire et dequoi me punir.
CLORISE.	CLORISE.
Dieux ſa raiſon ſe perd dans l’exces de ſa rage, Suiuez là Philidan i’ay peur qu'elle s’outrage.	Dieux sa raison se perd dans l'excès de sa rage, Suivez là Philidan j'ai peur qu'elle s'outrage.
Seule c'eſt à ce coup que ie puis librement Donner ce que ie doibs a mon reſſentiment, C’eſt icy mon berger qu’vn trespas legitime Nous vangera tous deux de l’exces de mon crime.	Seule c'est à ce coup que je puis librement Donner ce que je crois a mon ressentiment, C'est ici mon berger qu'un trépas légitime Nous vengera tous deux de l'excès de mon crime.
Donc mes yeux, permetteZ qu’vne ſource de pleurs Puiſſe acheuer ma vie auecque mes malheurs;	Donc mes yeux, permettez qu'une source de pleurs Puisse achever ma vie avec mes malheurs;
Et que pour obliger noſtre commune flame Par ou ie pris ſon cœur ie luy rende moname.	Et que pour obliger notre commune flamme Par ou un grand son cœur ie lui rende monme.
Toy Lignon dont les eaux triomphent de mon bien Ne crains pas de faillir en receuant le ſien,	Toi Lignon dont les eaux triomphent de mon bien Ne crains pas de faillir en recevant le sien,
SCENE CINQVIESME.	SCÈNE CINQUIÈME.
ALIDOR, CLORISE,	ÀLIDOR, CLORISE,
ALIDOR.	ÀLIDOR.
Ll’a ſceu l’accident,	Ll'a su l'accident,
L  eNaL.	 LNaL.
Preſente à mon enuie L’endroit ou i’ay perdu la moitié de ma vie, Et ſi quelque pitié te touche de mon deuil Pour vn meſme deſir ouure vn meſme Cercueil :	Présente à mon envie L'endroit ou j'ai perdu la moitié de ma vie, Et si quelque pitié te touche de mon deuil Pour un même désir ouvre un même Cercueil :
Et toy pauure Berger, à qui mon iniuſtice A pu faire ſouffrir ce funeſte ſupplice, Si les lieux ou tu vis deſpouillé de ton corps Souffrent que les Mortels ſoient dans l’esprit des morts, Reçoy mon repentir, & voy ce que m'inſpire Ce Dieu qui nous rangea deſſous vn meſme Empire.	Et toi pauvre Berger, à qui mon injustice A pu faire souffrir ce funeste supplice, Si les lieux ou tu vis dépouillé de ton corps Souffrent que les Mortels soient dans l'esprit des morts, Reçois mon repentir, et vois ce que m'inspire Ce Dieu qui nous rangea dessous un même Empire.
Iuſqu’icy le reſpect m'a fait celer mes feux, Il m'a fait oppoſer ma rigueur a tes vœux, nfun le tuymeu pomtunt, & deſſous cette feinte Ie cachois vne forte, & veritable atteinte.	Jusqu'ici le respect m'a fait celer mes feux, Il m'a fait opposer ma rigueur a tes vœux, nfun le le pomtunt, et dessous cette feinte Je cachais une forte, et véritable atteinte.
ALIDOR.	ÀLIDOR.
Douce confeßion.	Douce confession.
CLORISE.	CLORISE.
Mais ceje trop diſcourir Penſant à mon berger i’oubliois de mourir,	Mais ceje trop discourir Pensant à mon berger j'oubliais de mourir,
Cloriſe?	Clorise?
ALIDOR.	ÀLIDOR.
E iiuj	E iiuj
CLORISE.	CLORISE.
Qui m'appelle?	Qui m'appelle?
ALIDOR.	ÀLIDOR.
Attends moy	Attends moi
CLORISE.	CLORISE.
Quel ſpectacle.	Quel spectacle.
Les Dieux en cette mort ont ils fait vn miracle?	Les Dieux en cette mort ont ils fait un miracle?
Ah ne m'approche point doux fantoſme & trompeur, Mon ſort veut que ie meure autrement que de peur:	Ah ne m'approche point doux fantôme et trompeur, Mon sort veut que de meure autrement que de peur:
Arreſte encor vn coup Cloriſe t’en coniure Que ſi tu viens icy pour vanger ton iniure, Chere Ombre attends vn peu mon tombeau n’eſt pas loin Voudrois-tu refuſer d’en eſtre le teſmoin?	Arrête encor un coup Clorise t'en conjure Que si tu viens ici pour venger ton injure, Chère Ombre attends un peu mon tombeau n'est pas loin Voudrais-tu refuser d'en être le témoin?
AIIDOR.	ÀIIDOR.
Mdu le ne fun puomort,	Médu le ne fun puomort,
CLORISE.	CLORISE.
Non pas dedans mon ame, Ton nom s’y void eſcrit en des lettres de flame, Et l’Amour, doux vainqueur, a voulu d’vn beau trait Y grauer pour iamais ton aymable pourtrait.	Non pas dedans mon âme, Ton nom s'y voit écrit en des lettres de flamme, Et l'Amour, doux vainqueur, a voulu d'Un beau trait Y graver pour jamais ton aimable pourtrait.
ALIDOR.	ÀLIDOR.
Tu donnes des faueurs à mon ame rauie Qui me feront mourir dequoy ie ſuis en vie, Ie voudrois en effet auoir quitté le iour Si de ma ſeule mort doit naiſtre ton amour.	Tu donnes des faveurs à mon âme ravie Qui me feront mourir de quoi apprendre en vie, Je voudrais en effet avoir quitté le jour Si de ma seule mort doit naître ton amour.
Mais Cloriſe,	Mais Clorise,
CLORISE.	CLORISE.
Pour Dieu!	Pour Dieu!
demeure, ahcheres Manes Pouuez-vous bien ſouffrir l’entretien des prophanes?	demeure, ahcheres Manes Pouvez-vous bien souffrir l'entretien des prophanes?
Attendez que ie viue aux lieux, ou les Amants N’ont plus rién qui s’oppoſe à leurs contentellienta y Ou l’ame, loing du corps qui l’auoit detenuë, Sans crime laiſſe voir ſa beauté toute nuë.	Attendez que ici vive aux lieux, ou les Amants N'ont plus rién qui s'oppose à leurs contentellienta y Ou l'âme, loin du corps qui l'avait détenue, Sans crime laisse voir sa beauté toute nue.
ALIDOR.	ÀLIDOR.
Cloriſe ie vous iure vne ſeconde fois Que ce corps animé ſert d’organe à ma voix.	Clorise ie vous jure une seconde fois Que ce corps animé sert d'organe à ma voix.
Que mon treſpas eſt feint, & ma foy veritable.	Que mon trépas est feint, et ma foi véritable.
Mais on tient qu’vn esprit ne peut eſtre palpable Donnez moy voſtre main,	Mais on tient qu'un esprit ne peut être palpable Donnés moi votre main,
CLORISE.	CLORISE.
Foferon te toucher Si ie meurs ſeulement de peur de t’approcher?	Foferon te toucher Si ici meurs seulement de peur de t'approcher?
ALIDOR.	ÀLIDOR.
Pour peu que vous puißiez dißiper cette crainte, Deux mots vous apprendront le ſucces de ma feinte:	Pour peu que vous passiez dissiper cette crainte, Deux mots vous apprendront le succès de ma feinte:
4 de venen temegnern,	4 de venen temegnern,
CLORISE.	CLORISE.
Inſolent que fais-tu?	Insolent que fais-tu?
ALIDOR.	ÀLIDOR.
Ie rends à voſtre esprit ſa premiere vertu.	Je rends à votre esprit sa première vertu.
CLORISE.	CLORISE.
Ce remede eſt faſcheme, tonttjon enenſable Puis qu’il m’eſt de ta vie vne preuue agreable;	Ce remède est fâcheme, tontion enensable Puis qu'il m'est de ta vie une preuve agréable;
Mais n'y retourne plus, & dy moy cependant L’origine & la fin de ce faux accident.	Mais n'y retourne plus, et dis -moi cependant L'origine et la fin de ce faux accident.
ALIDOR.	ÀLIDOR.
Lors que voſtre rigueur vn peu trop violente M'a preſcrit de mourir ou d’aymer Eliante, Car i’appelle mourir eſtre eſloigné de vous, Le treſpas m'a ſemblé plus facile & plus doux:	Lors que votre rigueur un peu trop violente M'a prescrit de mourir ou d'aimer Éliante, Car j'appelle mourir être éloigné de vous, Le trépas m'a semblé plus facile et plus doux:
De ſorte que i’allois mettre fin à ma vie Si perſonne n’euſt mis d’obſtacle à mon enuie.	De sorte que j'allais mettre fin à ma vie Si personne n'eût mis d'obstacle à mon envie.
Mais Philidan touché de mon affliction Par l’intereſt du ſang, & de l’affection, Cher frere, m’a-til dit, contre tant d’iniuſtice Nous pouuons ſans offenſe oppoſer l’artifice:	Mais Philidan touché de mon affliction Par l'intérêt du sang, et de l'affection, Cher frère, m'a-til dit, contre tant d'injustice Nous pouvons sans offense opposer l'artifice:
FeigneZ donc de quitter le ſoin de vos brebis, Mettons force cailloux dans l’vn de vos habits Et puis le rempliſſant de fueillage, ou de chaume, Le mieux qu’il ſe pourra formons-en vn fantoſme;	Feignez donc de quitter le soin de vos brebis, Mettons force cailloux dans l'un de vos habits Et puis le remplissant de fueillage, ou de chaume, Le mieux qu'il se pourra formons-en un fantôme;
Nous le ferons porter tout contre ces rochers Dont le faſcheux abord fait paſlir les Nochers,	Nous le ferons porter tout contre ces rochers Dont le fâcheux abord fait pâlir les Nochers,
Et là quand vous aureZ d’vne plainte commune Blaſphemé contre Amour, & contre la Fortune, De qui la Tyrannie ouure voſtre tombeau, Vous precipiterez ce fantoſme dans l’eau, Qui ne paroiſtra plus, car les pierres maſsiues Ne permettront iamais qu’il approche les riues.	Et là quand vous aurez d'une plainte commune Blasphemé contre Amour, et contre la Fortune, De qui la Tyrannie ouvre ou tombeau, Vous précipiterez ce fantôme dans l'eau, Qui ne paraîtra plus, car les pierres massiues Ne permettront jamais qu'il approche les rives.
Le bruit de voſtre mort courra tout le Foreſts, Peut-eſtre que Cloriſe en fera des regrets, Et qu’vn vif repentir pourra plus ſur ſon ame Que n’a fait iuſqu'icy le Temps ny voſtre flame Eliante en aura beaucoup de deſplaiſir, Mais n’ayant plus d’eſpoir, que fera ſon deſir?	Le bruit de votre mort courra tout le Forêts, Peut-être que Clorise en fera des regrets, Et qu'un vif repentir pourra plus sur son âme Que n'a fait jusqu'ici le Tempsîle votre flamme Éliante en aura beaucoup de déplaisir, Mais n'ayant plus d'espoir, que fera son désir?
Sans doute qu’il mourra, le temps qui tout efface Luy fermera ſon cœur & m’ouurira ſa grace.	Sans doute qu'il mourra, le temps qui tout efface Lui fermera son cœur et m'ouvrira sa grâce.
Voila tout le diſcours que mon frere m’a fait Qui de fort peu de temps a preuenu l’effect, Mais lors que ie cherchois vn teſmoin de ma perte De hazard Eliante à mes yeux s’eſt offerte, Qui par cette action trompee heureuſement Me croit enſeuely dans t'humide Element.	Voilà tout le discours que mon frère m'a fait Qui de fort peu de temps à prévenu l'effet, Mais lors que ie cherchais un témoin de ma perte De hasard Éliante à mes yeux s'est offerte, Qui par cette action trompe heureusement Me croit enseveli dans t'humide Élément.
CLORISE.	CLORISE.
Ell'eſt de ce treſpas encor deſesperee,	Elle est de ce trépas encor désespérée,
ALIDOR.	ÀLIDOR.
Mais quoy ſi de mon ſang voſtre ame eſt alteree, Si ma feinte vous faſche, & s’il faut que ma voix Murmure encor vn coup de vos iniuſtes loix, Vn moment differé me rendroit trop coupable Ie ſuis preſt de chercher vne mort veritable Bergere commandeZ.	Mais quoi si de mon sang votre âme est altère, Si ma feinte vous fâche, et s'il faut que ma voix Murmure encor un coup de vos injustes lois, Un moment différé me rendrait trop coupable Je suis prêt de chercher une mort véritable Bergère commandez.
CLORISE.	CLORISE.
Alidor leue toy, Tu n’auras plus ſuiet de te plaindre de moy:	Alidor lève toi, Tu n'auras plus sujet de te plaindre de moi:
Ie t’ayme, ie l’auouë, & pourueu que ton ame Mette en meſme degré mon deuoir, & maflame, Qu'vn reſpect eternel anime tes deſirs, Tu conduiras ma vie au gré de tes plaiſirs.	Je t'aime, Seigneur l'avoue, et pourvu que ton âme Mette en même degré mon devoir, et maflame, Qu'un respect éternel anime tes désirs, Tu conduiras ma vie au gré de tes plaisirs.
I’en dis trop Alidor pour le ſiecle ou nous sõmes, Ou l'Art de conſeruer la liberté des hommes Conſiſte en la rigueur, car la facilité Eſt vn puiſſant obſtacle a leur fidelité.	J'en dis trop Alidor pour le siècle ou nous sommes, Ou l'Art de conserver la liberté des hommes Consiste en la rigueur, car la facilité Est un puissant obstacle à leur fidélité.
ALIDOR.	ÀLIDOR.
Cloriſe, ſi les loix que vous m’auez preſcrittes Au milieu de mon cœur ne demeurent eſcrittes, Et ſi iamais mon ame en perd le ſouuenir Que le Ciel ennemy commence à me punir:	Clorise, si les lois que vous m'avez prescrittes Au milieu de mon cœur ne demeurent écrittes, Et si jamais mon âme en perd le souvenir Que le Ciel ennemi commence à me punir:
Mais rendez s’il ſe peut Eliante guerie, TireZ la tout a faict de ceſte reſuerie De peur qu’elle s’obſtine a nous faire du mal, Vous ſçauez qu’a mon bien ſon deſir eſt fatal de quumum que erosferte fon amoureuſe enuit Autant elle verra diminuer ma vie.	Mais rendez s'il se peut Éliante guérie, Tirez la tout a fait de cette rêverie De peur qu'elle s'obstine à nous faire du mal, Vous savez qu'a mon bien son désir est fatal de quum que erosferte son amoureuse enuit Autant elle verra diminuer ma vie.
Mais la voicy qui vient,	Mais la voici qui vient,
CLORISE.	CLORISE.
Son viſage a chaße Tous les traits qui marquoient ſon deſplaiſi paßé.	Son visage a chasse Tous les traits qui marquaient son déplaisi passé.
SCENE CINQVIESME.	SCÈNE CINQUIÈME.
ELIANTE PHILIDAN.	ÉLIANTE PHILIDAN.
MEIDOR CLORIOE.	MEIDOR CLORIOE.
ELIANTE.	ÉLIANTE.
Outce que tu m’as dit me plaiſt & me I conſole Mais berger haſte-toy d’obſeruer ta parolle;	Outce que tu m'as dit me plaît et me I console Mais berger hâte-toi d'observer ta parole;
LHEBIEAICO Si vous ne me teniez la voſtre eſgallement Vous me ferieZ mourir;	LHÉBIEAICO Si vous ne me teniez la vôtre également Vous me ferieZ mourir;
ELIANTE.	ÉLIANTE.
Allons, ah ie le vois N'en doute nullement	Allons, ah ie le vois N'en doute nullement
PHILIDAN.	PHILIDAN.
Et bien eſt-ce vn menſonge?	Et bien est-ce un mensonge?
ELIANTE.	ÉLIANTE.
Certes ces accidens ne me ſemblent qu’vn ſonge Arbitres des mortels que mon ſort eſt mutin, Mais qui peut s’oppoſer aux arreſts du Deſtint Ma Compagne, vn remords bleſſe ma conſcience Et m’oblige à venir reparer vne offenſe Auiourd’huy par amour commiſe contre amour, La raiſon vient en moy triompher à ſon tour, Et m'apprend qu’vn esprit a la gloire ſenſible Ne doit iamais tenter vne choſe impoßible.	Certes ces accidents ne me semblent qu'Hir songe Arbitres des mortels que mon sort est mutin, Mais qui peut s'opposer aux arrêts du Destint Ma Compagne, un remords blesse ma conscience Et m'oblige à venir réparer une offense Auiourd’ces par amour commise contre amour, La raison vient en moi triompher à son tour, Et m'apprend qu'un esprit à la gloire sensible Ne doit jamais tenter une chose impossible.
En cela i’ay failly penſant que ce berger Deuſt ſortir de vos fers & deuenir leger, Eſtrange aueuglement, puiſqu’aupres de vos charmes Il n'eſt point de beauté qui ne rende les armes.	En cela j'ai failli pensant que ce berger Deust sortir de vos fers et devenir léger, Étrange aveuglement, puisqu'auprès de vos charmes Il n'est point de beauté qui ne rende les armes.
Mais à ce coup remiſe en mon premier deuoir Ie vous cede le bien que ie voulois auoir, De ce berger ſouſmis triomphez à voſtre aiſe, Et ſur tout que vos feux entretiennent ſa braiſe Ie veux que vous l’aymiez.	Mais à ce coup remise en mon premier devoir Je vous cède le bien que je voulais avoir, De ce berger sousmis triomphez à votre aise, Et sur tout que vos feux entretiennent sa braise Je veux que vous l'aimiez.
ALIDOR.	ÀLIDOR.
Ah que cette pitié M'attache auecque vous d’vne eſtrotte amitié, Ie vous de vou don mon repos.	Ah que cette pitié M'attache auecque vous d'une étrotte amitié, Je vous de vou on mon repos.
ELIANTE.	ÉLIANTE.
Faſſent les deſtinees Qu'il ne puiſſe finir qu'auecque tes annees.	Fassent les destinées Qu'il ne puisse finir qu'avec tes années.
CLORISE.	CLORISE.
1 Qteecauis nefait uimaniinonunc ement bien prompt?	1 Qteecavis nefait uimaniinonunc ement bien prompt?
ELIANIE.	ÉLIANIE.
Certes i’en porte encor la honte ſur le front,	Certes j'en porte encor la honte sur le front,
CLORISE.	CLORISE.
Cela ne prouient pas d’vne cauſe commune,	Cela ne prouient pas d'une cause commune,
ELIANTE.	ÉLIANTE.
Ie croy que c'eſt vn ieu d’Amour & de Fortune:	Je crois que c'est un jeu d'Amour et de Fortune:
Vous ſçauez que croyant Alidor expiré Mon eſprit a paru comme deſesperé, Et i’euſſe aſſeurément attenté ſur ma vie Mais par voſtre conſeil Philidan m’a ſuiuie Qui voyant ma fureur a voulu ſagement Retirer mon esprit de ce forcenement.	Vous savez que croyant Alidor expiré Mon esprit a paru comme désespéré, Et j'eusse assurément attenté sur ma vie Mais par votre conseil Philidan m'a suivie Qui voyant ma fureur a voulu sagement Retirer mon esprit de ce forcènement.
Il m’a donc raconté toute la tromperie De ſorte qu'arreſtant l’effet de ma furie, 0 Il a ſceu me guerir, mais à condition Que ie ſerois ſenſible à ſon affection;	Il m'a donc raconté toute la tromperie De sorte qu'arrêtant l'effet de ma furie, 0 Il a su me guérir, mais à condition Que je serais sensible à son affection;
Et que i’employerois des ſoings pour me diſtraire, De cette paßion que i’auois pour ſon frere.	Et que j'employerais des soins pour me distraire, De cette passion que j'avais pour son frère.
Depuis vos intereſts aux ſiens ſe ſont meſlez Pour rendre la lumiere à mes ſens aueugleZ, Si bien qu’vn peu d’effort m’a donné la victoire D’vn combat que l’amour oppoſoit à ma S 2.	Depuis vos intérêts aux siens se sont mêlez Pour rendre la lumière à mes sens aveugleés, Si bien qu'un peu d'effort m'a donné la victoire D'un combat que l'amour opposait à ma S 2.
C’est de mon changement & la cauſe & l'effeet.	C'est de mon changement et la cause et l'effet.
PHILIDAN.	PHILIDAN.
Que d'extremes faueurs voſtre bonte me fait,	Que d'extrêmes faveurs votre bonté me fait,
CLORISE.	CLORISE.
Que le deſtin eſt fort	Que le destin est fort
ALIDOR.	ÀLIDOR.
Ses loix inuiolables Nous font comme il leur plaiſt heureux ou miſerables.	Ses lois inviolables Nous font comme il leur plaît heureux ou misérables.
ELIANTE.	ÉLIANTE.
Ma Compagne il eſt temps de finir nos ennuis, Pour moy i’ayme ſi fort le repos ouie ſuis, Qu’auant que Philidan meure dedans mon ame Nos ruiſſeaux produiront vne ſource de flame.	Ma Compagne il est temps de finir nos ennuis, Pour moi j'aime si fort le repos ouïe suis, Qu'avant que Philidan meure dedans mon âme Nos ruisseaux produiront une source de flamme.
PHILIDAN.	PHILIDAN.
Aintmua qne tejels dgd de qyaucrer Le Soleil n’aura plus le pouuoir d’eſclairer.	Aintmua qne tejels dgd de qyaucrer Le Soleil n'aura plus le pouvoir d'éclairer.
ALIDOR.	ÀLIDOR.
Mon amour durera beaucoup plus que le monde Et la voſtre mon cœur?	Mon amour durera beaucoup plus que le monde Et la vôtre mon cœur?
CLORISE.	CLORISE.
Croy qu'elle eſt ſans ſeconde.	Crois qu'elle est sans seconde.
Mais depuis trop tong iepreeeynons entretient, Voicy l’heure à peu pres que mon pere reuient Il faut que ie m'en aille,	Mais depuis trop tong iepreeeynons entretient, Voici l'heure à peu pres que mon père revient Il faut que ie m'en aille,
ALIDOR.	ÀLIDOR.
Adieu belle bergere,	Adieu belle bergère,
ELIANTE.	ÉLIANTE.
Iuſqu’a tantoſt,	Jusqu'a tantôt,
PHILIDAN.	PHILIDAN.
Adieu mais ne ſois plus legere.	Adieu mais ne sois plus légère.
Fij	Fij
ALIDOR.	ÀLIDOR.
Que ton inuention nous oblige tous deux,	Que ton invention nous oblige tous deux,
I HILIDA Truu nui pouuions attendre vn ſucces plus heureux.	I HILIDA Tru nui pouvions attendre un succès plus heureux.
ACTE QVATRIESME.	ACTE QUATRIÈME.
SCENE PREMIERE.	SCÈNE PREMIÈRE.
PHILIDAN, ELIANTE.	PHILIDAN, ÉLIANTE.
PHILIDAN.	PHILIDAN.
H que ie ſuis raui, d’entendre de ta bouche Que de mes maux paſſez le repentir te touche;	H que ici suis ravi, d'entendre de ta bouche Que de mes maux passez le repentir te touche;
Pour peu que ta rigueur ceſſe de m’affliger, Tu deuiendras ſçauante en l’art de m'obliger.	Pour peu que ta rigueur cesse de m'affliger, Tu deviendras sçauante en l'art de m'obliger.
ELIANTE.	ÉLIANTE.
C’eſt ainſi que l’on void apres vn grand orage Le Soleil ſe montrer auec vn beau viſage:	C'est ainsi que l'on voit après un grand orage Le Soleil se montrer toujours un beau visage:
ii	ji
PHILIDAN.	PHILIDAN.
Tu dis la verité, ie croy qu’auec raiſon On ne peut dementir cette comparaiſon;	Tu dis la vérité, je crois qu'avec raison On ne peut démentir cette comparaison;
Comme toy le Soleil eſchauffe tout le monde, Il porte comme toy la cheuelure blonde, Le iour luy doibt ſa fin & ſon commencement, Et moy ie doibs mon iour à tes yeux ſeulement, Car eſloigné de toy, mille ſoucis funebres Abandonnent mon ame a l'horreur des tenebres.	Comme toi le Soleil échauffe tout le monde, Il porte comme toi la cheelure blonde, Le jour lui doibt sa fin et son commencement, Et moi -même doibs mon jour à tes yeux seulement, Car esloigné de toi, mille soucis funèbres Abandonnent mon âme a l'horreur des ténèbres.
ELIANTE.	ÉLIANTE.
Menteur tout ce diſcours n’a pas vn bon obiect Exerce ton esprit ſur vn meilleur ſuiect:	Menteur tout ce discours n'a pas un bon objet Exerce ton esprit sur un meilleur sujet:
PHILIDAN.	PHILIDAN.
Ou veux-tu que i’en trouue vn autre qui me plaiſe?	Ou veux-tu que j'en trouve un autre qui me plaise?
Si tu n’es mon obiect il faut que ie me taiſe, Parlons de ton corſage, où de ce teint ſi blanc Quſſemble à des lys moüillez d’vn peu de ſang;	Si tu n'es mon objet il faut que je me taise, Parlons de ton corsage, où de ce teint si blanc Qussemble à des lys mouillez d'un peu de sang;
Diſcourons de ton ſein qui par vn priuilege En deſpit des chaleurs conſerue de la Neige.	Discourons de ton sein qui par un privilège En dépit des chaleurs conserve de la Neige.
ELIANTE.	ÉLIANTE.
Tume flattes touſiours d’vne meſme façon, Mais, berger, faisõs mieux, disõs cette chãſon Que Tirſis autrefois compoſa pour Syluie,	Tume flattes toujours d'une même façon, Mais, berger, faisons mieux, disons cette chandson Que Tirsis autrefois composa pour Syluie,
PHILIDAN.	PHILIDAN.
Elle conuient fort bien à l’eſtat de ma vie.	Elle convient fort bien à l'état de ma vie.
CHANSON EN DIALOGVE.	CHANSON EN DIALOGUE.
ELIANTE ET PHILIDAN.	ÉLIANTE ET PHILIDAN.
Elian.	Elian.
Quell' eſt ton amour, reſponds moy?	Quel est ton amour, réponds moi?
Phil.	Phil.
Ell’eſt egalle à ton merite, Elian.	Elle est égale à ton mérite, Elian.
Berger, ell’eſt donc bien petite, Phil.	Berger, elle a donc bien petite, Phil.
Ell' eſt parfaitte comme toy.	Elle est parfaite comme toi.
Elian.	Elian.
Et ſi tu ments, Phil.	Et si tu mens, Phil.
Que le Ciel me puniſſe, Eliante & Philidan enſemble.	Que le Ciel me punisse, Éliante et Philidan ensemble.
Dieux!	Dieux!
inuentez vn ſupplice Pour les pariures amants.	inventez un supplice Pour les parjures amants.
Elian.	Elian.
Combien en durera le cours?	Combien en durera le cours?
Phil.	Phil.
Autant que durera mon ame, Elian.	Autant que durera mon âme, Elian.
Le temps eſteindra cette flame, .	Le temps éteindra cette flamme, .
, Fuij Phil.	, Fuij Il.
Pluſtoſt il eſteindra mes iours.	Plutôt il éteindra mes jours.
Elian.	Elian.
Et ſi tu ments, Phil.	Et si tu mens, Phil.
Que le Ciel me puniſſe, Eliante & Philidan enſemble.	Que le Ciel me punisse, Éliante et Philidan ensemble.
Dieuxummez ton fupptite Pour les pariures amants.	Dieuxummez ton fupptite Pour les parjures amants.
PHILIDAN.	PHILIDAN.
Veux-tu bien m’obliger?	Veux-tu bien m'obliger?
confeſſe à cette fois Que nos cœurs ſont d’accord außi bien que nos voix,	confesse à cette fois Que nos cœurs sont d'accord aussi bien que nos voix,
ELIANTE.	ÉLIANTE.
Ie leveuxore, pomrneuqut iamantu ne ſortes Des termes du reſpect qu’il faut que tu me portes:	Je leveuxore, pomrneuqut jamantu ne sortes Des termes du respect qu'il faut que tu me portes:
.	.
PHILIDAN.	PHILIDAN.
Que tu me fais de tort ſeulement d’y penſer, Croy que ma paßion ne ſçauroit t’offenſer:	Que tu me fais de tort seulement d'y penser, Crois que ma passion ne saurait t'offenser:
Ie choiſirois pluſtoſt les morts les plus cruelles Que de faire un outrage à la Reine des belles.	Je choisirais plutôt les morts les plus cruelles Que de faire un outrage à la Reine des belles.
ELIANTE.	ÉLIANTE.
C’eſt trop, ie ne ſçaurois plus long temps conſentir A t’aymer & te voir capable de mentir.	C'est trop, Seigneur ne saurais plus long temps consentir A t'aimer et te voir capable de mentir.
PHILIDAN.	PHILIDAN.
Si de ce que i’ay dit, ta rigueur trop cognuë Cherche la verité, &la voilà toute nuë.	Si de ce que j'ai dit, ta rigueur trop connue Cherche la vérité, etla voilà toute nue.
ELIANTE.	ÉLIANTE.
Que fais-tu Philidan?	Que fais-tu Philidan?
PHILIDAN.	PHILIDAN.
C’eſt que ie veux au moins Vous conuaincre d'erreur duec deux beaux teſmoins	C'est que personne veux au moins Vous convaincre d'erreur du deux beaux témoins
ELIANTE.	ÉLIANTE.
Cauſeur, rends ce mouchoir, Xou de tant de, ,yeremalices At jyauray enaſtier t'Auinen, &tes coplices.	Causeur, rends ce mouchoir, Xou de tant de, ,yeremalices jyauray enastier t'Auinen, ettes coplices.
ſe cou	se cou
PHILIDAN.	PHILIDAN.
Pourquoy les caches-tu?	Pourquoi les caches-tu?
ELIANTE.	ÉLIANTE.
Pource que i’ay raiſon, Puis qu’ils ſont faux-teſmoins, de les mettre MFJeis	Pource que j'ai raison, Puis qu'ils sont faux-témoins, de les mettre MOJeis
PHILIDAN.	PHILIDAN.
Ie meure, ta penſée eſt aimable & gentille, Il me ſemble les voir à trauers vne grille:	Je meure, ta pensée est aimable et gentille, Il me semble les voir à travers une grille:
*-	*-
ELIANTE.	ÉLIANTE.
Tu ne les verras plus.	Tu ne les verras plus.
I --	I --
PHILIDAN.	PHILIDAN.
Inhumaine, pourquoy?	Inhumaine, pourquoi?
ELIANTE.	ÉLIANTE.
Ils t’ont donné ſuiet de te moquer de moy.	Ils t'ont donné sujet de te moquer de moi.
PHILIDAN.	PHILIDAN.
Au moins, ſi tes rigueurs ne ſont du tout extremes Vn baiſer deſrobé m’apprẽdra ſi tu m’aimes:	Au moins, si tes rigueurs ne sont du tout extrêmes Un baiser dérobé m'apprendra si tu m'aimes:
ELIANTE.	ÉLIANTE.
Sois diſcret, Philidan, ou ie te vay punir, Fay toſt voila Phedon:	Sois discret, Philidan, ou ainsi te vais punir, Fais tôt voilà Phédon:
PHILIDAN.	PHILIDAN.
Ouytete deſſcvenir.	Ouitette desscvenir.
SCENE SECONDE.	SCÈNE SECONDE.
THEDON.	THÉDON.
CLORISE.	CLORISE.
E te veux marier, Cloriſe ie le lure IAutremẽt i’ẽfreindroisles loix de la nature	E te veux marier, Clorise ie le lure IAutremẽt j'enfreindraisles lois de la nature
CLORISE.	CLORISE.
Quelle neceßité de meſloigner de vous?	Quelle necessité de mêloigner de vous?
PHEDON.	PHÉDON.
Cela ne ſera point, Eraſte ton eſpoux,	Cela ne sera point, Éraste ton époux,
Ayant ſes biens enclos dans noſtre voiſinage, Nous ne ſerons iamais ſeparez de meſnage.	Ayant ses biens enclos dans notre voisinage, Nous ne serons jamais séparés de ménage.
Mais d’ou viẽt que tõ ame oppoſe à mes plaiſirs Vn eſprit eſloigné de ſemblables deſirs?	Mais d'ou vien que to âme oppose à mes plaisirs Un esprit éloigné de semblables désirs?
Ma fille, ſonge a toy, toutes ces belles marques Ne ſeruent qu’a dreſſer le triomphe des Parques;	Ma fille, songe a toi, toutes ces belles marques Ne servent qu'a dresser le triomphe des Parques;
Le temps fait les beautez, mais en fin il deſtruit Par vn ordre fatal tout ce qu’il a produit:	Le temps fait les beautés, mais en fin il détruit Par un ordre fatal tout ce qu'il a produit:
Ce front imperieux ſe couurira de rides, Et ces yeux, tant de fois appelleZ homicides, Deſcheus en peu de temps de leur eſclat trõpeur Sans doute, au lieu d’amour, feront mourir de peur.	Ce front impérieux se couvrira de rides, Et ces yeux, tant de fois appelez homicides, Dêcheus en peu de temps de leur éclat tromeur Sans doute, au lieu d'amour, feront mourir de peur.
Toutes les fleurs mourront qui paroiſſent écloſes, Sur ce teint tout couuert & de lys & de roſes, Et rien n’y reſtera que ce iaune ſoucy Qui paroiſt ſur vn corps que la fieure a tranſy.	Toutes les fleurs mourront qui paraissent écloses, Sur ce teint tout couvert et de lys et de roses, Et rien n'y restera que ce jaune souci Qui paraît sur un corps que la fièvre à transi.
Ce beau ſang, qui te boult auiourd’huy dans les veines, N’aura plus de vigueur que pour nourrir tes peines.	Ce beau sang, qui te boult aujourd'hui dans les veines, N'aura plus de vigueur que pour nourrir tes peines.
L’or de tes beaux cheueux prendra le teint d’argent, Les graces s’enfuiront;	L'or de tes beaux cheveux prendra le teint d'argent, Les grâces s'enfuiront;
& ce pied diligent Qui te fait admirer à la danſe, à la chaſſe, N’aura plus le pouuoir de ſortir d’vne place.	et ce pied diligent Qui te fait admirer à la danse, à la chasse, N'aura plus le pouvoir de sortir d'une place.
Ton œil s’eſtonnera de ſe voir different, Et d’eſtre ſi petit aupres d’vn nez ſi grand:	Ton œil s'étonnera de se voir différent, Et d'être si petit auprès d'vn nez si grand:
En fin cet Enbonpoint, & cette peau ſi nette, Vn iour ſeront pareils à l’horreur d’vn ſquelette.	En fin cet Enbonpoint, et cette peau si nette, Un jour seront pareils à l'horreur d'H squelette.
Alors que deuiendra l’hommage qu’on te doibt?	Alors que deviendra l'hommage qu'on te doibt?
Tous ceux qui te verront te montreront au doigt, Et diront qu’vn deffaut d’esprit, ou de merite, T’aura fait mourir fille en l’age decrepite.	Tous ceux qui te verront te montreront au doigt, Et diront qu'un défaut d'esprit, ou de mérite, T'aura fait mourir fille en l'age défrepite.
CLORISE.	CLORISE.
On n’a point de regret quand on ſe void priuer Des choſes qu’außi bien on ne peut conſeruer, L’Age preſcrit au corps vne fin neceſſaire, Mais noſtre ame n'eſt peun de jes toix tributaire;	On n'a point de regret quand on se voit priuer Es choses qu'avez bien on ne peut conserver, L'Age prescrit au corps une fin nécessaire, Mais notre âme n'est peun de jes toix tributaire;
Libre, des ſa naiſſance, elle peut en tout temps Deffendre ſes beautez de l’iniure des ans, La Vertu, qui ſe plaiſt de reſider en elle, N'eſt pas, comme le corps, d’vne eſſence mortelle, Ses charmes rauiſſants n’ont rien de limité, Ils ne peuuent finir qu’auec l’eternité.	Libre, des sa naissance, elle peut en tout temps Défendre ses beautés de l'injure des ans, La Vertu, qui se plaît de résider en elle, N'est pas, comme le corps, d'une essence mortelle, Ses charmes ravissants n'ont rien de limité, Ils ne peuvent finir qu'avec l'éternité.
Telle i’oſe esperer qu’en cet Age ou vous eſtes, Quoy que fille, i’auray des douceurs tres-parfaittes, Et quemagle cecorps qu'un fede vageſter Mon ame aura dequoy ſe faire respecter.	Telle j'ose espérer qu'en cet Age ou vous êtes, Quoi que fille, j'aurai des douceurs très-parfaittes, Et quemagle cécorez qu'un fède vagester Mon âme aura dequoy se faire respecter.
PHEDON.	PHÉDON.
Eſpoir de mes vieux ans, ceſſe de te deffendre Par de foibles raiſons de me donner vn gendre;	Espoir de mes vieux ans, cesse de te défendre Par de faibles raisons de me donner un gendre;
Tu doibs diſcrettement vſer de tes appas, Eſpargne bien le temps qui ne t’eſpargne pas:	Tu dois discrètement user de tes appas, Espargne bien le temps qui ne t'épargne pas:
Cette meſme vertu dont tu fais tant d’eſtime Te doibt faire trouuer mon deſſein legitime, Outre que ie puis tout deſſus tes volontez, Et que de mes deſirs les tiens ſont limitez.	Cette même vertu dont tu fais tant d'estime Te doibt faire trouver mon dessein légitime, Outre que je puis tout dessus tes volontés, Et que de mes désirs les tiens sont limités.
Penſe donc d’obeyr à ce que ie t’ordonne Eraſte vaut beaucoup, & i’ayme ſa perſonne Bien plus que tant de biens dont il doit heriter, peeux-tu pas en cela mon humeur contenter?	Pense donc d'obéir à ce que je t'ordonne Eraste vaut beaucoup, et j'aime sa personne Bien plus que tant de biens dont il doit hériter, peeux-tu pas en cela mon humeur contenter?
CLORISE.	CLORISE.
C’eſt m’engager trop toſt ſous les loix d’Hymenee,	C'est m'engager trop tôt sous les lois d'Hymène,
TIEBSe la C’en eſt fait toutefois ma parole eſt donnee.	TIEBSe la C'en est fait toutefois ma parole est donne.
LORTSE.	LORTSE.
Eh ne m’affligez pas d’vn mal ſi violent,	Eh ne m'affligez pas d'un mal si violent,
PHEDON.	PHÉDON.
A quel propos?	À quel propos?
en fin ce refus inſolent Aigriroit mon humeur contre ta reſiſtance, Niismiifaapaa.	en fin ce refus insolent Aigrirait mon humeur contre ta résistance, Niismiifaapa.
CLORISE.	CLORISE.
Ancruelle ſentence!	Ancruelle sentence!
PHEDON.	PHÉDON.
Leue toy les voicy fay leur vn bon accueil	Leve -toi les voici fais leur un bon accueil
CLORISE.	CLORISE.
Comme à ceux qui ſont preſts de m’ouurir vn cercueil.	Comme à ceux qui sont prêts de m'ouvrir un cercueil.
SCENE TROISIESME.	SCÈNE -TROISIÈME.
CTCENDRE, PHEDON, ERASTE.	CTCENDRE, PHÉDON, ERASTE.
CLORTSE.	CLORTSE.
NICANDRE.	NICANDRE.
I Ous voyez ſi ie ſuis exacte en ma promeſſe Phedon voila dequoy.	I Jus voyez si ici suis exacte en ma promesse Phédon voilà dequoy.
PHEDON.	PHÉDON.
C’a que ie vous careſſe, prons que tous mes deſtisreguruet autontd huy Comme de mes vieux ans l’eſperance & l'appuy.	C'a que je vous caresse, prons que tous mes destisréguruet autontd hui Comme de mes vieux ans l'espérance et l'appui.
ERASTE.	ERASTE.
Si i’ay creu meriter l’hõneur qu’õ me pourchaſſe, Que le Ciel coniuré puniſſe mon audace;	Si j'ai cru mériter l'honneur qu'on me pourchasse, Que le Ciel conjuré punisse mon audace;
Le bien dont vous allez ma fortune obliger Eſt plus digne d’vn Dieu que nõ pas d’vn berger.	Le bien dont vous allez ma fortune obliger Est plus digne d'un Dieu que nomme pas d'un berger.
Mais puis qu'vne bõté pour moy trop fauorable Fait paroiſtre qu'ell’a mon ſeruice agreable, Ie veux que ma raiſon conſente à me trahir Si ie penſe iamais à vous deſobeyr.	Mais puis qu'une bõté pour moi trop favorable Fait paraître qu'elle a mon service agréable, Je veux que ma raison consente à me trahir Si tu pense jamais à vous désobéir.
PHEDON.	PHÉDON.
Ie croy bien, que ſçachant l’amour que ie vous porte nounammois pamme puure uie paßion forte, Allez vous acquitter du deuoir d’vn Amant.	Je crois bien, que sachant l'amour que je vous porte nounammois pamme puure uie passion forte, Allez vous acquitter du devoir d'un Amant.
NICANDRE, Elle reçoit Eraſte vn peu bien froidement,	NICANDRE, Elle reçoit Eraste un peu bien froidement,
PHEDON.	PHÉDON.
Noſtre deſſein l’a miſe en d’eſtranges allarmes	Notre dessein l'a mise en d'étranges alarmes
ERASTE.	ERASTE.
Si ie viens eriger vn Autel à vos charmes, Beauté qui poſſedez tant d’aymables appas, CondamneZ leur pouuoir ou ne m'en blaſmez pas.	Si ici viens ériger un Autel à vos charmes, Beauté qui possédez tant d'aimables appas, Condamnés leur pouvoir ou ne m'en blâmez pas.
Les traits dont la Nature arma ce beau viſage, Redoutables vainqueurs, ont causé mõ ſeruage;	Les traits dont la Nature arma ce beau visage, Redoutables vainqueurs, ont causé mon servage;
Et ie fay bien cognoiſtre en cette extremité Que leur force eſt fatale à noſtre liberté:	Et été fais bien connaître en cette extrémité Que leur force est fatale à notre liberté:
La crainte toutefois que i’ay de vous desplaire Euſteſloigné du iour ce deſſein temeraire, Si ceux Si ceux qui comme vous ſont abſolus ſur moy Ne m'en euſſent preſcrit vne contraire loy.	La crainte toutefois que j'ai de vous déplaire Eustesloigné du jour ce dessein téméraire, Si ceux Si ceux qui comme vous sont absolus sur moi Ne m'en eussent prescrit contraire loi.
Donc beauté que i’adore, & pour qui ie ſouſpire, Augmentez d’vn ſubiet l’eſtat de voſtre Empire, Ertroyez que la mort ſeule me peut rauir La gloire que mon ame attend de vous ſeruir.	Donc beauté que j'adore, et pour qui ie soupire, Augmentez d'un sujet l'état de votre Empire, Eroyez que la mort seule me peut ravir La gloire que mon âme attend de vous servir.
IICMNDNE.	IICMNDNE.
Ie voy qu’à ce diſcours elle n’eſt guere eſmeuë,	Je vois qu'à ce discours elle n'est guère émue,
PHEDON.	PHÉDON.
Il parle d’vne choſe à ſon aage incogneuë.	Il parle d'une chose à son âge inconnue.
ERASTE.	ERASTE.
On dit que le ſilence eſt vn conſentement, A ce conte, ie ſuis heureux parfaittement.	On dit que le silence est un consentement, À ce conte, Elle suis heureux parfaitement.
CLORISE.	CLORISE.
Ie n’ay pour repartir que la bouche d’vn pere Qu'il ſeconde mes vœux, ou qu’il me deſespere, Il n'importe, ie cede à la neceßsité Qui le rend abſolu deſſus ma volonté.	Je n'ai pour répartir que la bouche d'Hommes père Qu'il seconde mes vœux, ou qu'il me désespère, Il n'importe, Elle cède à la necesssité Qui le rend absolu dessus ma volonté.
a Meira lnl.	à Meira lul.
La vertu dont l’eſclat paroiſt en ce langage, Adiouſte à vos beautez vn charme qui m'engage.	La vertu dont l'éclat paraît en ce langage, Adjoute à vos beautés un charme qui m'engage.
Iuſqu'à ne vouloir plus rechercher de plaiſirs S’ils n’ont quelque rapport auecque vos deſirs.	Jusqu'à ne vouloir plus rechercher de plaisirs S'ils n'ont quelque rapport apprendre vos désirs.
PHEDON.	PHÉDON.
Eraſte vn petit mot, encor qu’en apparence Vous trouuieZ ſon eſprit dans quelque indifference, Ive vous revutez pas, pour cognoiſtre l’amour Ce ſexe n’a beſoin que d’vne heure ou d’vn iour.	Eraste un petit mot, encor qu'en apparence Vous trouviez son esprit dans quelque indifférence, Ive vous revîtez pas, pour connaître l'amour Ce sexe n'a besoin que d'une heure ou d'un jour.
ERASTE.	ERASTE.
Content de ſon accueil, ie n’ay dequoy me plaindre.	Content de son accueil, ie n'ai dequoy me plaindre.
ICANDRE.	ICANDRE.
Bergere, il n’eſt plus temps de rougir ny dé fein dre, On s’en remet à vous, il ne s’agit ſinon De parler franchement, & dire ouy ou non Peut eſtre, ieune d’ans, vous trouuez fort eſtrâge Cette condition ou la voſtre ſe change;	Bergère, il n'est plus temps de rougir ni dé sein dre, On s'en remet à vous, il ne s'agit sinon De parler franchement, et dire ouï ou non Peut été, jeune d'ans, vous trouvez fort estrâge Cette condition ou la vôtre se change;
Mais ſi d’vn ſens raßis vous y ietteZ les yeux Vous verrez qu’elle aura changé de bien en mieux.	Mais si d'un sens rassis vous y jettez les yeux Vous verrez qu'elle aura changé de bien en mieux.
Eraſte en premier lieu n’aura de la fortune Vne ſeule faueur qui ne vous ſoit commune, Amour en vn moment trouuera des moyens Pour meſler doucement vos ames & vos biens Belle confuſion, ou voſtre Age conuie Ceux qui veulent iuger des plaiſirs de la vie D’ailleurs, quand vous aureZ vni nos deux maiſons, Quelque iniure du Ciel qui trouble les ſaiſons, A moins que de les perdre en vn ſecond deluge, Contre tous accidents nous aurons vn refuge.	Eraste en premier lieu n'aura de la fortune Âmes seule faveur qui ne vous soit commune, Amour en un moment trouvera des moyens Pour mêler doucement vos âmes et vos biens Belle confusion, ou votre Age convie Ceux qui veulent juger des plaisirs de la vie D'ailleurs, quand vous avez uni nos deux maisons, Quelque injure du Ciel qui trouble les saisons, A moins que de les perdre en un second déluge, Contre tous accidents nous aurons un refuge.
Qu'endites vous?	Qu'endites -vous?
PHEDON.	PHÉDON.
C’eſt trop ſa froideur conſulter Quoy qu'elle euſt respondu qu’en peut-il reſulter, Suffit que ie leveux, & qu'elle eſt trop bien nee Pour fuyr le repos ou ie l’ay deſtinee.	C'est trop sa froideur consulter Quoi qu'elle eût répondu qu'en peut-il résulter, Suffit que deux leveux, et qu'elle est trop bien née Pour fuir le repos ou ainsi l'ai destinée.
Donne moy cette main,	Donne -moi cette main,
CLORISE.	CLORISE.
Eh mon pere!	Eh mon père!
PHEDON.	PHÉDON.
oſes-tu Coupable dementir ta premiere vertu?	oses-tu Coupable démentir ta première vertu?
Garde que mon courroux,	Garde que mon courroux,
CLORISE.	CLORISE.
Dieux prenez ma deffence,	Dieux prenez ma défense,
PHEDON.	PHÉDON.
Tay toy foible d’esprit ce murmure m’offenſe.	Tais -toi faible d'esprit ce murmure m'offense.
Vueille ce Dieu puiſſant qui regit les humains Vnir vos volonteZ de meſme que vos mains;	Veuille ce Dieu puissant qui régit les humains Unir vos volontés de même que vos mains;
Que i’aſſemble auiourd’huy pour eſtre vn teſ moignage Que vous eſtes tous deux promis en mariage.	Que j'assemble aujourd'hui pour être un té moignage Que vous êtes tous deux promis en mariage.
ERASTE.	ERASTE.
Paueur incomparable, & que ie dois benir Comme le plus grand bien qui pouuoit m’auenir.	Paveur incomparable, et que je dois bénir Comme le plus grand bien qui pouuoit m'avenir.
PHEDON.	PHÉDON.
Ce ſoir meſme il en faut conſommer l’hymenee, Tandis allons chez moy paſſer l’apreſdiſnee, Pour toy, tu peux de nous vn peu te ſeparer Afin d’auoir du temps pour t'y mieux preparer.	Ce soir même il en faut consommer l'hyménée, Tandis allons chez moi passer l'apresdisnee, Pour toi, tu peux de nous un peu te séparer Afin d'avoir du temps pour t'y mieux préparer.
CLORISE.	CLORISE.
Qu'ay-ie fait, criminelle, & de quelle iniuſtice Permets-ie que mon ame auiourd’huy ſe noirciſſe;	Qu'ai-je fait, criminelle, et de quelle injustice Permets-je que mon âme aujourd'hui se noircisse;
Alidor eſt il vray que mon conſentement Ait deſtruit ton espoir & mon contentement?	Alidor est -il vrai que mon consentement Ait détruit ton espoir et mon contentement?
Helas!	Hélas!
que nos plaiſirs ſont de peu de duree, Que d’vn espace court leur Age eſt meſuree, Et que ce Dieu puiſſant cogneu ſur nos Autels, Fait peu regner la ioye en l’eſprit des mortels.	que nos plaisirs sont de peu de dure, Que d' espace court leur Age est mesurée, Et que ce Dieu puissant connu sur nos Autels, Fait pu régner la joie en l'esprit des mortels.
I'ay donc trahy tes feux, & d’vn coup homicide Acquis la qualité d’ingrate & de perfide!	J'ai donc trahi tes feux, et d'un coup homicide Acquis la qualité d'ingrate et de perfide!
I'ay donc trahy tes feux, & contre mon amour Preparé ton courage à la perte duiour!	J'ai donc trahi tes feux, et contre mon amour Préparé ton courage à la perte duiour!
Ah deuoir tyrannique!	Ah devoir tyrannique!
ah contrainte importune!	ah contrainte importune!
Qui nous bleſſes tous deux d’vne douleur commune, D’ou vient que deſormais ta rigueur ne veut pas Vnir en ma faueur ma peine & mon treſpas?	Qui nous blesses tous deux d'une douleur commune, D'ou vient que désormais ta rigueur ne veut pas Unir en ma faveur ma peine et mon trépas?
Helas!	Hélas!
dans le ſucces de ce malheur extreme, Coupable, ie ne dois m'en prẽdre qu'a moymeſme	dans le succès de ce malheur extrême, Coupable, Elle ne dois m'en prendre qu'a moymesme
G iij	G jijà
I'ay trop peu reſiſté, i'ay trop toſt conſenti, Mon ſilence eſt vn trait d’vn esprit diuerti, Ie deuois preuenir le tourment qui m'affolle Et perdre eſgallement la vie, & la parolle.	J'ai trop peu résisté, j'ai trop tôt consenti, Mon silence est un trait d'un esprit diverti, Je devais prévenir le tourment qui m'affolle Et perdre également la vie, et la parole.
Mais ie ne l’ay pas fait!	Mais ici ne l'ai pas fait!
cet iniuſte deuoir En ce moment funeste à montré ſon pouuoir, Et i'ay montre (perfide a mon premier ſeruage Vne grande vertu, mais bien peu de courage.	cet injuste devoir En ce moment funeste à montré son pouvoir, Et j'ai montre (perfide à mon premier servage Vune grande vertu, mais bien peu de courage.
Infortuné berger, que ne doibt ta raiſon Deſormais attenter contre ma trahiſon?	Infortuné berger, que ne doibt ta raison Désormais attenter contre ma trahison?
Trahiſon, qu’ay-ie dit?	Trahison, qu'ai-je dit?
qui ſuit les loix d’vn Maiſtre, Ne fait rien qui conuienne aux actions d’vn traistre;	qui suit les lois d'une Maître, Ne fait rien qui convienne aux actions d'un traître;
Voy combien de Tyrans y forcent mon esprit Les Dieux l’ont deſiré, Phedon me l’a preſcrit.	Vois combien de Tyrans y forcent mon esprit Les Dieux l'ont désiré, Phédon me l'a prescrit.
Dieux!	Dieux!
quel deuiendras-tu quand cét arreſt estrange T’apprendra le deſtin ou ſa rigueur me range?	quel deviendras-tu quand cet arrêt étrange T'apprendra le destin ou sa rigueur me range?
I'entends ſon flageolet, ah qu’il ne penſe pas Rencontrer ſes plaiſirs ſi proches du trespas.	J'entends son flageolet, ah qu'il ne pense pas Rencontrer ses plaisirs si proches du trépas.
SCENE QVATRIESME.	SCÈNE QUATRIÈME.
ALIDOR, CLORISE.	ÀLIDOR, CLORISE.
ALIDOR.	ÀLIDOR.
Ouſiours la Mer, groſſe d’orages, I Ne fait paſlir les Matelots, Et de l’eſcume de ſes flots Elle ne blanchit ſes riuages:	Ousjours la Mer, grosse d'orages, I Ne fait pâlir les Matelots, Et de l'écume de ses flots Elle ne blanchit ses rivages:
Touſiours l’air caché d’vne nuict.	Toujours l'air caché d'une nuit.
D’eſclairs, de foudres, & de bruit Ne s’arme contre la Nature;	D'éclairs, de foudres, et de bruit Ne s'arme contre la Nature;
Et touſiours les foibles vaiſſeaux Ne rencontrent leur ſepulture Au milieu des feux ou des eaux.	Et toujours les faibles vaisseaux Ne rencontrent leur sépulture Au milieu des feux ou des eaux.
Poufiomio la rigueur importune D’vn hyuer, chargé de glaçons, N’arreſte le cours des poiſſons Deſſous l’Empire de Neptune:	Poufiomio la rigueur importune D'un hiver, chargé de glaçons, N'arrête le cours des poissons Dessous l'Empire de Neptune:
Ainſi touſiours vn pauure Amant Ne void dans l’horreur du tourment Ses esperances eſtouffees, Amour arreſte ſes douleurs, Et luy fait cueillir des trophees Ouiadis il ſemoit des pleurs.	Ainsi toujours un pauvre Amant Ne voit dans l'horreur du tourment Ses espérances étouffes, Amour arrête ses douleurs, Et tu fait cueillir des trophées Ouiadis il semait des pleurs.
Heureux plus qu’il ne ſe peut dire, I'ay rendu le Ciel enuieux Depuis l’heure que deux beaux yeux Ont pris leur part de mon martyre:	Heureux plus qu'il ne se peut dire, J'ai rendu le Ciel envieux Depuis l'heure que deux beaux yeux Ont pris leur part de mon martyre:
Tous mes maux Ah ie voy cette aymable Beauté D’ou l'Amour a pour moy bannila cruauté, Me voicy de retour;	Tous mes maux Ah Dieux vois cette aimable Beauté D'ou l'Amour a pour moi bannila cruauté, Me voici de retour;
CLORISE.	CLORISE.
Ouy, trop toſt pour entendre Le plus faſcheux arreſt que tu pouuois attendre, Mon pere me deſtine vn autre eſpoux que toy,	Oui, trop tôt pour entendre Le plus fâcheux arrêt que tu pouuois attendre, Mon père me destine un autre époux que toi,
ALIDOR.	ÀLIDOR.
Follaſtre tu te plais à te mocquer de moy:	Folâtre tu te plais à te moquer de moi:
CLORISE.	CLORISE.
Helas!	Hélas!
ie ne ments point, la choſe eſt reſoluë, Eraſte en a receu la parolle abſoluë, Et pour rendre ma peine eſgalle à ton amour le ne puis eſtre a toy que le reſte du-iour.	Ne ne mens point, la chose est résolue, Eraste en a reçue la parole absolue, Et pour rendre ma peine égalle à ton amour le ne puis chang a toi que le reste dujour.
ALIDOR.	ÀLIDOR.
Nouuelle inſupportable!	Nouvelle insupportable!
ô ſentence cruelle!	ô sentence cruelle!
Mais vous chere beauté ſerez vous infidelle?	Mais vous chère beauté serez -vous infidèle?
Ma vie & mon treſpas ſont en voſtre pouuoir Qu'auez vous reſolu?	Ma vie et mon trépas sont en votre pouvoir Qu'avez -vous résolu?
CLORISE.	CLORISE.
De faire mon deuoir.	De faire mon devoir.
ALIDOR.	ÀLIDOR.
Il faut donc s’affranchir de cette loy barbare Qui tend à merauir vne beauté ſi rare, Vous deuez cet effort à mon affection:	Il faut donc s'affranchir de cette loi barbare Qui tend à méravir une beauté si rare, Vous devez cet effort à mon affection:
CLORISE.	CLORISE.
Au contraire, ie dois cacher ma paßion, Et d’vn eſprit, aueugle en ſon obeiſſance, Suiure, telle qu'elle eſt, cette iniuſte ordonnance.	Au contraire, Madame dois cacher ma passion, Et d'un esprit, aveugle en son obéissance, Suivre, telle qu'elle est, cette injuste ordonnance.
ALIDOR.	ÀLIDOR.
Doncques vostrerigueur conſent à mes ennuis?	Doncques vostrerigueur consent à mes ennuis?
CLORISE.	CLORISE.
On ne peut m’accuſer faiſant ce que ie puis, Tu ſcais qu’a mon deuoir ma force ſe meſure.	On ne peut m'accuser faisant ce que je puis, Tu sais qu'a mon devoir ma force se mesure.
ALIDOR.	ÀLIDOR.
Dieux!	Dieux!
ſi voſtre courroux ne punit cette iniure Vous eſtes impuiſſants;	si votre courroux ne punit cette injure Vous êtes impuissants;
CLORISE.	CLORISE.
Pourquoy blaſphemes tul Ta colere m’afflige, & bleſſe ma vertu:	Pourquoi blasphèmes tul Ta colère m'afflige, et blesse ma vertu:
Sors de ton interest & te mets en ma place, Demande à ta raiſon ce qu’il faut que ie faſſe, Veux-tu que ie me tue afin de te guerir?	Sors de ton intérêt et te mets en ma place, Demande à ta raison ce qu'il faut que ieclasse, Veux-tu que sans me tue afin de te guérir?
Car offenſer Phedon c’eſt autant que mourir.	Car offenser Phédon c'est autant que mourir.
ALIDOR.	ÀLIDOR.
Non non viueZ heureuſe, & puis que tant de peines N'ont point encor ſaoulé vos rigueurs inhumaines,	Non non vivez heureuse, et puis que tant de peines N'ont point encor saoulé vos rigueurs inhumaines,
AdiouſteZ aux tourments que mon ame a ſoufferts Tous ceux que l’on endure en l’horreur des enfers;	Ajoutez aux tourments que mon âme a soufferts Tous ceux que l'on endure en l'horreur des enfers;
Ie les ſouffriray tous, pour eſtre plus capable D'expier le peché dont vous eſtes coupable.	Je les souffrirai tous, pour être plus capable D'expier le péché dont vous êtes coupable.
Ah!	Ah!
ſi vous auieZ fait deſſein de me trahir Vous ne deuiez iamais ceſſer de me hayr, Mais s’eſtre aſſubiettie en vn meſme ſeruage Et puis m’abandonner, c’eſt vn ſuiect de rage, Ie forcene, ie meurs:	si vous aviez fait dessein de me trahir Vous ne deviez jamais cesser de me haïr, Mais s'être assubiétie en un même servage Et puis m'abandonner, c'est un sujet de rage, Je forcené, je meurs:
ah!	ah!
Destin trop cruel D’ou prouient que tu rends mon mal continuel?	Destin trop cruel D'ou provient que tu rends mon mal continuel?
Complice de Cloriſe aſſouuy ſon enuie, Et finis ta rigueur en finiſſant ma vie.	Complice de Clorise assoui son envie, Et finis ta rigueur en finissant ma vie.
Arriere deſormais tout espoir de plaiſir, Faittes place aux tranſports qui me viennent ea min ſaiſir, CedeZ à la fureur que Cloriſe m’inſpire!	Arrière désormais tout espoir de plaisir, Faites place aux transports qui me viennent ea min saisir, Cédés à la fureur que Clorise m'inspire!
L’ingratte m’a quitté!	L'ingrate m'a quitté!
Dieux le puis-ie bien dire Et ſuruiure, trahi, ce funeſte moment?	Dieux le puis-je bien dire Et survivre, trahi, ce funeste moment?
Non ne le faiſons pas, mourons, mais promptement Et puiſque l’inhumaine a mon amour changee Recherchons pour luy plaire vne fin enragee;	Non ne le faisons pas, mourons, mais promptement Et puisque l'inhumaine à mon amour changée Recherchons pour lui plaire une fin enragée;
Aſſemblons s’il ſe peut en vne mille morts, Et ne laiſſons partir mon ame de ce corps Qu'elle n'ait pour ſortir cent bleſſures mortelles.	Assemblons s'il se peut en une m morts, Et ne laissons partir mon âme de ce corps Qu'elle n'ait pour sortir cent blessures mortelles.
CLORISE.	CLORISE.
Arreſte, mon berger, tes fureurs criminelles, Et ſi ton amitié n’est eſteinte pour moy Permets que ie t'impoſe encore cette loy.	Arrête, mon berger, tes fureurs criminelles, Et si ton amitié n'est éteinte pour moi Permets que sans t'impose encore cette loi.
Helas!	Hélas!
tu cognois bien que ta douleur me touche, Ie t’en parle des yeux, autant que de la bouche, Et le Ciel m’eſt teſmoin ſi ie ne voudrois pas Acheter ton repos au prix de mon trespas:	tu connais bien que ta douleur me touche, Je t'en parle des yeux, autant que de la bouche, Et le Ciel m'est témoin si je ne voudrais pas Acheter ton repos au prix de mon trépas:
Mais puiſqu'à ce malheur tu n’as point de remede, Taſche au moins d’alleger le mal qui te poſſede;	Mais puisqu'à ce malheur tu n'as point de remède, Tâche au moins d'alléger le mal qui te possède;
Et ſur tout ne meurs point, mais cherche doucement Le moyen de guerir par vn eſloignement:	Et sur tout ne meurs point, mais cherche doucement Le moyen de guérir par un éloignement:
Außi bien, dans l’exces ou ſe porte tarage, Ie voy que mon honneur receuroit quelque outrage.	Aussi bien, dans l'excès ou se porte tarage, Je vois que mon honneur recevrait quelque outrage.
Ce qui n’auiendra point, ſi tu veux approuuer La loy que ie te donne, & la vien ooſeruer.	Ce qui n'aviendra point, si tu veux approuver La loi que je te donne, et la vien ooserver.
ALIDOR.	ÀLIDOR.
Ouy, puiſqu’elle vous plaiſt, elle ſera ſuiuie Iuſqu'au dernier ſouspir qui marquera ma vie;	Oui, puisqu'elle vous plaît, elle sera suivie Jusqu'au dernier soupir qui marquera ma vie;
Mais deuant que ie parte au moins trouuons vn heh Ou ie puiſſe vous dire vn eternel Adieu.	Mais devant que Seigneur parte au moins trouvons un héh Ou On puisse vous dire un éternel Adieu.
CLORISE.	CLORISE.
Tantost, que ce flambeau qui fait le tour du monde Sera preſt de cacher ſa lumiere dans l’onde, Ie me deſroberay pour venir droit icy.	Tantôt, que ce flambeau qui fait le tour du monde Sera prêt de cacher sa lumière dans l'onde, Je me déroberai pour venir droit ici.
ALIDOR.	ÀLIDOR.
Ie prendray pour m'y rẽdre vn ſemblable ſoucy, Heureux ſi ce moment à mon repos funeſte Pouuoit eſtre nommé le dernier qui me reſte.	Je prendrai pour m'y rendre un semblable souci, Heureux si ce moment à mon repos funeste Pouvait être nommé le dernier qui me reste.
ACTE CINQVIESME.	ACTE CINQUIÈME.
SCENE PREMIERE.	SCÈNE PREMIÈRE.
ALIDOR.	ÀLIDOR.
OVS, qui ſouliez iadis parler de mes douleurs, Traiſtres yeux, qui retient la ſource de vos pleurs?	OUS, qui soûliez jadis parler de mes douleurs, Traîtres yeux, qui retient la source de vos pleurs?
Ah!	Ah!
ſouffrez que par vous mon deſeſpoir s’exprime, Vous ſçaueZ que la cauſe en eſt trop legitime, Et que s’en abſtenir en cette extremité Seroit vrayment commettre vn trait de laſ cheté.	souffrez que par vous mon désespoir s'exprime, Vous savez que la cause en est trop légitime, Et que s'en abstenir en cette extrémité Serait vraiment commettre un trait de las chété.
Il eſt donc ordonné qu’a iamais ie m’abſente De l'obiect le plus beau dont la Terre ſe vante, Et que me ſeparant de cet heureux ſeiour Ie perde mon ſoleil & ie ſouffre le iour.	Il est donc ordonné qu'a jamais avoir m'absente De l'objet le plus beau dont la Terre se vante, Et que me séparant de cet heureux seiour Je perde mon soleil et Seigneur souffre le jour.
Beaux Arbres eſleueZ, dont les rameaux ſuperbes Eſloignent de vos troncs la chaleur & les herbes;	Beaux Arbres élevés, dont les rameaux superbes Éloignent de vos troncs la chaleur et les herbes;
Enfin cette Beauté trop prompte à me changer Preſcrit à ma demeure vn Climat eſtranger, Vous ne me verrez plus;	Enfin cette Beauté trop prompte à me changer Prescrit à ma demeure un Climat étranger, Vous ne me verrez plus;
mais quoy, s’il eſt poſfible, Que pour moy voſtre cœur ne ſoit pas inſenſible, Encore que mon corps ſoit ſeparé du ſien Ne ſepareZ iamais ſon beau nom & le mien.	mais quoi, s'il est possible, Que pour moi votre cœur ne soit pas insensible, Encore que mon corps soit séparé du sien Ne séparés jamais son beau nom et le mien.
Et toy qui dans l’exces de ma douleur amere As porté mes regrets iuſqu’au ſein de ta mere, Lignon, s’il aduenoit que ce couple d’amants Vinſt profaner tes bords de ſes contentements, Vange moy ie te prie, & dans tes bras humides Eſtouffe en ma faueur leurs flames homicides.	Et toi qui dans l'excès de ma douleur âme As porté mes regrets jusqu'au sein de ta -mère, Lignon, s'il avait que ce couple d'amants Vinst profaner tes bords de ses contentements, Venge moi quelque te prie, et dans tes bras humides Étouffe en ma faveur leurs flammes homicides.
Et vous monts ſourcilleux, deſerts inhabitez Touchant ma paßsion tant de fois conſultez, Qui trouuant vne voix dedans vos roches creuſes Auez cent fois redit mes plaintes amoureuſes.	Et vous monts sourcilleux, déserts inhabités Touchant ma passion tant de fois consultés, Qui trouvant quelque voix dedans vos roches creuses Avez cent fois redit mes plaintes amoureuses.
Vous ne parlereZ plus, cet eſprit criminel, Comme a moy, vous impoſe vn ſilence eternel:	Vous ne parlez plus, cet esprit criminel, Comme à moi, vous impose un silence éternel:
Mais d’où vient qu'au logis trop long temps retenuë Cette ingratte beauté n’eſt point encor venuë?	Mais d'où vient qu'au logis trop long temps retenue Cette ingrate beauté n'est point encor venue?
Voudriez vous bien m’oſter deſtins pernicieur La derniere faueur que i’attends de ſes yeux?	Voudriez -vous bien m'ôter destins pernicieur La dernière faveur que j'attends de ses yeux?
Ah ie voy bien qu'à tort ie fay cette reproche, A trauers ces Ormeaux ie la voy qui s’approche.	Ah petit vois bien qu'à tort arrêt fais cette reproche, A travers ces Ormeaux toujours la voy qui s'approche.
SCENE	SCÈNE
SCENE SECONDE.	SCÈNE SECONDE.
CLOMoE, AlEIDor.	CLOMoE, AlEIDor.
CLORISE.	CLORISE.
’En eſt fait, ma raiſon, ne deliberons plus, Tous ces rudes combats ſont en fin ſuperflus, Le ſort en eſt ietté, puiſque Phedon l’ordonne Ie ne puis m’oppoſer à la loy qu’il me donne.	Ç'En est fait, ma raison, ne délibérons plus, Tous ces rudes combats sont en fin superflus, Le sort en est jeté, puisque Phédon l'ordonne Je ne puis m'opposer à la loi qu'il me donne.
Reſpect iniurieux, Tyran dont la rigueur Partage auec l’Amour l’Empire de mon cœur, Partage, ie dis mal puis qu’on void à ma honte Que ce traiſtre deuoir me force & me ſurmonte.	Respect injurieux, Tyran dont la rigueur Partage avec l'Amour l'Empire de mon cœur, Partage, ie dis mal puis qu'on voit à ma honte Que ce traître devoir me force et me surmonte.
Vous qui voyez ma peine & ne m'aßiſtez pas, Grands Dieux:	Vous qui voyez ma peine et ne m'assistez pas, Grands Dieux:
mais Alidor a deuancé mes pas, Allons ſouffrir du Ciel la derniere malice.	mais Alidor a devancé mes pas, Allons souffrir du Ciel la dernière malice.
ALIDOR.	ÀLIDOR.
Semblable au malheureux qu’on deſtine au ſupplice, Ie viens pour receuoir & de vous & du ſort L’arreſt de ma diſgrace & le coup de ma mort,	Semblable au malheureux qu'on destine au supplice, Je viens pour recevoir et de vous et du sort L'arrêt de ma disgrâce et le coup de ma mort,
CLORISE.	CLORISE.
Et moy, que ta raiſon void exempte de crime;	Et moi, que ta raison voit exempte de crime;
Ie viens pour t’aſſurer que ie ſers de victime Aux paßions d’vn pere, & que luy ſeulement Par ce dernier Arreſt nous perd eſgallement.	Je viens pour t'assurer que je sers de victime Aux passions d'un père, et que Seigneur seulement Par ce dernier Arrêt nous perd également.
Mais puiſque i’ay du temps pour te dire ma peine, Repoſons nous berger pres de cette fontaine.	Mais puisque j'ai du temps pour te dire ma peine, Reposons nous berger pres de cette fontaine.
SCENE TROISIESME.	SCÈNE -TROISIÈME.
MſcilIE, GROREN AIMDOR.	MscilIE, GROREN AIMDOR.
ERASTE.	ERASTE.
Loriſe ſe deſrobe, ou va-t'elle ſi tard?	Lorise se dérobe, ou va-t'-elle si tard?
OIl faut qu'vn grand deſſein l’appelle en quelque part;	ÔIl faut qu'un grand dessein l'appelle en quelque part;
Vn berger la careſſe ah Dieux quelle inſolence Eſcoutons leurs diſcours;	Un berger la caresse ah Dieux quelle insolence Escoutons leurs discours;
ils gardent le ſilence.	ils gardent le silence.
CLORISE.	CLORISE.
D'on vient qu'en te eſiai on ta mis ia douleur, Tu manques außi bien de voix que de couleur.	D'on vient qu'en te esiai on ta mis ja douleur, Tu manques aussi bien de voix que de couleur.
ALIDOR.	ÀLIDOR.
C’eſt dequoy ie remarque, inſenſible & volage Que vous manquez d’amour autant que de courage.	C'est dequoy grande remarque, insensible et volage Que vous manquez d'amour autant que de courage.
H ij	H ij
CLORISE.	CLORISE.
Ah cruel!	Ah cruel!
oſes-tu D’vn blaſpheme ſi grand offenſer ma vertu;	oses-tu D'Han naspheme si grand offenser ma vertu;
Iuge que ie ne puis en ſoulageant ta peine Que me rendre coupable, & meriter ta haine:	Juge que personne ne puis en soulageant ta peine Que me rendre coupable, et mériter ta haine:
Ie le ſçay, mon berger, ton courage eſt trop haut Pour aymer vne fille apres vn tel deffaut, Voyque c’eſt mon deuoir, & permets que ie viue Subiette à quelque ſort qu’vn pere me preſcriue.	Je le sais, mon berger, ton courage est trop haut Pour aimer une fille après un tel défaut, Voique c'est mon devoir, et permets que je vive Subiette à quelque sort qu'un père me prescrive.
ALIDOR.	ÀLIDOR.
Ouy viuez i’y conſents, ſi pour me ſecourir Voſtre bouche me donne vn pouuoir de mourir.	Oui vivez j'y consents, si pour me secourir Votre bouche me donne un pouvoir de mourir.
CLORISE.	CLORISE.
Que ie lis peu d’amour en ce que tu propoſes, Si l’on nomme la mort la fin de toutes choſes, Ne vois-tu pas, Berger, qu'en la perte duiour Tu trouuerois außi celle de ton amour.	Que quelque lis peu d'amour en ce que tu proposes, Si l'on nomme la mort la fin de toutes choses, Ne vois-tu pas, Berger, qu'en la perte duite Du trouuerois aussi celle de ton amour.
ALIDOR.	ÀLIDOR.
Ie ne le penſe pas, car ie ſçay que ma flame N'eſtend point ſa chaleur au dela de mon ame, Et l’ame ne meurt point.	Je ne le pense pas, car ainsi sais que ma flamme N'étend point sa chaleur au déla de mon âme, Et l'âme ne meurt point.
CLORISE.	CLORISE.
Ahie t’y prends berger, Tondiſcours me fournit dequoy te ſoulager, Car s’il eſt vray qu'Amour, comme tu viens de dire, Seulement ſur ton ame exerce ſon Empire, Quel ſuiect auras-tu de te plaindre de moy Si ie bruſle touſiours du meſme feu que toy?	Ahie t'y prends berger, Tondiscours me fournit dequoy te soulager, Car s'il est vrai qu'Amour, comme tu viens de dire, Seulement sur ton âme exerce son Empire, Quel sujet auras-tu de te plaindre de moi Si tu brûle toujours du même feu que toi?
Ce corps ne futiamais digne de ta victoire, Qu'vn barbare en eſleue vn Autel à ſa gloire, Il n’aura pour obiect de ſes plaiſirs diuers Que le ſale butin de la Terre & des Vers:	Ce corps ne futiamais digne de ta victoire, Qu'un barbare en esleue un Autel à sa gloire, Il n'aura pour objet de ses plaisirs divers Que le sale butin de la Terre et des Vers:
Ce n'eſt pas que celuy dont l’acces m’importune N'adiouſtaſt quelque choſe à ma bõne fortune, Eraſte vaut beaucoup, il a des qualiteZ Capables de charmer les plus grandes beautez,	Ce n'est pas que celui dont l'accès m'importune N'ajoutât quelque chose à ma bonne fortune, Eraste vaut beaucoup, il a des qualités Capables de charmer les plus grandes beautés,
ERASTE.	ERASTE.
Voicy mon intereſt,	Voici mon intérêt,
CLORISE.	CLORISE.
Mais il eſtimpoßible.	Mais il estimpossible.
Qu'à nul plaiſir ſans toy ie demeure ſenſible;	Qu'à nul plaisir sans toi ici demeure sensible;
H iij Pars donc, & ſois certain que iuſqu'a mon treſpas, Ie ſeray du penſer compagne de tes pas, Et bien que ce Riual te deſrobe vne femme, Il n'aura que le corps dont tu poſſedes l’ame.	H Hijà Pars donc, et sois certain que jusqu'a mon trépas, Je serai du penser compagne de tes pas, Et bien que ce Rival te dérobe une femme, Il n'aura que le corps dont tu possèdes l'âme.
a a .	a a .
Ce diſcours me deſplaiſt,	Ce discours me déplaît,
ALIDOR.	ÀLIDOR.
Et bien, il faut partir Noſtre destin l’ordonne & i’y dois conſentir;	Et bien, il faut partir Notre destin l'ordonne et j'y dois consentir;
Ie recognoy qu'en vain mon amour le dispute, C’eſt vn commandemẽt qu’il faut que i’execute:	Je reconnais qu'en vain mon amour le dispute, C'est un commandement qu'il faut que j'execute:
Adieu;	Adieu;
ſouuenez vous que ie pars enragé Ee la leuicaquamrepartensge.	souvenez vous que ie pars enragé Ee la leuicaquamrepartensge.
CLORISEE.	CLORISE.
Ou ſera ta retraitte?	Ou sera ta retraite?
ALIDOR.	ÀLIDOR.
En quelque ſolitude Ou ie veux que la mort ſoit toute mon eſtude, Ladans quelque Antre obſcur, moins noir que mon malheur, L'enfer meſme viendra conſulter ma douleur, Pour ſçauoir s’il eſt vray qu'en l’horreur lle ſon gouffre Il ſoit quelque tourment comme ceux que ie ſouffre.	En quelque solitude Ou ie veux que la mort soit toute mon étude, Ladans quelque Antre obscur, moins noir que mon malheur, L'enfer Seigneur viendra consulter ma douleur, Pour savoir s'il est vrai qu'en l'horreur lèle son gouffre Il soit quelque tourment comme ceux que Ne souffre.
Là ie veux que mes nuicts craignent moins le Soleil Que l’approche du Dieu qui verſe le ſommeil, Et qu’au feu de ma rage & de mes reſueries S’allument les flambeaux que portent les furies.	Là grande veux que mes nuits craignent moins le Soleil Que l'approche du Dieu qui verse le sommeil, Et qu'au feu de ma rage et de mes rêveries S'allument les flambeaux que portent les furies.
CLORISE.	CLORISE.
Ah change ce deſſein & rentre en ton bon ſens, N’accuſe mes deſirs ils ſont trop innocents;	Ah change ce dessein et rentre en ton bon sens, N'accuse mes désirs ils sont trop innocents;
Ie iure par les Dieux que ſeruent nos Druides, Par leur foudre commiſe à punir les perfides, Et par tout ce qui void ce dernier entretien De ne cherir iamais d’autre nom que le tien:	Je jure par les Dieux que servent nos Druides, Par leur foudre commise à punir les perfides, Et par tout ce qui void ce dernier entretien De ne chérir jamais d'autre nom que le tien:
Eſcris moy ton ſeiour, Adieu, Pan te conſole.	Écris -moi ton séjour, Adieu, Pan te console.
ERASTE.	ERASTE.
Il s’en va ſans pouuoir former vne parolle, Ses ſanglots redoublez luy deſrobent la voix, Feignons de reuenir du plus profond du bois.	Il s'en va sans pouvoir former une parole, Ses sanglots redoublés luy dérobent la voix, Feignons de revenir du plus profond du bois.
.	.
H iuj	H juj
CLORISE.	CLORISE.
da ſuipije ſaſeheuje.	da supije saseheuje.
ERASTE.	ERASTE.
A quoy s’eſt diuertie La beauté que ie ſers depuis qu'ell' eſt ſortie?	À quoi s'est divertie La beauté que je sers depuis qu'elle est sortie?
anedran.	anedran.
A chercher Eliante,	À chercher Éliante,
ERASTE.	ERASTE.
Et d’où viennent ces pleurs Dont vous ſembleZ haſter la naiſſance des fleurs?	Et d'où viennent ces pleurs Dont vous semblez hâter la naissance des fleurs?
LORISE.	LORISE.
C’eſt que dans le moment que vous m’auez trouuee I'auois pris vn peu d’eau dont ie m’eſtois lauee, Mais ie n’ay pas pleuré.	C'est que dans le moment que vous m'avez trouvée J'avais pris un peu d'eau dont votre m'étais lauée, Mais ie n'ai pas pleuré.
ERASTE.	ERASTE.
Qu'elle ſcait bien mentir Et taire la douleur qu’on luy void reſſentir:	Qu'elle sait bien mentir Et taire la douleur qu'on tu voit ressentir:
Chere moitié de moy, Beauté toute diuine, D'ou que vos deſplaiſirs tirent leur origine Ne me le cachez plus, ie ſuis preſt de perir Si vous iugez ma perte vtile à vous guerir.	Chère moitié de moi, Beauté toute divine, D'ou que vos déplaisirs tirent leur origine Ne me le cachez plus, ils suis prêt de périr Si vous jugez ma perte utile à vous guérir.
Eſt il quelque berger dans nos bois qui vous faſche?	Est -il quelque berger dans nos bois qui vous fâche?
Dittes, en quelque lieu que ſa crainte le cache Donune ſamunifaumfiomaut irrite, Ce bras l’ira punir de ſa temerité.	Dittes, en quelque lieu que sa crainte le cache Donune samunifaumiomaut irrite, Ce bras l'ira punir de sa témérité.
CLORISE.	CLORISE.
EuiteZ ce peril,	Évitez ce péril,
ERASTE.	ERASTE.
Qu'elle eſt ingenieuſe.	Qu'elle est ingénieuse.
Bergere, ſi ie ments que la Terre enuieuſe Des plaiſirs que ie gouſte, & de ceux que i'attends Pour me perure pluſtoſt s'ouure en ce meſme temps.	Bergère, si belle mens que la Terre envieuse Des plaisirs que ie goûte, et de ceux que j'attends Pour me pérure plutôt s'ouvre en ce même temps.
Mais ie voy Philidan qui conduit Eliante,	Mais ici vois Philidan qui conduit Éliante,
OICRISE.	ÔICRISE.
Qu'à ma fortune helas la ſienne eſt differente	Qu'à ma fortune hélas la sienne est différente
ERASTE.	ERASTE.
Ils s’en viennent à nous,	Ils s'en viennent à nous,
SCENE QVATRIESME.	SCÈNE QUATRIÈME.
ELIANTE.	ÉLIANTE.
CLORISE.	CLORISE.
DRAUTES MAIEIDAN.	DRAUTES MAIEIDAN.
ELIANTE.	ÉLIANTE.
IE vous cherche par tout I'ay couru tout ce bois de l’vn à l’autre bout Sans vous pouuoir trouuer;	JE vous cherche par tout J'ai couru tout ce bois de l'un à l'autre bout Sans vous pouvoir trouver;
CLORISE.	CLORISE.
CUt fait te juis perdue,	CUt fait te juis perdue,
ELIANTE.	ÉLIANTE.
Dépuis quel temps?	Dépuis quel temps?
CLORISE.	CLORISE.
Depuis que ie ne vous ay veuë.	Depuis que je ne vous ai vue.
ELIANTE.	ÉLIANTE.
Vous m'eſtonnez,	Vous m'étonnez,
ERASTE.	ERASTE.
Allons faire vn tour cependant Et ie vons apprenuray quet eſt cet accident.	Allons faire un tour cependant Et ainsi vons apprenurai quet est cet accident.
PHILIDAN.	PHILIDAN.
Vous m'aueZ mis en peyne,	Vous m'avez mis en peine,
ERASTE.	ERASTE.
Ie m’en vay vous attendre ou l’Amour vous conuie, Sur tout ne ſoyez point pareſſeuſe à venir Noſtre heur doit commencer & le iour va finir.	Je m'en vais vous attendre ou l'Amour vous convie, Sur tout ne soyez point paresseuse à venir Notre heur doit commencer et le jour va finir.
eiral laa L’eſtrange changement,	eiral la L'étrange changement,
CLORISE.	CLORISE.
Vous voyez ma diſgrace, Ie ne puis l’euiter quelque effort que ie faſſe, I es pouſe ce berger, Phedonl a deſire.	Vous voyez ma disgrâce, Je ne puis l'éviter quelque effort que je fasse, I ès pouze ce berger, Phédon a désire.
ELIANTE.	ÉLIANTE.
Et qu'en dit Alidor?	Et qu'en dit Alidor?
CLORISE.	CLORISE.
Il eſt deſesperé, Et pour mieux ſouſpirer noſtre douleur cõmune Il change de Climat en changeant de fortune:	Il est désespéré, Et pour mieux soupirer notre douleur commune Il change de Climat en changeant de fortune:
Mais le iour s’eſloignant auance mon treſpas,	Mais le jour s'éloignant avance mon trépas,
ELIANTE.	ÉLIANTE.
Retirons nous,	Retirons -nous,
CLORISE.	CLORISE.
Au moins ne m’abandonnez pas.	Au moins ne m'abandonnez pas.
SCENE CINQVIESME.	SCÈNE CINQUIÈME.
ALIDOR.	ÀLIDOR.
Voy donc?	Vois donc?
ie permettray qu'on m’impute la honte De viure & de ſouffrir qu’vn autre la ſurmonte, Qu'vn Tyran, qu’vn voleur, enuieux de mon bien, Triomphe d’vn obiect qui deuroit eſtre mien?	Ce permettrai qu'on m'impute la honte De vivre et de souffrir qu'un autre la surmonte, Qu'un Tyran, qu'un voleur, envieux de mon bien, Triomphe d'un objet qui devrait être mien?
Non non ne partons point, mon deſespoir s'oppoſe A ce commandement que Cloriſe m'impoſe,	Non non ne partons point, mon désespoir s'oppose À ce commandement que Clorise m'impose,
Il vaut mieux que ie meure, & que d’vn meſme ſort Nous receuions tous trois vne pareille mort.	Il vaut mieux que de meure, et que d'un même sort Nous recevions tous trois une pareille mort.
Voicy' qui punira l’exces de leur iniure, Qui fera dans nos corps vne meſme bleſſure, Et qui par ma fureur, poußé dans noſtre flanc, dansiSeparant nos eſprits meſlera noſtre ſang.	Voici une punira l'excès de leur injure, Qui fera dans nos corps une seule blessure, Et qui par ma fureur, pouvé dans ma flanc, dansiSéparant nos esprits mêlera notre sang.
Apres mon attentat qu’importe qu’on m'accuſe, Il n'est point de peché que ma rage n’excuſe, Et de quelque transport que ie ſois agité Mon amour le rend iuſte en cette extremité.	Après mon attentat qu'importe qu'on m'accuse, Il n'est point de péché que ma rage n'excuse, Et de quelque transport que je sois agité Mon amour le rend juste en cette extrémité.
Rauiſſeur impudent, ta fortune eſt ſemblable A de beaux fondements, mais ietteZ ſur le ſable;	Ravisseur impudent, ta fortune est semblable À de beaux fondements, mais jettez sur le sable;
Au deſtin d’vne fleur, mais qui n’a qu’vn moment Qui ſepare ſa fin de ſon commencement:	Au destin d'une fleur, mais qui n'a qu'un moment Qui sépare sa fin de son commencement:
Voicy d’ou ie pretends tirer mon allegeance, C’eſt icy le Demon qui fera ma vengeance, Et que les tiens, ſurpris d’vn prodige nouueau, Te penſans voir au lict te verront au tombeau.	Voici d'ougrès prétends tirer mon allégeance, C'est ici le Démon qui fera ma vengeance, Et que les tiens, surpris d'un prodige nouveau, Te pensants voir au lit te verront au tombeau.
Mais ie ne ſonge pas en formant cette plaint Au principal ſuiect d’où procede ma crainte;	Mais ici ne songe pas en formant cette plaint Au principal sujet d'où procède ma crainte;
Peut eſtre ence moment, Eraſte, mon riual, Poſſede autant de bien que ie ſouffre de mal, Il ſe rid de mes pleurs, il embraſſe, ilcareſſe, Celle quil tient eſclaue & qui fut ma maiſtreſſe;	Peut être ence moment, Eraste, mon rival, Possède autant de bien que sans souffre de mal, Il se rid de mes pleurs, il embrasse, ilcaresse, Celle quil tient esclaue et qui fut ma maîtresse;
Il taſche d’amollir, agreable deſſein, Par d’humides baiſers la neige de ſon ſein, Poſſeſſeur abſolu d’vne belle victoire, Il void mille threſors prepareZ à ſa gloire, Et i'adiouſte à mes maux encor ce dernier point Que Cloriſe le ſouffre & ne ſe deffend point Ah c’est fait, haſtons nous de punir cet outrage, Acheuons le deſſein ou ſe porte ma rage, Vangeons nous par ſa mort de ſa temerité, Ie doibs cette victime à ma fidelité.	Il tâche d'amollir, agréable dessein, Par d'humides baisers la neige de son sein, Possesseur absolu d'une belle victoire, Il voit mille trésors préparés à sa gloire, Et j'ajoute à mes maux encor ce dernier point Que Clorise le souffre et le se défend point Ah c'est fait, hâtons nous de punir cet outrage, Achevons le dessein ou se porte ma rage, Vengeons nous par sa mort de sa témérité, Je dois cette victime à ma fidélité.
Et donnant à ſa flame vn glorieux obſtacle Faire de noſtre hiſtoire vn tragique spectacle.	Et donnant à sa flamme un glorieux obstacle Faire de notre histoire un tragique spectacle.
Mais ce dernier ſoupçon ne me doit pas faj cher, A peine le ſoleil commence à ſe cacher, Et pour ioindre l’effect à mes craintes funebres Il faudra que la nuict leur preſte ſes tenebres, S’il eſt vray, beau Soleil, arreſte icy ton cours, Mais ie t'appelle en vain tu t’eſloignes touſiours, Et ſans auoir eſgard à ma iuſte priere Tu m’ostes l’esperance auecque ta lumiere.	Mais ce dernier soupçon ne me doit pas faj cher, À peine le soleil commence à se cacher, Et pour joindre l'effet à mes craintes funèbres Il faudra que la nuit leur prête ses ténèbres, S'il est vrai, beau Soleil, arrête ici ton cours, Mais tu t'appelle en vain tu t'éloignes toujours, Et sans avoir égard à ma juste prière Tu m'ôtes l'espérance auecque ta lumière.
Ah ſuiuons hardiment noſtre premier obiect, Uruu pour mieux reußir en ce triſte proiect, Dont le ſucces doit eſtre à trois amants funeſte, Laiſſons paſſer encor ce peu de iour qui reſte.	Ah suivons hardiment notre premier objet, Uru pour mieux reussir en ce triste prois, Dont le succès doit être à trois amants funeste, Laissons passer encor ce peu de jour qui reste.
SCENE, SIXIESME.	SCÈNE, SIXIÈME.
ERASIE, TAILIDAN, ALIDOR.	ERASIE, TAILIDAN, ALIDOR.
ERASTE.	ERASTE.
Epuis ſi peu de temps il ne peut eſtre loin, D'Haſtons nous toutefois ſa peine en a beſoin.	Epuis si peu de temps il ne peut être loin, D'Hâtons nous toutefois sa peine en a besoin.
PHILIDAN.	PHILIDAN.
Si les Dieux en cecy leur puiſſance ne montrens, En vain nous esperons que nos pas le rencontrent;	Si les Dieux en ceci leur puissance ne montrends, En vain nous espérons que nos pas le rencontrent;
Ie cognois ſon esprit, il eſt trop violent 10 Pour ſouffrir en ſon mal vn proceder ſi lent.	Je connais son esprit, il est trop violent 10 Pour souffrir en son mal un procéder si lent.
LRASTE.	LRASTE.
Faiſants noſtre deuoir, il eſt bien difficile Que noſtre ſoin ſe perde & ne luy ſoit vtile.	Faisants notre devoir, il est bien difficile Que notre soin se perde et ne porte soit utile.
ALIDOR.	ÀLIDOR.
Ah nuictou tardes-tu?	Ah nuitou tardes-tu?
PHILIDAN.	PHILIDAN.
PHILIDAN.	PHILIDAN.
Bons Dieux i'entends ſa voix.	Bons Dieux j'entends sa voix.
ALIDOR.	ÀLIDOR.
Vien ioindre ton horreur à celle ou ie me vois.	Viens joindre ton horreur à celle ou ie me vois.
PHILIDAN.	PHILIDAN.
C’eſt luy meſme, ô deſtin que ta faueur m’oblige, Voyez comme accablé du regret qui l’afflige Il giſt non-chalamment deſſus l’herbe eſtendu.	C'est quelque autre, ô destin que ta faveur m'oblige, Voyez comme accablé du regret qui l'afflige Il gît non-chalamment dessus l'herbe étendu.
Mais ie voy ſur cet arbre vn poignard ſuſpendu, Cachez vous pour vn peu ie crains qu’il n’entreprenne De ſe vanger ſur vous de l’exces de ſa peine.	Mais ici voy sur cet arbre un poignard suspendu, Cachez -vous pour un peu toujours crains qu'il n'entreprenne De se venger sur vous de l'excès de sa peine.
Ie m'en vay laborder.	Je m'en vais laborder.
ALIDOR.	ÀLIDOR.
Dieux!	Dieux!
ou vas tu ſi tard?	ou vas tu si tard?
PHITIDAN.	PHITIDAN.
I'ay pour mes conducteurs l’Amour & le HaZ ard Deux deitez ſans yeux.	J'ai pour mes conducteurs l'Amour et le Hasard ard Deux déité sans yeux.
.	.
ALIDOR.	ÀLIDOR.
D'on viens iu .	D'on viens ju .
PHILIDAN.	PHILIDAN.
Du Village	Du Village
Qu'y fait on?	Qu'y fait on?
ALIDOR.	ÀLIDOR.
PHILIDAN.	PHILIDAN.
Rien du tout,	Rien du tout,
ALIDOR.	ÀLIDOR.
Et ce beau mariage De Cloriſe & a'Eraſte eſt-i point ache ué?	Et ce beau mariage De Clorise et a'Éraste est- jon ache ?
PHILIDAN.	PHILIDAN.
Peut-eſtre en quelque ſonge où vous l'au reſué.	Peut-être en quelque songe où vous l'au rêvé.
ALIDOR.	ÀLIDOR.
dy mrigneres donc!	dis mrignères donc!
helas Cloriſe me me M’a prononcé l’arreſt de ce malheur ext me.	hélas Clorise me me M'a prononcé l'arrêt de ce malheur ext me.
PHILIDAN.	PHILIDAN.
Cloriſe!	Clorise!
nullement elle a l’esprit trop fort Pour eſpouſer iamais qu'Alidor ou la mort.	nullement elle a l'esprit trop fort Pour épouser jamais qu'Alidor ou la mort.
ALIDOR.	ÀLIDOR.
Ah que ton iugement, d’ignorance coupable, Cognoiſt mal les defauts dot ce ſexe eſt capable, Mais,	Ah que ton jugement, d'ignorance coupable, Cognoist mal les défauts dot ce sexe est capable, Mais,
PHILIDAN.	PHILIDAN.
N'en murmurez point, vostre felicité Se void au plus haut poinct qu’ell’ait iamais eſté.	N'en murmurez point, votre félicité Se voit au plus haut point qu'elle est jamais été.
ALIDOR.	ÀLIDOR.
Ouy *car ie n'eus iamais vn ſi proche remede garde ie Que ie puſſe appliquer au mal qui me poſſe-g’ird de,	Oui *car au J'eus jamais un si proche remède garde pers Que ie pusse appliquer au mal qui me posse-g'ird de,
PHILIDAN.	PHILIDAN.
Prophete, vous parlez mieux que vous ne penſez.	Prophète, vous parlez mieux que vous ne pensez.
ALIDOR.	ÀLIDOR.
Tu retiens mes eſprits en doute balancez.	Tu retiens mes esprits en doute balancés.
1;	1;
PHILIDAN.	PHILIDAN.
En vnmot ce riual vos deſſeins authoriſe	En unmot ce rival vos desseins autorise
ALIDOR.	ÀLIDOR.
Ouy celuy de mourir.	Oui celui de mourir.
PHILIDAN.	PHILIDAN.
Non, d'eſpouſer Cloriſe.	Non, d'épouser Clorise.
ALIDOR.	ÀLIDOR.
Ah foible inuention qui ne peut reüßir Tu crois par ce rapport mes trauaux adoucir;	Ah faible invention qui ne peut réussir Tu crois par ce rapport mes travaux adoucir;
Mais tu n’auances rien, tes ruſes nompareilles Ne ſçauroient dementir mes yeux ny mes oreilles.	Mais tu n'avances rien, tes ruses nompareilles Ne sauraient démentir mes yeux toujours mes oreilles.
Eo ma	Eo ma
PHILIDAN.	PHILIDAN.
Vous ne me croyeZ point?	Vous ne me croisez point?
ALIDOR.	ÀLIDOR.
Cela m'eſt interdit.	Cela m'est interdit.
PHILIDAN.	PHILIDAN.
Voudriez vous point qu’encor Eraſte vous le aik:	Voudriez -vous point qu'encor Éraste vous le aik:
ALIDOR.	ÀLIDOR.
Ouy vrayment:	Oui vraiment:
pour guerir du mal que ie ſupporte Il ne m’en faudroit pas vne preuue moins forAvraisttiant ſe peut, it ne demordra pas De ce riche butin qu'en faueur du treſpas.	pour guérir du mal que Dieu supporte Il ne m'en faudrait pas une preuve moins forAvraisttiant se peut, it ne démordra pas De ce riche butin qu'en faveur du trépas.
Eraſte AAILIDAN.	Eraste AAILIDAN.
ALIDOR.	ÀLIDOR.
Dieux!	Dieux!
amis n’eſt-ce point quelque ſonge Ou cette viſion fantaſtique me plonge?	amis n'est-ce point quelque songe Ou cette vision fantastique me plonge?
ERASTE.	ERASTE.
C’eſt vne verité qui te donne cet heur De reuoir ta Cloriſe.	C'est une vérité qui te donne cet heur De revoir ta Clorise.
I lu	I lu
PHILIDAN.	PHILIDAN.
Et bien ſuis-ie menteur?	Et bien suis-je menteur?
ALIDOR.	ÀLIDOR.
Berger digne vrayment de loüange eternelle, Excuſe les tranſports d’vne ame criminelle, LAcuſe vnamoureux, qui ſe trouut en effect Indigne des faueurs que ta grace luy faict.	Berger digne vraiment de lange éternelle, Excuse les transports d'une âme criminelle, LAcuse unamoureux, qui se trouut en effet Indigne des faveurs que ta grâce un fait.
ERASTE.	ERASTE.
Toy cher amy pardonne à ma ſeule ignorance L’iniure que i’ay faitte à ta perſeuerance:	Toi cher ami pardonne à ma seule ignorance L'injure que j'ai faites à ta persévérance:
Ie la viens reparer & par mille ſerments Attacher mon repos à tes contentements Nicandre trouuera s’il me veut ſatisfaire Aſſez d’autres beauteZ capables de luy plaire, Pour moy, i'aymerois mieux estre priué du iour Que de t’auoir rauy l’obiect de ton amour Ton Adieum’a touché tantost de telle ſorte Moumenbepru pour vn Tronc dont la raci ne eſt morte, Et te voyant partir i’ay ſenty les efforts – Que fait l’ame en forçant la priſon de ſon corps Mais ſans perdre du temps retournons au Village Que la nuict y commence auec ton MariaMon pere en eſt contẽt Phedon le veut außi, Tout ce que i’y pretends ie te le cede icy:	Je la viens réparer et par mille serments Attacher mon repos à tes contentements Nicandre trouvera s'il me veut satisfaire Assez d'autres beautés capables de M plaire, Pour moi, j'aimerais mieux prendre privé du jour De de ravoir ravis l'objet de ton amour Ton Adieum'a touché tantôt de telle sorte Moumenbepru pour un Tronc dont la raci ne est morte, Et te voyant partir j'ai senti les efforts Que fait âme en forçant la prison de son corps Mais sans perdre du temps retournons au Village Que la nuict y commence auec ton MariaMon pere en est contẽt Phedon le veut aussi, Tout ce que y prétends ie te le cede :
Si bien que tu n’auras en ta belle entrepriſe De plus fort ennemy que l'eſprit de Cloriſe Iuge par ce diſcours de ta prosperité.	Si bien que tu n'auras en ta belle entreprise De plus fort ennemi que l'esprit de Clorise Juge par ce discours de ta prospérité.
ALIDOR.	ÀLIDOR.
Vnique & cher Autheur de ma felicité, Quels perils recherchez, & quelle ſerlitude Ne me laiſſeront pas noircy d’ingratitude Par queiies acitons pourray-te m'atquitter Des faueurs que la tienne a voulu mert ter.	Unique et cher Auteur de ma félicité, Quels périls recherchés, et quelle serlitude Ne me laisseront pas noirci d'ingratitude Par que acitons pourrai-te m'atquitter Des faveurs que la tienne a voulu mert ter.
PHILIDAN.	PHILIDAN.
Trefue à ces Compliments, ou l’on nous va ſurprendre Ie voy venir à nous & Phedon & Nicandre, Cloriſe eſt auec eux, ma bergere les fuit.	Trefue à ces Compliments, ou l'on nous va surprendre Je vois venir à nous et Phédon et Nicandre, Clorise est avec eux, ma bergère les fuit.
I uij	I Juij
ERASTE.	ERASTE.
Ie ne demande pas quel deſir les conduit Nous ſommes le ſuiect de leur impatience.	Je ne demande pas quel désir les conduit Nous sommes le sujet de leur impatience.
SCENE DERNIERE.	SCÈNE DERNIÈRE.
NICANDRE, ERASTE, PHEDON, ALIDOR, CIORISS, PHILIDAN, ELIANTE.	NICANDRE, ERASTE, PHÉDON, ALIDOR, CIORIS, PHILIDAN, ÉLIANTE.
NICANDRE.	NICANDRE.
Os maux ſont accomplis i’en voy l’exN perience	Os maux sont accomplis j'en vois l'exN périence
E RASTE.	E RASTE.
Venerable Phedon voicy le ſeul berger Qui doibt, gendre accepté, voſtre aage ſoulager.	Vénérable Phédon voici le seul berger Qui doibt, gendre accepté, votre âge soulager.
PHEDON.	PHÉDON.
Approche mõ enfant, vraye & viuante image D’vn pere qui iadis fuſt l’honneur de noſtre aage, Et qui ſceut le premier en cet heureux ſeiour Faire regner la Paix, la Iuſtice, & l’Amour.	Approche momme enfant, vraie et vivante image D'un père qui jadis fût l'honneur de notre âge, Et qui sut le premier en cet heureux séjour Faire régner la Paix, la Justice, et l'Amour.
ALIDOR.	ÀLIDOR.
Ionneur de nos foreſts, ſi contre ce coupable Voſtre ame deſormais de vengeance eſt capable, Qu'elle en faſſe l’arreſt, me voicy reſolu De ſuiure aueuglément ce qu'elle aura voulu iſpoſeZ de mon ſort au gré de voſtre enuie yſouſmets ma franchiſe & mes biens, & ma vie.	Jonneur de nos forêts, si contre ce coupable Votre âme désormais de vengeance est capable, Qu'elle en fasse l'arrêt, me voici résolu De suivre aveuglément ce qu'elle aura voulu isposés de mon sort au gré de votre envie ysousmets ma franchise et mes biens, et ma vie.
PHEDON.	PHÉDON.
Leue toy, ie ne puis blaſmer tes actions Que de m’auoir trop tard ouuert tes paßions Mais puiſque la faueur d’Eraſte & de Nicandre e veut ceder vn bien qu’ils te pouuoient defendre Confeſſe que tu tiens ma fille & ta moitié Je ton propre merite & de leur amitié.	Leve -toi, je ne puis blâmer tes actions Que de m'avoir trop tard ouvert tes passions Mais puisque la faveur d'Eraste et de Nicandre e veut céder un bien qu'ils te pouvaient défendre Confesse que tu tiens ma fille et ta moitié Je ton propre mérite et de leur amitié.
AMLCIC.	AMLCIC.
h mon ame ſe perd dans l’exces de ſa ioye.	h mon âme se perd dans l'excès de sa joie.
CLORISE.	CLORISE.
L-il vray que ie viue & que ie te reuoye Alidor.	L'il vrai que ici vive et que sans te revoie Alidor.
Mais pardonne au reſpect que ie doib A ceux de qui ie tiens l’aiſe auquel tu me vois Sans cela dans mes bras.	Mais pardonne au respect que iedoib A ceux de qui ren tiens l'aise auquel tu me vois Sans cela dans mes bras.
ALIDOR.	ÀLIDOR.
N’en dittes plus mon anVous allez augmentant mon amoureuſe flan Ie vay remercier Phedon de ce bien fait.	N'en dites plus mon anUous allez augment mon amoureuse flan Je vais remercier Phédon de ce bien fait.
PHILIDAN Sans doute nos deſirs auront vn meſme effeſt Les Dieux en ſoient loüez, nous verrons Vnis en meſme temps par nos deux marias.	PHILIDAN Sans doute nos désirs auront un même effêt Les Dieux en soient louez, nous verrons Unis en même temps par nos deux marias.
Iconſents-ta monceur.	Iconsens-ta monceur.
ELIANTE.	ÉLIANTE.
Ton deſir eſt le mie	Ton désir est le mie
PHILIDAN, Que cette nuict m’oblige & me promet bien.	PHILIDAN, Que cette nuit m'oblige et me promet bien.
NICANDRE.	NICANDRE.
Remettez ce diſcours & finiſſons l’affaire Il s'agit moins icy de parler que de faire.	Remettez ce discours et finissons l'affaire Il s'agit moins ici de parler que de faire.
ERASTE.	ERASTE.
Les corps n’õt deſia plus d’ombres ny de couleur Allons dans le repos perdre noſtre douleur.	Les corps n'ont déjà plus d'ombres ni de couleur Allons dans le repos perdre notre douleur.
PHEDON.	PHÉDON.
Allons que de nos chants tout le Hameaureſonne Que d’vn Myrthe amoureux voſtre chef ſe couronne;	Allons que de nos chants tout le Hameauresonne Que d'un Myrte amoureux votre chef se couronne;
Que les jeux, les feſtins, & les balets encor De cet Age de fer faſſent vn Siecle d’or:	Que les jeux, les festins, et les ballets encor De cet Age de fer fassent un Siècle d'or:
Que deſormais nos ſens loing des traicts de l’enuie Gouſtent parfaittement les douceurs de la vie Et qu’vn docte trauail tant de fois merité Conſacre voſtre hiſtoire à l’immortalité.	Que désormais nos sens loing des traits de l'envie Goûtent parfaittement les douceurs de la vie Et qu'un docte travail tant de fois mérité Consacre votre histoire à l'immortalité.
FIN.	FIN.
Exiaitr au lrintegc an Ioy.	Exiaitr au lrintegc an Ioi.
AR Grace & Priuilege de ſa Majeſté donné à Paris le troiſieſme iour de Septembre 1631.	AR Grâce et Privilège de sa Majesté donné à Paris le troisième jour de Septembre 1631.
ſigné Par le Roy en ſon Conſeil, Conrard, & ſeellé du grand Seau, il eſt permis à François Pomeray, marchand Libraire & Imprimeur à Paris, d’imprimer vendre & diſtribuer vn liure intitulé, LA CLORISE DV SIEVR BARO, PASTORALE, pendant le temps de ſin ans entiers, auec deffences à tous autres Librat res, & Imprimeurs, de l’imprimer, vendre n en debiter d’autre impreſſion que de celle qu' aura faict ou faict faire ledit Pomeray à peine de confiſcation des exemplaires contrefaicts u de quinze cens liures d’amende, deſpens, dommages & intereſts, voulant ſadicte Maieſte qu’en mettant le preſent extraict au commen coirent ou a ia firduurec irure, ir Iont tenu pou deuëment ſignifié à tous qu’il appart iendra ainſi qu’il eſt plus amplement porté par ledic Priuilege.	signé Par le Roi en son Conseil, Conrard, et seellé du grand Seau, il est permis à Français Pomerai, marchand Libraire et Imprimeur à Paris, d'imprimer vendre et distribuer un livre intitulé, LA LORISE DU SIEUR BARO, PASTORALE, pendant le temps de sin ans entiers, avec défenses à tous autres Librat rés, et Imprimeurs, de l'imprimer, vendre en débiter d'autre impression que de celle qu' ou fait ou fait faire ledit Perai à peine de confiscation des exemplaires contre de quinze cens liures amende, dépens, dommages et intérêts, voulant sadicte Maieste en mettant le présent extraict au commen coirent ou a firduurec irure, Iont tenu pou deuëment signifié tous il appart iendra ainsi il est plus amplement porté par ledic Priuilege.
Acheue d'imprimer pour la premiere fois le dernier iour de Decembre, 1631.	Achève d'imprimer pour la première fois le dernier jour de Décembre, 1631.
Exiaitr au lrintegc an Ioy.	Exiaitr au lrintegc an Ioi.
AR Grace & Priuilege de ſa Majeſté donné à Paris le troiſieſme iour de Septembre 1631.	AR Grâce et Privilège de sa Majesté donné à Paris le troisième jour de Septembre 1631.
ſigné Par le Roy en ſon Conſeil, Conrard, & ſeellé du grand Seau, il eſt permis à François Pomeray, marchand Libraire & Imprimeur à Paris, d’imprimer vendre & diſtribuer vn liure intitulé, LA CLORISE DV SIEVR BARO, PASTORALE, pendant le temps de ſin ans entiers, auec deffences à tous autres Librat res, & Imprimeurs, de l’imprimer, vendre n en debiter d’autre impreſſion que de celle qu' aura faict ou faict faire ledit Pomeray à peine de confiſcation des exemplaires contrefaicts u de quinze cens liures d’amende, deſpens, dommages & intereſts, voulant ſadicte Maieſte qu’en mettant le preſent extraict au commen coirent ou a ia firduurec irure, ir Iont tenu pou deuëment ſignifié à tous qu’il appart iendra ainſi qu’il eſt plus amplement porté par ledic Priuilege.	signé Par le Roi en son Conseil, Conrard, et seellé du grand Seau, il est permis à Français Pomerai, marchand Libraire et Imprimeur à Paris, d'imprimer vendre et distribuer un livre intitulé, LA LORISE DU SIEUR BARO, PASTORALE, pendant le temps de sin ans entiers, avec défenses à tous autres Librat rés, et Imprimeurs, de l'imprimer, vendre en débiter d'autre impression que de celle qu' ou fait ou fait faire ledit Perai à peine de confiscation des exemplaires contre de quinze cens liures amende, dépens, dommages et intérêts, voulant sadicte Maieste en mettant le présent extraict au commen coirent ou a firduurec irure, Iont tenu pou deuëment signifié tous il appart iendra ainsi il est plus amplement porté par ledic Priuilege.
Acheue d'imprimer pour la premiere fois le dernier iour de Decembre, 1631.	Achève d'imprimer pour la première fois le dernier jour de Décembre, 1631.
