ACTEORE DU PROLOGUE.	ACTEORE DU PROLOGUE.
A PAIX.	À PAIX.
Suite de la Paix.	Suite de la Paix.
UNE BERGERE.	UNE BERGÈRE.
Chœur & Troupe de Bergers & de Bergeres.	Chœur et Troupe de Bergers et de Bergères.
PROLOGUE.	PROLOGUE.
LA GLOIRE.	LA GLOIRE.
Suite de la Gloire.	Suite de la Gloire.
AFAAMEOE LA PAIX au milieu d’une troupe de Bergers.	AFFAMEOE LA PAIX au milieu d'une troupe de Bergers.
S Eſt en vain qu’aprés la victoire, Ie croyois poſſeder le vainqueur glorieux Par qui je regne dans ces lieux:	 Est en vain qu'après la victoire, Je croyais posséder le vainqueur glorieux Par qui je règne dans ces lieux:
Son cœur n’eſt fait que pour la gloire;	Son cœur n'est fait que pour la gloire;
Ce n'eſt que par des ſoins nouveaux, Qu'il veut ſe delaſſer de ceux qu’il prend pour elle;	Ce n'est que par des soins nouveaux, Qu'il veut se délasser de ceux qu'il prend pour elle;
Et je dois borner tout mon Zele à vous faire goûter le fruit de ſes travaux.	Et je dois borner tout mon Zèle à vous faire goûter le fruit de ses travaux.
Que les jeux, les plaiſirs, & la riche abondance.	Que les jeux, les plaisirs, et la riche abondance.
Ne vous abandonnent jamais.	Ne vous abandonnons jamais.
Faites voir à l’envi voſtre réjouïſſance;	Faites voir à l'envi votre réjouissance;
L’autheur des biens que je vous fais Ne veut point d’autre recompenſe.	L'auteur des biens que je vous fais Ne veut point d'autre récompense.
La ſuite de la Paix ſe meſle parmi les Bergers;	La suite de la Paix se mêle parmi les Bergers;
& tous enſemble forment une eſpece de feſte pour témoigner le plaiſir mutuel qu’ils reçoivent d’une union ſi douce.	et tous ensemble forment une espèce de fête pour témoigner le plaisir mutuel qu'ils reçoivent d'une union si douce.
INE BERGERE.	INE BERGÈRE.
Lors que la Paix vient regner ſur la terre;	Lors que la Paix vient régner sur la terre;
C’eſti à l’amour de regner dans les cœurs:	C'esti à l'amour de régner dans les cœurs:
C’eſt à ſon tour de nous faire la glierre;	C'est à son tour de nous faire la glierre;
Que tout cede à ſes traits vainqueurs:	Que tout cède à ses traits vainqueurs:
Lors que la Paix vient regner ſur la terre;	Lors que la Paix vient régner sur la terre;
C’eſt a l’amour de regner dans les cœurs.	C'est -à l'amour de régner dans les cœurs.
A peine le chœur a repeté ces ſix vers que la feſte eſt troublée par un bruit de guerre qui d’abord ſe fait entendre en éloignement.	À peine le chœur a répété ces six vers que la fête est troublée par un bruit de guerre qui d'abord se fait entendre en éloignement.
Le Chœur repete ces deux derniers vers;	Le Chœur répète ces deux derniers vers;
& la Paix continuë.	et la Paix continue.
Que mon regne auroit eù de charmes!	Que mon règne aurait éù de charmes!
Qu’il alloit donner de beaux jours!	Qu'il allait donner de beaux jours!
Faut-il que la fureur des armes En termine ſi-toſt le cours!	Faut-il que la fureur des armes En termine sitôt le cours!
Le bruit de guerre redouble & paroiſt plus proche.	Le bruit de guerre redouble et paraît plus proche.
Quel bruit!	Quel bruit!
quelles triſtes allarmes!	quelles tristes alarmes!
Bellone revient;	Bellone revient;
fuyons tous;	fuyons tous;
Sauvons-nous, ſauvons-nous.	Sauvons-nous, sauvons-nous.
Le Chœur repete ces deux derniers vers;	Le Chœur répète ces deux derniers vers;
& cependant la gloire paroiſt ſuivie des tambours & des trompettes qui ont formé le bruit de guerre.	et cependant la gloire paraît suivie des tambours et des trompettes qui ont formé le bruit de guerre.
LA PAIX.	LA PAIX.
Quel bruit!	Quel bruit!
quelles triſtes allarmes!	quelles tristes alarmes!
Bellonne revient;	Bellonne revient;
fuyons tous;	fuyons tous;
Sauvons-nous, ſauvons nous.	Sauvons-nous, sauvons nous.
LA GLOIRE Demeurez douce paix;	LA GLOIRE Demeurez douce paix;
que rien ne vous étonne;	que rien ne vous étonne;
Le plus puiſſant des Rois A trop bien affermi l’empire qu’il vous donne;	Le plus puissant des Rois À trop bien affermi l'empire qu'il vous donne;
Il n’aura plus beſoin du ſecours de Bellone:	Il n'aura plus besoin du secours de Bellone:
La memoire de ſes exploits, Et l’éclat dont je l’environne Suffiront à tenir l’Univers ſous ſes loix.	La mémoire de ses exploits, Et l'éclat dont je l'environne Suffiront à tenir l'Univers sous ses lois.
Regnez, tranquille paix;	Regnez, tranquille paix;
que rien ne vous étonne.	que rien ne vous étonne.
ReveneZ jeux charmants;	Revenez jeux charmants;
Bergers raſſurez-vous;	Bergers rassurez-vous;
Venez recommencer vos concerts les plus doux.	Venez recommencer vos concerts les plus doux.
Les tambours & les trompettes Vont s’unir à vos muſettes:	Les tambours et les trompettes Vont s'unir à vos musettes:
Ce qui ſervoit à vous troubler Va ſervir à vous raſſembler.	Ce qui servait à vous troubler Va servir à vous rassembler.
Aprés que la gloire & la paix ont repeté enſemble ces quatre derniers vers;	Après que la gloire et la paix ont répété ensemble ces quatre derniers vers;
& que les tambours, les trompettes, les muſettes & les hautbois ont formé un concert au bruit duquel la ſuite de la paix, & les Bergers ſe raſſemblent;	et que les tambours, les trompettes, les musettes et les hautbois ont formé un concert au bruit duquel la suite de la paix, et les Bergers se rassemblent;
la gloire continuë.	la gloire continue.
I’ay ſuivi dans ces lieux charmants Cet auguſte Heros que tout le montit ndmire:	J'ai suivi dans ces lieux charmants Cet auguste Héros que tout le montit nédire:
Il y vient, pour quelques moments, Prendre part au repos qu’il donne à ſon empire.	Il y vient, pour quelques moments, Prendre part au repos qu'il donne à son empire.
Profitez-en, Bergers heureux;	Profitez-en, Bergers heureux;
Venez le delaſſer par d’agreables jeux:	Venez le délacer par d'agréables jeux:
Offrez-luy ceux que vous inspire Ont palx qui comole eos cenxe.	Offrez-lui ceux que vous inspire Ont palx qui comole eos cènexe.
LA GLOIRE & LA PAIX enſemble.	LA GLOIRE et LA PAIX ensemble.
Le bonheur d’un peuple qu’il aime Eſt un doux ſpectacle à ſes yeux:	Le bonheur d'un peuple qu'il aime Est un doux spectacle à ses yeux:
A l’exemple des Dieux Il ſe fait un plaiſir ſuprême Des biens qu’il répand en tous lieux.	À l'exemple des Dieux Il se fait un plaisir suprême Des biens qu'il répand en tous lieux.
Quel plaiſir eſt plus glorieux!	Quel plaisir est plus glorieux!
La ſuite de la Paix, celle de la Gloire, & les Bergers puiimene, repetent ce que ces deux Deeſſes viennent de dire enſemble, & font voir par leurs danſes avec quelle allegreſſe ils ſe diſpoſent à divertir le plus illuſtre des Monarques.	La suite de la Paix, celle de la Gloire, et les Bergers puiimène, répètent ce que ces deux Déesses viennent de dire ensemble, et font voir par leurs danses avec quelle allégresse ils se disposent à divertir le plus illustre des Monarques.
FIN DU PROLOGUE.	FIN DU PROLOGUE.
ACTEURS	ACTEURS
6.	6.
ACT L DE ONS LA PASTORALE.	ACT L DE ONS LA PASTORALE.
RCAS, Berger oncle de Climene.	RACS, Berger oncle de Climène.
TIRCIS, Berger amoureux de Climene.	TIRCIS, Berger amoureux de Climène.
HILAS, Berger fameux inconſtant.	HILAS, Berger fameux inconstant.
CLIMENE, Bergere.	CLIMENE, Bergère.
CLORIS, Bergere amie de Climene.	CLORIS, Bergère amie de Climène.
CHOEUR & TROUPE d’Ouvriers qui preparent le lieu destiné pour les Jeux.	CHOEUR et TROUPE d'Ouvriers qui préparent le lieu destiné pour les Jeux.
TROUPE DE PAISANNES.	TROUPE DE PAYSANES.
DEUX BOHEMIENNES.	DEUX BOHÉMIENNES.
TROUPE DE BOHEMIENNES.	TROUPE DE BOHÉMIENNES.
QUATRE BERGERS,	QUATRE BERGERS,
DODELCLECO DE MARLY AATSIORIEE	DODELCLECO DE MARLY AATSIORIE
ACTE PREMIER.	ACTE PREMIER.
SCENE PREMIERE.	SCÈNE PREMIÈRE.
TIRCIS.	TIRCIS.
Emoins de ma longue ſouffrance, Favoriſez la violence Que je veux me faire en ce jour:	Emoins de ma longue souffrance, Favorisez la violence Que je veux me faire en ce jour:
Joignez voſtre ſecours à mon triſte ſilence.	Joignez votre secours à mon triste silence.
Pour cacher mon funeſte amour.	Pour cacher mon funeste amour.
Puis qu’il offenſe ma Bergere;	Puis qu'il offense ma Bergère;
Ah!	Ah!
puis qu’au lieu de la toucher, Cet amour malheureux m’expoſe à ſa colere;	puis qu'au lieu de la toucher, Cet amour malheureux m'expose à sa colère;
Ie ne ſçaurois trop le cacher.	Je ne saurais trop le cacher.
Témoins de ma longue ſouffrance, Ioignez voſtre ſecours à mon triſte ſilence.	Témoins de ma longue souffrance, Joignez votre secours à mon triste silence.
Couvrez, arbres officieux, CouvreZ le deſeſpoir qui paroiſt dans mes yeux, Sous l’épaiſſeur de vos ombrages;	Couvrez, arbres officieux, Couvrez le désespoir qui paraît dans mes yeux, Sous l'épaisseur de vos ombrages;
Eßuyez mes pleurs, doux Zephirs;	Essuyez mes pleurs, doux Zéphyrs;
Et vous, oiſeaux, par vos ramages, Aux échos indiſcrets derobez mes ſoupirs.	Et vous, oiseaux, par vos ramages, Aux échos indiscrets dérobez mes soupirs.
Témoins de ma longue ſouffrance, FavorijοN Mοotεnεε:	Témoins de ma longue souffrance, Favorij Mοotεnεε:
Que je veux me faire en ce jour:	Que je veux me faire en ce jour:
IoigneZ voſtre ſecours à mon triſte ſilence, Pour cacher mon funeſte amour.	Joignez votre secours à mon triste silence, Pour cacher mon funeste amour.
SCENE SECONDE.	SCÈNE SECONDE.
ARCAS, TIRCIS.	ARCAS, TIRCIS.
ARCAS.	ARCAS.
Velle preſſante inquietude  Peut te faire aujourd’huy chercher la ſolitude?	Velle pressante inquiétude Peut te faire aujourd'hui chercher la solitude?
Depuis Depuis que le doux Printemps Revient ſans le bruit des armes;	Depuis Depuis que le doux Printemps Revient sans le bruit des armes;
Depuis que nous gardons nos troupeaux ſans allarmes;	Depuis que nous gardons nos troupeaux sans alarmes;
Et que nos fruits, pour nous, meuriſſẽt dans nos chãps;	Et que nos fruits, pour nous, mûrissent dans nos chans;
Voicy le jour où, tous les ans On renouvelle une feſte galante Pour celebrer une Paix ſi charmante.	Voici le jour où, tous les ans On renouvelle une fête galante Pour célébrer une Paix si charmante.
Le grand Roy qui nous donne un bien ſi précieux, Pour prix de ſes ſoins glorieux, Et pour marque de ſa tendreſſe, Vient luy-même aujourd’huy ſe faire dans ces lieux, Un plaiſir de noſtre allegreſſe.	Le grand Roi qui nous donne un bien si précieux, Pour prix de ses soins glorieux, Et pour marque de sa tendresse, Vient lui-même aujourd'hui se faire dans ces lieux, Un plaisir de notre allégresse.
Du tous les hameaux d’alentour, Pour s’y rendre, chacun ſe preſſe:	Du tous les hameaux d'alentour, Pour s'y rendre, chacun se presse:
Veux-tu, ſeul, dans un ſi beau jour, Garder une indigne triſteſſe?	Veux-tu, seul, dans un si beau jour, Garder une indigne tristesse?
CIS.	CIS.
Eh!	Eh!
puis-je eſtre ſenſible aux douceurs de la Paix, Si de mon iriſte cœur une ioy trop cruelle La bannit pour jamais?	puis-je être sensible aux douceurs de la Paix, Si de mon iriste cœur une joi trop cruelle La bannit pour jamais?
Atteint d’une douleur mortelle, Ie ſens mon ſort plus rigoureux, Quand je vois tout le monde heureux.	Atteint d'une douleur mortelle, Je sens mon sort plus rigoureux, Quand je vois tout le monde heureux.
CAS.	CAS.
Il eſt peu de maux ſans remede:	Il est peu de maux sans remède:
Ne peut-on te ſecourir Dans celuy qui te poſſede?	Ne peut-on te secourir Dans celui qui te possède?
IRCIS.	JRCIS.
Le ſeul trépas peut le guerir.	Le seul trépas peut le guérir.
Dés ſes plus jeunes ans Climene ſçût me plaire;	Dès ses plus jeunes ans Climène reux me plaire;
Ie brûlois pour elle, en ſecret, Heureux ſi mon cœur indiſcret N'eût jamais découvert ſa flâme temeraire:	Je brûlais pour elle, en secret, Heureux si mon cœur indiscret N'eût jamais découvert sa flamme téméraire:
Du moins, j’aurois toûjours le plaiſir de la voir.	Du moins, j'aurais toujours le plaisir de la voir.
Helas!	Hélas!
elle m'impoſe une abſence éternelle:	elle m'impose une absence éternelle:
Helas!	Hélas!
je vais mourir, loin d’elle, De regret ou de deſeſpoir.	je vais mourir, loin d'elle, De regret ou de désespoir.
* RCAS.	* RCAS.
Sur Climene le ſang me donne quelque empire;	Sur Climène le sang me donne quelque empire;
Et pour toy, s’il le faut, je le feray valoir,	Et pour toi, s'il le faut, je le ferai valoir,
IRCIS.	JRCIS.
Son cœur n’eſt pas en ton pouvoir;	Son cœur n'est pas en ton pouvoir;
Et c’eſt le ſeul bien où j’aſpire.	Et c'est le seul bien où j'aspire.
ARCAS.	ARCAS.
C’eſt dans ce même lieu qu’on doit faire les jeux;	C'est dans ce même lieu qu'on doit faire les jeux;
En jomen vais preſſer nos Bergers de s’y rendre!	En jomen vais presser nos Bergers de s'y rendre!
Toy, tu peux icy les attendre.	Toi, tu peux ici les attendre.
Tu verras Climene avec eux;	Tu verras Climène avec eux;
Mais n’évite point ſa preſence;	Mais n'évite point sa présence;
D'un ordre ſi rigoureux L’amour même te diſpenſe:	D'un ordre si rigoureux L'amour même te dispense:
Eſpere tout de luy, de moy, de ta conſtance.	Espère tout de belle, de moi, de ta constance.
Ie trouveray, peut-être, avant la fin du jour.	Je trouverai, peut-être, avant la fin du jour.
Le temps de jereir ion amour.	Le temps de jereir ion amour.
SCENE TROISIESME.	SCÈNE -TROISIÈME.
TIRCIS ſeul.	TIRCIS seul.
Aut-il, par ma preſence, irriter ce que j’aime?	Aut-il, par ma présence, irriter ce que j'aime?
Faut-il m’arracher à moy-même En m'éloignant de tant d’appas?	Faut-il m'arracher à moi-même En m'éloignant de tant d'appas?
Infortuné Tircis!	Infortuné Tircis!
helas!	hélas!
Fuyons:	Fuyons:
faiſons-nous violence:	faisons-nous violence:
Mourons, & ne l’irritons pas.	Mourons, et ne l'irritons pas.
Peut-étre mon obéiſſance.	Peut-être mon obéissance.
Fera regretter mon trépas.	Fera regretter mon trépas.
oG il iu1	oG il ju1
SCENE QUATRIESME.	SCÈNE QUATRIÈME.
Des Ouvriers de pluſieurs ſortes, conduits par Hilas, viennent preparer ce lieu pour les Jeux.	Des Ouvriers de plusieurs sortes, conduits par Hilas, viennent préparer ce lieu pour les Jeux.
Ils l’aplaniſſent & l’environnent d’une eſpece d’Amphiteâtre dont ils ont apporté les pieces.	Ils l'aplanissent et l'environnent d'une espèce d'Amphiteâtre dont ils ont apporté les pièces.
HILAS, CHœUr ET TROUPE	HILAS, CHœUr ET TROUPE
HILAS.	HILAS.
Llons, que chacun s’avance;	Llons, que chacun s'avance;
Preparez promptement ces lieux:	Préparez promptement ces lieux:
D’un jour de réjouïſſance Pous les momems jou preciomves	D'un jour de réjouissance Pous les momems jou reciomves
CHOEUR.	CHOEUR.
Allons, que chacun s’avance;	Allons, que chacun s'avance;
Preparons promptement ces lieux:	Préparons promptement ces lieux:
D’un jour de réjouiſſance Tous les moments ſont precieux.	D'un jour de réjouissance Tous les moments sont précieux.
Sur le point que l’ouvrage eſt achevé, il paſſe une troupe de Païſannes que ces Ouvriers obligent de danſer avec eux.	Sur le point que l'ouvrage est achevé, il passe une troupe de Paysannes que ces Ouvriers obligent de danser avec eux.
SCENE CINQUIESME.	SCÈNE CINQUIÈME.
Ils ſont interrompus par une troupe de Bohemiennes qui vient en danſant ſe mêler parmi eux;	Ils sont interrompus par une troupe de Bohemiennes qui vient en dans se mêler parmi eux;
ce qui les oblige de témoigner leur défiance par des poſtures plaiſantes;	ce qui les oblige de témoigner leur défiance par des postures plaisantes;
& enfin, de ſe retirer.	et enfin, de se retirer.
Hilas en fait une galanterie aux Bohemiennes, & les engage à eſtre de la feſte.	Hilas en fait une galanterie aux Bohémiennes, et les engage à être de la fête.
HILAS, DEUX BOHEMIENNES, TROUPE DE BOHEMIENNES.	HILAS, DEUX BOHÉMIENNES, TROUPE DE BOHÉMIENNES.
Ah!	Ah!
An:	An:
ſi vous en eſitez, qu'eue ſeroit charmante!	si vous en esitez, qu'eue serait charmante!
PREMIERE BOHEMIENNE.	PREMIÈRE BOHÉMIENNE.
Lors qu’on nous offre des plaiſirs, Nous ne ſçavons point nous défendre.	Lors qu'on nous offre des plaisirs, Nous ne savons point nous défendre.
DEUXIESME BOHEMIENNE.	DEUXIÈME BOHÉMIENNE.
Avec empreſſement nous les cherchons toûjours.	Avec empressement nous les cherchons toujours.
Mais, Berger, qu’à vôtre air vous me paroiſſez tẽdre!	Mais, Berger, qu'à votre air vous me paraissez tendre!
ENSEMDLE.	ENSEMDLE.
Donnez-nous vôre main, nous allons vous apprendre Tout le ſuccés de vos amours.	Donnez-nous vôre main, nous allons vous apprendre Tout le succès de vos amours.
HILAS.	HILAS.
Pour dire la bonne-aventure L’art n’aprend que de vains ſecrets.	Pour dire la bonne-aventure L'art n'apprend que de vains secrets.
Conſultez plûtoſt la naim.	Consultez plutôt la naim.
Qui vous a faites tout exprés, Pour faire la bonne-aventure.	Qui vous a faites tout exprès, Pour faire la bonne-aventure.
PREMIERE BOHEMIENNE.	PREMIÈRE BOHÉMIENNE.
En tous lieux, dans mon art, je me fais admirer.	En tous lieux, dans mon art, je me fais admirer.
DEUXIESME BOHEMIENNE.	DEUXIÈME BOHÉMIENNE.
Ma ſcience n’eſt pas commune.	Ma science n'est pas commune.
HILAS.	HILAS.
N’importe, je veux ignorer Ce que me garde la fortune.	N'importe, je veux ignorer Ce que me garde la fortune.
Un bien n’en eſt que plus doux, Lors qu’il vient ſans qu’on y penſe:	Un bien n'en est que plus doux, Lors qu'il vient sans qu'on y pense:
Souffrir un mal par avance, C’eſt en redoubler les coups.	Souffrir un mal par avance, C'est en redoubler les coups.
Tout eſt preſt:	Tout est prêt:
il eſt temps que la feſte commence.	il est temps que la fête commence.
Ne tardez pas;	Ne tardez pas;
Suivez mes pas.	Suivez mes pas.
En diligence.	En diligence.
HILAS ET LES DEUX BOHEMIENNES.	HILAS ET LES DEUX BOHÉMIENNES.
Hilas.	Hilas.
Ne tardez-pas L Suivez mes pas.	Ne tardez-pas L Suivez mes pas.
Ne tardons-pas Les Bohemiennes.	Ne tardons-pas Les Bohemiennes.
S Suivons ſes pas C En diligence.	 Suivons ses pas Ç En diligence.
Hilas s’en va & toute la troupe le ſuit, aprés avoir, par quelques pas de danſe marqué la joye qu’elle a d’être de la feſte.	Hilas s'en va et toute la troupe le suit, après avoir, par quelques pas de danse marqué la joie qu'elle a d'être de la fête.
INCIEEBONVEY.	INCIEBONVEY.
SCENE PREMIERE.	SCÈNE PREMIÈRE.
CLIMENE ſeule.	CLIMENE seule.
Aiſſe, laiſſe en repos, impuiſſante fierté, Un cœur que tu n'as pu deffendre:	Aisse, laisse en repos, impuissante fierté, Un cœur que tu n'as pu défendre:
Tes vains efforts, pour le reprendre, Ne m’ont déja que trop coûté.	Tes vains efforts, pour le reprendre, Ne m'ont déjà que trop coûté.
Tu veux ſurmonter ma foibleſſe, Helas!	Tu veux surmonter ma faiblesse, Hélas!
& tu ne peux ſeulement la cacher!	et tu ne peux seulement la cacher!
Comment veux tu guerir la douleur qui me preſſe?	Comment veux tu guérir la douleur qui me presse?
Tu ne ſçaurois arracher Le trait fatal qui me bleſſe.	Tu ne saurais arracher Le trait fatal qui me blesse.
Laiſſe mon cœur en paix, impuiſſante fierté, Que ſert-il à ta cruauté D’exiler un Berger fidele?	Laisse mon cœur en paix, impuissante fierté, Que sert-il à ta cruauté D'exiler un Berger fidèle?
En ſuis-je plus en 'ſeureté?	En suis-je plus en 'seureté?
Son image charmante, à tes ordres rebelle, Vient ſans ceſſe m’entretenir:	Son image charmante, à tes ordres rebelle, Vient sans cesse m'entretenir:
Dés que tu penſe la banir, L’Amour, plus puiſſant la rapelle.	Dès que tu pense la banir, L'Amour, plus puissant la rappelle.
Laiſſe, laiſſe en repos, impuiſſante fierté, en pour que tu n’as pu deffendre:	Laisse, laisse en repos, impuissante fierté, en pour que tu n'as pu défendre:
Tes vains efforts, pour le reprendre, Ne m oni deja que trop coute.	Tes vains efforts, pour le reprendre, Ne m oni déjà que trop coute.
SCENE SECONDE.	SCÈNE SECONDE.
CLIMENE, CLORIS.	CLIMENE, CLORIS.
I CLORIS.	I CLORIS.
On changement m’eſtonne;	On changement m'étonne;
& je n’en ſçay que dire.	et je n'en sais que dire.
Autrefois tu n’aimois qu’à rire;	Autrefois tu n'aimais qu'à rire;
Tu ne pouvois vivre ſans moy;	Tu ne pouvais vivre sans moi;
Tu me fuis;	Tu me fuis;
tu deviens réveuſe:	tu deviens réveuse:
Quand Dircé devint amoureuſe, Elle fit de meſme que toy.	Quand Dircé devint amoureuse, Elle fit de même que toi.
CLIMENE.	CLIMENE.
Non, ce n’eſt point à toy, Cloris, que je veux faire Un vain miſtere, D’un mal que trahit ma langueur.	Non, ce n'est point à toi, Cloris, que je veux faire Un vain mystère, D'un mal que trahit ma langueur.
Tircis n'a que trop ſçeu me plaire;	Tircis n'a que trop su me plaire;
Il regne en ſecret dans mon cœur.	Il règne en secret dans mon cœur.
En vain, pour combatre ma flamme, Ma fierté s’arme de rigueur;	En vain, pour combattre ma flamme, Ma fierté s'arme de rigueur;
Elle a du pouvoir ſur mon ame Aſſez pour la faire ſouffrir;	Elle a du pouvoir sur mon âme Assez pour la faire souffrir;
Mais, helas, elle en a trop peu pour la guerir.	Mais, hélas, elle en a trop peu pour la guérir.
Tu ris, inhumaine, De ma douleur!	Tu ris, inhumaine, De ma douleur!
LORIS.	LORIS.
Je ris, ma Climene, De ton erreur.	Je ris, ma Climène, De ton erreur.
Quand on ſe ſent le cœur tendre, Pourquoy perdre, à ſe deffendre, Un temps qu'on doit aux plaiſirs?	Quand on se sent le cœur tendre, Pourquoi perdre, à se défendre, Un temps qu'on doit aux plaisirs?
Souvent on voudroit ſe rendre, Lors qu’un Amant, las d’attendre, A perdu tous ſes deſirs.	Souvent on voudrait se rendre, Lors qu'un Amant, las d'attendre, A perdu tous ses désirs.
Eleinble.	Élinble.
Trop heureux, dans ſa foibleſſe, Un cœur qui ſans peine est domté!	Trop heureux, dans sa faiblesse, Un cœur qui sans peine est domté!
Malheureux, lors que la fierté	Malheureux, lors que la fierté
LIMENE.	LIMENE.
La tranquille Paix Ne ſe tient jamais Où l’on reconnoiſt plus d’un Maiſtre.	La tranquille Paix Ne se tient jamais Où l'on reconnaît plus d'un Maître.
CLORIS.	CLORIS.
A quoy bon faire un vain effort?	À quoi bon faire un vain effort?
L'Amour le doit eſtre;	L'Amour le doit être;
Il est le plus fort.	Il est le plus fort.
Enſemble.	Ensemble.
Trop heureux, dans ſa foibleſſe, Un cœur qui ſans peine est domté!	Trop heureux, dans sa faiblesse, Un cœur qui sans peine est domté!
Malheureux, lors que la fierté Le diſpute à la tendreſſe!	Malheureux, lors que la fierté Le dispute à la tendresse!
LORIS.	LORIS.
Tircis vient:	Tircis vient:
de ton cœur l’amour veut prendre ſoin:	de ton cœur l'amour veut prendre soin:
Il te rend ce Berger;	Il te rend ce Berger;
& je vous laiſſe enſemble:	et je vous laisse ensemble:
L’amour ne veut point de témoin.	L'amour ne veut point de témoin.
CLIMENE.	CLIMENE.
Ne m’abandonne pas.	Ne m'abandonne pas.
je tremble.	Je tremble.
LORTS.	LORTS.
Que crains-tu d’un Berger ſi ſoûmis à tes Loix?	Que crains-tu d'un Berger si soumis à tes Lois?
SCENE TROISIE’ME.	SCÈNE -TROISIE'ME.
TIRCIS, CLIMENE.	TIRCIS, CLIMENE.
TIRCIS.	TIRCIS.
Scoute un malheureux, pour la derniere fois.	Soute un malheureux, pour la dernière fois.
A Je vais, enfin, te ſatisfaire:	A Je vais, enfin, te satisfaire:
Pour te vanger plustost, d’un amour temeraire, Je vais hâter l’effet de ma triste langueur Heureux, ſi mon trépas appaiſe ta rigueur.	Pour te venger plutôt, d'un amour téméraire, Je vais hâter l'effet de ma triste langueur Heureux, si mon trépas appaise ta rigueur.
C’est l’unique bien que j’eſpere:	C'est l'unique bien que j'espère:
Si je puis m’en flater, trop aimable Bergere, Tout funeſte qu’il eſt mon deſtin ſera doux.	Si je puis m'en flatter, trop aimable Bergère, Tout funeste qu'il est mon destin sera doux.
Je ne crains rien que ton couroux;	Je ne crains rien que ton courroux;
Mon cœur ne connoiſt point de ſi cruels ſuplices.	Mon cœur ne connaît point de si cruels suplices.
Adieu:	Adieu:
perds, s’il ſe peut, juſques au ſouvenir D’un crime, dont le Ciel & tes yeux ſont complices, Et dont je vais ſeul me punir.	perds, s'il se peut, jusques au souvenir D'un crime, dont le Ciel et tes yeux sont complices, Et dont je vais seul me punir.
CLIMENE.	CLIMENE.
Tu me fais une double offenſe:	Tu me fais une double offense:
Non, mon cœur innocent n’étend point ſa vengeance Juſques à te faire perir.	Non, mon cœur innocent n'étend point sa vengeance Jusques à te faire périr.
CIS.	CIS.
Tu me bannis de ta preſence, Cruelle;	Tu me bannis de ta présence, Cruelle;
n’eſt-ce pas m’ordonner de mourir?	n'est-ce pas m'ordonner de mourir?
SBIMENE.	SBIMENE.
Tu n'es pas l’objet de ma haine;	Tu n'es pas l'objet de ma haine;
C’eſt l’amour ſeul que je fuïs:	C'est l'amour seul que je fuis:
Ne m'en parle jamais, Tircis;	Ne m'en parle jamais, Tircis;
Et je te verray ſans peine.	Et je te verrai sans peine.
F CIS.	 FIS.
Quand, pour cacher mon amour, Je me ferois violence;	Quand, pour cacher mon amour, Je me ferais violence;
Tout, juſques à mon ſilence, T’en parleroit chaque jour.	Tout, jusques à mon silence, T'en parlerait chaque jour.
Climene, ſe peut-il que ton cœur s’effarouche Au nom du plus charmant des Dieux!	Climène, se peut-il que ton cœur s'effarouche Au nom du plus charmant des Dieux!
Ne peux-tu ſouffrir dans ma bouche, Un Dieu qui regne dans tes yeux?	Ne peux-tu souffrir dans ma bouche, Un Dieu qui règne dans tes yeux?
Tu ne m'écoutes pas:	Tu ne m'écoutes pas:
ma preſence te geſne.	ma présence te gêne.
Pourquoy perdre le temps en diſcours ſuperflus?	Pourquoi perdre le temps en discours superflus?
ontuous orteut;	ontvous orteut;
uuieu s tu ne me verras plus.	uuieu tu ne me verras plus.
CLIMENE.	CLIMENE.
Ta eas mouri:	Ta eas mouri:
IRCIS.	JRCIS.
Je vais où ta rigueur m’entraîne.	Je vais où ta rigueur m'entraîne.
Tircis!	Tircis!
CLIMENE.	CLIMENE.
TIRCIS.	TIRCIS.
Quomtensefe, cul?	Quomptensefe, cul?
& que ouenseſe ue voir!	et que ouensée ue voir!
Tes yeux couverts de pleurs, & ton cœur qui ſoupire.	Tes yeux couverts de pleurs, et ton cœur qui soupire.
LIMENE.	LIMENE.
Helas!	Hélas!
ils t’en font trop ſçavoir;	ils t'en font trop savoir;
Et plus que je n’en voulois dire.	Et plus que je n'en voulais dire.
S.	S.
Se peut-il que tout preſt de courir à la mort.	Se peut-il que tout prêt de courir à la mort.
CLIMENE.	CLIMENE.
On vient;	On vient;
modere ton tranſport.	modère ton transport.
SCENF	SCENF
SCENE QUATRIE’ME.	SCÈNE QUATRIE'ME.
ARCAS, TIRCIS, HILAS, CLIMENE, CLORIS, TROIS BERGERS, DEuX BERGERES, CHOEURET TROUPE DE BERGERS ET DE BERGERES, TROUPE DE BOHEMIENNES.	ARCAS, TIRCIS, HILAS, CLIMENE, CLORIS, TROIS BERGERS, DEuX BERGERES, CHOURET TROUPE DE BERGERS ET DE BERGERES, TROUPE DE BOHÉMIENNES.
La Feſte s’avance en bon ordre, au bruit de pluſieurs Inſtruments Champeſtres.	La Fête s'avance en bon ordre, au bruit de plusieurs Instruments Champêtres.
CHOEUR.	CHOEUR.
Douce Paix!	Douce Paix!
Que vous eſtes charmante!	Que vous êtes charmante!
Ne nous quittez jamais.	Ne nous quittez jamais.
Qu’icy tout ſe reſſente De vos bienfaits.	Qu'ici tout se ressente De vos bienfaits.
ARCAS.	ARCAS.
Conſervez à noſtre terre Son heureuſe fertilité:	Conservez à notre terre Son heureuse fertilité:
Qu’une longue felicité Nous faſſe oublier la Guerre.	Qu'une longue félicité Nous fasse oublier la Guerre.
Ou, du moins, ſi de ſes fureurs On ne peut oublier l’Hiſtoire;	Ou, du moins, si de ses fureurs On ne peut oublier l'Histoire;
Qu’une ſi funeſte Memoire Faſſe mieux ſentir vos douceurs.	Qu'une si funeste Mémoire Fasse mieux sentir vos douceurs.
CHOEUR.	CHOEUR.
O douce paix!	Ô douce paix!
Que vous eſtes charmante!	Que vous êtes charmante!
Ne nous quittez jamais:	Ne nous quittez jamais:
Qu'icy tout ſe reſſente De vos bienfaits.	Qu'ici tout se ressente De vos bienfaits.
Une partie des Bergers & des Bergeres va prendre place avec la Symphonie ſur l’Amphiteatre que i oir a drerie enpresy d ou par res Charits, elle anime l’autre partie qui s’exerce à la Danſe, à la Luitte, & à Sauter, leurs Jeux ordinaires.	Une partie des Bergers et des Bergères va prendre place avec la Symphonie sur l'Amphiteatre que j' avoir a drie enprési d ou par rés Charits, elle anime l'autre partie qui s'exerce à la Danse, à la Luite, et à Sauter, leurs Jeux ordinaires.
TRRVITERE BERGERE au milieu d’une Troupe de Bergers & de Bergeres qui danſent.	TRRVITERE BERGÈRE au milieu d'une Troupe de Bergers et de Bergères qui dansent.
Chantons, danſons ſous cét ombrage;	Chantons, dansons sous cet ombrage;
Ne craignons pas que rien trouble nos Jeux.	Ne craignons pas que rien trouble nos Jeux.
Le Chœur repete ces deux Vers.	Le Chœur répète ces deux Vers.
De boberoy proproe u nos ouux, A diſſipé juſqu’au moindre nuage.	De boberai proproe nos œux, A dissipé jusqu'au moindre nuage.
IOEUR.	JOUR.
Chantons, danſons ſous cét ombrage;	Chantons, dansons sous cet ombrage;
Ne craignons pas que rien trouble nos Jeux.	Ne craignons pas que rien trouble nos Jeux.
PREMIERE BERGERE.	PREMIÈRE BERGÈRE.
Nos troupeaux, dans ce pâturage, En ſeureté paiſſent le tendre herbage;	Nos troupeaux, dans ce pâturage, En sûreté paissent le tendre herbage;
Tout est paiſible en ces Climats heureux.	Tout est paisible en ces Climats heureux.
Chantons, danſons ſous cét ombrage;	Chantons, dansons sous cet ombrage;
Ne craignons pas que rien trouble nos Jeux.	Ne craignons pas que rien trouble nos Jeux.
Le Chœur repete ces deux derniers Vers.	Le Chœur répète ces deux derniers Vers.
SECONDE BERGERE.	SECONDE BERGÈRE.
Parmy ces fleurs, & ce feuillage, L'amour ſe plaiſt à former mille nœuds.	Parmi ces fleurs, et ce feuillage, L'amour se plaît à former mille nœuds.
Le Chœur repete ces deux Vers.	Le Chœur répète ces deux Vers.
Il y fait éproucer jes fome A tous les cœurs qu’il épargne au Village.	Il y fait éproucer jes fome À tous les cœurs qu'il épargne au Village.
CHOEUR.	CHOEUR.
Parmy ces fleurs, & ce feuillage, L’amour ſe plaiſt à former mille nœuds.	Parmi ces fleurs, et ce feuillage, L'amour se plaît à former mille nœuds.
SECONDE BERGERE.	SECONDE BERGÈRE.
C’est luy ſeul qui dans ce bocage, Aux Roſſignols donne un ſi doux ramage:	C'est lui seul qui dans ce bocage, Aux Rossignols donne un si doux ramage:
Aimons aimons, nous chanterons comme eux, Parmy ces fleurs, & ce feüillage, L’amour ſe plaiſt à former mille nœuds.	Aimons aimons, nous chanterons comme eux, Parmi ces fleurs, et ce feuillage, L'amour se plaît à former mille nœuds.
Le Chœur repete ces deux derniers Vers.	Le Chœur répète ces deux derniers Vers.
PREMIERE BERGERE.	PREMIÈRE BERGÈRE.
O cer cuno nos Cuumps que font tes erais plaiſirs.	Ô cer cuno nos Cumps que font tes erais plaisirs.
Nous y paſſons une innocente vie.	Nous y passons une innocente vie.
Vn doux repos y comble nos deſirs:	Un doux repos y comble nos désirs:
Tout autre bien ne nous fait point d’envie.	Tout autre bien ne nous fait point d'envie.
Le Chœur repete ces quatre Vers.	Le Chœur répète ces quatre Vers.
PREMIER BERGER.	PREMIER BERGER.
Dans nos Hameaux l’Amour tient ſon empire:	Dans nos Hameaux l'Amour tient son empire:
On s’y ſoümet auſſi-toſt qu’on reſpire.	On s'y soumet aussitôt qu'on respire.
Sur tous nos cœurs il regne ſans rivaux:	Sur tous nos cœurs il règne sans rivaux:
Il fait luy ſeul, tous nos biens & nos maux.	Il fait esprit seul, tous nos biens et nos maux.
SECOND BERGER, & SECONDE BERGERE.	SECOND BERGER, et SECONDE BERGÈRE.
Jeunes cœurs, cedez tous à ſes charmes:	Jeunes cœurs, cédez tous à ses charmes:
Qu'il est fort quand il est parmy nous!	Qu'il est fort quand il est parmi nous!
N’eſpereZ pas d’échaper à ſes coups:	N'espérez pas d'échapper à ses coups:
Dans ces beaux lieux tout luy donne des armes.	Dans ces beaux lieux tout notre donne des armes.
TROISIE’ME BERGER.	TROISIE'ME BERGER.
Tost ou tard on doit eſtre charmé:	Tôt ou tard on doit être charmé:
Gardez-vous bien de vous mettre en deffence.	Gardez-vous bien de vous mettre en défense.
Le regret d’avoir trop tard aimé, Seroit le prix de vostre reſistance.	Le regret d'avoir trop tard aimé, Serait le prix de votre résistance.
CHOEUR.	CHOEUR.
C’eſt dans nos Champs que ſont les vrais plaiſirs:	C'est dans nos Champs que sont les vrais plaisirs:
Nous y paſſons une innocente vie.	Nous y passons une innocente vie.
Vn doux repos y comble nos deſirs:	Un doux repos y comble nos désirs:
Tout autrt vten ne nous fait point d’envie.	Tout autrt vten ne nous fait point d'envie.
Les Bergers reprennent haleine;	Les Bergers reprennent haleine;
& cependant la Symphonie jouë un Ronideau qui ſert d’Intermede.	et cependant la Symphonie joue un Ronideau qui sert d'Intermède.
EIN DU SECOND ACTE.	EIN DU SECOND ACTE.
ACTE	ACTE
ACTE TROISIE'ME.	ACTE -THROISIE'ME.
SCENE PREMIERE.	SCÈNE PREMIÈRE.
Arcas conduit Climene au milieu des Bergers, ali qu’ene pume les von tous, & choiſir pour époux celuy qui luy plaira le plus.	Arcas conduit Climène au milieu des Bergers, ali qu'ène pume les von tous, et choisir pour époux celui qui lui plaira le plus.
ARCAS, CLIMENE.	ARCAS, CLIMENE.
S- ARCAS.	- SRCAS.
Limene, juſques à ce jour, Le ſang, qui pour toy m’intereſſe, M’a fait prendre le ſoin d’élever ta jeuneſſe:	Limène, jusques à ce jour, Le sang, qui pour toi m'intéresse, M'a fait prendre le soin d'élever ta jeunesse:
Il faut qu’en faveur de l’amour, Vn autre le prenne à ſon tour.	Il faut qu'en faveur de l'amour, Un autre le prenne à son tour.
Parmy les Bergers du Village, Que cette Feste aſſemble tous, Tu peux choiſir cetuy qui te plaiſt da vantage;	Parmi les Bergers du Village, Que cette Fête assemble tous, Tu peux choisir cet qui te plaît da vantage;
Et je veux, dés ce ſoir, en faire ton époux.	Et je veux, dès ce soir, en faire ton époux.
Faut-il qu’un ſi beau jour ſe paſſe Sans former d’agreables nœuds?	Faut-il qu'un si beau jour se passe Sans former d'agréables nœuds?
Parmy les Plaiſirs & les Jeux, L’amour n’auroit-il point de place?	Parmi les Plaisirs et les Jeux, L'amour n'aurait-il point de place?
Tu rougis!	Tu rougis!
dans tes yeux je lis ton embarras:	dans tes yeux je lis ton embarras:
Le ſeul nom de l’Himen te cauſe des allarmes.	Le seul nom de l'Hymen te cause des alarmes.
Ah!	Ah!
Climene, il n’en cauſe pas A ceux qui connoiſſent ſes charmes.	Climène, il n'en cause pas A ceux qui connaissent ses charmes.
Qu'il est doux de s’engager Avec un tendre Berger, Le plaiſir ſe renouvelle, Et la peine eſt moins cruelle Lors qu’on peut les partager Avec un tendre Berger.	Qu'il est doux de s'engager Avec un tendre Berger, Le plaisir se renouvelle, Et la peine est moins cruelle Lors qu'on peut les partager Avec un tendre Berger.
Pireis & rillas s’aprochent de Climene;	Pireis et rillas s'approchent de Climène;
& Arcas ſe retire pour laiſſer à cette Bergere plus de liberté dans ſon choix.	et Arcas se retire pour laisser à cette Bergère plus de liberté dans son choix.
CENE SECONDE.	CÈNE SECONDE.
IRCIS, HILAS, CLIMENE.	JRCIS, HILAS, CLIMENE.
TIRCIS & HILAS enſemble.	TIRCIS et HILAS ensemble.
I c’eſt au Berger le plus tendre Que tu dois engager ta foy.	I c'est au Berger le plus tendre Que tu dois engager ta foi.
ILAS.	ILAS.
C’eſt à moy d’y prétendre.	C'est à moi d'y prétendre.
CIS.	CIS.
C'eſt un vien qui n'eſt du qu'a moy.	C'est un viens qui n'est du qu'a moi.
Enſemble.	Ensemble.
C’eſt à moy d’y prétendre;	C'est à moi d'y prétendre;
C’eſt un bien qui n’eſt dû qu’à moy.	C'est un bien qui n'est dû qu'à moi.
AS.	AS.
Ie ne ſentis jamais pour toute autre Bergere Une ardeur ſi ſincere.	Je ne sentis jamais pour toute autre Bergère Une ardeur si sincère.
CIS.	CIS.
Ie n’ay jamais aimé que toy.	Je n'ai jamais aimé que toi.
Enſemble.	Ensemble.
Si c’eſt au Berger le plus tendre Que tu dois engager ta foy;	Si c'est au Berger le plus tendre Que tu dois engager ta foi;
C’eſt à moy d’y prétendre;	C'est à moi d'y prétendre;
C’eſt un bien qui n’eſt dû qu’à moy.	C'est un bien qui n'est dû qu'à moi.
LIMENE.	LIMENE.
Tircis, une ſecrette flâme, Des long-temps a fixé mon choix:	Tircis, une secrète flamme, Des longtemps a fixé mon choix:
L’amour me rangea ſous tes loix, Ceoctors quit in aſjeren lon ame.	L'amour me rangea sous tes lois, Ceoctors quit in asjéren lon âme.
Mais, quand le choix d’un vainqueur Seroit encore en ma puiſſance, Ie ſens toujours que mon cœur Seroit le prix de ta conſtance.	Mais, quand le choix d'un vainqueur Serait encore en ma puissance, Je sens toujours que mon cœur Serait le prix de ta constance.
Pendant que le Chœur fait des exclamations ſur le bonheur de Tircis, ce Berger reconduit Climene à ſa place;	Pendant que le Chœur fait des exclamations sur le bonheur de Tircis, ce Berger reconduit Climène à sa place;
& la malicieuſe Cloris quitte la lienne pour conſoler Hilas à ſa maniere.	et la malicieuse Cloris quitte la lienne pour consoler Hilas à sa manière.
SCENE TROISIE’ME.	SCÈNE -TROISIE'ME.
HILAS, CLORIS, CHOEUR de Bergers & de Bergeres.	HILAS, CLORIS, CHOEUR de Bergers et de Bergères.
CHOEUR.	CHOEUR.
Trop heureux Tircis!	Trop heureux Tircis!
ô que ton ſort eſt doux!	ô que ton sort est doux!
Que tu vas faire de jaloux!	Que tu vas faire de jaloux!
IILAS.	IILAS.
Par une injuſte preferance, Un autre aura le prix que j’aurois mérité.	Par une injuste préférance, Un autre aura le prix que j'aurais mérité.
CLORIS.	CLORIS.
Conſole-toy, dans l’eſperance De recoüvrer ta liberté.	Console-toi, dans l'espérance De recourer ta liberté.
IILAS.	IILAS.
Ie ne puis reſiſter au penchant qui m’entraîne;	Je ne puis résister au penchant qui m'entraîne;
nt faut que je ſeis amoureux.	nt faut que je seis amoureux.
Mais, pour me dégager d’un amour malheureux, Ie puis, au moins changer de chaïne.	Mais, pour me dégager d'un amour malheureux, Je puis, au moins changer de chaïne.
Ie ſens déja que tes appas Vont me vanger de cette ingrate.	Je sens déjà que tes appas Vont me venger de cette ingrate.
CLORIS.	CLORIS.
Ton cœur ne m’accomode pas:	Ton cœur ne m'accomode pas:
Par tout ſon inconſtance éclate.	Par tout son inconstance éclate.
HILAS.	HILAS.
HILAS.	HILAS.
Quel que puiſſe estre un amant;	Quel que puisse être un amant;
C’est un doux amuſement.	C'est un doux amusement.
Lors que l’on en trouve un ſage;	Lors que l'on en trouve un sage;
On peut l’aimer tendrement.	On peut l'aimer tendrement.
Quand on en trouve un volage;	Quand on en trouve un volage;
On s’en tient au badinage:	On s'en tient au badinage:
Mais, quel que ſoit un amant;	Mais, quel que soit un amant;
C’est un doux amuſement.	C'est un doux amusement.
ORIS.	ORIS.
Souvent un amuſement Devient une grande affaire:	Souvent un amusement Devient une grande affaire:
Lors qu’un Berger est charmant, uoy-que volage, il peut plaire:	Lors qu'un Berger est charmant, uoi-que volage, il peut plaire:
Et, quand il vient à changer, Quelquefois une Bergere, qui n’a pas l’ame legere, Ne ſçauroit ſe dégager.	Et, quand il vient à changer, Quelquefois une Bergère, qui n'a pas l'âme légère, Ne saurait se dégager.
LAS.	LAS.
I'ay toûjours, par malheur, aimé des inhumaines;	J'ai toujours, par malheur, aimé des inhumaines;
Et mon cœur ennemy.	Et mon cœur ennemi.
des peines, N’a pu ſe fairé à leurs rigueurs.	des peines, N'a pu se fairé à leurs rigueurs.
Il ne tiendra qu'à toy de n’estre pas cruelle;	Il ne tiendra qu'à toi de n'être pas cruelle;
Et d’eſſayer ſi tes faveurs Le rendroient plus fidele.	Et d'essayer si tes faveurs Le rendraient plus fidèle.
Toute la troupe ſe leve & ſe partage.	Toute la troupe se lève et se partage.
Une partie témoigne qu’elle eſt du ſentiment d’Hilas;	Une partie témoigne qu'elle est du sentiment d'Hilas;
& l’autre, qu’elle eſt de celuy de Cloris:	et l'autre, qu'elle est de celui de Cloris:
Enſuite elle ſe réünit pour feliciter Tircis & Climene ſur leur bonheur;	Ensuite elle se réunit pour féliciter Tircis et Climène sur leur bonheur;
& pour benir encore une fois l’heureuſe paix, qui eſt la ſource de tous leurs plaiſirs.	et pour bénir encore une fois l'heureuse paix, qui est la source de tous leurs plaisirs.
SCENE QVATRIE’ME.	SCÈNE QUTATRIE'ME.
ARCAS, TIRCIS, HILAS, CLIMENE, CLORIS, un berger, deux bergeres, Chœur & Troupe de Bergers & de Bergeres, Troupe de Boheliennes.	ARCAS, TIRCIS, HILAS, CLIMENE, CLORIS, un berger, deux bergères, Chœur et Troupe de Bergers et de Bergères, Troupe de Boheliennes.
CLORIS.	CLORIS.
N Amant leger O'Veut toüjours changer.	N Amant léger O' Tenez toujours changer.
Vne longue attente Rebute ſes vœux;	Une longue attente Rebute ses vœux;
On eteint jes ſeux Quand on le contente:	On éteint jes seux Quand on le contente:
Vn Amant leger Veut toûjours changer.	Un Amant léger Veut toujours changer.
Ces huit Vers ſont repetez par le Party de Cloris.	Ces huit Vers sont répétés par le Parti de Cloris.
HILAS.	HILAS.
L’amour est un martire Quand tout ſeul on ſoûpire.	L'amour est un martyre Quand tout seul on soupire.
Quel Amant peut aimer le changement Quand on répond à ſa tendreſſe?	Quel Amant peut aimer le changement Quand on répond à sa tendresse?
Mais, quand on rit de l’amour qui nous preſſe, C’eſt estre fou que d’aimer constamment.	Mais, quand on rit de l'amour qui nous presse, C'est être fou que d'aimer constamment.
Le Party d’Hilas repete ces ſix Vers.	Le Parti d'Hilas répète ces six Vers.
UNE BERGERE à Tircis & Climene.	UNE BERGÈRE à Tircis et Climène.
Heureux Amants, ceſſez de vous contraindre:	Heureux Amants, cessez de vous contraindre:
Tout est permis à dot ronures deſirs.	Tout est permis à dot ronures désirs.
Qu’il eſt doux d’aimer ſans rien craindre!	Qu'il est doux d'aimer sans rien craindre!
Qu’un nœud charmant vous promet de plaiſirs.	Qu'un nœud charmant vous promet de plaisirs.
UN BERGER ET DEUX BERGERES.	UN BERGER ET DEUX BERGERES.
Ah!	Ah!
ſi l’amour nous fait aimer ſes peines Pour peu d’eſpoir qu’il meſle à ſes rigueurs;	si l'amour nous fait aimer ses peines Pour peu d'espoir qu'il mêle à ses rigueurs;
Quel plaiſir de porter ſes chaines, Quand on est ſeur de goûter ſes douceurs.	Quel plaisir de porter ses chaines, Quand on est sûr de goûter ses douceurs.
CHOEUR.	CHOEUR.
O douce Paix!	Ô douce Paix!
Que vous eſtes charmante!	Que vous êtes charmante!
Ne nous quittez jamais.	Ne nous quittez jamais.
Qu'icy tout ſe reſſente De vos bienfaits.	Qu'ici tout se ressente De vos bienfaits.
