ECPRIVILEGEDU ROY.	ECPRIVILEGEDU ROI.
LE LIBRAIRE AU LECTEUR.	LE LIBRAIRE AU LECTEUR.
d’une main.	d'une main.
M.	M.
Quinault à fait les Paroles qui s’y chantent en Muſique, a la reſerve de la Plaintes Italienne.	Quinault à fait les Paroles qui s'y chantent en Musique, a la réserve de la Plaintes Italienne.
M.	M.
Moliere a dreſſé le Plan de la Piece, & reglé la diſpoſition, où il s’eſt plus attaché au beautez & à la pompe du Spectacle, qu’à l’exacte regularité.	Molière a dressé le Plan de la Pièce, et réglé la disposition, où il s'est plus attaché au beautés et à la pompe du Spectacle, qu'à l'exacte régularité.
Quant à la Verſification, il n’a pas eu le loiſir de la faire entiere.	Quant à la Versification, il n'a pas eu le loisir de la faire entière.
Le Carnaval approchoit, & les Ordres preſſans du Roy, qui ſe vouloit donner ce magnifiqne Divertißement pluſieurs fois avant le Carême, l'ont mis dans la neceſſité de ſouffrir un peu de ſecours.	Le Carnaval approchait, et les Ordres pressants du Roi, qui se voulait donner ce magnifique Divertissement plusieurs fois avant le Carême, l'ont mis dans la nécessité de souffrir un peu de secours.
Ainſi il n’y a que le Prologue, le Premier Acte, la premiere Scene du Second, & la premiere du Troiſiéme, dont les Vers ſoient de luy.	Ainsi il n'y a que le Prologue, le Premier Acte, la première Scène du Second, et la première du Troisième, dont les Vers soient de grands.
M.	M.
Corneille a employé une quinzaine au reſte;	Corneille a employé une quinzaine au reste;
& par ce moyen Sa Majeſté s’eſt trouvée ſervie dans le temps qu’elle l'avoit ordonné.	et par ce moyen Sa Majesté s'est trouvée servie dans le temps qu'elle l'avait ordonné.
ÆGIA 14 14 L L E Graces.	ÉGIA 14 14 L Y Grâces.
LE ROY, Pere de Pſiché.	LE ROY, Père de Psiché.
AGLA I U oteurs de rſiché.	AGLA I V oteurs de riché.
Re	Re
LE ZEI H LE DIEU I L R UN FLEUVI	LE ZEI H LE DIEU I L R UN FLEUI
TV I TAT TRAGEDIE -BALLET.	TU I TAT TRAGÉDIE -BALLET.
PROLOGUE.	PROLOGUE.
A Scene repreſente ſur le devant un Lieu champeſtre, & dans l’enfoncement un Rocher percé à jour, à travers duquel on voit la Mer en éloiment.	À Scène représente sur le devant un Lieu champêtre, et dans l'enfoncement un Rocher percé à jour, à travers duquel on voit la Mer en éloiment.
Flore paroit au milieu du Théatre, accompagnée de Vertumne Dieu des Arbres & des Fruits, & de Palemon Dieu des Eaux.	Flore parait au milieu du Théâtre, accompagnée de Vertne Dieu des Arbres et des Fruits, et de Palemon Dieu des Eaux.
Chacun de ces Dieux conduit une troupe de Divinitez:	Chacun de ces Dieux conduit une troupe de Divinités:
l’un mene à ſa ſuite des Dryades & des Sylvains;	l'un mène à sa suite des Dryades et des Sylvains;
& l’autre des Dieux, des Fleuves & des Nayades.	et l'autre des Dieux, des Fleuves et des Naïades.
Flore chante ee Recit pour inviter Venus à deſcendre en Terre.	Flore chante ce Recit pour inviter Venus à descendre en Terre.
E n’eſt plus le tems de la Guerre, C Le plus puiſſant des Rois Interrompt ſes Exploits Pour donner la Paix à la Terre.	E n'est plus le temps de la Guerre, Ç Le plus puissant des Rois Interrompt ses Exploits Pour donner la Paix à la Terre.
Deſcendez, Mere des Amours, Venez nous donner de beaux jours.	Descendez, Mère des Amours, Venez nous donner de beaux jours.
Vertumne & Pelemon, avec les Divinitez qui les acco mpagnent, joignent leurs voix à celle de Flore, & chantent ces paroles.	Vertumne et Pèlemon, avec les Divinités qui les acco magnent, joignent leurs voix à celle de Flore, et chantent ces paroles.
CHOEUR DE TOUTES LES Divinitez de la Terre & des Eaux.	CHOEUR DE TOUTES LES Divinités de la Terre et des Eaux.
Compoſé de Flore, Nymphes, Palemon, Vertumne, Sylvains, Faunes, Dryades & Nayades.	Composé de Flore, Nymphes, Palemon, Vertne, Sylvains, Faunes, Dryades et Nayades.
Ous gouſtons une Paix proſonde;	Ous goûtons une Paix prosonde;
N Les plus doux Jeux font ici bas?	N Les plus doux Jeux font ici bas?
On doit ce repos plein d’appas Au plus Grand Roy du Monde.	On doit ce repos plein d'appas Au plus Grand Roi du Monde.
Deſcendez;	Descendez;
Mere des Amours, Venez nous donner de beaux jours.	Mère des Amours, Venez nous donner de beaux jours.
Il ſe fait en ſuite une Entrée de Ballet, compoſée de deux Dryades, quatre Sylvains, deux Fleuves, & deux Nayades.	Il se fait en suite une Entrée de Ballet, composée de deux Dryades, quatre Sylvains, deux Fleuves, et deux Nayades.
Aprés laquelle, Vertumne & Palamon chantent te Dialogue.	Après laquelle, Vertumne et Palamon chantent te Dialogue.
VERTUMNE.	VERTUMNE.
Endez-vous, Beautez cruelles, N Soûpirez à vôtre tour.	Endez-vous, Beautés cruelles, N Soûpirez à votre tour.
PALÆMON.	PALÆMON.
Voicy la Reine des Belles, Qui vient inſpiter l’amour,	Voici la Reine des Belles, Qui vient inspiter l'amour,
ERTUMNE.	ERTUMNE.
Un bel Objet toûjours ſevere Ne ſe fait jamais bien aimer.	Un bel Objet toujours sévère Ne se fait jamais bien aimer.
PALÆMON.	PALÆMON.
C’eſt la beauté qui commence de plaire, Mais la douceur acheve de charmer.	C'est la beauté qui commence de plaire, Mais la douceur achève de charmer.
Ils repetent enſemble ces derniers Vers, C’eſt la beaute que commente ue plaire, Mais la douceur acheve de charmer.	Ils répètent ensemble ces derniers Vers, C'est la beauté que commente ue plaire, Mais la douceur achève de charmer.
ERTUMNE.	ERTUMNE.
Souffrons tous qn’Amour nous bleſſe, Languiſſons, puis qu’il le faut.	Souffrons tous -n'Amour nous blesse, Languissons, puis qu'il le faut.
PADALMMOI.	PADALMOI.
Que ſert un cœur ſans tendreſſe?	Que sert un cœur sans tendresse?
Eſt-il un plus grand defaut ?	Est-il un plus grand défaut ?
ERTUMNE.	ERTUMNE.
Un bel Objet toujours ſeven Ne ſe fait jamais bien aimer.	Un bel Objet toujours séven Ne se fait jamais bien aimer.
C’eſt la beauté qui commence de plaire, Mais la douceur acheve de charmer.	C'est la beauté qui commence de plaire, Mais la douceur achève de charmer.
Flore répond au Dialogue de Vertumne & de Palamon, par ce Menuet;	Flore répond au Dialogue de Vertumne et de Palamon, par ce Menuet;
& les autres Divinitez, milent leurs Dances St-on ſage EDans le bel âge, Eſt-on ſage De n’aimer pas?	et les autres Divinités, milent leurs Dances St-on sage ÉDants le bel âge, Est-on sage De n'aimer pas?
Que ſans ceſſe L’on ſe preſſe De goûter les plaiſirs ici bas!	Que sans cesse L'on se presse De goûter les plaisirs ici bas!
La ſageſſe De la Jeuneſſe, C’eſt de ſçavoir joüer de ſes appas.	La sagesse De la Jeunesse, C'est de savoir jouer de ses appas.
A 4	A 4
L’Amour charme.	L'Amour charme.
Ceux qu’il deſarme;	Ceux qu'il désarme;
L’Amour charme, Cedons lui tous, Nôtre peine Seroit vaine De vouloir reſiſter à ſes coups;	L'Amour charme, Cédons lui tous, Notre peine Serait vaine De vouloir résister à ses coups;
Quelque chaine Qu’un Amant prenne, La liberté n’a rien qui ſoit ſi doux.	Quelque chaine Qu'un Amant prenne, La liberté n'a rien qui soit si doux.
Vénus deſcend du Ciel dans une grande Machine avec l’Amour ſon Fils, & deux petites Graces, nommées Ægiale & Phaéne, & les Divinitez de la Terre Ques Hauin irtommentom ue joindre toutes leurs voix, & continuënt par leurs Dances de luy témoigner la joye qu’elles reßentent à ſon abord.	Venus descend du Ciel dans une grande Machine avec l'Amour son Fils, et deux petites Grâces, nommées Égiale et Phane, et les Divinités de la Terre Ques Havin irtommentom ue joindre toutes leurs voix, et continuent par leurs Dances de lui témoigner la joie qu'elles ressentent à son abord.
CHOEUR DE TOUTES LES Diviaitez de la Terre & des Eaux.	CHOEUR DE TOUTES LES Diviaitez de la Terre et des Eaux.
Ous goûtons une Paix profonde;	Ous goûtons une Paix profonde;
N Les plus doux Jeux ſont ici bas:	N Les plus doux Jeux sont ici bas:
On doit ce repos plein d’appas Au plus Grand leurdu Monde.	On doit ce repos plein d'appas Au plus Grand leurdu Monde.
Melcendel y Mere des lliours r Venez nous donner de beaux jours,	Melcendel y Mère des liours r Venez nous donner de beaux jours,
nniuo onaut ſa Machine.	nniuo onaut sa Machine.
Eſſez, ceſſez pour moi tous vos chãts d’allegreſſe De ſi rares honneurs ne m’appartiennent pas, Et l’hommage qu’icy vôtre bonté m’adreſſe Doit être reſervé pour de plus doux appas.	Essez, cessez pour moi tous vos chãts d'allégresse De si rares honneurs ne m'appartiennent pas, Et l'hommage qu'ici votre bonté m'adresse Doit être réservé pour de plus doux appas.
C’eſt une trop vielle methods De me venir faire ſa Cour;	C'est une trop vielle méthods De me venir faire sa Cour;
Toutes les choſes ont leur tour, Et Vénus n’eſt plus à la mode.	Toutes les choses ont leur tour, Et Venus n'est plus à la mode.
Il eſt d’autres attraits naiſſans, Où l’on va porter ſes encens;	Il est d'autres attraits naissants, Où l'on va porter ses encens;
Pſiché, Pſiché la Belle, aujourd’hui tient ma place, Déja tout l’Univers s’empreſſe à l’adorer Et c’eſt trop que dans ma diſgrace Je trouve encor quelqu’un qui me daigne honorer.	Psiché, Psiché la Belle, aujourd'hui tient ma place, Déjà tout l'Univers s'empresse à l'adorer Et c'est trop que dans ma disgrâce Je trouve encor quelqu'un qui me daigne honorer.
On ne balance point eut re nos deux mérites, A quitter mon parti tout s’eſt licencié, Et du nombreux amas de Graces favorites, Dont je traînois par tout les ſoins & l’amitié, Il ne m’en eſt reſté que deux des plus petites:	On ne balance point eut re nos deux mérites, À quitter mon parti tout s'est licencié, Et du nombreux amas de Grâces favorites, Dont je traînais par tout les soins et l'amitié, Il ne m'en est resté que deux des plus petites:
Qui m’accompagnent par pitié.	Qui m'accompagnent par pitié.
Souffrez que ces Demeures ſombres Preſtent leur ſolitude aux troubles de mon cœur, Et me laiſſez parmi leur oumres Cacher ma honte & ma douleur.	Souffrez que ces Demeures sombres Prêtent leur solitude aux troubles de mon cœur, Et me laissez parmi leur oumres Cacher ma honte et ma douleur.
Flore & les autres Deïtez ſe retirent, & Vénus avec ſa Suite ſort de ſa Machine.	Flore et les autres Déités se retirent, et Vénus avec sa Suite sort de sa Machine.
ÆGIALE.	ÆGIALE.
Nous ne ſçavons, Déeſſe, comment faire, Dans ce chagrin qu’on voit vous accabler:	Nous ne savons, Déesse, comment faire, Dans ce chagrin qu'on voit vous accabler:
Nôtre reſpect veut ſe taire, Nôtre zéle veut parler.	Notre respect veut se taire, Notre zèle veut parler.
ENUS.	ENUS.
Parlez, mais ſi vos ſoins aſpirent à me plaire Laiſſez tous vos conſeils pour une autre ſaiſon.	Parlez, mais si vos soins aspirent à me plaire Laissez tous vos conseils pour une autre saison.
Et ne parlez de ma colere, Que pour dire que j’ai raiſon.	Et ne parlez de ma colère, Que pour dire que j'ai raison.
C’étoit-la, c’étoit là la plus ſenfible offence!	C'était-la, c'était là la plus sensible offense!
Que ma Divinité pût jamais recevoir;	Que ma Divinité pût jamais recevoir;
Mais j’en aurai la vengeance, Si les Dieux ont du pouvoir.	Mais j'en aurai la vengeance, Si les Dieux ont du pouvoir.
PHAENE.	PHANE.
Vous avez plus que nous de clartez, de ſageſſe, Pour juger qui peut être digne de vous:	Vous avez plus que nous de clartés, de sagesse, Pour juger qui peut être digne de vous:
Mais poul moi j aurois ciu qu’une grande Déeſſe Dévroit moins ſe mettre en couroux.	Mais poul moi j aurais civ qu'une grande Déesse Dévroit moins se mettre en courroux.
ENUS.	ENUS.
Et c’eſt la raiſon de ce couroux extréme.	Et c'est la raison de ce courroux extrême.
Plus mon rang a d’éclat, plus l’affront eſt ſanglant, Et ſi je n’étois pas dans ce degré ſupréme, Le dépit de mon cœur ſeroit moins violent.	Plus mon rang a d'éclat, plus l'affront est sanglant, Et si je n'étais pas dans ce degré suprême, Le dépit de mon cœur serait moins violent.
Moy la Fille du Dieu qui lance le Tonnerre, Mere du Dieu qui fait aimer;	Moi la Fille du Dieu qui lance le Tonnerre, Mère du Dieu qui fait aimer;
Moy les plus doux ſouhaits du Ciel & de la Terre, Et qui ne ſuis venuë au jour que pour charmer;	Moi les plus doux souhaits du Ciel et de la Terre, Et qui ne suis venue au jour que pour charmer;
Moi, qui par tout ce qui reſpire Ai veu de tant de vœux encenſer mes Autels, Et qui de la Beauté, par des droits immortels, Ai tenu de tout tems le ſouverain Empire;	Moi, qui par tout ce qui respire Aussi vu de tant de vœux encenser mes Autels, Et qui de la Beauté, par des droits immortels, Ai tenu de tout temps le souverain Empire;
Moi, dont les yeux ont mis deux grandes Deïtez Au point de me ceder le prix de la plus belle, Je me voy ma victoire & mes droits diſputez Par une chetive Mortelle !	Moi, dont les yeux ont mis deux grandes Deïtez Au point de me der le prix de la plus belle, Je me vois ma victoire et mes droits disputez Par une chétive Mortelle !
Le ridicule excés d’un folenreſtement Va juſqu’à m’oppoſer une petite Fille !	Le ridicule excès d'un folenrestement Va jusqu'à m'opposer une petite Fille !
our ces traits de les miens pentuitar conſtamment Un temeraire jugement?	our ces traits de les miens pentuit constamment Un téméraire jugement?
Et du haut des Cieux où je brille, J’entendrai prononcer aux Mortels prévenus, Elle eſt plus belle que Venus!	Et du haut des Cieux où je brille, J'entendrai prononcer aux Mortels prévenus, Elle est plus belle que Venus!
ÆGIALE.	ÆGIALE.
10 Voila comme l’on fait, c’eſt le ſtyle des Hommes, Ils ſont impertinent dans leurs comparaiſons,	10 Voilà comme l'on fait, c'est le style des Hommes, Ils sont impertinent dans leurs comparaisons,
PHAENE.	PHANE.
Ils ne ſçauroient loüer dans le Si ecle ou nous ſõmes, Qu’ils n’outragent les plus grands noms.	Ils ne sauraient louer dans le Si éle ou nous sommes, Qu'ils n'outragent les plus grands noms.
ENUS.	ENUS.
Ah que de ces trois mots la rigueur iuſolente Vange bien Junon & Pallas, Et conſole leurs cœurs de la gloire éclatante Que la fameuſe Pomme acquit à mes appas!	Ah que de ces trois mots la rigueur jusolente Venge bien Junon et Pallas, Et console leurs cœurs de la gloire éclatante Que la fameuse Pomme acquit à mes appas!
Je les voi s’applaudir de mon inquietude, Affecter à toute heure un ris malicieux, Et d’un fixe regard chercher avec étude Ma confuſion dans mes yeux.	Je les voi s'applaudir de mon inquiétude, Affecter à toute heure un ris malicieux, Et d'un fixe regard chercher avec étude Ma confusion dans mes yeux.
Leur triomphante joïe au fort d’un tel outrage, Semble me venir dire, inſultant mon couroux, Vante, vante, Venus, les traits de ton viſage, Au jugement d’un ſeul tu l’emportas ſur nous, Mais par le jugement de tous Une ſimple Mortelle a ſur toi l’avantage.	Leur triomphante joïe au fort d'un tel outrage, Semble me venir dire, insultant mon courroux, Vante, vante, Vante, les traits de ton visage, Au jugement d'un seul tu l'emportas sur nous, Mais par le jugement de tous Une simple Mortelle a sur toi l'avantage.
22 Ah!	22 Ah!
ce coup là m’acheve, il me perce le cœur, Je n’en puis plus ſouffrir les rigueurs ſans égales.	ce coup là m'achève, il me perce le cœur, Je n'en puis plus souffrir les rigueurs sans égales.
Et c’eſt trop de ſuscroit à ma vive douleur, Que le plaiſir de mes Rivales.	Et c'est trop de suscroit à ma vive douleur, Que le plaisir de mes Rivales.
Mon Fils, ſi j’eus jamais ſur toi quelque credit Ft ſi jamais je te fus chere, Si tu portes un cœur à ſentir le dépit Qui trouble le cœur d’une Mere, Qui ſi tendrement ce chetir;	Mon Fils, si j'eus jamais sur toi quelque crédit Fait si jamais je te fus chère, Si tu portes un cœur à sentir le dépit Qui trouble le cœur d'une Mère, Qui si tendrement ce chétir;
Employe, employe ici l’effort de ta purſance A ſoûtenir mes intereſts, Et fais à Pſiché par tes traits Sentir les traits de ma vangeance, Pour rendre ſon cœur malheureux, Prens celui de tes traits le plus prqpre à me plaire, Le plus empoiſonné de ceux	Emploie, emploie ici l'effort de ta pursance A soutenir mes intérêts, Et fais à Psiché par tes traits Sentir les traits de ma vengeance, Pour rendre son cœur malheureux, Prends celui de tes traits le plus prqpre à me plaire, Le plus empoisonné de ceux
Que tu lances dans ta colere;	Que tu lances dans ta colère;
Du plus bas, du plus vil, du plus affreux Mortel, Fais que juſqu’à la rage elle ſeit enflammée, Et qu’elle ait à ſouffrir le ſuplice cruel D’aimer & n’être point aimée.	Du plus bas, du plus vil, du plus affreux Mortel, Fais que jusqu'à la rage elle seit enflammée, Et qu'elle ait à souffrir le suplice cruel D'aimer et n'être point aimée.
	
L’AMOUR.	L'AMOUR.
Dans le Mõde on n’entend que plaintes de l’Amour, On m’impute par tout mille fautes commiſes, Et vous ne croiriez point le mal & les ſottiſes Que l’on dit de moi chaque jour.	Dans le Modède on n'entend que plaintes de l'Amour, On m'impute par tout mille fautes commises, Et vous ne croiriez point le mal et les sottises Que l'on dit de moi chaque jour.
Si pour ſervir vôtre colere.	Si pour servir votre colère.
2 N US.	2 N US.
Va ne reſiſte point aux ſouhaits de ta Mere, N’applique tes raiſonnemens Qu’à chercher les plus prompts momens De faire un ſacrifice à ma gloire outragée.	Va ne résiste point aux souhaits de ta Mère, N'applique tes raisonnements Qu'à chercher les plus prompts moments Il faire un sacrifice à ma gloire outragée.
narts, pour toure reponie à mes empreſſemens, Et ne me revoi point que je ne ſois vangée.	narts, pour toure réponie à mes empressements, Et ne me revoi point que je ne sois vengée.
L’Amour s’envole, & Vénus ſe retire	L'Amour s'envole, et Venus se retire
ACTE PREMIER SCENE PREMIERE.	ACTE PREMIER SCÈNE PREMIÈRE.
AGLAURE, CIDIPPE.	AGLAURE, CIDIPPE.
AGLAURE.	AGLAURE.
L eſt des maux, ma Sœur, que le ſilence aigrit, Laiſſons, laiſſons parler mon chagrin & le vôtre, Et de nos cœurs l’un à l’autre Exhalons le cuiſant dépit:	L est des maux, ma Sœur, que le silence aigrit, Laissons, laissons parler mon chagrin et le vôtre, Et de nos cœurs l'un à l'autre Exhalons le cuisant dépit:
Nous nous voyons Sœurs d’infortune;	Nous nous voyons Sœurs d'infortune;
Et la vôtre & la mienne ont un ſi grand raport, Que nous pouvons mêler toutes les deux en une, Et dans nôtre juſte tranſport Murmurer à plainte commune Des cruautez de nôt re ſort.	Et la vôtre et la mienne ont un si grand rapport, Que nous pouvons mêler toutes les deux en une, Et dans notre juste transport Murmurer à plainte commune Des cruautés de not re sort.
Quelle fatalité ſecrete, Ma Sœur, ſoûmet tout l’Univers Aux attraits de nôtre Cadette, Et de tant de Princes divers Qu’en ces lieux la Fortune jette, N’en preſente aucun à nos fers?	Quelle fatalité secrète, Ma Sœur, soumet tout l'Univers Aux attraits de notre Cadette, Et de tant de Princes divers Qu'en ces lieux la Fortune jette, N'en présente aucun à nos fers?
Quoi, voir de toutes parts pour lui rendre les armes, Les cœur ſe précipiter, Et paſſer devant nos charmes, Sans s’y vouloir arrêter?	Quoi, voir de toutes parts pour lui rendre les armes, Les cœur se précipiter, Et passer devant nos charmes, Sans s'y vouloir arrêter?
Quel ſort ont nos yeux en partage, Et qu’eſt-ce qu’ils ont fait aux Dieux, De ne joüir d’aucun hommage, Parmi tous ces tributs de ſoûpirs glorieux, Dont le ſuperbe avantage Fait triompher d’autres yeux?	Quel sort ont nos yeux en partage, Et qu'est-ce qu'ils ont fait aux Dieux, De ne jouir d'aucun hommage, Parmi tous ces tributs de soupirs glorieux, Dont le superbe avantage Fait triompher d'autres yeux?
Eſt-il pour nous, ma Sœur, de plus rude diſgrace, Que de voir tous les cœeurs inepriier nos appas, Et l’heureuſe Pſiché joüir avec audace D’une foule d’Amans attachez à ſes pas?	Est-il pour nous, ma Sœur, de plus rude disgrâce, Que de voir tous les cœeurs inéprier nos appas, Et l'heureuse Psiché joüir avec audace D'une foule d'Amands attachés à ses pas?
CIDIPPE.	CIDIPE.
liu;	liv;
ma oœur, c’eſt un avanture A faire perdre la raiſon, Et tous les maux de la Nature, Ne ſont rien en comparaiſon.	ma oœur, c'est un aventure A faire perdre la raison, Et tous les maux de la Nature, Ne sont rien en comparaison.
AGLAURE.	AGLAURE.
Pour moi j’en ſuis ſouvent juſqu’à verſer des l’armes, Tout plaiſir, tout repos, par là m’eſt arraché, Cõtre un pareil malheur ma conſtance eſt ſans armes, Toûjours à ce chagrin mon eſprit attaché Me tient devant les yeux la houte de nos charmes, Et le triomphe de Pſiché.	Pour moi j'en suis souvent jusqu'à verser des l'armes, Tout plaisir, tout repos, par là m'est arraché, Contre un pareil malheur ma constance est sans armes, Toujours à ce chagrin mon esprit attaché Me tient devant les yeux la houte de nos charmes, Et le triomphe de Psiché.
La nuit il m'en repaſſe une idée éternelle Qui ſur toute choſe prévaut;	La nuit il m'en repasse une idée éternelle Qui sur toute chose prévaut;
Rien ne me peut chaſſer cette image cruelle;	Rien ne me peut chasser cette image cruelle;
Et des qu’un doux ſommeil me vient délivrer d’elle, Dans mon eſprit auſſi-tôt Quelque ſonge la rappelle, Qui me réveille en furlaut.	Et des qu'un doux sommeil me vient délivrer d'elle, Dans mon esprit aussitôt Quelque songe la rappelle, Qui me réveille en furlaut.
CIDIPPE.	CIDIPE.
Ma Sœur, voila mon martire, Dans vos diſcours je me voi, Et veus venelrlade ane.	Ma Sœur, voilà mon martyre, Dans vos discours je me voi, Et veux venelrade ane.
Tout ce qui ſe paſſe en moy.	Tout ce qui se passe en moi.
AGLAURE.	AGLAURE.
Mais encor, raiſonnons un peu ſur cette affaire.	Mais encor, raisonnons un peu sur cette affaire.
Quels charmes ſi puiſſans en elle ſont épars, Et par où, dites-moy, du grand ſecret de plaire, L’honneur eſt il acquis à ſes moindres regards?	Quels charmes si puissants en elle sont épars, Et par où, dites-moi, du grand secret de plaire, L'honneur est il acquis à ses moindres regards?
Que voit-on dans ſa perſonne, Pour inſpirer tant d’ardeurs?	Que voit-on dans sa personne, Pour inspirer tant d'ardeurs?
Quel droit de beauté luy donne L’Empire de tous les cœuis?	Quel droit de beauté avait donne L'Empire de tous les cœuis?
Elle a quelques attraits, quelque éclat de jeuneſſe, On en tombe d’accord, je n’en diſconviens pas;	Elle a quelques attraits, quelque éclat de jeunesse, On en tombe d'accord, je n'en disconviens pas;
Mais lui cede-t-on fort pour quelque peu d’aineſſe, Et ſe voit-on ſans appas?	Mais lui cède-t-on fort pour quelque peu d'aînesse, Et se voit-on sans appas?
Eſt on d’une figure à faire qu’on ſe raille?	Est on d'une figure à faire qu'on se raille?
N’a-t-on point quelques traits, & quelques agrémẽs.	N'a-t-on point quelques traits, et quelques agréments.
Quelque teint, quelques yeux, quelque air & quelque taille A pouvoir dans nos fers jetter quelques Amans?	Quelque teint, quelques yeux, quelque air et quelque taille À pouvoir dans nos fers jeter quelques Amants?
Ma Sœur, faites-moi la grace De ine pailcrhranenemeue:	Ma Sœur, faites-moi la grâce De ine pailcrhranenemeue:
Suis je faite d’un air à vôtre jugement, 2 Que mon mérite au ſien doive ceder la place, Et dans quelque ajuſtement Trouvez-vous qu’elle m’efface?	Suis je faite d'un air à votre jugement, 2 Que mon mérite au sien doive céder la place, Et dans quelque ajustement Trouvez-vous qu'elle m'efface?
CIDIPPE.	CIDIPE.
Qui, vous, ma Sœur?	Qui, vous, ma Sœur?
nullement.	nullement.
Hier à la Chaſſe, pres d’elle, Je vous regardai long temps, Et ſans vous donner d’encens, Vous me parûtes plus belle.	Hier à la Chasse, pres d'elle, Je vous regardai long temps, Et sans vous donner d'encens, Vous me parûtes plus belle.
Mais moi, dites ma Sœur, ſans me vouloir flater, Sont-ce des viſions que je me mets en tête:	Mais moi, dites ma Sœur, sans me vouloir flatter, Sont-ce des visions que je me mets en tête:
Quand je me croi taillée à pour von feriter La gloire de quelque conquête;	Quand je me crois taillée à pour von feriter La gloire de quelque conquête;
AGLAURE.	AGLAURE.
Vous, m’a Sœur, vous avez ſans nul déguiſement, Tout ce qui peut cauſer une amoureuſe flâme;	Vous, m'a Sœur, vous avez sans nul déguisement, Tout ce qui peut causer une amoureuse flamme;
Vos moindres actions brillent d’un agrément Dont je me ſens toutner r'ume, Et je ſerois votre Amant, Si j’étois autre que Femme.	Vos moindres actions brillent d'un agrément Dont je me sens toutner rume, Et je serais votre Amant, Si j'étais autre que Femme.
IDIPPE.	JDIPE.
D’où vient dõcqu’on la voit l’emporter ſur nous deux Qu’à les premiers regards les cœurs rẽdent les armes Et que d’aucun tribut de ſoûpirs & de vœux On ne fait honneur à nos charmes?	D'où vient dõcqu’on la voit l'emporter sur nous deux Qu'à les premiers regards les cœurs ramendent les armes Et que d'aucun tribut de soupirs et de vœux On ne fait honneur à nos charmes?
AGLAURE.	AGLAURE.
Toures les Damles d une voix Trouvent ſes attraits peu de choſe, Et du nombre d’Amans qu’elle tient ſous ſes loix, Ma Sœur, j’ay découvert la cauſe.	Toures les Damles d' une voix Trouvent ses attraits peu de chose, Et du nombre d'Amand qu'elle tient sous ses lois, Ma Sœur, j'ai découvert la cause.
CIDIPPE.	CIDIPE.
Pour moi jela devine, & l’on doit préſumer Qu’il faut que la-deſſous ſoit caché du miſtere:	Pour moi jela devine, et l'on doit présumer Qu'il faut que la-dessous soit caché du mystère:
Ce lecret de tout enffamer N’eſt point de la Nature un effet ordinaire, L’Art de la Theſſalie entre dans cette affaire, Et quelque main a ſçeu ſans doute lui former Un charme pour ſe faire aimer.	Ce lecret de tout enffamer N'est point de la Nature un effet ordinaire, L'Art de la Thessalie entre dans cette affaire, Et quelque main a su sans doute lui former Un charme pour se faire aimer.
AGLAURE.	AGLAURE.
Sur un plus fort appui ma croyance ſe fonde, Et le charme qu’elle a pour attirer les cœurs, C’eſt un air en tout temps deſarmé de rigueurs Des regar s careſſans que la bouche ſeconde, Un ſoûris chargé de douceurs Qui tend les bras à tout le monde, Et ne vous promet que faveurs.	Sur un plus fort appui ma croyance se fonde, Et le charme qu'elle a pour attirer les cœurs, C'est un air en tout temps désarmé de rigueurs Des régar s caressants que la bouche seconde, Un souris chargé de douceurs Qui tend les bras à tout le monde, Et ne vous promet que faveurs.
Nôtre gloire n’eſt plus aujourd’huy conſervée, Et l’on n’eſt plus au temps de ces nobles fiertez, Qui par un digne eſſai d’illuſtres cruautez, Vouloient voir d’un Amant la conſtance éprouvée.	Notre gloire n'est plus aujourd'hui conservée, Et l'on n'est plus au temps de ces nobles fierté, Qui par un digne essai d'illustres cruautés, Voulaient voir d'un Amant la constance éprouvée.
De tout ce noble orgueil qui nous ſeyoit ſi bien, On eſt bien deſcendu dans le Siecle où nous ſommes, Et l’on en eſt reduite à n’eſperer plus rien, A moins que l’on ſe jerte à la tête des Hommes.	De tout ce noble orgueil qui nous seyait si bien, On est bien descendu dans le Siècle où nous sommes, Et l'on en est réduite à n'espérer plus rien, À moins que l'on se jerte à la tête des Hommes.
IDIPPE.	JDIPE.
Oüy;	Oui;
voilà le ſecret de l’affaire, & je voy Que vous le prenez mieux que moi.	voilà le secret de l'affaire, et je vois Que vous le prenez mieux que moi.
C’eſt pour nous attacher à trop de bienſeance, Qu’aucun Amant, ma Sœur, à nous ne veut venir, Et nous ne voulons trop ſeûtenir L’honneur de nôtre Sexe, & de nôtre naiſſance, Les Hommes maintenant aiment ce qui leur rit, L’eſpoir, plus que l’Amour, eſt ce qui les attire, Et c’eſt par-là que Pſiché-nous ravit Tous les A mans qu’on voit ſous ſon empire.	C'est pour nous attacher à trop de bienséance, Qu'aucun Amant, ma Sœur, à nous ne veut venir, Et nous ne voulons trop seintenir L'honneur de notre Sexe, et de notre naissance, Les Hommes maintenant aiment ce qui leur rit, L'espoir, plus que l'Amour, est ce qui les attire, Et c'est par-là que Psiché-nous ravit Tous les A ans qu'on voit sous son empire.
Suivois, ſuivons l’exemple, ajuſtons nous au tems, Abaiſſons-nous ma Sœur à faire des avances, Et ne ménageons plus de triſtes bienſeances Qui nous ôtent les fruits du plus beau de nos ans.	Suivais, suivons l'exemple, ajustons nous au temps, Abaissons-nous ma Sœur à faire des avances, Et ne ménageons plus de tristes bienséances Qui nous ôtent les fruits du plus beau de nos ans.
AGLAURE.	AGLAURE.
J’aprouve la penſée, & nous avons matiere D’en faire l’épreuve premiere Aux deux Princes qui ſont ſes derniers arrivez.	J'approuve la pensée, et nous avons matière D'en faire l'épreuve première Aux deux Princes qui sont ses derniers arrivez.
Ils ſont charmans, ma Sœur, & leus perſonne entiere	Ils sont charmants, ma Sœur, et lus personne entière
IDIPPE.	JDIPE.
Ah, ma Sœur, ils ſont faits tous d’eux d'une maniere Que mon ame.	Ah, ma Sœur, ils sont faits tous d'eux d'une manière Que mon âme.
Ce ſont deux Princes achevez.	Ce sont deux Princes achevés.
AG LAURE.	AG LAURE.
.	.
yimnune quon pourroie reenerener leur tendreſſe, Sans ſe faire des honneur.	yimnune quon pourroie reenerener leur tendresse, Sans se faire des honneur.
IDIPPE.	JDIPE.
Je trouve que ſans honte une belle Princeſſe Leur pourroit donner ſon cœur.	Je trouve que sans honte une belle Princesse Leur pourrait donner son cœur.
SCENE II.	SCÈNE II.
CLEOMENR, AGENOR AGLAURE, CIDIPPE.	CLEOMENR, AGENOR AGLAURE, CIDIPE.
ACLACRE.	ACLACRE.
Es voicy tous deux, & j’admite De Leur an & leul almtement.	Es voici tous deux, et j'admite De Leur an et leul almtement.
IDIPPE.	JDIPE.
Ils ne démentent nullement Tout ce que nous venons de dire.	Ils ne démentent nullement Tout ce que nous venons de dire.
AGLAURE.	AGLAURE.
b ouriem, princes, d'eu vient que vous fuyez ainſi?	 bouriem, princes, d'eu vient que vous fuyez ainsi?
Prenez-vous l’épouvente en nous voyant paroître?	Prenez-vous l'épouvante en nous voyant paraître?
CLEOMENE, On nons faiſoit croire qu’icy La Princeſſe Pſiché, Madame, pourroit être.	CLÉOMENE, On nons faisait croire qu'ici La Princesse Psiché, Madame, pourrait être.
AGLAURE.	AGLAURE.
Tous ces lieux n’ont-il rien d’agreable pour vous, Si vous ne les voyez ornez de ſa preſence?	Tous ces lieux n'ont-il rien d'agréable pour vous, Si vous ne les voyez ornez de sa présence?
AGENOR.	AGENOR.
Les lieux peuvent avoir des charmes aſſez doux?	Les lieux peuvent avoir des charmes assez doux?
Mais nous cherchons Pliché dans nôtre impatience.	Mais nous cherchons Pliché dans notre impatience.
CIDIPPE.	CIDIPE.
Quelque choſe de bien preſſant Vous doit à la chercher pouſſer tous deux ſans doute	Quelque chose de bien pressant Vous doit à la chercher pousser tous deux sans doute
CLEOMENE.	CLÉOMENE.
Le motil eit anez puihant, Puis que nôtre fortune enfin en dépend toute.	Le motil eit anez puihant, Puis que notre fortune enfin en dépend toute.
AGLAURÉ.	AGLAURE.
Ce ſeroit trop à nous, que de nous informer Du ſecret que ces mots nous peuvent enfermer.	Ce serait trop à nous, que de nous informer Du secret que ces mots nous peuvent enfermer.
CLEOMENE.	CLÉOMENE.
Nous ne pretendons point en faire de miſtere;	Nous ne prétendons point en faire de mystère;
Auſſi bien malgre nous paroitroit-n’au jour, Et le ſecret ne dure guere.	Aussi bien malgré nous paraît-n'au jour, Et le secret ne dure guère.
Madame, quand c’eſt de l’amour.	Madame, quand c'est de l'amour.
CIDIPPE.	CIDIPE.
Sans aller plus avant, Princes, cela veut dire, Que vous aimen i'nehé tous deux.	Sans aller plus avant, Princes, cela veut dire, Que vous aimen j'unehé tous deux.
AGENOR.	AGENOR.
Tous deux ſoûmis à ſon empire Nous allons de conſert lui découvrir nos feux.	Tous deux soumis à son empire Nous allons de consert lui découvrir nos feux.
AGLAURE.	AGLAURE.
C’eſt une nouveauté ſans doute aſſez bizarre, Que deux Rivaux ſi bien unis.	C'est une nouveauté sans doute assez bizarre, Que deux Rivaux si bien unis.
CLEOMENE.	CLÉOMENE.
Ieit vray que la cnole citrale, Mais non pas impoſſible à deux parfaits Amis.	Jeit vrai que la cnole citrale, Mais non pas impossible à deux parfaits Amis.
IDIPPE.	JDIPE.
Eſt-ce que dans ces lieux il n’eſt qu’elle de belle, Et n’y trouvez-vous point à ſeparer vos vœux?	Est-ce que dans ces lieux il n'est qu'elle de belle, Et n'y trouvez-vous point à séparer vos vœux?
AGLAURE.	AGLAURE.
Parmi l’éclat du ſang, vos yeux n’ont-ils veu qu’elle A pouvonr meriter vos reux ?	Parmi l'éclat du sang, vos yeux n'ont-ils vu qu'elle A pouvr mériter vos reux ?
CLEOMENE.	CLÉOMENE.
Eſt-ce que l’on conſulte au moment qu’on s’enflâme?	Est-ce que l'on consulte au moment qu'on s'enflamme?
Cho ſit-on qui l’on veut aimer?	Cho sit-on qui l'on veut aimer?
Et pour donner toute ſon ame, Regarde-t-on quel droit on a de nous charmer?	Et pour donner toute son âme, Regarde-t-on quel droit on a de nous charmer?
AGENOR.	AGENOR.
Sans qu’on ait le pouvoir d’élire, On ſuit dans une telle ardeur Quelque choſe qui nous attire, Et lors que l’Amour touche un cœur, On n’a point de raiſons à dire.	Sans qu'on ait le pouvoir d'élire, On suit dans une telle ardeur Quelque chose qui nous attire, Et lors que l'Amour touche un cœur, On n'a point de raisons à dire.
AGLAURE.	AGLAURE.
En verité je plains les fâcheux embarras Où je voi que vos cœurs ſe mettent;	En vérité je plains les fâcheux embarras Où je vois que vos cœurs se mettent;
Vous aimez un Objet dont les rians appas Mêleront des chagrins à l’eſpoir qu’ils vous jettent, Et ſon cœur ne vous tiendra pas Tout ce que ſes yeux vous promettent.	Vous aimez un Objet dont les riants appas Mêleront des chagrins à l'espoir qu'ils vous jettent, Et son cœur ne vous tiendra pas Tout ce que ses yeux vous promettent.
IDIPPE.	JDIPE.
L erpon qui vous appene au rann de les Amahs Trouvera du méconte aux douceurs qu’elle étale;	 Lerpon qui vous appène au rann de les Amahs Trouvera du méconte aux douceurs qu'elle étale;
Et c’eſt pour eſſuyer de tres fâcheux momens, Que les ſoudains retours de ſon ame inégale.	Et c'est pour essuyer de très fâcheux moments, Que les soudains retours de son âme inégale.
AGLAURE:	AGLAURE:
Un clair diſcernement de ce que vous valez Nous fait plaindre le ſort où cét amour vous guide, Et vous pouvez trouver tous deux, ſi vous voulez, Avec autant d’attraits, une ame plus ſollide	Un clair discernement de ce que vous valez Nous fait plaindre le sort où cet amour vous guide, Et vous pouvez trouver tous deux, si vous voulez, Avec autant d'attraits, une âme plus sollide
CIDIPPE.	CIDIPE.
Par un choix plus doux de moitié Vous pouvez de l’amour ſauver vôtre amitié, Et l’on voit en vous deux un merite ſi rare, Qu’un tendre avis veut bien prevenir par pitié Ce que votre cœur le prepare.	Par un choix plus doux de moitié Vous pouvez de l'amour sauver votre amitié, Et l'on voit en vous deux un mérite si rare, Qu'un tendre avis veut bien prévenir par pitié Ce que votre cœur le prépare.
CLEOMENE.	CLÉOMENE.
Cet avis genereux fait pour nous éclater Des bontez qui nous touchent l’ame;	Cet avis généreux fait pour nous éclater Des bontés qui nous touchent l'âme;
muis le erei hous reduit à ce malheur, Madame, De ne pouvoir en profiter.	muis le erei jou réduit à ce malheur, Madame, De ne pouvoir en profiter.
AGENOR.	AGENOR.
Vôtre illuſtre pitié veut en vain nous diſtraire D’un amour dont tous deux nous nedoutons l’effet;	Votre illustre pitié veut en vain nous distraire D'un amour dont tous deux nous nedoutons l'effet;
Ce que nôtre amitié, Madame, n’a pas fait, Il n’eſt rien qui le puiſſe faire	Ce que notre amitié, Madame, n'a pas fait, Il n'est rien qui le puisse faire
IDITIE.	IDITIE.
Il faut que le pouvoir de Pſiché.	Il faut que le pouvoir de Psiché.
La voicy.	La voici.
SCENE III.	SCÈNE III.
PSICHE', CIDIPPE, AGLAURE, CLEOMENE, AGENOR.	PSICHÉE', CIDIPE, AGLAURE, CLEMENE, AGENOR.
CIDIPPE.	CIDIPE.
V Enez joüir, ma Sœur, de ce qu’on vous aprête.	V Unez jouir, ma Sœur, de ce qu'on vous apprête.
AGLAURE, LIepaiel vos attrants a Iecero tey Le triomphe nouvcau d’une illuſtre conquête.	AGLAURE, LIépaiel vos attrants a Jecéro tei Le triomphe nouvcau d'une illustre conquête.
IDIPPE.	JDIPE.
Ces Princes ont tous deux ſi bien ſenty vos coups, Qu’à vous le découvrir leur bouche ſe diſpoſe.	Ces Princes ont tous deux si bien senti vos coups, Qu'à vous le découvrir leur bouche se dispose.
ICHE'.	ICHÉE.
Du ſujet qui les tient ſi réveurs parmy nous Je ne me croyois pas la cauſe, Et j’aurois crû toute autre choſe En les vo yait perler à vous.	Du sujet qui les tient si réveurs parmi nous Je ne me croyais pas la cause, Et j'aurais cru toute autre chose En les vo yait perler à vous.
AGLAURE.	AGLAURE.
N’ayant ny beauté, ny naiſſance A pouvoir meriter leur amour & leurs ſoins, ris hous ravornent du moins De l’honneur de la confidence.	N'ayant ici beauté, ni naissance À pouvoir mériter leur amour et leurs soins, ris hous ravornent du moins De l'honneur de la confidence.
CLEOMENE, L'aveu qu’il nous faut faire à vos divins appas, Eſt ſans doute, Madame, un aveu temeraire, Mais tant de cœur pres du trépas, Sont par de tels aveus forcez à vous deplaire, Que vous êtes reduite à ne les punir pas Des foudres de vôtre colere.	CLEMENE, L'aveu qu'il nous faut faire à vos divins appas, Est sans doute, Madame, un aveu téméraire, Mais tant de cœur pres du trépas, Sont par de tels aveus forcez à vous déplaire, Que vous êtes réduite à ne les punir pas Des foudres de votre colère.
Vous voyez en nous deux Amis, Qu’un doux raport d’humeurs ſçeu joindre dés l'enEt ces tendres liens ſe ſont veus affermis (fance;	Vous voyez en nous deux Amis, Qu'un doux rapport d'humeurs sçeu oindre dès l'enÉt ces tendres liens se sont vus affermis (fance;
Par cent combats d’eſtime & de reconnoiſſance.	Par cent combats d'estime et de reconnaissance.
Du Deſtin enne my les aſſauts rigoureux, Les mépris de la mort & l’aſpect des ſupplices, Par d’illuſtres éclats, de mutuels offices Ont de nôtre amitié ſignalé les beaux nœuds:	Du Destin enne mi les assauts rigoureux, Les mépris de la mort et l'aspect des supplices, Par d'illustres éclats, de mutuels offices Ont de notre amitié signalé les beaux nœuds:
Mais à quelques eſſais qu’elle ſe ſoit trouvée, Son grand triomphe eſt en ce jour, Et rien ne fait tant voir ſa conſtance éprouvée, Que de ſe conſerver au milieu de l’Amour.	Mais à quelques essais qu'elle se soit trouvée, Son grand triomphe est en ce jour, Et rien ne fait tant voir sa constance éprouvée, Que de se conserver au milieu de l'Amour.
Oüy, malgré tant d’appas, ſon illuſtre conſtance Aux Loix qu’elle nous fait a ſoûmis tous nos vœux;	Oui, malgré tant d'appas, son illustre constance Aux Lois qu'elle nous fait a soumis tous nos vœux;
Elle vient d’une douce & pleine déference Remettre à vôtre choix le ſuccés de nos feux, Et pour donner un poids à nôtre concurrence, Qui des raiſons d’Ecat entraine la b lance Sur le choix de l’un de nous deux, Cette même amit ié s’offre ſans répugnance D’unis nos deux Etats au ſort du plus heureux.	Elle vient d'une douce et pleine déférence Remettre à votre choix le succès de nos feux, Et pour donner un poids à notre concurrence, Qui des raisons d'Écat entraine la bonne lance Sur le choix de l'un de nous deux, Cette même amit jit j'offre sans répugnance D'unis nos deux États au sort du plus heureux.
AGENOR.	AGENOR.
Oüy, de ces deux Etats, Madame, Que ſous vôtreihûreux choix nous nous ofrons d’unir Nous voulons faire à nôtre flame Un ſecours pour vous obtenir Ce que pour ce bonheur?	Oui, de ces deux États, Madame, Que sous vôtreihûreux choix nous nous ofrons d'unir Nous voulons faire à notre flamme Un secours pour vous obtenir Ce que pour ce bonheur?
pres du Roy vôtre Pere Nous nous ſacrifions tous deux, N’a rien de difficile à nos cœurs amoureux, Et c’eſt au plus heureux a faire un don neceſſaire D’un pouvoir dont le malheureux,	pres du Roi votre Père Nous nous sacrifions tous deux, N'a rien de difficile à nos cœurs amoureux, Et c'est au plus heureux a faire un don nécessaire D'un pouvoir dont le malheureux,
Madame, n’aura plus affaire.	Madame, n'aura plus affaire.
SICHE'.	SICHÉE.
yeux Le choix que vous m’offrez, Princes, montre à mes Dequoi remplir les vœux de l’ame la plus fiere, Et vous me le parez tous deux d’une maniere, Qu’on ne peut offeir qui ſoit plus precieux.	yeux Le choix que vous m'offrez, Princes, montre à mes Dequoi remplir les vœux de l'âme la plus fière, Et vous me le parez tous deux d'une manière, Qu'on ne peut offeir qui soit plus précieux.
Vos feux;	Vos feux;
vôtre amitié, vôtre vertu ſupréme, Tout me releve en vous l'offre de vôtre foy;	votre amitié, votre vertu suprême, Tout me relève en vous l'offre de votre foi;
Et j’i vois un merite à s’oppoſer luy-même A ce que vous voulez de moi.	Et j'y vois un mérite à s'opposer Ah-même À ce que vous voulez de moi.
Ce n’eſt pas à mon cœur qu’il faut que je défere Pour entrer ſous de tels liens Ma main, pour ſe donner, attend l’ordre d'un Pere.	Ce n'est pas à mon cœur qu'il faut que je défère Pour entrer sous de tels liens Ma main, pour se donner, attend l'ordre d'un Père.
Et mes Sœurs ont des droits qui vont devãt les miens Mais ſi l’on me rendoit ſur mes vœux abſoluë Vous y pourriez avoir trop de part à la fois, Et toute mon eſtime entre vous ſuſpenduë, 2 Ne pourroit ſur aucun laiſſer tomber mon choix.	Et mes Sœurs ont des droits qui vont devant les miens Mais si l'on me rendait sur mes vœux absolue Vous y pourriez avoir trop de part à la fois, Et toute mon estime entre vous suspendue, 2 Ne pourrait sur aucun laisser tomber mon choix.
A l’ardeur de vôtre pourſuite Je répondrois aſſez de mes vœux le plus doux.	À l'ardeur de votre poursuite Je répondrais assez de mes vœux le plus doux.
Mais c’eſt parmi tant de merite Trop que deux cœurs pour moi, trop peu qu’un coup pour vous.	Mais c'est parmi tant de mérite Trop que deux cœurs pour moi, trop peu qu'un coup pour vous.
De mes plus doux ſouhairs j’aurois l’ame gênée.	De mes plus doux souhairs j'aurais l'âme gênée.
A l’effort de vôtre amitié, Et j’y vois l’un de vous prendre une Deſtinée A me faire trop de pitié.	À l'effort de votre amitié, Et j'y vois l'un de vous prendre une Destinée À me faire trop de pitié.
Oüi, Princes, à tous ceux dont l’amour ſuit le vôtre Je vous prefererois tous deux avec ardeur;	Oui, Princes, à tous ceux dont l'amour suit le vôtre Je vous préférerais tous deux avec ardeur;
Mais je n’aurois jamais le cœur De pouvoir preferer l’un de vous deux à l’autre.	Mais je n'aurais jamais le cœur De pouvoir préférer l'un de vous deux à l'autre.
A celui que je choiſirois, Ma tendreſſe feroit un trop grand ſacrifice, Et je m’imputerois à barbare injuſtice, Le tort qu’à l’autre je ferois.	À celui que je choisirais, Ma tendresse ferait un trop grand sacrifice, Et je m'imputerais à barbare injustice, Le tort qu'à l'autre je ferais.
Oüi, tous deux vous brillez de trop de grãdeur d’ame.	Oui, tous deux vous brillez de trop de grandeur d'âme.
Pour en faire aucun malheureux, Et vous devez chercher dans l’amoureuſe flâme Le moyen d’être heureux tous deux.	Pour en faire aucun malheureux, Et vous devez chercher dans l'amoureuse flamme Le moyen d'être heureux tous deux.
Si vôtre cœur me conſidere Aſſez pour me ſouffrir de diſpoſer de vous, J’ay deux Sœurs capables de plaire, Qui peuvent bien vous faire un deſtin aſſez doux, Et l’amitié me rend leur perſonne aſſez chere, Pour vous ſouhaiter leurs Epoux.	Si votre cœur me considère Assez pour me souffrir de disposer de vous, J'ai deux Sœurs capables de plaire, Qui peuvent bien vous faire un destin assez doux, Et l'amitié me rend leur personne assez chère, Pour vous souhaiter leurs Époux.
CLEOMENE.	CLÉOMENE.
Un cœur dont l’amour eſt extréme Peut-il bien conſentir, helas, D’être donné par ce qu’il aime!	Un cœur dont l'amour est extrême Peut-il bien consentir, hélas, D'être donné par ce qu'il aime!
our nos ueurcœurs, Mradame, à vos divins appas Nous donnons un pouvoir ſuprême, Diſpoſez-en pour le trépas, Mais pour une autre que vous même Ayez cette bonté de n’en diſpoſer pas.	our nos eurcœurs, Mradame, à vos divins appas Nous donnons un pouvoir suprême, Disposez-en pour le trépas, Mais pour une autre que vous -même Ayez cette bonté de n'en disposer pas.
AGENOR.	AGENOR.
Aux Princeſſes, Madame, on feroit trop d’outrage, Et c’eſt pour leurs attraits un indigne partage, Que les reſtes d’une autre ardeur.	Aux Princesses, Madame, on ferait trop d'outrage, Et c'est pour leurs attraits un indigne partage, Que les restes d'une autre ardeur.
Il faut d’un premier feu la pureté fidelle, Pour aſpirer à cet honneur Où vôtre bonté nous appelle, Et chacune merite un cœur qui n’ait ſoûpiré que pour elle.	Il faut d'un premier feu la pureté fidèle, Pour aspirer à cet honneur Où votre bonté nous appelle, Et chacune mérite un cœur qui n'ait soupiré que pour elle.
AGLAURE.	AGLAURE.
Il me ſemble, ſans nul courroux, Qu’avant que de vous en defendre, Princes, vous deviez bien attendre Qu’on ſe fut expliqué ſur vous.	Il me semble, sans nul courroux, Qu'avant que de vous en défendre, Princes, vous deviez bien attendre Qu'on se fut expliqué sur vous.
Nous croyez vous un cœur ſi facile & ſi tendre ?	Nous croyez -vous un cœur si facile et si tendre ?
Et lors qu’on parle ici de vous donner à nous, Sçavez-vous ſi l’on veut vous prendre ?	Et lors qu'on parle ici de vous donner à nous, Savez-vous si l'on veut vous prendre ?
IDIPPE.	JDIPE.
Je penſe que l’on a d'aſſez hauts ſentimens Pour refuſer un cœur qu’il faut qu’on ſollicite, Et qu’on ne veut devoir qu’à ſon propre merite La conquête de ſes Amans.	Je pense que l'on a d'assez hauts sentiments Pour refuser un cœur qu'il faut qu'on sollicite, Et qu'on ne veut devoir qu'à son propre mérite La conquête de ses Amants.
O lO IlL.	Ô lO IlL.
J’ai crû pour vous, mes Sœurs, une gloire aſſez grãde, arla fonemen a an ineine nndaclas	J'ai cru pour vous, mes Sœurs, une gloire assez grands, arla fonémen a an ineine naclas
ODIEIV.	ODIEIV.
LYCAS, PSICHE', AGLAURE, CIDIPPE, CLEOMENE, AGENOR.	LYCAS, PSICHÉE, AGLAURE, CIDIPE, CLÉMENE, AGENOR.
LYCAS.	LYCAS.
AH, Madame!	AH, Madame!
SICHE’.	SICHÉE.
Qu’as-tu?	Qu'as-tu?
LYCAS.	LYCAS.
Le Roy.	Le Roi.
PSICHE’.	PSICHÉE.
LYCAS.	LYCAS.
Vous demande.	Vous demande.
Te HE.	Te HÉ.
De ce trouble ſi grand, que faut-il que j’attende?	De ce trouble si grand, que faut-il que j'attende?
LAS.	LAS.
Vous ne le ſçaurez que trop toſt.	Vous ne le saurez que trop tôt.
H Hélas!	H Hélas!
que pour le Roi tu me donne à craindre!	que pour le Roi tu me donne à craindre!
o n oi Ne craignez que pour vous, c’eſt vous que l’on doit plaindre.	ô n oi Ne craignez que pour vous, c'est vous que l'on doit plaindre.
ICHE'.	ICHÉE.
C’eſt pour loüer le Ciel, & me voir hors d’effroi, De ſçavoir que je n’aye à craindre que pour moy, Mais apren-moy, Lycas le ſujet qui te toüche.	C'est pour louer le Ciel, et me voir hors d'effroi, De savoir que je n'aie à craindre que pour moi, Mais appren-moi, Lycas le sujet qui te tirer.
OID.	ÔID.
Souffrez que j’obéïſſe à qui m’envoye icy, Madame, & qu’on vous laiſſe aprendre de ſa bouche Ce qui peut mmaffliger ainſi.	Souffrez que j'obéisse à qui m'envoie ici, Madame, et qu'on vous laisse apprendre de sa bouche Ce qui peut mémaffliger ainsi.
CHE'.	CHÉE.
Allons ſçavoir ſurquoi l’on craint tant ma foibleſſe.	Allons sçavoir surquoi l'on craint tant ma faiblesse.
SCENEV.	SCENEU.
RGLAURE, CIDIPPE, LICAS.	RGLAURE, CIDIPE, LICAS.
AGLAURE.	AGLAURE.
I ton ordre n'eſt pas juſqu’à nous étendu, ODy nous quel grand malheur nous couvre ta triſLYCAS.	I ton ordre n'est pas jusqu'à nous étendu, ODi nous quel grand malheur nous couvre ta trisCAS.
teſſe.	tesse.
Helas!	Hélas!
ce grand malheur dans la Cour répandu, Voyez-le vous même, Princeſſe, Dans l’Oracle qu’au Roi les Deſtins ont rendu.	ce grand malheur dans la Cour répandu, Voyez-le vous même, Princesse, Dans l'Oracle qu'au Roi les Destins ont rendu.
Voicy ſes propres mots, que la douleur, Madame, A gravez au font de mon ame.	Voici ses propres mots, que la douleur, Madame, A gravés au font de mon âme.
Que l’on ne penſe nullement A vouloir de Pſiché conclure l’Hymenée;	Que l'on ne pense nullement A vouloir de Psiché conclure l'Hyménée;
Mais qu’au ſommet d’un Mont elle ſoit promptement En pompe funebre menée, Et que de tous abandonnée, Pour Epoux elle attende en ces lieux conſtamment Un Monſtre dont on a la veuë empoiſonnée, Un ſer pent qui répand ſon venin en tous lieux, Et trouble dans ſa rage & la Terre & les Cieux.	Mais qu'au sommet d'un Mont elle soit promptement En pompe funèbre menée, Et que de tous abandonnée, Pour Époux elle attende en ces lieux constamment Un Monstre dont on a la vue empoisonnée, Un ser pent qui répand son venin en tous lieux, Et trouble dans sa rage et la Terre et les Cieux.
Aprés un arrêt ſi ſevere.	Après un arrêt si sévère.
Je vous quitte, & vous laiſſe à juger entre vous, Si par de plus cruels & plus ſenſibles coups Tous les Dieux nous pouvoient expliquer leur colere.	Je vous quitte, et vous laisse à juger entre vous, Si par de plus cruels et plus sensibles coups Tous les Dieux nous pouvaient expliquer leur colère.
SCENEVI.	SCENEVI.
noEnOR, CIDIIIE.	noEnOR, CIDIE.
CIDIPPE.	CIDIPE.
A Sœur que ſentez vous à ce ſoudain malheur MlOù nous voyõs Pſiché par les Deſtms plongée?	À Sœur que sentez -vous à ce soudain malheur MlOù nous voyõs Psiché par les Destms plongée?
AGLAURE.	AGLAURE.
Mais vous, que ſentez-vous, ma Sœur?	Mais vous, que sentez-vous, ma Sœur?
C IDIITE.	Ç CDIITE.
A ne vous point mentir, je ſens que dans mon cœur.	À ne vous point mentir, je sens que dans mon cœur.
Je n’en ſuis pas trop affligée.	Je n'en suis pas trop affligée.
»	"
AGLAURE.	AGLAURE.
Moi, je ſens quelque choſe au mien Qui reſſemble aſſez à la joye.	Moi, je sens quelque chose au mien Qui ressemble assez à la joie.
AMOnS, ie Deſſii lious envoye Un mal que nous pouvons regarder comme un bien.	AMOnS, votre Dessi lious envoie Un mal que nous pouvons regarder comme un bien.
PREMIER INTERMEDE.	PREMIER INTERMÈDE.
A Scene eſt changée en des Rochers affreux, & Lfait voir en éloigne nent une Grotte effroyable.	À Scène est changée en des Rochers affreux, et Lfait voir en éloigne nent une Grotte effroyable.
C’eſt dans ce Deſert que Pſiché doit être expoſée pour obeir à l’Oracle Une trouppe de Perſonnes affligéts y viennant déployer ſa diſgrace.	C'est dans ce Désert que Psiché doit être exposée pour obéir à l'Oracle Une troupe de Personnes affligets y viennant déployer sa disgrâce.
Une partie de cette Troupe deſolée témoigne ſa pitié par des Plaintes touchantes & par des Conceres lugubres;	Une partie de cette Troupe désolée témoigne sa pitié par des Plaintes touchantes et par des Concères lugubres;
& l’autre exprime ſa deſolation par une Dance pleine de toutes les mars ques du plus violeut deſeſpoir.	et l'autre exprime sa désolation par une Dance pleine de toutes les mars ques du plus violut désespoir.
PLAINTES EN ITALIEN, chantées par une Femme deſolée, & deux Hommes affligez.	PLAINTES EN ITALIEN, chantées par une Femme désolée, et deux Hommes affligez.
Femme deſolée.	Femme désolée.
Eh, piangete al pianto meo D Saſſi duri, antiche ſelve, Lagrimate fonti, e belve, Dtan belvolto il fato rio.	Eh, piangète al pianto meo D Assi dury, antiche selve, Lagrimate fonti, é lève, Dtan belvolto il fato rio.
1.	1.
Homme affligé.	Homme affligé.
ni aelere.	ni aelere.
2.	2.
Homme affligé.	Homme affligé.
A hi martire !	À hi martyre !
1.	1.
Homme affligé.	Homme affligé.
Cruda morte?	Cruda morte?
OSIROIS.	OSIROIS.
Che condanni à mourir tanta beltà.	Che condamni à mourir tanta beltà.
Cieli, ſtelle, ahi crudeltà.	Cieli, stelle, ahi crudeltà.
Com’eſſer puo fra voi, o Numi eterni, Chi voglia eſtinta una beltà innocente?	Com'esser puo fra voi, ô Numi éterni, Chi voglia estinta una beltà innocente?
Ahi!	Ahi!
che tanto rigor, Cielo inclemente, Vince di crudeltà gli ſteſſi Inferni.	che tanto rigor, Cielo inclémente, Vince di crudeltà gli stessi Inferni.
1.	1.
Homme affligé.	Homme affligé.
Nume fierto !	Nume fierto !
2.	2.
Homme affligé.	Homme affligé.
Dio ſevero!	Dio severo!
ENSEMBLE.	ENSEMBLE.
Perche tanto rigor Contro innocente cor?	Perche tanto rigor Contro innocente cor?
Iinl, lentenza indana, Dar morte à la Beltà, ch’altrui da vita.	Jinl, lentenza indana, Dar morte à la Beltà, ch'altrui da vita.
Femme deſolée.	Femme désolée.
Ahi ch’indarno ſi tarda, Non reſiſte à li Dei mortale affetto, Alto impero ne sforza, ore commanda il Ciel, l’Uuom cede à forza.	Ahi chindarno si tarda, Non résiste à li Dei mortale affetto, Alto impero ne sforza, ore commanda il Ciel, l'Uuom cède à forza.
Ahi dolore!	Ahi dolore!
&c.	etc.
Come ſopra.	Come sopra.
Ces Plaintes ſont entrecoupées & finies par une Eutrée de Ballet de nuit Feſfonne, affeigées.	Ces Plaintes sont entrecoupées et finies par une Eutrée de Ballet de nuit Fesfonne, affeigées.
ACTE II SCENE PREMIERE.	ACTE II SCÈNE PREMIÈRE.
LE ROT PSICIIE, AGEMURE, CIDIPPE, LYCAS, SUITE.	LE ROT PSICIE, AGEMURE, CIDIPE, LYCAS, SUITE.
D PSICHE’.	D PSICHÉE.
E vos larmes, Seigneur, la ſource m’eſt bien chere;	ELLE vos larmes, Seigneur, la source m'est bien chère;
Mais c’eſt trop aux bontez que vous avez pour moi , Que de laiſſer regner ſes tendreſſes de Juſque dans les yeux d’un grand Roi [Pere Ce qu’on vous voir icy donner à la Nature Au rang que vous tenez, Seigneur, fait trop d’injure, Et jen dois lerdier les touenantes fareurs:	Mais c'est trop aux bontés que vous avez pour moi , Que de laisser régner ses tendresses de Jusque dans les yeux d'un grand Roi [Père Ce qu'on vous voir ici donner à la Nature Au rang que vous tenez, Seigneur, fait trop d'injure, Et jen dois lerdier les touenantes fareurs:
Laiſſez moins ſur vôtre ſageſſe Prendre d’empire à vos douleurs, Et ceſſez d’honorer mon deſtin par des pleurs, Qui dans le cœur d’un Roi montrent de la froibleſſe.	Laissez moins sur votre sagesse Prendre d'empire à vos douleurs, Et cessez d'honorer mon destin par des pleurs, Qui dans le cœur d'un Roi montrent de la froiblesse.
LEROY.	LEROY.
Ah!	Ah!
ma Fille, à ces pleurs laiſſe mes yeux onverts, Mon deüil eſt raiſonnable, encor qu’il ſoit extrême, B iij Et lers que pour toûjours on perd ce que je perds, La Sageſſe, croi-moi, peut pleurer e le-même.	ma Fille, à ces pleurs laisse mes yeux onverts, Mon deuil est raisonnable, encor qu'il soit extrême, B ijou Et il que pour toujours on perd La Sage je perds, La Sagesse, crois-moi, peut pleurer eût le-même.
En vain l’orgueil du Diadéme Veut qu’on ſoit inſenſible à ces cruels revers, En vain de la Raiſon les ſecours ſont offerts, Pour vouloir d’un œil ſec voir mourir ce qu’on aime:	En vain l'orgueil du Diadème Veut qu'on soit insensible à ces cruels revers, En vain de la Raison les secours sont offerts, Pour vouloir d'un œil sec voir mourir ce qu'on aime:
L’effort en eſt barbare aux yeux de l’Univers, Et c’eſt brutalité plus que vertu ſuprême.	L'effort en est barbare aux yeux de l'Univers, Et c'est brutalité plus que vertu suprême.
Je ne veux point dans cette averſité Parer mon cœur d’inſenſibilité, Et cacher l’ennuy qui me touche;	Je ne veux point dans cette aversité Parer mon cœur d'insensibilité, Et cacher l'ennui qui me touche;
Je renonce à la vanité De cette dureté farouche, Que l’on appelle fermeté;	Je renonce à la vanité De cette dureté farouche, Que l'on appelle fermeté;
Et de quelque façon qu’on nomme Cette vive douleur dont je reſens les coups, Je veux bien l’étaler, ma Fille, aux yeux de tous, Et dans le cœur d’un Roi monter le cœur d’un Hõme.	Et de quelque façon qu'on nomme Cette vive douleur dont je résens les coups, Je veux bien l'étaler, ma Fille, aux yeux de tous, Et dans le cœur d'un Roi monter le cœur d'un Homme.
SICHE'.	SICHÉE.
Je ne mérite pas cette grande douleur:	Je ne mérite pas cette grande douleur:
Oppoſez, oppoſez un peu de reſiſtance Aux droits qu’elle prend ſur un cœur Dont mille évenemens ont marque la puiſſance.	Opposez, opposez un peu de résistance Aux droits qu'elle prend sur un cœur Dont mille événements ont marque la puissance.
Quoi, faut-il que pour moi vous tenonciez, Seigneur, A cette Royale conſtance, Dont vous avez fa t voir dans les coups du malheur Une fameuſe experience?	Quoi, faut-il que pour moi vous tenonciez, Seigneur, À cette Royale constance, Dont vous avez fa t voir dans les coups du malheur Une fameuse expérience?
LE ROY.	LE ROY.
La conſtance eſt facile en mille occaſions.	La constance est facile en mille occasions,
Toutes les révolutions Où nous peut ex poſer la Fortune inhumaine, La perte des grandeurs, les perſécutions, Le poiſon de l’Envie, les traits de la Haine, N’ont rien qui ne puiſſent ſans peine Braver les réſolutions D’une ame où la raiſon eſt un peu ſouveraine?	Toutes les révolutions Où nous peut ex poser la Fortune inhumaine, La perte des grandeurs, les persécutions, Le poison de l'Envie, les traits de la Haine, N'ont rien qui ne puissent sans peine Braver les résolutions D'une âme où la raison est un peu souveraine?
Mals ce qui porte des rigueurs A faire ſuccomber les cœurs Sous le poids des douleurs ameres, Ce ſont, ce ſont les rudes traits De ces fatalitez ſeveres, Qui nous enlevent pour jamais Les Perſonnes qui nons ſont cheres.	Mals ce qui porte des rigueurs A faire succomber les cœurs Sous le poids des douleurs amères, Ce sont, ce sont les rudes traits De ces fatalités sévères, Qui nous enlèvent pour jamais Les Personnes qui nons sont chères.
La Raiſon contre de tels coups Moffre point d’armes ſecourables;	La Raison contre de tels coups Mouffre point d'armes secourables;
Et voila des Dieux en couroux Les foudres les plus redoutables Qui ſe puiſſent lancer ſur nous.	Et voilà des Dieux en courroux Les foudres les plus redoutables Qui se puissent lancer sur nous.
SICHE'.	SICHÉE.
Seigneur, une douceur ici vous eſt offerte:	Seigneur, une douceur ici vous est offerte:
Vôtre hymen a reçeu plus d’un preſent des Dieux, Et par une faveur ouverte Ils ne vous oſtent rien en m'oſtant à vos yeux, 4 Dont ils n’ayent pris le ſoin de reparer la perte.	Votre hymen a reçu plus d'un présent des Dieux, Et par une faveur ouverte Ils ne vous ôtent rien en m'ôtant à vos yeux, 4 Dont ilsonaient pris le soin de réparer la perte.
Il vous reſte dequoi conſoler vos douleurs, Et cette loi du Ciel que vous nommez cueſſe Dans les deux Princeſſes mes Sœurs, Laiſſe à l’amitié paternelle Où placer toutes ſes douceurs.	Il vous reste dequoi consoler vos douleurs, Et cette lois du Ciel que vous nommez cuesse Dans les deux Princesses mes Sœurs, Laisse à l'amitié paternelle Où placer toutes ses douceurs.
LEROY.	LEROY.
Ah, de mes maux ſoulagement frivole!	Ah, de mes maux soulagement frivole!
Men, rlen ne s’ofre à moy qui de toi me confole?	Men, rlen ne s'ofre à moi qui de toi me confole?
C’eſt ſur mes déplaiſirs que j’ai les yeux ouverts, Et dans un deſtin ſi funeſtre Je regarde ce que je perds, Et ne voi point ce qui me reſte.	C'est sur mes déplaisirs que j'ai les yeux ouverts, Et dans un destin si funestre Je garde ce que je perds, Et ne voi point ce qui me reste.
PSICHE'.	PSICHÉE.
Dieux.	Dieux.
Vous ſçavez mieux que moi qu’aux volontez des B 3 Seigneur, il faut regler les nôtres, Et je ne puis vous dire en ces triſtes Adieux, Que ce que beaucoup mieux vous pouvez dire aux auCes Dieux ſont maiſtres ſouverains.	Vous savez mieux que moi qu'aux volontés des B 3 Seigneur, il faut régler les nôtres, Et je ne puis vous dire en ces tristes Adieux, Que ce que beaucoup mieux vous pouvez dire aux auCes Dieux sont maîtres souverains.
tres.	très.
Des preſens qu’ils daignent nous faire;	Des présents qu'ils daignent nous faire;
Ils ne les laiſſent dans nos mains Qu’autant de tems qu’il peut leur plaire.	Ils ne les laissent dans nos mains Qu'autant de temps qu'il peut leur plaire.
Lors qu’ils viennent les retirer, On n’a nul droit de murmurer Des graces que leur main ne veut plus nous étendre?	Lors qu'ils viennent les retirer, On n'a nul droit de murmurer Des grâces que leur main ne veut plus nous étendre?
Seigneur, je ſuis un don qu’ils ont fait à vos vœux, Et quand par cet Arrêt ils veulent me reprendre, Ils ne vous oſtent rien que vous ne teniez d’eux, Et c’eſt ſans murmurer que vous devez me rendre,	Seigneur, je suis un donc qu'ils ont fait à vos vœux, Et quand par cet Arrêt ils veulent me reprendre, Ils ne vous ôtent rien que vous ne teniez d'eux, Et c'est sans murmurer que vous devez me rendre,
LE ROY.	LE ROY.
Ah, cherche un meilleur fondement Aux conſolations que ton cœur me preſente, Et de la fauſſeté de ce raiſonnement Ne fais point un accablement A cette douleur ſi cuiſante, Dont je ſouffre ici le tourment.	Ah, cherche un meilleur fondement Aux consolations que ton cœur me présente, Et de la fausseté de ce raisonnement Ne fais point un accablement À cette douleur si cuisante, Dont je souffre ici le tourment.
Crois tu là me donner une raiſon puiſſance, Pour ne me plaindre point de cet art Arrêt des Cieux?	Crois -tu là me donner une raison puissance, Pour ne me plaindre point de cet art Arrêt des Cieux?
Et dans le procedé des Dieux Dont tu veux que je me contente, Une rigueur aſſaſſinante Ne paroît elle pas aux yeux?	Et dans le procédé des Dieux Dont tu veux que je me contente, Une rigueur assassinante Ne paraît elle pas aux yeux?
Voi l’état où ces Dieux me forment à te rendre, Et l’autre où te reçeu mon cœur infortuné:	Vois l'état où ces Dieux me forment à te rendre, Et l'autre où te reçu mon cœur infortuné:
Tu connoîtras par là qu’ils me viennent reprendre Bien plus que ce qu’ils m’ont donné.	Tu connaîtras par là qu'ils me viennent reprendre Bien plus que ce qu'ils m'ont donné.
Je reçûs d’eux en toy, ma Fille, Un preſent que mon cœur ne leuf demannoit pas?	Je reçus d'eux en toi, ma Fille, Un présent que mon cœur ne leuf demannait pas?
y trouvois alors peu d’appas, 210	y trouvais alors peu d'appas, 210
Et leur en vis ſans joye accroître ma famille, Mais mon cœur ainſi que mes yeux S’eſt fait de ce preſent une douce habitude:	Et leur en vis sans joie accroître ma famille, Mais mon cœur ainsi que mes yeux S'est fait de ce présent une douce habitude:
J’ai mis quinze ans de ſoins, de veilles, & d’étude, A me le rendre précieux, Je l’ai paré de l’aimable richeſſe De mille brillantes vertus, En luy j’ai renfermé par des ſoins aſſidus Tous les plus beaux treſors que fournit la Sageſſe, A lui j’ai de mon ame attaché la tendreſſe, J’en ai fait de ce cœur le charme & l’allegreſſe, La conſolation de mes ſens abbatus, Le doux eſpoir de ma vielleſſe.	J'ai mis quinze ans de soins, de veilles, et d'étude, À me le rendre précieux, Je l'ai paré de l'aimable richesse De mille brillantes vertus, En était j'ai rendre par des soins assidus Tous les plus beaux trésors que fournit la Sagesse, À lui j'ai de m âme attaché la tendresse, J'en ai fait de ce cœur le charme et l'allégresse, La consolation de mes sens abatus, Le doux espoir de ma viellesse.
Ils moſtent tout cela, ces Dieux, Et tu veux que je n’aye aucun ſujet de plainte, Sur cet affreux Arrêt dont je ſouffre l’atteinte?	Ils môtent tout cela, ces Dieux, Et tu veux que je n'aie aucun sujet de plainte, Sur cet affreux Arrêt dont je souffre l'atteinte?
Ah!	Ah!
leur pouvoir ſe jouë avec trop de rigueur Des tendreſſes de nôtre cœur:	leur pouvoir se joue avec trop de rigueur Des tendresses de notre cœur:
Ipurm ontt teui preicie, leur falloit-il attendre Que j’en euſſe fait tout mon bien?	Ipurm ontt teui préicie, leur fallait-il attendre Que j'en eusse fait tout mon bien?
Ou plûtôt, s’ils avoient deſſein de le réprendre, Neut-il pas éré mieux de ne me donner Fien ?	Ou plutôt, s'ils avaient dessein de le reprendre, Neut-il pas éré mieux de ne me donner Fien ?
SICHE'.	SICHÉE.
Seigneur, redoutez la colere De ces Dieux contre qui vous oſez éclater.	Seigneur, redoutez la colère De ces Dieux contre qui vous osez éclater.
LE ROY Apies ce coupque peuveut na mne lhire s Ils m’ont mis en état de ne rien redouter.	LE ROY Apies ce coupque peuveut na mne lhire ' Ils s'ont mis en état de ne rien redouter.
SICHE'.	SICHÉE.
Ah, Seigneur, je tremble des crimes Que je vous fais commettre, & je dois me haïr.	Ah, Seigneur, je tremble des crimes Que je vous fais commettre, et je dois me haïr.
LE ROY.	LE ROY.
Ah, qu’ils ſouffrent du moins mes plaintes legitimes, Ce m’eſt aſſez d’effort que de leur obeïr, Bc Ce doit leur être aſſez que mon cœur t'abandonne Au ba bare reſpect qu’il faut qu’on ait pour eux, Sans pretendre gêner la douleur que me donne L’épouvantable Arreſt d’un Sort ſi rigoureux.	Ah, qu'ils souffrent du moins mes plaintes légitimes, Ce m'est assez d'effort que de leur obéir, Bc Ce doit leur être assez que mon cœur t'abandonne Au ba bare respect qu'il faut qu'on ait pour eux, Sans prétendre gêner la douleur que me donne L'épouvantable Arrêt d'un Sort si rigoureux.
Mon juſte deſeſpoir ne ſçauroit ſe contraindre, Je veux, je veux garder ma douleur à jamais, Je veux ſentir toûjours la perte que je fais, De la rigueur du Ciel je veux toûjours me plaindre, Je veux juſqu’au trépas inceſſamment pleurer Ce que tout l’Univers ne peut me reparer.	Mon juste désespoir ne saurait se contraindre, Je veux, je veux garder ma douleur à jamais, Je veux sentir toujours la perte que je fais, De la rigueur du Ciel je veux toujours me plaindre, Je veux jusqu'au trépas incessamment pleurer Ce que tout l'Univers ne peut me réparer.
SICHE'.	SICHÉE.
Ah, de grace, Seigneur, épargnez ma foibleſſe, J’ai beſoin de conſtance en l’état où je ſuis:	Ah, de grâce, Seigneur, épargnez ma faiblesse, J'ai besoin de constance en l'état où je suis:
Ne fortifiez point l’excés de mes ennuis Des ſarmes de votre tendrene.	Ne fortifiez point l'excès de mes ennuis Es sarmes de votre tendrène.
Seuls ils ſont aſſez forts, & c’eſt pour mon cœur, Demon deſtin & de vôtre douleur.	Seuls ils sont assez forts, et c'est pour mon cœur, Demon et et de votre douleur.
LE ROY.	LE ROY.
Oüi, je doi t’épaigner mon deüil inconſolable.	Oui, je dois t'épaigner mon deuil inconsolable.
Voicy l’inſtant fatal de m’aracher de toi:	Voici l'instant fatal de m'aracher de toi:
Mais comment prononcer ce mot épouvantable?	Mais comment prononcer ce mot épouvantable?
Il le faut toutefois, le Ciel m’en fait la loi, Une rigueur inévitable M’oolige à te laiſſer en ce funeſte lieu.	Il le faut toutefois, le Ciel m'en fait la loi, Une rigueur inévitable M'ooligu de te laisser en ce funeste lieu.
Adieu, je vais.	Adieu, je vais.
Adieu.	Adieu.
Ce qui ſuit juſqu'à la fin de la Piece, eſt de M.	Ce qui suit jusqu'à la fin de la Pièce, est de M.
C.	Ç.
à la reſerve de la premiere Scene du troiſiéme Acte, qui eſt de la méme main que ce qui a precedé.	à la réserve de la première Scène du troisième Acte, qui est de la même main que ce qui a précédé.
SCENE II.	SCÈNE II.
PSICHE, AGLAURE, CIDIPPE.	PSYCHE, AGLAURE, CIDIPE.
PSICHE' QUivez le Roi, mes Sœurs, vous eſſuirez ſes larmes?	PSICHÉL' QUivez le Roi, mes Sœurs, vous essuirez ses larmes?
Vous adoucirez ſes douleurs, Et vous l’accableriez d’alarmes, Si vous vous expoſiez encor a mes malheurs.	Vous adoucirez ses douleurs, Et vous l'accableriez d'alarmes, Si vous vous exposiez encor à mes malheurs.
Conſervez lui ce qui lur reſte.	Conservez lui ce qui lur reste.
Le Serpent que j’attens peut vous être funeſte, Vous enveloper dans mon ſort, Et me porter en vous une ſeconde mort.	Le Serpent que j'attends peut vous être funeste, Vous envelopper dans mon sort, Et me porter en vous une seconde mort.
De Cferm’a ſeule condamné A ſon halcine empoiſonnée, Rien ne ſçauroit me ſecourir, Et je n’ay pas beſoin d’exemple pour mourir.	De Cferm'a seule condamné À son halcine empoisonnée, Rien ne saurait me secourir, Et je n'ai pas besoin d'exemple pour mourir.
AGLAURE.	AGLAURE.
Ne nous enviez vous pas ce cruel avant age De confondre nos pleurs avec vos déplaiſirs, De mêler nos ſoûpirs à vos derniers ſoûpirs;	Ne nous enviez -vous pas ce cruel avant age De confondre nos pleurs avec vos déplaisirs, De mêler nos soupirs à vos derniers soupirs;
D’une tendre amitié ſouffrez ce dermer gage.	D'une tendre amitié souffrez ce dermer gage.
SICHEC’eſt vous perdre inutilement.	SICHÉC'est vous perdre inutilement.
IDIPPE.	JDIPE.
Ceſt en vôtre faveur eſperer un miracle, Ou vous accompagner juſques au monument.	Cest en votre faveur espérer un miracle, Ou vous accompagner jusques au monument.
CHE'.	CHÉE.
Que peut-on ſe promettre aples un tel Oracle?	Que peut-on se promettre aples un tel Oracle?
AGLAURE.	AGLAURE.
Un Oracle jamais n'eſt ſans obſcurité, (tendre, On l’entend d’autant moins que mieux on croit l'enEt peut-être aprés tout n’en devez-vous attendre Que gloire & que felicité.	Un Oracle jamais n'est sans obscurité, (tendre, On l'entend d'autant moins que mieux on croit l'enÉt peut-être après tout n'en devez-vous attendre Que gloire et que félicité.
Laiſſez nous voir, ma Sœur, par une digne iſſuë, Cette frayeur mortelle heureuſement déçeuë, Où mourir du moins avec vous, Si le Ciel à nos vœux ne ſe montre plus doux.	Laissez nous voir, ma Sœur, par une digne issue, Cette frayeur mortelle heureusement déçue, Où mourir du moins avec vous, Si le Ciel à nos vœux ne se montre plus doux.
SICHE'.	SICHÉE.
Ma Sœur, écoutez mieux la voix de la Nature, Qui vous appelle aupres du Roy.	Ma Sœur, écoutez mieux la voix de la Nature, Qui vous appelle auprès du Roi.
Vous n’aimez trop, le devoir en murmure, Vous en ſçavez l’indiſpenſable loy, Un Pere vous doit être encor plus cher que moy.	Vous n'aimez trop, le devoir en murmure, Vous en savez l'indispensable loi, Un Père vous doit être encor plus cher que moi.
Rendez-vous toutes deux l’appuy de ſa vieilleſſe, Vous luy devez chacune un Gendre, & des Neveux, Mille Rois à l’envy vous gardent leur tendreſſe, Mille Rois à l’envy vous offriront leurs vœux:	Rendez-vous toutes deux l'appui de sa vieillesse, Vous avez devez chacune un Gendre, et des Neveux, Mille Rois à l'envi vous gardent leur tendresse, Mille Rois à l'envi vous offriront leurs vœux:
D'Oruere me veueleuis, ce feute aun je veux Mourir ſi je puis, ſans foibleſſe, On ne vous avoit pas pour temoins toutes ueux De ce que malgré moy la Nature m’en laiſſe.	D'Orèvre me veueleuis, ce feute aun je veux Mourir si je puis, sans faiblesse, On ne vous avait pas pour témoins toutes ueux De ce que malgré moi la Nature m'en laisse.
AGLAURE.	AGLAURE.
Partager vos malheurs, c’eſt vous importuner.	Partager vos malheurs, c'est vous importuner.
CIDIPPE.	CIDIPE.
J’oſe dire un peu plus, ma Sœur, c’eſt vous déplaire,	J'ose dire un peu plus, ma Sœur, c'est vous déplaire,
PSICHE'.	PSICHÉE.
Non, mais enfin c’eſt me gêner, Et peut-être du Ciel redoubler la colere.	Non, mais enfin c'est me gêner, Et peut-être du Ciel redoubler la colère.
AGLAURE.	AGLAURE.
Vous le voulez, & nous partons.	Vous le voulez, et nous partons.
Daigne ce même Ciel plus juſte & moins ſevere, Vous envoyer le ſort que nous vous ſouhaitons, Et que nôtre amitié ſincere En dépit de l’Oracle & maigré vous elpere.	Daigne ce même Ciel plus juste et moins sévère, Vous envoyer le sort que nous vous souhaitons, Et que notre amitié sincère En dépit de l'Oracle et maigré vous élpère.
SICHE'.	SICHÉE.
Adieu, c’eſt un eſpoir, ma Sœur, & des ſouhaits, Qu aucuu des Bleuxne fempihla jainars.	Adieu, c'est un espoir, ma Sœur, et des souhaits, Qu aucu des Bleuxne fempiha jars.
EEEDIII	EEEDIII
PSICHE' ſeule.	PSICHÉE seule.
E Nſin ſeule, & toute à moy-même, Je puis enviſager cet affreux changement, Qui du haut d’une gloire extréme Me précipite au monument.	E Nsin seule, et toute à moi-même, Je puis envisager cet affreux changement, Qui du haut d'une gloire extrême Me précipite au monument.
Cette gloire étoit ſans ſeconde, (de L’éclat s’en répãdoit juſqu’aux deux bouts du MonTout ce qu’il a de Rois ſẽbloient faits pour m’aimer:	Cette gloire était sans seconde, (de L'éclat s'en répandait jusqu'aux deux bouts du MonTout ce qu'il a de Rois sont faits pour m'aimer:
Tous leurs Sujets me prenant pour Deeſſe, Commençoient à m’accoûtumer Aux encens qu’ils m’offroient ſans ceſſe;	Tous leurs Sujets me prenant pour Déesse, Commençaient à m'accoutumer Aux encens qu'ils m'offraient sans cesse;
Leurs ſoûpirs me ſuivoient ſans qu’il m’en coûtát Mon ame reſtoit libre en captivant tant d’ame, (rien, 2 Et j’étois parmy tant de flâmes Reine de tous les cœurs, & maîtreſſe du mien.	Leurs soupirs me suivaient sans qu'il m'en coût Mon âme restait libre en captivant tant d'âme, (rien, 2 Et j'étais parmi tant de flammes Reine de tous les cœurs, et maîtresse du mien.
O Ciel!	Ô Ciel!
m’auriez-vous fait un crime De cette inſen ſibilité ?	m'auriez-vous fait un crime De cette insen sibilité ?
Déployez vous ſur moy tant de ſeverité, Pour n’avoir à leurs vœux rendu que de l’eſtime?	Déployez -vous sur moi tant de sévérité, Pour n'avoir à leurs vœux rendu que de l'estime?
Si vous m’impoſiez cette loy, 0 Qu’il fallut faire un choix pour ne pas vous déplaire Puis que je ne pouvois faire, Que ne le faiſiez-vous pour moy;	Si vous m'imposiez cette loi, 0 Qu'il fallut faire un choix pour ne pas vous déplaire Puis que je ne pouvais faire, Que ne le faisiez-vous pour moi;
Que ne m’inſpiriez, vous ce qu’inſpire à tãt d’autres Le mérite, l’amour, &.	Que ne m'inspiriez, vous ce qu'inspire à tant d'autres Le mérite, l'amour, et.
Mais que vois-je icy?	Mais que vois-je ici?
SGENE IV.	SGENE IV.
CLEOMENE, AGENOR, PSICHE'.	CLÉOMENE, AGENOR, PSICHÉE.
CLEOMENE.	CLÉOMENE.
Eux Amis, deux Rivaux, dont l’unique ſouci D'Eſt d’expoſer leurs jours pour conſerver les vôSICHE’.	Eux Amis, deux Rivaux, dont l'unique souci D'Est d'exposer leurs jours pour conserver les vôSICHE’.
tres, Puis je vous écouter quand j’ay chaſſé deux Sœurs?	très, Puis -je vous écouter quand j'ai chassé deux Sœurs?
Princes, contre le Ciel penſez-vous me defendre?	Princes, contre le Ciel pensez-vous me défendre?
Vous livrer au Serpent qu’icy je dois attendre, Ce n’eſt qu’un deſeſpoir qui ſied mal aux grands Et mourir alors que je meurs, (cœurs, C’eſt accabler une ame tendre Qui n’a que trop de ſes douleurs.	Vous livrer au Serpent qu'ici je dois attendre, Ce n'est qu'un désespoir qui sied mal aux grands Et mourir alors que je meurs, (cœurs, C'est accabler une âme tendre Qui n'a que trop de ses douleurs.
AGENGR.	AGENGR.
Un Serpent n’eſt pas invincible?	Un Serpent n'est pas invincible?
Cadmus qui n’aimoit rien défit celui de Mars;	Cadmus qui n'aimait rien défit celui de Mars;
Nous aimons, & l’Amour ſçait rendre tout poſſible Au cœur qui ſuit ſes étendarts, A la main dont lui-même il conduit tous les dards.	Nous aimons, et l'Amour sait rendre tout possible Au cœur qui suit ses étendards, À la main dont lui-même il conduit tous les dards.
PSICHE’.	PSICHÉE.
Voulez-vous qu’il vous ſerve en faveur d’une ingrate Que tous ſes traits n’ont pû toucher?	Voulez-vous qu'il vous serve en faveur d'une ingrate Que tous ses traits n'ont pu toucher?
Qu’il dompte ſa vangeance au moment qu’elle éclate Et vous aide à m’en arracher?	Qu'il dompte sa vengeance au moment qu'elle éclate Et vous aide à m'en arracher?
Quaud même vous m’auriez ſervie, Quand vous m’auriez rendu la vie, Quel fruit elperez-vous de qui ne paut aimer ?	Quaud même vous m'auriez servie, Quand vous m'auriez rendu la vie, Quel fruit elperez-vous de qui ne paut aimer ?
CLEOMENE.	CLÉOMENE.
Ce n’eſt point par l’eſpoir d’un ſi charmant ſalaire Que nous nous ſentons animer, Nous ne cherchons qu'à ſatisfaire Aux devoirs d’un amour qui n’oſe pr éſumer Que jamais, quoi qu’il puiſſe faire, Il ſoit capable de vous plaire, Et digne de vous enffâmer.	Ce n'est point par l'espoir d'un si charmant salaire Que nous nous sentons animer, Nous ne cherchons qu'à satisfaire Aux devoirs d'un amour qui n'ose pr èsumer Que jamais, quoi qu'il puisse faire, Il soit capable de vous plaire, Et digne de vous enffâmer.
Vivez, belle Princeſſe, & vivez pour un autre?	Vivez, belle Princesse, et vivez pour un autre?
Nous le verrons d’un œil jaloux, Nous en mourrons, mais d’un trepas plus doux Que s’il nous falloit voir le vôtre;	Nous le verrons d'un œil jaloux, Nous en mourrons, mais d'un trépas plus doux Que s'il nous fallait voir le vôtre;
Et ſi nous ne mourons en vous ſauvant le jour, Quelque amour qu’à nos yeux vous preferiez au nôtre, Nous voulons bien mourir de douleur & d’amour.	Et si nous ne mourons en vous sauvant le jour, Quelque amour qu'à nos yeux vous préfériez au nôtre, Nous voulons bien mourir de douleur et d'amour.
I CHE'.	I CHÉE.
Vivez, Princes, vivez, & de ma Deſtinée Ne ſongez plus à rompre, ou partager la loy:	Vivez, Princes, vivez, et de ma Destinée Ne songez plus à rompre, ou partager la loi:
Je croy vous l’avoir dit, le Ciel ne veut que moi, Le Ciel m’a ſeule condamnée.	Je crois vous l'avoir dit, le Ciel ne veut que moi, Le Ciel m'a seule condamnée.
Je penſe oüir déja les mortels ſifflemens De ſon Miniſtre qui s’approche, Ma frayeur me le peint, me l’offre à tous momens, Et inaitiene qu’elle elt de tous llles rentrinens, Elle me le figure au haut de cette Roche:	Je pense ouïr déjà les mortels sifflements De son Ministre qui s'approche, Ma frayeur me le peint, me l'offre à tous moments, Et inaitène qu'elle alt de tous llles rentrinents, Elle me le figure au haut de cette Roche:
J’en tombe de foibleſſe, & mon cœur abatu Ne ſoûtient plus qu’à peine un reſte de vertu.	J'en tombe de faiblesse, et mon cœur abattu Ne soutient plus qu'à peine un reste de vertu.
A dieu, Princes, fuyez, qu’il ne vous empoiſonne.	À dieu, Princes, fuyez, qu'il ne vous empoisonne.
AGENOR.	AGENOR.
Rien ne s’offre à nos yeux encor qui les étoune, Et quand vous vous peignez un ſi procherrépas, Si la force vous abandonne.	Rien ne s'offre à nos yeux encor qui les étoune, Et quand vous vous peignez un si procherrépas, Si la force vous abandonne.
Nous avons des cœurs & des bras Que l’eſpoir n’abandonne pas.	Nous avons des cœurs et des bras Que l'espoir n'abandonne pas.
Peut-être qu’un Rival a dicté cet Oracle, Que l’or a fait parler celuy qui l’a rendu :	Peut-être qu'un Rival a dicté cet Oracle, Que l'or a fait parler celui qui l'a rendu :
Ce ne ſeroit pas un miracle, Que pour un Dieu muet un Homme eut répondu?	Ce ne serait pas un miracle, Que pour un Dieu muet un Homme eut répondu?
Et dans tous les Climats on n’a que top d’exemples Qu’il eſt ainſi qu’ailleurs des méchãs dans les Tem(ples	Et dans tous les Climats on n'a que top d'exemples Qu'il est ainsi qu'ailleurs des méchants dans les Tembleples
CLEOMENE.	CLÉOMENE.
Laiſſez-nous oppoſer au lâche Raviſſeur, A qui le Sacrilege indignement vous livre, Un amour qu’a le Ciel choiſi pour defenſeur De la ſeule Beauté pour qui nous voulons vivre.	Laissez-nous opposer au lâche Ravisseur, À qui le Sacrilège indignement vous livre, Un amour qu'a le Ciel choisi pour défenseur De la seule Beauté pour qui nous voulons vivre.
Si nous n’oſons pretendre à ſa ponſenion Du moins en ſon peril permettez-nous de ſuivre L’ardeur & les devoirs de nôtre paſſion.	Si nous n'osons prétendre à sa ponsenion Du moins en son péril permettez-nous de suivre L'ardeur et les devoirs de notre passion.
SICHE'.	SICHÉE.
Portez-les à d’autres moy-mêmes, Princes, portez-les à mes Sœurs Ces devoirs, ces ardeurs extrêmes Dont pour moi ſont remplis vos cœurs, Vivez pour elles quand je meurs, Plaignez de mon deſtin les funeſtes rigueurs, Sans leur donner en vous de nouvelles matieres.	Portez-les à d'autres moi-mêmes, Princes, portez-les à mes Sœurs Ces devoirs, ces ardeurs extrêmes Dont pour moi sont remplis vos cœurs, Vivez pour elles quand je meurs, Plaignez de mon destin les funestes rigueurs, Sans leur donner en vous de nouvelles matières.
De fant ines volumten uuidieres, Et l’on a reçeu de tout temps Pour ſouveraines loix les ordres des Mourans.	De fant ines volumten uuidieres, Et l'on a reçu de tout temps Pour souveraines lois les ordres des Mourants.
Princeſſe.	Princesse.
CLEOMENE.	CLÉOMENE.
PSICHE'.	PSICHÉE.
Encor un coup, Princes, vivez pour elles, Tant que vous m’aimerez vous devez m’obeïr;	Encore un coup, Princes, vivez pour elles, Tant que vous m'aimerez -vous devez m'obéir;
Ne me reduiſez pas à vouloir vous hair,	Ne me réduisez pas à vouloir vous haïr,
Et vons regarder en rebelles, A force de m’être fidelles.	Et vons regarder en rebelles, A force de m'être fidèles.
Allez, laiſſez moi ſeule expirer en ce lieu, Où je n’ay plus de voix que pour vous dire Adieu.	Allez, laissez -moi seule expirer en ce lieu, Où je n'ai plus de voix que pour vous dire Adieu.
Mais je ſens qu’on m’enleve, & l’air m’ouvre une rouD’où vous n’entendrez plus cette mourante voix.	Mais je sens qu'on m'enlève, et l'air m'ouvre une rouD'où vous n'entendrez plus cette mourante voix.
te Adieu, Princes, A dieu pour la derniere fois, Voyez ſr de mon ſort vous pouvez etſe en doute.	te Adieu, Princes, A dieu pour la dernière fois, Voyez sr de mon sort vous pouvez etse en doute.
Elle eſt enlevée en l’air par deux Zephires.	Elle est enlevée en l'air par deux Zéphires.
AGENOR.	AGENOR.
rious ia perdons de veuë, allons tous deux chercher Sur le faiſte de ce Rocher, Prinee, ns moyens de la ſuivre.	rious ja perdons de vue, allons tous deux chercher Sur le faîte de ce Rocher, Prinée, ns moyens de la suivre.
CLEOMENE.	CLÉOMENE.
Allons-y chercher ceux de ne luy point ſurvivre.	Allons-y chercher ceux de ne lui point survivre.
SCLNEV L’AMOUR en l'air.	SCLNEU L'AMOUR en l'air.
A Llez mourir, Rivaux d’un Dieu jaloux, Dont vous merittez le courroux, rour avoir eu le cœur ſenſible aux mêmes charmes.	À Llez mourir, Rivaux d'un Dieu jaloux, Dont vous mérittez le courroux, rour avoir eu le cœur sensible aux mêmes charmes.
Et toy, forge, Vulcain, mille brillans attraits Pour orner un Palais, Où l’Amour de Pſiché veut eſſuyer les larmes, Et lui rendre les armes.	Et toi, forge, Vulcain, mille brillants attraits Pour orner un Palais, Où l'Amour de Psiché veut essuyer les larmes, Et lui rendre les armes.
SECOND INTERMEDE.	SECOND INTERMÈDE.
A Scene ſe change en une Cour magnifique, ornée E de Colomnes de Lapis enrichies de Figures d’or, qui forment un Palais pompeux & brillant, que l’Amour deſtine pour Pſiché.	À Scène se change en une Cour magnifique, ornée E de Colomnes de Lapis enrichies de Figures d'or, qui forment un Palais pompeux et brillant, que l'Amour destine pour Psiché.
Six Cyclopes avec quatre Fées y ſout une Entrée de Ballet, où il ac hevent en cadence quatre gros Vaſes d’argent que les Fées leur ont apportez.	Six Cyclopes avec quatre Fées y sout une Entrée de Ballet, où il ac hèvent en cadence quatre gros Vases d'argent que les Fées leur ont apportez.
Cette Entrée eſt entrecoupée par ce Recit de Vu!	Cette Entrée est entrecoupée par ce Recit de Vu!
cain, qu’il fait à deux repriſes.	cain, qu'il fait à deux reprises.
Epêchez, preparez ces lieux D Pour le plus aimables des Dieux.	Epêchez, préparez ces lieux D Pour le plus aimables des Dieux.
Que chacun pour lui s’intereſſe, N’oubliez rien des ſoffs qu’il faut;	Que chacun pour lui s'intéresse, N'oubliez rien des soffs qu'il faut;
Quand l’amour preſſe, On n’a jamais fait aſſez tôt.	Quand l'amour presse, On n'a jamais fait assez tôt.
48 ταση L’amour ne veut point qu’on differe, Travaillez, hatez-vous, Frappez, redoublez vos coups;	48 > L'amour ne veut point qu'on diffère, Travaillez, hâtez-vous, Frappez, redoublez vos coups;
Que l’ardeur de luy plaire Faſſe vos ſoins les plus doux.	Que l'ardeur de lui plaire Fasse vos soins les plus doux.
SECOND COUPLET.	SECOND COUPLET.
Ervez bien un Dieu ſi charmant, Al Il ſe plait dans T’emprenement, Que chacun pour lui s’intereſſe.	Ervez bien un Dieu si charmant, Al Il se plaît dans T'éprenement, Que chacun pour lui s'intéresse.
N’oubliez rien des ſoins qu’il faut:	N'oubliez rien des soins qu'il faut:
Quand l’amour preſſe, On n’a jamais fait aſſez-tôt.	Quand l'amour presse, On n'a jamais fait assez-tôt.
g M L’Amour ne veut point qu’on differe, Travaillez, &c.	guère , TRAmour ne veut point qu'on diffère, Travaillez, etc.
ROTE II.	ROTE II.
SGG PREMIERE.	SGG PREMIÈRE.
L’AMOUR, ZEPHIRE.	L'AMOUR, ZÉPHIRE.
ZEPHIRE.	ZÉPHIRE.
UY, je me fuis galamment acquité De la commiſſion que vous m’avez donnée, Et du haur du Rocher je l’ay, cette Beauté, Par le milieu des airs doucement amenée.	UY, je me fuis galamment acquité De la commission que vous m'avez donnée, Et du haur du Rocher je l'ai, cette Beauté, Par le milieu des airs doucement amenée.
Dans ce beau Palais enchanté, Où vous pouvez en liberté Diſpoſer de ſa Deſtinée:	Dans ce beau Palais enchanté, Où vous pouvez en liberté Disposer de sa Destinée:
Mais vous me ſurprenez par ce grand changement Qu’en vôtre perſonne vous faïtes;	Mais vous me surprenez par ce grand changement Qu'en votre personne vous faïtes;
Cette taille, ces traits, & cet ajuſtement, Cachent tout-à fait quę vous êtes, ( Et je donne aux plus fins à pouvoir en ce jour Vous reconnoître pour l’Amour.	Cette taille, ces traits, et cet ajustement, Cachent tout-à fait qu' vous êtes, ( Et je donne aux plus fins à pouvoir en ce jour Vous reconnaître pour l'Amour.
L’AMOUR.	L'AMOUR.
Auſſi ne veux-je pas qu’on puiſſe me connoître, Je ne veux à Pſiché que découvrir mon cœur, Rien que les beaux tranſports de cette vive ardeur Que ſes doux charmes y font naître?	Aussi ne veux-je pas qu'on puisse me connaître, Je ne veux à Psiché que découvrir mon cœur, Rien que les beaux transports de cette vive ardeur Que ses doux charmes y font naître?
Et pour en ex primer l’amoureuſe langueur, Et cacher ce que je puis être Aux veux qui m’impoſent des loix, J’ay pris la forme que tu vois.	Et pour en ex primer l'amoureuse langueur, Et cacher ce que je puis être Aux veux qui m'imposent des lois, J'ai pris la forme que tu vois.
ZEPHIRE.	ZÉPHIRE.
En tout vous êtes un grand Maître, C’eſt icy que je le connois.	En tout vous êtes un grand Maître, C'est ici que je le connais.
Sous ces déguiſemens de diverſes nature On a veu les Dieux amoureux Chercher à ſoulager cette douce bleſſure Que reçoivent les cœurs de vos traits pleins de feux:	Sous ces déguisements de diverses nature On a vu les Dieux amoureux Chercher à soulager cette douce blessure Que reçoivent les cœurs de vos traits pleins de feux:
Mais en bon ſens yous l’emportez ſur eux, Et voila la bonne figure Pour avoir un ſuccez heureux, Pres de l’aimable Sexe où l'on porte ſes vœux, Oüi, de ces foimes la l’aſiſitance eſt bien forte, Et ſans parler ny de rang, ny d’eſprit, Qui peut trouver moyen d’être fait de la ſorte, Ne ſoûpire guere à credit.	Mais en bon sens yous l'emportez sur eux, Et voilà la bonne figure Pour avoir un succès heureux, Pres de l'aimable Sexe où l'on porte ses vœux, Oui, de ces faimes la l'asisitance est bien forte, Et sans parler ni de rang, ni d'esprit, Qui peut trouver moyen d'être fait de la sorte, Ne soupire guère à crédit.
L'AMOUR.	L'AMOUR.
J’ay reſolu, mon chei Zephire, De demeurer ainſi toûjours, Et l’on ne peut trouver à redire A l’aîné de tous les A mours.	J'ai résolu, mon chey Zéphire, De demeurer ainsi toujours, Et l'on ne peut trouver à redire À l'aîné de tous les A mours.
Il eſt tems de ſortir de cette longue enfance Qui fatigue ina patience, Il eſt tems deſorn ais que je devienne grand.	Il est temps de sortir de cette longue enfance Qui fatigue ina patience, Il est temps désorn ais que je devienne grand.
ZEPHIRE.	ZÉPHIRE.
Fort-bien, vous ne pouvez mieux faire, Et vous entrez dans un miſtere.	Fort-bien, vous ne pouvez mieux faire, Et vous entrez dans un mystère.
Qui ne demande rien d’enfant.	Qui ne demande rien d'enfant.
L'AMOUR.	L'AMOUR.
Ce changement ſans doute irritera ma Mere.	Ce changement sans doute irritera ma Mère.
ZEPHIRE.	ZÉPHIRE.
Je prévoy là deſſus quelque peu de colere.	Je prévois là -dessus quelque peu de colère.
Bien que les diſputes des ans Ne doivent point regner parmy des Immortelles, Vôtre Mere Venus eſt de l’humeur des Belles Qui n’aiment point de grands enfans.	Bien que les disputes des ans Ne doivent point régner parmi des Immortelles, Votre Mère Venus est de l'humeur des Belles Qui n'aiment point de grands enfants.
Mais où je la trouve outragée, C’eſt dans le procedé que l’on vous voit tenir, Et c’eſt l’avoir étrangement vangée, Que d’aimer la Beaute qu’enle vouion puntr.	Mais où je la trouve outragée, C'est dans le procédé que l'on vous voit tenir, Et c'est l'avoir étrangement vengée, Que d'aimer la Beaute qu'enle vouion puntr.
Cette haine où ſes vœux prétendent que réponde La puiſſance d’un Fils que redoutent les Dieux.	Cette haine où ses vœux prétendent que réponde La puissance d'un Fils que redoutent les Dieux.
L’AMOUR.	L'AMOUR.
Laiſſons cela, Zephire, & me dyſites yeux Ne trouve pas Pſiché la plus belle du Monde?	Laissons cela, Zéphire, et me disites yeux Ne trouve pas Psiché la plus belle du Monde?
Eſt-il rien ſur la Terre, eſt il rien dans les Cieux, Qui puiſſe luy ravir le titre gloneux.	Est-il rien sur la Terre, est -il rien dans les Cieux, Qui puisse notre ravir le titre gloneux.
De beauté ſans ſeconde?	De beauté sans seconde?
Mais je la voy, mon cher Zephire,	Mais je la vois, mon cher Zéphire,
ZEPHIRE.	ZÉPHIRE.
Vous pouvez vous montrer pour finir ſon martyre, Luy découvrir ſon deſtin glorieux, Et vous dire entre vous tout ce que peuvent dire Les ſoûpirs, la bouche, & les yeux.	Vous pouvez vous montrer pour finir son martyre, Lui découvrir son destin glorieux, Et vous dire entre vous tout ce que peuvent dire Les soupirs, la bouche, et les yeux.
En Confident diſcret je ſçai ce qu’il faut faire Pour ne pas interrompre un amoureux myſtere.	En Confident discret je sais ce qu'il faut faire Pour ne pas interrompre un amoureux mystère.
SCENE II.	SCÈNE II.
66 &i M* 135 Le Ciel auroit-il fait cet amas de merveilles Pour la demeure d’un Serpent ?	66 eti M* 135 Le Ciel aurait-il fait cet amas de merveilles Pour la demeure d'un Serpent ?
Et lors que par leur veuë il amuſe & ſuſpend De mon Deſtin jaloux les rigueurs ſans pareilles, Veut-il montrer qu’il s’en repent ?	Et lors que par leur vue il amuse et suspend De mon Destin jaloux les rigueurs sans pareilles, Veut-il montrer quil 'en repent ?
Non, non, c’eſt de ſa harne en cruautez féconde Lc pius hoi, le prus pude trait, Qui par uue rigueur nouvelle & ſans ſeconde N’étale ce choix qu’elle a fait De ce qu’a de plus beau le Monde, Qu’afin que je le quitte avec plus de regret.	Non, non, c'est de sa harne en cruautés féconde Lis pius hoi, le prus pude trait, Qui par ouve rigueur nouvelle et sans seconde N'étale ce choix qu'elle a fait De ce qu'a de plus beau le Monde, Qu'afin que je le quitte avec plus de regret.
ee M35	ce M35
PSICHE' ſeule.	PSICHÉE seule.
U ſuis jer & dans un lieu que je croyois barbare, O Quelle ſçavante main à bâty ce Palais, Que l’Art, que la Nature pare De l’aſſemblage le plus rare Que l’œil puiſſe admirer jamais?	V suis jer et dans un lieu que je croyais barbare, Ô Quelle savante main à bâti ce Palais, Que l'Art, que la Nature pare De l'assemblage le plus rare Que l'œil puisse admirer jamais?
Tout rit, tout brille, tout éclate, Dans ces Jardins, dans ces apartemens, Dont les pompeux ameublemens N’ont rien qui n’enchante & ne flate;	Tout rit, tout brille, tout éclate, Dans ces Jardins, dans ces appartements, Dont les pompeux ameublements N'ont rien qui n'enchante et ne flatte;
Et de quelque côté que tour nent mes frayeurs, Je ne voy ſous mes pas que de l’or, ou des fleurs.	Et de quelque côté que tour nent mes frayeurs, Je ne vois sous mes pas que de l'or, ou des fleurs.
Que mon eſpoir eſt ridicule, S’il croit parla ſoulager mes douleurs !	Que mon espoir est ridicule, S'il croit parla soulager mes douleurs !
Tout autant de momens que ma mort ſe recule, Sont autant de nouveaux malheurs, Plus elle tarde, & plus de fois je meurs.	Tout autant de moments que ma mort se recule, Sont autant de nouveaux malheurs, Plus elle tarde, et plus de fois je meurs.
Ne me fai plus languir, vien prendre ta victime, Monſtre qui dois me déchirer, Veux-tu que je te cherche, & faut-il que j’anime Les fureurs à me devorer?	Ne me fait plus languir, viens prendre ta victime, Montre qui dois me déchirer, Veux-tu que je te cherche, et faut-il que j'anime Les fureurs à me dévorer?
Si le Ciel veut ma mort, ſi ma vie eſt un crime.	Si le Ciel veut ma mort, si ma vie est un crime.
De ce peu qui m’en reſte oſe enfin t’emparer.	De ce peu qui m'en reste ose enfin t'emparer.
Je ſuis laſſe de murmurer coutre un chaſtiment legitime, Je ſuis laſſe de ſoupirer, vien, que juendve d’expirer.	Je suis lasse de murmurer coutre un châtiment légitime, Je suis lasse de soupirer, vien, que juendue d'expirer.
Q d d de ſ lire.	Q dès d de s lire.
L’AMOUR, PSIICHE', ZEPHIRE.	L'AMOUR, PSICHÉE, ZEPHIRE.
L'AMOUR.	L'AMOUR.
E voila ce Serpent, ce Monſtre impitoyable, LQu'un Oracle étonnant pour vous a préparé, Et qui n’eſt pas peut être à tel point effroyable Que vous vous l’êtes figuré.	E voilà ce Serpent, ce Monstre impitoyable, LUQu'un Oracle étonnant pour vous a préparé, Et qui n'est pas peut être à tel point effroyable Que vous vous l'êtes figuré.
ICHE.	ICHÉ.
Vous, Seigneur, vous ſeriez ce Monſtre dont l’Oracle A menacé mes triſtes jours.	Vous, Seigneur, vous seriez ce Monstre dont l'Oracle A menacé mes tristes jours.
Vous qui ſemblez plûtôt un Dieu qui par miracle Daigne venir lui-même à mon ſecours!	Vous qui semblez plutôt un Dieu qui par miracle Daigne venir lui-même à mon secours!
L’AMOUR.	L'AMOUR.
Quel beſoin de ſecours aa milieu d’un Empire,	Quel besoin de secours a milieu d'un Empire,
où tout ce qui reſpire N’attends que vos regards pour en prendre la Loi, Où vous n’avez à craindre autre Monſtre que moi!	où tout ce qui respire N'attends que vos regards pour en prendre la Lois, Où vous n'avez à craindre autre Montre que moi!
SICHE'.	SICHÉE.
Qu’un Monſtre tel que vous inſpire peu de crainte!	Qu'un Monstre tel que vous inspire peu de crainte!
Et que s’il a quelque poiſon, Une ame auroit peu de raiſon De hazarder la moindre plainte, Contre une favorable atteinte Dont tout le cœur craindroit la gueriſon!	Et que s'il a quelque poison, Une âme aurait peu de raison De hasarder la moindre plainte, Contre une favorable atteinte Dont tout le cœur craindrait la guérison!
A peine je vous voi, que mes frayeurs ceſſées Laiſſent évanoüir l’image du trépas, Et que je ſens couler dans mes vaines glacées Un je ne ſçai quel feu que je ne connoi pas.	À peine je vous vois, que mes frayeurs cessées Laissent évanouir l'image du trépas, Et que je sens couler dans mes vaines glacées Un je ne sais quel feu que je ne connais pas.
J’ai ſenty de l’eſtime, & de la conplaiſance, De l’amitié, la reconnoiſſance, De la compaſſion les chagrins innocens M’en ont fait ſentir la puiſſance, Mais je n’ai point encor ſenti ce que je ſens.	J'ai senti de l'estime, et de la conplaisance, De l'amitié, la reconnaissance, De la compassion les chagrins innocents M'en ont fait sentir la puissance, Mais je n'ai point encor senti ce que je sens.
Je ne ſçaï ce que c’eſt, mais je ſçai qu’il me charme, Que je n’en conçoi point d’alarme;	Je ne sçaï ce que c'est, mais je sais qu'il me charme, Que je n'en conçois point d'alarme;
Plus j’ai les yeux ſur vous, plus je m’en ſens charmer:	Plus j'ai les yeux sur vous, plus je m'en sens charmer:
Tout ce que j’ai ſen ti n’agiſſoit point de même, Et je dirois que je vous aime, Seigneur, ſi je ſçavois ce que c’eſt que d’aimer.	Tout ce que j'ai sen ty n'agissait point de même, Et je dirais que je vous aime, Seigneur, si je sais ce que c'est que d'aimer.
Ne les detournez point, ces yeux qui m’empoiſõnent, Ces yeux tendres, ces yeux perçans, mais amoureux, Qui ſemblent partager le trouble qu’ils me donnent.	Ne les détournez point, ces yeux qui m'empoisõnent, Ces yeux tendres, ces yeux perçants, mais amoureux, Qui semblent partager le trouble qu'ils me donnent.
Helas!	Hélas!
plus ils ſont dangereux, Plus je me plais à mattacher ſur eux.	plus ils sont dangereux, Plus je me plais à mattacher sur eux.
Par quel ordre du Ciel que je ne puis comprendre Vous dy-je plus que je ne doi, Moi de qui la pudeur devroit du moins attendre Que vous m’expliquaſſiez le trouble où je vous voi Vous ſoûpirez, Seigneur, ainſi que je ſoûpire, Vos ſens comme les miens paroiſſent interdits, C’eſt à moi de m’en taire, à vous de me le dire, Et cependant c’eſt moi qui vous le dis.	Par quel ordre du Ciel que je ne puis comprendre Vous dis-je plus que je ne dois, Moi de qui la pudeur devrait du moins attendre Que vous m'expliquassiez le trouble où je vous voi Vous soupirez, Seigneur, ainsi que je soupire, Vos sens comme les miens paraissent interdits, C'est à moi de m'en taire, à vous de me le dire, Et cependant c'est moi qui vous le dis.
L’AMOUR.	L'AMOUR.
Vous avez eu, Pſiché, l’ame toûjours ſi dure.	Vous avez eu, Psiché, l'âme toujours si dure.
Qu’il ne faut pas vous étonner, Si pour en reparer l’injure L’Amour en ce moment ſe paye avec uſure De ceux qu’elle a deu lui donner.	Qu'il ne faut pas vous étonner, Si pour en réparer l'injure L'Amour en ce moment se paye avec usure De ceux qu'elle a dev lui donner.
Ce moment eſt venu qu’il faut que vôtre bouche Exhale des ſoûpirs ſi long-tems retenus, Et qu’en vous arrachant à cette humeur farouche, Un amas de tranſporis auſſi doux qu’inconnus Auſſi ſenſiblement tout à la fois vous touche, Qu’ils ont dû vous toucher durãt tant de beaux jours Dont cette ame inſenſible a Profané le cours.	Ce moment est venu qu'il faut que votre bouche Exhale des soupirs si longtemps retenus, Et qu'en vous arrachant à cette humeur farouche, Un amas de transporis aussi doux qu'inconnus Aussi sensiblement tout à la fois vous touche, Qu'ils ont dû vous toucher durant tant de beaux jours Dont cette âme insensible a Profané le cours.
* o A OIE5 N’aimer point, c’eſt donc un grand crime!	* ô À OIE5 N'aimer point, c'est donc un grand crime!
E AMOON.	 AMOON.
En ſouffrez vous un rude chatiment?	En souffrez -vous un rude châtiment?
PSICHE'.	PSICHÉE.
C’eſt punir aſſez doucement.	C'est punir assez doucement.
L'AMOUR.	L'AMOUR.
C’eſt lui choiſir ſa peine légitime, Et ſe faire juſtice en ce glorieux jour D’un manquement d’amour, par un excés d’a nour.	C'est lui choisir sa peine légitime, Et se faire justice en ce glorieux jour D'un manquement d'amour, par un excès d'a nour.
PSICHE'.	PSICHÉE.
Que n’ai-je été plûtôt punie!	Que n'ai-je été plutôt punie!
y mets le bonheur de ma vie, Je devrois en rougir, ou le dire plus bas, Mais le ſuplice a trop d’appas:	y mets le bonheur de ma vie, Je devrais en rougir, ou le dire plus bas, Mais le suplice a trop d'appas:
Permettez que tout haut je le die & redie, Je le dirois cent fois & n’en rougirois pas.	Permettez que tout haut je le die et rédie, Je le dirais cent fois et n'en rougirais pas.
Ce n’eſt point moi qui parle, & de vôtre preſence L’empire ſurprenant, laimable violence, Dés que je veux parler, s’empare de ma voix.	Ce n'est point moi qui parle, et de votre présence L'empire surprenant, laimable violence, Dès que je veux parler, s'empare de ma voix.
C’eſt en vain qu’en ſecret ma pudeur s’en offenſe, Que le Sexe & la bienſeance Oſent me faire d’autre loix;	C'est en vain qu'en secret ma pudeur s'en offense, Que le Sexe et la bienséance Osent me faire d'autre lois;
Vos yeux de ma réponſe eux-mêmes tont le choix.	Vos yeux de ma réponse eux-mêmes tont le choix.
Et ma oouche aſſervie à leur toute-puiſfance Ne me conſulte plus ſur ce que je me dois.	Et ma oouche asservie à leur toute-puissance Ne me consulte plus sur ce que je me dois.
L’AMOUR.	L'AMOUR.
croyez, belle Pſiché, croyez ce qu’ils vous diſent.	croyez, belle Psiché, croyez ce qu'ils vous disent.
Ces yeux, qui ne ſont point jaloux, Qu’à l’envi les voſtres m’inſtruiſent De tout ce qui ſe paſſe en vous.	Ces yeux, qui ne sont point jaloux, Qu'à l'envi les vôtres m'instruisent De tout ce qui se passe en vous.
Croyez en ce cœur qui ſoûpire.	Croyez -en ce cœur qui soupire.
Et qui, tant que le vôtre y voudra repartir.	Et qui, tant que le vôtre y voudra répartir.
Vous dira bien plus d’un ſoûpir Que cent regards ne peuvent dire.	Vous dira bien plus d'un soupir Que cent regards ne peuvent dire.
C’eſt le langage le plus doux, C’eſt le plus foit, c’eſt le plus ſeur de tous,	C'est le langage le plus doux, C'est le plus soit, c'est le plus sûr de tous,
SICHE'.	SICHÉE.
L’intelligence en étoit deuë A nos cœurs, pour les rendre également contens:	L'intelligence en était due A nos cœurs, pour les rendre également contens:
J’ai ſoûpiré, vous m’avez entenduë;	J'ai soupiré, vous m'avez entendue;
Vous ſoûpirez, je vous entens.	Vous soupirez, je vous entends.
Mais ne me laiſſez plus en doute Seigneur, & dites-moin par la meme loute Aprés moi le Zephire ici vous a rendu Pour me dire ce que j’écoute.	Mais ne me laissez plus en doute Seigneur, et dites-moin par la même loute Après moi le Zéphire ici vous a rendu Pour me dire ce que j'écoute.
Quand j’y ſuis arrivée, étiez-vous attendu?	Quand j'y suis arrivée, étiez-vous attendu?
Rt quand vous lui parlerez êtes vous entendu?	Rt quand vous lui parlerez êtes vous entendu?
L’AMOUR.	L'AMOUR.
J’ai dans ce doux climal un ſouverain empire, Comme vous l’avez ſur mon cœur:	J'ai dans ce doux climal un souverain empire, Comme vous l'avez sur mon cœur:
L’Amour m’eſt favorable, & c’eſt en ſa faveur Qu’à mes ordres Æole a ſoûmis le Téphire.	L'Amour m'est favorable, et c'est en sa faveur Qu'à mes ordres Æole a soumis le Téphire.
C’eſt l’Amour qui pout voir mes ſeux récompenſez Lui-même a decté cet Oracle, Par qui vos beaux jours menacez D’une foule d’Amans ſe ſont débaraſſez, Et qui m’a délivré de l’éternel obſtacle De tant de ſoûpirs empreſſez, Qui ne méritoient pas de vous être adreſſez.	C'est l'Amour qui pout voir mes seux récompensez Lui-même a décté cet Oracle, Par qui vos beaux jours menacés D'une foule d'Amand se sont débarassez, Et qui m'a délivré de l'éternel obstacle De tant de soupirs empressez, Qui ne méritaient pas de vous être adressez.
Ne me demandez point quelle eſt cette Province, Ni le nom de ſon Prince, Vous le ſçaurez quand il en ſera tems:	Ne me demandez point quelle est cette Province, Ni le nom de son Prince, Vous le saurez quand il en sera temps:
Je veux vous acquerir, mais c’eſt par mes ſervices, Par des ſoins aſſidus, & par des vœux conſtans, Pâr les amoureux ſacrifices  De tout ce que je ſuis.	Je veux vous acquérir, mais c'est par mes services, Par des soins assidus, et par des vœux constants, Pâtr les amoureux sacrifices De tout ce que je suis.
De tout ce que je puis.	De tout ce que je puis.
Sans que l’éclat du rang pour moi vous ſollicite, Sans que de mon pouvoir je me faſſe un mérite;	Sans que l'éclat du rang pour moi vous sollicite, Sans que de mon pouvoir je me fasse un mérite;
Et bien que Souverain dans cet heureux ſéjour, Je ne vous veux, Pſiché, devoir qu’à mon amour.	Et bien que Souverain dans cet heureux séjour, Je ne vous veux, Psiché, devoir qu'à mon amour.
Venez en admirer avec moi les merveilles, Princeſſe, & préparez vos yeux & vos oreilles A ce qu’il a d’enchantemens.	Venez en admirer avec moi les merveilles, Princesse, et préparés vos yeux et vos oreilles À ce qu'il a d'enchantements.
Vous y verrez des Bois & des Prairies Conteſter ſur leurs agrémens Avec l’Or & les Pierreries;	Vous y verrez des Bois et des Prairies Conter sur leurs agrémens Avec l'Or et les Pierreries;
Vous n’entendrez que des concerts charmans.	Vous n'entendrez que des concerts charmants.
De cent Beautez- vous y ſerez ſervie, Qui vous adoreront ſans vous porter envie.	De cent Beautés- vous y serez servie, Qui vous adoreront sans vous porter envie.
Et brigueront à tous momens D’une ame ſoûmiſe & ravie L’honneur de vos commandemens,	Et brigueront à tous moments D'une âme soumise et ravie L'honneur de vos commandements,
SICHE'.	SICHÉE.
Mes volon ez ſuivent les vôtres, Je n’en ſçaurois plus avoir d’autres;	Mes volon ez suivent les vôtres, Je n'en saurais plus avoir d'autres;
Mais vôtre Oracle enfin vient de me ſépareri De deux Sœurs, & du Roi mon Pere;	Mais votre Oracle enfin vient de me sépareri De deux Sœurs, et du Roi mon Père;
Que mon trépas imaginaire Réduit tous trois à me pleurer.	Que mon trépas imaginaire Réduit tous trois à me pleurer.
Pour diſſiper l’erreur dont leur ame accablée De mortels déplaiſirs ſe voit pour moi comblée, Souffrez que mes Sœurs ſoient témoins Et de ma gloire & de vos ſoins.	Pour dissiper l'erreur dont leur âme accablée De mortels déplaisirs se voit pour moi comblée, Souffrez que mes Sœurs soient témoins Et de ma gloire et de vos soins.
Prétez-leur comme à moi les aiſſes du Zéphire, Qui leur puiſſent de vôtre Empire  Ainn qua mol faeliter lacces , Faites-leur voir en quels lieux je reſpire, Faites-leur de ma perte admirer le ſuccés.	Prêtez-leur comme à moi les aisses du Zéphire, Qui leur puissent de votre Empire Ainn qua mol faeliter lacées , Faites-leur voir en quels lieux je respire, Faites-leur de ma perte admirer le succès.
L’AMOUR.	L'AMOUR.
Vous ne me donnez pas, Pſiché, toute vôtre ame, Ce tendre ſouvenir d’un Pere & de deux Sœurs Me vole une part des douceurs Que je veux toutes pour ma flame.	Vous ne me donnez pas, Psiché, toute votre âme, Ce tendre souvenir d'un Père et de deux Sœurs Me vole une part des douceurs Que je veux toutes pour ma flamme.
vous, N’ayez d’yeux que pour moi, qui n'en ai que pour Ne ſongez qu’à m’aimer, ne ſongez qu’a me plaire;	vous, N'ayez d'yeux que pour moi, qui n'en ai que pour Ne songez qu'à m'aimer, ne songez qu'à me plaire;
Et quand de tels ſoucis oſe vous en diſtraire.	Et quand de tels soucis ose vous en distraire.
SICHE'.	SICHÉE.
Des tendreſſes du ſang peut-on être jaloux?	Des tendresses du sang peut-on être jaloux?
L'AMOUR.	L'AMOUR.
Je le ſuis, ma Pſiché, de toute la Nature.	Je le suis, ma Psiché, de toute la Nature.
Les rayons du Soleil vous baiſent trop ſouvent, Vos cheveux ſouffrent trop les careſſes du Vent;	Les rayons du Soleil vous baisent trop souvent, Vos cheveux souffrent trop les caresses du Vent;
Dés qu’il les flate, j’en murmure:	Dès qu'il les flatte, j'en murmure:
L’air même que vous reſpüez.	L'air même que vous respüez.
Avec trop de plaiſir paſſe par vôtre bouche;	Avec trop de plaisir passe par votre bouche;
vôtre habit de trop prés yous touche	votre habit de trop près yous touche
Et ſi-tôt que vous ſoûpirez, Je ne ſçai quoi qui m’effarouche Craint parmi vos ſoûpirs des ſoûpirs égarez.	Et sitôt que vous soupirez, Je ne sais qui qui m'effarouche Craint parmi vos soupirs des soûpirs égarés.
muit rous voulez vos Sœurs allez, partez Zéphire, Pſiché le veut, je ne l’en puis dédire.	muit rous voulez vos Sœurs allez, partez Zéphire, Psiché le veut, je ne l'en puis dédire.
Le Zephire s’envole.	Le Zéphire s'envole.
Quand vous leur ferez voir ce bienheureux ſejour, De ſes treſors faites leur cent largaſſes, Prodiguez leur careſſes ſur careſſes, Et du ſang, s’il ſe peut, épuiſez les tendreſſes.	Quand vous leur ferez voir ce bienheureux séjour, De ses trésors faites leur cent largasses, Prodiguez leur caresses sur caresses, Et du sang, s'il se peut, épuisez les tendresses.
Pour vous rendre toute à l’Amour.	Pour vous rendre toute à l'Amour.
Je n’y mêlerai point d’importune préſence, Mais ne feur faites pas de miengy entretiens;	Je n'y mêlerai point d'importune présence, Mais ne seur faites pas de miengi entretiens;
Vous ne ſçauriez pour eux avoir de complaiſance, Que vous ne dérobiez aux miens.	Vous ne sauriez pour eux avoir de complaisance, Que vous ne dérobiez aux miens.
ICHE.	ICHÉ.
Vôtre amour me fait une grace Dont je n’abuſerai jamais	Votre amour me fait une grâce Dont je n'abuserai jamais
L’AMOUR.	L'AMOUR.
Allons voir cependant ces Jardins, ce Palais, Où vous ne verrez rien que vôtre éclat n’efface.	Allons voir cependant ces Jardins, ce Palais, Où vous ne verrez rien que votre éclat n'efface.
Et vous petits Amours, & vous jeunes Zépirs, Qui pour ames n’avez que de tendres ſoûpirs, Montrez tous à l’envy ce qu’à voir ma Princeſſe Vous avez ſenty d’allegreſſe.	Et vous petits Amours, et vous jeunes Zépirs, Qui pour âmes n'avez que de tendres soupirs, Montrez tous à l'envi ce qu'à voir ma Princesse Vous avez senti d'allégresse.
TROISIESME INTERMEDE.	TROISIÈME INTERMÈDE.
I ſe fait une Entrée de Ballet de quatre Amours & Iquatre Zéphirs, interrompuë deux fois par un Dialoque enante par un Amour Orun Zéphir.	I se fait une Entrée de Ballet de quatre Amours et Iquatre Zéphirs, interrompue deux fois par un Dialoque enante par un Amour Orun Zéphir.
LE ZEPHIR.	LE ZEPHYR.
Imable Jeuneſſe, A Suivez la tendreſſe, Joignez aux beaux jours La douceur des mes Amours.	Imable Jeunesse, À Suivez la tendresse, Joignez aux beaux jours La douceur des mes Amours.
C’eſt pour vous ſurprendre, on vous fait entendre Qu’il faut éviter leurs ſoûpirs.	C'est pour vous surprendre, on vous fait entendre Qu'il faut éviter leurs soupirs.
Et craindle leurs denrs ;	Et craindle leurs denrs ;
Laiſſez-vous apprendre Quels ſont leurs plaiſirs.	Laissez-vous apprendre Quels sont leurs plaisirs.
Ils chantent enſemble.	Ils chantent ensemble.
«Haeun eit oonge d’aimer 3 A ſon tour Et plus on a dequoi charmer, Plus on doit à l’Amour.	«Haeun eit oonge d'aimer 3 À son tour Et plus on a dequoi charmer, Plus on doit à l'Amour.
LE ZEPHIR ſeulUn cœur jeune & tendre Eſt fait pour ſe rendre, Il n’a point à prendre De fâcheux détour.	LE ZEPHYR seulUn cœur jeune et tendre Est fait pour se rendre, Il n'a point à prendre De fâcheux détour.
Les deux enſemble.	Les deux ensemble.
Chacun eſt obligé d’aimer A ſon tour, Et plus on a dequoi charmer, Plus on doſt à lAmour,	Chacun est obligé d'aimer A son tour, Et plus on a déquoi charmer, Plus on d' à lAmour,
L’AMOUR ſeul.	L'AMOUR seul.
Pourquoi ſe défendre!	Pourquoi se défendre!
ue ſert-il d’attendre!	Que sert-il d'attendre!
Quuna em peru an jaur, On le perd ſans retour.	Quuna em perv an jaur, On le perd sans retour.
Les deux enſemble.	Les deux ensemble.
Chacun eſt obligé d’aimer A ſon tour, Et plus on a dequoi charmer, Plus on doit à l'’Amour	Chacun est obligé d'aimer A son tour, Et plus on a déquoi charmer, Plus on doit à l'Amour
ECOND COUPLET.	ECOND COUPLET.
LE ZEPHIR.	LE ZEPHYR.
L’Amour a des charmes, Rendons lui les at mes, Ses ſoins & ſes pleurs Ne ſont pas ſans douceurs.	L'Amour a des charmes, Rendons lui les at mes, Ses soins et ses pleurs Ne sont pas sans douceurs.
Un cœur pour le ſuïvre A cent maux ſe livre Il faut gouter ſes appas Languir janqqu’au trépas.	Un cœur pour le suire À cent maux se livre Il faut goûter ses appas Languir janqqu'au trépas.
Mais ce neit pas vivle Que de n’aimer pas.	Mais ce neit pas vivle Que de n'aimer pas.
110	110
Ils chantent enſemble.	Ils chantent ensemble.
s’il faut des ſoins & des travaux En aimant, On eſt payé de mille maux Par un heureux moment.	s'il faut des soins et des travaux En aimant, On est payé de mille maux Par un heureux moment.
LE ZEPHIR ſeul.	LE ZEPHYR seul.
On craint, on eſpere, Il faut du miſtere, Mais on obtient guere Du bien ſans tourment.	On craint, on espère, Il faut du mystère, Mais on obtient guère Du bien sans tourment.
Les deux enſemble.	Les deux ensemble.
S’il faut des ſoins & des travaux En aimant, On eſt paye de mille faux Par un heureux moment.	S'il faut des soins et des travaux En aimant, On est paie de mille faux Par un heureux moment.
L’AMOUR ſeul.	L'AMOUR seul.
Que peut-on mieux faire, l alimer, d que plalle .	Que peut-on mieux faire, l alimer, d que plalle .
C’eſt un ſoin charmant, Que l’employ d’un Amant.	C'est un soin charmant, Que l'emploi d'un Amant.
Les deux enſemble.	Les deux ensemble.
s li laut des loins a des tlavaua En aimant, On eſt payé de mille maux Par un heureux moment.	s li laut des loins a des tlava En aimant, On est payé de mille maux Par un heureux moment.
Le Theatre devient un autre Palais magnifique, eoupé dans le fond par un Veſtibule, au travers duquel on voit un jardin ſuperbe & charmant, décoré de pluſieurs Vaſes d’Orangers, & d’Aibres chargez de outes ſortes de Fruits.	Le Théâtre devient un autre Palais magnifique, eoupé dans le fond par un Vestibule, au travers duquel on voit un jardin superbe et charmant, décoré de plusieurs Vases d'Orangers, et d'Aibres chargez de outes sortes de Fruits.
ACTE IV SCENE PREMIERE.	ACTE IV SCÈNE PREMIÈRE.
101 AGLAURE, CIDIPPE.	101 AGLAURE, CIDIPE.
AGLAURE.	AGLAURE.
1 E n’en puis plus, ma Sœur, j’ai veu trop de merveilles, L’avenir aura peine à les bien concevoir;	1 E n'en puis plus, ma Sœur, j'ai vu trop de merveilles, L'avenir aura peine à les bien concevoir;
Le Soleil qui voit tout, & qui nous fait tous voir, N’en a veu jamais de pareilles.	Le Soleil qui voit tout, et qui nous fait tous voir, N'en a vu jamais de pareilles.
Elles me chagrinent l’eſprit;	Elles me chagrinent l'esprit;
Et ce brillant Palais, ce pompeux équipage.	Et ce brillant Palais, ce pompeux équipage.
Font un odieux étalage Qui m’accable de honte autant que de dépit.	Font un odieux étalage Qui m'accable de honte autant que de dépit.
Que la Fortune andignement nous traite, Et que ſa largeſſe indiſcrete Prodigue aveuglement, épuiſe, unit d’efforts, Pour faire de tant de tréſors Le partage d’une Cadette:	Que la Fortune andignement nous traite, Et que sa largesse indiscrète Prodigue aveuglement, épuise, unit d'efforts, Pour faire de tant de trésors Le partage d'une Cadette:
IDIPPE.	JDIPE.
J’entre dans tous vos ſentimens J’ai les mêmes chagrins, & dans ces lieux!	J'entre dans tous vos sentiments J'ai les mêmes chagrins, et dans ces lieux!
charmans Tout ce qui vous déplaiſt me bleſſe;	charmands Tout ce qui vous déplaît me blesse;
Tout ce que vous prenez pour un mortel affront, Comme vous M accavle, ee me laiſſe L’amertume dans l’ame, & la rougeur au front.	Tout ce que vous prenez pour un mortel affront, Comme vous M accavle, ce me laisse L'amertume dans l'âme, et la rougeur au front.
A GLAURE.	À GLAURE.
Non, ma Sœur, il n’eſt point de Reines, Qui dans leur propre Etat parlent en Souveraines, Comme Pſiché parle en ces lieux.	Non, ma Sœur, il n'est point de Reines, Qui dans leur propre Etat parlent en Souveraines, Comme Psiché parle en ces lieux.
On l’y voit obeïe avec exactitude, Et de ſes volontez une amoureuſe étude Les cherche juſques dans ſes yeux.	On l'y voit obéie avec exactitude, Et de ses volontés une amoureuse étude Les cherche jusque dans ses yeux.
Mille beautez s’empreſſent autour d’elle, En ſemblent dire à nos regards jaloux, Quels que ſoient nos attraits, elle eſt encor plus belle, Et nous qui la ſervons, le ſommes plus que vous.	Mille beautés s'empressent autour d'elle, En semblent dire à nos regards jaloux, Quels que soient nos attraits, elle est encor plus belle, Et nous qui la servons, le sommes plus que vous.
Elle prononce, on execute, Aucun ne s’en défend, aucun ne s'en rebute:	Elle prononce, on execute, Aucun ne s'en défend, aucun ne s'en rebute:
Flore qui s’attache à ſes pas, Répand à pleines mais autour de ſa perſonne Ce qu’elle à de plus doux appas, Zephire vole aux ordres qu’elle donne, Et ſon Amante & lui s’en laiſſant trop charmer, Quittent pour la ſervir les ſoins de s’entr’aimer.	Flore qui s'attache à ses pas, Répand à pleines mais autour de sa personne Ce qu'elle à de plus doux appas, Zéphire vole aux ordres qu'elle donne, Et son Amante et lui s'en laissant trop charmer, Quittent pour la servir les soins de s'entre aimer.
CIDIPPE.	CIDIPE.
Elle a des Dieux à ſon ſervice, Elle aura bien-tôt des Autels;	Elle a des Dieux à son service, Elle aura bientôt des Autels;
Et nous ne commandons qu’à de chétifs Mortels, De qui l’audace & le caprice, Contre nous a toute heure en ſecret revoltez, Oppoſent à nos volontez Ou le murmure ou l’artifice.	Et nous ne commandons qu'à de chétifs Mortels, De qui l'audace et le caprice, Contre nous a toute heure en secret révoltez, Opposent à nos volontés Ou le murmure ou l'artifice.
AGLAURE.	AGLAURE.
C’étoit peu que dans nôtre Cour Tant de cœurs à l'envy nous l’euſſent preferée;	C'était peu que dans notre Cour Tant de cœurs à l'envi nous l'eussent préférée;
Ce n’étoit pas aſſez que de nuit & de jour D’une foule d’Amans elle y fut adorée:	Ce n'était pas assez que de nuit et de jour D'une foule d'Amand elle y fut adorée:
Quand nous conſolions de la voir au tombeau Par l’ordre impréveu d’un Oracle, Elle a voulu de ſon deſtin nouveau Faire en nôtre preſence éclater le miracle, Et choiſi nos yeux pour témoins De ce qu’au fond du cœur nous ſouhaitions le moins	Quand nous consolions de la voir au tombeau Par l'ordre imprévu d'un Oracle, Elle a voulu de son destin nouveau Faire en notre présence éclater le miracle, Et choisi nos yeux pour témoins De ce qu'au fond du cœur nous souhaitions le moins
IDIPPE.	JDIPE.
Ce qui le plus me deſeſpere, C’eſt cet Amant parfait & ſi digne de plaire, Qui ſe captive ſous ſes loix.	Ce qui le plus me désespère, C'est cet Amant parfait et si digne de plaire, Qui se captive sous ses lois.
Quand nous nous pourrions choiſir entre tous les Monarques, En eſt il un de tant de Rois Qui porte de ſi nobles marques?	Quand nous nous pourrions choisir entre tous les Monarques, En est il un de tant de Rois Qui porte de si nobles marques?
Se voir du bien par delà ſes ſouhaits, N’eſt ſouvent qu’un bonheur qui fait des miſérables;	Se voir du bien par delà ses souhaits, N'est souvent qu'un bonheur qui fait des misérables;
Il n’eſt ny train pompeux ny ſuperbes Palais, Qui n’ouvrent quelque porte à des maux incurables;	Il n'est assez train pompeux Seigneur superbes Palais, Qui n'ouvrent quelque porte à des maux incurables;
Mais avoir un amant d’un mérite achevé, Et s’en voir cherement aimée, C’eſt un bon-heur ſi haut, ſi relevé, Que ſa grandeur ne peut être exprimée.	Mais avoir un amant d'un mérite achevé, Et s'en voir chèrement aimée, C'est un bonheur si haut, si relevé, Que sa grandeur ne peut être exprimée.
AGLAURE.	AGLAURE.
N’en parlõs plus, ma Sœur, nous en mourrions d’enSongeons plûtôt a la vangeance;	N'en parlons plus, ma Sœur, nous en mourrions d'enSongeons plutôt a la vengeance;
[nuy, Et trouvons le moyen de rompre entre elle & luy Cette adorable intelligence.	[nui, Et trouvons le moyen de rompre entre elle et Seigneur Cette adorable intelligence.
La voicy.	La voici.
J’ay des coups tous prêts à lui porter, Qu'elle aura peine d’éviter.	J'ai des coups tous prêts à lui porter, Qu'elle aura peine d'éviter.
SCENE II.	SCÈNE II.
Biene, AGERURE, CIDIPTE.	Biene, AGERURE, CIDIPTE.
PSICHE'.	PSICHÉE.
E viens vous dire adieu, mon Amant vous renvoye Et ne ſçauroit plus endurer Que vous lui retranchiez un moment de la joye Qu’il prend de ſe voir ſeul à me conſiderer.	E viens vous dire adieu, mon Amant vous renvoie Et ne saurait plus endurer Que vous lui retranchiez un moment de la joie Qu'il prend de se voir seul à me considérer.
Dans un ſimple regard, dans la moindre parole, Son amour trouve des douceurs, Qu’en faveur du ſang je lui vole, Quand je les partage à des Sœurs.	Dans un simple regard, dans la moindre parole, Son amour trouve des douceurs, Qu'en faveur du sang je lui vole, Quand je les partage à des Sœurs.
AGLAURE.	AGLAURE.
La jalouſie eſt aſſez fine, Et ces delicats ſentimens Méritent bien qu’on s’imagine Que celui qui pour vous à ces empreſſemens, Paſſe le commun des Amans.	La jalousie est assez fine, Et ces délicats sentiments Méritent bien qu'on s'imagine Que celui qui pour vous à ces empressements, Passe le commun des Amants.
Je vous en parle ainſi faute de le connoître.	Je vous en parle ainsi faute de le connaître.
Vous ignorez ſon nom, & ceux dont il tient l’être, Nos eſprits en ſont alarmez:	Vous ignorez son nom, et ceux dont il tient l'être, Nos esprits en sont alarmés:
Je le tiens un grand Prince, & d’un pouvoir ſupréme Bien au dela du Diadéme, Ses treſors ſous vos pas confuſément ſemez Ont dequoy faire honte à l’abondance même;	Je le tiens un grand Prince, et d'un pouvoir suprême Bien au déla du Diadème, Ses trésors sous vos pas confusément semés Ont dequoy faire honte à l'abondance même;
Vous l’aimez autant qu’il vous aime, Il vous charme, & vous le charmez;	Vous l'aimez autant qu'il vous aime, Il vous charme, et vous le charmez;
Vôtre felicité, ma Sœur, ſeroit extréme, Si vous ſçaviez qui vous aimez.	Votre félicité, ma Sœur, ferait extrême, Si vous saviez qui vous aimez.
PSICHE'.	PSICHÉE.
Que m’importe?	Que m'importe?
j’en ſuis aimée;	j'en suis aimée;
Plus il me voit, plus je lui plais?	Plus il me voit, plus je lui plais?
Il n’eſt point de plaiſirs dont l’ame ſoit charmée;	Il n'est point de plaisirs dont l'âme soit charmée;
Qui ne préviennent mes ſouhaits, Et je voi mal dequoila votre eſt dlaimnec, Quand tout me ſert dans ce Palais.	Qui ne préviennent mes souhaits, Et je vois mal dequoila votre est dlaimènec, Quand tout me sert dans ce Palais.
AGLAURE.	AGLAURE.
Qu’importe qu’icy tout vous ſerve, Si toûjours cet Amaut vous cache ce qu’il eſt;	Qu'importe qu'ici tout vous serve, Si toujours cet Amaut vous cache ce qu'il est;
Nous ne nous alarmons que pour vôtre interrêt.	Nous ne nous alarmons que pour votre interrêt.
En vain tout vous y rit, en vain tout vous y plait, Le veritable amour ne fait point de reſerve, Et qui s’obſtine à ſe cacher, Sent quelque choſe en ſoy qu’on lui peut reprochet.	En vain tout vous y rit, en vain tout vous y plaît, Le véritable amour ne fait point de réserve, Et qui s'obstine à se cacher, Sent quelque chose en soi qu'on lui peut reprochet.
Si cet Amant devient volage, Car ſouvent en amour le change eſt aſſez doux, Et j’oſe le dire entre nous, Pour grand que ſoit l’éclat dont brille ce viſage, Il en peut être ailleurs d’auſſi belles que vous.	Si cet Amant devient volage, Car souvent en amour le change est assez doux, Et j'ose le dire entre nous, Pour grand que soit l'éclat dont brille ce visage, Il en peut être ailleurs d'aussi belles que vous.
Si, dis-je, un autre objet ſous d’autres loix l’engage, Si dans l’état où je vous voi, Seule en ſes mains, & ſans défenſe Il va juſqu’à la violence, oui qui voas vaagela le non Ou de ce changement, ou de cette inſollence?	Si, dis-je, un autre objet sous d'autres lois l'engage, Si dans l'état où je vous voi, Seule en ses mains, et sans défense Il va jusqu'à la violence, oui qui voas vaagela le non Ou de ce changement, ou de cette insollence?
PSICHE.	PSYCHÉ.
Ma Sœur, vous me faites trembler.	Ma Sœur, vous me faites trembler.
Juſte Ciel!	Juste Ciel!
pourrois je être aſſez infortunée.	pourrais -je être assez infortunée.
CIDIPPE.	CIDIPE.
Que ſçait-on ſi déja les nœuds de l’Hymenée.	Que sait-on si déjà les nœuds de l'Hyménée.
ICHE'.	ICHÉE.
N’achevez pas, ce ſeroit m’accabler.	N'achevez pas, ce serait m'accabler.
AGLAURE.	AGLAURE.
Je n’ay plus qu’un mot à vous dire.	Je n'ai plus qu'un mot à vous dire.
Ce Prince qui vous aime, & qui cõmande aux Vents, Qui nous donne pour Char les aiſles de Zéphire, Et de nouveaux plaiſirs vous comble à tous momens Quand il rompt à vos yeux l’ordre de la Nature, Peut-êrre à tant d’amour meſle un peu d’impoſture, Peut-être ce Palais n’eſt qu’un enchantement, Et ces lambris dorez ces amas de richeſſes Dont il achete vos tendreſſes, 1 fa mhomfanle de ſoumm vos careſſes, Diſparoîtront en un moment.	Ce Prince qui vous aime, et qui commande aux Vents, Qui nous donne pour Char les aisles de Zéphire, Et de nouveaux plaisirs vous comble à tous moments Quand il rompt à vos yeux l'ordre de la Nature, Peut-être à tant d'amour mêle un peu d'imposture, Peut-être ce Palais n'est qu'un enchantement, Et ces lambris dorez ces amas de richesses Dont il achète vos tendresses, 1 fa mhomfanle de soumm vos caresses, Disparaîtront en un moment.
Vous tçavez come nous ce que peuvent les charmes.	Vous tavez compe nous ce que peuvent les charmes.
PSICHE'.	PSICHÉE.
Que je ſens à mon tour de cruelles alarmes!	Que je sens à mon tour de cruelles alarmes!
AGLAURE.	AGLAURE.
Nôtre amitié ne veut que vôtre bien.	Notre amitié ne veut que votre bien.
ICHE'.	ICHÉE.
Adieu, mes Sœurs, finiſſons l’entretien, j’aime, & je crains qu’on ne s’impatiente Partez, & demain ſi je puis Vous me verrez, ou plus contente, Ou dans l’accablement des plus mortels ennuis.	Adieu, mes Sœurs, finissons l'entretien, j'aime, et je crains qu'on ne s'impatiente Partez, et demain si je puis Vous me verrez, ou plus contente, Ou dans l'accablement des plus mortels ennuis.
AGLAURE.	AGLAURE.
Nou, allous dic au Nol quene nouvelle glorre, Quel excés de bonheur le Ciel répand ſur vous.	No, allous dic au Nol quène nouvelle glorre, Quel excès de bonheur le Ciel répand sur vous.
CIDIPPE.	CIDIPE.
Nous allons luy conter d’un changement ſi doux La ſurprenante & merveilleuſe hiſtoire.	Nous allons Seigneur conter d'un changement si doux La surprenante et merveilleuse histoire.
SICHE'.	SICHÉE.
Ne l'inquiétez point, ma Sœur:	Ne l'inquiétez point, ma Sœur:
de vos ſoupçons ;	de vos soupçons ;
Et quand vous lui peindrez un ſi charmant Empire.	Et quand vous lui peindrez un si charmant Empire.
AGLAURE.	AGLAURE.
Nous ſçavons toutes deux ce qu’il faut taire, ou dire, Et n’avons pas beſoin ſur ce point de leçons.	Nous Savons toutes deux ce qu'il faut taire, ou dire, Et n'avons pas besoin sur ce point de leçons.
Le Zéphire enleve les deux Sœurs de Pſiché dans iin nüage qui deſcend juſqu’à terre, & dans lequel il les emporte avec raptaite.	Le Zéphire enlève les deux Sœurs de Psiché dans jin nuage qui descend jusqu'à terre, et dans lequel il les emporte avec rapaite.
SCENE III.	SCÈNE III.
L’AMOUR, PSICHE'	L'AMOUR, PSICHÉE
L'AMOUR.	L'AMOUR.
Nfin vous êtes ſeule;	Nfin vous êtes seule;
& je puis vous redire, L Sans avoir pour témoins vos importunes Sœurs, Ce que des yeux ſi beaux ont pris ſur mot d’empire, Et quel excés ont les douceurs Qu’une ſincere ardeur inſpire Si-tôt qu’elle aſſemble deux cœurs.	et je puis vous redire, L Ans avoir pour témoins vos importunes Sœurs, Ce que des yeux si beaux ont pris sur mot d'empire, Et quel excès ont les douceurs Qu'une sincère ardeur inspire Si-tôt qu'elle assemble deux cœurs.
Je puis vous expliquer de mon ame ravie Les amoureux empreſſemens,  Et vous jurer qu’à vous ſeule aſſervie Elle n’a pour objet de ces raviſſemens, Que de voir cette ardeur de même ardeur ſuivie Ne concevoir plus d’autre envie Que de iegler mes vœux ſur vos deſirs, Et de ce qui vous prart rane tous mes plaiſirs.	Je puis vous expliquer de mon âme ravie Les amoureux empressements, Et vous jurer qu'à vous seule asservie Elle n'a pour objet de ces ravissements, Que de voir cette ardeur de même ardeur suivie Ne concevoir plus d'autre envie Que de iegler mes vœux sur vos désirs, Et de ce qui vous prart rane tous mes plaisirs.
Mais d’où vient qu’un triſte nuage Semble offuſquer l’éclat de ces beaux yeux?	Mais d'où vient qu'un triste nuage Semble offusquer l'éclat de ces beaux yeux?
Vous manque-t-il quelque choſe en ces lieux?	Vous manque-t-il quelque chose en ces lieux?
Des vœux qu’on vous y rend dédaignez vous l’homSTCHE'.	Des vœux qu'on vous y rend dédaignez -vous l'homSTCHÉE.
mage?	mage?
Non, Seigneur.	Non, Seigneur.
lap a Mouo.	lap a Mouo.
L'AMOUR.	L'AMOUR.
Qu'eſt ce donc, & d’où vient mon malheur!	Qu'est ce donc, et d'où vient mon malheur!
J’entens moins de ſoûpirs d’amour que de douleur, Je voi de vôtre teint les roſes amorties Marquer un déplaiſir ſecret;	J'entends moins de soupirs d'amour que de douleur, Je voi de votre teint les roses amorties Marquer un déplaisir secret;
Vos Sœurs à peine ſont parties, Que vous ſoûpirez de regret!	Vos Sœurs à peine sont parties, Que vous soupirez de regret!
Ah, Pſiche, de deux cœurs quãd l’ardeur eſt la même, Ont-ils des ſoûpirs differens;	Ah, Psiche, de deux cœurs quand l'ardeur est la même, Ont-ils des soupirs différents;
Et quand on aime bien, & qu’on voit ce qu’on aime, Peut-on ſonger à des Parens?	Et quand on aime bien, et qu'on voit ce qu'on aime, Peut-on songer à des Parents?
SICHE'.	SICHÉE.
Ce n’eſt point là ce qui m’afflige.	Ce n'est point là ce qui m'afflige.
L AMOOR Eſt-ce l’abſcence d’un Rival, Et d’un Rival aimé qui fait qu’on me neglige?	 AMOOR Est-ce l'abscence d'un Rival, Et d'un Rival aimé qui fait qu'on me néglige?
SICHE'.	SICHÉE.
Dans un cœur tout à vous que vous penetrez mal?	Dans un cœur tout à vous que vous pénétrez mal?
Je vous aime, Seigneur, & mon amour s’irrite De l’indigne ſoupçon que vous avez formé:	Je vous aime, Seigneur, et mon amour s'irrite De l'indigne soupçon que vous avez formé:
Vous ne connoiſſez pas quel eſt vôtre merite, Si vous craignez de n’être pas aimé Je vous aime, & depuis que j’ay veu la lumiere, Je me ſuis montrée aſſez fiere.	Vous ne connaissez pas quel est votre mérite, Si vous craignez de n'être pas aimé Je vous aime, et depuis que j'ai vu la lumière, Je me suis montrée assez fière.
Pour dédaigner les vœux de plus d’un Roy:	Pour dédaigner les vœux de plus d'un Roi:
Et s’il vous faut ouvrir mon ame toute entiere, Je n’ay trouvé que vous qui fut digne de moi.	Et s'il vous faut ouvrir mon âme toute entière, Je n'ai trouvé que vous qui fut digne de moi.
Cependant j’ay quelque triſteſſe Qu’en vain je voudrois vous cacher, Un noir chagrin ſe mêle à toute ma tendreſſe, Dont je ne la puis detacher.	Cependant j'ai quelque tristesse Qu'en vain je voudrais vous cacher, Un noir chagrin se mêle à toute ma tendresse, Dont je ne la puis détacher.
Ne m’en demandez point la cauſe, Peut-être la ſçachant, voudrez-vous m’en punis Et ſi j’oſe aſpirer encor à quelque choſe, Je luis leurc du moins de ne point l’obtenire	Ne m'en demandez point la cause, Peut-être la sçachant, voudrez-vous m'en punis Et si j'ose aspirer encor à quelque chose, Je luis leurc du moins de ne point l'obtenire
L’AMOUR.	L'AMOUR.
Et ne craignez-vous point qu’à mon tour je m’irrite, Que vous connoiſſiez mal quel eſt vôtre merite, Ou feigniez de ne pas ſçavoir Quél eſt ſur moi vôtre abſolu pouvoir ?	Et ne craignez-vous point qu'à mon tour je m'irrite, Que vous connaissiez mal quel est votre mérite, Ou feigniez de ne pas savoir Quel est sur moi votre absolu pouvoir ?
Ah ſi vous en doutez, ioyez derabuſée, Pailez.	Ah si vous en doutez, joyez derabusée, Pailez.
1 4	1 4
I1OIuI.	I1OII.
J’aurai l’affront de me voir refuſée.	J'aurai l'affront de me voir refusée.
L’AMOUR.	L'AMOUR.
Prenez en ma faveur de meilleurs ſentimens, L’experience en eſt aiſée;	Prenez en ma faveur de meilleurs sentiments, L'expérience en est aisée;
Parlez, tout ſe tient prêt à vos commandemens.	Parlez, tout se tient prêt à vos commandements.
Si pour m’en croire il vous faut des ſermens.	Si pour m'en croire il vous faut des serments.
J’en jure vos beaux yeux, ces maîtres de mon ame, Ces divins autheurs de ma flame;	J'en jure vos beaux yeux, ces maîtres de mon âme, Ces divins auteurs de ma flamme;
Et ſi ce n’eſt aſſez d’en jurer vos beaux yeux, J’en jure par le Styx, comme jurent les Dieux.	Et si ce n'est assez d'en jurer vos beaux yeux, J'en jure par le Styx, comme jurent les Dieux.
SICHE'.	SICHÉE.
J’oſe craindre un peu moins apres cette aſſurance.	J'ose craindre un peu moins après cette assurance.
Seigneur, je vois icy la pompe & l’abondance, Je vous adore, & vous m’aimez, Mon cœur enent fary;	Seigneur, je vois ici la pompe et l'abondance, Je vous adore, et vous m'aimez, Mon cœur enent sari;
mes ſens en ſont charmez;	mes sens en sont charmés;
Mais parmy ce bonheur ſupréme j'ay te marneur de neſçavonr qui j’aime.	Mais parmi ce bonheur suprême j'ai te marneur de nesçavonr qui j'aime.
Diſſipez cet aveuglement.	Dissipez cet aveuglement.
Et faites-moi connoiſtre un ſi parfait Amant.	Et faites-moi connaître un si parfait Amant.
L’AMOUR.	L'AMOUR.
Pſiché, que venez-vous de dire	Psiché, que venez-vous de dire
ICHE'.	ICHÉE.
Que c’eſt le bonheur où j’aſpire:	Que c'est le bonheur où j'aspire:
Et ſi vous ne me l’accordez.	Et si vous ne me l'accordez.
L’AMOUR.	L'AMOUR.
Je l’ai juré je n’en ſuis, plus le maîtreMais vous ne ſçavez pas ce que vous demandezLaiſſez moi mon ſecret;	Je l'ai juré je n'en suis, plus le maîtreMais vous ne savez pas ce que vous demandezLaissez moi mon secret;
ſi je me fais connoître, Je voue perdoy uemommm perdez.	si je me fais connaître, Je voue perdais emomm perdez.
Le ſeul remede eſt de vous en dedire.	Le seul remède est de vous en dédire.
{RC IEAIT C’eſt là ſur vous mon ſouverain empire?	ÇRC JÉAIT C'est là sur vous mon souverain empire?
L’AIMOUR.	L'AIMOUR.
Vous pouvez tout, & je ſuis tout à vous;	Vous pouvez tout, et je suis tout à vous;
Mais ſi nos feux vous ſemblent doux.	Mais si nos feux vous semblent doux.
Me mettez point d’obſtacle à leur charmante ſuite a Ice me lorcempomt à la Iuite :	Me mettez point d'obstacle à leur charmante suite a Ice me lorcempompt à la Juite :
C’eſt le moindre malheur qui nous puiſſe arriver.	C'est le moindre malheur qui nous puisse arriver.
D’un ſouhait qui vous a ſeduite.	D'un souhait qui vous a séduite.
PSICHE'.	PSICHÉE.
Seigneur, vous voulez m’éprouver, Mais je ſçay ce que j’en doi croire.	Seigneur, vou lez m'éprouver, Mais je sais ce que j'en dois croire.
De grace, aprenez-moi l’excés de ma gloire .	De grâce, apprenez-moi l'excès de ma gloire .
Et ne me euenez plus pour quer frruitte choix.	Et ne me euenez plus pour quer fruitte choix.
J’ai rejetté les vœux de tant de Rois.	J'ai rejetté les vœux de tant de Rois.
Le voulez-vous?	Le voulez-vous?
L’AMOUR.	L'AMOUR.
PSIC HE', Souffrez que je vous en conjure.	PSIC HÉ, Souffrez que je vous en conjure.
Daal ai do Re.	Da ai do Re.
Si vous ſçaviez, Pſiché, la cruelle avanture Que par la vous vous attirez.	Si vous savez, Psiché, la cruelle aventure Que par la vous vous attirez.
SICHE'.	SICHÉE.
Seigneur, vous me deſeſperez.	Seigneur, vous me désespérez.
L’AMOUR.	L'AMOUR.
Penſez-y bien, je puis encor me taire.	Pensez-y bien, je puis encor me taire.
SICHF'.	SICHF'.
Faites-vous des ſermens pour n’y point ſatisftiret	Faites-vous des serments pour n'y point satisftyret
L'AMOUR.	L'AMOUR.
Hé bien, je ſuis le Dieu le plus puiſſant des Dieux, Abſolu ſur la Terre, abſolu dans les Cieux;	Hé bien, je suis le Dieu le plus puissant des Dieux, Absolu sur la Terre, absolu dans les Cieux;
Dans les eaux, dans les airs mon pouvoir eſt ſuptéme En un mot je fuis l’Amour même, Qui de mes, propres traits m’étoitibleſſé pour vous;	Dans les eaux, dans les airs mon pouvoir est suptéme En un mot je fuis l'Amour même, Qui de mes, propres traits m'étoitiblessé pour vous;
Et ſans la violence, helas!	Et sans la violence, hélas!
que vous me faites, Et qui vient de changer mon amour en couroux, Vous m’alliez avoir pour Epoux.	que vous me faites, Et qui vient de changer mon amour en courroux, Vous m'alliez avoir pour Époux.
Vos volontez ſont ſatisfaites, Vous avez ſçeu qui vous aimiez, Vous connnoiſſiez l’Amant que vous charmiez, Pſiché, voyez où vous en êtes.	Vos volontés sont satisfaites, Vous avez su qui vous aimiez, Vous connaissiez l'Amant que vous charmiez, Psiché, voyez où vous en êtes.
Vous me forcez vous-même à vous quitter, Vous me forcez vous-même à vous ôter Tout l’effet de vôtre victoire:	Vous me forcez vous-même à vous quitter, Vous me forcez vous-même à vous ôter Tout l'effet de votre victoire:
Peut-être vos beaux yeux ne me reverront plus;	Peut-être vos beaux yeux ne me reverront plus;
Ce Palais, ces Jardins avec moi diſparus Vont faire évanoüir vôtre naiſſante gloire;	Ce Palais, ces Jardins avec moi disparus Vont faire évanouir votre naissante gloire;
Vous n’avez pas voulu m’en croire;	Vous n'avez pas voulu m'en croire;
Et pour tout fruit de ce doute éclaircy, Le Deſtin ſous qui le Ciel tremble,	Et pour tout fruit de ce doute éclairci, Le Destin sous qui le Ciel tremble,
L'Amour diſparoit, & dans l'inſtant qu’il s'envole, le ſuperbe fardin s’évanoüit.	L'Amour disparaît, et dans l'instant qu'il s'envole, le superbe fardin s'évanoüit.
Pſiché demeure ſeule au milieu d’une vaſte Campagne, & ſur le bord ſauvaga d’un grand Fleuve où e le ſe veut précipiter.	Psiché demeure seule au milieu d'une vaste Campagne, et sur le bord sauvaga d'un grand Fleuve où e le se veut précipiter.
Le Dieu du Fleuve paroît aſſis ſur un amas de ſoncs & de Ro	Le Dieu du Fleuve paraît assis sur un amas de soncs et de Ro
Plus fort que mon atnour, que tous les Dieux enſemVous va montrer ſa haine, & me chaſſe d’icy.	Plus fort que mon atnour, que tous les Dieux ensemUous va montrer sa haine, et me chasse d'ici.
ble,	blé,
e e dAql 1r	 eût dAql 1r
PSICHE', Ruel Deſtin!	PSICHÉE', Ruel Destin!
funeſte inquiétude!	funeste inquiétude!
C Fatale curioſité!	Ç Fatale curiosité!
Qu’avez-vous fait, affreuſe Solitude, De toute ma felicité;	Qu'avez-vous fait, affreuse Solitude, De toute ma félicité;
J’aimois un Dieu, j’en étois adorée, Mon bonheur redoubloit de moment en moment, 1 Et je me voi ſeule, éplorée, Au milieu d’un Deſert, où pour accablement, Et confuſe, & deſeſperée.	J'aimais un Dieu, j'en étais adorée, Mon bonheur redoublait de moment en moment, 1 Et je me voi seule, éplorée, Au milieu d'un Désert, où pour accablement, Et confuse, et désespérée.
Je ſens croitre l’amour, quand j’ar perdu l’Amant, Le ſouvenir m’en charme & m’empoiſonne, Sa douceur tyrranniſe un cœur infortuné Qu’au plus cuiſans chagrins ma flame a condamné.	Je sens croître l'amour, quand j'ar perdu l'Amant, Le souvenir m'en charme et m'empoisonne, Sa douceur tyrrannise un cœur infortuné Qu'au plus cuisants chagrins ma flamme a condamné.
O Ciel!	Ô Ciel!
quand l’amour m’abandonne, Pourquoy me laiſſe-t-il l’amour qu’il m’a donné?	quand l'amour m'abandonne, Pourquoi me laisse-t-il l'amour qu'il m'a donné?
Source de tous les biens inépuiſab e & pure, Maîtte des Hommes & des Dieux, Cher Autheur des maux que j’endure, Etes-vous pour jamais diſparu de mes yeux?	Source de tous les biens inépuisab eût et pure, Maîtte des Hommes et des Dieux, Cher Auteur des maux que j'endure, Ées-vous pour jamais disparu de mes yeux?
Je vous en ai banni moi même;	Je vous en ai banni moi -même;
Dans un exces d’amour, dans un bonheur extréme, Cœur ingrat, tu n’avois qu’un feu mal allumé, Et l’on ne peut vouloir du moment que l’on aime, Que ce que veut l’Objet aimé.	Dans un excès d'amour, dans un bonheur extrême, Cœur ingrat, tu n'avais qu'un feu mal allumé, Et l'on ne peut vouloir du moment que l'on aime, Que ce que veut l'Objet aimé.
Mourons, c’eſt le party qui ſeul me reſte à ſuivre, Apres la perte que je fais.	Mourons, c'est le parti qui seul me reste à suivre, Après la perte que je fais.
Pour qui, grands Dieux, voudrois je vivre, Et pour qui former des ſouhaits?	Pour qui, grands Dieux, voudrais je vivre, Et pour qui former des souhaits?
Fleuve, de qui les eaux baignent ces triſtes fables, Enſevely mon crime dans tes flots, Et pour finir des maux ſi deplorables;	Fleuve, de qui les eaux baignent ces tristes fables, Ensevely mon crime dans tes flots, Et pour finir des maux si déplorables;
Laiſſe-moi dans ton lit aſſurer mon repos.	Laisse-moi dans ton lit assurer mon repos.
LE DIEU DU FLEUVE.	LE DIE DU FLEUVE.
Ton trépas ſoûilleroit mes ondes, Pſiché.	Ton trépas souillerait mes ondes, Psiché.
le Ciel te le défend, Et peut-être qu’apres des douleurs ſi profondes Un autre ſort t'attend.	le Ciel te le défend, Et peut-être qu'après des douleurs si profondes Un autre sort t'attend.
Fui plûtôt de Venus l’implacable colere;	Fui plutôt de Venus l'implacable colère;
de la voy qui de encienc a qui te veut pun, L’amour du Fils a fait la ha ne de la Mere, Fuy, je ſçauray la retenir.	de la vois qui de encienc à qui te veut pun, L'amour du Fils a fait la ha ne de la Mère, Fui, je saurai la retenir.
ICHE' J’attens ſes Fureurs vangereſſes, Qu'auront-elles pour moi qui ne me ſoit trop doux?	ICHE J'attends ses Fureurs vengeresses, Qu'auront-elles pour moi qui ne me soit trop doux?
Qui cherche le trépas, ne craint Dieux, ny Déeſſes, Et peut braver tout leur couroux.	Qui cherche le trépas, ne craint Dieux, ni Déesses, Et peut braver tout leur courroux.
SCLNE II.	SCLNE II.
VENUS, PSICHE'.	VENUS, PSICHÉE'.
*ENUS.	*ENUS.
Rgueilleuſe Pſiché, vous m’oſez donc attendre, O Apres m’avoir ſur Terre enlevé mes honneurs, A pres que vos traits ſuborneurs Ont reçû les ençẽns qu’aux miens ſeuls on doit rendre J’ay veu mes Temples deſertez, j'ai veu tous les Mortels ſéduits par vos beautez Idolâtrer en vous la beauté ſouveraine, Vous offiir des reſpects juſqu’àlors inconnus, Et ne ſe mettre pas en peine s’il étoit une autre Vénus:	Reilleuse Psiché, vous m'osez donc attendre, Ô Pres m'avoir sur Terre enlevé mes honneurs, A pres que vos traits suborneurs Ont reçu les ençẽns qu'aux miens seuls on doit rendre J'ai vu mes Temples désertés, j'ai vu tous les Mortels séduits par vos beautés Idolâtrer en vous la beauté souveraine, Vous offir des respects jusqu'àlors inconnus, Et ne se mettre pas en peine s'il était une autre Vénus:
Et je vous vois encor l’audace De n’en pas redouter les juſtes châtimens, Et de me regarder en face, Comme ſi c’étoit peu que mes reſſentimens.	Et je vous vois encor l'audace De n'en pas redouter les justes châtiments, Et de me regarder en face, Comme si c'était peu que mes ressentiments.
SICHE'.	SICHÉE.
Si de quelques Mortels on m’a veuë adorée, Eſt-ce un crime pour moy d’avoir eu des appas, Dont leur ame inconſiderée Laiſſoit charmer des yeux qui ne vous voyoient pas!	Si de quelques Mortels on m'a vue adorée, Est-ce un crime pour moi d'avoir eu des appas, Dont leur âme inconsidérée Laissait charmer des yeux qui ne vous voyaient pas!
Je ſuis ce que le ciel m’a faite, Je n’ay que les beautez qu’il m’a voulu prêter:	Je suis ce que le ciel m'a faite, Je n'ai que les beautés qu'il m'a voulu prêter:
Si les vœux qu’on m’offroit vous ont mal fatisfaite, Pour forcer tous les cœurs à vous les reporter, vous naviez qu'a vous picienter, Qu’a ne leur cacher plus cette beauté parfaite, Qui pour les rendre à leur devoir, Pour ſe faire adorer, n’a qu’à ſe faire voir.	Si les vœux qu'on m'offrait vous ont mal satisfaite, Pour forcer tous les cœurs à vous les reporter, vous naviez qu'a vous picienter, Qu'a ne leur cacher plus cette beauté parfaite, Qui pour les rendre à leur devoir, Pour se faire adorer, n'a qu'à se faire voir.
TENUS.	TENUS.
Il falloit vous en mieux défendre, Ces reſpects, ces encens ſe devoient refuſer, Et pour les mieux deſabuſer, Il falloit à leurs yeux vous-même me les rendre.	Il fallait vous en mieux défendre, Ces respects, ces encens se devaient refuser, Et pour les mieux désabuser, Il fallait à leurs yeux vous-même me les rendre.
Vous avez aimé cette erreur Pour qui vous ne deviez avoir que de l’horreur;	Vous avez aimé cette erreur Pour qui vous ne deviez avoir que de l'horreur;
Vous avez bien fait plus, vôtre humeur arrogante Sur le mépris de mille Rois Juſques aux Cieux a porté de ſon choix L’ambition extravagante.	Vous avez bien fait plus, votre humeur arrogante Sur le mépris de mille Rois Jusques aux Cieux a porté de son choix L'ambition extravagante.
ICHE'.	ICHÉE.
J’aurois porté mon choix Deeſſe, juiqueaux Cieux?	J'aurais porté mon choix Déesse, juiqueaux Cieux?
ENUS.	ENUS.
Vôtre innocence eſt ſans ſeconde;	Votre innocence est sans seconde;
Deuuigner tous les Rois du Monde;	Deuuigner tous les Rois du Monde;
N’eſt-ce pas aſpirer aux Dieux?	N'est-ce pas aspirer aux Dieux?
SICHE'.	SICHÉE.
Si l’amour pour eux tous m’avoit endurcy l’ame, Et me reſervoit toute à lui, En puis-je être coupable, & faut-il qu’aujourd’hui Pour prix d’une ſi belle flame, Vous vouliez m’accabler d’un éternel ennuy?	Si l'amour pour eux tous m'avait endurci l'âme, Et me réservait toute à lui, En puis-je être coupable, et faut-il qu'aujourd'hui Pour prix d'une si belle flamme, Vous vouliez m'accabler d'un éternel ennui?
E la d os Pſiché, vous deviez mieux connoître Qui vous étiez, & quel étoit ce Dieu.	E la d os Psiché, vous deviez mieux connaître Qui vous étiez, et quel était ce Dieu.
ICHE.	ICHÉ.
Et m'en a-t-il donné ny le temps, ni le lieu, nurqui de tout mõ cœur d’abord s’eſt rendu maîtres	Et m'en a-t-il donné ainsi le temps, ni le lieu, nurqui de tout mon cœur d'abord s'est rendu maîtres
ENUS.	ENUS.
Tout vôtre cœur s’en eſt laiſſé charmer Et vous l’avez aimé dés qu’il vous a dit, j’aime.	Tout votre cœur s'en est laissé charmer Et vous l'avez aimé dès qu'il vous a dit, j'aime.
ICHE'.	ICHÉE.
Pouvois-je n’aimer pas le Dieu qui fait aimer, Et qui me parioit pour luy-même?	Pouvais-je n'aimer pas le Dieu qui fait aimer, Et qui me pariait pour venir-même?
C’eſt vôtre Fils, vous ſçavez ſon pouvoir, Vous en connoiſſez le mérite.	C'est votre Fils, vous savez son pouvoir, Vous en connaissez le mérite.
ENUS.	ENUS.
Oüi, c’eſt mon Fils, mais un Fils qui m’irrite, Un Fils qui me rend mal ce qu’il ſçai me devoir, Un Fils qui fait qu’on m’abandonne, Et qui pour mieux flater ſes indignes amours, Depuis que vous l’aimez, ne bleſſe plus perſonne Qui vienne à mes Autels implorer mon ſecours.	Oui, c'est mon Fils, mais un Fils qui m'irrite, Un Fils qui me rend mal ce qu'il sais me devoir, Un Fils qui fait qu'on m'abandonne, Et qui pour mieux flatter ses indignes amours, Depuis que vous l'aimez, ne blesse plus personne Qui vienne à mes Autels implorer mon secours.
Vous m’en avez fait un rebelle, On m’en verra vangée, & hautement ſur vous Et je vous apprendrai s’il faut qu’une Mortelle Souffre qu’un Dieu ſoûpire à ſes genoux.	Vous m'en avez fait un rebelle, On m'en verra vengée, et hautement sur vous Et je vous apprendrai s'il faut qu'une Mortelle Souffre qu'un Dieu soupire à ses genoux.
Suivez-moi, vous verrez par vôtre experience A quelle folle confiance Vous portoit cette ambition;	Suivez-moi, vous verrez par votre expérience À quelle folle confiance Vous portait cette ambition;
yenez, & préparez autant de patience, Qu’on vous voit de préſomption.	yenez, et préparez autant de patience, Qu'on vous voit de présomption.
QUATRIESME INTERMEDE	QUATRIÈME INTERMÈDE
A Scene repreſente les Enfers.	À Scène représente les Enfers.
On y voit une Mer Etoute de fea, dont les flots ſont dans une perpetuelle agitation.	On y voit une Mer Étoute de fea, dont les flots sont dans une perpétuelle agitation.
Cette Mer effroyable eſt bornée par des Ruines enflammées;	Cette Mer effroyable est bornée par des Ruines enflammées;
& au milieu de ſes flots agitez, du travers d’une Gueelle affreuſe, paroit le Palais Infernal de Pluton Huit Furies en ſortent, & forment une Entrée de Ballet, où elles ſe réjoüißsent de Ia roge qu'elle ont allumée dans l’ame de la plus douca des Divinitez.	et au milieu de ses flots agités, du travers d'une Guelle affreuse, parait le Palais Infernal de Pluton Huit Furies en sortent, et forment une Entrée de Ballet, où elles se réjoüisssent de Ia roge qu'elle ont allumée dans l'âme de la plus douca des Divinités.
Un Latin mêle quantité de ſauts perilleux à leurs Dances, cependant que Pſiché qui a paſſe aux Enfers par le commandement de Vénus, repaſſe dans la Barques de emon, avec la Boëte qu’elle a repeuë de Proſerpine pour cette Déeſſe.	Un Latin mêle quantité de sauts périlleux à leurs Dances, cependant que Psiché qui a passe aux Enfers par le commandement de Venus, repasse dans la Barques de émon, avec la Boète qu'elle a repue de Proserpine pour cette Déesse.
ROTL SCENE PREMIERES	ROTL SCÈNE PREMIERES
PSICHE'.	PSICHÉE.
FFROYABLES replis des ondes inferna rles, Noirs Palais où Megére & ſes Sœur font leur Cour, 1 Eternels ennemis du Jour, Parmi vos Ixions, & parmi vos Tantales, Parmi tant de tourmens qui n’ont point d’intervales, Eſt-il dans vôtre affreux ſéjour Quelques peines qui ſoient égales Aux travaux où Vénus condamne mon amour?	FROYABLES replis des ondes inferna règles, Noirs Palais où Megére et ses Sœur font leur Cour, 1 Éternels ennemis du Jour, Parmi vos Ixions, et parmi vos Tantales, Parmi tant de tourments qui n'ont point d'intervales, Est-il dans votre affreux séjour Quelques peines qui soient égales Aux travaux où Vénus condamne mon amour?
Elle n’en peut être aſſouvie;	Elle n'en peut être assouvie;
Et depuis qu’à ſes loix je me trouve aſſervie, Depuis qu’elle me livre à ſes reſſentimens, Il m’a fallu dans ces cruels momens Plus d’une ame, & plus d’une vie, Pour remplir ſes commandemens.	Et depuis qu'à ses lois je me trouve asservie, Depuis qu'elle me livre à ses ressentiments, Il m'a fallu dans ces cruels momens Plus d'une âme, et plus d'une vie, Pour remplir ses commandements.
Je ſouff rirois tout avec joye, Si parmi les rigueurs que ſa haine déploye,	Je sous rirais tout avec joie, Si parmi les rigueurs que sa haine déploie,
STCHE, Mes yeux pouvoient revoir, ne fût-ce qu’un moment, Ce cher, cet adorable Amant:	STCHE, Mes yeux pouvaient revoir, ne fût-ce qu'un moment, Ce cher, cet adorable Amant:
Je n’oſe le nommer 3 ma bouche criminelle D’avoir trop exigé de lui, S’en eſt renduë indigne, & dans ce dur ennui La ſouffrance la plus mortelle 2 Dont m’accable à toute heute un renaiſſant trépas, Eſt celle de ne le voir pas.	Je n'ose le nommer 3 ma bouche criminelle D'avoir trop exigé de lui, S'en est rendue indigne, et dans ce dur ennui La souffrance la plus mortelle 2 Dont m'accable à toute heute un renaissant trépas, Est celle de ne le voir pas.
Si ſon couroux duroit encore, Jamais aucun malheur n’aprocheroit du mien:	Si son courroux durait encore, Jamais aucun malheur n'approcherait du mien:
Mais s’il avoit pitié d’une ame qui l’adore, Quoi qu’il fallut ſouffrir, je ne ſouffrirois rien.	Mais s'il avait pitié d'une âme qui l'adore, Quoi qu'il fallut souffrir, je ne souffrirais rien.
Oüy, Deſtius, s’il calmoit cette juſte colere, Tous mes malheurs ſeroient finis:	Oui, Détius, s'il calmait cette juste colère, Tous mes malheurs seraient finis:
Pour me rendre inſenſible aux fureurs de la Mere, Il ne faut qu’un regard d’un Fils.	Pour me rendre insensible aux fureurs de la Mère, Il ne faut qu'un regard d'un Fils.
Je n’en veux plus douter, il partage ma peine, Il voit ce que je ſouffre, & ſouffre comme moi, Tout ce que j’en dure le geſne.	Je n'en veux plus douter, il partage ma peine, Il voit ce que je souffre, et souffre comme moi, Tout ce que j'en dure le gêne.
Lui même il s’en impoſe une amoureuſe loiEn dépit de Vénus;	Lui même il s'en impose une amoureuse loisEn dépit de Venus;
en dépit de mon ctime, C’eſt lui qui me ſoûtient, c’eſt lui qui me ranime, Au milieu des périls où l’on me fait courir:	en dépit de mon ctime, C'est lui qui me soutient, c'est lui qui me ranime, Au milieu des périls où l'on me fait courir:
Il garde la tendreſſe où ſon feu le convie:	Il garde la tendresse où son feu le convie:
ni prend ſoin de me rendre une nouvelle vie, Chaque fois qu’il me faut mourir.	ni prend soin de me rendre une nouvelle vie, Chaque fois qu'il me faut mourir.
Mais que me veulent ces deux Ombres Qu'à travers le faux jour de ces Demeures ſombres J’entrevoi s’avancer vers moi?	Mais que me veulent ces deux Ombres Qu'à travers le faux jour de ces Demeures sombres J'entrevoi s'avancer vers moi?
SCENE II.	SCÈNE II.
14 AbICHN, CEBOMENE, AGINOR,	14 AbICHN, CEBOMENE, AGINOR,
SICHE’.	SICHÉE.
10F1 2 Leomene, Agenor, eſt-ce vous que je voy 4 C Qui vous a ravy la lumiere ?	10F1 2 Lomène, Agénor, est-ce vous que je vois 4 Ç Qui vous a ravi la lumière ?
CLEOMENE.	CLÉOMENE.
La plus juſte douleur, qui d’un beau deſeſpoir Nous eut pû fournir la matiere, Cette pompe funebre, où du ſort le plus noir Vous attendiez la rigueur la plus fiere, L’injuſtice la plus entiere.	La plus juste douleur, qui d'un beau désespoir Nous eut pu fournir la matière, Cette pompe funèbre, où du sort le plus noir Vous attendiez la rigueur la plus fière, L'injustice la plus entière.
AGENOR.	AGENOR.
Sur ce même Rocher, où le Ciel en couroux Vous promettoit au lieu d’Epoux Un Serpent dont ſoudain vous ſeriez devorée, Nous tenions la main prepatée A repouſſer ſa rage, ou mourir avec vous.	Sur ce même Rocher, où le Ciel en courroux Vous promettait au lieu d'Époux Un Serpent dont soudain vous seriez dévorée, Nous tenions la main prepatée A repousser sa rage, ou mourir avec vous.
Vous le ſçavez, Princeſſe, & lors qu’à nôtre veue Par le milieu des airs vous êtes diſparuë, Du naut de ce Rocler pour fuivle vos prautez, Ou plûtôt pour gouſter cette amoureuſe joye D’offrir pour vous au Monſtre une premiere proye, D’amour & de douleur l'un & l’autre emportez, Nous nous ſommes précipitez.	Vous le savez, Princesse, et lors qu'à notre vue Par le milieu des airs vous êtes disparue, Du naut de ce Rocler pour fuivle vos prautés, Ou plutôt pour goûter cette amoureuse joie D'offrir pour vous au Monstre une première proie, D'amour et de douleur l'un et l'autre emportez, Nous nous sommes précipitez.
CLEOMENE.	CLÉOMENE.
Heureuſement déçeus au ſens de vôrre Oracle, Nous en avons ict reconnu le miracle, D3 Et ſçeu que le Serpent prêt à vous devorer Etoit le Dieu qui fait qu’on aime, Et qui tout D eu qu’il eſt, vous adorant lui même;	Heureusement déçus au sens de vôrre Oracle, Nous en avons ici reconnu le miracle, D3 Et su que le Serpent prêt à vous dévorer Etoit le Dieu qui fait qu'on aime, Et qui tout eu qu'il est, vous adorant lui -même;
Ne pouvoit endurer Qu’un mortel comme nous oſât vous adorer.	Ne pouvait endurer Qu'un mortel comme nous osât vous adorer.
AGENOR.	AGENOR.
Pour prix de vous avoir ſuivie, Nous joüiſſons ici d’un trépas aſſez doux:	Pour prix de vous avoir suivie, Nous jouissons ici d'un trépas assez doux:
Qu’avions-nous affaire de vie, Si nous ne pouvions être à vous?	Qu'avions-nous affaire de vie, Si nous ne pouvions être à vous?
Nous revoyons ici vos charmes, &u aueun des deux la haut l'auroit reveus jamais.	Nous revoyons ici vos charmes, etu aveun des deux la haut l'aurait revus jamais.
Heureux ſi nous voyons la moindre de vos larmes Honorer des malheurs que vous nous avez faits.	Heureux si nous voyons la moindre de vos larmes Honorer des malheurs que vous nous avez faits.
CHE'.	CHÉE.
Puis-je avoir des larmes de reſte Aprés qu’on a porté les miens au dernier point?	Puis-je avoir des larmes de reste Après qu'on a porté les miens au dernier point?
Uniſſons nos ſoûpirs d'ans un ſort ſi funeſte, Les ſoupirs ne s’épuiſent point.	Unissons nos soupirs d'ans un sort si funeste, Les soupirs ne s'épuisent point.
Miais vous ioup reriez, Prinees, pourune Ingrate, Vous n’avez point voulu ſurvivre à mes malheurs, Et quelque douleur qui m’abate, Ce n’eſt point poar vous que je meurs,	Miais -vous joup reriez, Prinées, pourune Ingrate, Vous n'avez point voulu survivre à mes malheurs, Et quelque douleur qui m'abate, Ce n'est point poar vous que je meurs,
CLEOMENE.	CLÉOMENE.
L’avons nous merité, nous dont tout la flâme N’a fait que vous laſſer du recit ne nos maux?	L'avons nous mérité, nous dont tout la flamme N'a fait que vous lasser du récit ne nos maux?
SICHE'.	SICHÉE.
Vous pouviez meriter.	Vous pouviez mériter.
Princes, toute mon ame, Si vous n’euſſiez été Rivaux, Ces qualitez incomparables Qui de l’un & de l’autre accompagnoient les vœux, Vous reudoient tous deux trop aimables, Pour mépriſer aucun des deux.	Princes, toute mon âme, Si vous n'eussiez été Rivaux, Ces qualités incomparables Qui de l'un et de l'autre accompagnaient les vœux, Vous reudaient tous deux trop aimables, Pour mépriser aucun des deux.
AGENOR.	AGENOR.
Vous avez pû ſans être injuſte), ni cruel̂le, Nous refuſer un cœur reſervé pour un Dieu.	Vous avez pu sans être injuste), ni cruelole, Nous refuser un cœur réservé pour un Dieu.
muis fenroyen renus:	muis fenroyen renus:
Le Deſtin nous rappelle, Et nous force a vous dire Adieu.	Le Destin nous rappelle, Et nous force a vous dire Adieu.
IDIPPE.	JDIPE.
Ne vous donne- t-il point le loint de me dire Quel eſt ici vôtre ſéjour;	Ne vous donne- t-il point le loint de me dire Quel est ici votre séjour;
CLEOM ENE.	CLÉOM ENE.
Dans des Bois toûjours verds, où d’amour on reſpice, Auſſi tôt qu’on eſt mort d’amour.	Dans des Bois toujours verds, où d'amour on respice, Aussi tôt qu'on est mort d'amour.
D'amour on y revit, d’amour on y ſoûpire, Sous les plus douces loix de ſon heureux Empire?	D'amour on y revit, d'amour on y soupire, Sous les plus douces lois de son heureux Empire?
Et l’éternelle nuit n’oſe en chaſſer le jour, Que lui meme il attire Sur nos fantômes qu’il inſpire, Et dont aux Enfers même il ſe fait une Cour.	Et l'éternelle nuit n'ose en chasser le jour, Que lui -même il attire Sur nos fantômes qu'il inspire, Et dont aux Enfers même il se fait une Cour.
AGENOR.	AGENOR.
Vos envieuſes Sœurs aprés nous deſcenduës, Pour vous perdre ſe ſont perduës, Et l’une & l’autre tour à tour, Pour le prix d’un conſeil qui leur couſte la vie, A côté d’Ixion, à côte de Tytye, Souffre tantôt la rouë, & tantôt le Vautour.	Vos envieuses Sœurs après nous descendues, Pour vous perdre se sont perdues, Et l'une et l'autre tour à tour, Pour le prix d'un conseil qui leur coûte la vie, À côté d’ Ixion, à côte de Tytye, Souffre tantôt la roue, et tantôt le Vautour.
L’Amour par les Zéphirs s’eſt fait prompte juſtice De leur envenimée & jalouſe malice :	L'Amour par les Zéphirs s'est fait prompte justice De leur envenimée et jalouse malice :
Ces Miniſtres aiflez de ſon juſte couroux, Sous couleur de les rendre encor auprés de vous, Ont plongé l’une & l’autre au fond d’un précipice, Où le ſpectacle affreux de leurs corps déchirez, N’étale que le moindre, & le premier ſuplice De ces conſeils dont l’artifice Fait les maux dont vous ſoûpirez.	Ces Ministres aiflez de son juste courroux, Sous couleur de les rendre encor auprès de vous, Ont plongé l'une et l'autre au fond d'un précipice, Où le spectacle affreux de leurs corps déchirez, N'étale que le moindre, et le premier suplice De ces conseils dont l'artifice Fait les maux dont vous soupirez.
Que je les plains :	Que je les plains :
PSICHE'.	PSICHÉE.
CLEOMENE.	CLÉOMENE.
Vous êtes ſeule à plaindre.	Vous êtes seule à plaindre.
Mais nous demeurons trop à vous entretenir, Adieu, puiſſions nous vivre en vôtre ſouvenir, Puiſſiez-vous, & bientôt, n’avoir plus rien à craindre, Puiſſe, & bientôt, l’Amour vous enlever aux Cieux, Vous y mettre à côté des Dieux, Arillanenl a jamlals i'cerat de vos deuul jeux muagmenter le jour en ces lieux.	Mais nous demeurons trop à vous entretenir, Adieu, puissions nous vivre en votre souvenir, Puissiez-vous, et bientôt, n'avoir plus rien à craindre, Puisse, et bientôt, l'Amour vous enlever aux Cieux, Vous y mettre à cuisse des Dieux, Arillanenl à jamlals j'cérat de vos deuul ju agmenter le jour en ces lieux.
SCENE III.	SCÈNE III.
PSICHE'.	PSICHÉE.
Auvres Amans !	Auvres Amants !
leur amour dure encore, I Tous morts qu’ils ſont l’un & l’autre m’odere Moi dont la dureté reçeut ſi mal leurs vœux:	leur amour dure encore, I Tous morts qu'ils sont l'un et l'autre m'ode Moi dont la dureté reçut si mal leurs vœux:
Tu n’en fais pas ainſi, toi qui ſeul m’as ravie, Amant, que j’aime encor cent fois plus que ma vie, Et qui briſes de ſi beaux nœuds.	Tu n'en fais pas ainsi, toi qui seul m'as ravie, Amant, que j'aime encor cent fois plus que ma vie, Et qui brises de si beaux nœuds.
Ne me fui plus, & ſouffre que j’eſpere Que tu pourras un jour rabaiſſer l’œil ſur moi;	Ne me fui plus, et souffre que j'espère Que tu pourras un jour rabaisser l'œil sur moi;
Qu’à force de ſouffrir j’aurai dequoi te plaire, Dequoi me rengager ta foy.	Qu'à force de souffrir j'aurai dequoi te plaire, Dequoi me rengager ta foi.
Mais ce que j’ai ſouffert m’a trop défigure.	Mais ce que j'ai souffert m'a trop défigure.
Pour rappeller un tel eſpoir:	Pour rappeler un tel espoir:
L’œil abbatu, triſte, deſeſperée, Languiſſante & décolorée, Dequoi puis-je me prévaloir;	L'œil abattu, triste, désespérée, Languissante et décolorée, Dequoi puis-je me prévaloir;
Si par quelque miracle impoſſible à prévoir, Ma beauté qui t’a plû ne ſe voit reparéex Je porte icy dequoi la reparer, Ce treſor de beauté divine, Qu’en mes mains pour Vénus a remis Proſerpine, Enferme des appas dont je puis m’emparer, Et l’éclat en doit être extréme, Puis que Venus la beauté même Les demande pour ſe parer:	Si par quelque miracle impossible à prévoir, Ma eauté qui t'a plu ne se voit reparéex Je porte ici dequoi la réparer, Ce trésor de beauté divine, Qu'en mes mains pour Venus a remis Proserpine, Enferme des appas dont je puis m'emparer, Et l'éclat en doit être extrême, Puis que Venus la beauté même Les demande pour se parer:
En dérober un peu ſeroit-ce un ſi grand crime ?	En dérober un peu serait-ce un si grand crime ?
Pour plaire aux yeux d’un pieu qui s’eſt faitmõ Amãt Pour regagner ſon cœur, & finir mon tourment, Tout n’eſt il pas trop legitime?	Pour plaire aux yeux d'un pieu qui s'est faitmõ Amant Pour regagner son cœur, et finir mon tourment, Tout n'est il pas trop légitime?
Ouvrons.	Ouvrons.
Quelles vapeurs m’offuſquent le ce rveau, Et que vois-je ſortir de cette Boëte ouverte?	Quelles vapeurs m'offusquent le ce rueau, Et que vois-je sortir de cette Boète ouverte?
Amour, ſi ta pitié ne s’oppoſe à ma perte, Pour ne revivre plus, je deſcens au tombeau.	Amour, si ta pitié ne s'oppose à ma perte, Pour ne revivre plus, je descends au tombeau.
Elle s’évanoüit, & l'Amour deſcend aupres d’elle en volant.	Elle s'évanoüit, et l'Amour descend auprès d'elle en volant.
SCENE TV L’AMOUR, PSICHE' évanoüie.	SCÈNE TU L'AMOUR, PSYCHE évanouie.
L'AMOUR.	L'AMOUR.
7 Otre peril, Pſiché, diſſipe ma colere, V Ou plûtôt de mes feux l’ardeur n’a point ceſſé, Et bien qu’au dernier point vous m’ayez ſçeudéplaire Je ne me ſuis intereſſé Que contre celle de ma Mere.	7 Otre péril, Psiché, dissipe ma colère, V Ou plutôt de mes feux l'ardeur n'a point cessé, Et bien qu'au dernier point vous m'ayez sçeudéplaire Je ne me suis intéressé Que contre celle de ma Mère.
J’ai veu tous vos travaux;	J'ai vu tous vos travaux;
j’ai ſuivy vos malheurs, Mos ſoûpirs ont par tout accompagné vos pleurs;	j'ai suivi vos malheurs, Mos soupirs ont par tout accompagné vos pleurs;
Tournez les yeux vers moi, je ſuis encor le même?	Tournez les yeux vers moi, je suis encor le même?
L 3	 3
Quoi!	Quoi!
je dis & redis tout haut que je vous aime, Et vous ne dites point, Pſiché, que vous m’aimez!	je dis et redis tout haut que je vous aime, Et vous ne dites point, Psiché, que vous m'aimez!
Eſt ce que pour jamais vos beaux yeux ſont fermez?	Est -ce que pour jamais vos beaux yeux sont fermés?
Qu’à jamais la clarté leur vient d’êtte ravie?	Qu'à jamais la clarté leur vient d'être ravie?
O mort, devois-tu prendre un dard ſi criminel, Et ſans aucun reſpect pour mon Eſtre éternel Attenter à ma propre vie?	Ô mort, devais-tu prendre un dard si criminel, Et sans aucun respect pour mon Être éternel Attenter à ma propre vie?
Combien de fois, ingrate Deïté, Ai-je groſſy ton noir Empire, Par les mépris & par la cruauté D’une orgueilleuſe ou farouche Beauté?	Combien de fois, ingrate Deïté, Ai-je grossi ton noir Empire, Par les mépris et par la cruauté D'une orgueilleuse ou farouche Beauté?
Combien même, s’il le faut dire, T'ai-je immolé de fidelle Amans A force de raviſſemens?	Combien même, s'il le faut dire, T'ai-je immolé de fidèle Amants À force de ravissements?
Va, je ne bleſſerai plus d’ames, Je ne percerai plus de cœurs, Qu’avec des dards trempez aux divines liqueurs Qui nourriſſent du Ciel les immortelles flâmes, Et n’en lancerai plus que pour faire à tes yeux Autant d’Amans, autant de Dieux.	Va, je ne blesserai plus d'ames, Je ne percerai plus de cœurs, Qu'avec des dards trempez aux divines liqueurs Qui nourrissent du Ciel les immortelles flammes, Et n'en lancerai plus que pour faire à tes yeux Autant d'Amands, autant de Dieux.
Et vous, impitoyable Mere, Qui la forcez à m’arracher Tout ce que j’avois de plus cher, Craignez à vôtre tour l’effet de ma colere.	Et vous, impitoyable Mère, Qui la forcez à m'arracher Tout ce que j'avais de plus cher, Craignez à votre tour l'effet de ma colère.
Vous me voulez faire la loi, Vous qu’on voir ſi ſouvent la recevoir de moi!	Vous me voulez faire la loi, Vous qu'on voir si souvent la recevoir de moi!
Vous qui portez un cœur ſenſible comme un autre, Vous enviez au mien les delices du vôtre!	Vous qui portez un cœur sensible comme un autre, Vous enviez au mien les délices du vôtre!
Mais dans ce même cœur j’enfoncerai des coups, Qui ne ſeront ſujvis que de chagrins jaloux;	Mais dans ce même cœur j'enfoncerai des coups, Qui ne seront sujvis que de chagrins jaloux;
Je vous accablerai de honteuſes ſurpriſes, Et choiſirai par tout à vos vœux les plus doux Des Adonis & des Anchiſes, 10 Qui n’auront que haine pour yous	Je vous accablerai de honteuses surprises, Et choisirai par tout à vos vœux les plus doux Des Adonis et des Anchises, 10 Qui n'auront que haine pour yous
SCENE V.	SCÈNE V.
S, L'AMOUR.	S, L'AMOUR.
3 1e Il L conhoüie.	3 1e Il conhouie.
ENUS.	ENUS.
LA menace eſt reſpectueuſe, Et d’un Enfant qui fait le revolté La colere préſomptueuſe.	LA menace est respectueuse, Et d'un Enfant qui fait le révolté La colère présomptueuse.
L A dod les.	L À dod les.
Je ne ſuis plus Enfant, & je l’ai trop été, Et ma colere eſt juſte autant qu’impetueuſe.	Je ne suis plus Enfant, et je l'ai trop été, Et ma colère est juste autant qu'impétueuse.
ENUS.	ENUS.
L’impetuoſité s’en devroit retenir, Et vous pourriez vous ſouvenir Que vous me devez la naiſſance.	L'impétuosité s'en devrait retenir, Et vous pourriez vous souvenir Que vous me devez la naissance.
L’AMOUR.	L'AMOUR.
Et vous pourriez n’oublier pas Que vous avez un cœur & des appas Qui relevent de ma puiſſance:	Et vous pourriez n'oublier pas Que vous avez un cœur et des appas Qui relèvent de ma puissance:
Que mon Arc de la vôtre eſt l’unique ſoûtien, Que ſans mes traits elle n’eſt rien, Et que ſi les cœurs les plus braves, En triomphe par vous ſe ſont laiſſez traîner, Vous n’avez jamais fait d’Eſclaves Que ceux qu’il m’a plû d’enchaîper.	Que mon Arc de la vôtre est l'unique soutien, Que sans mes traits elle n'est rien, Et que si les cœurs les plus braves, En triomphe par vous se sont laissez traîner, Vous n'avez jamais fait d'Esclaves Que ceux qu'il m'a plu d'enchaîper.
Ne me vantez donc plus ces droits de la naiſſance Qui tyranniſent mes deſirs;	Ne me vantez donc plus ces droits de la naissance Qui tyrannisent mes désirs;
Et ſi vous ne voulez perdre mille ſoûpirs, songez en me voyant à la reconnoiſſance, Vous qui tenez de ma puiſſance.	Et si vous ne voulez perdre mille soupirs, songez en me voyant à la reconnaissance, Vous qui tenez de ma puissance.
Et vonſe gloire, & vos plainrs	Et vonse gloire, et vos plainrs
J S Comment l’avez-vous défenduë;	 Comment l'avez-vous défendue;
Cette gloire dont vous parlez?	Cette gloire dont vous parlez?
Comment me l’avez vous renduë?	Comment me l'avez -vous rendue?
Et quand vous avez eû-mes Autels deſolez, Mes Temples violez, Mes honneurs ravalez, Si vous avez pris part à tant d’ignominie, Comment en a-t-on veu punie Pſiché qui me les a volez?	Et quand vous avez eu-mêmes Autels désolés, Mes Temples violez, Mes honneurs ravalez, Si vous avez pris part à tant d'ignominie, Comment en a-t-on vu punie Psiché qui me les a volés?
Je vous ai commandé de la rendre charmée Du plus vil de tous les Mortels, Qui ne daignât repondre à ſon ame enſſâmée Que par des rebuts éternels, Par les mépris les plus cruels, Et vous-même l’avez aimée!	Je vous ai commandé de la rendre charmée Du plus vil de tous les Mortels, Qui ne daignât répondre à son âme enssâmée Que par des rebuts éternels, Par les mépris les plus cruels, Et vous-même l'avez aimée!
Vous avez contre moi ſéduit des Immortels, C’eſt pour vous qu’à mes yeux les Zephirs l’ont caQu’appollon même ſubornée Par un Oracle adroitement tourné Me l’avoit ſi bien arrachée, Que ſi ſa curioſité Par une aveugle défiance Ne l’eut renduë à ma vangeance, Elle échapoit à mon cœur irrité.	Vous avez contre moi séduit des Immortels, C'est pour vous qu'à mes yeux les Zéphirs l'ont caQu'appollon même subornée Par un Oracle adroitement tourné Me l'avait si bien arrachée, Que si sa curiosité Par une aveugle défiance Ne l'eut rendue à ma vengeance, Elle échappait à mon cœur irrité.
chée, Voyez l’état ou vôtre amour l’a miſe, Vôtre Pſiché ſon ame va partir.	chée, Voyez l'état où votre amour l'a mise, Votre Psiché son âme va partir.
Voyez, & ſi la vôtre en eſt encor épriſe, Recevez ſon dernier ſoûpir.	Voyez, et si la vôtre en est encor éprise, Recevez son dernier soupir.
Menacez bravez.	Menacez bravés.
moi, cependant qu’elle expire:	moi, cependant qu'elle expire:
Tant d’inſolence vous ſied bien, Et je dois endurer, quoi qu’il vous plaiſe dire, Moy qui fans vas traits ne purs fiell	Tant d'insolence vous sied bien, Et je dois endurer, quoi qu'il vous plaise dire, Moi qui fans as traits ne purs fiell
L’AMOUR.	L'AMOUR.
Vous ne pouvez que trop, Déeſſe impitoyable, Le Deſtin l’abandonne à tout vôtre couroux :	Vous ne pouvez que trop, Déesse impitoyable, Le Destin l'abandonne à tout votre courroux :
Mais ſoyez moins inéxorable Aux prieres, aux pleurs d’un Fils à vos genoux, Cerdoit vous être un ſpectacle aſſez doux De voir d’un œ il Pſiché mourante, Et de l’autre ce Fils d’une voix ſupliante Ne vouloir plus tenir ſon bonheur que de vous.	Mais soyez moins inéxorable Aux prières, aux pleurs d'un Fils à vos genoux, Cerdait vous être un spectacle assez doux De voir d'un œ il Psiché mourante, Et de l'autre ce Fils d'une voix suppliante Ne vouloir plus tenir son bonheur que de vous.
Rendez-moi ma Pſiché, rendez-lui tous ſes charmes reeiiuen la;	Rendez-moi ma Psiché, rendez-lui tous ses charmes reeiiuen la;
Deent à mes larmes, Rendez à mon amour, rendez à ma douleur Le charme de mes yeux, & le choix de mon cœur.	Deent à mes larmes, Rendez à mon amour, rendez à ma douleur Le charme de mes yeux, et le choix de mon cœur.
ENUS.	ENUS.
Quelque amour que Pſiché vous donné, De ſes malheurs par moi n’attendez pas la fin:	Quelque amour que Psiché vous donné, De ses malheurs par moi n'attendez pas la fin:
Si le Deſtin me l’abandonne, Je l’abandonne à ſon Deſtin.	Si le Destin me l'abandonne, Je l'abandonne à son Destin.
Ne m’importunez plus, & dans cette infortune Eallica la fans venus trompher ou perir.	Ne m'importunez plus, et dans cette infortune Eallica la fans venus trompher ou périr.
L'AMOUR.	L'AMOUR.
Helas!	Hélas!
ſi je vous importune, Je ne le ferois pas, ſi je pouvois mourir.	si je vous importune, Je ne le ferais pas, si je pouvais mourir.
ENUS.	ENUS.
Coute dourtui n'eſt pas commune, Qui force un Immortel a ſouhaiter la mort.	Coute dourtui n'est pas commune, Qui force un Immortel a souhaiter la mort.
L’AMOUR.	L'AMOUR.
Voyez par ſon excez ſi mon amour eſt fort.	Voyez par son excès si mon amour est fort.
Ne luy ferez-vous grace aucune?	Ne notre ferez-vous grâce aucune?
ENUS.	ENUS.
91 Je vous l'avouë, il me touche le cœur, Vôtre amour, il deſarme, il fléchit ma rigueur;	91 Je vous l'avoue, il me touche le cœur, Votre amour, il désarme, il fléchit ma rigueur;
vôtre Pſiché reverra la lumiere.	votre Psiché reverra la lumière.
L’AMOUR.	L'AMOUR.
Que je vous vai par tout faire donſſer d’encens	Que je vous vais par tout faire donsser d'encens
2 N D S.	2 N D D.
Oüi, vous la reverrez dans ſa beauté premiere:	Oui, vous la reverrez dans sa beauté première:
Mais de vos vœux reconnoiſſans Je veux la déf rence entiere Je veux qu'un vrar ferpece, ame u monamtié Vous choiſit une autre Moitié.	Mais de vos vœux reconnaissants Je veux la déf renée entière Je veux qu'un vrar ferpèce, âme monamtié Vous choisit une autre Moitié.
L'AMOUR.	L'AMOUR.
Et moi, je ne veux plus de grace, Je reprens toute mon audace, Je veux Pſiché, je veux ſa foi:	Et moi, je ne veux plus de grâce, Je reprends toute mon audace, Je veux Psiché, je veux sa foi:
Je veux qu’elle revive & revive pour moi, Et rien indifferent que vôtre haine laſſe, En faveur d’une autre ſe paſſe.	Je veux qu'elle revive et revive pour moi, Et rien indifférent que votre haine lasse, En faveur d'une autre se passe.
Jupiter qui paroit va juger entre nous De lues empor emens ee de votle couroum Aprés quelques éclairs & roulemens de Tonnerre, Jupiter paroit en l’air ſur ſon Aigle.	Jupiter qui parait va juger entre nous De lues empor ements ce de votle couroum Ès quelques éclairs et roulements de Tonnerre, Jupiter parait en l'air sur son Aigle.
SCENDDERRIERE.	SCENDDERIERE.
ITER, VENUS, L'AMOUR, PSICHE'.	ITER, VENUS, L'AMOUR, PSICHÉE'.
L’AMOUR.	L'AMOUR.
V Ous à qui ſeul eſt poſſible, Pere des Dieux, Souverain des Mortels, Fléchichez la rigueur d’une Mere inſſéxibles Qui ſans moi n’auroit point d’Autels.	V Ous à qui seul est possible, Père des Dieux, Souverain des Mortels, Fléchichez la rigueur d'une Mère insséxibles Qui sans moi n'aurait point d'Autels.
J’ai pleuré, j’ai prié, je ſoûpire, menace, Et perds menaces & ſoûpirs;	J'ai pleuré, j'ai prié, je soupire, menace, Et perds menaces et soupirs;
Elle ne veut pas voir que de mes déplaifirs Dépend du monde entier l’heureuſe, ou triſte face, Et que ſi Pſiché perd le jour, Si Pſiché n’eſt à moi, je ne ſuis plus l’Amour.	Elle ne veut pas voir que de mes déplaisirs Dépend du monde entier l'heureuse, ou triste face, Et que si Psiché perd le jour, Si Psiché n'est à moi, je ne suis plus l'Amour.
Oüy, je rompray mon Arc, je briſera y mes fléches, J’éteindrai juſqu’à mon flambeau, Je laiſſerai languir la Nature au tombeau;	Oui, je romprai mon Arc, je brisera y mes flèches, J'éteindrai jusqu'à mon flambeau, Je laisserai languir la Nature au tombeau;
ches, Ou ſi je daigne aux cœurs faire encor quelques bréAvec ces pointes d’or qui me font obeïr Je vous bleſſerai tous la haut pour des Mortelles, Et ne décocheray ſur elles Que des traits émouſſez qui forcent à haĩr.	chez, Ou si je daigne aux cœurs faire encor quelques bréAvec ces pointes d'or qui me font obéir Je vous blesserai tous la haut pour des Mortelles, Et ne décocherai sur elles Que des traits émoussez qui forcent à haĩr.
Et qui ne font que des rebelles, Des ingrates, & des cruelles.	Et qui ne font que des rebelles, Des ingrates, et des cruelles.
Par quelle tyrrannique loi 'I iendrai-je à vous fervil mes ariſes toujoulalpreſtes, Et vous feray-je à tous conquêtes ſur conquêtes, Si vous me defendez d’en faire une pour moi ?	Par quelle tyrrannique loi 'I iendrai-je à vous fervil mes arises toujoulalprêtes, Et vous ferai-je à tous conquêtes sur conquêtes, Si vous me défendez d'en faire une pour moi ?
UPITER.	OÙPITER.
Ma Fille, ſois lui moins ſevere.	Ma Fille, sois lui moins sévère.
Tu tiens de ſa Pſiché le Deſtin en tes mains, La Parque au moindre mot va ſuivre ta colere, Parle, & laiſſe toi vaincre aux tendreſſes de Mere;	Tu tiens de sa Psiché le Destin en tes mains, La Parque au moindre mot va suivre ta colère, Parle, et laisse toi vaincre aux tendresses de Mère;
Ou redoute un couroux que moy-même je crains.	Ou redoute un courroux que moi-même je crains.
Veux-tu donner le monde en proye A la haine, au deſordre, à la confuſion, Et d’un Dieu d’union, D’un Dieu de douceurs & de joye Faire un Dieu d’amertume & de diviſion?	Veux-tu donner le monde en proie A la haine, au désordre, à la confusion, Et d'un Dieu d'union, D'un Dieu de douceurs et de joie Faire un Dieu d'amertume et de division?
Conſidere ce que nous ſommes, Et ſi les paſſions doivent nous dominer.	Considère ce que nous sommes, Et si les passions doivent nous dominer.
Plus la vengeance a dequoi plaire aux Hommes, Plus il ſied bien aux Dieux de pardonner.	Plus la vengeance a dequoi plaire aux Hommes, Plus il sied bien aux Dieux de pardonner.
JENUS.	JENUS.
Je pardonne à ce Fils rebelle!	Je pardonne à ce Fils rebelle!
Mais voulez-vous qu’il me ſoit reproché Qu’une miſerable Mortelle, L’obiet de mon couroux, l’orgueilleuſe Pſiché, Sous ombre qu’elle eſt un peu belle, l'ai un riymen dont je reugis, Soüille mon alliance, & le lit de mon Fils?	Mais voulez-vous qu'il me soit reproché Qu'une misérable Mortelle, L'objet de mon courroux, l'orgueilleuse Psiché, Sous ombre qu'elle est un peu belle, l'ai un rimen dont je rempis, Sourille mon alliance, et le lit de mon Fils?
ITER.	ITER.
Hé bien, je la fais immortelle, .	Hé bien, je la fais immortelle, .
Afin d’y rendre tout égal.	Afin d'y rendre tout égal.
IENUS.	JENUS.
Je n’ai plus de mépris, ny de haine pour elle, Et l’admets à l’honneur de ce nœud conjugal.	Je n'ai plus de mépris, Seigneur de haine pour elle, Et l'admets à l'honneur de ce nœud conjugal.
Pſiché, reprenez la lumiere, Pour ne la reperdre jamais, Jupiter a fait vôtre paix, Et je quitte cette humeur fiere Qui s’oppoſoit à vos ſouhaits,	Psiché, reprenez la lumière, Pour ne la reperdre jamais, Jupiter a fait votre paix, Et je quitte cette humeur fière Qui s'opposait à vos souhaits,
SICHE’.	SICHÉE.
C’eſt donc vous, ô grande Déeſſe, Qui redonnez la vie a ce cœur innocent!	C'est donc vous, ô grande Déesse, Qui redonnés la vie à ce cœur innocent!
ENUS.	ENUS.
Jupiter vous fait grace, & ma colere ceſſe.	Jupiter vous fait grâce, et ma colère cesse.
.	.
Venus l’ordonne, aimez elle y conſent.	Venus l'ordonne, aimez elle y consent.
PSICHE' à l'Amour.	PSICHÉE' à l'Amour.
Je vous revois enfin, chęr objet de ma flâme!	Je vous revois enfin, chaîr objet de ma flamme!
L’AMOUR à Pſiché.	L'AMOUR à Psiché.
Je vous poſſede enfin, delices de mon ame!	Je vous possède enfin, délices de mon âme!
JPITER.	JPITER.
Vencz Amans, venez aux Cieux Achever un ſi grand & ſi digne Hymenée:	Vencz Amants, venez aux Cieux Achever un si grand et si digne Hyménée:
Viens y, belle Pſiché, changer de Deſtinée, Viens prendre place au rang des Dieur.	Viens y, belle Psiché, changer de Destinée, Viens prendre place au rang des Dieur.
Eux grandes Machines deſcendent aux deux côDtez de ſupiter, cependant qu’il dit ces derniers Vers.	Eux grandes Machines descendent aux deux côtés de supiter, cependant qu'il dit ces derniers Vers.
Venus avec ſa Suite monte dans l’une.	Venus avec sa Suite monte dans l'une.
L’Amour uott l'fitne aumedutre, & tous enſemble remontent au Ciel.	L'Amour uott l'une aumédutre, et tous ensemble remontent au Ciel.
Les Divinitez qui avoient été partagées entre Vénus & ſon Fils, ſe réunißent en les voyant d’accord;	Les Divinités qui avaient été partagées entre Vénus et son Fils, se réunissent en les voyant d'accord;
& toutes enſemble par des Concerts, des Chants, & des Dances, celebrent la Fête des Nopces de:	et toutes ensemble par des Concerts, des Chants, et des Dances, célèbrent la Fête des Noces de:
l’Amour.	L'Amour.
Eppollon paroît le premier, & comme Dieu le l'Harmonie commence a chanter pour inviter les datres Dieux à ſe rejoüir.	Épollon paraît le premier, et comme Dieu le l'Harmonie commence a chanter pour inviter les datres Dieux à se réjouir.
RECIT D'APPOLLON.	RÉCIT D'APOLLON.
Niſſons-nous, Troupe immortelle;	Nissons-nous, Troupe immortelle;
O Le Dieu d’Amour devient heureux Amant, Et Venus a repris ſa douceur naturelle En faveur d’un Fils ſi charmant:	Ô Ô Dieu d'Amour devient heureux Amant, Et Venus a repris sa douceur naturelle En faveur d'un Fils si charmant:
Il va goûter en paix, aprés un long tourment, Une felicité qui doit être éternelle.	Il va goûter en paix, après un long tourment, Une félicité qui doit être éternelle.
Toutes les Divinitez, chantent enſemble-ce Couplet à la gloire de l’Amour.	Toutes les Divinités, chantent ensemble-ce Couplet à la gloire de l'Amour.
Elebrons ce grand Jour;	Élébrons ce grand Jour;
CCelebrons tous une Feſte ſi belle:	CCélébrons tous une Fête si belle:
Que nos Chants en tous lieux en portent la nouvelle Qu’ils faffent retentir le celeſte ſejour:	Que nos Chants en tous lieux en portent la nouvelle Qu'ils faffent retentir le celeste jour:
Chantons, repetons tour à tour, Qu’il n’eſt point d’Ame ſi cruelle, Qui tôt ou tard ne ſe rende à l’Amour.	Chantons, répétons tour à tour, Qu'il n'est point d'Âme si cruelle, Qui tôt ou tard ne se rende à l'Amour.
APOLLON continuëE Dieu qui nous engage LA lui faire la Cour, Defend qu’on ſoit trop ſage.	APOLLON continueE Dieu qui nous engage LA lui faire la Cour, Défend qu'on soit trop sage.
Les plaiſirs ont leur tour, C’eſt leur plus doux uſage;	Les plaisirs ont leur tour, C'est leur plus doux usage;
Que de finir des ſoins du Jour.	Que de finir des soins du Jour.
La nuit eſt le partage Mee jeur ce de l'Amoure.	La nuit est le partage Me jeur ce de l'Amoure.
Le ſeroit grand dommage Qu’en ce charmant Séjour On eut un cœur ſauvage.	Le serait grand dommage Qu'en ce charmant Séjour On eut un cœur sauvage.
Les Pla ſirs ont leur tour, C’eſt leur plus doux uſage, Que de nn lles ioins du joule La nuit eſt le partage Des Jeux & de l’Amour.	Les Pla sirs ont leur tour, C'est leur plus doux usage, Que de nn les joins du joule La nuit est le partage Des Jeux et de l'Amour.
Deux Muſes qui ont toûjours évitè de s’engager ſous les Loix de l’Amour, conſeillent aux Belles, qui n’ont point encore aimé, de s’en defendre avec ſoin à leur exemple.	Deux Muses qui ont toujours évitèrent de s'engager sous les Lois de l'Amour, conseillent aux Belles, qui n'ont point encore aimé, de s'en défendre avec soin à leur exemple.
CHANSON DES MUSES.	CHANSON DES MUSES.
Ardéz-vous, Beautez ſeveres, C Les Amours font trop d’affaires, Craignez toûjours de vous laiſſer charmer;	Ardéz-vous, Beautés sévères, Ç Les Amours font trop d'affaires, Craignez toujours de vous laisser charmer;
Quand il faut que l’on ſoûpire, Tout le mal n’eſt pas de s’enflâmer?	Quand il faut que l'on soupire, Tout le mal n'est pas de s'enflammer?
Le martire De le dire Coute pius cent lats quea amer.	Le martyre De le dire Coute pius cent lats quea amer.
SECOND COUPLET DES MUSES.	SECOND COUPLET DES MUSES.
On ne peut aimer ſans peines, Il eſt peu de douces chaînes, A tout moment on ſe ſent alarmer;	On ne peut aimer sans peines, Il est peu de douces chaînes, À tout moment on se sent alarmer;
Quand il faut que l’on ſoûpire, Tout le mal n’eſt pas de s’enflâmer;	Quand il faut que l'on soupire, Tout le mal n'est pas de s'enflammer;
Le martire De le dire, Coûte plus cent fois que d’aimer.	Le martyre De le dire, Coûte plus cent fois que d'aimer.
Bachas fait entendre qu’il n’eſt pas ſi dangereux que l’Amour.	Bachas fait entendre qu'il n'est pas si dangereux que l'Amour.
RECIT DE BACCHUS.	RÉCIT DE BACCHUS.
I quelquefois,  Suivant nos douces Loix, La raiſon ſe perd & s’oublie Ce que le Vin nous cauſe de folie Commence & finit en un jour, Mais quand un cœur eſt enyvré d’Amour, Souvent c’eſt pour toute la vie.	I quelquefois, Suivant nos douces Lois, La raison se perd et s'oublie Ce que le Vin nous cause de folie Commence et finit en un jour, Mais quand un cœur est enivré d'Amour, Souvent c'est pour toute la vie.
Mome declare qu’il n’a point de plus doux employ que deméd re, & que ce n’eſt qu’à l’Amour ſeul qu’il n’oſe ſe jouër.	Mome déclare qu'il n'a point de plus doux emploi que deméd ré, et que ce n'est qu'à l'Amour seul qu'il n'ose se jouer.
RECIT DE MOME.	RÉCIT DE MÔME.
E cherche à médire, Sur la Terre & dans les Cieux, Je ſoûmets à ma Satyre Les plus grands des Dieux.	E cherche à médire, Sur la Terre et dans les Cieux, Je soumets à ma Satire Les plus grands des Dieux.
Lh’eſt dans l’Univers que l’Amour qui m’étonne Il eſt le ſeul que j’épargne aujourd’hui, Il n’appartient qu’à luy De n’epargner perlonne.	Lh’est dans l'Univers que l'Amour qui m'étonne Il est le seul que j'épargne aujourd'hui, Il n'appartient qu'à avait Eu n'épargner perlonne.
ENTRE’E DE BALLET.	ENTRE DE BALLET.
Compoſée de deux Mœnades & de deux Ægipans qui Juivent Bacchus.	Composée de deux Mœnades et de deux Ægipans qui Juivent Bacchus.
ENTRE'E DE BALLET.	ENTRE DE BALLET.
Compoſée de quatre Polichinelles & de deux Mataſsins qui ſuivent Mome, & viennent joindre leur plaiſante, ie & leur badinage aux divertißemens de cette grande Fête.	Composée de quatre Polichinelles et de deux Matassins qui suivent Mome, et viennent joindre leur plaisante, on et leur badinage aux divertissements de cette grande Fête.
Bacchus & Mome qui les conduiſent, chantent au miltenm enn & umennum onanjon, batenus a la loüange du Vin, & Mome une Chanſon enjoüée ſur le ſujet & les avantage de la raillerie.	Bacchus et Mome qui les conduisent, chantent au miltenm en et umennum onanjon, batenus a la louange du Vin, et Mome une Chanson enjouée sur le sujet et les avantage de la raillerie.
RECIT DE BACCHUS Dmirons le jus de la Treille:	RÉCIT DE BACCHUS Démirons le jus de la Treille:
A Qu’il eſt puiſſant!	A Qu'il est puissant!
qu’il a d’attraits!	qu'il a d'attraits!
I tert aux douceurs de la Paix, Et dans la Guerre il fait merveille:	I tert aux douceurs de la Paix, Et dans la Guerre il fait merveille:
Mais ſur tout pour les Amours, Le Vin eſt d’un grand ſecours.	Mais sur tout pour les Amours, Le Vin est d'un grand secours.
RECIT DE MOME.	RÉCIT DE MÔME.
Olaſtrons, divertiſſons-nous, L'Raillons, nous ne ſçaurions mie ux faire;	Olâtrons, divertissons-nous, L'Raillons, nous ne saurions mie ux faire;
La raillerie eſt neceſſaire Dans les Jeux les plus dodrJans la douceur que l’on goûte à médire, On trouve peu de plaiſirs ſans ennui, Rien n’eſt ſi plaiſant que de rire, Quand on rit aux dépens d’autrui.	La raillerie est nécessaire Dans les Jeux les plus dodrants la douceur que l'on goûte à médire, On trouve peu de plaisirs sans ennui, Rien n'est si plaisant que de rire, Quand on rit aux dépens d'autrui.
acπἁτο Plaiſantons, ne pardonnons rien, Rions, rien n’eſt plus à la rlode.	acπἁτο Plaisantons, ne pardonnons rien, Rions, rien n'est plus à la rode.
On court péril d’être iucommode, Et diſant trop de bien.	On court péril d'être jucommode, Et disant trop de bien.
Sans la douceur que l’on goûte à médire, On trouve peu de plaiſirs ſans eunuy;	Sans la douceur que l'on goûte à médire, On trouve peu de plaisirs sans eunui;
Rien n’eſt ſi plaiſant que de rire, Quand on rit aux dépens d’autrui.	Rien n'est si plaisant que de rire, Quand on rit aux dépens d'autrui.
RECIT DE MARS.	RÉCIT DE MARS.
Aiſſons en paix toute la Terre, L Cherchons de doux amuſemens;	Aissons en paix toute la Terre, L Cherchons de doux amusements;
Parmy les Jeux les plus charmans, Mêlons l’image de la Guerre.	Parmi les Jeux les plus charmants, Mêlons l'image de la Guerre.
ENNREEDE DALUET.	ENNREDE DALUET.
Suivans de Mars, qui font en dançant avec des Enſeignes une maniere d’Exercice.	Suivants de Mars, qui font en dançant avec des Enseignes une manière d'Exercice.
DERNIERE ENTRE’E DE BALLET.	DERNIÈRE ENTRE DE DE BALLET.
Les Troupes differentes de la Suite d’Apollon, de Bacchus, de Mome, & de Mars, apres avoir achevé leurs Entrées partirulieres, s'unißent enſemble, & forment la derniere Entrée qui renferme toutes les autres.	Les Troupes différentes de la Suite d'Apollon, de Bacchus, de Mome, et de Mars, après avoir achevé leurs Entrées partirulières, s'uni ensemble, et forment la dernière Entrée qui renferme toutes les autres.
Un Chœur de toutes les Voix & de tous les Inſtrumens, qui ſont au nombre de quarante, ſe joint à la Dunje guieiie & termine la Fête des Nopces de l’Amour & de Fiche.	Un Chœur de toutes les Voix et de tous les Instruments, qui sont au nombre de quarante, se joint à la Dunje guieiie et termine la Fête des Nopces de l'Amour et de Fiche.
DERNIER CHOEUR.	DERNIER CHOEUR.
Hantons les plaiſirs charmans ODes heureux Amans, Que tout le Ciel s’empreſſe A leur faire ſa Cour, Celebrons ce beau Jour Par mille doux chants d’allegreſſe, Celebrons ce beau Jour Par mille doux chants pleins d’amour.	Hantons les plaisirs charmands ODes heureux Amants, Que tout le Ciel s'empresse À leur faire sa Cour, Clébrons ce beau Jour Par mille doux chants d'allégresse, Célébrons ce beau Jour Par mille doux chants pleins d'amour.
Dans le grand Sallon du Palais des Tuilleries, où Pſiché a été repreſentée devant Leurs Majeſtez, il y avoit des Timbales:	Dans le grand Sallon du Palais des Tuilleries, où Psiché a été représentée devant Leurs Majectés, il y avait des Timbales:
des Trompettes & des Tambours, mêlez dans ces derniers Concerts;	des Trompettes et des Tambours, mêlés dans ces derniers Concerts;
& ce dernier Couplet Je thantuis ainſi.	et ce dernier Couplet Je thantuis ainsi.
Ll C'Hantons les plaiſirs charmans C Des heureux Amens.	Ll C'Hantons les plaisirs charmants Ç Es heureux Aments.
Répondez nous Trompettes, Timbales & Tambouts:	Répondez nous Trompettes, Timbales et Tambouts:
Accordez-vous toûjours A vec le doux ſon des Muſettes, Accordez vous toûjours vec le doux chant des Amours:	Accordez-vous toujours A vec le doux son des Musettes, Accordez vous toujours vec le doux chant des Amours:
I N.	I N.
Extrait du Privilege du Roi.	Extrait du Privilège du Roi.
AR Grace & Privilege dn Roi, Donné à Paris le I 31.	AR Grâce et Privilège dn Roi, Donné à Paris le I 31.
jour de Decembre, l’an de grace 1670.	jour de Décembre, l'an de grâce 1670.
Signé.	Signé.
Par le Roi en ſon Couſeil, GUITONNEAU;	Par le Roi en son Couseil, GUITONEAU;
Il eſt permis à Jean Baptiſte Pocquelin de Moliere, l’un des Comediens de Sa Majeſté, de faire imprimer, avendre, & debiter une piece de The atre, intitulée, LES AMOURS DE PSICHE', par tel Imprimeur ou Libraire qu’il voudra choiſir, pendant le tems de dix années entieres & accomplies, à compter du jour que ladite Piece ſera achevée d’imprimer pour la «premiere fois:	Il est permis à Jean Baptiste Pocquelin de Molière, l'un des Comédiens de Sa Majesté, de faire imprimer, avendre, et débiter une pièce de Thé âtre, intitulée, LES AMOURS DE PSICHÉE, par tel Imprimeur ou Libraire qu'il voudra choisir, pendant le temps de dix années entières et accomplies, à compter du jour que ladite Pièce sera achevée d'imprimer pour la «premiere fois:
Et defenſes ſont faites à toutes Perſonnes, de quelque qualité & condition qu’elles ſoient d’imprimer, faire imprimer, vendre, ni debiter ladite Piece, ſans le conſentement de l’Expoſant, ou de ceux qui auront droit de luy, à peine de ſix mille livres d'anfemde, connteationdes naemplants contrefaits, & de tous dépens, dommages & intereſts, ainſi que plus au long il eſt porté audit Privilege.	Et défenses sont faites à toutes Personnes, de quelque qualité et condition qu'elles soient d'imprimer, faire imprimer, vendre, ni débiter ladite Pièce, sans le consentement de l'Exposant, ou de ceux qui auront droit de soins, à peine de six mille livres d'anfemde, connationdes namplants contrefaits, et de tous dépens, dommages et intérêts, ainsi que plus au long il est porté audit Privilège.
Ledit Sieur Moliere a cedé ſon droit de Privilege à Anne David, Femme de Jean Ribou, ainſi qu’il apert par ſa Ceſſion:	Ledit Sieur Molière a cédé son droit de Privilège à Anne David, Femme de Jean Ribou, ainsi qu'il apert par sa Cession:
& ladite David a cedé du droit de Privilege des Oeuvres dudit Sieur Moliere à Cia Barbin, ſuivant l’accord fait entr’eux.	et ladite David a cédé du droit de Privilège des Oeuvres dudit Sieur Molière à Cia Barbin, suivant l'accord fait entr'eux.
Regiſtré ſur le Livre de la Communauté des In primeurs & Marchands Libraires de Paris ſuivant l’Arrêt de la Cœur de Parlement du 8.	Registré sur le Livre de la Communauté des In primeurs et Marchands Libraires de Paris suivant l'Arrêt de la Cœur de Parlement du 8.
Avril 1653.	Avril 1653.
aux charges & conditions portées és prȩſentes Lettres.	aux charges et conditions portées ès pransentes Lettres.
Fait ce 13 Mars mil ſix cens ſoixante, & onze.	Fait ce 13 Mars mil six cens soixante, et onze.
Achevé d’imprimer le 1a.	Achevé d'imprimer le 1a.
Auru 1e78.	Auru 1e78.
rance	rance
