LIMEIVE.	LIMEIVE.
LE TRIOMPHE DE LA VERTV.	LE TRIOMPHE DE LA VERTU.
Trage-comedie en Proſe.	Trage-comédie en Prose.
DEDIEE A MADAME LA DVCHESSE DE SVLLY.	DÉDIE À MADAME LA DVCHESSE DE SVLLY.
Par Monſieur DE LA SERRE.	Par Monsieur DE LA SERRE.
A PARIS, Chez ANTOINE DE SOMMAVILLE, à l’Eſcu de France, dans la Salle des Merciers.	À PARIS, Chez ANTOINE DE SOMAUILLE, à l'Écu de France, dans la Salle des Merciers.
AVGVSTIN COVRBE', Libraire & Imprimeur de Monſeigneur Frere du Roy, à la Palme, en la meſme Salle.	AUGUSTIN COURBE, Libraire et Imprimeur de Monseigneur Frère du Roi, à la Palme, en la même Salle.
M.	M.
DC.	DC.
XXXXIII.	XXXXIII.
Auec Priuilege du Roy.	Avec Privilège du Roi.
A MADAME MADAME LA DVCHESSE DE SVLLY a rineene axien y chemnont.	À MADAME MADAME LA DVCHESSE DE SVLLY a rineene axien y chemnont.
2 E ADAME, Il falloit de neceſſité que ie vous dediaſſe cet ouurage, pour faire triompher dignement la Vertu, puis que voſtre reputation eſt le plus ſuperbe de ſes trophées.	2 E DAME, Il fallait de nécessité que je vous dédiasse cet ouvrage, pour faire triompher dignement la Vertu, puis que votre réputation est le plus superbe de ses trophées.
Ie la fay donc voir triomphante MADAME, à toute l’Europe ſous la prote clion de voſtre Nom, & auec d’autant triomphe auec elle ſous vn meſme viſage puis que le voſtre eſt le fidelle portrait de toutes deux.	Je la fais donc voir triomphante MADAME, à toute l'Europe sous la prote clion de votre Nom, et avec d'autant triomphe avec elle sous un même visage puis que le vôtre est le fidèle portrait de toutes deux.
En effet MADAME, on peut dire hardiment que vous nous faites voir auiourd’huy & la Vertu & la Beauté auec les meſmes apas & les meſmes graces dont le Ciel a pourueu l’vne, & la Nature lautre.	En effet MADAME, on peut dire hardiment que vous nous faites voir aujourd'hui et la Vertu et la Beauté avec les mêmes apas et les mêmes grâces dont le Ciel a pourvu l'une, et la Nature lautre.
Ce qui vous rend ſi admirable aux yeux meſmes de l'Enuie, que ne poüuant ſe taire elle eſt contrainte à parler dignement de vous.	Ce qui vous rend si admirable aux yeux mêmes de l'Envie, que ne pouvant se taire elle est contrainte à parler dignement de vous.
Certes MADAME, ie trouue ſi peu de perſonnes qui vous reſſemblent, que i’oſe dire ſans flaterie qu’il y en auroit beaucoup pour celles que ie comparerois auec vous.	Certes MADAME, je trouve si peu de personnes qui vous ressemblent, que j'ose dire sans flatterie qu'il y en aurait beaucoup pour celles que un comparerais sez vous.
Ce n'eſt pas qu'on ne puſſie voir en diuers ſuiets les meſmesqualitezque voüs poſſedeZ:	Ce n'est pas qu'on ne pussie voir en divers sujets les mesmesqualitezque voüs possédés:
Mais comme elles empruntent leur eſclat l’vne de lautre, on ne ſçauroit les admirer qu’en vous ſeulle toutes enſemble, & c'eſt ce qui vous met hors de comparaiſon.	Mais comme elles empruntent leur éclat l'une de lautre, on ne saurait les admirer qu'en vous seulle toutes ensemble, et c'est ce qui vous met hors de comparaison.
De faire icy voſtre Panegiryqué, il y a ſi peu de proportion de ce que vous meriteZ à ce que i'en ſçaurois dire, que le ſilence me ſera touſiours autant auantageux qu’il vous peut eſtre agreable, puis que la neceſſité me l’impoſe auſsi abſolument que voſtre modeſtie.	De faire ici Rom Panegiryqué, il y a si peu de proportion de ce que vous méritez à ce que j'en saurais dire, que le silence me sera toujours autant avantageux qu'il vous peut avoir agréable, puis que la nécessité me l'impose aussi absolument que votre modestie.
Ie me tairay donc MADAME, mais ce ſera apres auoir publié hautement d’vne voix qui ſe faira entendre à tous le ſiecles, que ie ſuis par inclination autant que par deuoir,	Je me tairai donc MADAME, mais ce sera après avoir publié hautement d'une voix qui se faira entendre à tous le siècles, que je suis par inclination autant que par devoir,
MADAME,	MADAME,
Voſtre tres-humble & tres- obeïſſant ſeruiteur.	Votre très-humble et très- obéissant serviteur.
PVGET DE LA SERRE.	PUGET DE LA SERE.
NOMO SHS ACTEVRS.	NOMO SHS ACTEURS.
LE NOI.	LE NOI.
POLIARQVE, ſon Fauory.	POLIARQUE, son Favori.
de d0	de d0
PITTEANOIV, Gapitaiſle des Gardes.	PITTEANOIV, Gapitaisle des Gardes.
LE FAGE de Clconte.	LE SAGE de Clconte.
DORASTE.	DORASTE.
L RINCESSE CLIMENE.	 LINCESSE CLIMENE.
LA PRINCESSE PAMPHILIE,	LA PRINCESSE PAMPHILIE,
Ia DOur.	Ia DOur.
MELISTEE, Conſidente de Climene.	MELISTE, Considente de Climène.
DORISTENE, vne de ſes Dames d’honneur.	DORISTENE, une de ses Dames d'honneur.
L’VRANIE, Confidente de Pamphilie.	L'URANIE, Confidente de Pamphilhie.
CEIEVEEEVRJ OV LE TRIOMPHE MEENIV TECLETE OMEDIE.	CEIEVEEEVRJ OU LE TRIOMPHE MENIV TECLETE OMEDIE.
PREMIER ACTE.	PREMIER ACTE.
PREMIERE SCENE.	PREMIÈRE SCÈNE.
VE ie m’eſtime heureux, cher amy, de M me voir eſclaue dans vne priſon, dont I la Beauté eſt ma Geoliere.	VE ie m'estime heureux, cher ami, de M me voir esclave dans une prison, dont I la Beauté est ma Géolière.
Ie ſuis enchaiſné:	Je suis enchaîné:
mais les graces ont fait mes liens.	mais les grâces ont fait mes liens.
Ie ſuis aueugle:	Je suis aveugle:
mais elles- meſmes m’ont encore bandé les yeux.	mais elles- mêmes m'ont encore bandé les yeux.
Et pour ne me perdre pas dans ce labyrinte où ie me cherche toujours ſans auoir enuie de me retrouuer, l’Eſperance m’y ſert de guide.	Et pour ne me perdre pas dans ce labyrinte où Elle me cherche toujours sans avoir envie de me retrouver, l'Espérance m'y sert de guide.
DORIMANTE.	DORIMANTE.
I’admire voſtre bon-heur ſans en connétre la cauſc.	J'admire votre bonheur sans en connaître la causc.
POLIARQVE.	POLIARQUE.
Sçaches qu’à l’arriuée de Climene & de Pamphilie, ces deux grandes Princeſſes, qui bannies de leur païs par la tvrannie de Clytamas, ont cherché leur protection dans cette Cour, pour la treuuer en la bonté du Roy;	Saches qu'à l'arrivée de Climène et de Pampilie, ces deux grandes Princesses, qui bannies de leur pays par la trouver de Clyamas, ont cherché leur protection dans cette Cour, pour la trouver en la bonté du Roi;
Ie me ſentis tout à coup atteint d’vne bleſſure mortelle, dont les beaux yeux de Climene furent contrains de s’accuſer eux-meſmes;	Je me sentis tout à coup atteint d'une blessure mortelle, dont les beaux yeux de Climène furent contrains de s'accuser eux-mêmes;
puis que forgeans ſans ceſſe de leurs regards des traits bien aſſerez, ils en bleſſerent de nouueau mon cœur:	puis que forgeants sans cesse de leurs regards des traits bien asserez, ils en blessèrent de nouveau mon cœur:
mais ſi doucement, qu’il ſoûpira à l’inſtant meſme de la crainte de ſa gueriſon.	mais si doucement, qu'il soupira à l'instant ici de la crainte de sa guérison.
Reduit en cét eſtat où ie pouuois donner de l’enuie, conſiderant l’objet de mon Amour.	Réduit en cet état où je pouvais donner de l'envie, considérant l'objet de mon Amour.
Ie fus encore ſi heureux, qu’apres auoir treuué l’occaſion de rendre les premiers hommages de ma ſeruitude à cette Reyne de mon ame, elle les receut auec le meſme viſage qu’elle m’auoit contraint de les luy rendre.	Je fus encore si heureux, qu'après avoir trouvé l'occasion de rendre les premiers hommages de ma servitude à cette Reine de mon âme, elle les reçut avec le même visage qu'elle m'avait contraint de les lui rendre.
Ie veux dire auec les meſmes graces qui m’auoient enchaiſne 5ee qui mileme cempo nrauorent fendu aueu2.	Je veux dire avec les mêmes grâces qui m'avaient enchaîne 5 qui mylême cempo nravorent fendu aveu2.
DORIMANTE.	DORIMANTE.
Veritablement voſtre felicité dans ſon excez, fera des jaloux, ſi luy-meſme par ſa courte durée n’en modere l’enuie.	Véritablement votre félicité dans son excès, fera des jaloux, si tu-même par sa courte durée n'en molère l'envie.
le vis hier cette Princeſſe dont vous me parlez.	le vis hier cette Princesse dont vous me parlez.
Et quoy que la grandeur & la maieſté qui l’enuironnent, impoſent des loix de reſpect, auſſi bien que d’admiration, à tous ceux qui la regardent.	Et quoi que la grandeur et la maiesté qui l'environnent, imposent des lois de respect, aussi bien que d'admiration, à tous ceux qui la regardent.
Teus toutes les peines du monde de retirer mes yeux deſſus elle, tant ſon viſage me paroiſſoit admirable & charmant.	Tus toutes les peines du monde de retirer mes yeux dessus elle, tant son visage me paraissait admirable et charmant.
POLIARQVE.	POLIARQUE.
Ha!	Ha!
que ta préuoyance eſt iudicieuſe, Dorime¬· te, lors que tu menaſſes mon extreme bon-heur.	que ta prévoyance est judicieuse, Dorime te, lors que tu menaces mon extrême bonheur.
d’vne courte durée.	d'une courte durée.
Il eſt vray, la Fortune me rit, l’Amour me fauoriſe, & l’Eſperance me conſole.	Il est vrai, la Fortune me rit, l'Amour me favorise, et l'Espérance me console.
Mais que ne dois ie pas craindre d’vne volage;	Mais que ne dois ie pas craindre d'une volage;
où me ſçauroit conduire vn aueugle.	où me saurait conduire un aveugle.
Et comment me puis ie fier à celle qui ma trompé ſi ſouuent.	Et comment me puis rien fier à celle qui ma trompé si souvent.
I’ay ſuiet d’apprchender que le Roy ſoit mon Riual, puis que mes regards ont mille fois ſurpris les ſiens ſur le beau viſage de celle qui les attiroit tous CtCiHible.	J'ai sujet d'apprender que le Roi soit mon Rival, puis que mes regards ont mille fois surpris les siens sur le beau visage de celle qui les attirait tous Cthiible.
DORMIANTE.	DORMIANTE.
Le Roy n’a iamais eu de l’amour que pour la Vertu:	Le Roi n'a jamais eu de l'amour que pour la Vertu:
Et ſes paſſions en leur naiſſance ont beau agiter ſon ame des diuers ſentimens qui leur ſont propres, ſa prudence en calme l’orage, & l’on le voit troimphant, auſſi toſt que combatu,	Et ses passions en leur naissance ont beau agiter son âme des divers sentiments qui leur sont propres, sa prudence en calme l'orage, et l'on le voit troimphant, aussi tôt que combattu,
POLIARQVE.	POLIARQUE.
Ie ſçay bien que ſes inclinations le portent à la haine du vice.	Je sais bien que ses inclinations le portent à la haine du vice.
Mais comme l’Amour eſt vne maladie affectée à noſtre condition, ſa prudence ne ſçauroit l’en exemter que par hazard, puis qu’il y eſt ſuiet par nature.	Mais comme l'Amour est une maladie affectée à notre condition, sa prudence ne saurait l'en exemter que par hasard, puis qu'il y est sujet par nature.
Qui peut reſiſter aux efforts d’vne grande Beauté, ſi dans ce combat noſtre raiſon ſe rend la premiere?	Qui peut résister aux efforts d'une grande Beauté, si dans ce combat notre raison se rend la première?
Les Sceptres des Roys ſont des armes inutiles pour ſe deffendre contre les traits d’Amour:	Les Sceptres des Rois sont des armes inutiles pour se défendre contre les traits d'Amour:
Ils ſoûpirent comme nous, Dorimante, ſous la peſanteur de ſes chaiſnes.	Ils soupirent comme nous, Dorimante, sous la pesanteur de ses chaînes.
Mais auec cét auantage toutefois, de les pouuoir adoucir quand il leur plaiſt, n’ayans pas la force de les rompre.	Mais était cet avantage toutefois, de les pouvoir adoucir quand il leur plaît, n'ayant pas la force de les rompre.
DORIMANTE.	DORIMANTE.
Ce vous eſt touſiours quelque ſorte de conſolation de preuoir de bonne heure vn malheur que vous ne pouuez éuiter:	Ce vous est toujours quelque sorte de consolation de prévoir de bonne heure un malheur que vous ne pouvez éviter:
voſtre paſſion ne fait que de naiſtre:	votre passion ne fait que de naître:
étoufez-là dans ſon berceau.	étouffez-là dans son berceau.
Seruezvous de vos larmes pour éteindre vos feux.	Seruezvous de vos larmes pour éteindre vos feux.
la crainte fait perdre l’eſperance;	la crainte fait perdre l'espérance;
& n’ayant plus d’eſpoir, vous n’aurez plus d’amour.	et n'ayant plus d'espoir, vous n'aurez plus d'amour.
POLIARQVE.	POLIARQUE.
Ne ſçay-tu pas que ſa paſſion, tire ſa force du ſuiet qui la produit?	Ne sais-tu pas que sa passion, tire sa force du sujet qui la produit?
Croy tu qu’on puiſſe aymer moderément vne extreme beauté?	Crois -tu qu'on puisse aimer modérément une extrême beauté?
Les charmes de Climene ſont ſi puiſſans, qu’en m’oſtant la liberté, eux meſmes m’ont fait reſoudre de rendre ma ſeruitude eternelle.	Les charmes de Climène sont si puissants, qu'en m'ôtant la liberté, eux -mêmes m'ont fait résoudre de rendre ma servitude éternelle.
Et ce ſeroit en vain que mes yeux répandroient des larmes pour amortir le feu dont ie ſuis embraſé, puis que mon deſtin veut que mes cendres ſeules ayent cette puiſſance.	Et ce serait en vain que mes yeux répandraient des larmes pour amortir le feu dont je suis embrasé, puis que mon destin veut que mes cendres seules aient cette puissance.
DORIMANTE.	DORIMANTE.
Pourquoy vous plaignez-vous d’vn mal heur qui n’eſt pas encore arriué.	Pourquoi vous plaignez-vous d'un mal heur qui n'est pas encore arrivé.
A iij	À jijà
POLIARQVE.	POLIARQUE.
Taliii de le iounn faiis iie praidre quand il arriuera.	Taliver de le joun fayiz jie praidre quand il arrivera.
DORIMANTE.	DORIMANTE.
Mais les plaintes que vous en faites, en auancent la peine.	Mais les plaintes que vous en faites, en avancent la peine.
POLI.	POLI.
Elles meſmes l’adouciſſent auſſi par le ſoulagement que i’en reçoy.	Elles mêmes l'adoucissent aussi par le soulagement que j'en reçois.
DORIMANTE.	DORIMANTE.
Nous rendons ſouuent veritables des maux imaginaires, à force de les apprehender.	Nous rendons souvent véritables des maux imaginaires, à force de les appréhender.
POLI.	POLI.
Quand noſtre crainte eſt iuſte, il y a plus de verité que d’imagination.	Quand notre crainte est juste, il y a plus de vérité que d'imagination.
DORIMANTE.	DORIMANTE.
Mais tous les maux que nous apprehendons auec raiſon, ne nous arriuent pas.	Mais tous les maux que nous appréhendons toujours raison, ne nous arrivent pas.
Attendez du Temps & de la Fortune, ce que vous ne pouuez eſperer ny de l’Amour, ny de vos ſoins.	Attendez du Temps et de la Fortune, ce que vous ne pestés espérer ici de l'Amour, Seigneur de vos soins.
POLI.	POLI.
Ie m’en vay auſſi de ce pas étudier le Roy, pour conétre ſes amoureux deſſeins.	Je m'en vais aussi de ce pas étudier le Roi, pour conaître ses amoureux desseins.
Il neſçauroit ſi bien cacher ſa paſſion, que la mienne ne la découure.	Il nesçauroit si bien cacher sa passion, que la mienne ne la découvre.
Et en cela, cher amy, tes vœux me ſeront plus vtiles que tes conſeils.	Et en cela, cher ami, tes vœux me seront plus utiles que tes conseils.
LEE II CLIMENE.	LE II CLIMENE.
PANPHILIE, ſuiuies de deux Dames d’honneur.	PANPHILIE, suivies de deux Dames d'honneur.
CLIMENE.	CLIMENE.
L faut que ie vous confeſſe, ma ſœur, que les ciTuilitez de Poliarque m’ont touchée ſenſiblement;	L faut que je vous confesse, ma sœur, que les ciTuilités de Poliarque m'ont touchée sensiblement;
le le trouue ſi bien fait & ſi accomply en toutes choſes, que ſans conſiderer le bruit de ſa reputation, & moins encore l’éclat de ſa fortune, ie m’eſtime fort heureuſe de ne paſſer pas pour indiferente dans ſon eſprit.	le le trouve si bien fait et si accompli en toutes choses, que sans considérer le bruit de sa réputation, et moins encore l'éclat de sa fortune, je m'estime fort heureuse de ne passer pas pour indiférente dans son esprit.
PANPHILIE.	PANPHILIE.
Ie n’ay point remarqué d’excez en ſes ſoumiſſions;	Je n'ai point remarqué d'excès en ses soumission;
il vous a rendu ce qu’il vous deuoit.	il vous a rendu ce qu'il vous devait.
Et le iugement auantageux que vous en faites, procede pluſtoſt de linclination que vous auez à l’eſtimer, que de la connonſance qur vous demeure de ſon merite.	Et le jugement avantageux que vous en faites, procède plutôt de linclination que vous avez à l'estimer, que de la connonsance qur vous demeure de son mérite.
CLIMENE.	CLIMENE.
Il eſt vray que ſa bonne mine, ſes beaux diſcours, & la grace qui accompagnoit toutes ſes actions, m’ont tellement perſuadée à luy donner place dans mon eſtime, qu'à peine ay-ie eu la liberté d’y penſer auant que ie m’y ſois reſoluë.	Il est vrai que sa bonne mine, ses beaux discours, et la grâce qui accompagnait toutes ses actions, m'ont tellement persuadée à lui donner place dans mon estime, qu'à peine ai-je eu la liberté d'y penser avant que sans m'y sois résolue.
PANPHILIE.	PANPHILIE.
Ie croy que vous ne paſſerez pas de cette eſtime, à l’amour, ſi vous conſiderez la difference qu’il y a de voſtre condition à la ſienne.	Je crois que vous ne passerez pas de cette estime, à l'amour, si vous considérez la différence qu'il y a de votre condition à la sienne.
CLIMENE.	CLIMENE.
Vous voyez bien que cette qualité de Princeſſe que nous portons, ne nous a peu exemter des malheurs où nous iommes reduites.	Vous voyez bien que cette qualité de Princesse que nous portons, ne nous a peu exemter des malheurs où nous jommes réduites.
Ie ne ſuis pas en eſtat de refuſer les ſeruices d’vn fauory, apres auoir fait vn ſi long chemin, pour trouuer la protection de ſon Maiſtre.	Je ne suis pas en état de refuser les services d'un favori, après avoir fait un si long chemin, pour trouver la protection de son Maître.
PANPHILIE	PANPHILIE
IRMOIOMEDIE, 9	JRMOIOMEDIE, 9
PANPHILIE.	PANPHILIE.
Il ſemble que voſtre ambition releue de la Fortune.	Il semble que votre ambition relève de la Fortune.
Il faut que la grandeur de noſtre naïſſance, ſoit la meſure de nos deſſeins?	Il faut que la grandeur de notre naïssance, soit la mesure de nos desseins?
Quelque chemin que vous puiſſiez tenir, vous treuuerez vn iour à vos pieds, les meſmes coronnes dont vous voulez maintenant parer voſtre teſte	Quelque chemin que vous puissiez tenir, vous trouverez un jour à vos pieds, les mêmes coronnes dont vous voulez maintenant parer votre tête
CLIMENE.	CLIMENE.
Puis que nos grandeurs & nos felicitez ne ſubſiſtent que dans noſtre memoire, il faut perdre le ſouuenir de leur joüiſſance, pour nous exemter du regret de leur priuatlon.	Puis que nos grandeurs et nos félicités ne subsistent que dans notre mémoire, il faut perdre le souvenir de leur jouissance, pour nous exemter du regret de leur privatlon.
Et a meſme temps prenant conſeil de la neceſſité, nous deuons faire ce qu’elle veut, auant qu’elle nous y contraigne.	Et a même temps prenant conseil de la nécessité, nous devons faire ce qu'elle veut, avant qu'elle nous y contraigne.
PANPHILIE.	PANPHILIE.
Les perſonnes de noſtre condition ne cognoiſſent point d’autres Loix que celles de leur deuoir:	Les personnes de notre condition ne connaissent point d'autres Lois que celles de leur devoir:
Et la Fortune à beau les precipiter de leur trône;	Et la Fortune à beau les précipiter de leur trône;
elles en font toûjours vn nouueau de la place qu’elles occupent, & regnent, abſolument dans leurs miſeres, ſur elles meſmes, pour mettre toûjours leurs actions hors des attaintes de la cenſure.	elles en font toujours un nouveau de la place qu'elles occupent, et règnent, absolument dans leurs misères, sur elles mêmes, pour mettre toujours leurs actions hors des attaintes de la censure.
CLIMENE.	CLIMENE.
Il me ſemble que ie fay ce que ie dois, quand ie preſte l’oreille aux conſeils que la Prudence me donne;	Il me semble que vertu fais ce que ici dois, quand Elle prête l'oreille aux conseils que la Prudence me donne;
que ſi dans le malheur, ou ie me treuue, ie n’obſerue pas en mes actions, toute la decence que ie pourrois faire dans vne autre ſaiſon:	que si dans le malheur, ou ainsi me trouve, je n'observe pas en mes actions, toute la décence que personne pourrais faire dans autre saison:
Il ſuffit que ma conſcience ſoit en repos, & mon honneur à l’abry, tout le reſte paſſe pour fantaſie.	Il suffit que ma conscience soit en repos, et mon honneur à l'abri, tout le reste passe pour fantaisie.
PANPHILIE.	PANPHILIE.
Ce n’eſt pas aſſez, ce me ſemble, dans la condition où nous ſommes eleuées, de mettre noſtre conſcience en repos, & noſtre honneur à l’abry.	Ce n'est pas assez, ce me semble, dans la condition où nous sommes eleuées, de mettre notre conscience en repos, et notre honneur à l'abri.
Il faut encore que toutes nos actions portent auec elles l’éclat de noſtre naïſſance, pour faire taire l’Enuie à ſa propre confuſion.	Il faut encore que toutes nos actions portent avec elles l'éclat de notre naïssance, pour faire taire l'Enuie à sa propre confusion.
CLIMENE.	CLIMENE.
Encor que vous m'aimiez beaucoup, ie ſuis plus intereſſée que vous, a conſeruer mon honneur, & à terminer mes affaires.	Encor que vous m'aimiez beaucoup, je suis plus intéressée que vous, a conserver mon honneur, et à terminer mes affaires.
Vous auez plus de ſuict de ſuiure mon exemple, que ie n’ay de raiſon à croire vos conſeils.	Vous avez plus de sujet de suivre mon exemple, que je n'ai de raison à croire vos conseils.
PHANPHILIE.	PHANPHILIE.
Si mes conſeils ſont mauuais, ie vous feray voir que mes actions ſont exemptes de reproche.	Si mes conseils sont mauvais, on vous ferai voir que mes actions sont exemptes de reproche.
Cleonte duce toutes les grandeurs, n’a ſçeu encore obtenir de moy vn quart d’heure d’audience pour m’offrir ſon ſeruice.	Cléonte duce toutes les grandeurs, n'a su encore obtenir de moi un quart d'heure d'audience pour m'offrir son service.
CLIMENE.	CLIMENE.
Il y a plus de vanité, que de raiſon, en ce meſpris;	Il y a plus de vanité, que de raison, en ce mépris;
Les ſoins d’vne perſonne de ſa naïſſance & de ſa reputation, vous doiuent étre conſiderables.	Les soins d'une personne de sa naïssance et de sa réputation, vous doivent être considérables.
PANPHILIE.	PANPHILIE.
Son merite, ny ſa qualité, ne ſçauroient m’ôter l’aduerſion que i’ay pour luy.	Son mérite, ni sa qualité, ne sauraient m'ôter l'aversion que j'ai pour lui.
CLIMENE.	CLIMENE.
Et le merite & la qualité de Poliarque, ne ſçauroient faire changer l’inclination que i’ay à l’eſtimer plus que perſonne du monde.	Et le mérite et la qualité de Poliarque, ne sauraient faire changer l'inclination que j'ai à l'estimer plus que personne du monde.
PANPHILIE.	PANPHILIE.
Ie vous demande pardon, ſi i’ay choqué, ſans y penſer, vos ſentimens,	Je vous demande pardon, si j'ai choqué, sans y penser, vos sentiments,
CLIMENE.	CLIMENE.
Et ie vous laiſſe la liberté de ſuiure voſtre humeur;	Et ici vous laisse la liberté de suivre votre humeur;
allons atteſidie roffaique dans ma chambre, ie croy qu’il a deſſein de nous rendre viſite.	allons attesidie roffaique dans ma chambre, Elle crois qu'il a dessein de nous rendre visite.
PANPHILIE.	PANPHILIE.
Ie vous ſuiuray.	Je vous suivrai.
ALIVE III LE ROY.	ÀLIVE III LE ROY.
auec POLIARQVE ſon fauory.	Les POLIARQUE son favori.
LE ROY.	LE ROY.
Ve dis-tu de Climene, Poliarque, fut-il iamais rien de plus beau.	Ve dis-tu de Climène, Poliarque, fut-il jamais rien de plus beau.
.	.
.	.
POLIARQVE.	POLIARQUE.
Ie croy veritablement, que s’il y auoit vn ſecond prix pour la Beauté, elle l’emporteroit, ſans diſpute, ſi ſa ſœur n’y pretendoit pas.	Je crois véritablement, que s'il y avait un second prix pour la Beauté, elle l'emporterait, sans dispute, si sa sœur n'y prétendait pas.
LE ROY.	LE ROY.
Pamphilie luy eſt plus proche d’alliance, que de Beauté;	Pamphilie lui était plus proche d'alliance, que de Beauté;
Et tu m’auoüeras que quand le Nature duroit fait de ſes mains propres ces deux merueilles ſous vn meſme viſage, Climene ſeroit toujours l’original du pourtrait de ſa ſœur.	Et tu m'auoüeras que quand le Nature durait fait de ses mains propres ces deux merveilles sous un même visage, Climène serait toujours l'original du porttrait de sa sœur.
POLIARQVE.	POLIARQUE.
Quand il n’y auroit autre difference que celle que voſtre Maieſté ymet, elle ſera touſiours aſſez grande, pour diminuer l’eſtime de l’vne, en faueur de l'autre.	Quand il n'y aurait autre différence que celle que votre Majesté ymet, elle sera toujours assez grande, pour diminuer l'estime de l'une, en faveur de l'autre.
Tauoue que Cmnene à le droit d’aiſneſſe en toutes choſes ſur Panphilie;	Tavoue que Cmnène à le droit d'aînesse en toutes choses sur Panphilie;
Et cét auantage encore, qui ne ſouffre point de comparaiſon, d’étre conſiderée de voſtre Maieſté.	Et cet avantage encore, qui ne souffre point de comparaison, d'être considérée de votre Majesté.
LEROY.	LEROY.
Ie ne l’ay pas ſeulement conſiderée, Poliarque, mais admirée, & ſa beauté a ſi fort rauy mon eſprit, & aſſujety mes volontez, qu’en m’oſtant ce titre de Souuerain, elle en a pris le pouuoir, & ne m’en a laiſſé que les marques.	Je ne l'ai pas seulement considérée, Poliarque, mais admirée, et sa beauté a si fort ravi mon esprit, et assujet mes volontés, qu'en m'ôtant ce titre de Souverain, elle en a pris le pouvoir, et ne m'en a laissé que les marques.
Que ſi i’ay la li.	Que si j'ai la li.
berté toutesfois de porter le Sceptre à la main, ce n’eſt que pour le mettre à ſes pieds, en luy renouuellant les vœux de ma ſeruitude.	berté toutefois de porter le Sceptre à la main, ce n'est que pour le mettre à ses pieds, en lui renouvelant les vœux de ma servitude.
POLIARQVE.	POLIARQUE.
Comment, eſt il poſſible que dans ſi peu de temps, vile paiſion ir contrane a r'humieur de voſtre Maieſté, l’ait tout à fait changée.	Comment, est -il possible que dans si peu de temps, vile paision ir contrane a rhumieur de votre Majesté, l'ait tout à fait changée.
LE ROY.	LE ROY.
Meſure-tu la puiſſance des Dieux, auec celle des hommes.	Mesure-tu la puissance des Dieux, avec celle des hommes.
L’amour dans vn inſtant, auec vn ſeul regard des beaux yeux de Climene, s’eſt rendu maiſtre de ma Raiſon, apres auoir charmé mes ſens.	L'amour dans un instant, avec un seul regard des beaux yeux de Climène, s'est rendu ma de ma Raison, après avoir charmé mes sens.
Mes ſoûpirs t’en diront d’auantage, puis qu’ils ſortent de mon cœur, où tous ces miracles ont eſté faits.	Mes soupirs t'en diront d'avantage, puis qu'ils sortent de mon cœur, où tous ces miracles ont été faits.
POLIARQVE.	POLIARQUE.
La ſoumiſſion & la deferance que ie dois à voſtre Maieſté, me ſeruent de foy pour le croire.	La soumission et la déférence que je dois à votre Majesté, me servent de foi pour le croire.
LE ROY.	LE ROY.
Ceſſe de t'eſtonner, & commence de me ſecourir.	Cesse de t'étonner, et commence de me secourir.
Va t’en de ce pas luy repreſenter l’amour que I’ay pour elle:	Va t'en de ce pas homme représenter l'amour que J'ai pour elle:
Ie veux tenter ſa vertu pour en cognoiſtre le merite, preſſe là hardiment, ſi elle te reſiſte, ie me rendray en l’eſpouſant;	Je veux tenter sa vertu pour en connaître le mérite, presse là hardiment, si elle te résiste, Seigneur me rendrai en l'épousant;
& ſi elle ne ſe deffend pas, i’emporteray ſans combat le prix que ie deſire.	et si elle ne se défend pas, j'emporterai sans combat le prix que ie desire.
Il faut que la cognoiſſance precede l’Amour, ſi l’on veut eſtre fidelle.	Il faut que la connaissance précède l'Amour, si l'on veut être fidèle.
POLIARQVE.	POLIARQUE.
Ie n’auray pas beaucoup de peine d’executer les commandemens de voſtre Maieſté:	Je n'aurai pas beaucoup de peine d'exécuter les commandements de votre Majesté:
Mais i’apprehende, de l’humeur qu’elle eſt, que mon obeïſſance ne luy ſoit inutile.	Mais j'appréhende, de l'humeur qu'elle est, que mon obéissance ne lui soit inutile.
LE ROY.	LE ROY.
Refuſera t’elle vn Royaume, apres auoir perdu ſes Eſtats:	Refusera -t-elle un Royaume, après avoir perdu ses États:
Teſmoigne moy ſeulement que la paſſion que tu as de me ſeruir, s’interreſſe dans celle que i’ay de me ſatisfaire;	Témoigne moi seulement que la passion que tu as de me servir, s'interresse dans celle que j'ai de me satisfaire;
Les Roys ne ſont iamais malheureux en Amour.	Les Rois ne sont jamais malheureux en Amour.
POLIARQVE ſeul.	POLIARQUE seul.
Dis plutoſt, les Tyrans, puis qu’ils prenent par force ce que la raiſon leur refuſe.	Dis plutôt, les Tyrans, puis qu'ils prennent par force ce que la raison leur refuse.
En quel eſtat me voy ie reduit, d’auoir vn Roy pour Riual, dans vne paſſion qui me poſſede abſolument, & dont ie ne puis moderer la violence?	En quel état me vois venir réduit, d'avoir un Roi pour Rival, dans une passion qui me possède absolument, et dont ici ne puis modérer la violence?
Il eſt vray, ie ſuis n’ay ſon ſuiet;	Il est vrai, je suis n'ai son sujet;
Mais l’Amour veut que ie meure ſon eſclaue;	Mais l'Amour veut que ici meure son esclave;
à qui dois ie obeïr?	à qui dois assez obéir?
Cruel reſpect, aymable priſon, faſcheux obiet de mon deuoir, belle cauſe de mon inquietude, Raiſon, Amour, Nature, Honneur, terminez vos differens, & faites moy connétre ſenſiblement à quel de vous ie me doy rendre;	Cruel respect, aimable prison, fâcheux objet de mon devoir, belle cause de mon inquiétude, Raison, Amour, Nature, Honneur, terminez vos différents, et faites -moi connaître sensiblement à quel de vous je me dois rendre;
Ha!	Ha!
ie reſſens que vous eſtes d’accord, puiſque l’Honneur plus puiſſant & plus abſolu me contraint de ſubir les loix qu’il m’a déja preſcrites.	Ce ressens que vous êtes d'accord, puisque l'Honneur plus puissant et plus absolu me contraint de subir les lois qu'il m'a déjà prescrites.
Allons donc, puis qu’il le faut, allons dire à Climene que le Roy eſt ſon Amant, pour luy faire connétre que ie ne porte plus ce titre?	Allons donc, puis qu'il le faut, allons dire à Climène que le Roi est son Amant, pour lui faire connaître que personne ne porte plus ce titre?
ue ſi elle m’accuſe de trahiſon, repreſentons luy hardiment que ſa Beauté la trahie la premiere, m’ayant dome vn Riual qui n’en fouffre point.	Que si elle m'accuse de trahison, représentons g hardiment que sa Beauté la trahie la première, m'ayant dôme un Rivalu qui n'en souffre point.
AMAA TE	AMA TE
SCENE IREMIERE.	SCÈNE IREMIÈRE.
CLIMENE ſeule auec ſa confidente.	CLIMENE seule avec sa confidente.
8 Æ'AVOIS reſolu Doriſtée, d’attendre aſſii la vifite de Poliarque dans ma cham bre:	8 VOTRE EVOIS résolu Doristée, d'attendre assi la vifite de Poliarque dans ma cham bre:
mais la preſence de ma ſœur toûjours jalouſe du bon-heur qui me ſuit, me fait changer de deſſein, pour l’entretenir à ſon deſçeuà la premiere rencontre.	mais la présence de ma sœur toujours jalouse du bonheur qui me suit, me fait changer de dessein, pour l'entretenir à son desçeuà la première rencontre.
MELISTEE.	MELISTE.
Vn de ſes Pages vous a veuë ſortir de voſtre chambre;	Un de ses Pages vous a vue sortir de votre chambre;
& meſme ſi ie ne me trompe, il vous a ſuiuie, pour auertir ſon Maiſtre du chemin que vous tenez;	et même si ici ne me trompe, il vous a suivie, pour avertir son Maître du chemin que vous tenez;
le voicy qui vient.	le voici qui vient.
SUENE II POLIARQVE parlant à CLIMENE.	SUENE II POLIARQUE parlant à CLIMENE.
CLIMENE.	CLIMENE.
Monſieur, ie ne trouue rien d’eſtrange dans voitle nuieul volage, puiſque tous les hommes font inconſtans:	Monsieur, Seigneur ne trouve rien d'étrange dans voitle nuieul volage, puisque tous les hommes font inconstant:
Ie m’eſtonne ſeulement, qu’aprés auoir perdu le reſpect que vous deuez aux perſonnes de ma qualité, vous cherchiez encore des faux pretextes pour vous ſeruir d’excuſe.	Je m'étonne seulement, qu'après avoir perdu le respect que vous devez aux personnes de ma qualité, vous cherchiez encore des faux prétextes pour vous servir d'excuse.
POLIARQVE.	POLIARQUE.
Les aſſeurances que le Roy m’a données de l’amour qu’il a pour vous, ſont les ſeuls pretextes, dont ie me ſers pour mcuior mon changement.	Les assurances que le Roi m'a données de l'amour qu'il a pour vous, sont les seuls prétextes, dont une me sers pour mcuior mon changement.
CLIMENE.	CLIMENE.
Serois-je ſi malheureuſe, d’auoir quelque choſc en moy qui pleût à ſa Majeſté.	Serais-je si malheureuse, d'avoir quelque chosc en moi qui pleut à sa Majesté.
POLIARQVE.	POLIARQUE.
Mettez-vous au rang de vos malheurs, la fin de vos diſgraces:	Mettez-vous au rang de vos malheurs, la fin de vos disgrâces:
voſtre fortune eſt hors de comparaiſon.	votre fortune est hors de comparaison.
CLIMENE.	CLIMENE.
Les perſonnes de ma condition ne font iamais fortune.	Les personnes de ma condition ne font jamais fortune.
La Nature en naiſſant m’a mis le Sceptre à la main, & ma teſte eſt accouſtumée dés le berceau à porter des coronnes;	La Nature en naissant m'a mis le Sceptre à la main, et ma tête est accoutumée dès le berceau à porter des coronnes;
Que ſi la Tyranie aujourd’huy me priue de tous les deux:	Que si la Tyranie aujourd'hui me prive de tous les deux:
cette conſolation me demeure de les pouuoir porter quand il me plaira.	cette consolation me demeure de les pouvoir porter quand il me plaira.
POLIARQVE.	POLIARQUE.
Ie veux croire que voſtre Grandeur égalle voſtre Beauté:	Je veux croire que votre Grandeur égalle votre Beauté:
mais ce ne ſera pas ternir l’eſclat de l’vne, ny offencer le merite de l’autre, d’auoir vn Roy pour ſeruiteur.	mais ce ne sera pas ternir l'éclat de l'une, ni offenser le mérite de l'autre, d'avoir un Roy pour serviteur.
CLIMENE, Ie voy bien que vous ne me connoiſſez pas, Si ie me ſuis rabaiſſée par vn excez de foibleſſe, iuſques au point d’agreer vos ciuilitez.	CLIMENE, Je vois bien que vous ne me connaissez pas, Si je me suis rabaissée par un excès de faiblesse, jusques au point d'agréer vos civilités.
Ie m’eſleue maintenant ſur le Trône de mes Peres par vne action de courage, pour regarder à mes pieds indiferemment les plus Grands Rois de la Terre.	Je m'élever maintenant sur le Trône de mes Pères par une action de courage, pour regarder à mes pieds indiféremment les plus Grands Rois de la Terre.
POLIARQVE.	POLIARQUE.
Ce n’eſt pas aſſez de vous eſleuer de penſée ſur le Trône de vos Ayeuls.	Ce n'est pas assez de vous élever de pensée sur le Trône de vos Aussi.
Il faut qu’en effect vous en occupiez la place.	Il faut qu'en effet vous en occupiez la place.
Et ſa Majeſté en vous donnant ſon cœur, vous en offre les moyens.	Et sa Majesté en vous donnant son cœur, vous en offre les moyens.
CLIMENE.	CLIMENE.
On ne monte iamais ſur vn Trône d’honneur par les degtez de la fonte.	On ne monte jamais sur un Trône d'honneur par les dégtez de la fonte.
POLIARQVE.	POLIARQUE.
La Neceſſité eſt plus forte que la Raiſon.	La Nécessité est plus forte que la Raison.
Tout vous eſt permis en l’état où vous eſtes.	Tout vous est permis en l'état où vous êtes.
CLIMENE.	CLIMENE.
Il ſemble que vous me regardiez encore auec le meſme œil, que vous m’auez conſiderée lors que vous eûtes l’audace de m’offrir vos ſeruices:	Il semble que vous me regardiez encore auec le même œil, que vous m'avez considérée lors que vous eûtes l'audace de m'offrir vos services:
Ie n’ay point changé de condition pour auoir iſla puliſaſiée m'ert pas abroie cans ce Royaume, ma volonté la ſera toûjours dans mon deuoir.	Je n'ai point changé de condition pour avoir isla pulisasiée m'ert pas abroie cans ce Royaume, ma volonté la sera toujours dans mon devoir.
POLIARQVE.	POLIARQUE.
Ie veux croire qu’il y auoit autant d’audace en mon aſſioul, qu’il y a de Iuitiee en celle du Roy.	Je veux croire qu'il y avait autant d'audace en mon assioul, qu'il y a de Juitie en celle du Roi.
Oubliez donc la temerité de l’vne, & conſiderez l’importance de l’autre.	Oubliez donc la témérité de l'une, et considérez l'importance de l'autre.
CLIMENE.	CLIMENE.
le ne conſidere que mon intereſt.	le ne considère que mon intérêt.
Le Roy a beau chercher des Maiſtreſſes, il n’en treuuera iamais de ma qualité, & moins encore de mon humeur.	Le Roi a beau chercher des Maîtresses, il n'en trouvera jamais de ma qualité, et moins encore de mon humeur.
POLIARQVE.	POLIARQUE.
Il faut que vous ſoyez d’accord auec vousmeſme:	Il faut que vous soyez d'accord avec vousmesme:
vous demandez la protection du Roy, & vous refuſez ſes bonnes graces;	vous demandez la protection du Roi, et vous refusez ses bonnes grâces;
ce n’eſt pas le moyen de reuſſir en vos deſſeins.	ce n'est pas le moyen de réussir en vos desseins.
CLIMENE.	CLIMENE.
Quant ie demande ſa Protection, ſa Iuſtice & ſa C iij Bonté m’en permettent le deſir;	Quant ici demande sa Protection, sa Justice et sa Ç ij Onté m'en permettent le désir;
& quant il m’offre ſes bonnes graces, ma vertu & mon deuoir luy deffendent l’eſperance.	et quant il m'offre ses bonnes grâces, ma vertu et mon devoir homme défendent l'espérance.
POLIARQVE.	POLIARQUE.
Les ſoûpirs d’vn Roy n’offencent point les oreilles les plus chaſtes.	Les soupirs d'un Roy n'offensent point les oreilles les plus chastes.
CLIMENE.	CLIMENE.
Les mépris d’vne fille ne bleſſent iamais les yeux d’vn Amant.	Les mépris d'une fille ne blessent jamais les yeux d'une Amant.
POLIARQVE.	POLIARQUE.
Ce ſeroit bannir de vos actions les graces qui qui les accompagnent, de faire la deſdaigneuſe deuant ſa Majeſté.	Ce serait bannir de vos actions les grâces qui qui les accompagnent, de faire la dédaigneuse devant sa Majesté.
CLIMERM.	CLIMERM.
Puis que vous m’aprenez les diſcours qu’elle me doit tenir.	Puis que vous m'apprenez les discours qu'elle me doit tenir.
Ie ſçay la reſponce que ie luy dois faire.	Je sais la réponse que ie lui dois faire.
POLIARQVE.	POLIARQUE.
Où trouuerez-vous vne plus belle occaſion que celle qui ſe preſente, de conſeruer vos Eſtats.	Où trouverez-vous une plus belle occasion que celle qui se présente, de conserver vos États.
CLIMENE.	CLIMENE.
Ie n’en chercheray iamais de pareilles, pour y faire ma nouuelle entrée.	Je n'en chercherai jamais de pareilles, pour y faire ma nouvelle entrée.
C Vne amour extréme a des charmes inéuitables.	Ç Une amour extrême a des charmes inévitables.
CLIMENE.	CLIMENE.
Vne iniuſte paſſion a des malheureux confidens.	Une injuste passion a des malheureux confidents.
POLIANOYE.	POLIANOYE.
On auoüera toûjours en vous voyant, que la Paſſion du Roy eſt raiſonnable.	On auoüera toujours en vous voyant, que la Passion du Roi est raisonnable.
CLIMENE.	CLIMENE.
Et l’on peut connoiſtre apres vous auoir ouy, que vos deneis ne lont pas innocens.	Et l'on peut connaître après vous avoir oui, que vos dénéis ne lont pas innocents.
POLIARQVE.	POLIARQUE.
Ie ſuits les ſentimens de mon Maiſtre.	Je suits les sentiments de mon Maître.
CLIMENE.	CLIMENE.
Et moy ceux de la Vertu.	Et moi ceux de la Vertu.
POLIARQVE.	POLIARQUE.
Mais quelle ſatisfaction donneray-je de voſtre part à ſa Majeſté.	Mais quelle satisfaction donnerai-je de votre part à sa Majesté.
CLIMENE.	CLIMENE.
Celle de ne perdre point ſon temps, & de ſoulager vos peines.	Celle de ne perdre point son temps, et de soulager vos peines.
PODIARQVE.	PODIARQUE.
L’honneur que le Roy vous faict n’eſt pas à refuſer.	L'honneur que le Roi vous fait n'est pas à refuser.
CLIMENE.	CLIMENE.
Celuy qu’il pretend n'eit pas à vendre.	Celui qu'il prétend n'éit pas à vendre.
POLIARQVE.	POLIARQUE.
Donnez luy au moins quelque eſperance.	Donnez mieux au moins quelque espérance.
CLIMENE.	CLIMENE.
H Ie ne fay iamais des preſens inutiles.	H Je ne fais jamais des présents inutiles.
POLIARQVE.	POLIARQUE.
Vous ſuiuez vn mauuais conſeil.	Vous suivez un mauvais conseil.
CLIMENE.	CLIMENE.
CLIMENE.	CLIMENE.
Vous tenez vn mauuais chemin.	Vous tenez un mauvais chemin.
POBIIRRQVE.	POBIIRQUE.
Aprenez m’en vn plus beau.	Apprenez m'en un plus beau.
CLIMENE.	CLIMENE.
Retournez lur ros pas;	Retournez lur ros pas;
ce ne vous engagez plus dans vne carriere, où le regret & la honte vous attendent au bout.	ce ne vous engagez plus dans une carrière, où le regret et la honte vous attendent au bout.
SCENE POLIARQVE ſeul.	SCÈNE POLIARQUE seul.
III	III
VE fa rigueur me plaiſt:	VE fa rigueur me plaît:
que ſes mépris  ſont doux en reſiſtant à ces attaques:	que ses mépris sont doux en résistant à ces attaques:
Il me ſemble qu’elle ſe defend pour moy, auſſi bien que pour elle.	Il me semble qu'elle se défend pour moi, aussi bien que pour elle.
I’ay ſuby toutesfois les loix de mon deuoir, & violé celles de mon Amour.	J'ai sujet toutefois les lois de mon devoir, et violé celles de mon Amour.
I’ay paru tout de glace au milieu de mes flâmes.	J'ai paru tout de glace au milieu de mes flammes.
I’ay caché ma paſſion pour faire conneſtre celle du Roy.	J'ai caché ma passion pour faire connaître celle du Roi.
Que ſi mon obeïſſance & ma fidelité reuſſiſſent ſans y penſer à ſon deſauantage.	Que si mon obéissance et ma fidélité réussissent sans y penser à son désavantage.
Ie ne ſçaurois me plaindre de ma bonne Fortune, Il me ſuffit d’eſtre innocent.	Je ne saurais me plaindre de ma bonne Fortune, Il me suffit d'être innocent.
8 AEATE IV PAMPHILIE auec ſa Confidente.	8 AEATE IV PAMPHILIE était sa Confidente.
PANPHILIE.	PANPHILIE.
VE ie ſuis inquietée, Vranie, depuis noſtre Parriuée en cette Cour:	VE soins suis inquiétée, Vranie, depuis notre Parriuée en cette Cour:
i'y cherche les plaiis que les auties y trouuene, iy attens les felicitez dont tout le monde iouïſt;	j'y cherche les plaiis que les auties y trouvène, ji attends les félicités dont tout le monde iouïst;
& quoy que l’objet de mes deſirs y ſoit toûjours preſent, le deſeſpoir de le poſſeder me faict ſoûpirer de ſon abſcence.	et quoi que l'objet de mes désirs y soit toujours présent, le désespoir de le posséder me fait soupirer de son abscence.
VRANIE.	VRANIE.
Si vous ne me faites mieux connoiſtre voſtre mal, vous m’oſtez le moyen d’y apporter du remede.	Si vous ne me faites mieux connaître votre mal, vous m'ôtez le moyen d'y apporter du remède.
PANPHILIE.	PANPHILIE.
Mon mal eſt de telle nature, que bien loin de le guerir, ie perds tous les iours l’eſperance de le voir ſoulagé.	Mon mal est de telle nature, que bien loin de le guérir, Elle perds tous les jours l'espérance de le voir soulagé.
VRANIE.	VRANIE.
Ce n’eſt fien dire encore pour ma ſatisfaction, contentez ma curioſité, & tirez-moy de peine.	Ce n'est sien dire encore pour ma satisfaction, contentez ma curiosité, et tirez-moi de peine.
PANPHILIE.	PANPHILIE.
Mon denen veut que l'ayme Poliarque, Vranie, parce que ie luy ſuis indiferente:	Mon den veut que l'aime Poliarque, Vranie, parce que ie cy suis indiférente:
iuge de l’excés de ma douleur, par la neceſſité de ſon mépris.	juge de l'excès de ma douleur, par la nécessité de son mépris.
VRANIE.	VRANIE.
Il ſe connoit bien dans l’alarme où vous eſtes, que c’eſt la premiere fois que voſtre cœur a ſoupiré d’Amour:	Il se connaît bien dans l'alarme où vous êtes, que c'est la première fois que votre cœur a soupiré d'Amour:
on guerit de ſa maladie lors qu’elle eſt deſeſperée, puis que l’eſperance ſeule luy ſert d’aliment.	on guérit de sa maladie lors qu'elle est désespérée, puis que l'espérance seule lui sert d'aliment.
PANPHILIE.	PANPHILIE.
Chacun ayme à ſa façon, Vranie, & de l'humeur que ie ſuis, ie preuoy que la mort ſera le remede de mes peines.	Chacun aime à sa façon, Vranie, et de l'humeur que sans suis, Les preuoi que la mort sera le remède de mes peines.
VRANIE.	VRANIE.
Si Poliarque eſt libre, vous auez aſſez de meDI fite pour ronpgorinuon ne leſt pas, vous auez trop de raiſon pour vous plaindre inutilement.	Si Poliarque est libre, vous avez assez de méDI site pour ronpgorinuon ne lest pas, vous avez trop de raison pour vous plaindre inutilement.
PANPHILIE.	PANPHILIE.
Il eſt eſclaue auſſi bien que moy:	Il est esclave aussi bien que moi:
Mais noſtre ſort paroiſt bien different.	Mais notre sort paraît bien différend.
Il ſoûpire dans vne priſon, dont il apprehende la ſortie;	Il soupire dans une prison, dont il appréhende la sortie;
& ie me plains dans des fers que le temps, ny tes perſuaſions ne rompront iamais.	et petit me plains dans des fers que le temps, ni tes persuasions ne rompront jamais.
VRANIE.	VRANIE.
Ne peut on pas ſçauoir le nom de voſtre Riuale.	Ne peut on pas savoir le nom de votre Rivale.
PANPHILIE.	PANPHILIE.
Si ie te le dis, tu blaſmeras ma jalouſie, apres auoir condamné mon Amour :	Si grande te le dis, tu blâmeras ma jalousie, après avoir condamné mon Amour :
mais dans l’aueuglement où ie ſuis, ie ne connois perſonne;	mais dans l'aveuglement où tu suis, je ne connais personne;
e Bie llla leune	Je Bie llla lune
VRANIE.	VRANIE.
Pourquoy luy diſputez-vous l’auantage de vous auoir preuenuë dans le meſme deſſein que vous auiez.	Pourquoi était disputez-vous l'avantage de vous avoir prévenue dans le même dessein que vous aviez.
PANPHILIE.	PANPHILIE.
Ie ne ſçaurois luy diſputer le prix qu’elle a emporté:	Je ne saurais autre disputer le prix qu'elle a emporté:
mais i’enuie ſa fortune.	mais j'envie sa fortune.
VRANIE.	VRANIE.
Il y a de la foibleſſe d’enuier les felicitez que les autres poſſedent, rendez-vous heureuſe vousmeſme, puis que voſtre naiſſance & voſtre merite peuuent contribuer à ce deſſein.	Il y a de la faiblesse d'envier les félicités que les autres possèdent, rendez-vous heureuse vousmesme, puis que votre naissance et votre mérite peuvent contribuer à ce dessein.
Cleonte vous ayme auec paſſion, pretez l’oreille à ſa recherche, ſa qualité de Duc, vaut bien celle de Fauory.	Cléonte vous aime a pion, prêtez l'oreille à sa recherche, sa qualité de Duc, vaut bien celle de Favori.
PANPHILIE.	PANPHILIE.
Crois tu que nos ames ſe dépoüillent de leurs paſſions, de meſme que nos corps font de leurs habits:	Crois -tu que nos âmes se dépouillent de leurs passions, de même que nos corps font de leurs habits:
Comme elles nous ſurprenent auec plainiy enies louo illdiriliene duce violence:	Comme elles nous surprennent était plaini enies louo illdirilien ce violence:
Et c’eſt en vain, Vranie, que nous eſſayons ſouuent d’en rompre les fers;	Et c'est en vain, Vranie, que nous essayons souvent d'en rompre les fers;
il y a plus de bon-heur que d’adreſſe à reuſſir en céte entrepriſe:	il y a plus de bonheur que d'adresse à réussir en cette entreprise:
i’aymeray Poliarque iuſques au Tombeau.	j'aimerai Poliarque jusques au Tombeau.
VRANIE.	VRANIE.
Quel plaiſir prenez-vous à porter dans le ſein vn feu qui vous deuore:	Quel plaisir prenez-vous à porter dans le sein un feu qui vous dévore:
ſi voſtre Prudence n’en éteint l’ardeur de bonne heure, vous en mourrez vn iour de regret.	si votre Prudence n'en éteint l'ardeur de bonne heure, vous en mourrez un jour de regret.
PANPHILIE.	PANPHILIE.
Tu ne ſçait que c’eſt que d’aimer:	Tu ne sait que c'est que d'aimer:
vne ame attainte de céte paſſion, n’eſt capable que de ſuiure les ſentimens qu’elle nous inſpire;	une âme attainte de cette passion, n'est capable que de suivre les sentiments qu'elle nous inspire;
Et ſi la pudeur de noſtre ſexe ne moderoit en quelque ſorte la violance de ſes efforts, il n’eſt point d’extremité où nous ne fuſſions reduites:	Et si la pudeur de notre sexe ne modérait en quelque sorte la violance de ses efforts, il n'est point d'extrémité où nous ne fussions réduites:
Change de diſcours ou de conſeil.	Change de discours ou de conseil.
VRANIE.	VRANIE.
Mais quel eſt voſtre deſſein.	Mais quel est votre dessein.
PANPHILIE.	PANPHILIE.
D’executer ce que mon deſeſpoir me propoſe.	D'exécuter ce que mon désespoir me propose.
Le Roy eſt Riual de Poliarque;	Le Roi est Rival de Poliarque;
ie veux que la jalouſie de l’vn, gueriſſe l’Amour de l’autre, & que de la forte, ee ſemede cprouué me ſerue de ſoulagement.	Je veux que la jalousie de l'un, guérisse l'Amour de l'autre, et que de la forte, ce mède cprouvé me serve de soulagement.
Allons nous rendre ſçauantes ſur ce ſujet, pour faire reuſſir mon entreprſe.	Allons nous rendre savantes sur ce sujet, pour faire réussir mon entrepresse.
Mais voicy ce fâcheux Cleonte;	Mais voici ce fâcheux Cléonte;
Il me ſuit inceſſamment d’auſſi-prés que mon ombre.	Il me suit incessamment d'aussi-près que mon ombre.
VRANIE.	VRANIE.
Faites en vn nouuel Ixyon, & nourriſſez-le d’eſperance.	Faites en un nouuel Ixion, et nourrissez-le d'espérance.
SOENE CLEONTE ſeul.	ZONE CLEONTE seul.
V	V
PANPHILIE.	PANPHILIE.
Monſieur, ie reçoy à faueur les témoignages que vous me rendez de voſtre bonne volonté:	Monsieur, Seigneur reçois à faveur les témoignages que vous me rendez de votre bonne volonté:
Mais comme nous ſommes tous les iours à la veille de noſtre départ;	Mais comme nous sommes tous les jours à la veille de notre départ;
ie me trouue plus diſpoſée d’en conſeruer le ſouuenir, que d’en agréer la continuation.	Ne me trouve plus disposée d'en conserver le souvenir, que d'en agréer la continuation.
.	.
CLEONTE.	CLÉONTE.
Voſtre départ ny voſtre abſence ne ſçauroient diminuer l’affection que ie vous ay voüée, puis que voſtre ſeul merite en eſt l’objet.	Votre départ ni vostre absence ne sauraient diminuer l'affection que je vous ai vue, puis que votre seul mérite en est l'objet.
Il me ſuffit de me voir au nombre des ſeruiteurs qu’il vous a faict acquerir.	Il me suffit de me voir au nombre des serviteurs qu'il vous a fait acquérir.
PANPHILIE.	PANPHILIE.
Tous les Caualiers ſont ſeruiteurs des Dames.	Tous les Cavaliers sont serviteurs des Dames.
va.	va.
I’agrée vos ciuilitez ſans m’engager plus auant.	J'agrée vos civilités sans m'engager plus avant.
CLEONTE ſeul.	CLÉONTE seul.
Ie ne ſçay maintenant ſi ie me dois plaindre de ſes rigueurs, ou la loüer de ſes honeſtetez:	Je ne sais maintenant si ici me dois plaindre de ses rigueurs, ou la louer de ses honnêtetés:
mais en l’eſtat où elle m’a reduit, les plaintes me ſeroient inutiles, & les loüanges luy peuuent étre agreables.	mais en l'état où elle m'a réduit, les plaintes me seraient inutiles, et les louanges esprit peuvent être agréables.
Ie veux faire aujourd’huy de nouuelles maximes d’Amour, aymant ſans eſperance d’eſtre aymé;	Je veux faire aujourd'hui de nouvelles maximes d'Amour, aimant sans espérance d'être aimé;
Que ſi ma conſtance n’eſt pas coronnée, la ſatisfaction qui me demeurera d’auoir fait ce que ie deuois, me ſeruira toûjours de prix.	Que si ma constance n'est pas coronnée, la satisfaction qui me demeurera d'avoir fait ce que ie deuois, me servira toûjours de prix.
Et dans céte reſolution ie me donneray la liberté de luy eſcrire, ſi ie n’ay pas celle de la voir.	Et dans céte résolution je me donnerai la liberté de deux écrire, si notre n'ai pas celle de la voir.
SCENE	SCÈNE
SCETVE LE ROY auec ſon Fauory.	SCETUE LE ROY avec son Favori.
V L	V L
V es mal-heureux en amour, Poliarque, I l’Eloquence des Rois ſçait l’art de perſuader tout le monde.	V es malheureux en amour, Poliarque, I J'Éloquence des Rois sait l'art de persuader tout le monde.
Suis moy, ie te veux faire voir que mon authorité abſoluë, communiquant ſa vertu à mes paroles, elles forcent en priant, pour ne trouuer iamais de la reſiſtance.	Suis -moi, ie je veux faire voir que mon autorité absolue, communiquant sa vertu à mes paroles, elles forcent en priant, pour ne trouver jamais de la résistance.
POLIARQVE.	POLIARQUE.
Quand voſtre Majeſté n’auroit d’autre auantage ſur moy, que celuy de l’éclat qui l’enuironne, elle peut perſuader tout ce qu’elle veut.	Quand votre Majesté n'aurait d'autre avantage sur moi, que celui de l'éclat qui l'environne, elle peut persuader tout ce qu'elle veut.
45 LE ROY.	45 LE ROY.
Va-t’en luy dire ſeulement, que ie la prie de me donner vn quart d’heure de ſon entretien;	Va-t-en cy dire seulement, que je la prie de me donner un quart d'heure de son entretien;
& que ie l’euſſe eſté voir dans ſon apartement, ſi les diſcours que i’ay à luy tenir pouuoient ſouffrir la preſence de ſa ſœur.	et que ici l'eusse été voir dans son appartement, si les discours que j'ai à peine tenir pouvaient souffrir la présence de sa sœur.
l'obeïs.	l'obéis.
POLIARQVE.	POLIARQUE.
LE ROY.	LE ROY.
Ie me ſens tout étonné à ſes aproches.	Je me sens tout étonné à ses approches.
Amout fauoriſe mes deſſeins, & du meſme feu que tu brûles mon cœur, échauffe mon courage.	Amout favorise mes desseins, et du Seigneur feu que tu brûles mon cœur, échauffe mon courage.
ſ eM VIE LE ROY parlant à CLIMENE en preſence d’vne des Dames d’honneur, & de POLIARQVE.	s' eM ET DE ROY parlant à CLIMENE en présence d'une des Dames d'honneur, et de POLIARQUE.
LE ROY.	LE ROY.
Adame, ie ne viens-pas icy pour vous M faire des complimens, ny pour vous rendre mes ciuilitez;	Adame, Seigneur ne viens-pas ici pour vous M faire des compliments, Seigneur pour vous rendre mes civilités;
l’Amour m’y conduit, apres m’auoir bandé les yeux, pour ſubir aueuglement les loix que vous m’auez preſcrites.	L'Amour m'y conduit, après m'avoir bandé les yeux, pour subir aveuglement les lois que vous m'avez prescrites.
CLIMENE.	CLIMENE.
Sire, voſtre Majeſté a beau ſe rabaiſſer dans ſes ſoûmiſſions, le reſpect que ie luy dois m’eſt ſi ſenſible, que ie ne me relâcheray lamais vn ſeul moment de l’action de le luy rendre;	Sire, votre Majesté a beau se rabaisser dans ses soumission, le respect que ie luy dois m'est si sensible, que ieans me relâcherai lamais un seul moment de l'action de le lui rendre;
ie n’impoſe point de loix à mon Souuerain.	Elle n'impose point de lois à mon Souverain.
LE ROY.	LE ROY.
Voſtre merite m’a fait changer la qualité de Roy en celle d’eſclaue:	Votre mérite m'a fait changer la qualité de Roi en celle d'esclave:
Ie vous ayme, Madame, & comme vos yeux en ont imprimé la verité dans mon cœur auec des traits tous de flâme, ie me ſens brûler en vous le diſant.	Je vous aime, Madame, et comme vos yeux en ont imprimé la vérité dans mon cœur avec des traits tous de flamme, Seigneur me sens brûler en vous le disant.
CLIMENE.	CLIMENE.
le iuis obiigce de cione que v.	le juis objet de cione que v.
Majeſté me veut du bien, puis qu’elle m’en fait tous les iours:	Majesté me veut du bien, puis qu'elle m'en fait tous les jours:
Mais ſi ie reçoy à honneur les preuues de ſon amitié, celle de ſon Amour me tiennent lieu d’offence.	Mais si ici reçois à honneur les prévues de son amitié, celle de son Amour me tiennent lieu d'offense.
LE ROY.	LE ROY.
Si c’eſt vn crime de vous aymer, où treuuerez-vous des Innocens.	Si c'est un crime de vous aimer, où trouverez-vous des Inocents.
Et comment pourriezvous punir ceux que vous rendez coupables.	Et comment pourriezvous punir ceux que vous rendez coupables.
2--	2-
CLIMENE.	CLIMENE.
le ſuis aſſez vangée de leur oſter l’eſperances ie ne leur impoſe point d’autre chaſtiment.	le suis assez vengée de leur ôter l'espérances apprendre ne leur impose point d'autre châtiment.
LE ROY.	LE ROY.
Voſtre rigueur ne s’accorde pas auee voſtre beauté, il faut que vous changiez, ou d’humeur ou de viſage.	Votre rigueur ne s'accorde pas ave votre beauté, il faut que vous changiez, ou d'humeur ou de visage.
CLIMENE.	CLIMENE.
Ie changeray plutoſt de diſcours, en ſuppliant Voſtre Majeſté de terminer promptement mes affaires, pour auancer le iour de mon départ.	Je changerai plutôt de discours, en suppliant Votre Majesté de terminer promptement mes affaires, pour avancer le jour de mon départ.
LE ROY.	LE ROY.
Me pourriez-vous abandonner dans le deplorable Eſtat où vous m’auez reduit,	Me pourriez-vous abandonner dans le déplorable État où vous m'avez réduit,
CLIMENE.	CLIMENE.
Me voudriez-vous retenir dans la miſcrable condition où ie me trouue.	Me voudriez-vous retenir dans la miscrable condition où tu me trouve.
LE ROY.	LE ROY.
Comment voulez-vous que ie vous preſte mes armes pour vaincre vos ennemis, ſi vous n’eſtes entrée dans ce Royaume que pour triompher de moy-meſme.	Comment voulez-vous que votre vous prête mes armes pour vaincre vos ennemis, si vous n'êtes entrée dans ce Royaume que pour triompher de moi-même.
CLIMENE.	CLIMENE.
Vne perſonne qui attend voſtre ſecours, n’a pas deſſein de vous faire la guerre.	Une personne qui attend votre secours, n'a pas dessein de vous faire la guerre.
LE ROI.	LE ROI.
Et vn homme qui ſert d’objet à voſtre com-Ne paſſion, n'a pas le pouuoir de vous ſecourir.	Et un homme qui sert d'objet à votre com-Ne passion, n'a pas le pouvoir de vous secourir.
pas en	pas en
CLIMENE.	CLIMENE.
Où ſont les effets de vos promeſſes.	Où sont les effets de vos promesses.
LE ROY.	LE ROY.
Dans l’obeïſſance que ie vous ay voüée.	Dans l'obéissance que je vous ai vue.
CLIMENE.	CLIMENE.
le vous demande raiſon plutoſt que faueur,	le vous demande raison plutôt que faveur,
LE ROY.	LE ROY.
Et i'implore voſtre Bonté, plutoſt que voſtre Iuſtice.	Et j'implore votre Bonté, plutôt que votre Justice.
E n	ELLE n
CLIMENE.	CLIMENE.
Si mes prieres ne peuuent meriter voſtre protection, le Ciel ne la refuſera pas à mon innocence.	Si mes prières ne peuvent mériter votre protection, le Ciel ne la refusera pas à mon innocence.
LE ROY.	LE ROY.
Et ſi mes ſeruices ne me rendent dignes de voſtre Amour, le temps me vengera de voſtre mépris.	Et si mes services ne me rendent dignes de votre Amour, le temps me vengera de votre mépris.
CLIMENE.	CLIMENE.
C’eſt à moy à me plaindre, de celuy que vous faites de mes intereſts.	C'est à moi à me plaindre, de celui que vous faites de mes intérêts.
LE ROY.	LE ROY.
Ne me condemnez-pas ſans m’oüir.	Ne me condemnez-pas sans m'ouïr.
Vous voulez r’entrer dans vos Eſtats;	Vous voulez rentrer dans vos États;
Ie vous offre mon Royaume:	Je vous offre mon Royaume:
Pourquoy en refuſez-vous le Gouuernement?	Pourquoi en refusez-vous le Gouvernement?
CLIMENE.	CLIMENE.
Parce que la honte de l’acquerir eſt beauçoup plus grande, que la gloité de le poſſeder.	Parce que la honte de l'acquérir est beauçoup plus grande, que la gloité de le posséder.
LE ROY.	LE ROY.
Les Rois ſont des ſources d’honneur, dont ils comblent celles qu’ils ayment.	Les Rois sont des sources d'honneur, dont ils comblent celles qu'ils aiment.
CLIMENE.	CLIMENE.
Et les Princeſſes de mon humeur, des Images de vertu, dont enes laient Tadmiration à tous ceux qui les connoiſſent.	Et les Princesses de mon humeur, des Images de vertu, dont enes laient Tadmiration à tous ceux qui les connaissent.
LE ROY.	LE ROY.
Ie ſçay bien que vbitie eeputation eſt auſſi grande que voſtre Beauté:	Je sais bien que vbitie éputation est aussi grande que votre Beauté:
mais ſi l’vne a fait nâitre mon Amour, ne ſouffrez pas que l’autre la détruiſe.	mais si l'une a fait naître mon Amour, ne souffrez pas que l'autre la détruise.
CLIMENE.	CLIMENE.
Ma beauté ne ſçauroit faire que des Amants volages, parce que ſi elle donne le deſir, ma vertu oſte l’eſperance.	Ma beauté ne saurait faire que des Amants volages, parce que si elle donne le désir, ma vertu ôte l'espérance.
LE ROY.	LE ROY.
Il y a de l’excés dans voſtre cruauté.	Il y a de l'excès dans votre cruauté.
CLIMENE.	CLIMENE.
Il y a de la violence dans vos pourſuites.	Il y a de la violence dans vos poursuites.
LE ROY.	LE ROY.
Qui peut condamner mon Amour.	Qui peut condamner mon Amour.
CLIMENE.	CLIMENE.
Qui peut blaſmer le mépris que i’en fay?	Qui peut blâmer le mépris que j'en fais?
LE ROY.	LE ROY.
Vous deuriez conſiderer qui ie ſuis.	Vous devriez considérer qui tu suis.
CLIMENE.	CLIMENE.
Le bandeau que vous portez m’empeſche de vous connoiſtre.	Le bandeau que vous portez m'empêche de vous connaître.
LE ROT.	LE ROT.
Quant vous ne me verriez pas, ie me fay aſſez entendre.	Quant vous ne me verriez pas, Seigneur me fais assez entendre.
CLIMENE.	CLIMENE.
Les diſcours d'in cielaue iont bien differens de ceux d’vn Roy.	Les discours d'in cielave jont bien différents de ceux d'un Roi.
LE ROI.	LE ROI.
m.	m.
1 Ie parle le langage que l’Amour m’a appris.	1 Je parle le langage que l'Amour m'a appris.
CLIMENE.	CLIMENE.
Et moy celuy que la raiſon m’enſeigne,	Et moi celui que la raison m'enseigne,
LE ROY.	LE ROY.
Serez-vous touſiours inſenſible, & à mes ſoüpirs pirs & a mes larmes.	Serez-vous toujours insensible, et à mes soupirs pirs et à mes larmes.
CLIMENE.	CLIMENE.
Mon cœur eſt vn rocher au milieu de ces orages.	Mon cœur est un rocher au milieu de ces orages.
A Re l.	À Re l.
Ie vous feray la plus grande du monde.	Je vous ferai la plus grande du monde.
CLIMENE.	CLIMENE.
La Nature vous a preuenu;	La Nature vous a prévenu;
celle qui mépriſe les grandeurs, eſt au deſſus d’elles.	celle qui méprise les grandeurs, est au dessus d'elles.
LE ROY.	LE ROY.
Souhaitez, demandez;	Souhaitez, demandez;
Ie defie voſtre ambition de donner des limites à l’enuie que i’ay de la ſatisfaire.	Je defie votre ambition de donner des limites à l'envie que j'ai de la satisfaire.
ODILADECD, Ie ſouhaite de mourir auec la meſme gloire que i’ay veſcu, & ie demande à V.	ODILADECD, Je souhaite de mourir avec la même gloire que j'ai vécu, et Seigneur demande à V.
Majeſté cette grace de le croire, afin qu’elle change de deſ- Ele ſein:	Majesté cette grâce de le croire, afin qu'elle change de des- Le sein:
Ie n’ay point d’autre ambition.	Je n'ai point d'autre ambition.
LE ROY ſeul auec POLIARQVE.	LE ROY seul homme POLIARQUE.
Ha!	Ha!
que cét orgueil ſied bien à ſa Bcauté, & ce mepris à ſa Vertu:	que cet orgueil sied bien à sa Bcauté, et ce mépris à sa Vertu:
Que tout le monde admire ſes graces, ie veux adorer ſa rigueur;	Que tout le monde admire ses grâces, on veux adorer sa rigueur;
Qu’on ſe plaigne de ſa cruauté, ie ne ſçaurois ſoupirer d’Amour que pour elle.	Qu'on se plaigne de sa cruauté, on ne saurais soupirer d'Amour que pour elle.
Mais ſi faut-il l’attaquer de nouueau, pour luy faire acquerir des nouuelles coronnes;	Mais si faut-il l'attaquer de nouveau, pour lui faire acquérir des nouvelles coronnes;
dis-luy hardiment que mon Amour s’eſt changée en fureur à force de mépris;	dis-lui hardiment que mon Amour s'est changée en fureur à force de mépris;
& que cette paſſion toûjours aueugle ayant allumé ſon funeſte flambeau des dernieres eſtincelles du feu dont i’eſtois embraſé;	et que cette passion toujours aveugle ayant allumé son funeste flambeau des dernières étincelles du feu dont j'étais embrasé;
elle demande ces cendres pour l’aſſouuir, ou ſon honneur pour me ſatisfaire.	elle demande ces cendres pour l'assouvir, ou son honneur pour me satisfaire.
Que ſi dans ce dernier combat ie me trouue vaincu, ie partageray auec elle les coronnes de ſon Triomphe, pour le rendre plus glorieux.	Que si dans ce dernier combat On me trouve vaincu, quelque partagerai était elle les coronnes de son Triomphe, pour le rendre plus glorieux.
SCENE VIII.	SCÈNE VIII.
POLIARQVE feul.	POLIARQUE seul.
VEL rigoureux commandement:	VEL rigoureux commandement:
Quel LL eſtrange meſſage?	Quel LL étrange message?
Ie vay attaquer vn ennemy, dont la defaite ne me peut eſtre que funeſte:	Je vais attaquer un ennemi, dont la défaite ne me peut être que funeste:
car s’il ſe rend à mes efforts, il me mene en triomphe pour me faire voir toutes mes eſperances enſeuelies:	car s'il se rend à mes efforts, il me mène en triomphe pour me faire voir toutes mes espérances ensevelies:
& s’il y reſiſte, ie me trouue toûjours vaincu par mon malheur, puis qu’on me doit rauir le bien de mon attente.	et s'il y résiste, Seigneur me trouve toujours vaincu par mon malheur, puis qu'on me doit ravir le bien de mon attente.
Dure neceſſité inexorable à mes vœux?	Dure nécessité inexorable à mes vœux?
quel perſonnage me faistu faire:	quel personnage me faistu faire:
Inſatiable deuoir, Tyran des ames Amoureuſes, à quelle extremité me reduis tu?	Insatiable devoir, Tyran des âmes Amoureuses, à quelle extrémité me réduis tu?
I’aime, ie ſuis aimé;	J'aime, Madame suis aimé;
& il ne m’eſt permis de ſoupirer que de mon malheur;	et il ne m'est permis de soupirer que de mon malheur;
encore faut il que ce ſoit en cachetes, de peur que ces ſoupirs témoins de ma douleur ne le ſoient de mon Amour?	encore faut -il que ce soit en cachetés, de peur que ces soupirs témoins de ma douleur ne le soient de mon Amour?
Mais à quoy ſert-il de murmurer contre ſon Deſtin, puis que les Loix en ſont inuiolables, il faut ſe reſoudre à l’obeïſſance, ſi ie ne le ſuis il m'entrainera.	Mais à quoi sert-il de murmurer contre son Destin, puis que les Lois en sont inviolables, il faut se résoudre à l'obéissance, si tu ne le suis il m'entra.
LITE ETR	LITE ETR
SCENE IREMIERE.	SCÈNE IREMIÈRE.
PANPHILIE auec ſa confidente.	PANPHILIE avec sa confidente.
BE ne ſçaurois plus viure en l'eſtat où V ie fuis, Vranie, il faut que ie cherche le repos ou la mort;	BE ne saurais plus vivre en l'état où V ie fuis, Vranie, il faut que a cherche le repos ou la mort;
Poliarque eſt paſſionnément amoureux de ma ſœur, auſſi bien que le Roy:	Poliarque est passionnément amoureux de ma sœur, aussi bien que le Roi:
Et comme il ne peut eſtre confident de fon Riual ſans le trahir, en éloignant ſa Majeſté de ſon deſſein, il empeſche que à ma recherche, mais les ſoins en ſeront inutiles tandis qu’il ſera Amoureux de ma ſœur:	Et comme il ne peut être confident de son Rival sans le trahir, en éloignant sa Majesté de son dessein, il empêche que à ma recherche, mais les soins en seront inutiles tandis qu'il sera Amoureux de ma sœur:
ce qui me contraint de deſcouurir au Roy ſa trahiſon, puiſque ie ne ſçaurois l’acquerir ſans courre le hazard de le perdre.	ce qui me contraint de découvrir au Roi sa trahison, puisque ici ne saurais l'acquérir sans courre le hasard de le perdre.
VRANIE.	VRANIE.
Comment, eſt il poſſible que voſtre cœur ſoit touché egallement, & d’Amour & de haine pour vn meſme ſujet?	Comment, est -il possible que votre cœur soit touché également, et d'Amour et de haine pour un même sujet?
Vous aymez Poliarque auec paſſion, & dans l’excez de cette Amour vous coniurez ſa perte, par vn excez de haine;	Vous aimez Poliarque avec passion, et dans l'excès de cette Amour vous conjurez sa perte, par un excès de haine;
c’eſt ce que ie ne puis conceuoir.	c'est ce que Madame ne puis concevoir.
PANPHILIE.	PANPHILIE.
Ie ne trahis Poliarque que pour luy eſtre trop fidelle:	Je ne trahis Poliarque que pour lui être trop fidèle:
ſi i’hazarde ſa fortune, c’eſt pour le luiure dais ion mamſeur;	si j'hasarde sa fortune, c'est pour le lui dais ion mameur;
n'ie le mets mal dans l’eſprit du Roy, c’eſt pour le mieux placer dans mon ame:	n'ie le mets mal dans l'esprit du Roi, c'est pour le mieux placer dans mon âme:
de ſorte que ſi ma jalouſie le punit, mon Amour le recompenſera.	de sorte que si ma jalousie le punit, mon Amour le récompensera.
VRANIE.	VRANIE.
Il ne faut iamais hazarder les choſes qui nous ſont ſi cheres;	Il ne faut jamais hasarder les choses qui nous sont si chères;
vous allez mettre le glaiue & le flambeau dans la main d’vn aueugle, apres l’auoir piqué iuſques au vif, qui pourra donner des limites à ſa vengeance?	vous allez mettre le glaiue et le flambeau dans la main d'un aveugle, après l'avoir piqué jusqu' a voir, qui pourra donner des limites à sa vengeance?
PANPHILIE.	PANPHILIE.
Moy-meſme en m’expoſant la premiere aux fralcts de la fureur.	Moi-même en m'exposant la première aux fralcts de la fureur.
VRANIE.	VRANIE.
voitre perte le tirera pas fors du danger, celuy que vous aurez mis dedans.	voitre perte le tirera pas fors du danger, celui que vous aurez mis dedans.
PANPHILIE.	PANPHILIE.
Non:	Non:
mais i’en mourray de regret, pour en euiter les reproches.	mais j'en mourrai de regret, pour en éviter les reproches.
VXARIL.	VXARIL.
C'eſt vne foible conſolation de s'immoler ſur vn autel, où l’on a ſacrifié vne innocente Victime.	C'est quelque faible consolation de s'immoler sur un autel, où l'on a sacrifié une innocente Victime.
2 Aer lainlE.	2 Aer lainlE.
Mais c’eſt en expier le crime, en quelque façon, de chercher ſon tombeau dans le feu qui la lodule ala cendles	Mais c'est en expier le crime, en quelque façon, de chercher son tombeau dans le feu qui la lodule ala cendles
VRANIE.	VRANIE.
Pourquoy voulez-vous commencer vne faute, dont vous preuoyez déja le repentir.	Pourquoi voulez-vous commencer une faute, dont vous prévoyez déjà le repentir.
PANPHILIE.	PANPHILIE.
Parce que la preuoyance que i’en puis auoir ne le rend pas infallible, & dans l’eſtat où ie ſuis, ma perte eſt ineuitable.	Parce que la prévoyance que j'en puis avoir ne le rend pas infaillible, et dans l'état où grande suis, ma perte est inévitable.
VRANIE.	VRANIE.
Vous trompez le Roy.	Vous trompez le Roi.
PANPHILIE.	PANPHILIE.
C’eſt pour ſon contentement.	C'est pour son contentement.
VRANIE.	VRANIE.
Vous offencez voſtre ſœur.	Vous offensez votre sœur.
PANPHILIE.	PANPHILIE.
Cent poul lon plonts.	Cent poul lon plonts.
VRANIE.	VRANIE.
Vous calomniez Poliarque.	Vous calomniez Poliarque.
PANPHILIE.	PANPHILIE.
La meſme bouche qui l’accuſera le peut iuſtifier:	La même bouche qui l'accusera le peut justifier:
Tu me propoſe mille ſujets de crainte, mais i’en ay beaucoup plus d’eſperance.	Tu me propose mille sujets de crainte, mais j'en ai beaucoup plus d'espérance.
VRANIE.	VRANIE.
Que pouuez-vous eſperer de tous vos ſoins, ſi le ſuccez meſme n’en ſçauroit eſtre que funeſte.	Que pouvez-vous espérer de tous vos soins, si le succès belle n'en saurait être que funeste.
Ie veux que le Roy âjoute foy à vos diſcours, Poliarque eſt perdu:	Je veux que le Roi âjoute foi à vos discours, Poliarque est perdu:
Et quelle ſatisfaction tirerezvous de ſon dommage, ſi l’Amour que vous auez pour luy, vous le fait partager également?	Et quelle satisfaction tirerezvous de son dommage, si l'Amour que vous avez pour lui, vous le fait partager également?
PANPHILE.	PANPHILE.
Dans l’extrémité où ie me vois reduite, ie ne loligo qu'a toulager lu duuieur du mal que ic ſens, plutoſt qu’à guerir de la crainte de celuy dont tu me menaces.	Dans l'extrémité où tu me vois réduite, je ne loligo qu'a toulager lu duuieur du mal que ic sens, plutôt qu'à guérir de la crainte de celui dont tu me menaces.
VRANIE.	VRANIE.
Mais le mal que vous ſouffrez ne durera pas long temps, & celuy que vous préuoyez n’a point de remede.	Mais le mal que vous souffrez ne durera pas long temps, et celui que vous prévoyez n'a point de remède.
PANPHILE.	PANPHILE.
C’eſt trop raiſonner contre vne Amante;	C'est trop raisonner contre une Amante;
tritemoy en malade, puis que ie la ſuis;	tritemoi en malade, puis que je la suis;
ie ſçay bien que la paſſion qui me poſſede eſt aueugle:	Ne sais bien que la passion qui me possède est aveugle:
mais comme le peril où ie me trouue eſt beaucoup plus grand que celuy que ie dois encourir;	mais comme le péril où belle me trouve est beaucoup plus grand que celui que ici dois encourir;
ce m’eſt quelque ſorte de conſolation d’hazarder vne vie miſerable comme celle que ie traine.	ce m'est quelque sorte de consolation d'hasarder une vie misérable comme celle que ie traine.
VRANIE, Mais vous deuez conſiderer qu’en cette entrepriſe, priſe, voſtre honneur s’y trouue intereſſé.	VRANIE, Mais vous devez considérer qu'en cette entreprise, prise, votre honneur s'y trouve intéressé.
PANPHILE.	PANPHILE.
Il y a plus de conduite que d’imprudence;	Il y a plus de conduite que d'imprudence;
ſi Poliarque eſt coupable, ie le punis;	si Poliarque est coupable, ie le punis;
s’il eſt innocent, ie me ſatisfaits.	s'il est innocent, Seigneur me satisfaits.
SCI AVE POLIARQVE ſeul.	SCI AVE POLIARQUE seul.
II	II
E cherche par tout inutilement l’occaſion de Iparler à Climene.	E cherche par tout inutilement l'occasion de Iparler à Climène.
Ce n’eſt pas que ie ne la rencontre en mille lieux:	Ce n'est pas que ici ne la rencontre en mille lieux:
mais comme elle fuit mon abord, elle m’oſte toûjours le moyen de l’acoſter par l’ocupation qu’elle ſe donne.	mais comme elle fuit mon abord, elle m'ôte toujours le moyen de l'acôter par l'ocupation qu'elle se donne.
Vn de ſes Pages m’a dit qu’elle paſſera bien tôt par icy, pour aller viſiter ſa ſœur dans ſa chambre.	Un de ses Pages m'a dit qu'elle passera bien tôt par ici, pour aller visiter sa sœur dans sa chambre.
Il faut que ie l’attende;	Il faut que ici l'attende;
Ne la voy-je pas, c’eſt elle-meſme?	Ne la vois-je pas, c'est -elle-même?
Climene paſſant d’vn bout du Theatre à l’autre.	Climène passant d'une bout du Théâtre à l'autre.
SCLESM III.	SCLÊM III.
POLIARQVE parle.	POLIARQUE parle.
CLIMENE.	CLIMENE.
Que peut-elle pretendre de moy?	Que peut-elle prétendre de moi?
& qu’auezvous encore à me dire?	et qu'auezvous encore à me dire?
POLIARQVE.	POLIARQUE.
Que le Roy ne ſçauroit plus ſouffrir vos mépris en l’eſtat où il ſe trouue.	Que le Roi ne saurait plus souffrir vos mépris en l'état où il se trouve.
CLIMENE.	CLIMENE.
Ie ſuis rauie que ma vertu le mette en colere, elle me ſera toûjours plus agreable que ſon Amour	Je suis ravie que ma vertu le mette en colère, elle me sera toujours plus agréable que son Amour
POLIARQVE.	POLIARQUE.
Mais il eſt à craindre que cette Amour mépriſée, ne ſe change en tirannie.	Mais il est à craindre que cette Amour méprisée, ne se change en tyrannie.
CLIMENE.	CLIMENE.
I'aymie mieux encourle le pen par malheur, qu’en éuiter le dommage par la honte.	J'aimie mieux encourle le pen par malheur, qu'en éviter le dommage par la honte.
POLIARQVE.	POLIARQUE.
Quelle raiſon pouuez-vous tirer d’vn homme à qui vous l’auez oſtée.	Quelle raison pouvez-vous tirer d'un homme à qui vous l'avez ôtée.
CEIMEAE.	CEIMEAE.
Et quelle faueur ſçauroit-il pretendre d’vne Princeſſe qui n'en fiſt iamais?	Et quelle faveur saurait-il prétendre d'une Princesse qui n'en fit jamais?
ROBIMRCS Si vous conſiderez la violence de ſon Amour par le merite de voſtre Beauté, il eſt capable de tout entreprendre.	ROBIMRCS Si vous considérez la violence de son Amour par le mérite de votre Beauté, il est capable de tout entreprendre.
CLIMENE.	CLIMENE.
Et s’il connoit la grandeur de ma naiſſance par le ſeul bruit de ma reputation, il n’oſera rien executer.	Et s'il connaît la grandeur de ma naissance par le seul bruit de ma réputation, il n'osera rien exécuter.
POLIARQVE.	POLIARQUE.
Vne puiſſance abſoluë, ſe fait toújours craindre dans vne Amour extréme.	Une puissance absolue, se fait toujours craindre dans une Amour extrême.
CLIMENE.	CLIMENE.
Et vile grande vertu le fait toûjours reſpecter dans vne perſonne de ma condition.	Et vile grande vertu le fait toujours respecter dans une personne de ma condition.
AeBInR.	AeBInR.
Conſiderez le lieu où vous eſtes,	Considérez le lieu où vous êtes,
BIAENH.	BIANH.
Immole-t’on des Victimes ſur vn Autel de Refuge.	Immole-t-on des Victimes sur un Autel de Refuge.
POLIARQVE.	POLIARQUE.
Ceux qui font les Loix s’exemtent quand ils veulent de leur ſeruitude.	Ceux qui font les Lois s'exemptent quand ils veulent de leur servitude.
CLIMENE.	CLIMENE.
Et celles qui ne craignent point la mort, ſe moquent quand il leur plaiſt des Tyrans.	Et celles qui ne craignent point la mort, se moquent quand il leur plaît des Tyrans.
POLIARQVE ſeul.	POLIARQUE seul.
IV	IV
Velle force d’eſprit & de courage reluit tout  à la fois en cette grande Princeſſe.	Velle force d'esprit et de courage reluit tout à la fois en cette grande Princesse.
Apres eſtre precipitée de ſon Troſne, le Roy luy tend la main pour l’ayder à remonter deſſus, & elle la refuſe.	Après être précipitée de son Trône, le Roi quelque tend la main pour l'aider à remonter dessus, et elle la refuse.
Elle ſe voit reduite à la diſcretion de ſon ennemy, & au lieu de ſubir les loix qu’il luy a preſcrites, elle luy impoſe celle de ſon humeur, & le contraint à l’obeïſſance.	Elle se voit réduite à la discrétion de son ennemi, et au lieu de subir les lois qu'il lui a es, elle avait impose celle de son humeur, et le contraint à l'obéissance.
Que ie l’eſtime heureuſe dans ſon malheur.	Que quelque l'estime heureuse dans son malheur.
La Fortune croyant la ſurprendre par ſes ruſes, luy oſte la Coronne que la Nature luy a laiſſée en partage, & la donne à l’Amour pour la luyrendre à meſme temps:	La Fortune croyant la surprendre par ses ruses, lui ôte la Coronne que la Nature lui a laissée en partage, et la donne à l'Amour pour la luyrendre à même temps:
Mais le mépris qu’elle en fait, quoy qu’elle luy appartienne, luy érige maintenant vn Troſne tout nouueau à la honte de ces deux aueugles, où elle peut conſiderer à ſes pieds toutes les Grandeurs de la Terre.	Mais le mépris qu'elle en fait, quoi qu'elle avait appartienne, Seigneur érige maintenant un Trône tout nouveau à la honte de ces deux aveugles, où elle peut considérer à ses pieds toutes les Grandeurs de la Terre.
Mais pourquoy faut-il que ie loüe ſa Vertu?	Mais pourquoi faut-il que ici loue sa Vertu?
c’eſt elle ſeule auiourd’huy qui m’oſte l’eſperance.	c'est elle seule aujourd'hui qui m'ôte l'espérance.
Diray-je qu’il faut l’adorer?	Dirai-je qu'il faut l'adorer?
ſi ie dois eſtre la Victime de cette Idole, luy feray-ie dreſſer des autels pour eſtre immolé deſſus?	si ici dois être la Victime de cette Idole, Elle ferai-je dresser des autels pour être immolé dessus?
Ouy, ma paſſion dans ſon excez doit ceder par reſpect à la violance de celle de mon Maiſtre:	Oui, ma passion dans son excès doit céder par respect à la violance de celle de mon Maître:
Obeïſſons, la qualité de ſujet m’impoſe ſilence:	Obéissons, la qualité de sujet m'impose silence:
Mais ſi faut il le rompre pour ſon contentement.	Mais si faut il le rompre pour son contentement.
LE ROY.	LE ROY.
Et bien, Poliarque, quelle reſponce t’a-t’elle ldite.	Et bien, Poliarque, quelle réponse t'a-t-elle lédite.
POLIARQVE.	POLIARQUE.
Da miemne que voitre ſorajeite en a receuë.	Da miemne que voitre sorajeite en a reçue.
LE ROY.	LE ROY.
Mais voicy ſa ſœur, que veut-elle de moy?	Mais voici sa sœur, que veut-elle de moi?
SCENE PANPHILIE auec ſa Confidente.	SCÈNE PANPHILIE avec sa Confidente.
Ire, ie deſire parler à voſtre Majeſté, de O quelque affaire qui la touche.	Ire, Seigneur désire parler à votre Majesté, de Ô quelque affaire qui la touche.
LE ROY.	LE ROY.
Qu'vi chacun le fetne, qu'on me laiſſe igy ſeul.	Qu'est chacun le fène, qu'on me laisse igi seul.
PANPHILIE.	PANPHILIE.
Il eſt important que voſtre Majeſté ſçache la trahiſon de Poliarque;	Il est important que votre Majesté sache la trahison de Poliarque;
il ayme ma ſœur, & ne luy parle iamais que de ſa paſſion, au lieu de luy repreſenter l’amour que voſtre Majeſté a pour elle.	il aime ma sœur, et ne lui parle jamais que de sa passion, au lieu de lui représenter l'amour que votre Majesté a pour elle.
Ce qui m’a obligé, conſiderant l’honneur que voſtre Majeſté luy fait, & celuy que i’en reçoy, de luy en deceler le ſecret, afin qu’elle en tire ſon auantage.	Ce qui m'a obligé, considérant l'honneur que votre Majesté deux fait, et celui que j'en reçois, deeyne en déceler le secret, afin qu'elle en tire son avantage.
LE ROY.	LE ROY.
Que Poliarque ayme voſtre ſœur, eſtes-vous bien aſſeurée de ce que vous me dites?	Que Poliarque aime vôtre sœur, êtes-vous bien assurée de ce que vous me dites?
PANPHILIE.	PANPHILIE.
Apres auoir preſté ſouuent l’oreille à leurs diſcours, ie n’en ſçaurois plus douter:	Apres avoir prêté souvent l'oreille à leurs discours, ie j'en apprêtais plus douter:
Et voſtre Majeſté eſt obligée à le croire.	Et votre Majesté est obligée à le croire.
LE ROY.	LE ROY.
Poliarque Amoureux de Climene.	Poliarque Amoureux de Climène.
Il en mourra le perfide, & ſi le Soleil me reproche auiourd’huy cette honte d’auoir vn ſujet pour Riual, ie veux que ſa lumiere éclaire à ma vengeance pour éfacer les taches de ces reproches, ou dans ſes cendres, ou dans ſon ſang.	Il en mourra le perfide, et si le Soleil me reproche aujourd'hui cette honte d'avoir un sujet pour Rival, ie eût que sa lumière éclaire à ma vengeance pour éfacer les taches de ces reproches, ou dans ses cendres, ou dans son sang.
Page, qu’on appelle mon Capitaine des Gardes.	Page, qu'on appelle mon Capitaine des Gardes.
Climene ſouffre dans mon Palais la recherche de Poliarque, au meſme temps que ie luy témoigne l’Amour que i’ay pour elle:	Climène souffre dans mon Palais la recherche de Poliarque, au même temps que ielui oigne l'Amour que j'ai pour elle:
Son mépris & ſa feintiſe me font.	Son mépris et sa feintise me font.
changer de deſſ-in:	changer de dess-in:
Elle m’oſte l'eſperance, faiſons luy reſſentir mon deſeſpoir;	Elle m'ôte l'espérance, faisons lui ressentir mon désespoir;
Elle veut que ie meure, i’y conſens:	Elle veut que personne meure, j'y consens:
mais ie mourray de regret ou de ioye, apres auoir aſſouuy ma paſſion.	mais ici mourrai de regret ou de joie, après avoir assouie ma passion.
Le bandeau que vous portez, m’a t’elle dit, m’empeſche de vous connoiſtre, ie ray deſchiré, tu n’auras plus d’excuſe.	Le bandeau que vous portez, m'a -t-elle dit, m'empêche de vous connaître, ieclay déchiré, tu n'auras plus d'excuse.
Le langage d’vn Eſclaue, purſuiuoit-elle encor, eſt bien different de celuy d’vn Roy.	Le langage d'un Esclave, pursuivait-elle encor, est bien différent de celui d'un Roi.
Mes liens ſont rompus, chercherce d’autres pretextes.	Mes liens sont rompus, chercherce d'autres prétextes.
SCENE	SCÈNE
S CENE PHILAMON Capitaine des Gardes.	SEIGNEUR CÈNE PHILAMON Capitaine des Gardes.
I	I
LE ROY.	LE ROY.
DHilamon, va arreſter Poliarque, & mene-le Y dans la priſon de mon Palais, où perſonne ne le voye, ny ne luy parle.	DHilamon, va arrêter Poliarque, et mène-le Y dans la prison de mon Palais, où personne ne le voie, ni ne le parle.
Ta teſte me doit reſpondre de la ſienne:	Ta tête me doit répondre de la sienne:
Et ſans perdre temps ſur ſa depoſition, ie veux dés auiourd’huy luy faire reſſentir la peine de ſon crime.	Et sans perdre temps sur sa déposition, on veux dès aujourd'hui tu faire ressentir la peine de son crime.
PANPHILIE.	PANPHILIE.
Sire, ie demande à voſtre Majeſté la liberté de le voir, pour oſter d’abord le ſoupçon à ma ſœur, que ie ſuis ſa partie.	Sire, Seigneur demande à votre Majesté la liberté de le voir, pour ôter d'abord le soupçon à ma sœur, que ie suis sa partie.
LE ROY.	LE ROY.
Ie vous le permets, à condition que vous me rendrez ſçauant d’heure à autre de leurs nouuelles iutelligences.	Je vous le permets, à condition que vous me rendrez sçauant d'heure à autre de leurs nouvelles jutelligences.
PANPHILIE.	PANPHILIE.
Elle Ie ne manqueray pas, Sire.	Elle Ie ne manquerai pas, Sire.
LE ROY.	LE ROY.
Philamon, ie le laiſſe ſous ta garde, c’eſt vn criminel d’Eſtat, puis qu’il trouble le repos de ma vic.	Philamon, Seigneur le laisse sous ta garde, c'est un criminel d'État, puis qu'il trouble le repos de ma vic.
PHILAMON.	PHILAMON.
La mienne vous répond de luy.	La mienne vous répond de belle.
LE ROT.	LE ROT.
Va donc executer mes commandemens;	Va donc exécuter mes commandements;
& oite moy le miojeir de tuccuſer de pareſſe.	et oite moi le mioïrir de tuccuser de paresse.
TEHDHMON.	TEHDHMON.
Voſtre Majeſté verra bien toſt les effects de mon obeïſſance.	Votre Majesté verra bien tôt les effets de mon obéissance.
AIOTEE A V	AIOTE A V
SCENE IREMTERE.	SCÈNE IREMTERE.
PANPHILIE auec ſa Conſidente.	PANPHILIE avec sa Considente.
A chere Vranie!	À chère Vranie!
que les meſpris de tes conſeils ma déja coûté de ſoupirs, & des larmes:	que les mépris de tes conseils ma déjà coûté de soupirs, et des larmes:
le Roy eſt reſolu de faiM re mourir Poliarque, pour le punir du crime que i’ay commis.	le Roi est résolu de faiM ré mourir Poliarque, pour le punir du crime que j'ai commis.
Mais ie veux preuenir ſa vengeance, & me punir moy meſme la premiere, pour expier l’horreur de mon peché.	Mais ie veux prévenir sa vengeance, et me punir moi -même la première, pour expier l'horreur de mon péché.
VRANIE, Il ne faut pas que voſtre repentir luy ſoit intilve;	VRANIE, Il ne faut pas que votre repentir ton soit intilve;
puiſque vous l’auez ietté dans le peril où lſie trouue, ſongez aux moyens de reparer le dommage qu’il en peut encourir.	puisque vous l'avez jeté dans le péril où lie trouve, songez aux moyens de réparer le dommage qu'il en peut encourir.
PANPHILIE.	PANPHILIE.
Dés le moment que la colere du Roy luy fit prononcer ſon arreſt de mort, mon Amour me ſuggera l’inuention de luy ſauuer la vie, en demandant la liberté de le voir en priſon, afin que ma ſœur ne creût pas que ie l’euſſe trahie;	Dès le moment que la colère du Roy y fit prononcer son arrêt de mort, mon Amour me suggéra l'invention de rendre sauver la vie, en demandant la liberté de le voir en prison, afin que ma sœur ne crut pas que sans l'eusse trahie;
ce qu’il ni uecorda umeme temps:	ce qu'il ni ecorda umme temps:
de ſorte que ie le puis faire ſortir ſous mon habit, ſans eſtre connu de perſonne.	de sorte que personne le puis faire sortir sous mon habit, sans être connu de personne.
VRANIE.	VRANIE.
aauez vous le courage de Tentreprendre.	aavez -vous le courage de Tentreprendre.
PANPHILIE.	PANPHILIE.
As-tu la foibleſſe d’en douter.	As-tu la faiblesse d'en douter.
VRANIE.	VRANIE.
Ce deſſein me ſemble bien hardy, pour vne perſonne de voſtre condition.	Ce dessein me semble bien hardi, pour une personne de votre condition.
PANPHILIE.	PANPHILIE.
Dis plutoſt qu’il ne peut eſtre moins geneteux, pour vne fidelle Amante.	Dis plutôt qu'il ne peut être moins geneteux, pour une fidèle Amante.
VRANIE.	VRANIE.
Vous hazardez voſtre honneur.	Vous hasardez votre honneur.
PANPHILIE.	PANPHILIE.
Mais ie mets ma conſcience en repos.	Mais ici mets ma conscience en repos.
VRANIE.	VRANIE.
Vous courez danger de la vie.	Vous courez danger de la vie.
PARTIIEIE.	PARTIIEIE.
Ie voudrois déja eſtre au bout de ſa penible carriere.	Je voudrais déjà être au bout de sa pénible carrière.
VRANIE.	VRANIE.
Quel auantage eſperez-vous du ſuccez de voſtre entrepriſe.	Quel avantage espérez-vous du succès de votre entreprise.
PANPHILIE.	PANPHILIE.
Celuy de m’eſtre acquittée de mon deuoir.	Celui de m'être acquittée de mon devoir.
VRARTIE.	VRARTIE.
Il vous oblige de ſonger à voſtre ſalut.	Il vous oblige de songer à votre salut.
PANPHILIE.	PANPHILIE.
N’eſt-ce pas y penſer, que d’euiter la perte B1 de celuy que i’ayme plus que moy-meſme;	N'est-ce pas y penser, que d'éviter la perte B1 de celui que j'aime plus que moi-même;
l'Amour me reproche déja le temps que i’ay employé à eſcouter tes diſcours.	l'Amour me reproche déjà le temps que j'ai employé à écouter tes discours.
Page, allez dire de ma part à Philamon Capitaine des Gardes, qu’il me face ouurir de ce coſté icy, la porte de la enaiiore où Ponarque ole alronte priſonnier, & que i’ay enuie de le voir.	Page, allez dire de ma part à Philamon Capitaine des Gardes, qu'il me face ouvrir de ce côté ici, la porte de la enaijore où Ponarque ole alronte prisonnier, et que j'ai envie de le voir.
VRANIE.	VRANIE.
I'apprehende qu’vn nouueau malheur ne ſuccede à celuy qui vous eſt déja arriué.	J'appréhende qu'un nouveau malheur ne succède à celui qui vous est déjà arrivé.
PANPHILIE.	PANPHILIE.
Nos humeurs ſont auſſi differentes que nos conditions;	Nos humeurs sont aussi différentes que nos conditions;
Vranie, tu as toute la crainte, & i’ay tout l’Amour:	Vranie, tu as toute la crainte, et j'ai tout l'Amour:
Commance à aymer, & tu ceſſeras de craindre.	Commance à aimer, et tu cesseras de craindre.
NOE II PHILAMON Capitaine des Gardes.	NOE II PHILAMON Capitaine des Gardes.
Il ouure par dedans la porte de la chambre, où POLIARQVE eſt arreſté, & ſortant le premier, il parle à PANPHILIE.	Il ouvre par dedans la porte de la chambre, où POLIARQUE est arrêté, et sortant le premier, il parle à PANPHILIE.
PHILAMON.	PHILAMON.
Adame, le voicy qui vient, vous auez la 1i NTliberté de luy parler autant qu’il vous plaira.	Adame, le voici qui vient, vous avez la 1i NTliberté de lui parler autant qu'il vous plaira.
S'en va	S'en va
SCENTRIT POLIARQVE ſortant de la chambre où I'eſt areſte.	SCENTRIT POLIARQUE sortant de la chambre où J'est arête.
Onſieur;	Onsieur;
I'ay ſi peu de temps à vous en tretenir du deſſein qui m'amene icy, dans le peril où vous eſtes, que ie vous diray en peu de mots, que c’eſt moy ſeule qui vous y ay engagé.	J'ai si peu de temps à vous en tretenir du dessein qui m'amène ici, dans le péril où vous êtes, que je vous dirai en peu de mots, que c'est moi seule qui vous y ai engagé.
L’inclination que i’eus à vous eſtimer plus que toutes les perſonnes du monde, à mon arriuée en cette Cour, s’eſtant peu à peu changée en affection, ie deuins ſi jalouſe de ma ſœur, pour m’auoir preuenuë dans les meſmes ſentimens qu’elle auoit pour vous, que cette ialouſie m’a fourny d’inuention à vous accuſer de trahiſon enuers le Roy, l’aſſeurant que vous eſtiez ſon Riual, en la recherche de ma ſœur, & que meſme vous le deſſeruiez auprés d’elle, pour vous mettre mieux dans ſon eſprit.	L'inclination que j'eus à vous estimer plus que toutes les personnes du monde, à mon arrivée en cette Cour, s'étant peu à peu changée en affection, ie deuins si jalouse de ma sœur, pour m'avoir prévenue dans les mêmes sentiments qu'elle avait pour vous, que cette jalousie m'a fourni d'invention à vous accuser de trahison envers le Roi, l'assurant que vous étiez son Riual, en le recherche de ma sœur, et que même vous le desserviez auprès d'elle, pour vous mettre mieux dans son esprit.
Ce qu’il a creu auec tant de facilité, que ſe laiſſant emporter aux premiers mouuemens de ſa colere:	Ce qu'il a cru auec tant de facilité, que se laissant emporter aux premiers mouvements de sa colère:
il yous a fait arreſter priſonnier, auec ce funeſte deſſein de porter ſa vengeance iuſques au dernier ſupplice.	il y a fait arrêter prisonnier, avec ce funeste dessein de porter sa vengeance jusques au dernier supplice.
De vous demander maintenant pardon du crime que i’ay commis, voſtre merite m’en a donné la premiere penſée, & ma ialouſie, dont vous connoiſſez la cauſe, me la faite executer.	De vous demander maintenant pardon du crime que j'ai commis, votre mérite m'en a donné la première pensée, et ma jalousie, dont vous connaissez la cause, me la faite exécuter.
Il me ſuffit de vous teſmoigner dans le repentir qui men demeure, la reroſution que I’ay priſe de vous ſauuer, puiſque mon bon-heur m’en prepare les moyens.	Il me suffit de vous témoigner dans le repentir qui men demeure, la rerosution que J'ai prise de vous sauver, puisque mon bonheur m'en prépare les moyens.
POLIARQVE.	POLIARQUE.
Madame, vos diſcours me rendent ſi confus, que ie ne ſçay en quels termes ie vous doy reſpondre.	Madame, vos discours me rendent si confus, que personne ne sais en quels termes un vous dois répondre.
La vanité que vous me donnez dans l’eſtime que vous auez fait de moy, me ſurprend:	La vanité que vous me donnez dans l'estime que vous avez fait de moi, me surprend:
La ialouſie que vous auez euë de voſtre ſœur m’étonne, & le danger où vous m’auez expoſé, ſans vous auoir offencée, met encore mon eſprit dans vn nouueau deſordre.	La jalousie que vous avez eue de votre sœur m'étonne, et le danger où vous m'avez exposé, sans vous avoir offensée, met encore mon esprit dans un nouveau désordre.
Mais quand ie confidere d’vn autre coſté l’honneur que vous m’auez fait de ietter vosyeux ſur moy, l’auantage qui me demeure de l’affection que vous m’auez temoignée, & le regret que vous faites paroiſtre de m’auoir calomnié, ie me ſens plus obligé qu’offencé, & m’eſtime trop heureux dans mon malheur, que vous en ſoyez la ieule cauſe.	Mais quand ici considère d'vn autre côté l'honneur que vous m'avez fait de jeter vosyeux que moi, l'avantage qui me demeure de l'affection que vous m'avez témoignée, et le regret que vous faites paraître de m'avoir calomnié, tu me sens plus obligé qu'offensé, et m'estime trop heureux dans mon malheur, que vous en soyez la jeule cause.
PANPHILIE.	PANPHILIE.
Ie n’ay iamais douté de voſtre generoſité:	Je n'ai jamais douté de votre générosité:
mais ie veux vous faire connoiſtre la mienne.	mais grands veux vous faire connaître la mienne.
La liberté que le Roy m’a donnée de vous voir, ſous pretexte d’obliger ma ſœur, me ſert de moyen auiourd’huy de vous faire ſauuer en prenant mes habits, & ſortant de voſtre chambre auec Vranie, qui m’eſt fort fidele.	La liberté que le Roi m'a donnée de vous voir, sous prétexte d'obliger ma sœur, me sert de moyen aujourd'hui de vous faire sauver en prenant mes habits, et sortant de votre chambre avec Vranie, qui m'est fort fidèle.
Vous ferez voſtre retraite dans la Tour du Palais, dont Cleonte voſtre intime amy, & l'vn de mes nouueaux ſeruſteuis ent Gouuemeur, en attendant que i’aye adoucy la colere du Roy, apres luy auoir fait connoiſtre la verité de voſtre innocence, par la confeſſion de mon crime.	Vous ferez votre retraite dans la Tour du Palais, dont Cléonte votre intime ami, et l'un de mes nouveaux sérusteuis ent Gouuemeur, en attendant que j'aie adouci la colère du Roi, après lui avoir fait connaître la vérité de votre innocence, par la confession de mon crime.
POLIARQVE.	POLIARQUE.
I’ayme mieux perdre la vie, qu’intereſſer vôtre honneur.	J'aime mieux perdre la vie, qu'intéresser votre honneur.
PANPHILIE.	PANPHILIE.
Et il y va de mon honneur de vous ſauuer la vie.	Et il y va de mon honneur de vous sauver la vie.
POLIARQVE.	POLIARQUE.
Mon ſilence rendra voſtre crime inconnu, pour en éuiter les reproches.	Mon silence rendra votre crime inconnu, pour en éuiter les proches.
PANPHILIE.	PANPHILIE.
Mais ma conſcience me le reproche déja en ſecret, pour m’en faire porter la peine.	Mais ma conscience me le reproche déjà en secret, pour m'en faire porter la peine.
POLIARQVE, Si l’Amour vous a conſeillé de me rendre malheureux, ma diſgrace m’eſt plus agreable que voſtre repentir.	POLIARQUE, Si l'Amour vous a conseillé de me rendre malheureux, ma disgrâce m'est plus agréable que votre repentir.
PANPHILIE.	PANPHILIE.
Ie n’ay point changé de conſeil, encore que i’aye changé de deſſein.	Je n'ai point changé de conseil, encore que j'aie changé de dessein.
C’eſt luy-meſme qui me perſuade de vous ſauuer, & mon deuoir m’y contraint auec beaucoup de violence;	C'est lui-même qui me persuade de vous sauver, et mon devoir m'y contraint avec beaucoup de violence;
le temps nous eſt fort cher, ſeruez-vous de l’occaſion.	le temps nous est fort cher, servez-vous de l'occasion.
Ie reuiendray vous voir dans vn moment, ſous pretexte de vous apporter quelque nouuelle de la part du Roy, & i'entreray par dedans le Palais, afin de n’eſtre point veuë que de vos gardes;	Je reviendrai vous voir dans un moment, sous prétexte de vous apporter quelque nouvelle de la part du Roi, et j'entrerai par dedans le Palais, afin de n'être point vue que de vos gardes;
& cependant ie tireray parole de Cleonte de vous donner retraite dans la Tour, pour plus grande aſſeurance.	et cependant esprit tirerai parole de Cléonte de vous donner retraite dans la Tour, pour plus grande assurance.
POLIARQVE.	POLIARQUE.
Ie m’abandonne ſous voſtre protection;	Je m'abandonne sous votre protection;
i’ay fait perſuader Madame voſtre ſœur de s’y retirer auſſi dedans, auec deux ou trois de ſes Dames d’honneur, de peur que le Roy ne ſe porte à.	j'ai fait persuader Madame votre sœur de s'y retirer aussi dedans, avec deux ou trois de ses Dames d'honneur, de peur que le Roi ne se porte à.
quelque violance, à force de ialouſie;	quelque violance, à force de jalousie;
m’étant imaginé que quelqu’vn luy auoit decelé le ſecret de mon amour.	m'étant imaginé que quelqu'un lui avait décelé le secret de mon amour.
PANPHILIE.	PANPHILIE.
Ie prendray ſujet de l’aller viſiter pour luy deManuer paſuon de la ſemie faute, apres auoir eclaircy l’eſprit du Roy de toutes les meffiances qu’on luy peut auoir données:	Je prendrai sujet de l'aller visiter pour lui deManuer pasuon de la semie faute, après avoir éclairci l'esprit du Roi de toutes les méfiances qu'on tu peut avoir données:
Allez donner ordre à vos affaires.	Allez donner ordre à vos affaires.
POLIARQVE.	POLIARQUE.
Ie vous ſuis trop obligé de l’honneur de vos ſoins.	Je vous suis trop obligé de l'honneur de vos soins.
PANPHILIE.	PANPHILIE.
Ie vous reuerray bientoſt de la part du Roy.	Je vous réverrai bientôt de la part du Roi.
ce de & vous apporteray ſans doute de bonnes nouvon.	ce de et vous apporterai sans doute de bonnes nouvon.
uelles.	uelles.
PHILAMON.	PHILAMON.
Il ne ſçauroit perdre ſa cauſe, Madame, ſi ttrevous prenez la peine de la plaider.	Il ne saurait perdre sa cause, Madame, si ttrevous prenez la peine de la plaider.
LARVEIEIETO.	LARVEIEIETO.
Ses ſeuices parleront plus haut que moy.	Ses sévices parleront plus haut que moi.
PANPHILE ſeule auec ſa Confidente.	PANPHILE seule avec sa Confidente.
Tout reuſſit à mes deſſeins, ſi ie trouue l’occaſion de parler à Cleonte:	Tout réussit à mes desseins, si tu trouve l'occasion de parler à Cléonte:
Mais voicy vn de ſes Pages qui m’aprendra de ſes nouuelles.	Mais voici un de ses Pages qui m'apprendra de ses nouvelles.
OUERD T V LE PAGE DE CLEONTE.	OÙRD THÉ LE PAGE DE CLEONTE.
PANPHILIE.	PANPHILIE.
Dis luy qu’il la vienne querir luy-meſIti'en mes tout maintenant.	Disblé qu'il la vienne quérir lui-mesIti'en mes tout maintenant.
va.	va.
Elle continuë à parler.	Elle continue à parler.
Ie n’ay point enuie de lire cette letre.	Je n'ai point envie de lire cette letre.
VRANIE.	VRANIE.
Vous auez bien peu de curioſité.	Vous avez bien peu de curiosité.
On vous a dit, ſans doute, que l’Amour eſt contagieuſe:	On vous a dit, sans doute, que l'Amour est contagieuse:
llars il vous auez cette apprenenſion, liſez la tout bas, pour empeſcher que ſon venin ne ſe gliſſe dans l’oreille.	lars il vous avez cette apprenension, lisez la tout bas, pour empêcher que son venin ne se glisse dans l'oreille.
PANPHILIE.	PANPHILIE.
Ce n’eſt pas ce que i’aprehende;	Ce n'est pas ce que j'appréhende;
ſi le cœur n’eſt diſpoſé à receuoir ce poiſon, tous ſes efforts ſont inutiles;	si le cœur n'est disposé à recevoir ce poison, tous ses efforts sont inutiles;
ie te veux contenter.	On te veux contenter.
Ele l’ouure lit.	Éle l'ouvre lit.
LETRE DE CLEONTE à Panphilie.	LETRE DE CLÉONTE à Panphilie.
E reſpect que ie vous dois, ayant impoſé ſiUlence à mon Amour;	E respect que je vous dois, ayant imposé siUlence à mon Amour;
Elle m’a perſuadé de vous en témoigner la verité dans cette Letre:	Elle m'a persuadé de vous en témoigner la vérité dans cette Letre:
mais la crainte que i’ay que vos yeux ne la reduiſent en cendres, de méme que le cœur qui la dictée, m’oblige à vous aſſeurer encore vne fois, pour l’oſter promptement de vos mains;	mais la crainte que j'ai que vos yeux ne la réduisent en cendres, de même que le cœur qui la dictée, m'oblige à vous assurer encore une fois, pour l'ôter promptement de vos mains;
Que ie ſuis ſans feintiſe, & ſeray toute ma vie auec paßion,	Que ie suis sans feintise, et serai toute ma vie avec passion,
Voſtre tres-humble, tres-obeïſſant & tres-fidelle ſeruiteur, CLEONTE.	Votre très-humble, très-obeïssant et très-fidelle serviteur, CLÉONTE.
Madame,	Madame,
PANPHILIE.	PANPHILIE.
Voila des belles paroles, Vranie, pour perſuader celles qui ſe repaiſſent de vent, mais ie ne croy pas de leger:	Voilà des belles paroles, Vranie, pour persuader celles qui se repaissent de vent, mais Seigneur ne crois pas de léger:
le veux des longs ſeruices plutoſt que des beaux complimens, auant qu’adioûter foy à toutes ces Letres.	le veux des longs services plutôt que des beaux compliments, avant qu'ajouter foi à toutes ces Letres.
VRANIE.	VRANIE.
Vne perſonne de voſtre condition ne ſçauroit auoir trop de ſeruiteurs:	Une personne de votre condition ne saurait avoir trop de serviteurs:
il faut qu’elle prene ſoin oeir faire beaucoup, & de n’en perdre pas vn ſeul, puis que le plus inutile ſert toûjours à quelque choſe.	il faut qu'elle prène soin oéir faire beaucoup, et de n'en perdre pas un seul, puis que le plus inutile sert toujours à quelque chose.
Vous auez mépriſé Cleonte, & celuy qui vous eſtoit ſi indifferent, vous eſt auiourd’huy ſi neceſſaire.	Vous avez méprisé Cléonte, et celui qui vous était si indifférent, vous est aujourd'hui si nécessaire.
Le voicy, ſi ie ne me trompe.	Le voici, si belle ne me trompe.
SUEN I	SVEN I
CLEONTE.	CLÉONTE.
Irdaiſle, je vieris receuon de voſtre bouNIche, plutoſt que de vos mains, la réponſe de ma Letre, puis que vous me l’auez commandé.	Irdaisle, je vieris reçuon de votre bouNIche, plutôt que de vos mains, la réponse de ma Letre, puis que vous me l'avez commandé.
PANPHILIE.	PANPHILIE.
Receuez là donc, en vous aſſeurant qu’elle m'a eſte fort agreable:	Recez là donc, en vous assurant qu'elle m'a este fort agréable:
mais quelques proteſtations de fidelité que vous m’ayez faites, ie vous en demande des nouuelles preuues pour ma ſatisfaction.	mais quelques protestations de fidélité que vous m'ayez faites, je vous en demande des nouvelles preuves pour ma satisfaction.
CLEONTE.	CLÉONTE.
Voſtre mefiance me conuie d’honneur, en me donnant le moyen de paroiſtre fidelle.	Votre méfiance me convie d'honneur, en me donnant le moyen de paraître fidèle.
Faitesmoy connoiſtre vos deſirs, & ie vous feray voir mon obeïſſance.	Faitesmoy connaître vos désirs, et je vous ferai voir mon obéissance.
PANPHILIE.	PANPHILIE.
Vous auez ſceu comme le Roy eſtant amoureux reux de ma ſœur, & ialoux de Poliarque, la fait arreſter priſonnier dans ſon Palais, auec deſſein de luy faire trancher la teſte pour mettre la ſienne en repos.	Vous avez su comme le Roi étant amoureux reux de ma sœur, et jaloux de Poliarque, la fait arrêter prisonnier dans son Palais, avec dessein de lui faire trancher la tête pour mettre la sienne en repos.
Ie vous ſupplie maintenant dans la reſolution que i’ar priſe de le faire ſortir de priſon, de luy donner retraite dans voſtre Place, iuſques à ce que i’aye apaiſé la cholere du Roy.	Je vous supplie maintenant dans la résolution que j'ar prise de le faire sortir de prison, de lui donner retraite dans votre Place, jusques à ce que j'aie apaisé la colère du Roi.
Ie ſçay bien que vous hazardez beaucoup.	Je sais bien que vous hasardez beaucoup.
Mais apres vous auoir aſſeuré que ie ſeray moy-meſme voſtre recompenſe, en agreant la faueur de voſtre recherche, l’affection que vous m’auez témoignée, & le ſeruice que vous nous auez voüé, me perſuadent deſia que vous m’accorderez cette grace.	Mais après vous avoir assuré que femme serai moi-même votre récompense, en agréant la faveur de votre recherche, l'affection que vous m'avez témoignée, et le service que vous avez val voüé, me persuadent déjà que vous m'accorderez cette grâce.
CLEONTE.	CLÉONTE.
Madame, vn eſclaue ne ſçauroit faire grace à ſon maiſtre.	Madame, un esclave ne saurait faire grâce à son maître.
Il me ſuffit de vous dire encore vne fois, puis qu’il ſemble que vous l’ayez oublié, qu’en vous donnant mon cœur, ie vous ay mis ma vie & mon honneur entre les mains pour en diſpoſer abſolument, comme de la choſe du monde qui vous eſt la plus acquiſe.	Il me suffit de vous dire encore une fois, puis qu'il semble que vous l'ayez oublié, qu'en vous donnant mon cœur, je vous ai mis ma vie et mon honneur entre les mains pour en disposer absolument, comme de la chose du monde qui vous est la plus acquise.
Toutes les autres proteſtations que ie vous pourrois faire ſeroient inutiles, ſeruez vous du temps & de l’occaſion.	Toutes les autres protestations que je vous pourrais faire seraient inutiles, servez -vous du temps et de l'occasion.
Pagination incorrecte - date incorrecte NF Z 43-120-12	Pagination incorrecte - date incorrecte N Z 43-120-12
PANPHILIE.	PANPHILIE.
Ie prens voſtre parole, & vous laiſſe ma foy.	Je prends votre parole, et vous laisse ma foi.
CLEONTE ſeui.	CLÉONTE sévi.
Qu’ay ie dit, & qu’ay ie fait dans mon aueuglement.	Qu'ai ie dit, et qu'a ie fait dans mon aveuglément.
Mais que ne dirois ie pas, & que ne ferois-ie point encore durant le regne de ma paſſion.	Mais que ne dirais grande pas, et que ne ferais-je point encore durant le règne de ma passion.
M’arreſteray-je au milieu d’vne carriere, où l’amour meſme m’attend au bout pour me faire preſent de ſes myrthes.	M'arrêterai-je au milieu d'une carrière, où l'amour même m'attend au bout pour me faire présent de ses myrthes.
Ie ſçay bien que ie hazarde tout à la fois, mon honneur, ma vie, & ma fortune.	Je sais bien que Seigneur hasarde tout à la fois, mon honneur, ma vie, et ma fortune.
Mais de qui puis-ie prendre conſeil en I’eſtat où ie me treuue, ſi mes ſens & ma raiſon tiennent le party de Pamphilie contre moy-meſme.	Mais de qui puis-je prendre conseil en J'état où Elle me trouve, si mes sens et ma raison tiennent le parti de Pamphilie contre moi-même.
Les vns me repreſentent que ce n’eſt pas perdre l’honneur que de ſauuer vn Amant, pour obeïr à vne Maiſtreſſe:	Les uns me représentent que ce n'est pas perdre l'honneur que de sauver un Amant, pour obéir à une Maîtresse:
Et l’autre me fait cognoiſtre ſenſiblement, qu’en fuyant la mort qui s’offre à mes ycun, iccouis du deuant d’elle meſme par vn autre chemin que ie ſuis forcé de prendre?	Et l'autre me fait connaître sensiblement, qu'en fuyant la mort qui s'offre à mes ycun, jouis du devant d'elle même par un autre chemin que je suis forcé de prendre?
Foulons donc hardiment les épines qui ſe rencontrent ſous mes pieds, pour cueillir les roſes qui doiuent coronner ma teſte;	Foulons donc hardiment les épines qui se rencontrent sous mes pieds, pour cueillir les roses qui doivent coronner ma tête;
les delices que i’attends ſont plus conſiderables que les malheurs que ie puis encourir.	les délices que j'attends sont plus considérables que les malheurs que je puis encourir.
SCENE VII.	SCÈNE VII.
CLIMENE auec Doriſtene ſa confidente.	CLIMENE avec Doristène sa confidente.
CLIMENE.	CLIMENE.
L ſe faut ſauuer Doriſtene, le Roy a deſſein I lur mon nomneur, puis qu’il a fait arreſter Poliarque par vn excez de ialouſie, ſans l’accuſer d’autre crime que de celuy de m’aimer.	L se faut sauver Doristène, le Roi a dessein I lur mon nomneur, puis qu'il a fait arrêter Poliarque par un excès de jalousie, sans l'accuser d'autre crime que de celui de m'aimer.
DORBSTENE.	DORBSTENE.
Où pourrions-nous aller à l’heare qu’il eſt, ſans auoir vn lieu de retraite.	Où pourrions-nous aller à l'héare qu'il est, sans avoir un lieu de retraite.
CLIMENE.	CLIMENE.
Il faut nous retirer dans la tour, ſur l’aduis qu’on m’a donné que Cleonte qui en eſt Gouuerneur, nous y receura auec afſeurance de protection.	Il faut nous retirer dans la tour, sur l'avis qu'on m'a donné que Cléonte qui en est Gouverneur, nous y recevra avec acteurance de protection.
DORISTENE.	DORISTENE.
Vous perſuadez-vous qu’il prenne les armes contre ſon Maiſtre.	Vous persuadez-vous qu'il prenne les armes contre son Maître.
CLIMENE.	CLIMENE.
S’il ne les prends pas, ie m’en ſeruiray contre moy-meime pour deffendre mon honneur.	S'il ne les prends pas, Seigneur m'en servirai contre moi-même pour défendre mon honneur.
Fut il iamais Princeſſe plus, miſerable que moy.	Fut -il jamais Princesse plus, misérable que moi.
La mort ma rauy mes parens, la Tyrannie mes Eſtats, & pour vn ſurcroy de mal-heur, le Roy me veut rauir auiourd’huy toute la gloire qui me reſte, & aſſouuir ſes brutalles paſſions;	La mort ma ravi mes parents, la Tyrannie mes États, et pour un surcroi de malheur, le Roi me veut ravir aujourd'hui toute la gloire qui me reste, et assouvir ses brutales passions;
Mais ie luy feray connaiſtre à toute extremité que mon honneur tient ſi fort à ma vie, qu’on ne peut bleſſer l’vn ſans faire mourir l’autre?	Mais fort quelque ferai connaître à toute extrémité que mon honneur tient si fort à ma vie, qu'on ne peut blesser l'un sans faire mourir l'autre?
O Fortune!	Ô Fortune!
tu m’as oté tout ce que tu m’auois donné.	tu m'as oté tout ce que tu m'avais donné.
Mais ie te veux faire voir dans mes miſeres.	Mais ie te veux faire voir dans mes misères.
que ma vertu me comble de nouueaux treſors, & que mon courage ſeruant de clou pour arreſter ta roüe, elle n’aura plus d’autre mouuement que celuy de mes volontez.	que ma vertu me comble de nouveaux trésors, et que mon courage servant de clou pour arrêter ta rue, elle n'aura plus d'autre mouvement que celui de mes volontés.
DORISTENE.	DORISTENE.
Conſolez-vous, Madame, le Roy n’vſera ia.	Consolez-vous, Madame, le Roi n'usera ja.
mais de violence contre vne penonne de voſtre condition.	mais de violence contre une pénonne de votre condition.
CLIMENE.	CLIMENE.
Si la colere ſe fait craindre dans ſes premiers mouuemens, l’amour ne ſe fait pas moins redouter dans ſes continuelles violences?	Si la colère se fait craindre dans ses premiers mouvements, l'amour ne se fait pas moins redouter dans ses continuelles violences?
Et comme ces deux pailions font aucugles, erſcs authortſent l'horreur de leurs crimes de la neceſſité de leur bandeau.	Et comme ces deux pailions font aucugles, erscs authortsent l'horreur de leurs crimes de la nécessité de leur bandeau.
Ie veux me mettre à couuert de roruge dont ie ſuis menacée.	Je veux me mettre à couvert de roruge dont tu suis menacée.
DORISTENE.	DORISTENE.
Mais ſi vous aymez encore Poliarque, pourquoy l’abandonnez-vous dans le pemt’où il eſt.	Mais si vous aimez encore Poliarque, pourquoi l'abandonnez-vous dans le pemt'où il est.
CLIMENE.	CLIMENE.
Parce que ſon mal eſt de telle nature, qu’en le voulant ſoulager ie le rendrois incurable.	Parce que son mal est de telle nature, qu'en le voulant soulager personne le rendrais incurable.
DORISTENE.	DORISTENE.
La verité eſt touſiours plus puiſſante que la caK 1j lomnie:	La vérité est toujours plus puissante que la ca jà lomnie:
Son innocence & voſtre vertu triomplleront de tous ſes ennemis.	Son innocence et votre vertu triomplleront de tous ses ennemis.
CLIMENE.	CLIMENE.
Mais tu ne conſideres pas que ſon merite eſt le plus grand de tous;	Mais tu ne considères pas que son mérite est le plus grand de tous;
Si la ialouſie du Roy le rend coupable, comment veux-tu que mon amour le iuſtifie.	Si la jalousie du Roi le rend coupable, comment veux-tu que mon amour le justifie.
Ie ne ſçaurois luy donner que des vœux & des larmes, puis qu’il poſſede mon cœur.	Je ne saurais homme donner que des vœux et des larmes, puis qu'il possède mon cœur.
Songeons à noſtre retraite, le temps nous eſt trop cher.	Songeons à notre retraite, le temps nous est trop cher.
Fin du quatrieſme Acte.	Fin du quatrième Acte.
IA C T.	IA Ç T.
27	27
SCENE PREMIERE.	SCÈNE PREMIÈRE.
LE ROY paroiſſant ſur le haut de ſon Palais auec quelqu’vn des ſiens.	LE ROY paraissant sur le haut de son Palais sez quelqu'un des siens.
E voy le feu de mes Sacrifices allumé.	E vois le feu de mes Sacrifices allumé,
I’entens deſia les plaintes des victimes:	J'entends déjà les plaintes des victimes:
E La lumiere de ces flâmes deuorantes m’eſt vn nouueau Soleil au milieu de la nuict qui me fait voir le iour de ma vengeance;	 Elle lumière de ces flammes dévorantes m'est un nouveau Soleil au milieu de la nuit qui me fait voir le jour de ma vengeance;
Et ce bruit d’allarme & de tumulte ne parlant que de mort, en prononce l’Arreſt à mes ennemis, & l’execure à l’inſtant meſme.	Et ce bruit d'alarme et de tumulte ne parlant que de mort, en prononce l'Arrest à mes ennemis, et l'exécure à l'instant même.
Cette fumée a l’odeur de l’encens, puis que i’en ſuis tout à la fois, & l’Autel & l’Idole:	Cette fumée a l'odeur de l'encens, puis que j'en suis tout à la fois, et l'Autel et l'Idole:
Et tous ces cris dhorreur & d’effroy qui ſeruent d’épouuante à ceux meſmes qui les font éclater, changeant de nature à mes oreilles y reſonnent delicieuſement.	Et tous ces cris dhorreur et d'effroi qui servent d'épouvante à ceux mêmes qui les font éclater, changeant de nature à mes oreilles y résonnent délicieusement.
O quel nouueau plaiſir, de voir repreſenter à mes ennemis ſur vn theatre tout de flâme, la funeſte Tragedie de ma luſtice & de leur punition!	Ô quel nouveau plaisir, de voir représenter à mes ennemis sur un théâtre tout de flamme, la funeste Tragédie de ma lustice et de leur punition!
Ie leur fais conneſtre à la lumiere de mes foudres, qu’ils reduiſent en cendre les rebelles, & que ceux qui ne ſçauent pas m’obeir, doiuent ſe reſoudre à la mort.	Je leur fais connaître à la lumière de mes foudres, qu'ils réduisent en cendre les rebelles, et que ceux qui ne savent pas m'obéir, doivent se résoudre à la mort.
A DOENTE II PANPHILIE ſœur de CLIMENE toute éplorée.	À DOENTE II PANPHILIE sœur de CLIMENE toute éplorée.
Elle parle à genoux au Roy qui eſt ſur le haut de ſon Palais.	Elle parle à genoux au Roi qui est sur le haut de son Palais.
SLes cris de ces innocentes victimes perſuadent voſtre Iuſtice de les exemter du Sacrifice où voſtre Majeſté les a deſtinées, puis que les cendres de Poliarque ont aſſouuy ſon reſſentiment:	SLes cris de ces innocentes victimes persuadent votre Justice de les exemter du Sacrifice où votre Majesté les a destinées, puis que les cendres de Poliarque ont assouvi son ressentiment:
Et ma ſœur implore voſtre bonté, & vous demande grace ſans auoir failly.	Et ma sœur implore votre bonté, et vous demande grâce sans avoir failly.
LE ROY.	LE ROY.
Il faut que le feu de mon amour éteigne celuy de ma côlere, qu’on ſecoure ces miſerables, ie ſuis aſſez vangé, & ils ſont aſſez punis.	Il faut que le feu de mon amour éteigne celui de ma côlere, qu'on secoure ces misérables, une suis assez vengé, et ils sont assez punis.
Dites à voſtre ſœur que le repentir de ſa faute me contraint déja à l’oublier, & que ie luy en accorde la grace pourueu que ſa ſouſmiſſion me la demande tout maintenant.	Dites à votre sœur que le repentir de sa faute me contraint déjà à l'oublier, et que ie nir en accorde la grâce pourvu que sa soumission me la demande tout maintenant.
PANPHILIE.	PANPHILIE.
Ie vay luy porter cette agreable nouuelle, pour haſter ſes pas dans le deſſein qu’elle a fait de venir elle-meſme ſe jetter aux pieds de voſtre Majeſté pour en implorer la clemence.	Je vais lui porter cette agréable nouvelle, pour hâter ses pas dans le dessein qu'elle a fait de venir elle-même se jeter aux pieds de votre Majesté pour en implorer la clémence.
SCENE III	SCÈNE III
Vel prodigieux ſpectacle, l’effroy, l’horreur le deſeſpoir & la mort ſe font voir par tout à la funeſte lumiere de mille éclairs;	Vel prodigieux spectacle, l'effroi, l'horreur le désespoir et la mort se font voir par tout à la funeste lumière de mille éclairs;
Et d’autant de	Et d'autant de
Contraste insuffisant NF 2 43-120-14 foudres dont les flames vangereſſes ne font qu’vn inonceau de cendres de toute cette fortereſſe, & de tous ſes habitans.	Contraste insuffisant NF 2 43120-14 foudres dont les flammes vengeresses ne font qu'un inonceau de cendres de toute cette forteresse, et de tous ses habitants.
Là i’ay veu tout en feu, vne mere chargée de ſes enfans, qui brulans auec elle dans ſa fuite inutile ioignent leurs larmes aux ſiennes pour tacher d’eſteinure l’ardeur dont ils eſtoiẽt égallement embraſez;	Là j'ai vu tout en feu, une mère chargée de ses enfants, qui brûlants avec elle dans sa fuite inutile joignent leurs larmes aux siennes pour tacher d'éteinure l'ardeur dont ils étaient égallement embrasés;
Icy i’avietté les veux ſur vne fille dont le coutage beaucoup plus fort que ſon ſexe, la faite precipiter aueuglement au milieu des flames qui bruloient ſon pere, ſe ſentant bruier elle meſme du deſir de le ſauuer, ou de mourir;	Ici j'avietté les veux sur une fille dont le coutage beaucoup plus fort que son sexe, la faite précipiter aveuglement au milieu des flammes qui bruloient son père, se sentant bruier elle -même du désir de le sauver, ou de mourir;
l’ay conſideré encore de loin auec étonnement deux freres ſi fort attachez enſemble par ce premier lien d’amour dont la nature auoit enchaiſné leurs cœurs, que n’ayans tous deux qu’vne ame durant leur vie, ils n’ont voulu auoir auſſi qu’vn corps en mourant, s’eſtans de nouueau liez enſemble au milieu des flames pour encourir vn meſme treſpas, comme s’ils euſſent apprehendé que leurs cendres euſſent eſté ſeparées.	l'ai considéré encore de loin avec étonnement deux frères si fort attachés ensemble par ce premier lien d'amour dont la nature avait enchaîné leurs cœurs, que n'ayant tous deux qu'une âme durant leur vie, ils n'ont voulu avoir aussi qu'un corps en mourant, s'estans s' nouueau liez ensemble au milieu des flammes pour encourir un même trépas, comme s'ils eussent appréhendé que leurs cendres eussent été séparées.
Parmy l’horreur de tant de morts, ie ne ſçay quel Demon ma conſerué la vie, i’en vay rendre graces aux Dieux.	Parmi l'horreur de tant de morts, Elle ne sais quel Démon ma conservé la vie, j'en vais rendre grâces aux Dieux.
SCENE I LE ROY ſeul auec quelqu’vn des ſiens.	SCÈNE I LE ROY seul avec quelqu'un des siens.
Ve i’ay mauuaiſe grace de me mettre en coleCre contre moy-meſme.	Ve j'ai mauvaise grâce de me mettre en colère contre moi-même.
I’auois fait dreſſer vn bucher pour y reduire en cendre Climene, ſans conſiderer qu’en poſſedant mon cœur, i’euſſe eſté auſſi bien qu’elle la victime de ce ſacrifice.	J'avais fait dresser un bûcher pour y réduire en cendre Climène, sans considérer qu'en possédant mon cœur, j'eusse esté aux bien qu'elle la victime de ce sacrifice.
Ne puis ie pas dire dans l’excez de mon amour que ſa Vertu eſt mille fois plus grande encore.	Ne puis ie pas dire dans l'excès de mon amour que sa Vertu est mille fois plus grande encore.
I’attaquois ſon honneur, & ne pouuant le deffendre qu’au milieu des flames, elle y auoit erigé vn Autel de refuge ou elle vouloit eſtre immolée pour le conſeruer:	J'attaquais son honneur, et ne pouvant le défendre qu'au milieu des flammes, elle y avait erigé un Autel de refuge ou elle voulait avoir immolée pour le conserver:
Ceſſez donc mes paſſions, ceſſez de blaſmer celle de mon amour, ſa iuſtice vous impoſe ſilence.	Cessez donc mes passions, cessez de blâmer celle de mon amour, sa justice vous impose silence.
S SENE PHILAMON Capitaine des gardes.	 SENE PHILAMON Capitaine des gardes.
La Princeſſe Climene, accompagnée de Panphilie ſa ſœur, demande audiance à voſtre Maieſté.	La Princesse Climène, accompagnée de Panphilie sa sœur, demande audience à votre Majesté.
LE ROY.	LE ROY.
Qu'on la laiſſe entrer:	Qu'on la laisse entrer:
Elle vient ſans doute executer ſur moy-meſme le funeſte Arreſt que i’auois prononcé contre elle, puis que ſes yeux bruſlent tout le monde.	Elle vient sans doute exécuter sur moi-même le funeste Arrêt que j'avais prononcé contre elle, puis que ses yeux brûlent tout le monde.
Mais i’en veux tanter le peril, le dommage en eſt trop agreable.	Mais j'en veux tanter le péril, le dommage en est trop agréable.
SCENEVI CLIMENE.	SCENEUI CLIMENE.
PANPHILIE auec leurs Dames d’honneur & DORASTE.	PANPHILIE avec leurs Dames d'honneur et DORASTE.
Climene en action de ſe ietter aux pieds dis Roy.	Climène en action de se jeter aux pieds dis Roi.
Et ſa ſœur außi.	Et sa sœur aussi.
Ire.	Ire.
CLIMENE.	CLIMENE.
LE ROY.	LE ROY.
C’eſt à moy de parler le premier, comme le plus intereſſé, par les iuſtes reproches que vous me pouuez faire de la violence que i’ay exercée cõtre vous.	C'est à moi de parler le premier, comme le plus intéressé, par les justes reproches que vous me pouvez faire de la violence que j'ai exercée comptre vous.
I’ay offencé voſtre vertu Climene;	J'ai offensé votre vertu Climène;
Mais ſi mon amour m’en a donné le Conſeil, & voſtre beauté la hardieſſe, elles meſmes encore pour vous ſatisfaire m’en donnent maintenant le repentir	Mais si mon amour m'en a donné le Conseil, et votre beauté la hardiesse, elles -mêmes encore pour vous satisfaire m'en donnent maintenant le repentir
CLIMENE.	CLIMENE.
Encore que i’aye quelque ſuiet de me plaindre de voſtre Maieſté, les biens que i’en ay receus étant beaucoup plus grands que les mauxqu’elle ma faits, ie me ſens plus diſpoſée à la remercier des vns, qu’à luy reprocher les autres;	Encore que j'aie quelque sujet de me plaindre de votre Majesté, les biens que j'en ai reçus étant beaucoup plus grands que les mauxqu'elle ma faits, elle me sens plus disposée à la remercier des uns, qu'à lui reprocher les autres;
Mais ie partage auec elle le regret qu’elle doit auoir de la perte de Poliarque, conſiderant l’importance de ſa mort, par les preuues qui nous demeurent de ſon innocence.	Mais était partage avec elle le regret qu'elle doit avoir de la perte de Poliarque, considérant l'importance de sa mort, par les preuves qui nous demeurent de son innocence.
Ie ſuyois pour ſauuer mon honneur des pourſuites de voſtre amour, & il me ſuiuoit pour garantir ſa vie des attaintes de voſtre ialouſie;	Je suyois pour sauver mon honneur des poursuites de votre amour, et il me suivait pour garantir sa vie des attaintes de votre jalousie;
Mais tous deux, Sire, n’auions d’autre deſſein que de mourir auec la meſme gloire, où nous auons veſcu, luy comme fidelle ſujet, & moy en qualité de voſtre tres-humble ſeruante.	Mais tous deux, Sire, n'avions d'autre dessein que de mourir avec la même gloire, où nous avons vécu, lui comme fidèle sujet, et moi en qualité de votre très-humble servante.
LE ROY.	LE ROY.
Que Poliarque fût innocent, i’ay de la peine à le croire.	Que Poliarque fût innocent, j'ai de la peine à le croire.
CLIMENE.	CLIMENE.
Puis que ſa partie le confeſſe, voſtre Maieſté n’en ſçauroit plus douter.	Puis que sa partie le confesse, votre Majesté n'en saurait plus douter.
Il eſt vray qu’à mon arriuée en cette Cour, il me témoigna la paſſion qu’il auoit de me ſeruir.	Il est vrai qu'à mon arrivée en cette Cour, il me témoigna la passion qu'il avait de me servir.
Mais deſlors que voſtre Maieſté luy euſt fait eognoiſtre ſon deſſein, il changea de penſée, & ſubit les loix de ſon deuoir au meſpris de celles de ſon amour.	Mais délors que votre Majesté lui était fait reconnaître son dessein, il changea de pensée, et subit les lois de son devoir au mépris de celles de son amour.
La ialouſie de ma ſœur l’auoit rendu coupable, la voſtre le vouloit pririit;	La jalousie de ma sœur l'avait rendu coupable, la vôtre le voulait pririt;
et forr fimtiifeur ekcitaiſt vortre coſcre, toutes deux enſemble ont immolé cét innocent.	et forr fimtiifeur ekcitaist vortre côcre, toutes deux ensemble ont immolé cet innocent.
LE ROY.	LE ROY.
Ie me ſens touché iuſques au vif du regret de ia perte, ſa fidelité me demandoit des Coronnes, & ma tyranie luy en a fait de Cyprez?	Je me sens touché jusques au vif du regret de ja perte, sa fidélité me demandait des Coronnes, et ma tyranie mieux en a fait de Cyprez?
O Amour qui du feu de ton flambeau fatal à toute la nature, reduits en cendres tout le monde!	Ô Amour qui du feu de ton flambeau fatal à toute la nature, réduits en cendres tout le monde!
Pourquoy bleſſes- tu mon honneur, en bruſlant mon ame;	Pourquoi blesses- tu mon honneur, en brûlant mon âme;
Ie t’abandonne & mon repos, & ma liberté;	Je t'abandonne et mon repos, et ma liberté;
mais ſauue ma reputation, & ma gloire;	mais sauve ma réputation, et ma gloire;
Que ſi mon deſtin s’accorde auec toy pour coniurer ma perte, aſſouuiſſez egalement voſtre fureur ou de mon ſang, ou de mes cendres, pourueu que vous ayez du reſpect pour ma memoire, ie me plaindray de mon malheur pluſtoſt que de vos cruautez.	Que si mon destin s'accorde avec toi pour conjurer ma perte, assouissez également votre fureur ou de mon sang, ou de mes cendres, pourvu que vous ayez du respect pour ma mémoire, je me plaindrai de mon malheur plutôt que de vos cruautés.
SCENE VLE Vn Soldat de la Citadelle.	SCÈNE VLE Un Soldat de la Citadelle.
Ire, les bieux riotecteuis de Inmhocence ont O ſauué Poliarque du milieu des flames, il demande audiance à voſtre Majeſté.	Ire, les bieux riotecteuis de Inmhocence ont Ô sauvé Poliarque du milieu des flammes, il demande audience à votre Majesté.
LE ROY.	LE ROY.
Que cette nouuelle m’eſt agreable, ie me ſens maintenant attaqué, & combatu de deux differentes paſſions tout à la fois.	Que cette nouvelle m'est agréable, on me sens maintenant attaqué, et combattu de deux différentes passions tout à la fois.
Mais quoy que l’amour ſoit touſiours maiſtre de mes ſens, il fauę que ma gencroſité aujourd’huy le mene en triomphe.	Mais quoi que l'amour soit toujours maître de mes sens, il faute que ma gencrosité aujourd'hui le mène en triomphe.
A quoy ſert cét éclat de grandeur qui m’enuironne ſi l’innocence de mes actions n’en produit la lumiere:	À quoi sert cet éclat de grandeur qui m'environne si l'innocence de mes actions n'en produit la lumière:
vne teſte qui porte des Coronnes ne doit iamais auoir des penſées qui ſoient indignes d’elle:	un tête qui porte des Coronnes ne doit jamais avoir des pensées qui soient indignes d'elle:
puis que les Rois ſont Iuges Souuerains de leurs actions, ils doiuent preuenir la vengence des Dieux en ſe puniſſant les premiers des fautes qu’ils commettent;	puis que les Rois sont Juges Souverains de leurs actions, ils doivent prévenir la vengence des Dieux en se punissant les premiers des fautes qu'ils commettent;
qu’il entre, il demande Iuſtice ie la luy veux rendre, pour la faire à moy-meſme.	qu'il entre, il demande Justice on la lui veux rendre, pour la faire à moi-même.
SCEND VII.	SCEND VII.
POLIARQVE.	POLIARQUE.
Le Roy continuë à parler en le voyant.	Le Roi continue à parler en le voyant.
Oliarque, ferme la bouche à la iuſtice de tes I plaintes, & ouure les yeux à l’admiration de tant de beautez.	Oliarque, ferme la bouche à la justice de tes I plaintes, et ouvre les yeux à l'admiration de tant de beautés.
Si i’ay failly en te puniſſant, ie repare cette faute en te donnant le bien que i’attendois.	Si j'ai failli en te punissant, on répare cette faute en te donnant le bien que j'attendais.
Ie veux que Climene ſoit l’objet de ton amour, & celuy de mes reſpects.	Je veux que Climène soit l'objet de ton amour, et celui de mes respects.
Ie la rends à ton merite;	Je la rends à ton mérite;
auec ce regret toutesfois, de n’auoir pû preuenir ſa contrainte, puis qu’il m’y a forcé auſſi bien que mon deuoir.	avec ce regret toutefois, de n'avoir pu prévenir sa contrainte, puis qu'il m'y a forcé aussi bien que mon devoir.
POLIARQVE.	POLIARQUE.
Que voſtre Majeſté prenne donc le ſilence qu’elle m’impoſe pour remerciement de tant de faueurs dont elle me comble auiourd’huy, n’ayant que des vœux à luy offrir en recognoiſſance.	Que votre Majesté prenne donc le silence qu'elle m'impose pour remerciement de tant de faveurs dont elle me comble aujourd'hui, n'ayant que des vœux à lui offrir en reconnaissance.
CLIMENE.	CLIMENE.
Ie joins les miens à ceux de Poliarque dans la confuſion où ie me trouue, ne ſçachant que dire pour temnoigner av.	Je joins les miens à ceux de Poliarque dans la confusion où tu me trouve, ne sachant que dire pour témoigner au.
Majeſte le reſſentiment qui me demeure, de l’honneur qu’elle me fait.	Majeste le ressentiment qui me demeure, de l'honneur qu'elle me fait.
LE ROY.	LE ROY.
Ie vous oblige auiourd’huy de louer mon changement, puis qu’il ſert de recompenſe à voſtre fidelité.	Je vous oblige aujourd'hui de louer mon changement, puis qu'il sert de récompense à votre fidélité.
Mais dis-moy, Poliarque, comme ton deſtin & ma bonne fortune t’ont garanty du danger où ie t’auois precipité dans mon aueuglement.	Mais dis-moi, Poliarque, comme ton destin et ma bonne fortune t'ont garanti du danger où beau t'avais précipité dans mon aveuglement.
POLIARQVE.	POLIARQUE.
Dés lors qu’on eut mis le feu dans la place, ie ne ſongeay qu’à ſauuer la Princeſſe Climene pour me tirer hors de peril, puis que l’amour me faiſoit viure en elle ſeule.	Dès lors qu'on eut mis le feu dans la place, je ne songeai qu'à sauver la Princesse Climène pour me tirer hors de péril, puis que l'amour me faisait vivre en elle seule.
Et ie fus ſi heureux en cette penſée, que ſans rencontrer aucun obſtacle dans le chemin que ie m’eſtois propoſé de tenir;	Et beau fus si heureux en cette pensée, que sans rencontrer aucun obstacle dans le chemin que éclair étais proposé de tenir;
Ie fis monter ces deux Princeſſes au plus haut de la Tour, où ie les laiſſay ſous la protection de Dorimante, apres auoir fait attacher des eſchelles de corde de tous coſtez pour leur donner le moyen à toute extremité, de chercher leur dernier azyle dans la fuite.	Je fis monter ces deux Princesses au plus haut de la Tour, où tu les laissai sous la protection de Dorimante, après avoir fait attacher des échelles de corde de tous côtés pour leur donner le moyen à toute extrémité, de chercher leur dernier asile dans la fuite.
De moy, ie me cachay dans le magaſin des poudres, ſçachant que les ſoldats auoient eù ordre d’empeſcher que le feu n’en approchaſt, & meſme de i’eteindre s’ils en preuoyoient le peril.	De moi, je me cachai dans le magasin des poudres, sçachant que les soldats avaient éù ordre d'empêcher que le feu n'en approchât, et même de j'éteindre s'ils en prévoyaient le péril.
De ſorté que i’ay treuue le port, au milieu de l'écueil où ie deuois faire naufrage.	De sorté que j'ai trouve le port, au milieu de l'écueil où apprendre devais faire naufrage.
LE ROY.	LE ROY.
Ie loue ta conduite, & admire ton bon-heur, le Ciel ne pouuoit refuſer ſa protection à ton innocence.	Je loue ta conduite, et admire ton bonheur, le Ciel ne pouvait refuser sa protection à ton innocence.
Mais il faut que ma iuſtice ſoit ſatisfaite, & que Ciconte porte la pemle de la deſobeïſſance.	Mais il faut que ma justice soit satisfaite, et que Cicomte porte la pemle de la désobéissance.
le veux qu’il ſerue d’exemple aux rebelles, pour commencer à les punir par l’apprehenfion de ſon ſupplice.	le veux qu'il serve d'exemple aux rebelles, pour commencer à les punir par l'appréhension de son supplice.
POLIARQVE.	POLIARQUE.
Sire, l’amour plus puiſſant que ſon deuoir, en le faiſant coupable, le rend digne d’excuſe.	Sire, l'amour plus puissant que son devoir, en le faisant coupable, le rend digne d'excuse.
Le voicy qui vient implorer la clemence de Voſtre Majeſté.	Le voici qui vient implorer la clémence de Votre Majesté.
SCENE DERNIERE,	SCÈNE DERNIÈRE,
CLEONTE.	CLÉONTE.
die, voitre Majeite voit à les pieds vn crimiOnel d’Amour, auſſi bien que d’Etat, puis qu’à force d’aimer il s’eſt rendu coupable.	die, voitre Majeite voit à les pieds un crimiOnel d'Amour, aussi bien que d'État, puis qu'à force d'aimer il s'est rendu coupable.
LE ROY.	LE ROY.
Voſtre amour n’excuſe point voſtre audace.	Votre amour n'excuse point votre audace.
CLEONIE.	CLÉONIE.
Si ma paſſion n’eſt pas conſiderable dans mon cœur, qu’elle la ſoit au moins ſur le viſage de Panphilie, puis que ſa beauté la fait naiſtre.	Si ma passion n'est pas considérable dans mon cœur, qu'elle la soit au moins sur le visage de Panphilie, puis que sa beauté la fait naître.
PANPHILIE.	PANPHILIE.
Etese met Sire, il eſt vray que ie ſuis complice de ſon crime, l’ayant forcé de le commettre.	Êtese met Sire, il est vrai que sans suis complice de son crime, l'ayant forcé de le commettre.
Et comme ie me ſuis donnée moy-meſme pour recompenſe de ſa rebellion, en demandant ſa grace à V.	Et comme personne me suis donnée moi-même pour récompense de sa rébellion, en demandant sa grâce à V.
Majeſté, ie la ſupplie tout à la fois de m’accorder la mienlie, puie quon prouaiſes ont meſlé enſemble nos intereſts.	Majesté, Seigneur la supplie tout à la fois de m'accorder la mienlie, puie quon provaises ont mêlé ensemble nos intérêts.
LE ROY.	LE ROY.
Ie veux que ma Iuſtice auiourd’huy cede à ma Clemence.	Je veux que ma Justice aujourd'hui cède à ma Clémence.
Cleonte, ie te donne la vie, afin que tu conſerue celle de ta chere Panphilie, dans l’accompliſſement de vos chaſtes deſſeins:	Cléonte, Seigneur te donne la vie, afin que tu conserve celle de ta chère Panphilie, dans l'accomplissement de vos chastes desseins:
Et pour y contribuer encore quelque choſe du mien, ie te faits General de mes armées, auec ordre d’aller remettre en leurs Etats ces deux grandes Princeſſes:	Et pour y contribuer encore quelque chose du mien, Elle te faits Général de mes armées, avec ordre d'aller remettre en leurs Éats ces deux grandes Princesses:
Quoy que leur Vertu & leur Beauté, également admirables, les facent regner par tout abſolument.	Quoi que leur Vertu et leur Beauté, également admirables, les facent régner par tout absolument.
N	N
EXTRAIT DV PRIVILEGE du Roy.	EXTRAIT DU PRIVILÈGE du Roi.
Ar grace & Priuilege du Roy, donné à Paris le L 22.	Ar grâce et Privilège du Roi, donné à Paris le L 22.
iour de Fevrier 1643.	jour de Février 1643.
ſigné par le Roy en ſon Conſeil, COMBES, il eſt permis au Sieur DE LA SERRE, de faire Imprimer vn Liure qu’il a compoſé, intitulé Climene, ou le Triomphe de la Vertu, par tel Imprimeur ou Libraire qu’il voudra, durant le temps de cinqans.	signé par le Roi en son Conseil, COMBES, il est permis au Sieur DE LA RE, de faire Imprimer un Livre qu'il a composé, intitulé Climène, ou le Triomphe de la Vertu, par tel Imprimeur ou Libraire qu'il voudra, durant le temps de cinqans.
Et deffences ſont faites à toutes perſonnes de quelque qualité ou condition qu’elles ſoient, de l’imprimer, ou faire imprimer, ſinon ceux qui auront droit dudit Sieur DE LA SERRE, à peine de deux mil liures d’amende, ainſi qu’il eſt porté plus au long parledit Priuilege.	Et défenses sont faites à toutes personnes de quelque qualité ou condition qu'elles soient, de l'imprimer, ou faire imprimer, sinon ceux qui auront droit dudit Sieur DE LA SERRE, à peine de deux mille livres d'amende, ainsi qu'il est porté plus au long parledit Privilège.
Acheué d’imprimer pour la premiere fois, le vingtieſme de Mars mil ſix cens quarante-trois.	Achevé d'imprimer pour la première fois, le vingtième de Mars mil six cens quarante-trois.
Ledit Sieur de la Serre a cedé ſon Priuilege à Antoine de Sommauille & Auguſtin Courbé, Marchands Libraires à Paris, ſuiuant l’accord fait entr’eux.	Ledit Sieur de la Serre a cédé son Privilège à Antoine de Sommaville et Augustin Courbé, Marchands Libraires à Paris, suivant l'accord fait entr'eux.
EXTRAIT DV PRIVILEGE du Roy.	EXTRAIT DU PRIVILÈGE du Roi.
Ar grace & Priuilege du Roy, donné à Paris le L 22.	Ar grâce et Privilège du Roi, donné à Paris le L 22.
iour de Fevrier 1643.	jour de Février 1643.
ſigné par le Roy en ſon Conſeil, COMBES, il eſt permis au Sieur DE LA SERRE, de faire Imprimer vn Liure qu’il a compoſé, intitulé Climene, ou le Triomphe de la Vertu, par tel Imprimeur ou Libraire qu’il voudra, durant le temps de cinqans.	signé par le Roi en son Conseil, COMBES, il est permis au Sieur DE LA RE, de faire Imprimer un Livre qu'il a composé, intitulé Climène, ou le Triomphe de la Vertu, par tel Imprimeur ou Libraire qu'il voudra, durant le temps de cinqans.
Et deffences ſont faites à toutes perſonnes de quelque qualité ou condition qu’elles ſoient, de l’imprimer, ou faire imprimer, ſinon ceux qui auront droit dudit Sieur DE LA SERRE, à peine de deux mil liures d’amende, ainſi qu’il eſt porté plus au long parledit Priuilege.	Et défenses sont faites à toutes personnes de quelque qualité ou condition qu'elles soient, de l'imprimer, ou faire imprimer, sinon ceux qui auront droit dudit Sieur DE LA SERRE, à peine de deux mille livres d'amende, ainsi qu'il est porté plus au long parledit Privilège.
Acheué d’imprimer pour la premiere fois, le vingtieſme de Mars mil ſix cens quarante-trois.	Achevé d'imprimer pour la première fois, le vingtième de Mars mil six cens quarante-trois.
Ledit Sieur de la Serre a cedé ſon Priuilege à Antoine de Sommauille & Auguſtin Courbé, Marchands Libraires à Paris, ſuiuant l’accord fait entr’eux.	Ledit Sieur de la Serre a cédé son Privilège à Antoine de Sommaville et Augustin Courbé, Marchands Libraires à Paris, suivant l'accord fait entr'eux.
