ACTEURS.	ACTEURS.
LA COMTESSE dElcaibagnas.	LA COMTESSE dElcaibagnas.
LE COMTE, son nis	LE COMTE, son nis
LE VICOMTE, Amant de june.	LE VICOMTE, Amant de june.
ULIE, Amante du Vicomte.	ULIE, Amante du Vicomte.
MONSIEUR TIBAUDIER, Conſeiller, Amunt de lu domnciic.	MONSIEUR TIBAUDIER, Conseiller, Amunt de lu domnic.
MONSIEUR HARPIN, Receveur des Tailles, autre Aſnant de la Comteſſe.	MONSIEUR HARPIN, Receveur des Tailles, autre Ânant de la Comtesse.
M’ONSIEuR BOriNET, Precepteur de Monſieur le Comte.	M'ONSIEuR BOriNET, Précepteur de Monsieur le Comte.
ANDRE’E, Suivante de la Comteſſe.	ANDRE'E, Suivante de la Comtesse.
BEANNOT, Laquais de Monſieur Tibaudier.	BEANNOT, Laquais de Monsieur Tibaudier.
CRIQUET, Laquais de la Comteſſe.	CRIQUET, Laquais de la Comtesse.
La Scene eſt à Angouleſine.	La Scène est à Angoulesne.
LA	LA
LA COMTESSE D’ESCARBAGNAS, COMEDIE.	LA COMTESSE D'ÉCARBAGNAS, COMÉDIE.
ACTE PREMIER.	ACTE PREMIER.
SOLNVE IREMIERL.	SOLNVE IREMIERL.
ULIE, LE VICOMTE.	ULIE, LE VICOMTE.
LE VICOMTE.	LE VICOMTE.
E, quoy Madame, vous eſtes déja iicy?	E, quoi Madame, vous êtes déjà jici?
QV u LIE.	Q U IE.
Oüy, vous en devriez rougir, Cleante, & il n’eſt guere honneſte à un Amant de venir le dernier au tendez-vous.	Oui, vous en devriez rougir, Cléante, et il n'est guère honnête à un Amant de venir le dernier au tendez-vous.
E VICOMTE.	 VICOMTE.
Je ſerois icy il y a une heure, s’il n’y avoit point de fâcheux au monde, & j’ay eſté arreſté en chemin min par un vieux importun de qualité, qui m'a demandé tout exprés des nouvelles de la Cour, pour trouver moyen de m’en dire des plus extravagantes qu’on puiſſe debiter, & c’eſt là, comme vous ſçovez, le fleau des petites Villes, que ces grands Nouvelliſtes qui cherchent par tout où répandre les contes qu’ils ramaſſent.	Je serais ici il y a une heure, s'il n'y avait point de fâcheux au monde, et j'ai été arrêté en chemin min par un vieux importun de qualité, qui m'a demandé tout exprès des nouvelles de la Cour, pour trouver moyen de m'en dire des plus extravagantes qu'on puisse débiter, et c'est là, comme vous sav, le fléau des petites Villes, que ces grands Nouvellistes qui cherchent partout où répandre répandre les contes qu'ils ramassent.
Celuy-cy m’a montre d’abord deux feüilles de papier, pleines juſques aux bords d’un grand fatras de balivernes, qui viennent, m’a teil dit, de l’endroit le plus ſeur du monde.	Celui-cy m'a montre d'abord deux feuilles de papier, pleines jusques aux bords d'un grand fatras de balivernes, qui viennent, m'a teil dit, de l'endroit le plus sûr du monde.
En ſuite, comme d’une choſe fort curieuſe, il m’a fait avec grand myſtere une fatigante lecture de toutes les méchantes plaiſanteries de la Gazette de Hollande, dont il épouſe les intereſts.	En suite, comme d'une chose fort curieuse, il m'a fait avec grand mystère une fatigante lecture de toutes les méchantes plaisanteries de la Gazette de Hollande, dont il épouse les intérêts.
Il tient que là France eſt bâtuë en ruine par la plume de cet Ecrivain, & qu’il ne faut que ce bel eſprit pour défaire toutes nos Trouppes;	Il tient que là France est bâtuë en ruine par la plume de cet Écrivain, et qu'il ne faut que ce bel esprit pour défaire toutes nos Troupes;
& delà s’eſt jette à corps perdu dans le raiſonnement du Miniſtere, dont il remarque tous les défauts, & d’où j’ay creu qu’il ne ſortiroit point.	et delà s'est jette à corps perdu dans le raisonnement du Ministère, dont il remarque tous les défauts, et d'où j'ai cru qu'il ne sortirait point.
A l’entendre parler, il ſçait les ſecrets du Cabinet mieux que ceux qui lesfont.	À l'entendre parler, il sçait les secrets du Cabinet mieux que ceux qui lesfont.
La politique de l’Eſtat luy laiſſe voir tous ſes deſſeins, & elle ne fait pas un pas, dont il ne penetre les intentions.	La politique de l'État lui laisse voir tous ses desseins, et elle ne fait pas un pas, dont il ne pénètre les intentions.
Il nous apprend les reſſorts cachez de tout ce qui ſe fait, nous découvre lesveuës de la prudence de nos voiſins, & remuë à ſa fantaiſie toutes les affaires de l’Europe.	Il nous apprend les ressorts cachés de tout ce qui se fait, nous découvre lesvues de la prudence de nos voisins, et remue à sa fantaisie toutes les affaires de l'Europe.
Ses intelligences meſmes s’étendent juſques en Afrique, & en Aſie;	Ses intelligences mêmes s'étendent jusques en Afrique, et en Asie;
& il eſt informé de tout ce qui s’agite dans le Conſeil d’enhaut, du Prête-Jean, & dugrand Mogol.	et il est informé de tout ce qui s'agite dans le Conseil d'enhaut, du Prête-Jean, et dugrand Mogol.
ALIE.	ÀLIE.
Vous parez vôtre excuſe du mieux que vous pouvez, afin de la rendre agreable, & faire qu’elle ſoit plus aiſe ment reçuë.	Vous parez votre excuse du mieux que vous pouvez, afin de la rendre agréable, et faire qu'elle soit plus aise ment reçue.
LEVICOMTE.	LEUICOMTE.
C’eſt là, belle Julie, la veritable cauſe de mon retardement, & ſi je voulois y donner une excuſe gagalante, je n’aurois qu’à vous dire, que le rendezvous que vous voulez prendre peut authoriſer la pareſſe dont vous me querellez.	C'est là, belle Julie, la véritable cause de mon retardement, et si je voulais y donner une excuse gagalante, je n'aurais qu'à vous dire, que le rendezvous que vous voulez prendre peut autoriser la paresse dont vous me querellez.
Que m’engager a faire l’amant de la Maiſtreſſe du logis, c’eſt me mettre en eſtat de craindre de me trouuer icy le premier.	Que m'engager a faire l'amant de la Maîtresse du logis, c'est me mettre en état de craindre de me trouver ici le premier.
Que cette feinte où je me force n’eſtant que pour vous plaire, j’ay lieu de ne vouloir en ſouffrit la contrainte, que devant les yeux qui s’en divertiſſent Que j’évite le teſte à teſte avec cette Comteſſe ridicule, dont vous m’embaraſſez, & en un mot que ne venant icy que pour vous, j’ay toutes les raiſons du monde d’attendre que vous y ſoyez.	Que cette feinte où je me force n'étant que pour vous plaire, j'ai lieu de ne vouloir en souffrit la contrainte, que devant les yeux qui s'en divertissent Que j'évite le tête à tête avec cette Comtesse ridicule, dont vous m'embarrassez, et en un mot que ne venant ici que pour vous, j'ai toutes les raisons du monde d'attendre que vous y soyez.
u LIE.	Ou LIE.
Nous ſçavons bien que vous ne manquerez jamais d’eſprit, pour donner de belles couleurs aux fautes que vous pourrez faire.	Nous Savons bien que vous ne manquerez jamais d'esprit, pour donner de belles couleurs aux fautes que vous pourrez faire.
Cependant ſi vous eſtiez venu une demie heure plûtoſt, nous aurions profité de tous ces momens, car j’ay trouvé en arrivant que la Comteſſe eſtoit ſortie, & je ne doute point qu’elle neſoit allee par la Ville, ſe faire honneur de la Comedie, que vous me donnez ſous ſon nom.	Cependant si vous étiez venu une demie heure plutôt, nous aurions profité de tous ces moments, car j'ai trouvé en arrivant que la Comtesse était sortie, et je ne doute point qu'elle nesait allée par la Ville, se faire honneur de la Comédie, que vous me donnez sous son nom.
LEVICOMTE.	LEUICOMTE.
Mais tout de bon, Madame, quand voulez vous mettre fin à cette contrainte, & me faire moins acheter le bon-heur de vous voir?	Mais tout de bon, Madame, quand voulez -vous mettre fin à cette contrainte, et me faire moins acheter le bonheur de vous voir?
JULIE.	JULIE.
Quand nos Parens pourront eſtre d’accord, ce que je nole elperer.	Quand nos Parents pourront être d'accord, ce que je nole elpérer.
Vous ſçavez comme moy que les demeſlez de nos deux familles, ne nous permettent point de nous voir autrepart, & que mes Freres, non plus que vôtre Pere, ne ſont pas aſſez raiſonnables pour ſouffrir nôtre attachement.	Vous savez comme moi que les démêlés de nos deux familles, ne nous permettent point de nous voir autrepart, et que mes Frères, non plus que votre Père, ne sont pas assez raisonnables pour souffrir notre attachement.
LEVICOMTE.	LEUICOMTE.
Mais pourquoy ne pas mieux joüir du rendezvous que leur inimitié nous laiſſe, & me contraindre à perdre en une ſotte feinte, les momens que j’ay prés de vous?	Mais pourquoi ne pas mieux jouir du rendezvous que leur inimitié nous laisse, et me contraindre à perdre en une sotte feinte, les moments que j'ai prés de vous?
ULIE.	ULIE.
Pour mieux cacher nôtre amour;	Pour mieux cacher notre amour;
& puis à vous dire la verité, cette feinte dont vous parlez m’eſt une Comedie fort agreable, & je neſçay ſi celle que vous nous donnez aujourd’huy me divertira davantage.	et puis à vous dire la vérité, cette feinte dont vous parlez m'est une Comédie fort agréable, et je nesçai si celle que vous nous donnez aujourd'hui me divertira davantage.
Nôtre Comteſſe d’Eſcarbagnas, avec ſon perpetuel enteſtement de qualité, eſt un auſſi bon perſonnage qu’on en puiſſe mettre ſur le Theatre.	Notre Comtesse d'Écarbagnas, avec son perpétuel entêtement de qualité, est un aussi bon personnage qu'on en puisse mettre sur le Théâtre.
Le petit voyage qu’elle a fait à Paris, l’a ramenée dans Angouleſme, plus achevée qu’elle n’eſtoit.	Le petit voyage qu'elle a fait à Paris, l'a ramenée dans Angoulême, plus achevée qu'elle n'était.
L’approché de l’air de la Cour a donné à ſon ridicule de nouveaux agréemens, & ſa ſottiſe tous les jours ne fait que croiſtre & embellir.	L'approché de l'air de la Cour a donné à son ridicule de nouveaux agréments, et sa sottise tous les jours ne fait que croître et embellir.
LEVICOMTE.	LEUICOMTE.
Oüy, mais vous ne conſiderez pas que le jeu qui vous divertit tient mon cœur auſupplice, & qu’on n’eſt point capable de ſe joüer long-temps, lors qu’on a dans l’eſprit une paſſion auſſi ſerieuſe, que celle que je ſens pour vous.	Oui, mais vous ne considérez pas que le jeu qui vous divertit tient mon cœur ausupplice, et qu'on n'est point capable de se jouer longtemps, lors qu'on a dans l'esprit une passion aussi sérieuse, que celle que je sens pour vous.
il eſt cruel, belle Julie, que cet amuſement dérobe à mon amour un temps qu’il voudroit employer à vous expliquer ſon ardeur;	il est cruel, belle Julie, que cet amusement dérobe à mon amour un temps qu'il voudrait employer à vous expliquer son ardeur;
& cette nuit j’ay fait là deſſus quelques Vers, que je ne puis m’empeſcher de vous reciter, ſans que vous me le demandiez, tant la démangeaiſon de lire ſes ouvrages, eſt un vice attaché à la qualité de Poëte.	et cette nuit j'ai fait là dessus quelques Vers, que je ne puis m'empêcher de vous réciter, sans que vous me le demandiez, tant la démangeaison de lire ses ouvrages, est un vice attaché à la qualité de Poète.
Cenr trop long-temps, Inis, me mettre à la torture.	Cenr trop longtemps, Inis, me mettre à la torture.
Iris, comme vous le voyez, eſt mis la pour Julie.	Iris, comme vous le voyez, est mis la pour Julie.
C'eſt trop long-temps, Iris, me mettre à la torture, Et ſi je ſuy vos loix, je les blâme tout bas, De me forcer à taire un tourment que j’endure Pour déclarer un mal que je ne reſlens pas.	C'est trop longtemps, Iris, me mettre à la torture, Et si je sûre vos lois, je les blâme tout bas, De me forcer à taire un tourment que j'endure Pour déclarer un mal que je ne reslens pas.
Faut il que vos beaux yeux à qui je rends les armes, Veüille ſe divertir de mes triſtes ſoûpirs, Et n’eſt-ce pas aſſez de ſouffrir pour vos charmes, Sans me faire ſouffrir encor pour vos plaiſirs?	Faut -il que vos beaux yeux à qui je rends les armes, Veille se divertir de mes tristes soupirs, Et n'est-ce pas assez de souffrir pour vos charmes, Sans me faire souffrir encor pour vos plaisirs?
C’en eſt trop à lafois, que ce double martyre, Dt ce qu'il me faut taire, & ce qu’il me faut dire, Exerce ſur mon cœur pareille cruauté.	C'en est trop à lafois, que ce double martyre, Dt ce qu'il me faut taire, et ce qu'il me faut dire, Exerce sur mon cœur pareille cruauté.
L’amour le met en feu, la contrainte le tuë, Et ſi par la pitié vous n’eſtes combatuë, Je meurs, & de la feinte, & de la verité.	L'amour le met en feu, la contrainte le tue, Et si par la pitié vous n'êtes combattue, Je meurs, et de la feinte, et de la vérité.
ULIE.	ULIE.
Je vois que vous vous faites là bien plus maltraité que vous n’eſtes;	Je vois que vous vous faites là bien plus maltraité que vous n'êtes;
mais c’eſt unelicence que prennent Meſſieurs les Poëtes, de mentir de gayeté de cœur, & de donner à leurs Maiſtreſſes des cruautez qu’elles n’ont pas, pour s’acommoder aux penſées qui leur peuvent venir.	mais c'est unélicence que prennent Messieurs les Poètes, de mentir de gaieté de cœur, et de donner à leurs Maîtresses des cruautés qu'elles n'ont pas, pour s'acommoder aux pensées qui leur peuvent venir.
Cependant je ſeray bien aiſe que vous me donniez ces Vers par écrit.	Cependant je serai bien aise que vous me donniez ces Vers par écrit.
LEVTCOMTE.	LEUTCOMTE.
C’eſt atiez de vous les avoir dits, & je dois en demeurer là;	C'est atiez de vous les avoir dits, et je dois en demeurer là;
il eſt permis d’eſtre parfois aſſez fou pour faire des Vers, mais non pour vouloir qu’ils ſoient veus.	il est permis d'être parfois assez fou pour faire des Vers, mais non pour vouloir qu'ils soient vus.
dLTEe.	dLTEe.
C’eſt en vain que vous vous retranchez ſur une fauſſe modeſtie, on ſçait dans le monde que vous avez de l’eſprit, & je ne voy pas la raiſon qui vous oblige à cacher les vôtres.	C'est en vain que vous vous retranchez sur une fausse modestie, on sait dans le monde que vous avez de l'esprit, et je ne vois pas la raison qui vous oblige à cacher les vôtres.
LEVICOMTE.	LEUICOMTE.
Mon dieu, Madame, marchons là deſſus s’il vous plaiſt, avec beaucoup de retenuë;	Mon dieu, Madame, marchons là -dessus s'il vous plaît, avec beaucoup de retenue;
il eſt dangereux dans le monde de ſe meſler d’avoir de l’eſprit.	il est dangereux dans le monde de se mêler d'avoir de l'esprit.
Il y a là dedans un certain ridicule, qu’il eſtfacile d’attrapper, & nous avons de nos amis qui me font craindre leur exemple.	Il y a là -dedans un certain ridicule, qu'il estfacile d'attraper, et nous avons de nos amis qui me font craindre leur exemple.
ULIE.	ULIE.
Mon Dieu, Cleante, vous avez beau dire, je vois avec tout cela que vous mourez d’envie de me les donner, & jevous embaraſſerois ſi je faiſoisſemblant de ne m’en pas ſoucier.	Mon Dieu, Cléante, vous avez beau dire, je vois avec tout cela que vous mourez d'envie de me les donner, et jevous embarrais si je faisaisemblant de ne m'en pas soucier.
LE VICOXTE.	LE VICOXTE.
Moy, Madame, vous vous mocquez, & je ne ſuis pas ſi Poëte que vous pourriez bien croire, pour.	Moi, Madame, vous vous moquez, et je ne suis pas si Poète que vous pourriez bien croire, pour.
Mais voicy vôtre Madame la Comteſſe d’Eſcarbagnas, je ſors par l’autre porte pour ne la point trouver, & vais diſpoſer tout mon monde au divertiſſement que je vous ay promis.	Mais voici votre Madame la Comtesse d'Écarbagnas, je sors par l'autre porte pour ne la point trouver, et vais disposer tout mon monde au divertissement que je vous ai promis.
SCENE II.	SCÈNE II.
LA COMTESSE, JULIE.	LA COMTESSE, JULIE.
1 LA COMTESSE.	1 LA COMTESSE.
11.	11.
Aliou mieu 3 anauule;	Aliou mieu 3 anauule;
vous voſlà toute ſeule;	vous voslà toute seule;
quelle pitié eſt-ce là, toute ſeule;	quelle pitié est-ce là, toute seule;
il me ſemble que mes gens m’avoient dit;	il me semble que mes gens m'avaient dit;
que le Vicomte eſtoit icy?	que le Vicomte était ici?
ULIE.	ULIE.
ſ ut ray qu’il y eſt venû, mais c’eſt aſſez pour luy de ſçavoir que vous n’y eſtiez pas pour dobliger a Ioxth.	savoir que vous n'il y est venu, mais c'est assez pour sens de savoir que vous n'y étiez pas pour dobliger a Ioxth.
LA COMTESSE.	LA COMTESSE.
Comment il vous a vcue?	Comment il vous a vécue?
oüy.	oui.
ULIE.	ULIE.
LACOMTESSE.	LACOMTESSE.
Et il ne vous a rien dit?	Et il ne vous a rien dit?
LIE.	LIE.
Non, Madame, & il a voulu témoigner parlà qu’il eſt tout entier à vos charmes.	Non, Madame, et il a voulu témoigner parlà qu'il est tout entier à vos charmes.
LACOMTESSE.	LACOMTESSE.
Vraiment je le veux queiclier de cede aetion, quelque quelque amour que l’on ait pour moy, j’ayme que ceux qui m’ayment, rendentice qu’ils doivent au Sexe;	Vraiment je le veux queiclier de cède aétion, quelque quelque amour que l'on ait pour moi, j'aime que ceux qui m'aiment, rendentice qu'ils doivent au Sexe;
& je ne ſuis point de l’humeur de ces femmes injuſtes, qui s’applaudiſſent des inchilitez, que leurs Amans font aux autres belles.	et je ne suis point de l'humeur de ces femmes injustes, qui s'applaudissent des inchilités, que leurs Amants font aux autres belles.
ULIE.	ULIE.
Il ne faut point, Madame, que vous ſoyez ſurpriſe de ſon procedé L’amour que vous luy donnez, éclate dans toutes ſes actions, & l’empeſche d’avoir des yeux que pour vous.	Il ne faut point, Madame, que vous soyez surprise de son procédé L'amour que vous lui donnez, éclate dans toutes ses actions, et l'empêche d'avoir des yeux que pour vous.
LA COMTESSE.	LA COMTESSE.
Je croy eſtre en eſtat de pouvoir faire naiſtre une paſſion aſſez forte, & je me trouve pour cela aſſez de beauté, de jeuneſſe, & de qualité, Dieu mercy;	Je cro être en état de pouvoir faire naître une passion assez forte, et je me trouve pour cela assez de beauté, de jeunesse, et de qualité, Dieu merci;
mais cela n’empeſche pas, qu’avec ce que j’inſpire, on ne puiſſe garder de l’honneſteté, & de la complaiſance pour les autres.	mais cela n'empêche pas, qu'avec ce que j'inspire, on ne puisse garder de l'honnêteté, et de la complaisance pour les autres.
Que faites vous donc là, Laquais?	Que faites -vous donc là, Laquais?
eſt ce qu’il n’y a pas une antichambre, où ſe tenir, pour venir quand on vous appelle;	est ce qu'il n'y a pas une antichambre, où se tenir, pour venir quand on vous appelle;
cela ent etrange quon ne pume avoir en Proviuceun laquais qui ſçache ſon monde.	cela ent range quon ne pume avoir en Proviuceun laquais qui sçache son monde.
A qui eſt ce donc que je parie, voulez vous yous en aller la denors peut fripon?	À qui est ce donc que je parie, voulez -vous yous en aller la denors peut fripon?
Fille, approchez.	Fille, approchez.
ANDREE.	ANDRÉ.
Que vous plaiſt-il, Madame.	Que vous plaît-il, Madame.
LA COMTESSR.	LA COMTESSR.
Oltenmoy feseocires.	Oltenmoi féséocires.
Doueemient donc mal à droite, comme vous me ſaboulez la teſte avec vos mains peſantes!	Doueemient donc mal à droite, comme vous me saboulez la tête avec vos mains pesantes!
ANDRE'E.	ANDRÉ.
Je fais, Madame, le plus doucement que je puis.	Je fais, Madame, le plus doucement que je puis.
LA COMTESSE.	LA COMTESSE.
Oüy, mais le plus doucement que vous pouvez, eſt fort rudement pour ma teſte, & vous me l’avez déboitée.	Oui, mais le plus doucement que vous pouvez, est fort rudement pour ma tête, et vous me l'avez déboitée.
Tenez encore ce manchon, ne laiſlez point traiſner tout cela, & portez le dans ma garderobbe.	Tenez encore ce manchon, ne laislez point traîner tout cela, et portez le dans ma garderobe.
Hé bien, où ya t’elle, où va t’elle, que veut-elle faire, cet oyſon bridé?	Hé bien, où ya -t-elle, où va -elle, que veut-elle faire, cet oison bridé?
A N	À N
ANDRE’E.	ANDRÉ.
Je veux, Madame, comme vous m’avez dit, porter cela aux garde-robbes.	Je veux, Madame, comme vous m'avez dit, porter cela aux garde-robes.
LA COMTESSE.	LA COMTESSE.
Ah!	Ah!
mon dieu, l’impertinente.	mon dieu, l'impertinente.
Je vous demande pardon, Madame.	Je vous demande pardon, Madame.
Je vous ay dit ma pimmdune ygrane nente, celt a une où ſonf mes habits.	Je vous ai dit ma pimmèdune ygrane nente, celt a une où sons mes habits.
ANDRE'E.	ANDRÉ.
Eit-ce, Madame, qu’à la Cour une armoire s’appelle une garde-robbe?	Éit-ce, Madame, qu'à la Cour une armoire s'appelle une garde-robe?
LATC OIMIMSME.	LATC OIMIMSME.
Oüy, butorde, on appelle ainſi le lieu où I’on met les habits.	Oui, butorde, on appelle ainsi le lieu où J'on met les habits.
ANDREE.	ANDRÉ.
Je m’en reſouviendray, Madame, auſſi bien que de vôtre grenier, qu’il faût appeller garde-meuble.	Je m'en ressouviendrai, Madame, aussi bien que de votre grenier, qu'il faût appeler garde-meuble.
LA COMTESSE.	LA COMTESSE.
Quelle peine il faut prendre pour inſtruire ces animaun la.	Quelle peine il faut prendre pour instruire ces animaun la.
ULIE.	ULIE.
Je les trouve bien-heureux, Madame, d’eſtre ſous vôtre diſcipline.	Je les trouve bienheureux, Madame, d'être sous votre discipline.
LA COMTESSE.	LA COMTESSE.
C’eſt une fille de ma mere nourrice, que j’ay miſe à la chambre, & elle eſt toute neuve encore.	C'est une fille de ma mère nourrice, que j'ai mise à la chambre, et elle est toute neuve encore.
ILIE.	ILIE.
Cela eſt d’une belle ame, Madame, & il eſt glorieux de faire ainſi des creatures.	Cela est d'une belle âme, Madame, et il est glorieux de faire ainsi des créatures.
LA COMTESSE.	LA COMTESSE.
Allons, des ſieges.	Allons, des sièges.
Hola, Laquais, Laquais, Laquais.	Holà, Laquais, Laquais, Laquais.
En verité voilà qui eſt violent, de ne pouvoir pas avoir un Laquais, pour donner des fieges.	En vérité voilà qui est violent, de ne pouvoir pas avoir un Laquais, pour donner des sièges.
Filles, Laquais, Laquais, Filles, quelqu’un Je penſe que tous mes gens ſont morts, & que nous ſerons contraintes de nous donner des ſieges nous meſmes.	Filles, Laquais, Laquais, Filles, quelqu'un Je pense que tous mes gens sont morts, et que nous serons contraintes de nous donner des sièges nous mêmes.
ANDRE'E.	ANDRÉ.
Clem, canama.	Clem, canama.
OMTESSE.	OMTESE.
il le faur blen egouſler avec vous autres.	il le saur blen égousler avec vous autres.
ANDRE’E.	ANDRÉ.
J’enfermois vôtre manchon, & vos coëffez dans votſe anol.	J'enfermais votre manchon, et vos coiffez dans votse anol.
dis-je, dans vôtre garderobbe.	dis-je, dans votre garderobe.
DACONTESSE.	DACONTESSE.
Apellez-moy ce petit fripon de Laquais.	Apelez-moi ce petit fripon de Laquais.
ANDREE.	ANDRÉ.
Hola, Criquet.	Holà, Criquet.
MACOMIESSE.	MACOMIESSE.
Laiſſez-là vôtre Criquet, bouviere, & appellez Laquais.	Laissez-là votre Criquet, bouvière, et appelez Laquais.
ANDRE’E, Laquais donc, & non pas Criquet, venez parltru mauuamenje penſe quu en ſourd, Criq.	ANDRE’Y, Laquais donc, et non pas Criquet, venez parltru mauvamenje pense quu en sourd, Criq.
Laquais, Laquais.	Laquais, Laquais.
Plaiſt-il.	Plaît-il.
SRIQ dE T.	SRIQ dE -T.
LA COMTESSE.	LA COMTESSE.
où eſtiez vous donc, petit coquin?	où étiez -vous donc, petit coquin?
QUET.	QUET.
Dans la ruë, Madame.	Dans la rue, Madame.
A COMTESSE.	À COMTESSE.
Et pourquoy dans la ruë?	Et pourquoi dans la rue?
ET.	ET.
Vous m’avez dit d’aller là dehors.	Vous m'avez dit d'aller là dehors.
LA COMTESSE.	LA COMTESSE.
Vous eſtes lur perit impertment;	Vous êtes lur périt impertment;
mon amy, & vous devez ſçavoir que là dehors, en termes de perſonnes de qualité, veut dire l’antichambre.	mon ami, et vous devez savoir que là dehors, en termes de personnes de qualité, veut dire l'antichambre.
Andrée, ayez ſoin tantoſt de ſaire donner le foüet à ce petit fripon là, par mon Eſcuyer;	Andrée, ayez soin tantôt de zaïre donner le fouet à ce petit fripon là, par mon Escuyer;
c'eſt un petit incorrigible.	c'est un petit incorrigible.
ANDRE’E.	ANDRÉ.
Qu’eſt ce que c’eſt, Madame, que vôtre Eſcuyer?	Qu'est ce que c'est, Madame, que votre Escuyer?
eſt-ce Maiſtre Charles que vous appellez comme cela?	est-ce Maître Charles que vous appelez comme cela?
LA COMTESSE.	LA COMTESSE.
Taiſez-vous, ſotte que vous eſtes, vous ne ſçauriez ouvrir la bouche que vous ne diſiez une impertinence.	Taisez-vous, sotte que vous êtes, vous ne sauriez ouvrir la bouche que vous ne disiez une impertinence.
Des ſieges;	Des sièges;
& vous, allumez deux bougies dans mes flambeaux d’argent, il ſe fait déja tard.	et vous, allumez deux bougies dans mes flambeaux d'argent, il se fait déjà tard.
Qu'eſt ce que c’eſt donc que vous me regardez toute effarée?	Qu'est ce que c'est donc que vous me regardez toute effarée?
Madame.	Madame.
ANDRE’E.	ANDRÉ.
LA COMTESSE.	LA COMTESSE.
He bien, Mauaine.	He bien, Mauaine.
Qu’y à t’il?	Qu'y à t-il?
ANDRE’E.	ANDRÉ.
C’eſt que.	C'est que.
Quoy?	Quoi?
LA COMTESSE.	LA COMTESSE.
AldRA E.	AldRA E.
C’eſt que je n’ay point de bougie.	C'est que je n'ai point de bougie.
LACOMTESSE.	LACOMTESSE.
Comment vous n’en avez point?	Comment vous n'en avez point?
ANDRE’E.	ANDRÉ.
Non, Madame, ſi ce n’eſt des bougies de ſuif.	Non, Madame, si ce n'est des bougies de suif.
LA COMTESSE.	LA COMTESSE.
La bouviere.	La bouvière.
Et où eſt donc la cire que je fis acheter ces jours paſſez?	Et où est donc la cire que je fis acheter ces jours passés?
ANDRE’E.	ANDRÉ.
Je n’en ay point veu depuis que je ſuis ceans.	Je n'en ai point vu depuis que je suis céans.
A COMTESSE.	À COMTESSE.
Oſtez-vous de là, inſolente, je vous renvoyray chez vos parens.	Ostez-vous de là, insolente, je vous renvoierai chez vos parents.
Apportez moy un verre d’eau.	Apportez -moi un verre d'eau.
Madame, faiſant des ceremonies pour s’aſſtoir.	Madame, faisant des cérémonies pour s'asstoir.
Madame.	Madame.
UEIE.	OÙIE.
LA Ah!	LA Ah!
Madame.	Madame.
COMTESSE.	COMTESSE.
Ah!	Ah!
Madame.	Madame.
ULIE.	ULIE.
LA COMTESSE.	LA COMTESSE.
Mon dieu, Madame.	Mon dieu, Madame.
U LIE.	V LIE.
Mon Dieu, Madame.	Mon Dieu, Madame.
1 AGORTESSE.	1 AGORTESSE.
Oh, Madame.	Oh, Madame.
Oh, Madame.	Oh, Madame.
JULIE.	JULIE.
A CONTESSE.	À CONTESSE.
Eh, Madame.	Eh, Madame.
Anly Biadaie.	Anli Biadaie.
ULIE.	ULIE.
LA COMTESSE.	LA COMTESSE.
He aſlons donc, Madame.	He aslons donc, Madame.
LIE.	LIE.
Héfallons donc, Madame.	Héfallons donc, Madame.
LA COUTES SE.	LA COÛTES SE.
Je ſuis chez moy, Madame, nous ſommes dememtez d'accold de cela, Me plenez-vous pour une Provinciale, Madame?	Je suis chez moi, Madame, nous sommes déminés d'accold de cela, Me plenez-vous pour une Provinciale, Madame?
LIE.	LIE.
Dieu m’en garde, Madame?	Dieu m'en garde, Madame?
LA COMTESSE.	LA COMTESSE.
Allez, impertinente, je bois avec une ſoûcoupe.	Allez, impertinente, je bois avec une soucoupe.
Je vous dis que vous m’alliez querir une leucoupe pour ponc.	Je vous dis que vous m'alliez quérir une leucoupe pour ponc.
DRE’E.	DRÉE.
Enquet, qu’eſt-ce que c’eſt qu’une ſoûcoupe?	Enquet, qu'est-ce que c'est qu'une soue?
Une ſoûcoupe?	Une soue?
I QuET.	I QuET.
Oui.	Oui.
ANDRE'E.	ANDRÉ.
Je ne ſçay.	Je ne sais.
CRIQUET.	CRIQUET.
LA COMTESSE.	LA COMTESSE.
Vous ne vous groüillez pas?	Vous ne vous grouillez pas?
A *-	A *-
ANDRE’E.	ANDRÉ.
Nous ne ſçavons tous deux, Madame, ce que c’eſt qu’une loucoupe.	Nous ne Savons tous deux, Madame, ce que c'est qu'une loucoup.
LA COMTESSE.	LA COMTESSE.
Apprenez que c’eſt une aſſiette, ſur laquelle on met le verre.	Apprenez que c'est une assiette, sur laquelle on met le verre.
Vive Paris pour eſtre bien ſervie, ou vous entend-là au moindre coup d’œil.	Vive Paris pour être bien servie, ou vous entend-là au moindre coup d'œil.
He bien vous ayje dit comme cela, teſte de bœuf?	He bien vous ayje dit comme cela, tête de bœuf?
c’eſt deſſous qu’il faut mettre l’aſſiette.	c'est dessous qu'il faut mettre l'assiette.
ANDRE'E.	ANDRÉ.
Cela eſt bien aiſé.	Cela est bien aisé.
LA COMTESSE.	LA COMTESSE.
Andrée caſſe le verre.	Andrée casse le verre.
Hé bien ne voilà pas l’étourdie?	Hé bien ne voilà pas l'étourdie?
En verité vous me payerez mon verre.	En vérité vous me paierez mon verre.
ANDREE.	ANDRÉ.
Hé bien oüy, Madame, je le payeray.	Hé bien oui, Madame, je le payerai.
LA COMTESSE.	LA COMTESSE.
Mais voyez cette mal adroite, cette bouviere, ecite oulolde, celte.	Mais voyez cette mal adroite, cette bouvière, ecite oulolde, celte.
.	.
.	.
ANDRE’R s’en allant.	ANDRE'R s'en allant.
Dame, Madame, ſi je le paye, je ne veux point eſtre querellée.	Dame, Madame, si je le paie, je ne veux point être querellée.
LA COMTESSE.	LA COMTESSE.
Oſtez-vous de devant mes yeux.	Ostez-vous de devant mes yeux.
En verité, mauame, e cls une enole ctluuge que les petites Villes;	En vérité, maume, é ls une enole ctluge que les petites Villes;
on n’y ſçait point du tout ſon monde;	on n'y sait point du tout son monde;
& je viens de faire deux ou trois viſites, où ils ont penſé me deſeſperer, par le peu de reſpect qu’ils rendent à ma qualité.	et je viens de faire deux ou trois visites, où ils ont pensé me désespérer, par le peu de respect qu'ils rendent à ma qualité.
ILIE.	ILIE.
Où auroient ils appris à vivre, ils n’ont point fait de voyage à Paris?	Où auraient ils appris à vivre, ils n'ont point fait de voyage à Paris?
LA COMTESSE.	LA COMTESSE.
Ils ne laiſſeroient pas de l’apprendre s’ils vouloient écouter les perſonnes?	Ils ne laisseraient pas de l'apprendre s'ils voulaient écouter les personnes?
mais le mal que j’y trouve, c’eſt qu’ils veufent en igavon autant que moy, moy, qui ay eſté deux mois à Paris, & veu toute la cour.	mais le mal que j'y trouve, c'est qu'ils veufent en igavon autant que moi, moi, qui ai été deux mois à Paris, et vu toute la cour.
ULIE.	ULIE.
Les ſottes gens que voilà.	Les sottes gens que voilà.
LA COMTESSE.	LA COMTESSE.
Ils ſont inſupportables, avec les impertinentes égalitez dont ils traitent les gens.	Ils sont insupportables, avec les impertinentes égalités dont ils traitent les gens.
Car enſin, il faut qu’il y ait de la ſubordination dans les choſes;	Car ensin, il faut qu'il y ait de la subordination dans les choses;
& ce qui me met hors de moy, c’eſt qu’un Gentil-homme de Ville de deux jours, ou de deux cens ans, aura l’efronterie de dile qu’il eſt auſſi bien Gentil-homme, que feu Monſieur mon mary, qui demeuroit à la campagne, qui avort meute de emens couralis;	et ce qui me met hors de moi, c'est qu'un Gentilhomme de Ville de deux jours, ou de deux cents ans, aura l'efronterie de dile qu'il est aussi bien Gentilhomme, que feu Monsieur mon mari, qui demeurait à la campagne, qui avort meute de ements couralis;
& qui prenoit la qualité de Comte dans tous les Contracts qu’il paſſoit.	et qui prenait la qualité de Comte dans tous les Contrats qu'il passait.
LIE.	LIE.
On ſçait bien mieux vivre à Paris dans ces Hôtels, dont la memoire doit eſtre ſi chéle.	On sais bien mieux vivre à Paris dans ces Hôtels, dont la mémoire doit être si chèle.
Cet Hôtel de Mouhy, Madame, cet Hôtel de Lyon, cet Hôtel de Hollande.	Cet Hôtel de Mouhi, Madame, cet Hôtel de Lyon, cet Hôtel de Hollande.
Les agreables demeures que voilà !	Les agréables demeures que voilà !
LA COMTESSE.	LA COMTESSE.
Il eſt vray qu’il y a bien de la difference de ces lieux là, à tout cecy.	Il est vrai qu'il y a bien de la différence de ces lieux là, à tout ceci.
On y voit venir du beau monde, qui ne marchande point à vous rendre tous les reſpects qu’on ſçauroit ſoûhaiter.	On y voit venir du beau monde, qui ne marchande point à vous rendre tous les respects qu'on saurait souhaiter.
On ne s’en leve pas, ſi l’on veut, de deſſus ſon ſiege;	On ne s'en lève pas, si l'on veut, de dessus son siège;
& lors que l'on veut voir la reveuë, ou le grand Ballet de Pſiche, on eſt ſervie à point nommé.	et lors que l'on veut voir la revue, ou le grand Ballet de Psiche, on est servie à point nommé.
ILIE.	ILIE.
Je penſe, Madame, que durant vôtre ſéjour à Paris, vous avez fait bien des conqueſtes de qualité.	Je pense, Madame, que durant votre siéjour à Paris, vous avez fait bien des conquêtes de qualité.
LA COMTESSE.	LA COMTESSE.
Vous pouvez bien croire, Madame, que tout ce qui s’appelle les galans de la Cour, n’a pas manqué de venir à ma porte, & de m’en conter, ter, & je garde dans ma caſſette de leurs billets, qui peuvent faire voir quelles propoſitions j’ay refuſées;	Vous pouvez bien croire, Madame, que tout ce qui s'appelle les galants de la Cour, n'a pas manqué de venir à ma porte, et de m'en conter, ter, et je garde dans ma cassette de leurs billets, qui peuvent faire voir quelles propositions j'ai refusées;
il n’eſt pas neceſſaire de vous dire leurs noms, on ſçait ce qu’on veut dire par les ga.	il n'est pas nécessaire de vous dire leurs noms, on sait ce qu'on veut dire par les ga.
lans de la Cour.	lans de la Cour.
ULIE.	ULIE.
Je m’étonne, Madame, que de tous ces grands noms que je devine, vous ayez pû redeſcendre à un Monſieur Tibaudier, le Conſeiller, & à un Monſieur Harpin, le Receveur des Tailles.	Je m'étonne, Madame, que de tous ces grands noms que je devine, vous ayez pu redescendre à un Monsieur Tibaudier, le Conseiller, et à un Monsieur Harpin, le Receveur des Tailles.
La chûte eſt grande, je vous l’avoüe.	La chute est grande, je vous l'avoue.
Car pour Monſieur vôtre Vicomte, quoy que Vicomte de Province, c’eſt toûjours un Vicomte, & il peut faire un voyage à Paris, s’il n’en a point fait;	Car pour Monsieur votre Vicomte, quoi que Vicomte de Province, c'est toujours un Vicomte, et il peut faire un voyage à Paris, s'il n'en a point fait;
mais un Conſeiſler, & un Réceveur, ſont des Ainans un peu bien minces pour une grande Comteſſe comme vous.	mais un Conseîler, et un Réceveur, sont des Ainans un peu bien minces pour une grande Comtesse comme vous.
LA COMTESSE.	LA COMTESSE.
Ce, ſont gens qu’on ménage dans les Provinces pour le beſoin qu’on en peut avoir, ils ſervent au moins à remplir les vuides de la galantene, à faire nombre de loupirans;	Ce, sont gens qu'on ménage dans les Provinces pour le besoin qu'on en peut avoir, ils servent au moins à remplir les vides de la galantène, à faire nombre de loupirants;
& il eſt bon, Madame, de ne pas laiſſer un Amant ſeul maiſtre du terrain, de peur que faute de Riyaux, ſon amour ne s’endorme ſur trop de confiance.	et il est bon, Madame, de ne pas laisser un Amant seul maître du terrain, de peur que faute de Riaux, son amour ne s'endorme sur trop de confiance.
2 M.	2 M.
l Ie Je vous avouë, Madame, qu’il y a merveilleuſement à profiter de tout ce que vous dites, c’eſt une école que vôtre converſation, & j’y viens tous les jours attraper quelque choſe.	Je Ie Une école que, Votre, conversation, y a merveilleusement à profiter de tout ce que vous dites, c'est une école que votre conversation, et j'y viens tous les jours attraper quelque chose.
SCENE III.	SCÈNE III.
SRIQUET, LA COMTESSE, JULIE, ANDRE’E, JEANNOT.	SRIQUET, LA COMTESSE, JULIE, ANDRÉE, JEANNOT.
CRIQUET.	CRIQUET.
I j’Oila Jeannor de Monneur le Comemer, qui vous demande, Madame.	I j'Oila Jeannor de Monneur le Comemer, qui vous demande, Madame.
LA COMTESSE.	LA COMTESSE.
Hé bien petit coquin, voilà encore de vos aſneries:	Hé bien petit coquin, voilà encore de vos âneries:
un Laquais qui ſçauroit vivre, auroit eſté parler tout bas à la Demoiſelle ſuivante, qui ſeroit venuë dire doucement à l’oreille de ſa Maiſtreſle, Madâme, vona le Laquais de Monſieur un tel, qui demande à vous dire un mot, à quoy la Maiſtreſſe auroit répondu, faites ſe entrer.	un Laquais qui saurait vivre, aurait été parler tout bas à la Demoiselle suivante, qui serait venue dire doucement à l'oreille de sa Maîtresle, Madame, vona le Laquais de Monsieur un tel, qui demande à vous dire un mot, à quoi la Maîtresse aurait répondu, faites se entrer.
CEIQUET.	CEIQUET.
Entrez Jeannot!	Entrez Jeannot!
LA COMTESSE.	LA COMTESSE.
Autre lourderie.	Autre lourdérie.
Qu’y a-t-il, Laquais?	Qu'y a-t-il, Laquais?
Que portes tu là ?	Que portes tu là ?
ANNOT.	ANNOT.
C’eſt Monſieur le Conſeiller, Madame, qui vous ſoûhaite le bon jour;	C'est Monsieur le Conseiller, Madame, qui vous souhaite le bon jour;
& auparavant que de venir, vous envoye des poires de ſon jardin, avee ce peuit mor deent.	et auparavant que de venir, vous envoie des poires de son jardin, ave ce peuit mór deent.
LA COMTESSE.	LA COMTESSE.
Ceſt du bon-cnreitien, qui eſt fort beau.	Cest du bon -cnreitien, qui est fort beau.
Andrée faites porter cela à l’office, Tien mon enfant voilà pour boire.	Andrée faites porter cela à l'office, Tien mon enfant voilà pour boire.
ANNOT.	ANNOT.
Oh non, Madame.	Oh non, Madame.
LA COMTESSE.	LA COMTESSE.
Tien, te dis je?	Tiens, te dis -je?
ANNOT.	ANNOT.
Mon Maiſtre m’a defendu, Madame, de rien prendre de vous.	Mon Maître m'a défendu, Madame, de rien prendre de vous.
LA COMTESSE.	LA COMTESSE.
Cela ne Tait neſſ.	Cela ne Tait nés.
ANNOT.	ANNOT.
Pardonnez-moy, Madame.	Pardonnez-moi, Madame.
CRIQUET.	CRIQUET.
Hé prenez, Jeannot, ſi vous n’en voulez pas vous me le baillerez.	Hé prenez, Jeannot, si vous n'en voulez pas vous me le baillerez.
LACONTESSE.	LACONTESSE.
Dy à ton Maiſtre que je le remercie.	Dis à ton Maître que je le remercie.
UET.	OÙT.
Donne-moy donc cela?	Donne-moi donc cela?
ANNOT.	ANNOT.
Oüy, quelque ſot.	Oui, quelque sot.
CRIQUET.	CRIQUET.
C’eſt moy qui te l’ay fait prendre.	C'est moi qui te l'ai fait prendre.
ANNOT.	ANNOT.
Je l’aurois bien pris ſans toy.	Je l'aurais bien pris sans toi.
LA COMTESSE.	LA COMTESSE.
Ce qui me plaiſt de ce Monſieur Tibaudier, c’eſt qu’il ſçait vivre avec les perſonnes de ma qualité, & qu’il eſt fort reſpectueux.	Ce qui me plaît de ce Monsieur Tibaudier, c'est qu'il avait vivre avec les personnes de ma qualité, et qu'il est fort respectueux.
SCENE IV.	SCÈNE IV.
LE VICOMTE, LA COMTESSE, JULIE, CRIQUET, ANDRE’E.	LE VICOMTE, LA COMTESSE, JULIE, CRIQUET, ANDRÉE.
N LE VTCOMTE.	 NE VTCOMTE.
Adame, je viens vous avertir que la Comedie ſera bien toſt preſte, & que dans un quartd’heure nous pouvons paſſer dans la Salle.	Adame, je viens vous avertir que la Comédie sera bien tôt prête, et que dans un quartd'heure nous pouvons passer dans la Salle.
LA COMTESSE.	LA COMTESSE.
Je ne veux point de cohuë au moins.	Je ne veux point de cohue au moins.
Que l’on diſe à mon Suiſſe qu’il ne laiſſe entrer perſonne.	Que l'on dise à mon Suisse qu'il ne laisse entrer personne.
LE VICOMTE.	LE VICOMTE.
En ce cas, Madame, je vous déclare que je renonce à la Comedie, & je n’y ſçaurois prendre de plaiſir, lors que la compagnie n’eſt pas nombreuſe.	En ce cas, Madame, je vous déclare que je renonce à la Comédie, et je n'y saurais prendre de plaisir, lors que la compagnie n'est pas nombreuse.
Croyez moy, ſi vous voulez vous bien divertir, qu’on diſe à vos gens de laiſſer entrer toute la Ville.	Croyez -moi, si vous voulez -vous bien divertir, qu'on dise à vos gens de laisser entrer toute la Ville.
LA COMTESSE.	LA COMTESSE.
Laquais un ſiege.	Laquais un siège.
Vous voila venu à propos pour recevoir un petit ſacrifice que je veux bien vous faire.	Vous voilà venu à propos pour recevoir un petit sacrifice que je veux bien vous faire.
Tenez, c’eſt un billet de Monſieur Tibaudier, qui m’envoye des poires.	Tenez, c'est un billet de Monsieur Tibaudier, qui m'envoie des poires.
Je vous donne la liberté de le lire tout haut, je ne l’ay point encore vû.	Je vous donne la liberté de le lire tout haut, je ne l'ai point encore vu.
LE VICOMTE.	LE VICOMTE.
voicy un billet du beau ityle, Madaine, & qui merite d’eſtre bien écouté.	voici un billet du beau ityle, Madaine, et qui mérite d'être bien écouté.
Il lit.	Il lit.
Mada me, je n’aurois pas pût vous faire le preſent que je vous envoye, ſi je ne recueillois pas plus de fruit de mon munes que fuu ietucitelde mon amour.	Mada me, je n'aurais pas pût vous faire le présent que je vous envoie, si je ne recueillais pas plus de fruit de mon munes que fu ietucitelde mon amour.
LA COMTESSE.	LA COMTESSE.
Cela vous marque clairement qu’il ne ſe paſſe rien entre-nous.	Cela vous marque clairement qu'il ne se passe rien entrenous.
LE VICOMTE continuë.	LE VICOMTE continue.
Les poires ne ſont pas encore bien meures, mais elles eu quadrent mieux, avec la dureté de vôtre ame, qui par ſes continuels dedains, ne me promet pas poires molles.	Les poires ne sont pas encore bien meures, mais elles eu quadrent mieux, avec la dureté de votre âme, qui par ses continuels dédains, ne me promet pas poires molles.
Trouvez bon, Madame, que ſans m’engager dans une énumeration de vos perfections & charmes, qui me jetteroit dans un progres à l'infiny, je concluë ce mot, en vous faiſant conſiderer que je ſuis d’un auſſi franc Chreſtien, que les poires que je vous envoye, puiſque je rends le bien pour le mal;	Trouvez bon, Madame, que sans m'engager dans une énumération de vos perfections et charmes, qui me jetterait dans un progrès à l'infini, je conclue ce mot, en vous faisant considérer que je suis d'un aussi franc Chrétien, que les poires que je vous envoie, puisque je rends le bien pour le mal;
c’eſt à dire, Madame, pour m’expliquer plus intelligiblement, puiſque je vous preſente des poires de bon chreſtien, pour des poires d’angoiſſe, que vos cruautez me ſont avaler tous les jours.	c'est à dire, Madame, pour m'expliquer plus intelligiblement, puisque je vous présente des poires de bon chrétien, pour des poires d'angoisse, que vos cruautés me sont avaler tous les jours.
TIPAUDIEX, vôtre Eſclave indigne.	TIPAUDIEX, votre Esclave indigne.
voila, Rona;	voilà, Rona;
Mauallle, un bihlet à garder.	Mavallle, un bihlet à garder.
LA COMTESSE.	LA COMTESSE.
Il y a peut-eſtre quelque mot qui n’eſt pas de l’Academie;	Il y a peut-être quelque mot qui n'est pas de l'Academie;
mais j’y remarque un certain reſpect qui me plaiſt beaucoup.	mais j'y remarque un certain respect qui me plaît beaucoup.
LIE.	LIE.
Vous avez raiſon, Madame, & Monſieur le Vicomte deuſt il s’en offencer, j’aymerois un homme qui meertoit comine cela.	Vous avez raison, Madame, et Monsieur le Vicomte dût il s'en offenser, j'aimerais un homme qui meertait comine cela.
SCENE V.	SCÈNE V.
MONSIEUR TIBAUDIEI, LE VICOMTE, LA COMADOGHEJOHIE, AN.	MONSIEUR TIBAUDIEI, LE VICOMTE, LA COMADOGHEJOHIE, AN.
DRE’E, CRIQUET.	DRÉE, CRIQUET.
L LA COMTESSE.	 LA COMTESSE.
Pprochez, Monſieur Tibaudier, ne craignez point d’entrer.	Prochez, Monsieur Tibaudier, ne craignez point d'entrer.
Vôtre billet a eſté bien receu, auſſi bien que vos poires, & voilà Madame qui parle pour vous, contre vôtre Rival.	Votre billet a été bien reçu, aussi bien que vos poires, et voilà Madame qui parle pour vous, contre votre Rival.
MONSIEUR TIBAUDIER.	MONSIEUR TIBAUDIER.
Je luy ſuis bien obligé, Madame, & ſi elle a jamais quelque procés en nôtre siege, elle verra que je n’oubliray pas l’honneur qu’elle me fait, de le rendte auples de ros peaurez l’Avocat de ma flâme.	Je lui suis bien obligé, Madame, et si elle a jamais quelque procès en notre siège, elle verra que je n'oublirai pas l'honneur qu'elle me fait, de le rendte auples de ros peaurez l'Avocat de ma flamme.
uLIE.	uLIE.
Vous n’avez pas beſoin d’Avocat, Monſieur, & vôtre cauſe eſt juſte.	Vous n'avez pas besoin d'Avocat, Monsieur, et votre cause est juste.
MONSIEUR TIBAUDIER.	MONSIEUR TIBAUDIER.
Ce neantmoins, Madame, bon droit a beſoin d’ayde, & j’ay ſujet d’apprehender de me voir ſuplanté par un tel Rivai, & que Madame ne ſoit circonvenuë par la qualite de Vicomte.	Ce néanmoins, Madame, bon droit a besoin d'aide, et j'ai sujet d'appréhender de me voir suplanté par un tel Rivai, et que Madame ne soit circonvenue par la qualité de Vicomte.
LE VICOMTE.	LE VICOMTE.
J’eſperois quelque choie;	J'espérais quelque choie;
Momeul Iioauurer, avant avant vôtre billet, mais il me fait craindre pour mon amour.	Momeul Iioauurer, avant avant votre billet, mais il me fait craindre pour mon amour.
MONSIEUR TIBAUDIER.	MONSIEUR TIBAUDIER.
Voicy encore, Madame, deux petits Verſets, ou couplets, que j’ay compoſez à votre honneur & gloire.	Voici encore, Madame, deux petits Versets, ou couplets, que j'ai composez à votre honneur et gloire.
LE VICOMTE.	LE VICOMTE.
Ah!	Ah!
je ne penſois pas que Monſieur Tibauuier iuin pocte, & vona pour m’achever, que ces deux petits Verſets la.	je ne pensais pas que Monsieur Tibauvier juin pocte, et vona pour m'achever, que ces deux petits Versets la.
LA COMTESSE.	LA COMTESSE.
Il veut dire deux Strophes.	Il veut dire deux Strophes.
Laquais donnez un mege a Monieur tioauulers on phait, petit animal.	Laquais donnez un mége a Monieur tioauulers on phait, petit animal.
Monſieur Tibaudier mettez vous-là, & nous liſez vos Strophes.	Monsieur Tibaudier mettez vous-là, et nous lisez vos Strophes.
MONSIEUR TIBAUDIER.	MONSIEUR TIBAUDIER.
Vne perſonne de qualité Rauit mon ame, Elle a de la beauté, J’ay de la flâme;	Une personne de qualité Ravit mon âme, Elle a de la beauté, J'ai de la flamme;
diinta je la crame D’avoir de la fierté.	diinta je la crame D'avoir de la fierté.
LE VICOMTE.	LE VICOMTE.
je ſuis perdu âprés cela.	je suis perdu âprés cela.
LA COMTESSE.	LA COMTESSE.
Le premier Vers eſt beau, 'Onu perfonne de quiaſte.	Le premier Vers est beau, ' Onu personne de quiaste.
ULIE.	ULIE.
je croy qu'il eit un peu hop fong, mais on peut prendre une licence pour dire une belle penſée.	je crois qu'il eit un peu hop fong, mais on peut prendre une licence pour dire une belle pensée.
LA COMTESSE.	LA COMTESSE.
Voyons l’autre Strophe.	Voyons l'autre Strophe.
MONSIEUR TIBAUDTIR.	MONSIEUR TIBAUDTIR.
Je ne ſçay pas ſi vous doutez de mon parfait amour;	Je ne sais pas si vous doutez de mon parfait amour;
Mais je ſçay bien que mon cœur à toute heure Veut quitter ſa chegrine demeure, Pour aller par reſpect faire au vôtre ſa Cour:	Mais je sais bien que mon cœur à toute heure Veut quitter sa chegrine demeure, Pour aller par respect faire au vôtre sa Cour:
dipnes Aſprés cela pourtant, ſeure de ma tendreſſe, Et de ma foy, dont unique eſt l’eſpece, V’ous devriez à voſtre tour Vous contentant d’eſtre Comteſſe, Vous depouiller en ma faveur, d’une peru de tigreſſe, Qui couvre vos appas, la nuit comme le jour.	dipnes Asprés cela pourtant, sûre de ma tendresse, Et de ma foi, dont unique est l'espèce, V'ous devriez à votre tour Vous contentant d'être Comtesse, Vous dépouiller en ma faveur, d'une perv de tigresse, Qui couvre vos appas, la nuit comme le jour.
LE VICOMTE.	LE VICOMTE.
Me vond Iupſante, moy, par Monſieur Tibaudier.	Me vond Iupsante, moi, par Monsieur Tibaudier.
LA COMTESSE.	LA COMTESSE.
Ne penſez pas vous mocquert, pour des Vers faits dans la Province, ces Veis-là ſont fort beaux.	Ne pensez pas vous moquert, pour des Vers faits dans la Province, ces Véis-là sont fort beaux.
LE VICOMTE.	LE VICOMTE.
Comment, Madame, me mocquer ?	Comment, Madame, me moquer ?
Quoy que ſon Rival, je trouve ces Vers admirables, & ne les appelle pas ſeulement deux Strophes, comme vous, mais deux Epigrammes, auſſi bonnes que toûtes cenes de muitiale	Quoi que son Rival, je trouve ces Vers admirables, et ne les appelle pas seulement deux Strophes, comme vous, mais deux Épigrammes, aussi bonnes que toujours cènes de muitiale
LA COMTESSE.	LA COMTESSE.
Quoy, Martial fait-il des Vers, je penſois qu’il ne fiſt que des gans?	Quoi, Martial fait-il des Vers, je pensais qu'il ne fit que des gans?
MONSIEÆUR TIEAUDIER.	MONSIEUR TIEAUDIER.
Ce n’eſt pas ce Martial-là, Madame, c’eſt un Autheur qui vivoit il y a trente, ou quarante ans.	Ce n'est pas ce Martial-là, Madame, c'est un Auteur qui vivait il y a trente, ou quarante ans.
LE VICOMTE.	LE VICOMTE.
Monſieur Tibaudier a leu les Autheurs, comme vous le voyez.	Monsieur Tibaudier a lu les Auteurs, comme vous le voyez.
Mais allons voir, Madame, ſi ma Muſique & ma Comedie, avec mes entrées de Ballet, pourront combattre dans vôtre eſprit les progrés des deux Strophes, & du billet que nous venons de voir.	Mais allons voir, Madame, si ma Musique et ma Comédie, avec mes entrées de Ballet, pourront combattre dans votre esprit les progrès des deux Strophes, et du billet que nous venons de voir.
LA COMTESSE.	LA COMTESSE.
Il faut que mon Fils le Comte ſoit de la partie, car il eſt arrivé ce matin de mon Chaſteau avec ſon Precepteur, que je voy là dedans.	Il faut que mon Fils le Comte soit de la partie, car il est arrivé ce matin de mon Château avec son Précepteur, que je vois là -dedans.
SCE	SCE
SCENE VI.	SCÈNE VI.
MONSIEUR BOBINET, Mr.	MONSIEUR BOBINET, Mr.
TIBAUDIER, hindomenou, un vadomes OLIE, ANDRE’E, CRIQUET.	TIBAUDIER, hindomenou, un vadomes OLIE, ANDRÉE, CRIQUET.
LA COMTESSE.	LA COMTESSE.
Ola, Monſieur Bobinet, Monſieur Bobinet, approchez vous du monde.	Ola, Monsieur Bobinet, Monsieur Bobinet, approchez -vous du monde.
MONSIEUR BOBINET.	MONSIEUR BOBINET.
Je donne le bon Veſpres à toute l’honorable compagilie.	Je donne le bon Vesprès à toute l'honorable compagilie.
Que dene Madaine la Comteſſe.	Que dene Madaine la Comtesse.
d’Eſcarbagnas, de ſon tres-humble Serviteur Bobinet?	d'Écarbagnas, de son très-humble Serviteur Bobinet?
LA COMTESSE.	LA COMTESSE.
A quelle heure, Monſieur Bobinet, eſtes vous Purtju mieandiguue qutee mon dls de comte?	À quelle heure, Monsieur Bobinet, êtes -vous Purt ive qu' mon dès de complète?
MONSIEUR BOBINET.	MONSIEUR BOBINET.
A huit heures trois quarts, Madame, comme votre commandement me l’avoit ordonné.	À huit heures trois quarts, Madame, comme votre commandement me l'avait ordonné.
LA COMTESSE.	LA COMTESSE.
Comment ſe portent mes deux autres Fils, le Marquis, & le Commandeur?	Comment se portent mes deux autres Fils, le Marquis, et le Commandeur?
EOASEMAR BOBINET.	EOASEMAR BOBINET.
Ils ſont, Dieu grace, Madame, en parfaite ſante.	Ils sont, Dieu grâce, Madame, en parfaite santé.
LA COMTESSE.	LA COMTESSE.
Où eſt le Comte?	Où est le Comte?
MONSIEUR BOBINET.	MONSIEUR BOBINET.
Dans vôtre belle chamble dulcove;	Dans votre belle chamble dulcove;
madame.	madame.
LA COMTESSE.	LA COMTESSE.
Que fait-il, Monſieur Bobinet?	Que fait-il, Monsieur Bobinet?
MONSIEUR BOBINET.	MONSIEUR BOBINET.
Il compoſe un Thême, Madame, que je viens de luy dicter, ſur une Epiſtre de Ciceron.	Il compose un Thême, Madame, que je viens de lui dicter, sur une Épître de Cicéron.
LA COMTESSE.	LA COMTESSE.
Faites le veml, ſuonnieuf bobines.	Faites le veml, suonnieuf bobines.
MONSIEUR BOBINET.	MONSIEUR BOBINET.
Soit fait, Madame, ainſi que vous le commandez.	Soit fait, Madame, ainsi que vous le commandez.
LE VICOMTE.	LE VICOMTE.
Ce Monſieur Bobinet, Madaie;	Ce Monsieur Bobinet, Madaie;
a la mine fort ſage, & je croy qu’il a de l’eſprit.	à la mine fort sage, et je crois qu'il a de l'esprit.
SCENE VII.	SCÈNE VII.
LA COMTESSE, LE VICOMTE, JULIE, LE COMTE, MONSIEUR BOBINET, MONSIEON IIBAODIER, ANDRE’E, CRIQUET.	LA COMTESSE, LE VICOMTE, JULIE, LE COMTE, MONSIEUR BOBINET, MONSIEN IIBADIÈR, ANDRÉ, CRIQUET.
MONSIEUR BOBINET.	MONSIEUR BOBINET.
Lrunnmromtcumiomomte, uulluolvoir que vous profitez des bons documens qu’on vous donne.	Lrunnmromtcumiomomte, uulluolvoir que vous profitez des bons documents qu'on vous donne.
La reverence à toute l’honneſte aſſemblée.	La révérence à toute l'honnête assemblée.
LA COMTESSE.	LA COMTESSE.
Comte, ſaluez Madame.	Comte, saluez Madame.
Faites la reverence à Monſieur le Vicomte, ſaluez Monſieur le Conſeiller.	Faites la révérence à Monsieur le Vicomte, saluez Monsieur le Conseiller.
MOMIEUN IIIAUDIEC.	MOMIEUN IIIAUDIEC.
Je ſuis ravy, Madame, que vous me concediez la grace d’embraſſer Monſieur le Comte vôtre Fils.	Je suis ravi, Madame, que vous me concédiez la grâce d'embrasser Monsieur le Comte votre Fils.
On ne peut pas aymer le tronc, qu’on n'ayme auſſi les branches.	On ne peut pas aimer le tronc, qu'on n'aime aussi les branches.
LA CCMTESSE.	LA CCMTESSE.
Mon Dieu, Monſieur Tibaudier, de quelle comparaiſon vous ſervez vous là?	Mon Dieu, Monsieur Tibaudier, de quelle comparaison vous servez -vous là?
ULIE.	ULIE.
En verité, Madame, Monſieur le Comte a «tout à fait bon air.	En vérité, Madame, Monsieur le Compte a «tout à fait bon air.
LE.	LE.
LE VICOMTE.	LE VICOMTE.
Voilà un jeune Gentil-homme qui vient bien dans le monde.	Voilà un jeune Gentilhomme qui vient bien dans le monde.
JULIE.	JULIE.
Qui diroit que Madame euſt un ſi grand enfant?	Qui dirait que Madame eût un si grand enfant?
LA COMTESSE.	LA COMTESSE.
Helas!	Hélas!
quand je le fis, j’eſtois ſi jeune que je me joüois encore avec une poupée.	quand je le fis, j'étais si jeune que je me jouais encore avec une poupée.
JULIE.	JULIE.
C’eſt Monſieur vôtre Frere, & non pas Monſieur vôtre Fils.	C'est Monsieur votre Frère, et non pas Monsieur votre Fils.
Aa don IessL Monſieur Bobinet, ayez bien ſoin au moins de ſon éducation.	Aa donc IessL Monsieur Bobinet, ayez bien soin au moins de son éducation.
MONSIEUR BOBINET.	MONSIEUR BOBINET.
Madame, je n’oubliray aucune choſe pour cultiver cette jeune plante, dont vos bontez m’ont fait l’honneur de me confier la conduite, & je tâcheray de luy inculquer les ſemences de la vertu.	Madame, je n'oublierai aucune chose pour cultiver cette jeune plante, dont vos bontés m'ont fait l'honneur de me confier la conduite, et je tâcherai de même inculquer les semences de la vertu.
LA COMTESSE.	LA COMTESSE.
Monſieur Bobinet, faites lui un peu dire quelque perſte galanterie de ce que vous luy apprenez.	Monsieur Bobinet, faites lui un peu dire quelque pers galanterie de ce que vous avez apprenez.
MONSIEUR BOEINET.	MONSIEUR BONEINET.
Alons, Monſieur le Comte, recitez vôtre leçon d’hier au matin.	Alons, Monsieur le Comte, récitez votre leçon d'hier au matin.
LE COMTE.	LE COMTE.
Omne viro folt quoa convenir, eſto vmle.	Omne viro folt qua convenir, éto vle.
Omne vi.	Omne vi.
LA COMTESSE.	LA COMTESSE.
Fy Monſieur Bobinet, quelles ſottiſes eſt-ce que vous luy apprenez-là?	Fi Monsieur Bobinet, quelles sottises est-ce que vous lui apprenez-là?
MONSIEUR BOBINET.	MONSIEUR BOBINET.
C’eſt du Latin, Madame, & la premiere regle de Jean Deſpautere.	C'est du Latin, Madame, et la première règle de Jean Despaute.
LA COMTESSF.	LA COMTÉS.
Mon Dieu, ce Jean Deſpautere-là eſt uninſolent, O& je & je vous prie de luy enſeigner du Latin plus hondelte que celuy Ia.	Mon Dieu, ce Jean Despautere-là est uninsolent, Ô je et je vous prie de lui enseigner du Latin plus hondelte que celui Ia.
MONSIEUR BORINET.	MONSIEUR BORINET.
Si vous voulez, Madame, qu’il acheve, la gloſe expliquera ce que cela veut dire.	Si vous voulez, Madame, qu'il achève, la glose expliquera ce que cela veut dire.
Ele da lessls Non, non, celas’ explique aſſez,	Elle da lessls Non, non, celas' explique assez,
CRIQUET.	CRIQUET.
Les Comediens envoyent dire qu’ils ſont tout preſts.	Les Comédients envoient dire qu'ils sont tout prêts.
LA COMTESSEI Allons nous placer.	LA COMTESSEI Allons nous placer.
Monſieur Tibaudier, prenez Madame.	Monsieur Tibaudier, prenez Madame.
LE VICOMTE.	LE VICOMTE.
Il eſt neceſſaire de dire, que cette Comedie n’a eſte faite que pour lier enſemble les differents morceaux de Muſique, & de danſe, dont on a voulu compoſer ce divertiſſiment, & quutr	Il est nécessaire de dire, que cette Comédie n'a este faite que pour lier ensemble les différents morceaux de Musique, et de danse, dont on a voulu composer ce divertissiment, et quarrent
LA COMTESSE.	LA COMTESSE.
Mon Dieu voyons l’affaire, on a aſſez d’eſprit pour comprendre les choſes.	Mon Dieu voyons l'affaire, on a assez d'esprit pour comprendre les choses.
LE VICOMTE.	LE VICOMTE.
Qu’on commence le plûtoſt qu’on pourra, & qu’on empeſche, s’il ſe peut, qu’aucun fâcheux ne vienne troubler nôtre divertiſſement.	Qu'on commence le plutôt qu'on pourra, et qu'on empêche, s'il se peut, qu'aucun fâcheux ne vienne troubler notre divertissement.
Aprés que les Violons ont quelque peu joüé, & que toute la Compagnie eſt aſſiſe.	Après que les Violons ont quelque peu joué, et que toute la Compagnie est assise.
SCENE VIII.	SCÈNE VIII.
LA COMTESSE, LE COMTE, LE VICOMTE, JULIE, Mr.	LA COMTESSE, LE COMTE, LE VICOMTE, JULIE, Mr.
HARPIN, MONSIEUR TIBAUDIER, aux pieds de la Comteſſe MONSIEUR BOBINET, ANDREE.	HARPIN, MONSIEUR TIBAUDIER, aux pieds de la Comtesse MONSIEUR BOBINET, ANDRÉ.
MONSIEUR HARPIN.	MONSIEUR HARPIN.
D Arbleu la choſe eſt belle, & je me réjoüis de voir ce que je voy.	D Arbleu la chose est belle, et je me réjouis de voir ce que je vois.
LA COMTESSE.	LA COMTESSE.
Hola, Momneur Ie Neceveur, que voulez-vous donc dire avec l’action que vous faites, vient on interrompre comme cela une Comedie?	Holà, Momneur Je Neceveur, que voulez-vous donc dire avec l'action que vous faites, on vient interrompre comme cela une Comédie?
MONS IEUX HARPIN.	MONS JEUX HARPIN.
Morbleu, Madame, je ſuis ravy de cette avanfuile, ce ceoj me lait von ce que je doy ctoire de vous, & l’aſſurance qu’il y a au don de vôtre cœur, & aux ſermens que vous m’avez faits de ſa fidelité.	Morbleu, Madame, je suis ravi de cette avanfuile, ce ceoj me lait von ce que je dois ctoire de vous, et l'assurance qu'il y a au don de votre cœur, et aux serments que vous m'avez faits de sa fidélité.
LA COMTESS.	LA COMTÉS.
Mais vrayment, on ne vient point ainſi ſe jetter au travers d’une Comedie, & troubler un Acteur qua paris.	Mais vraiment, on ne vient point ainsi se jeter au travers d'une Comédie, et troubler un Acteur qua paris.
MONS IEUR HARPIN.	MONS JEUR HARPIN.
En terte-oleu, la veritable Comedie qui ſe fait icy, c’eſt celle que vous joüez, & ſi je vous trouble, c’eſt dequoy je me ſoucie peu.	En terte-oleu, la véritable Comédie qui se fait ici, c'est celle que vous joüez, et si je vous trouble, c'est dequoy je me soucie peu.
LA COMTESSE.	LA COMTESSE.
En verité vous ne ſçavez ce que vous dites.	En vérité vous ne savez ce que vous dites.
MONSIEUR HARPIN.	MONSIEUR HARPIN.
Si fait morbleu je le ſçay bien, je le ſçay bien, morbleu, &.	Si fait morbleu je le sais bien, je le sais bien, morbleu, et.
LA COMTESSE.	LA COMTESSE.
Eh fy, Monſieur, que cela eſt vilain de jurer de la forte.	Eh fi, Monsieur, que cela est vilain de jurer de la forte.
MONSIEUR HARPIN.	MONSIEUR HARPIN.
Eh ventrebleu, s’il y a icy quelque choſe de vilain, ce ne ſont point mes juremens, ce ſont vos actions, & il vaudroit bien mieux que Vous juraſſiez, vous, la teſte, la mort & le ſang, que de faire ce que vous faites avec Monſieur le Vicomte.	Eh ventrebleu, s'il y a ici quelque chose de vilain, ce ne sont point mes jurements, ce sont vos actions, et il vaudrait bien mieux que Vous jurassiez, vous, la tête, la mort et le sang, que de faire ce que vous faites avec Monsieur le Vicomte.
LE VICOMTE.	LE VICOMTE.
je ne ſcay pas, Monſieur le Receveur, dequoy vous vous plaignez, & ſi.	je ne sais pas, Monsieur le Receveur, de quoi vous plaignez, et si.
MONSIEUR HARPIN.	MONSIEUR HARPIN.
Pour vous, Monſieur, je n’ay rien à vous dire, vous faites bien de pouſſer vôtre pointe, cela eſt naturel, je ne le trouve point étrange, & je Vous demande pardon ſi j’interromps vôtre Comedie;	Pour vous, Monsieur, je n'ai rien à vous dire, vous faites bien de pousser votre pointe, cela est naturel, je ne le trouve point étrange, et je Vous demande pardon si j'interromps votre Comédie;
mais vous ne devez point trouver étrange auſſi que je me plaigne de ſon procedé, & nous avons raiſon tous deux de faire ce que nous faiſons.	mais vous ne devez point trouver étrange aussi que je me plaigne de son procédé, et nous avons raison tous deux de faire ce que nous faisons.
LE VICOMTE.	LE VICOMTE.
Je n’ay rien à dire à cela, & ne ſçay point les ſujets de plaintes, que vous pouvez avoir contre Madame la Comteſſe d’Eſcarbagnas.	Je n'ai rien à dire à cela, et ne sais point les sujets de plaintes, que vous pouvez avoir contre Madame la Comtesse d'Écarbagnas.
LA COMTESSE.	LA COMTESSE.
und on à des enaginis jaioua, on n’en uíe point de laſorte, & l’on vient doucement ſe plaindre à la perſonne que l’on ayme.	und on à des enaginis joua, on n'en uíe point de lasorte, et l'on vient doucement se plaindre à la personne que l'on aime.
MONSIEUR HARPIN.	MONSIEUR HARPIN.
Moy me plaindre doucement?	Moi me plaindre doucement?
LA COMTESSE.	LA COMTESSE.
Oüy.	Oui.
L’on ne vient point crier de deſſus un Theatre, ce qui ſe doit dire en particulier.	L'on ne vient point crier de dessus un Théâtre, ce qui se doit dire en particulier.
MONSIEUR HARPIN.	MONSIEUR HARPIN.
J’y viens moy morbleu tout exprés, c’eſt le lieu qu’il me faur, & je ſouhaiterois que ce fuſt un TheaTheatre public, pour vous dire avec plus d’éclattoutes vos veritez.	J'y viens moi morbleu tout exprès, c'est le lieu qu'il me saur, et je souhaiterais que ce fût un Théâtre public, pour vous dire avec plus d'éclattoutes vos vérités.
LA COMTESSE.	LA COMTESSE.
Faut-il faire un ſi grand vacarme pour une Comedie, que Monſieur le Vicomte me donne?	Faut-il faire un si grand vacarme pour une Comédie, que Monsieur le Vicomte me donne?
vous voyen que Momieur Pouudrer qui als ayine en uſe plus reſpectueuſement que vous.	vous voyen que Momieur Pouudrer qui als aiine en use plus respectueusement que vous.
MONSIEUR HARPIN.	MONSIEUR HARPIN.
Monſieur Tibaudier en uſe comme il luy plaiſt;	Monsieur Tibaudier en use comme il lui plaît;
je ne ſçay pas de quelle façon Monſieur Tibaudier a eſté avec vous, mais Monſieur Tibaudier n’eſt pas un exemple pour moy, & je ne ſuis point d’humeur à payer les Violons pour faire danſer les autres.	je ne sais pas de quelle façon Monsieur Tibaudier a été avec vous, mais Monsieur Tibaudier n'est pas un exemple pour moi, et je ne suis point d'humeur à payer les Violons pour faire danser les autres.
LA COMTESSE.	LA COMTESSE.
Mais vrayment, Monſieur le Receveur, vous ne ſongez pas à ce que vous dites, on ne traite point de la ſorte les Femmes de qualité, & ceux qui vous entenuent croifoient qu’il y a quelque choſe d’êtrange entre vous & moy.	Mais vraiment, Monsieur le Receveur, vous ne songez pas à ce que vous dites, on ne traite point de la sorte les Femmes de qualité, et ceux qui vous entenuent croisaient qu'il y a quelque chose d'étrange entre vous et moi.
MONSIXUR HARPIN.	MONSIXUR HARPIN.
Hé ventrebleu, Madame, quittons la faribole.	Hé ventrebleu, Madame, quittons la faribole.
LA COMTESSE.	LA COMTESSE.
Que voulez-vous donc dire, avec vôtre quittons la faribole?	Que voulez-vous donc dire, avec votre quittons la faribole?
MONSIEUR HARPIN.	MONSIEUR HARPIN.
Je veux dire, que je ne trouve point étrange que vous vous rendiez au merite de Monſieur le Vicomte, vous n’eſtes pas la premiere Femme qui jouë dans le monde de ces ſortes de caracteres, & qui ait auprés d’elle un Monſieur le Receveur, dont on lui voit trahir, & la paſſion, & la bourſe pour le premier venu qui luy donnera dans la veuë;	Je veux dire, que je ne trouve point étrange que vous vous rendiez au mérite de Monsieur le Vicomte, vous n'êtes pas la première Femme qui joue dans le monde de ces sortes de caractères, et qui ait auprès d'elle un Monsieur le Receveur, dont on lui voit trahir, et la passion, et la bourse pour le premier venue qui était donnera dans la vue;
mais ne trouvez point étrange auſſi que je ne ſois point la dupe d’une infidelité ſi ordinaire aux coquettes du temps, & que je vienne vous aſſurer devant bonne compagnie, que je romps commerce avec vous, & que Monſieur le Receveur ne ſera plus pour vous Monſieur ſe donneur.	mais ne trouvez point étrange aussi que je ne sois point la dupe d'une infidélité si ordinaire aux coquettes du temps, et que je vienne vous assurer devant bonne compagnie, que je romps commerce avec vous, et que Monsieur le Receveur ne sera plus pour vous Monsieur se donneur.
LA COMTESSE.	LA COMTESSE.
Cela eſt merveilleux, comme les Amans emportez deviennent à la mode;	Cela est merveilleux, comme les Amants emportés deviennent à la mode;
on ne voit autre choſe de tous coſtez.	on ne voit autre chose de tous côtés.
Là, là, Monſieur le Receveur, quittez votle coicle, de venen plendie place pour voir la Comedie.	Là, là, Monsieur le Receveur, quittez votle coicle, de venen plendie place pour voir la Comédie.
MONSIEUR HARPIN.	MONSIEUR HARPIN.
Moy, morbleu prendre place, cherchez vos benets à vos pieds.	Moi, morbleu prendre place, cherchez vos benêts à vos pieds.
Je vous laiſſe, Madame la Comteſſe, à Monſieur le Vicomte, & ce ſera à luy que j’envoyray tanton rouieutein vona ina Scene faite;	Je vous laisse, Madame la Comtesse, à Monsieur le Vicomte, et ce sera à cause que j'envoyrai tanton rouieutein vona ina Scène faite;
voilà mon rôle joüé.	voilà mon rôle joué.
Serviteur à la compagnie.	Serviteur à la compagnie.
MONSIEUR TIBAUDIER.	MONSIEUR TIBAUDIER.
Monſieur le Receveur, nous nous verrons autre part qu’icy, & je vous feray voir, que je ſuis au poil, & à la plume.	Monsieur le Receveur, nous nous verrons autre part qu'ici, et je vous ferai voir, que je suis au poil, et à la plume.
MONSLGSIIARTINO.	MONSLGSIIARTINO.
Tu as raiſon, Monſieur Tibaudier.	Tu as raison, Monsieur Tibaudier.
LA COMTESSE.	LA COMTESSE.
Pour moy je ſuis confuſe de cette inſolence.	Pour moi je suis confuse de cette insolence.
LE VICOMTE.	LE VICOMTE.
Les jaloux, Madame, ſont comme ceux qui perdent leur procés, ils ont permiſſion de tout dire.	Les jaloux, Madame, sont comme ceux qui perdent leur procès, ils ont permission de tout dire.
Preſtons ſilence à la Comedie.	Prêtons silence à la Comédie.
SCENE DERNIERE.	SCÈNE DERNIÈRE.
LACOMTESSE, LEVICOMTE.	LACOMTESSE, LEVICOMTE.
LE COMTE, JULIE, Mr.	LE COMTE, JULIE, Mr.
TIBAUDIER, MONSIEUR BOBINET, ANDRE’E, JEANNOT, CRIQUEIS	TIBAUDIER, MONSIEUR BOBINET, ANDRÉE, JEANNOT, CRIQUEIS
JEANROY.	JEANROY.
J oilà un billet, Monſieur, qu’on nous a dit de vous donner viſte.	 Joilà un billet, Monsieur, qu'on nous a dit de vous donner vite.
LE VICOMTE lit.	LE VICOMTE lit.
En cas que vous ayez quelque meſure à prendre, ja vous envoye promptement un avis.	En cas que vous ayez quelque mesure à prendre, ja vous envoie promptement un avis.
La querelle de vos Parens & de ceux de Julie, vient d'eſtre accomodée, & les conditions de cet accord, c’eſt le Mariage de vous, & d’elle.	La querelle de vos Parents et de ceux de Julie, vient d'être accommodée, et les conditions de cet accord, c'est le Mariage de vous, et d'elle.
Bon ſoir.	Bon soir.
Ma foy, Madame, voilà nôtre Comedie achevée auiii.	Ma foi, Madame, voilà notre Comédie achevée auji.
JULIE.	JULIE.
An!	An!
Cleante quel bon-heur!	Cléante quel bonheur!
notre amour euſtil oſé eſperer un ſi heureux ſuccés?	notre amour eûtil osé espérer un si heureux succès?
LA COMTESSE.	LA COMTESSE.
Comment donc, qu’eſt ce que cela veut dire?	Comment donc, qu'est ce que cela veut dire?
LE VICOMTE.	LE VICOMTE.
melu reut dne, mnadaie, quej epouie juiſe, & ſi vous m’en croyez, pour rendre la Comedie complette de tout point, vous épouſerez Monſieur Tipaudier, & donnerez Mademoiſelle Andrée à ſon Laquais, dont il fera ſon Valet de chambré.	melu reut dne, ménadaie, quej ouïe juise, et si vous m'en croyez, pour rendre la Comédie compllette de tout point, vous épouserez Monsieur Tipaudier, et donnerez Mademoiselle Andrée à son Laquais, dont il fera son Valet de chambré.
LA COMTESSE.	LA COMTESSE.
Quoy joüer de la ſorte une perſonne de ma qua1°?	Quoi jouer de la sorte une personne de ma qua16?
LE VICOMTE.	LE VICOMTE.
C’eſt ſans vous offencer, Madame, & les Comedie eulent de ces ſortes de choſes.	C'est sans vous offenser, Madame, et les Comédie élent de ces sortes de choses.
LA COMTESSE.	LA COMTESSE.
Oüy, Monſieur Tibaudier, je vous épouſe, pour faire ehragertout le monde.	Oui, Monsieur Tibaudier, je vous épouse, pour faire ehragertout le monde.
MONSIEUR TIBAUDIER.	MONSIEUR TIBAUDIER.
Ce m’eſt bien de l’honneur, Madame.	Ce m'est bien de l'honneur, Madame.
LEVICOMTE.	LEUICOMTE.
Souffrez, Madame, qu’en enrageant, nous puiſ.	Souffrez, Madame, qu'en enrageant, nous puis.
ſions voir icy le reſte du ſpectacle.	sions voir ici le reste du spectacle.
FIN.	FIN.
LA COMTESSE.	LA COMTESSE.
Oüy, Monſieur Tibaudier, je vous épouſe, pour faire ehragertout le monde.	Oui, Monsieur Tibaudier, je vous épouse, pour faire ehragertout le monde.
MONSIEUR TIBAUDIER.	MONSIEUR TIBAUDIER.
Ce m’eſt bien de l’honneur, Madame.	Ce m'est bien de l'honneur, Madame.
LEVICOMTE.	LEUICOMTE.
Souffrez, Madame, qu’en enrageant, nous puiſ.	Souffrez, Madame, qu'en enrageant, nous puis.
ſions voir icy le reſte du ſpectacle.	sions voir ici le reste du spectacle.
FIN.	FIN.
