PREFACE.	PRÉFACE.
Ly a long-temps qu’on auroit vut paroître ſur la Scene ce ſujet, qui  eſt un des plus grands & des plus na-i beaux de l’antiquité, ſt nos meilleurs Autheurs avoient crit pouvoir en ſurmonter les difficulteZ:	Ly a longtemps qu'on aurait vut paraître sur la Scène ce sujet, qui est un des plus grands et des plus na-y beaux de l'antiquité, st nos meilleurs Auteurs avaient crit pouvoir en surmonter les difficultés:
mais quand on eſt jeune on eſt toujours temeraire.	mais quand on est jeune on est toujours téméraire.
& l’on eſt quel quefois heureux.	et l'on est quel quefois heureux.
D’ailleurs comme l’on ſçait aſſeZ que la qualité d’Autheur n’eſt pai celle qui m’honnore le plus, j’ay voulu traiter un ſijet dont la reuſſite me déterminaſt à trauailler pour le Theatre, ou à employer mes momens de loiſir à quelque occupation qui me fuſt plits convenable.	D'ailleurs comme l'on sait assez que la qualité d'Auteur n'est pai celle qui m'honore le plus, j'ai voulu traiter un sijet dont la réussite me déterminât à travailler pour le Théâtre, ou à employer mes moments de loisir à quelque occupation qui me fût plits convenable.
Madame la Princeſſe de Conty, cheZ qui j’ay ou l’honneur d’eſtre élevé, me choiſit elle-même ce ſujet préferablement à beaucoup d’autres.	Madame la Princesse de Conty, chez qui j'ai ou l'honneur d'être élevé, me choisit elle-même ce sujet préférablement à beaucoup d'autres.
Ty ay donné tous mes ſoins;	Ty ai donné tous mes soins;
& ce qui me confirme encore dans la bonne opinion que j’en ay, c’eſt qu’on le voit encore paroiſtre tous les jours ſir la Scene avec autant de plaiſir & d’applaudiſſemens que dant les premieres repreſentations, je puir dire que cet Ouvrage a eſté ſi gercralement approirvé de tout et monde, que je ne répondray pas ſeulemenr à la mauvaiſe critique de ceux qui out condané Thoas & Thomiris:	et ce qui me confirme encore dans la bonne opinion que j'en ai, c'est qu'on le voit encore paraître tous les jours sir la Scène avec autant de plaisir et d'applaudissements que dant les premières représentations, je puir dire que cet Ouvrage a été si gercralement approuvé de tout et monde, que je ne répondrai pas seulemenr à la mauvaise critique de ceux qui out condamé Tho et Mir:
Cun eſt dans Euripide, ſaus lequel il n’y auroit point de P'iece, & je me ſuis aſſeZ bien trouvé de l'autre pour ne m’en pas repentir.	Cun est dans Euripide, saus lequel il n'y aurait point de P'ièce, et je me suis assez bien trouvé de l'autre pour ne m'en pas repentir.
La perte que fit le Theatre, en perdant Mademoiſelle de Champmeſle, m’avoit empeſché de faire imprimer cette Picce;	La perte que fit le Théâtre, en perdant Mademoiselle de Champmesle, m'avait empêché de faire imprimer cette Picce;
mais depuis qu’une jeune Aclrice, qui a parut ces jourt paſſeZ, nous en a rafraîchy la memoire, je me ſuis laiſſe vaincre par les preſſantes ſollicitations de mes amis, qui, avec mes autres Ouvraget, m’ont perſuadé de donner encore celuycy ait public, mne ſlattant que la lecture ne liy en fera pas moins de plaiſir que la repreſentation.	mais depuis qu'une jeune Aclice, qui a parut ces jourt passez, nous en a rafraîchi la mémoire, je me suis laisse vaincre par les pressantes sollicitations de mes amis, qui, avec mes autres Ouvraget, m'ont persuadé de donner encore celuici ait public, mê nant que la lecture ne li en fera pas moins de plaisir que la représentation.
EXTRAIT	EXTRAIT
EXTRAIT DU PRIVILEGE du Roi.	EXTRAIT DU PRIVILÈGE du Roi.
AR Grace & Privilege du Roy, donné à VerI ſailles le douziéme Fevrier 1699.	AR Grâce et Privilège du Roi, donné à VerI sailles le douzième Février 1699.
Signé, Par le Roy en ſon Conſeil, LE FEVRE.	Signé, Par le Roi en son Conseil, LE SEVRÉ.
Il eſt permis à PIERRE RIBOu Marchand Libraire à Paris, de faite imptimet le Recueil des Tragedies du Sieur de la Grange, pendant le temps de huit années, à compter du jour que chaque Tragedie ſera achevée d’imprimer pour la premiere fois;	Il est permis à PIERRE RIBOu Marchand Libraire à Paris, de faite imptimet le Recueil des Tragédies du Sieur de la Grange, pendant le temps de huit années, à compter du jour que chaque Tragédie sera achevée d'imprimer pour la première fois;
Pendant lequel temps faiſons tres-expreſſes défenſes à toutes perſonnes de quelque qualité & condition qu’elles ſoient, de faire imprimet, vendre ny debiter d’autre Edition que de celle de I’Expoſant, ou de ceux qui autont droit de luy, à peine de quinte cens livres d’amende, payables ſans deport par chacun des contrevenans, de de tous depens, dommages & intereſts, & autres peines portées plus au long par leſdites Lettres de Privilege.	Pendant lequel temps faisons très -expresses défenses à toutes personnes de quelque qualité et condition qu'elles soient, de faire imprimet, vendre sans débiter d'autre Édition que de celle de J'Exposant, ou de ceux qui autont droit de soins, à peine de quinte cens livres d'amende, payables sans déport par chacun des contrevenants, de de tous dépens, dommages et intérêts, et autres peines portées plus au long par lesdites Lettres de Privilège.
Regiſtré ſur le Livre de le Communauté des Imprimeun, & Marchands Libraites de Paris le 26.	Registré sur le Livre de le Communauté des Imprimeun, et Marchands Libraites de Paris le 26.
Fevrier 1699.	Février 1699.
Signé, C.	Signé, Ç.
BALLARD, Syndic.	BALARD, Syndic.
Achevé d’imprimer pour la preraiere fois le 2o.	Achevé d'imprimer pour la prraière fois le 2o.
Mars 1699.	Mars 1699.
AOTDORO.	ÀOTDORO.
IPHIGENIE, Fille d’Agamemnon, grande ORESTE.	IPHIGENIE, Fille d'Agamemnon, grande ORÉTE.
Preſtreſſe de Diane.	Prêtresse de Diane.
Frere d’Iphigenie.	Frère d'Iphigénie.
ORESTE	ORÊTE
ORESTE ET PILADE, TPHIGENIE EN TAURIDE.	ORÊTE ET PILADE, THIGENIE EN TAURIDE.
TRAGEDIE.	TRAGÉDIE.
AOTE SCENE PREMIERE.	ÀTE SCÈNE PREMIÈRE.
THOAS, HIDASPE.	THOAS, HIDASPE.
EIGNEUR, voicy le jour ſi longtemps ſouhaité, Où cenduit par l’hymen à la felicité, Thoas, l’heureux Thoas, épouſe ce qu’il aime.	EIGNEUR, voici le jour si longtemps souhaité, Où cenduit par l'hymen à la félicité, Thoas, l'heureux Thoas, épouse ce qu'il aime.
C’eſtoit peu qu’éloigné de la grandeur ſuprê	C'était peu qu'éloigné de la grandeur suprêné
me, Par vos ſeules vertus, ſans le ſecours du ſang.	me, Par vos seules vertus, sans le secours du sang.
, Vous euſſiez pû monter à cet auguſte rang:	, Vous eussiez pu monter à cet auguste rang:
C’eſtoit peu que de voir les Scythes indomptables, Vous ſoûmettre à l'envy leur rives redoutables, Pour vous faire un deſtin digne de vos exploits:	C'était peu que de voir les Scythes indomptables, Vous soumettre à l'envi leur rives redoutables, Pour vous faire un destin digne de vos exploits:
Et donner une, épouſe au plus grand de nos Rois.	Et donner une, épouse au plus grand de nos Rois.
Nous avons vû Diane en ces lieux adorée, Dans un éclat pompeux, par la route azurée, Vous amener, Seigneur, cette auguſte beauté, De qui voſtre conſtance a vaincu la fierté.	Nous avons vu Diane en ces lieux adorée, Dans un éclat pompeux, par la route azurée, Vous amener, Seigneur, cette auguste beauté, De qui votre constance a vaincu la fierté.
Tout vous rit :	Tout vous rit :
la ſplendeur qui dans ces lieux éclate, Eſt relevee encor par celle du Sarmate, Dont les Ambaſſadeurs honorent voſtre Cour.	la splendeur qui dans ces lieux éclate, Est relève encor par celle du Sarmate, Dont les Ambassadeurs honorent votre Cour.
Enfin pour vous combler de gloire ce grand jour.	Enfin pour vous combler de gloire ce grand jour.
HOAS.	HÔOAS.
A-t-on tout préparé?	A-t-on tout préparé?
verray-je la Princeſſe, Hidaſpe?	verrai-je la Princesse, Hidaspe?
HIDASPE.	HIDASPE.
Elle eſt encore aux pieds de-la Deeſſe.	Elle est encore aux pieds de -la Déesse.
«Tandis que de ce Grec à la mort deſtiné, On couronne de fleurs le front infortuué.	«Tandis que de ce Grec à la mort destiné, On couronne de fleurs le front infortué.
Pleine d’un feu divin dans l’enceinte ſacrée, Au fond du Sanctuaire elle s’eſt retitée:	Pleine d'un feu divin dans l'enceinte sacrée, Au fond du Sanctuaire elle s'est retitée:
Où ſon cœur attentif ſemble ſe préparer, Au myſtere ſanglant qu’elle va celebrer.	Où son cœur attentif semble se préparer, Au mystère sanglant qu'elle va célébrer.
Mais que vois-je!	Mais que vois-je!
en ce jour de gloire & d’allegreſſe, Qui n’attend que ce ſang qu’éxige la Deeſſe, Pour faire que ſans crime un Roy victorieux Poſſede enfin un cœur reſe.	en ce jour de gloire et d'allégresse, Qui n'attend que ce sang qu'éxige la Deesse, Pour faire que sans crime un Roi victorieux Possède enfin un cœur rée.
vé pour les Dieux:	vé pour les Dieux:
Lors qu’à ces nœuds ſacrez il n’eſt rien qui s’oppoDe ce ſombre chagrin qui peut être la cauſe?	Lors qu'à ces nœuds sacrés il n'est rien qui s'oppoDe ce sombre chagrin qui peut être la cause?
Me ſeroit-il permis, ſans ſortir du devoir, D’oſer m’en informer?	Me serait-il permis, sans sortir du devoir, D'oser m'en informer?
Ne le puis-je ſçavoir?	Ne le puis-je savoir?
THOAS.	THOAS.
Fieureux qui lans feniorus, portaiſt un Diadême, N’a point à redouter la vangeance ſuprême, Et n’eſt point obligé de conſerver ce rang, Par des droits violez, & des fleuves de ſang.	Fieureux qui lans feniorus, portait un Diadème, N'a point à redouter la vengeance suprême, Et n'est point obligé de conserver ce rang, Par des droits violez, et des fleuves de sang.
HIDASPE.	HIDASPE.
Qu'entens-je?	Qu'entends-je?
quel diſcours, Seigneur, qui vous I’inſpire?	quel discours, Seigneur, qui vous J'inspire?
Je n’ay pas oublié qu’en acceptant l’Empire, Vous jurâtes d’abord d’épouſer Thomiris.	Je n'ai pas oublié qu'en acceptant l'Empire, Vous jurâtes d'abord d'épouser Thomiris.
Que ſon pere en mourant mit le Sceptre à ce prix.	Que son père en mourant mit le Sceptre à ce prix.
Pour acquerir un Trone on oſe tout promettre.	Pour acquérir un Trone on ose tout promettre.
Mais ſur le Trône aſſis on ſe peut tout permettre:	Mais sur le Trône assis on se peut tout permettre:
Tranquile Souverain, & Vainqueur tant de fois, vous n’avez qu’à parler, tout fléchit ſous vos loix.	Tranquille Souverain, et Vainqueur tant de fois, vous n'avez qu'à parler, tout fléchit sous vos lois.
Dans luu ſenentimens i'nomsis n’eſt qu’à plaindre.	Dans lu sennentiments j'noms n'est qu'à plaindre.
THOAS.	THOAS.
Dans ſes reſſentimeus Thomiris eſt à craindre.	Dans ses ressentimeus Thomiris est à craindre.
Quelque trouble pourtant qu’elle puiſſe exciter;	Quelque trouble pourtant qu'elle puisse exciter;
De plus cruels chagrins viennent m’inquieter:	De plus cruels chagrins viennent m'inquiéter:
Elle n’eſt pas la ſeule icy que je iedoε¬.	Elle n'est pas la seule ici que je iedoε¬.
HIDASPE.	HIDASPE.
Et quel autle ennemy pouvez-vous craindre?	Et quel autle ennemi pouvez-vous craindre?
THOAS.	THOAS.
Ecoûte.	Écoute.
Quand le feu Roy, parmy tant de Scythes fameux, Daigna tourner ſur moy ſes regards & ſes vœux, Et me faire en mourant l’appuy de ſa famille, En m’accordant le Sceptre, & me donnant ſa fille:	Quand le feu Roi, parmi tant de Scythes fameux, Daigna tourner sur moi ses regards et ses vœux, Et me faire en mourant l'appui de sa famille, En m'accordant le Sceptre, et me donnant sa fille:
Guidé par mon devoir pluſque par mes ſermens, Je vorois chaque jour dans mes empreſſemens, T homiris s’applaudir d’augmenter ma tendreſſe.	Guidé par mon devoir plusque par mes serments, Je vorais chaque jour dans mes empressements, T omiris s'applaudir d'augmenter ma tendresse.
Helas.	Hélas.
je n’avois point encor vû la Preſtreſſe.	je n'avais point encor vu la Prêtresse.
Le jour qui l’amena dans toute ſa ſplendeur, Eclaira ſon triomphe enſemble, & mon malheur.	Le jour qui l'amena dans toute sa splendeur, Eclaira son triomphe ensemble, et mon malheur.
Mes yeux ne furent plus atrachez que ſur elle.	Mes yeux ne furent plus atrachés que sur elle.
Perfide à Thomiris, à ma gloire infidelle.	Perfide à Thomiris, à ma gloire infidèle.
Pour m’aſſurer le Trône, & regner ſans effroy, De tous ceux que j’en crus auſſi dignes que moy, Hidaſpe, j'étouffay l’eſpoir ayec la vie.	Pour m'assurer le Trône, et régner sans effroi, De tous ceux que j'en crus aussi dignes que moi, Hidaspe, j'étouffai l'espoir aiec la vie.
Mes ennemis domptez, la Thauride aſſervie, Parez de ces grands noms, de ces fameux exploits, Que la victoire ajoûte à la pourpre des Rois, le parlay de mes feux en Amant ſeur de plaire.	Mes ennemis domptés, la Thauride asservie, Parez de ces grands noms, de ces fameux exploits, Que la victoire ajoute à la pourpre des Rois, le parlai de mes feux en Amant sûr de plaire.
Quel revers!	Quel revers!
la Preſtreſſe inconne, étrangere.	la Prêtresse inconne, étrangère.
, Ne crut pas mon amour digne d’eſtre écoûté.	, Ne crut pas mon amour digne d'être écouté.
Que dis-je?	Que dis-je?
Elle pouſſa ſon injuſte ſierté Juſqu’à me refuſer;	Elle poussa son injuste sierté Jusqu'à me refuser;
ſoit mépris, ſoit prudence, De m’apprendre ſon nom, ſon païs, ſa naiſſance.	soit mépris, soit prudence, De m'apprendre son nom, son pays, sa naissance.
Cet orgueil imprévû ne fit que m’irriter.	Cet orgueil imprévu ne fit que m'irriter.
Pour fléchir ſa rigueur on me vit tout tenter:	Pour fléchir sa rigueur on me vit tout tenter:
Mais en vain:	Mais en vain:
je ne fis qu’augmenter ſon audace:	je ne fis qu'augmenter son audace:
Des Dieux, toutes les nuits, éprouvant la menact, Je voulus de mon ſort ſçavoir la verité.	Des Dieux, toutes les nuits, éprouvant la menact, Je voulus de mon sort avoir la vérité.
Voicy nar Apellen, ve qui me fut dicté.	Voici nar Apellen, ve qui me fut dicté.
Tu joüiras du Sceptre & de la vis, Tant quom jeras poſſeſſeur Du ſimulachre de ma Sœur:	Tu jouiras du Sceptre et de la vis, Tant quom jeras possesseur Du simulachre de ma Sœur:
Mais crains d’un Grec la main impie.	Mais crains d'un Grec la main impie.
La Statuë enlevée expiant ſa fureur, Te menace d’un ſort funeſte.	La Statue enlevée expiant sa fureur, Te menace d'un sort funeste.
Tremble, Thous, au nom d’Oreſte.	Tremble, Thous, au nom d'Oreste.
Quel Oracle!	Quel Oracle!
HIDASPE.	HIDASPE.
HOAS.	HÔOAS.
En ſecret m’ayant eſté rendu, R'appellant auſſi-tôt mon eſprit éperdu, Pour aſſurer mes jours contre ce coup funeſte, Je crus que je devois cacher le nom d’Oreſte;	En secret m'ayant été rendu, Rappelant aussitôt mon esprit éperdu, Pour assurer mes jours contre ce coup funeste, Je crus que je devais cacher le nom d'Oreste;
Rejetter.	Rejeter.
ſur les Grees ma crainte, & mon couroux, Et dans ce crime affreux les envelopper tous.	sur les Grez ma crainte, et mon courroux, Et dans ce crime affreux les envelopper tous.
Pour engager mon peuple à cet arreſt ſiniſtre, Je fis parler des Dieux le plus zelé Miniſtre.	Pour engager mon peuple à cet arrêt sinistre, Je fis parler des Dieux le plus zélé Ministre.
Les Scythes à ſa voix tremblerent pour l’Etat.	Les Scythes à sa voix tremblèrent pour l'État.
Tous s’armerent de cris contre cet attentat.	Tous s'armèrent de cris contre cet attentat.
De tous les Etrangers la perte fut jurée.	De tous les Étrangers la perte fut jurée.
Leurs jours furent proſcrits à Diane implorée.	Leurs jours furent proscrits à Diane implorée.
Que de ſang a depuis arroſé ſon Autel!	Que de sang a depuis arrosé son Autel!
Que d’innocens punis pour un ſeul criminel!	Que d'innocents punis pour un seul criminel!
Ces meurtres redoublez, ces ſanglantes victimes, Sans adoucir mes maux multiplioient mes crimes.	Ces meurtres redoublés, ces sanglantes victimes, Sans adoucir mes maux multipliaient mes crimes.
Rapellant ma raiſon dans ces obſcuritez.	Rappelant ma raison dans ces obscurités.
Voulant de cet Oreſte avoir quelques clartez.	Voulant de cet Oreste avoir quelques clartés.
Anthenor dont tu ſçais la prudence & l'adreſſe,.	Anthénor dont tu sais la prudence et l'adresse,.
Inſtruit de mon ſecret fit voile pour la Grece.	Instruit de mon secret fit voile pour la Grèce.
Depuis un an entier qu’il a quitté ce port, Il ne m’a point encor informé de ſon ſort:	Depuis un an entier qu'il a quitté ce port, Il ne m'a point encor informé de son sort:
Le mien traîne par tout le chagrin qui m’accable:	Le mien traîne par tout le chagrin qui m'accable:
Ce jour même, ce jour qu’un hymen favorable, Va mettre dans mon lit cette ſiere beauté, Ce prix de ma conſtance, & qui m’a tant coûté;	Ce jour même, ce jour qu'un hymen favorable, Va mettre dans mon lit cette sienne beauté, Ce prix de ma constance, et qui m'a tant coûté;
Je n’ay de mon bonheur qu’une joye inquiete.	Je n'ai de mon bonheur qu'une joie inquiète.
Etonné, traverſé d’une crainte ſecrete, Sans relâche.	Étonné, traversé d'une crainte secrète, Sans relâche.
Ah-!	Ah-!
grand Dieux, que vois-je!	grand Dieux, que vois-je!
eſt-ce Anthenor?	est-ce Anthénor?
eCMxvMI.	eCMxvMI.
THOAS, HIDASPE, ANTHENOR,	THOAS, HIDASPE, ANTHENOR,
T.	T.
HOAS.	HÔOAS.
el!	Que!
il m'eſt donc permis de te revoir encor.	il m'est donc permis de te revoir encor.
CAmy, de ton retour que faut-il que j’augute?	CAmi, de ton retour que faut-il que j'augute?
Qu’as-tu dévelopé de ma triſte avanture?	Qu'as-tu développé de ma triste aventure?
Parle:	Parle:
ay-je à craindre encor le celeſte courroux?	ai-je à craindre encor le céleste courroux?
ANTHENOR.	ANTHENOR.
Souffres qu’auparavant j’embraſſe vos genoux, Seigneur, que j’ay de fois tremblé pour vôtre vie!	Souffres qu'auparavant j'embrasse vos genoux, Seigneur, que j'ai de fois tremblé pour votre vie!
Quand par la trahiſon je la croyois ravie.	Quand par la trahison je la croyais ravie.
Qu’heureuſement, grands Dieux!	Qu'heureusement, grands Dieux!
vous calmez.	vous calmez.
mon effroy;	mon effroi;
Vous me rendez icy mon cher Maiſtre, mon Roy.	Vous me rendez ici mon cher Maître, mon Roi.
THOAS.	THOAS.
Qui peut t’avoir cauſé cette crainte funeſte?	Qui peut t'avoir causé cette crainte funeste?
Qu’as-tu vû?	Qu'as-tu vu?
que ſçais-tu?	que sais-tu?
connois-tu cet Oreſte?	connais-tu cet Oreste?
ANTENOR:	ANTENOR:
Je me ſuis vainement empreſſé pour le voir;	Je me suis vainement empressé pour le voir;
Mais ſon ſort dans la Grece eſt facile à ſçavoir.	Mais son sort dans la Grèce est facile à savoir.
Le grand Agamemnon luy donna la naiſſance.	Le grand Agamemnon lui donna la naissance.
Mycene eſt ſous ces loix, Argos ſous ſa puiſſances J'aborday ſon païs;	Mycène est sous ces lois, Argos sous sa puissances J'abordai son pays;
il yenoit d’en ſortir.	il yenait d'en sortir.
Un horrible deſſein l'en avoit fait partit.	Un horrible dessein l'en avait fait partit.
J’appris que pour vanger le trépas de ſon pere, Ayant trempé ſes mains dans le ſang de ſa mere:	J'appris que pour venger le trépas de son père, Ayant trempé ses mains dans le sang de sa mère:
Tourmenté, déchiré de ce crime odieux.	Tourmenté, déchiré de ce crime odieux.
Egalement hay des hommes, & des Dieux, Il en traînoit par tout l’idée épouvantable;	Également hai des hommes, et des Dieux, Il en traînait par tout l'idée épouvantable;
Et que pour expier ce meurtre déteſtable, Avec uu feur vaiueau, guſe pat la fureur, Pòrtant dans vos Etats la rage, & la terreuz, D’une ame au ſacrilege inſtruite & parvenuë, Il venoit de Diane enlever la Statuë?	Et que pour expier ce meurtre détestable, Avec œu seur vaiveau, guse pat la fureur, Prtant dans vos États la rage, et la terreuz, D'une âme au sacrilège instruite et parvenue, Il venait de Diane enlever la Statue?
A1O A J.	A1O A J.
Letemeraire!	Leteméraire!
Aprés d’innombrables travaux:	Après d'innombrables travaux:
Si ſon pere en dix ans avec mille vaiſſeaux, Vit à peine.	Si son père en dix ans avec mille vaisseaux, Vit à peine.
illion ſoûmis au ſang Attride, Croit-il avec un ſeul étonner la-Tauride?	illion soumis au sang Attride, Croit-il avec un seul étonner la-Tauride?
ANTHENOR.	ANTHENOR.
Ne vous y trompez pas, il y vient inconnu:	Ne vous y trompez pas, il y vient inconnu:
Mais quand avec ſon nom juſqu’à vous parvenu;	Mais quand avec son nom jusqu'à vous parvenu;
, Vous auriez connoiſſance encor de ſon viſage, Voſtre aſpect ne feroit qu’augmenter ſon courasi fur la foy des Grees on en croit ſon renom, Ce Prince, de la peur, ne connoiſt que le nom.	, Vous auriez connaissance encor de son visage, Votre aspect ne ferait qu'augmenter son courasi fur la foi des Gre on en croit son renom, Ce Prince, de la peur, ne connaît que le nom.
Ses ſermens ſolemnels ont juré voſtre perte :	Ses serments solennels ont juré votre perte :
Et ſoit par la ſurpriſe, ou par la force ouverte;	Et soit par la surprise, ou par la force ouverte;
Il vient, quelque peril qu’il y puifſe courir, Enlever la Sratuë, ou vous perdre, ou perir.	Il vient, quelque péril qu'il y puisse courir, Enlever la Sratue, ou vous perdre, ou périr.
Ah!	Ah!
Seigneur, quel devins-je à ce recit funeſte?	Seigneur, quel devins-je à ce récit funeste?
Que ne tentay-je point pour prévenir Oreſte?	Que ne tentai-je point pour prévenir Oreste?
Je combattis leng-tems & les vents & les mers,.	Je combattis lengtemps et les vents et les mers,.
Et cependant heureux que ces mêmes revers, Des projets du barbare ayent ſuſpendu la rage:	Et cependant heureux que ces mêmes revers, Des projets du barbare aient suspendu la rage:
Plus heureux ſi tous deux nous avions fait naufrage.	Plus heureux si tous deux nous avions fait naufrage.
S’il m’avoit devancé qu’auroit-ce été, grande Dieux;	S'il m'avait devancé qu'aurait-ce été, grande Dieux;
THOAS.	THOAS.
Il n’en faut point douter, ce Prince eſt en ceglieux.	Il n'en faut point douter, ce Prince est en céglieux.
Luy ?	Lui ?
ANTHENOR.	ANTHENOR.
THOAS.	THOAS.
C’eſt ce même Gree dont j’attens le ſupplice, Et qu’aujour d’huy Diane accepte en ſacriſice.	C'est ce même Grée dont j'attends le supplice, Et qu'aujour d'hui Diane accepte en sacrisice.
Son front où d’un beau ſang ſe tépand la fierté.	Son front où d'un beau sang se tépand la fierté.
Cet orgueil qu’il oppoſe à mon authorité;	Cet orgueil qu'il oppose à mon autorité;
Sur tout ſon nom qu’il cache, & qu’il s’obſtine à taire, Confirme le tecit que tu viens de m’en faire.	Sur tout son nom qu'il cache, et qu'il s'obstine à taire, Confirme le tecit que tu viens de m'en faire.
Des vagues en fureuts ſeul des ſiens échapé, Sans eſpoit de ſecouts, dans ſes projetstrompé:	Des vagues en fureuts seul des siens échappé, Sans espoit de secouts, dans ses projetstrompé:
A l’aſpect d’une mort dont l’horreur eſt extiême;	À l'aspect d'une mort dont l'horreur est extiême;
Il voit ſans s’étonner ſes malheurs.	Il voit sans s'étonner ses malheurs.
C'eſt luymême.	C'est luymême.
Dieux juſtes!	Dieux justes!
Dieux paiſſans!	Dieux paissants!
je reconnois vostraits.	je reconnais vostraits.
Voſtre prudence a mis un prix à vos bienfaits.	Votre prudence a mis un prix à vos bienfaits.
Elle en fait aux mortels achetter l’allegreſſe.	Elle en fait aux mortels achetter l'allégresse.
Je pers mon ennemy, j’épouſe la Preſtreſſe.	Je perds mon ennemi, j'épouse la Prêtresse.
Quoy qu’il m’en ait coûté pour avoir attendu, Ce bonheur ne m’eſt point encore aſſez vendu.	Quoi qu'il m'en ait coûté pour avoir attendu, Ce bonheur ne m'est point encore assez vendu.
Cher amy que je ſuis redevable à ton zele.	Cher ami que je suis redevable à ton zèle.
Allons, courons au Temple en porter la nouvelle:	Allons, courons au Temple en porter la nouvelle:
Informons la Preſtreſſe.	Informons la Prêtresse.
On ouvre, la voicy.	On ouvre, la voici.
THOAS, IPHIIGENIE,ANTHENOR, HIDASPE,CYANE.	THOAS, IPHIGENIE,ANTHENOR, HIDASPE,CYANE.
THOAS.	THOAS.
H!	H!
Madame, le ſort enſin s’eſt adoucy!	Madame, le sort ensin s'est adouci!
A Nous allons l’éprouver par l’hymen qui s’apreſte:	À Nous allons l'éprouver par l'hymen qui s'apprête:
L’ordrc.	L'ordrc.
IPHIGENIE.	IPHIGENIE.
Atteſte Thoas.	Atteste Thoas.
THOAS.	THOAS.
Hé quo	Hé quo
IPHIGENIE.	IPHIGENIE.
Thoas, arreſte.	Thoas, arrête.
nes Dieuu mepprourent pone ton hymen avec moy.	nés Dieuu mepprourent pone ton hymen avec moi.
Diane a prononcé.	Diane a prononcé.
Je ne puis eſtre à toy:	Je ne puis être à toi:
Ce n’eſt pas tout.	Ce n'est pas tout.
De ſang la Deeſſe ſe laſſe:	De sang la Déesse se lasse:
Devant ſon Tribunal ce Grec a trouvé grace:	Devant son Tribunal ce Grec a trouvé grâce:
Elle s’en fait l’appuy.	Elle s'en fait l'appui.
THOAS.	THOAS.
Ciel!	Ciel!
IPHIGENIE.	IPHIGENIE.
Au pied de l’Autel, Mon bras alloit ſur luy porter le coup mortel.	Au pied de l'Autel, Mon bras allait sur der porter le coup mortel.
Un prodige inouy me ſurprend, & m’arreſte.	Un prodige inouï me surprend, et m'arrête.
les ſaciez ornemens ſout tombez de ſa teſte.	les saciez ornements sout tombés de sa tête.
Le Temple ſous mes pas a paru s’ébrauler.	Le Temple sous mes pas a paru s'ébrauler.
La Statuë, & l’Autel ont ſemblé reculer.	La Statue, et l'Autel ont semblé reculer.
Sur mes ſens interdits la nuit s’eſt tépanduë.	Sur mes sens interdits la nuit s'est tépanduë.
Diane à mes regards eſt alors apparuë.	Diane à mes regards est alors apparue.
J’ay lû, j’ay reconnu dans ſes yeux irritez, Que formant des projets contre ſes volontez, Tu vas ſur tes Etats attirer ſa colete, Si d’en preſſer l’effet ton ame perſevere.	J'ai lu, j'ai reconnu dans ses yeux irrités, Que formant des projets contre ses volontés, Tu vas sur tes États attirer sa colère, Si d'en presser l'effet ton âme persévère.
Ceſſe d’eſtre rebelle aux menaces des Dieux.	Cesse d'être rebelle aux menaces des Dieux.
Ne verſe plus du ſang qui te rend odieux :	Ne verse plus du sang qui te rend odieux :
Etcin de ton amour l’ardeur deſavoüée:	Etcin de ton amour l'ardeur désavouée:
Laiſſe en paix unc fille aux Autels devoüée, Et ſonge bien-plûtoſt, déteſtant tes rigueurs, A gaguer les eſprits qu’a’contraindre les cœurs.	Laisse en paix unc fille aux Autels devoüée, Et songe bientôt, détestant tes rigueurs, A gaguer les esprits qu'acontraindre les cœurs.
THOAS.	THOAS.
où ſe replonge, ô Ciel!	où se replonge, ô Ciel!
mon ame épouvantée?	mon âme épouvantée?
Toujours entte la crainte & l’eſpoir agité, Ne peut-elle entre voir un avenir certain?	Toujours entte la crainte et l'espoir agité, Ne peut-elle entre voir un avenir certain?
Et vous qui m’accablez par un zele inhomain, Mes malheurs, mes chagrins n’ont-ils rien qui vous touche?	Et vous qui m'accablez par un zèle inhomain, Mes malheurs, mes chagrins n'ont-ils rien qui vous touche?
En ſeray-je ſans-ceſſe inſtruit par vôtre bouche ?	En serai-je sans-cesse instruit par votre bouche ?
Madame, ouvrez les yeux, quand on le pouſſe about, Rien n’eſt plus dangereux qu’un Amant qui peu:	Madame, ouvrez les yeux, quand on le pousse about, Rien n'est plus dangereux qu'un Amant qui peu:
tout.	tout.
Prevenez-en l’éclat, c’eſt trop vous le redire:	Prévenez-en l'éclat, c'est trop vous le redire:
Un peu de ſang verſe voas aſſure un Empire.	Un peu de sang verse vœas assure un Empire.
Ces refus outrageans ne vous ſont plus permis.	Ces refus outrageants ne vous sont plus permis.
Vous devez eſtre à moy.	Vous devez être à moi.
Vous me l’avez promis.	Vous me l'avez promis.
La parole a ſes loix qu’on ne doit point enfraindr Qui le ſouffre eſt indigne.	La parole à ses lois qu'on ne doit point enfraindr Qui le souffre est indigne.
IPHIGENIE.	IPHIGENIE.
Eſt-ce à toy de t’en plaindree Toy qui ne dois ce rang dont tu fais vanité, Qu’à ton manque de foy, qu’à ton impieté:	Est-ce à toi de t'en plaindree Toi qui ne dois ce rang dont tu fais vanité, Qu'à ton manque de foi, qu'à ton impiété:
Aux ordres du fen Roy ceſſe de faire injure.	Aux ordres du sen Roi cesse de faire injure.
Epouſe Thomiris, ou crains pour ton parjure.	Épouse Thomiris, ou crains pour ton parjure.
Mais la proſperité te tend ſouid à ma voix.	Mais la prospérité te tend souid à ma voix.
Un Tyran couronné ne connoît plus de loix.	Un Tyran couronné ne connaît plus de lois.
Tu veux par mon hymen combler tes injuſtices, Tu n’as plus de raiſon que pour ſlater tes vices.	Tu veux par mon hymen combler tes injustices, Tu n'as plus de raison que pour slater tes vices.
Tu te-crois revêtu d’un pouvoir qui peut tout;	Tu te-crois revêtu d'un pouvoir qui peut tout;
Voyons ce qu’il deſtine à qui te pouſſe à bout.	Voyons ce qu'il destine à qui te pousse à bout.
D’une odieuſe main inſtruite dans le crime, Va toy-même à l’Autel immoler la victime;	D'une odieuse main instruite dans le crime, Va toi-même à l'Autel immoler la victime;
Et pour braver un cœur fermea te refuſer, Aux yeux de la Deeſſe oſe, viens m’épouſer, Je vais t’attendre.	Et pour braver un cœur fermea te refuser, Aux yeux de la Déesse ose, viens m'épouser, Je vais t'attendre.
THOAS.	THOAS.
Hé bien, je vous ſuis, ma vangeance.	Hé bien, je vous suis, ma vengeance.
SCENE IV.	SCÈNE IV.
THIUAS, IPEIGENIE, ANTENOR, HIDASPE, TAXIS, CYANE.	THIUAS, IPEIGENIE, ANTENOR, HIDASPE, TAXIS, CYANE.
TAXIS.	TAXIS.
E Sarmate, Seigneur, vous demande audiance, Et de cette entreveuë il preſſe le moment.	 Sarmate, Seigneur, vous demande audience, Et de cette entrevue il presse le moment.
THOAS.	THOAS.
Ie vais l’entendte, & plein de mon reſſentiment, Je reviens à l’Autel, ſans que rien m’épouvante, Immoler la v.	Je vais l'entendte, et plein de mon ressentiment, Je reviens à l'Autel, sans que rien m'épouvante, Immoler la v.
ctime, & d’une main langlante, Vous épouſer malgré vôtre audace, & vos Dieux.	ctime, et d'une main langlante, Vous épouser malgré votre audace, et vos Dieux.
Mais pour vous déteſter, & vous eſtre odieux.	Mais pour vous détester, et vous être odieux.
Vous le voulez, cruelle, attendez-moy.	Vous le voulez, cruelle, attendez-moi.
SEENE V.	SENE V.
IPHIGENIE, CYANE.	IPHIGENIE, CYANE.
CYANE.	CYANE.
MAdams.	MAdams.
Quel eſt l’affreux deſſcin où s’emporte ſon ame!	Quel est l'affreux desscin où s'emporte son âme!
Que ſeroit-ce, grands Dieux!	Que serait-ce, grands Dieux!
s’il venoit à ſçavoir Quule prouige nen que pour le décevoir:	s'il venait à savoir Quule provige nen que pour le décevoir:
Que ce n’eſt qu’un menſonge inventé par vousmême.	Que ce n'est qu'un mensonge inventé par vousmême.
Quę ne permettra-t-il à ſa colere extrême?	Quę ne permettra-t-il à sa colère extrême?
Affermy dans ſes feux par cette fauſſeté, Je crois déja le voir furieux, irtité, Potter ſur vôtre teſte.	Affermi dans ses feux par cette fausseté, Je crois déjà le voir furieux, irtité, Potter sur votre tête.
IPHIGENIE.	IPHIGENIE.
Il n’oſeroit Cyane.	Il n'oserait Cyane.
Conſacrée aux Autels, Preſtreſſe de Diane, Quelque audace qu’il eût ce frein l’arreſtetoit.	Consacrée aux Autels, Prêtresse de Diane, Quelque audace qu'il eût ce frein l'arrestetoit.
Il a beau menacer Cyane, il n’oſeroit.	Il a beau menacer Cyane, il n'oserait.
Toy qui d’Iphigenie as penetré la feinte, Qui connois de mon cœur, & le trouble, & la crainte.	Toi qui d'Iphigénie as pénétré la feinte, Qui connais de mon cœur, et le trouble, et la crainte.
Diane, montre à tous, te declarant pour moy, Que le ſang de ton pere eſt protegé partoy.	Diane, montre à tous, te déclarant pour moi, Que le sang de ton père est protegé partoy.
Si ma fierté ſe porte à des démaiches vaines, C’eſt l’orgueil de ce ſang qui coule dãs mes veires.	Si ma fierté se porte à des démaiches vaines, C'est l'orgueil de ce sang qui coule dans mes veires.
VoudroisVoudrois-tu qu’un Tyran ſoüillaſt ſa pureté, Et poutrois-je deſcendte à cette indignité.	VoudraisVoudrais-tu qu'un Tyran saint sa pureté, Et poutrais-je descendte à cette indignité.
Pomdomne aune;	Pomdomne aune;
Seeite ya la pieute eſtiine, Que la pitié m’a fait prendre pour ta victime.	Seeite ya la piète étiine, Que la pitié m'a fait prendre pour ta victime.
L’appuy de l’innocence eſt l’ouvrage des Cieux:	L'appui de l'innocence est l'ouvrage des Cieux:
Et c’eſt une vertu que d’imiter les Dieux.	Et c'est une vertu que d'imiter les Dieux.
CYANE.	CYANE.
Mais quand vous renoncez au devoir de Preſtreſſe, N’apprehendez-vout point d’irriter la Deeſſe.	Mais quand vous renoncez au devoir de Prêtresse, N'appréhendez-vout point d'irriter la Déesse.
Le ſang de tous les Grecs à la vangeance eſt dû.	Le sang de tous les Grecs à la vengeance est dû.
Juſqu’icy, ſans fremir, vous l’avez répandu.	Jusqu'ici, sans frémir, vous l'avez répandu.
Une ſainte ferveur animoit ce beau zele.	Une sainte ferveur animait ce beau zèle.
D’où vient pour ce Grec ſeul que vôtre main chancele?	D'où vient pour ce Grec seul que votre main chancelé?
IPHIGENIE.	IPHIGENIE.
Me le demandes-tu?	Me le demandes-tu?
tes yeux furent témoins Du déplorable état qui l’offrit à mes ſoins:	tes yeux furent témoins Du déplorable état qui l'offrit à mes soins:
Quitte de mes devoirs, j’allois ſur le rivage Soúpirer mes malheurs, pleurer mon eſclavage.	Quitte de mes devoirs, j'allais sur le rivage Soúpirer mes malheurs, pleurer mon esclavage.
Les vents impetueux obſcureiſſoient les airs, Troubloieut les Elemens, faiſoient mugir les Mers:	Les vents impétueux obscureissaient les airs, Troublaient les Éléments, faisaient mugir les Mers:
Quand ſur des mats briſez la vague épouvantatable 2 Jetta ce malheureux étendu ſur le ſable:	Quand sur des mats brisés la vague épouvantatable 2 Jetta ce malheureux étendu sur le sable:
La pitié m’inſpira de conſerver ſes jours:	La pitié m'inspira de conserver ses jours:
Dans nos empteſſemens il trouva du ſecouts.	Dans nos emptessements il trouva du secouts.
N’aurois-je pris le ſoin de le rendre à la vie, Qu’afin que par moy-même elle luy fût ravie.	N'aurais-je pris le soin de le rendre à la vie, Qu'afin que par moi-même elle lui fût ravie.
Noñ, ſi je me portois à cet excés d’horreur, Diane en puniroit la barbare fureur.	Noñ, si je me portais à cet excès d'horreur, Diane en punirait la barbare fureur.
CYANE.	CYANE.
Et ſongez-vous pour qui vôtre ame s'intereſſe?	Et songez-vous pour qui votre âme s'intéresse?
Pout qui vous offenſez Thoas, & la Deeſſe.	Pout qui vous offensez Thoas, et la Déesse.
Ce Grec, dont la pitié vous fait prendre l’appuy, Répond-il aux bontez que vous avez pour luy?	Ce Grec, dont la pitié vous fait prendre l'appui, Répond-il aux bontés que vous avez pour lui?
Veus a-t-il dit quel ſang l’a tranſmis à la vie?	Vous a-t-il dit quel sang l'a transmis à la vie?
Lorſque de le ſçavoir vous témoignez l’envie, Le viſage interdit, les yeux pleins d’embarras:	Lorsque de le savoir vous témoignez l'envie, Le visage interdit, les yeux pleins d'embarras:
Il ſoûpire, Madame, & ne vous répond pas.	Il soupire, Madame, et ne vous répond pas.
IPHIGENIE.	IPHIGENIE.
D’un ſang illuſtre, & grand voila le caractere, Et c’eſt ce même orgueil qui me force à me taire.	D'un sang illustre, et grand voilà le caractère, Et c'est ce même orgueil qui me force à me taire.
Tu ſçais, quand de Calchas l’Oracle rigoureux, Eût prononcé la fin de mes jours malheureux, Et qu’aux feux du bucher par Diane enlevée, A ſervir ſes Autels je me vis reſervée, Que l'horreur de me voir chez les Scythes cruels!	Tu sais, quand de Calchas l'Oracle rigoureux, Eût prononcé la fin de mes jours malheureux, Et qu'aux feux du bûcher par Diane enlevée, A servir ses Autels je me vis réservée, Que l'horreur de me voir chez les Scythes cruels!
Rougir, cremper mes mains dans le ſang des mortels, M'a fait enſevelir le nom d'Iphigenie.	Rougir, crémper mes mains dans le sang des mortels, M'a fait ensevelir le nom d'Iphigénie.
Je:	Je:
n’ay conté qu’à toy les malheurs de ma vic.	n'ai conté qu'à toi les malheurs de ma vic.
Madame.	Madame.
CYANE.	CYANE.
IPHIGENIE.	IPHIGENIE.
De ce nom le fier reſſentiment, Déteſte cet indigne, & lâche abaiſſement.	De ce nom le fier ressentiment, Dêteste cet indigne, et lâche abaissement.
Il yeut briſer un joug dont ſa gloire eſt flêtrie.	Il yeut briser un joug dont sa gloire est flamtrie.
Je brûle de revoir la Grece, ma patrie, D’admirer, d’adorer couyert de tant d’exploits, Ce grand-Agamemnon Chef des Grecs, Roy des Rois:	Je brûle de revoir la Grèce, ma patrie, D'admirer, d'adorer couiert de tant d'exploits, Ce grand-Agamemnon Chef des Grecs, Roi des Rois:
D'entendre, dd'embraſſer-Clitemneſtre ma mere, Les Princeſſes mes ſœurs, Oreſte mon cher frere.	D'entendre, d'embrasser-Clitemnêtre ma mère, Les Princesses mes sœurs, Oreste mon cher frère.
Quels tranſports à me voir ne ſentiroient-ils pas?	Quels transports à me voir ne sentiraient-ils pas?
Mon pere, qui long-temps a pleuré mon trépas, Retrouvera ſa joye à l’aſpect d’une fille, Qui n’a point démenty ſon auguſte famille.	Mon père, qui longtemps a pleuré mon trépas, Retrouvera sa joie à l'aspect d'une fille, Qui n'a point démenti son auguste famille.
Pour eet heureux moment, qui fait tous mes ſouhaits:	Pour cet heureux moment, qui fait tous mes souhaits:
Ce Gtee ment iportant;	Ce Glée ment iportant;
de paus eher que jamais;	de paus eher que jamais;
Je vais le délivrer, le charger d’une lettre, Qu’aux mains d’Agamemnon il jure de remettre.	Je vais le délivrer, le charger d'une lettre, Qu'aux mains d'Agamemnon il jure de remettre.
Quand mon pere ſçaura.	Quand mon père sçaura.
N E.	N E.
Madame, y penſez-vout?	Madame, y pensez-vout?
Comment le dérober à Thoas en courroux?	Comment le dérober à Thoas en courroux?
Quand même à vôtre femte il donneroit croyanPenſez-vous d’un Tyran tromper la prévoyance?	Quand même à votre femte il donnerait croyanPensez-vous d'un Tyran tromper la prévoyance?
Quel vaiſſeau recerra l’Etranger ſur ſon bord?	Quel vaisseau recerra l'Étranger sur son bord?
Sans l’ordre de Thoas, on ne ſort point du port.	Sans l'ordre de Thoas, on ne sort point du port.
IPHIGENIE.	IPHIGENIE.
Cyane, il partira de l’aveu du Barbare;	Chyane, il partira de l'aveu du Barbare;
Il ne ſçait pas le coup que ma main luy prépare.	Il ne sait pas le coup que ma main avait prépare.
Des volontez du Ciel incertain, & troublé, Le peuple, autour du Temple, eſt encor aſſemblé.	Des volontés du Ciel incertain, et troublé, Le peuple, autour du Temple, est encor assemblé.
Je vais le ſoûlever contre le Tyran même:	Je vais le soulever contre le Tyran même:
Viens me voir, empruntant une audace ſupréme, Confondre, épouvanter le ſuperbe Thoas, Diane, en ce deſſein ne m’abandonne pas.	Viens me voir, empruntant une audace suprême, Confondre, épouvanter le superbe Thoas, Diane, en ce dessein ne m'abandonne pas.
Fin du premier Acte.	Fin du premier Acte.
A'ij	Ajjà
ACTE II.	ACTE II.
TERE.	TERE.
THOMIRIS, ANTHENOR;	THOMIRIS, ANTHENOR;
ERINE.	ÉRINE.
THOMIRIS.	THOMIRIS.
NTHENOR, vous ſçavez mes malheurs, mon injure, Thoas eſt un impie, un perfide, ur parjure, Qui retient vôtre bras quand il faut le punir;	NTHENOR, vous savez mes malheurs, mon injure, Thoas est un impie, un perfide, ur parjure, Qui retient votre bras quand il faut le punir;
Mon pere n’eſt-il plus dans vôtre ſouvenir?	Mon père n'est-il plus dans votre souvenir?
Ingrat, à ſes bienfaits perdez-vous la memoire ?	Ingrat, à ses bienfaits perdez-vous la mémoire ?
De ce que vous devez à ſa fille, à ſa gloire?	De ce que vous devez à sa fille, à sa gloire?
Au point où le Tyran ſe plaît à l’outrager, Thomiris n’attendoit que vous pour ſe vanger.	Au point où le Tyran se plaît à l'outrager, Thomiris n'attendait que vous pour se venger.
Vous eſtes de retour, vous voyez ma diſgrace, Et quand il faut agir vôtre cœur eſt de glace.	Vous êtes de retour, vous voyez ma disgrâce, Et quand il faut agir votre cœur est de glace.
ANTHENOR.	ANTHENOR.
Je ſçay ce que je dois, Madame, à vos malheurs:	Je sais ce que je dois, Madame, à vos malheurs:
Eſtimé du feu Roy, comblé de ſes faveurs, Je n’ay pas oublié qu’à ſon heute derniere, Il attacha ſur moy ſa confiance entiere;	Estimé du feu Roi, comblé de ses faveurs, Je n'ai pas oublié qu'à son heute dernière, Il attacha sur moi sa confiance entière;
qu'éblouy du ſerment par Thoas atteſté, Il n’en prii pour garant que ma fidelité.	qu'ébloui du serment par Thoas attesté, Il n'en pri pour garant que ma fidélité.
Il mourut.	Il mourut.
Si depuis, contre ſa foy donnée, Thoas, de vôtre hymen, differoit la journée:	Si depuis, contre sa foi donnée, Thoas, de votre hymen, différait la journée:
J’imputois ces delais, Madame;	J'imputais ces délais, Madame;
à ſon grand cœur, Qui pour vous affermir ſur le Trône en Vainqueur, Voulois que vous deuſſiez à ſa propre victoire, La paix de vos Etats, l’abondance, & la gloire.	à son grand cœur, Qui pour vous affermir sur le Trône en Vainqueur, Voulais que vous dussiez à sa propre victoire, La paix de vos États, l'abondance, et la gloire.
L’Oracle d’Apollon qui menaçoit ſes jours, Dè vos proſperirez vint traverſer le cours.	L'Oracle d'Apollon qui menaçait ses jours, Dées vos prospérirez vint traverser le cours.
Pour bannir de ces lieux la crainte, & la triſteſſe, A ſes ordres preſſans je partis pour la Grece.	Pour bannir de ces lieux la crainte, et la tristesse, À ses ordres pressants je partis pour la Grèce.
Jugez de ma douleur, Madame, à mon retour, Lorſque j’apprens qu’épris-d’un malheureux amour, Thoas, ſans reſpecter les Dieux;	Jugez de ma douleur, Madame, à mon retour, Lorsque j'apprends qu'épris-d’un malheureux amour, Thoas, sans respecter les Dieux;
ny fa promeſſe;	Ne fa promesse;
Veut d’une main impie épouſer la Preſtreſſe, Et l’élever au Trône au mépris de vos droits, A ce triſte recit interdit, & ſans voix.	Veut d'une main impie épouser la Prêtresse, Et l'élever au Trône au mépris de vos droits, À ce triste récit interdit, et sans voix.
THOMIRIS.	THOMIRIS.
Il faut d'autres efforts pour laver mon offence.	Il faut d'autres efforts pour laver mon offense.
C’eſt la mort du Tyran qu’éxige ma vangeance.	C'est la mort du Tyran qu'éxige ma vengeance.
La Preſtreſſe aujourd’huy le verroit ſon époux.	La Prêtresse aujourd'hui le verrait son époux.
Prevenons.	Prévenons.
ANT HENOB.	ANT HENOB.
Suſpendez un moment ce courroux:	Suspendez un moment ce courroux:
Tout ſemble s’oppoſer au ſort qui vous menace.	Tout semble s'opposer au sort qui vous menace.
Tout ſemble préſager qu’il va changer de face:	Tout semble présager qu'il va changer de face:
Ce Grec dont le trépas eſt encore incertain, De quelque heureux retour flate vôtre deſtin.	Ce Grec dont le trépas est encore incertain, De quelque heureux retour flatte votre destin.
J’allois, pour détourner le malheur qui vous preſſe, Au picd de ſes Autels implorer la Deeſſe.	J'allais, pour détourner le malheur qui vous presse, Au picd de ses Tels implorer la Déesse.
Son Temple étoit fermé, j’ay vû de toutes parts Le peuple pour entrer s’offrir à mes regards:	Son Temple était fermé, j'ai vu de toutes parts Le peuple pour entrer s'offrir à mes regards:
, B3	, B3
Lors qu’avec un grand bruit la porte s’eſt ouverte.	Lors qu'avec un grand bruit la porte s'est ouverte.
Auſſi-toſt la Preſtreſſe à nos yeux s’eſt offerte.	Aussitôt la Prêtresse à nos yeux s'est offerte.
Paſle, ſans appareil, ſes voiles déchirez;	Pâle, sans appareil, ses voiles déchirés;
Les cheveux heriſſez, les regards égarez:	Les cheveux hérissez, les regards égarés:
Elle a fait voir à tous par ſon maintien farouche, Que la Deeſſe alloit s’expliquer par ſa bouche.	Elle a fait voir à tous par son maintien farouche, Que la Deesse allait s'expliquer par sa bouche.
A ſon aſpect, tremblant, interdit, conſterné, Tout ce peuple à genoux eſt tombé proſterné:	À son aspect, tremblant, interdit, consterné, Tout ce peuple à genoux est tombé prosterné:
Une ſainte terreur qu’imprimoit ſa preſence,.	Une sainte terreur qu'imprimait sa présence,.
A ſur les aſſiſtans répandu le ſilence.	A sur les assistants répandu le silence.
Scythes, a-t-elle dit, tremblez tous;	Scythes, a-t-elle dit, tremblés tous;
fremiſſez- Des maux dont en ce jour vous eſtes menacez:	frémissez- Des maux dont en ce jour vous êtes menacés:
:	:
Diane de ce Grec protege l’infortune:	Diane de ce Grec protege l'infortune:
Elle ménage un ſang qu’a conſervé Neptunc.	Elle ménage un sang qu'a conservé Neptunc.
Attache voſtre ſort au ſalut de ſes jours.	Attache votre sort au salut de ses jours.
Vous deffend par me voix d’en abreger le cours:	Vous défend par me voix d'en abréger le cours:
Marquez-luy vos reſpects par voſtre obeiſſance:	Marquez-lui vos respects par votre obéissance:
Imitez ſon exemple, ou craignez ſa vangeance.	Imitez son exemple, ou craignez sa vengeance.
A ces mots, pour jurer, de maintenir ſes loix, Tout ce peuple aſſemblé n’a formé qu’une voix.	À ces mots, pour jurer, de maintenir ses lois, Tout ce peuple assemblé n'a formé qu'une voix.
Surpris d’un tel ſpectacle, & preſſé par mon zele, yaj couru enez le Roy porter cette nouvelle.	Surpris d'un tel spectacle, et pressé par mon zèle, yaj couru enez le Roi porter cette nouvelle.
Je l’ay trouvé ſortant d’avec l’Ambaſſadeur;	Je l'ai trouvé sortant d'avec l'Ambassadeur;
Mon recit ſur ſon front a porté la terreur;	Mon récit sur son front a porté la terreur;
Aprés s’eſtre affranchy du trouble de ſon ame, le l’ay vû s’empreſſer à vous parler, Madame.	Après s'être affranchi du trouble de son âme, le l'ai vu s'empresser à vous parler, Madame.
Il va venir.	Il va venir.
Les Dieux l’ont peut-eſtre touché:	Les Dieux l'ont peut-être touché:
Peut-eſtre à ſon devoir deſormais attaché, Qu’il vous raporte un Sceptre.	Peut-être à son devoir désormais attaché, Qu'il vous rapporte un Sceptre.
THOMIRIS.	THOMIRIS.
Aprés ſa perfidie, Aprés l'impunité de ſon audace impie, Vous eroyez qu’aux remords il ſe laiſſe ébranler aEt qu’il n’ait fait.	Après sa perfidie, Après l'impunité de son audace impie, Vous eroyez qu'aux remords il se laisse ébranler aEt qu'il n'ait fait.
ce pas qu’afin de reculer, Nòn, non, plus de pitié quand ſa mort eſt jurée.	ce pas qu'afin de reculer, Notre, non, plus de pitié quand sa mort est jurée.
Des plus grands de l’Etat la foy m’eſt aſſurée.	Des plus grands de l'État la foi m'est assurée.
Par la voix de euis Cheis,les Scythes mécontenta.	Par la voix de évis Cheis,les Scythes mécontenta.
Excitent ma vangeauce, en preſlent les inſtans.	Excitent ma venge, en présent les instans.
L'Ambaſſadeur Sarmate eſt dé l’intelligence.	L'Ambassadeur Sarmate est de l'intelligence.
Tous contre le Tyran vont.	Tous contre le Tyran vont.
AlTHEROR.	AlTHÉROR.
Madame, il s’avance:	Madame, il s'avance:
SCENE II.	SCÈNE II.
THOAS,THOMIRIS,ANTHENOR,, ERINE, HIDASPE.	THOAS,THOMIRIS,ANTHENOR, ÉRINE, HIDASPE.
THOAS.	THOAS.
TE ne viens point, Madame;	TE ne viens point, Madame;
orné de vains diſcours, D’une frivole excuſe emprunter les détours;	orné de vains discours, D'une frivole excuse emprunter les détours;
A regner avec moy vous eſtes deſtihée, Je dois m’unir à vous par un ſaint hymenée:	À régner avec moi vous êtes destihée, Je dois m'unir à vous par un saint hyménée:
Mais ce ſeroit vous faite un preſent odieux, Que l’hommage d’un Roy brûlant pour d’autres yeux:	Mais ce serait vous faite un présent odieux, Que l'hommage d'un Roi brûlant pour d'autres yeux:
Toutefois les tranſports d’un aveugle caprice, N’ont jamais.	Toutefois les transports d'un aveugle caprice, N'ont jamais.
de mon cœur écarté la juſtice:	de mon cœur écarté la justice:
Je me ſouvieus toujours qu’un Trône vous eſt dûrPar de plus dignes mains il vous ſera rendu.	Je me souvieus toujours qu'un Trône vous est dûrPar de plus dignes mains il vous sera rendu.
Charmé de vos vertus, le vaillant Merodate, Vous offre, avec ſa foy, l’Empire du Sarmate3 Avide, impatient de m’acquiter vers vous, J’ay reçù ſa demaude;	Charmé de vos vertus, le vaillant Mérodate, Vous offre, avec sa foi, l'Empire du Sarmate3 Avide, impatient de m'acquitter vers vous, J'ai reçù sa demaude;
il ſera vôtre epoux.	il sera votre époux.
THOMIRIS.	THOMIRIS.
Aux ordres de mon pere eſt-co ainſi que vôtre ame.	Aux ordres de mon père est-co ainsi que votre âme.
THOAS.	THOAS.
Il:	Il:
regnoit?	régnait?
A ſa voix tout fléchiſſoit, Madame:	À sa voix tout fléchissait, Madame:
J’obéïſſois.	J'obéissais.
Son Sceptre a paſſé ſous mes loix.	Son Sceptre a passé sous mes lois.
Je regne.	Je règne.
Obéïſſez pour la derniere fois.	Obéissez pour la dernière fois.
T.	T.
HOMIRIS.	HOMIRIS.
Vous regnez!	Vous régnez!
ſans nul titre, & de race communo, A-qui le devez-vous, Seigneur?	sans nul titre, et de race communo, A-qui le devez-vous, Seigneur?
THOAS.	THOAS.
A la fortune.	À la fortune.
Deſtiné pour remplir le Trone où je me vois, Au feu Roy vôtre pere elle impola ſon choix.	Destiné pour remplir le Trone où je me vois, Au feu Roi votre père elle impolà son choix.
c'eſt d’elle, & non de luy, que je tiens ma Couronne.	c'est d'elle, et non de Seigneur, que je tiens ma Couronne.
Arbitre des Etats qu'elle ôte, ou qu'elle donne:	Arbitre des États qu'elle ôte, ou qu'elle donne:
Efle éleve & détruit l’ouvrage de ſes mains, Par une intelligence inconnuë aux humains.	Éle élève et détruit l'ouvrage de ses mains, Par une intelligence inconnue aux humains.
T.	T.
HOMIRIS.	HOMIRIS.
Quoy!	Quoi!
loin de reſpecter les manes de mon pere.	loin de respecter les mânes de mon père.
THOAS.	THOAS.
Je vous eſtime encor, Madame, & vous revere.	Je vous estime encor, Madame, et vous révère.
N’allez point, rapellant d’inutiles clartez;	N'allez point, rappelant d'inutiles clartés;
.	.
Soûlever mon dépit, irriter mes bontez.	Soulever mon dépit, irriter mes bontés.
J’ay dit.	J'ai dit.
De Merodate acceptez l'hymenéeA ſes Ambaſſadeurs ma parole eſt donnée;	De Mérodate acceptez l'hymenéeA ses Ambassadeurs ma parole est donnée;
Son Sceptre vous attend.	Son Sceptre vous attend.
Allez le recevoir.	Allez le recevoir.
Tout eſt preſt:	Tout est prêt:
l’heure eſt priſes;	l'heure est prises;
& vous partezece ſoir.	et vous partezèce soir.
THOMIRIS.	THOMIRIS.
Perfide, car enfin je ne puis plus me taïre;	Perfide, car enfin je ne puis plus me taïre;
Tu veux par trop d’endroits meriter ma colere;	Tu veux par trop d'endroits mériter ma colère;
Et je me ſeus forcée à perdre malgré moy, Ce reſte de reſpect qur je gardois pour so D’où te vient tant d’orgueil, & par quelle puiſſance;	Et je me zeus forcée à perdre malgré moi, Ce reste de respect qur je gardais pour so D'où te vient tant d'orgueil, et par quelle puissance;
De promettre ta Reine, as-tu pris la licence?	De promettre ta Reine, as-tu pris la licence?
Merodate m’épouſe, & va me couronner;	Mérodate m'épouse, et va me couronner;
Mais quelle dot, Tyran, penſes-tu me donner?	Mais quelle dot, Tyran, penses-tu me donner?
Souveraine en naiſſant des lieux où je reſpire;	Souveraine en naissant des lieux où je respire;
J’irois ſous d’autres Cieux-mandier un Empire:	J'irais sous d'autres Cieux-mandier un Empire:
Et ma fuite approuvant tes lâches attentats, Te laiſſeroit paiſible occuper mes Etats.	Et ma fuite approuvant tes lâches attentats, Te laisserait paisible occuper mes États.
Non, ne préſume pas, quelque eſpoir qui te flatte:	Non, ne présume pas, quelque espoir qui te flatte:
Que je coure ſi loin pour trouver-un Sarmate.	Que je coure si loin pour trouver-un Sarmate.
s’il me veut obrenir, qu’il vienne me chercher:	s'il me veut obrenir, qu'il vienne me chercher:
Que d’un joug tyrannique il vienne m’arracher, Je le reçois alors, ma main eſt toute preſte, Pour qu’avec la ſienne il m’apporte ta teſte:	Que d'un joug tyrannique il vienne m'arracher, Je le reçois alors, ma main est toute prête, Pour qu'avec la sienne il m'apporte ta tête:
Voila.	Voilà.
par quels efforts il me pent meriter, Et ce n’eſt qu’à ce prix que je puis l’accepter:	par quels efforts il me pè mériter, Et ce n'est qu'à ce prix que je puis l'accepter:
Adieu.	Adieu.
SCENE III.	SCÈNE III.
THOAS, ANTHENOR, HIDASPE.	THOAS, ANTHÉNOR, HIDASPE.
THOAS à- Hidaſpe.	THOAS à- Hidaspe.
F'Aites venir ce Grec.	S'Êtes venir ce Grec.
ANTHENOR.	ANTHENOR.
Quelle ſurpriſe?	Quelle surprise?
Avez-vous pû, Seigneur, former cette entrepriſe?	Avez-vous pu, Seigneur, former cette entreprise?
Songez-veus bien à qui vous livrez Thomſric?	Songez-vus bien à qui vous livrez Thomsric?
Au Sarmate, au plus grand de tous vos ennemis:	Au Sarmate, au plus grand de tous vos ennemis:
Nætpetez de ces nœnas qu'une guerre immortelle:	Nætpetez de ces nœnas qu'une guerre immortelle:
Supetbe, armé des droits qu’elle porte avec elle;	Supète, armé des droits qu'elle porte avec elle;
Il joindra toſt ou tard voſtre Sceptre, & le ſien.	Il joindra tôt ou tard votre Sceptre, et le sien.
Vous le voyez, Scigneur, jamais.	Vous le voyez, Scigneur, jamais.
T’HOAS.	T'HOAS.
Je ne vois rien.	Je ne vois rien.
Dans les divers tranſports dont mon trouble m’anime;	Dans les divers transports dont mon trouble m'anime;
Quand j’entends que les Dieux protegent ma victime, Quand je vois que mon peuple interdit, effrayé, S’oppoſc à ma fureur, me tient le bras lié, Examiner ce Grec, éprouver la Preſtreſſe, Penetrer la pitié qui pour luy s’intereſſé;	Quand j'entends que les Dieux protègent ma victime, Quand je vois que mon peuple interdit, effrayé, S'opposc à ma fureur, me tient le bras lié, Examiner ce Grec, éprouver la Prêtresse, Pénétrer la pitié qui pour lui s'interessé;
Eclaitcir des ſoupçons dont mon cœur eſt frapée Voila l’unique ſoin dont je ſuis occupé.	Eclaitcir des soupçons dont mon cœur est frappée Voilà l'unique soin dont je suis occupé.
ANTHENOR.	ANTHENOR.
Prenez-garde, Seigneut, les ſuprêmes Puiſſancez Ne ſont pas à l’abry dés celeſtes vangeances:	Prenez-garde, Seigneut, les suprêmes Puissancez Ne sont pas à l'abri dès célestes vengeances:
Les Dieux tendent ſouvent un piege à nôtre orgueil;	Les Dieux tendent souvent un piège à notre orgueil;
L'hymen de la Preſtreſſe eſt peut-eſtre l’écueil ,Où pour faire échoüer vôtre ame chancelante.	L'hymen de la Prêtresse est peut-être l'écueil ,Où pour faire échouer votre âme chancelante.
a.	a.
CENE IV.	CÈNE IV.
THOAS, ANTHENOR, HIDASPE.	THOAS, ANTHÉNOR, HIDASPE.
THOAS.	THOAS.
Uoy!	Uoi!
ſans ce Grec Hidaſpe à mes yeux ſe preſente!	sans ce Grec Hidaspe à mes yeux se présente!
Qui l’arreſte?	Qui l'arrête?
Oſe-t-il méconnoiſtre ma veix?	Ose-t-il méconnaître ma veix?
Eſt-ce que la Preſtreſſe eſt rebelle à mes loix?	Est-ce que la Prêtresse est rebelle à mes lois?
Ne le verray-je pas?	Ne le verrai-je pas?
HIDASPE.	HIDASPE.
Seigneur, on vous l’ameine:	Seigneur, on vous l'amène:
Mais je ne l'ay du Peuple obtenu qu’avec peine:	Mais je ne l'ai du Peuple obtenu qu'avec peine:
Inſpiré par Diane à s’en faire l’appuy, Son zele, contretous, ſe déclare pour luy;	Inspiré par Diane à s'en faire l'appui, Son zèle, contretous, se déclare pour lui;
A me l’abandonner il marquoit ſa contrainte.	À me l'abandonner il marquait sa contrainte.
Par les Dieux atteſtez j’ay diſſipé ſa crainte, JJ’ay promis ſon retour.	Par les Dieux attestez j'ai dissipé sa crainte, JOur promis son retour.
1 HOAS.	1 HOAS.
Qu’il vienne.	Qu'il vienne.
HIDASPE.	HIDASPE.
Le voicy.	Le voici.
SCENE V.	SCÈNE V.
THOAS, PILADE, ANTHENOR, HIDASPE, TAXIS.	THOAS, PILADE, ANTHENOR, HIDASPE, TAXIS.
THOAS.	THOAS.
U'on cherche la Preſtreſſe, & qu’on l’ameine icy.	U'on cherche la Prêtresse, et qu'on l'amène ici.
Appioche.	Apioche.
Ce n’eſt plus ton nom, ny ta naiſſance Dont je veux par ta bouche avoir la counoiſſance.	Ce n'est plus ton nom, ni ta naissance Dont je veux par ta bouche avoir la counaissance.
La Preſtreſſe t’arrache à mon inimitié, Je veux ſauver des jours dont elle prend pitié:	La Prêtresse -t-arrache à mon inimitié, Je veux sauver des jours dont elle prend pitié:
Le Sarmate eſt chargé du ſoin de te conduire;	Le Sarmate est chargé du soin de te conduire;
Tu ſuivras Thomiris juſques dans leur Empire.	Tu suivras Thomiris jusque dans leur Empire.
Dela ſur un vaiſſeau qu’ils doivent te donner, Dans ton païs natal tu pourras retourner:	Déla sur un vaisseau qu'ils doivent te donner, Dans ton pays natal tu pourras retourner:
Mais s’il te reſte encor quelque amour pour la vie, Si de la prolonger tu conſerves l’envie, Prens garde qu’en ces lieux cet Aſtre que tu vois, Ne te retrouve pas une ſeconde fois.	Mais s'il te reste encor quelque amour pour la vie, Si de la prolonger tu conserves l'envie, Prends garde qu'en ces lieux cet Astre que tu vois, Ne te retrouve pas une seconde fois.
Tu peux partir.	Tu peux partir.
PILADE.	PILADE.
Le ſang dont le Ciel m'a fait naiſtre:	Le sang dont le Ciel m'a fait naître:
Dans ce vaſte Univers ne connoiſt point de maîSon ſort indépendant en tout temps, en tous lieus, Ne reçoit ny de loix, ny d’ordres que des Dieux.	Dans ce vaste Univers ne connaît point de maîSon sort indépendant en tout temps, en tous lieus, Ne reçoit ni de lois, ni d'ordres que des Dieux.
Je venois en ces lieux animer par la gloire, J’y devois remporter une illuſtre victoire.	Je venais en ces lieux animer par la gloire, J'y devais remporter une illustre victoire.
Janais Jamais projet ne fut plus dignement formé, Les Cieux armoient mon bras, les Mers l’ont deſarmé.	Janais Jamais projet ne fut plus dignement formé, Les Cieux armaient mon bras, les Mers l'ont désarmé.
De tes indignes mains ſi j’acceptois la vie, Je ne la traînetois qu’avec ignominie;	De tes indignes mains si j'acceptais la vie, Je ne la traînetois qu'avec ignominie;
Supprime tes bontez, & puiſque tes Etats N’ont point vû mon triomphe, ils verront mon trépas.	Supprime tes bontés, et puisque tes États N'ont point vu mon triomphe, ils verront mon trépas.
JA 3 Quel trouble à ce diſcours jette-t-il dans mon ame!	JA 3 Quel trouble à ce discours jette-t-il dans mon âme!
Seroit-ce l’ennemy.	Serait-ce l'ennemi.
SCENE VI.	SCÈNE VI.
THOAS, IPHIGENIE, PILADE:	THOAS, IPHIGENIE, PILADE:
ANTHENOR, HIDASPE, CYANE, la icicPov.	ANTHENOR, HIDASPE, CYANE, la icicPov.
THOAS.	THOAS.
VEnez, venez, Madame.	VEnez, venez, Madame.
Ce malbeureux mortel ſe déclare aujourd’huy, Indigne des bontez que vous avez pour luy:	Ce malbeureux mortel se déclare aujourd'hui, Indigne des bontés que vous avez pour quelque:
Il mourra, rien ne pent tetenir ma vangeance.	Il mourra, rien ne pent tetenir ma vengeance.
IPHIGENIE.	IPHIGENIE.
Diane, par ma voix, t’en a fait la deſfenſe:	Diane, par ma voix, t'en a fait la défense:
Oſes-tu t’oppoſer aux volontez des Cieux ?	Oses-tu t'opposer aux volontés des Cieux ?
HOAS.	HÔOAS.
Non, ne vous en prenez qu’à cet audacieux;	Non, ne vous en prenez qu'à cet audacieux;
Ardent à ſatisfaire au deſir qui veus preſſe, J’ouvrois à cet ingrat le chemin de la Grece.	Ardent à satisfaire au désir qui veux presse, J'ouvrais à cet ingrat le chemin de la Grèce.
Quoy que je m’appreſtaſſe un cruel repentir, Je ne longcois qu’à vous.	Quoi que je m'apprêtasse un cruel repentir, Je ne longcais qu'à vous.
Je le faiſois partir.	Je le faisais partir.
On voit par ſes refus ce qu’il cache en ſon ame, Et quelqu’autre intereſt l’arreſle icy, Madame.	On voit par ses refus ce qu'il cache en son âme, Et quelque autre intérêt l'arrêle ici, Madame.
IPHIGENIE.	IPHIGENIE.
Et quel motif le peut reteuir en des lieux?	Et quel motif le peut retuir en des lieux?
Où ſans ceſſe la mort eſt preſente à ſes yeux.	Où sans cesse la mort est présente à ses yeux.
AS.	AS.
Le volla, je vous laiſſe;	Le volla, je vous laisse;
il pourra vous l’apprendre;	il pourra vous l'apprendre;
our touej mpueerlaj ie paity qu'il doit prendre.	our touj mpueerlaj ie Maiti qu'il doit prendre.
Madame, il eſt encor l’atbitre de ſon ſort.	Madame, il est encor l'atbitre de son sort.
S’il part, j’oubliray tout;	S'il part, j'oublirai tout;
sil demeure, il eſt mort:	sil demeure, il est mort:
Dût Jupiter ſur moy faire tomber la foudre, Je ne vous donne plus qu’une heure à le reſoudre.	Dût Jupiter sur moi faire tomber la foudre, Je ne vous donne plus qu'une heure à le résoudre.
SCENE VII.	SCÈNE VII.
APATGENTE,, PILADE, CYANE.	APPATGENTE, PILADE, CYANE.
IPHIGENIE.	IPHIGENIE.
Alheureux étranger, où vous engagez-vous?	Alheureux étranger, où vous engagez-vous?
Nll Quelle temerité vous retient parmy nous?	Nll Quelle témérité vous retient parmi nous?
D’une ſanglante mott elle ſera ſuivie.	D'une sanglante mott elle sera suivie.
Avez-voustant de haine, & d’horteur pour la vies	Avez-voûtant de haine, et d'horteur pour la vies
PILADE.	PILADE.
Triſte joüet du ſort, abandonné des Dieux, Brûlant d’un vain deſit, le jour m’eſt odieux, Je n’avois qu’un amy.	Triste jet du sort, abandonné des Dieux, Brûlant d'un vain des, le jour m'est odieux, Je n'avais qu'un ami.
La colere celeſte Se plût à le former ſous no Aſtre funeſte.	La colère celeste Se plut à le former sous nô Astre funeste.
Telle fut de ſon ſort l'affreuſe cruauté, Qu’il luy ſit des forfaits une neceſſité.	Telle fut de son sort l'affreuse cruauté, Qu'il sem sit des forfaits une nécessité.
De l'horrible aſcendant qui l’entrainoit au crime, Aprés l’avoir commis, il devint la victime.	De l'horrible ascendant qui l'entraînait au crime, Après l'avoir commis, il devint la victime.
Quoy que juſte, il n’en cût pour fruit que le remords:	Quoi que juste, il n'en cût pour fruit que le remords:
Tourmenté, déchiré de furieux tranſports;	Tourmenté, déchiré de furieux transports;
Il venoit en Tauride expier ſon offenſe, Il y devoit trouve:	Il venait en Tauride expier son offense, Il y devait trouve:
, le repos, l'innocence.	, le repos, l'innocence.
L’Oracle l’aſſuroit, j’accompagnois ſes pas.	L'Oracle l'assurait, j'accompagnais ses pas.
N’eſtoit-ce, malheureux, que pour voir ſon trépas J'ay perdu mon amy:	N'était-ce, malheureux, que pour voir son trépas J'ai perdu mon ami:
témoin de ſon nauftage, Il ne me reſte plus ſur ce triſte rivage, Privé de lſembraſſer, & de l'enſevelir, Que d’appaiſer ſes Dieux, le p’euter, & moutir.	témoin de son naufthage, Il ne me reste plus sur ce triste rivage, Privé de lsembrasser, et de l'ensevelir, Que d'apaiser ses Dieux, le p'euter, et moutir.
BLIITGERIE.	BLIITGERIE.
D'un ſi pieux devoit nul ne peut vous reprendre:	D'un si pieux devait nul ne peut vous surprendre:
Mais n’en avez-vous point encor quelqu’autre à rendre?	Mais n'en avez-vous point encor quelque autre à rendre?
Et ne peut-on de vous eſperer un ſecours, Pour prix de tous les ſoins qu’on a pris de vos jours.	Et ne peut-on de vous espérer un secours, Pour prix de tous les soins qu'on a pris de vos jours.
TLADE De ces jours malheureux que pouvez-vous pretendre?	TLADE De ces jours malheureux que pouvez-vous prétendre?
Madame, & quel ſecours en devez-vous attendret Cependant cet eſpoir dont vous m’oſez flater, Au jour que je fuyois peut encor m’arreſter.	Madame, et quel secours en devez-vous attendret Cependant cet espoir dont vous m'osez flatter, Au jour que je fuyais peut encor m'arrêter.
Commandez, je ſuis preſt.	Commandez, je suis prêt.
Pour vous que puis-je faire?	Pour vous que puis-je faire?
IPHIGENIE.	IPHIGENIE.
Pluſque vous ne croyez vous m’eſtes neceſſaire.	Plusque vous ne croyez -vous m'êtes nécessaire.
Née au ſein de la Grece, où brillent mes a yeux, Je me vois, comme vous Etrangere en ces lieux:	Née au sein de la Grèce, où brillent mes a yeux, Je me vois, comme vous Etrangère en ces lieux:
ij Un Tytan m’y retient.	ij Un Tytan m'y retient.
Miniſtre de ſes crimes, Je rougis nos Autels d’innocentes victimes.	Ministre de ses crimes, Je rougis nos Autels d'innocentes victimes.
Que die je nnurepoureen pont là fureur, Dé ivrez-moy d’un joug barbare & plein d’horreur.	Que die je nurepoureen pont là fureur, Dé ivrez-moi d'un joug barbare et plein d'horreur.
Vous pouvez de ces lieux m’applanir la ſortie.	Vous pouvez de ces lieux m'applanir la sortie.
ILADE.	ILADE.
Armez mon bras, Madame, & vous ſerez ſervie.	Armez mon bras, Madame, et vous serez servie.
Redevable à vos loins de mes mallieureux jours, Heureux en vous ſervant d’en ſignaler le cours, Auimé par vous-même.	Redevable à vos loins de mes mallieureux jours, Heureux en vous servant d'en signaler le cours, Avimé par vous-même.
& pour voſtre deffenſe.	et pour votre défense.
D'un zele plus ardent que la reconnoiſſauce, J’iray porter le fer dans le ſein de Thoas.	D'un zèle plus ardent que la reconnaissauce, J'irai porter le fer dans le sein de Thoas.
IPHIGENIE.	IPHIGENIE.
Non, ce ſeroit vous perdre, & ne me ſauver pas.	Non, ce serait vous perdre, et ne me sauver pas.
Sans ex poſer vos jours, vous pouvez m’eſtre utile, Le Tyran vous en ouvre un chemin plus facile;	Sans ex poser vos jours, vous pouvez m'être utile, Le Tyran vous en ouvre un chemin plus facile;
Puiſqu'n vous le pemet preſez votre depart i Portez dans voſtre Gtece un écrit de ma part:	Puisqu'n vous le pemet presez votre départ y Portez dans votre Grèce un écrit de ma part:
Contez mon infortune à ceux qui m’ont fait nalIls me viendront chercher, & ſe feront connoiſtre, Suivis de plus de Rois, de Chefs, & de ſoldats, Qu’Helene n’en a fair armer par Menelas.	Comptez mon infortune à ceux qui m'ont fait nalIls me viendront chercher, et se feront connaître, Suivis de plus de Rois, de Chefs, et de soldats, Qu'Hélène n'en a fair armer par Ménélas.
PILA DE.	PILA DE.
Contre voſtre Tyran prompt à tout entreprendre, Avec mes ſeuls Vaiſſeaux je viendrois vous reprendre:	Contre votre Tyran prompt à tout entreprendre, Avec mes seuls Vaisseaux je viendrais vous reprendre:
Dans ce monde où mon nom ſans tache eſt parvenu, Je ne ſuit point entré, Madame, en inconnu.	Dans ce monde où mon nom sans tache est parvenu, Je ne suit point entré, Madame, en inconnu.
Ma naiſſance eſt d’un rang reſpecté dans la Grecez.	Ma naissance est d'un rang respecté dans la Grécès.
Mais ſi je pars, quel eſt l’état où je vous laiſſe!	Mais si je pars, quel est l'état où je vous laisse!
Un Tyran odieux.	Un Tyran odieux.
Je fremis d’y penſer,.	Je frémis d'y penser,.
A recevoir ſa main oſera vous forcer.	À recevoir sa main osera vous forcer.
O Ciel!	Ô Ciel!
je pourrois voir au pouvoir d’un barbare Ce que jamais les Dieux ont formé de plus rare, Pour qui d’un feu ſecret je me ſens dévorer.	je pourrais voir au pouvoir d'un barbare Ce que jamais les Dieux ont formé de plus rare, Pour qui d'un feu secret je me sens dévorer.
Que fais-Je?	Que fais-Je?
Ou na falton va teelle s’égarer:	Ou na fallon va teelle s'égarer:
Mes diſcours, mes regards, & mon trouble, Madame, Trahiſſent, malgré moy, le ſecret de mon ame.	Mes discours, mes regards, et mon trouble, Madame, Trahissent, malgré moi, le secret de mon âme.
IPHIGENIE.	IPHIGENIE.
Qu’entens-je ?	Qu'entends-je ?
Ma pitie daignoit vous ſecourir;	Ma pitié daignait vous secourir;
Je voulois vous ſauver, mais vous voulez mourir:	Je voulais vous sauver, mais vous voulez mourir:
Vous ajoûtez l’audace au ſort qui vous opprime.	Vous ajoutez l'audace au sort qui vous opprime.
Ciel!	Ciel!
Ciane à l’Autel remenez la victime.	Ciane à l'Autel remenez la victime.
PILADE.	PILADE.
Vous ne m’étonnez point, j'ay prévû vôtre Arreſt.	Vous ne m'étonnez point, j'ai prévu votre Arrêt.
Quay jeuitante da jourmemon teu tous déplaiſt?	Quais jeuitante da jourmemon tu tous déplaît?
Rla rigdeur du coup que votſe bras m’appreſte, Soûmis, ſans murmurer, je vais porter ma teſte.	Rla rigdeur du coup que votse bras m'apprête, Soumis, sans murmurer, je vais porter ma tête.
Trop heureux:	Trop heureux:
que ma mort rempliſſe vos defirs, Et plus heureux encor, que mes dernieis ſoûpit:	que ma mort remplisse vos désirs, Et plus heureux encor, que mes dernie soupit:
Vous rediſent cent fois, par un aveu ſincere, Tont ce que le reſpect me force de vcu taire.	Vous redisent cent fois, par un aveu sincère, Tont ce que le respect me force de vcu taire.
SCENE VIII.	SCÈNE VIII.
IPHIGENIE ſeule.	IPHIGENIE seule.
Ue dit-il?	Que dit-il?
je l'entends?	je l'entends?
je le laiſſe parlet, Je ſens à ſes diſcours mon devoir chanceler:	je le laisse parlet, Je sens à ses discours mon devoir chanceler:
Qui ſuis-je?	Qui suis-je?
Iphigenie aurois-tu la foibleſſe.	Iphigénie aurais-tu la faiblesse.
Que veux-je penetrer?	Que veux-je pénètre?
Dans quel trouble.	Dans quel trouble.
Oꝰ Deeſſe !	Ô Déesse !
G-iij.	Gij.
Je connois ta vangeance au malheur qui meſuit.	Je connais ta vengeance au malheur qui mesuit.
De ma lâche pitié voila quel eſt le fruir:	De ma lâche pitié voilà quel est le fruir:
Tu me punis d’avoir épargné ta victime, Ne porte pas plus loin la peinc de ton crime.	Tu me punis d'avoir épargné ta victime, Ne porte pas plus loin la peinc de ton crime.
Tu n’auras pas long-temps à me le reprocher.	Tu n'auras pas longtemps à me le reprocher.
Je vais percer ſon cœur.	Je vais percer son cœur.
Je vais ſur le bucher Eteindre dans ſon ſang ſon ardeur orgueilleuſe.	Je vais sur le bûcher Éteindre dans son sang son ardeur orgueilleuse.
Où vas-tu?	Où vas-tu?
Qu’oſes-tu promettre, malheureuſe!	Qu'oses-tu promettre, malheureuse!
Quelque loy que t’impoſe un fier devoit, helas!	Quelque loi que t'impose un fier devait, hélas!
Eſclave de ton cœur, répons-tu de ton bras?	Esclave de ton cœur, réponds-tu de ton bras?
J’entens quelqu’un, cachons le trouble de mon.	J'entends quelqu'un, cachons le trouble de mon.
amo,	amo,
SCENE IX.	SCÈNE IX.
IPHIGENIE, HIDASPE.	IPHIGENIE, HIDASPE.
HIDASPE.	HIDASPE.
N autre Grec ſe livre entre nos mains, 7 Madame.	N autre Grec se livre entre nos mains, 7 Madame.
Malgré tous ſes efforts, en ces lieux arrivez.	Malgré tous ses efforts, en ces lieux arrivés.
IPHIGENIE.	IPHIGENIE.
Comment?	Comment?
en quel état, où l’avez-vous trouvé?	en quel état, où l'avez-vous trouvé?
HIDASPE.	HIDASPE.
On alloit ramaſſer les débris d’un naufrage, Lors qu’entre les écueils qui bordent le rivage, Qu'un mortel ſans frayeur n’oſeroit approcher.	On allait ramasser les débris d'un naufrage, Lors qu'entre les écueils qui bordent le rivage, Qu'un mortel sans frayeur n'oserait approcher.
On en voit un, Madame, à l'abry d’un rocher.	On en voit un, Madame, à l'abri d'un rocher.
Sa veuë eſt égarée, & bien loin de ſe rendre, Contre un peuple ſans nombre, il oſe ſe défendre Il rompt, il perce, il frappe, il combat fierement.	Sa vue est égarée, et bien loin de se rendre, Contre un peuple sans nombre, il ose se défendre Il rompt, il perce, il frappe, il combat fièrement.
L’on dit même, & ce bruit n’eſt pas ſans fondement:	L'on dit même, et ce bruit n'est pas sans fondement:
Qu'on a vû devant luy les fieres Eumenides, Promener leurs flambeaux, vangeurs des homicides, L'inciter au carnage:	Qu'on a vu devant lui les fières Eumenides, Promener leurs flambeaux, vengeurs des homicides, L'inciter au carnage:
& pour comble d’horreur,.	et pour comble d'horreur,.
Luy ſoufler le venin de leur noire fureur.	Lui souffler le venin de leur noire fureur.
Cependant de cent cris les Echos retentiſſent.	Cependant de cent cris les Échos retentissent.
On court de toutes parts:	On court de toutes parts:
ſes forces s’affoibliſe.	ses forces s'affaiblise.
ſent.	sent.
J’arrive, je le vois privé de ſentiment:	J'arrive, je le vois privé de sentiment:
On vient de l’apporter dans cet appartement.	On vient de l'apporter dans cet appartement.
voila de quoy le Roy par moy vous fait inſtruire.	voilà de quoi le Roi par moi vous fait instruire.
PHIGENIE.	PHIGENIE.
Je feray mon devoir.	Je ferai mon devoir.
Hidaſpe, allez luy dire, Que j’attens la victime, & vais tour préparer.	Hidaspe, allez venir dire, Que j'attends la victime, et vais tour préparer.
SCENE X.	SCÈNE X.
IPHIGENIE ſeule.	IPHIGENIE seule.
E Ciel a fait mon crime, il va le reparer;	E Ciel a fait mon crime, il va le réparer;
Il Dans le ſang de ce Grec expions ma foibleſſe:	Il Dans le sang de ce Grec expions ma faiblesse:
Allons par ſon trépas appaiſer la Deeſſe.	Allons par son trépas apaiser la Déesse.
Tâchons d’engager l’autre à quelque repentir:	Tâchons d'engager l'autre à quelque repentir:
Sauvons ce malheureux, & le faiſons partir.	Sauvons ce malheureux, et le faisons partir.
Fin di ſecond Acte,	Fin di second Acte,
ACTE III.	ACTE III.
SCENE FREMIERE.	SCÈNE FREMIÈRE.
THOMIRIS, ERINE.	THOMIRIS, ÉRINE.
ERINE.	ÉRINE.
ADAME, quel deſſein em ces lieux vous rapelle?	ADAME, quel dessein em ces lieux vous rappelle?
Qui vous porte à revoir encore uninfidelle?	Qui vous porte à revoir encore uninfidèle?
Une ſeconde fois par d'inutiles eris, Venez-vous-eſſuyer ſes ſuperbes mépris?	Une seconde fois par d'inutiles eris, Venez-vous-essuyer ses superbes mépris?
THOMIRIS.	THOMIRIS.
Fluique tous mes mameurs, je ucteſte ſa veuë:	Fluique tous mes mameurs, je usteste sa vue:
Mais, Erine, aujourd’huy ma vangeance eſt:	Mais, Erine, aujourd'hui ma vengeance est:
perduë;	perdue;
Cet Etranger qui vient d'arriver ſur nos bords,.	Cet Étranger qui vient d'arriver sur nos bords,.
De mes ſecrets deſſeins renverſe les efforts.	De mes secrets desseins renverse les efforts.
ERINE.	ÉRINE.
Qu'à de commun ſon ſort, Madame,avec le vô* tre?	Qu'à de commun son sort, Madame,avec le vô* tre?
THOMIRIS.	THOMIRIS.
Son abord m'eſt funeſte.	Son abord m'est funeste.
Il nous perd l'un & l'aure Thoas va l’expoſer à la rigueur des loix.	Il nous perd l'un et l'aure Thoas va l'exposer à la rigueur des lois.
La Preſtreſſe y conſent, elle a donné ſa voix;	La Prêtresse y consent, elle a donné sa voix;
Sa main va l'immoler, & dés ce moment même Elle épouſe Thoas, & prend le Diadême:	Sa main va l'immoler, et dès ce moment même Elle pouze Thoas, et prend le Diadme:
Si ce fatal hymen s’acheve avant la nuit, De ma vangeance, ô Ciel:	Si ce fatal hymen s'achève avant la nuit, De ma vengeance, ô Ciel:
le projet eſt détruit, Le peuple qui redoute & cherit la Preſtreſſe, s'il la voit ſur le Trône,oubliant ſa Princeſſe, De la Religion ſe faiſant une loy, Reſpectueux pour elle, oſera moins pour moy.	le projet est détruit, Le peuple qui redoute et chérit la Prêtresse, s'il la voit sur le Trône,oubliant sa Princesse, De la Religion se faisant une loi, Respectueux pour elle, osera moins pour moi.
De l’hymen du Tyran troublons le ſactifice.	De l'hymen du Tyran troublons le sactifice.
Avant que l’Etranger ſoit conduit au ſupplice, Par l’ordte de Thoas on va faire un effort, Pour applenure ſon non, ia naiſſance, ſon ſort, Je viens, par mes avis, l’exhorter à ſe taire.	Avant que l'Étranger soit conduit au supplice, Par l'ordte de Thoas on va faire un effort, Pour applenure son non, ja naissance, son sort, Je viens, par mes avis, l'exhorter à se taire.
, S’il obtient que par là ſa peine ſe differe, Si juſques à demain il peut gagner du temps, Mon entrepriſe eſt ſeure, & mes deſirs contens,,	, S'il obtient que par là sa peine se diffère, Si jusques à demain il peut gagner du temps, Mon entreprise est sûre, et mes désirs contents,
SCENE II.	SCÈNE II.
THOMIRIS, ANTHENOR ERINE.	THOMIRIS, ANTHENOR ÉRINE.
THOMIRIS.	THOMIRIS.
J'Erray-je l’Etranger Anthenor?	J'Erai-je l'Étranger Anthénor?
ANTHENOR.	ANTHENOR.
Ouy, Madame:	Oui, Madame:
Mais toujonrs agité des troubles de ſon ame, Je viens de le laiſſer paſle & ſans mouvement;	Mais toujonrs agité des troubles de son âme, Je viens de le laisser pas et sans mouvement;
Attendez pour le voir dans cet appartement, Que rappellant ſes ſens, & ſa raiſon captive, Il preſte à vos diſcours une oreille attentive.	Attendez pour le voir dans cet appartement, Que rappelant ses sens, et sa raison captive, Il prête à vos discours une oreille attentive.
Nul ne peut en ces lieux traverſer vos ſouhaits:	Nul ne peut en ces lieux traverser vos souhaits:
On garde ſeulement les dehors du Palais.	On garde seulement les dehors du Palais.
THOMIRIS.	THOMIRIS.
C'eſt aſſez.	C'est assez.
Pour ſa vie, ô Ciel!	Pour sa vie, ô Ciel!
fay qu’il m'écoûte.	fais qu'il m'écoute.
Mais avec le Tyran prenons une autre route.	Mais avec le Tyran prenons une autre route.
Allez, pour l’abuſer, luy faire concevoir, Que ſur ſes volontez je regle mon devoir.	Allez, pour l'abuser, lui faire concevoir, Que sur ses volontés je règle mon devoir.
Mais juſqu’à mon départ, de l’hymen qu’il apprête, Anthenor, dites-luy qu’il ſuſpende la feſte.	Mais jusqu'à mon départ, de l'hymen qu'il apprête, Anthenor, dites-lui qu'il suspende la fête.
ANTHENOR.	ANTHENOR.
Je vais vous obéïr;	Je vais vous obéir;
mais je n’obtiendray rien;	mais je n'obtiendrai rien;
N’eſperez pas fléchir un cœur comme le ſien.	N'espérez pas fléchir un cœur comme le sien.
Il eſt pour cet hymen trop plein d’impatience, Une pareille ardeur anime ſa vangeance.	Il est pour cet hymen trop plein d'impatience, Une pareille ardeur anime sa vengeance.
Il croit que l’Etranger que l’on vient d’arreſter, Eſt celuy dont l'Oracle a ſçû l'épouvanter.	Il croit que l'Étranger que l'on vient d'arrêter, Est celui dont l'Oracle a su l'épouvanter.
Penſez-vous l’engager à la moindre contrainte, Qui ſuſpende ſa joye, & prolonge ſa crainte?	Pensez-vous l'engager à la moindre contrainte, Qui suspende sa joie, et prolonge sa crainte?
Déja par mes diſcours que n’ay-je point tenté:	Déjà par mes discours que n'ai-je point tenté:
L’ingrat n’écoûte plus que ſon iniquité.	L'ingrat n'écoute plus que son iniquité.
De ſes plus chers amis il s’attire la haine:	De ses plus chers amis il s'attire la haine:
Madame, c’eſt à nous d’avancer nos projets, Pour pouvoir de ſa rage empeſcher les effets.	Madame, c'est à nous d'avancer nos projets, Pour pouvoir de sa rage empêcher les effets.
Obligez l’Etranger à garder le ſilence, Quand on viendra ſçavoir ſon nom & ſa naiſſance, Et que Thoas par là differant ſon arreſt.	Obligez l'Étranger à garder le silence, Quand on viendra savoir son nom et sa naissance, Et que Thoas par là différant son arrêt.
THOMIRIS.	THOMIRIS.
Il ſuffit.	Il suffit.
Anthenor faites:	Anthénor faites:
que tout ſoit preſt.	que tout soit prêt.
Voyez Thoas, vous dis-je, & luy faîtes connoiſtre, Que je pars cette nuit.	Voyez Thoas, vous dis-je, et lui faîtes connaître, Que je par cette nuit.
Que demain il eſt maiſtre:	Que demain il est maître:
Le delay n’eſt pas long.	Le délai n'est pas long.
Allez.	Allez.
SCEND III.	SCEND III.
THOMIRIS, ERINE.	THOMIRIS, ÉRINE.
ERINE.	ÉRINE.
QU'ay-je entendu:	QU'ai-je entendu:
Quoy!	Quoi!
vous renoncez donc au rang qui vons eſt En faveur de Thoas, voſtre haine affoiblie.	vous renoncez donc au rang qui vons est En faveur de Thoas, votre haine affaiblie.
THOMIRIS.	THOMIRIS.
Non, non, je ne ſuis pas Erine encor partie.	Non, non, je ne suis pas Erine encor partie.
Si je feins du Tyran d’approuver le deſſein, C’eſt pour mieux luy plonger un poignard dans le ſein.	Si je feins du Tyran d'approuver le dessein, C'est pour mieux même plonger un poignard dans le sein.
Au piege qu’il me tend j’oppoſe l’artifice.	Au piège qu'il me tend j'oppose l'artifice.
Des voiles les plus noirs couvrant ſon injuſtice, Il a pris cette nuit pour çacher mon départ;	Des voiles les plus noirs couvrant son injustice, Il a pris cette nuit pour çacher mon départ;
De cette même nuit me faiſant un rempart, Peuple, Sarmate, amis animez d’un beau zele, A l’ennemy commun la rendront éternelle.	De cette même nuit me faisant un rempart, Peuple, Sarmate, amis animés d'un beau zèle, À l'ennemi commun la rendront éternelle.
Tous ont juré ſa mort, m’en ont donné leur foy:	Tous ont juré sa mort, m'en ont donné leur foi:
Le reſte de ce jour eſt à craindre pour moy.	Le reste de ce jour est à craindre pour moi.
Tâchons donc à ce Grec d’impoſer le:	Tâchons donc à ce Grec d'imposer le:
ſilence.	silence.
Que juſques à demain.	Que jusques à demain.
Je l’entens.	Je l'entends.
Il s’avancce Ses regards ſont encor égarez, furieux.	Il s'avancée Ses regards sont encor égarés, furieux.
Le trouble de ſes ſens nous dérobe à ſes yeux.	Le trouble de ses sens nous dérobe à ses yeux.
Diſſipe, juſte Cielu le voile qui les couvre.	Dissipe, juste Cielu le voile qui les couvre.
SOSNETVC ORESTE, THOMIRIS, ERINE.	SOSNETUC ORÉTE, THOMIRIS, ÉRINE.
ORESTE.	ORÊTE.
NOus mes pas chancelans quel abîme s’entr’onvre!	NOus mes pas chancelants quel abîme s'entr'onvre!
De tenebres, de feux je ſuis envelopé;	De ténèbres, de feux je suis enveloppé;
De troubles, de terreurs.	De troubles, de terreurs.
mon eſprit eſt frapé:	mon esprit est frappé:
Noires filles du Styx, implacables Deeſſes, Souffriray-je toujours vos fureurs vangereſſes?	Noires filles du Styx, implacables Déesses, Souffrirai-je toujours vos fureurs vengeresses?
Ne vous laſſez-vous point, ô deſtins ennemis!	Ne vous lassez-vous point, ô destins ennemis!
De punir ldes forfait que vous avez permis?	De punir lèdes forfait que vous avez permis?
Grace ad Cierje reſpne, & je vois la lumiere:	Grâce ad Cierje respne, et je vois la lumière:
Où ſuis-je?	Où suis-je?
Quel Palais!	Quel Palais!
quelle pompe étranS'offre de toutes parts à mes regards ſurpris:	quelle pompe étranS' offre de toutes parts à mes regards surpris:
Quę vois-je?	Quel vois-je?
quel objet vient fraper mes eſprits!	quel objet vient frapper mes esprits!
Ce portmajenuede, cerdagunte ciſage, D’une Divinité me preſente l’image.	Ce portmajenuède, cerdagunte cisage, D'une Divinité me présente l'image.
THOMIRIS.	THOMIRIS.
Etranger, rends le calme à tes ſens agitez.	Etranger, rends le calme à tes sens agités.
Remetsdans leur repoz tes eſprits irritez.	Remetsdans leur repoz tes esprits irrités.
Le malheur qui te livre aux Deeſſes terribles, Dans ces funeſtes lieux trouve des cœurs ſenſibles,	Le malheur qui te livre aux Déesses terribles, Dans ces funestes lieux trouve des cœurs sensibles,
ORESTE.	ORÊTE.
En eſt-il qui pour moy ſe laiſſent attendrir?	En est-il qui pour moi se laissent attendrir?
O vous!	Ô vous!
dont la pitié daigne me ſecourir, Qui jettez ſur mes jours un regatd favorable, Achevez d’adoucir le ſort d’un miſerable.	dont la pitié daigne me secourir, Qui jetés sur mes jours un régat favorable, Achevez d'adoucir le sort d'un misérable.
Où ſuis-je?	Où suis-je?
ſous quel Ciel me vois-je par venu?	sous quel Ciel me vois-je par venu?
Cominent, & par quel ordre y ſuis-je retenu?	Cominent, et par quel ordre y suis-je retenu?
THOMIRIS.	THOMIRIS.
Quel Aſtre t’a conduit dans ce climat baibare?	Quel Astre t'a conduit dans ce climat baibare?
Malheureux!	Malheureux!
je fremis du ſort qu’on t’y prépare.	je frémis du sort qu'on t'y prépare.
L’Enfer eſt un ſejour moins à craindre pour toy:	L'Enfer est un séjour moins à craindre pour toi:
Si tu veux l’éviter, prens confiance en moy.	Si tu veux l'éviter, prends confiance en moi.
Fier devant tes bourreaux, dans un profond ſilence, Enſevelis ton nom, & cache ta naiſſance.	Fier devant tes bourreaux, dans un profond silence, Ensevelis ton nom, et cache ta naissance.
C’eſt l’unique moyen de conſerver tes jours.	C'est l'unique moyen de conserver tes jours.
On tremble pour tã vie, on vole à ton ſecours:	On tremble pour tendre vie, on vole à ton secours:
D’une noble pitié ſeconde l’entrepriſe;	D'une noble pitié seconde l'entreprise;
Le temps preſſe d’agir.	Le temps presse d'agir.
Je crains d’eſtre ſurpriſe.	Je crains d'être surprise.
Pour t’affranchit du ſort qui t’attend en ce lieu, Obéis à ma voix, ou crains la mort.	Pour t'affranchit du sort qui t'attend en ce lieu, Obéis à ma voix, ou crains la mort.
Adieu.	Adieu.
SCENE V.	SCÈNE V.
ORESTE ſeul.	ORÊTE seul.
U'entens-je?	U'entends-je?
A mel malleurs elle paroiſt ſenſible, Mon nom doit m’attiter une mort infaillible:	À mel malleurs elle paraît sensible, Mon nom doit m'attiter une mort infaillible:
Le ſupplice le ſuit, & pour m’en arracher, Sa bouche par pitié m’invite à le cacher.	Le supplice le suit, et pour m'en arracher, Sa bouche par pitié m'invite à le cacher.
Du malheureux Oreſte auroit-on connoiſſance?	Du malheureux Oreste aurait-on connaissance?
Le ſang de Jupiter m’a donné la naiſſance.	Le sang de Jupiter m'a donné la naissance.
Quelque éclat qu’à ma vieattache un ſang ſi beau?	Quelque éclat qu'à ma vieattache un sang si beau?
Que ne m’a-t-il eſté ravy dés le berceat?	Que ne m'a-t-il été ravi dès le berceat?
Mes yeux n’ont point en paix jouy de la lumieIls ne ſe ſont ouverts quel pour voir ma miſerc.	Mes yeux n'ont point en paix joui de la lumieIls ne se sont ouverts quel pour voir ma miserc.
Le crime a ſans relâche inveſty tous mes pas.	Le crime a sans relâche investy tous mes pas.
Dés l’enfance étranger dans mes propres Etats, Un adultere affreux m’ôta le Diadême:	Dès l'enfance étranger dans mes propres États, Un adultère affreux m'ôta le Diadme:
Un meurtte déteſté me l’a rendu de même:	Un meurte détesté me l'a rendu de même:
Mais ce qu’ont de charmant ſes faſtueux dehors.	Mais ce qu'ont de charmant ses fastueux dehors.
, Ne mettent point une ame à l’abry des remords.	, Ne mettent point une âme à l'abri des remords.
Pour rendre à mes eſprits le calme, & l’innocence, J’imploray d’Apollon la celeſte puiſſance.	Pour rendre à mes esprits le calme, et l'innocence, J'implorai d'Apollon la celeste puissance.
Son Preſtre m’ordonna, que ſidelle à ſa voix, J’allaſſe où de Diane on reſpecte les loix;	Son Prêtre m'ordonna, que sidelle à sa voix, J'allasse où de Diane on respecte les lois;
Que la tranquilité ne me ſeroit renduë, Qu’aprés avoir du Temple enlevé ſa Statuë.	Que la tranquillité ne me serait rendue, Qu'après avoir du Temple enlevé sa Statue.
Je pars pour la Tauride avec ce doux eſpoir:	Je pars pour la Tauride avec ce doux espoir:
Son rivage à mes yeux déja ſe faiſoit voir, Quand tout à coup ſurpris par un cruel orage, Briſé contre un rocher mon Vaiſſeau fit raufraJ’ay vû perir amy, ſoldats, & matelots;	Son rivage à mes yeux déjà se faisait voir, Quand tout à coup surpris par un cruel orage, Brisé contre un rocher mon Vaisseau fit raufraJ’us vu périr ami, soldats, et matelots;
Moy-même enveloppé dans l’abîme des flots, J’ignore par quel ſort la clarté m’eſt renduë.	Moi-même enveloppé dans l'abîme des flots, J'ignore par quel sort la clarté m'est rendue.
Furieux, il ne reſte à mon ame éperduë, Qu'un triſte ſouvenir de mes crimes paſſez, Qui, ſur la foy du Ciel, alloient eſtre effacez:	Furieux, il ne reste à mon âme éperdue, Qu'un triste souvenir de mes crimes passez, Qui, sur la foi du Ciel, allaient être effacés:
Mais il s’eſt repenty.	Mais il s'est repenti.
Grands Dieux!	Grands Dieux!
puiſque ma De forfaits inoüis devoit eſtre ſuivic?	puisque ma De forfaits inoüis devait être suivic?
Pourquoy,!	Pourquoi,!
dans les remords dont je ſuis combactu, :	dans les remords dont je suis combactu, :
Ae laiſſez-vous un cœur ſenſible à la vertu!	Ae laissez-vous un cœur sensible à la vertu!
De ton orgueil, Oreſte, étouffe l’imprudence, Le deſtin veut ta mort, meurs, meurs,avec conſtance, Et verſant noblement le ſang qu’il t’a donné, Fais rougir Jupiter de t’avoir condamné.	De ton orgueil, Oreste, étouffe l'imprudence, Le destin veut ta mort, meurs, meurs,avec constance, Et versant noblement le sang qu'il t'a donné, Fais rougir Jupiter de t'avoir condamné.
Ne va point de ce ſang avilir ce qui teſte, Dans la nuit du tombeau'cache le nom d’Oreſte, Qu’il ne devienne point l’opprobre de ces lieux.	Ne va point de ce sang avilir ce qui tête, Dans la nuit du tombeau'cache le nom d'Oreste, Qu'il ne devienne point l'opprobre de ces lieux.
Allons!	Allons!
Quel autre objet ſe preſente à mes yeux?	Quel autre objet se présente à mes yeux?
Quel trouble à ſon abord me ſaiſit :	Quel trouble à son abord me saisit :
je l’admire!	je l'admire!
SCENE VI.	SCÈNE VI.
IPHTGENTE, ORESTE, CYANE,, S 23 an Pe.	IPHTGENTE, ORÉTE, CYANE, S 23 an Pe.
IEIIGENIE.	JEIIGENIE.
Loignez-vous, Cy:	Loignez-vous, Cy:
ne;	ne;
& vous qu’onſe retire.	et vous qu'onze retire.
STE.	SITE.
quelle gracers juenas Oieux?	quelle grâces juenas Yeux?
querle noble fierté:	querle noble fierté:
PHIGENIE.	PHIGENIE.
De crainte, en l’abordant, mon cœur eſt agité.	De crainte, en l'abordant, mon cœur est agité.
ORESTE.	ORÊTE.
D’où vient, en la voyant, que ma fureur me qui	D'où vient, en la voyant, que ma fureur me qui
IPHIGENIE.	IPHIGENIE.
D’où vient, qu’à ſon aſpect, je me ſens interdite ?	D'où vient, qu'à son aspect, je me sens interdite ?
3 T E Etonné de me voir ſur ce bord étranger, Madame, de quels yeux vous dois-je enviſager ?	3 TIGNE Étonné de me voir sur ce bord étranger, Madame, de quels yeux vous dois-je envisager ?
Quel ſort m’annonce icy voſtre auguſte preſence?	Quel sort m'annonce ici votre auguste présence?
Ne le puis-je ſçavoit?	Ne le puis-je savait?
IPHIGENIE.	IPHIGENIE.
Armez-vous de conſtance.	Armez-vous de constance.
Montrez de voſtre cœur toute la fermeté.	Montrez de votre cœur toute la fermeté.
C’eſt icy de Thoas l’Empire tedouté.	C'est ici de Thoas l'Empire tedouté.
Nul Grec ne met le pied ſur ce fatal rivage, Fut-il du ſang des Dieux, qu’il n’iminole à ſa rage.	Nul Grec ne met le pied sur ce fatal rivage, Fut-il du sang des Dieux, qu'il n'iminole à sa rage.
A vous porter le coup mon bras eſt deſtiné:	À vous porter le coup mon bras est destiné:
Le ſacriſice eſt preſt, l’appareil ordonné:	Le sacrisice est prêt, l'appareil ordonné:
Sur l’Autel de Diane, où vous allez me ſuivre, Avant la fin du jour vous ceſſerez de vivre.	Sur l'Autel de Diane, où vous allez me suivre, Avant la fin du jour vous cesserez de vivre.
EST E, Grace au Ciel mon deſtin ne m’eſt plus inconnu;	EST E, Grâce au Ciel mon destin ne m'est plus inconnu;
Au port tant deſiré je ſuis donc parvenu.	Au port tant désiré je suis donc parvenu.
O mort!	Ô mort!
heureuſe mort!	heureuse mort!
tu ſinis ma miſere.	tu sinis ma misère.
Vous qui ſur moy des Dieux épuiſez la colere, Levez le bras;	Vous qui sur moi des Dieux épuisez la colère, Levez le bras;
ftapez, je m’abandonne à vous, Et déja mon cœur vole au devant de vos coups.	fûtapez, je m'abandonne à vous, Et déjà mon cœur vole au devant de vos coups.
Me voila preſt, marchons.	Me voilà prêt, marchons.
IPHIGENIE.	IPHIGENIE.
Je demeure immobile:	Je demeure immobile:
Que vois-je?	Que vois-je?
Que la Grece en Heros eſt fertile!	Que la Grèce en Héros est fertile!
L'atreſt du coup mottel qui les doit accabler, N’arien d’aſſez affreux pour les faite trembler.	L'atrêt du coup mottel qui les doit accabler, N'arien d'assez affreux pour les faite trembler.
Magnanime Etranger, ne pourray-je connoiſtre Quel nomn vous fut donné, quel ſang vous a fait ſalide .	Magnanime Étranger, ne pourrai-je connaître Quel nomn vous fut donné, quel sang vous a fait salide .
E Ah!	E Ah!
que ce nom fatal, dans un profond oublj, Madame, avec mon ſang n’eſt-il enſevely.	que ce nom fatal, dans un profond oubli, Madame, avec mon sang n'est-il enseveli.
IPHIGENIE.	IPHIGENIE.
Où viſtes-vous le jour?	Où vite-vous le jour?
Eſtes-vous de Trezene?	Êtes-vous de Trezene?
De Thebes, ou d’Elis, de Sparte, ou de Mycene?	De Thebes, ou d'Élis, de Sparte, ou de Mycène?
ORESTE.	ORÊTE.
O de tes ſacrez murs, de ton riche Palais, Mycene, le deſtin m’éloigne pour jamais.	Ô de tes sacrés murs, de ton riche Palais, Mycène, le destin m'éloigne pour jamais.
IPHIGENIE Vous eſtes de Mycene?	IPHIGENIE Vous êtes de Mycène?
ô Ciel!	ô Ciel!
quelle eſt ma joye!	quelle est ma joie!
De quel œil y voit-on le deſtructeur de Troye?	De quel œil y voit-on le destructeur de Troie?
Que fait dans ſes Etats le giand Agamemnon?	Que fait dans ses États le giand Agamemnon?
ORELTE.	ORELTE.
Ah!	Ah!
ſans ceſſe, & par tout, entendray-je ce nom.	sans cesse, et par tout, entendrai-je ce nom.
Terre, pour le cacher n’as-tu point de conttée?	Terre, pour le cacher n'as-tu point de contée?
Source de tant d’horreur, malheureux ſang d’Atrée, Parmy tant de Heros ne pourra-ton jamais Publier ta ſplendeur, ſaes conter tes forfaits?	Source de tant d'horreur, malheureux sang d'Atrée, Parmi tant de Héros ne pourra-ton jamais Publier ta splendeur, saes conter tes forfaits?
lIGENIE.	lIGENIE.
Chef de la Grece, iſſu d’une ſource divine, Son nam ne dement point lon auguſte origine.	Chef de la Grèce, issu d'une source divine, Son nam ne dément point lon auguste origine.
ORESTE.	ORÊTE.
Contre la perfidie, ô titres ſuperflus!	Contre la perfidie, ô titres superflus!
Agamemnon.	Agamemnon.
IEMIGENIE.	JEMIGENIE.
Hé bien?	Hé bien?
ORESTE.	ORÊTE.
Madame, il ne vit plus.	Madame, il ne vit plus.
IPHIGENIE.	IPHIGENIE.
Il ne vit plus !	Il ne vit plus !
Jaloux d’une ſi belle vie, Dieux!	Jaloux d'une si belle vie, Dieux!
avez-vous permis qu’elle luy fuſt ravie?	avez-vous permis qu'elle a fût ravie?
DRESTE.	DRÊTE.
Les Dieux n’écoûtent plus quand ils ſont irritez.	Les Dieux n'écoutent plus quand ils sont irrités.
Sur ſon Tiône, au miiieu de ſes ptoſperitez, Chargé d’ans & d’honneurs, ce.	Sur son Tiône, au miieu de ses ptosperitez, Chargé d'ans et d'honneurs, ce.
Monarque intrepide A vû, dans un feſtin, une main parricide, Soüiller, par ſontrépas, la plus ſainte des loix,	Monarque intrépide A vu, dans un festin, une main parricide, Souiller, par sontrépas, la plus sainte des lois,
IPHIGENIE.	IPHIGENIE.
Quelle main?	Quelle main?
RESTE.	RESTE.
Aſon nom, ciel!	Ason nom, ciel!
étouſſe ma voix	étousse ma voix
IPHIGENIE.	IPHIGENIE.
Quel eit ce monſtre?	Quel eit ce monstre?
ah Dieux!	ah Dieux!
ORESTE.	ORÊTE.
Saus commettre un blaſphême Puis-je le prononcer!	Saus commettre un blasphême Puis-je le prononcer!
c’eſt ſa femme elle-même.	c'est sa femme elle-même.
IPHIGENIE.	IPHIGENIE.
Clitemneſtre!	Clitemnêtre!
O A EJ A.	Ô Ô EJ A.
Lr.	Lr.
Ouy, Madame.	Oui, Madame.
Horrrible ſouvenir!	Horrible souvenir!
Ne puiſſes-tu jamais penetrer l’avenir.	Ne puisses-tu jamais pénétrer l'avenir.
IPHIGENIE.	IPHIGENIE.
Déplorable famille!	Déplorable famille!
ô criſte Iphigenie!	ô criste Iphigénie!
OREST.	ORÊT.
E.	E.
Heureuſement pour elle, elle a perdu la vie:	Heureusement pour elle, elle a perdu la vie:
Des Grecs par ſon ticpas aſlarant le départ.	Des Grecs par son ticpas aslarant le départ.
Aux crimes de ſa race elle n’eut point de part, E de tous ſes parans n’a point vû la miſere;	Aux crimes de sa race elle n'eût point de part, E de tous ses parants n'a point vu la misère;
Mais helas!	Mais hélas!
que ſa mort coûta cher à ſon pere.	que sa mort coûta cher à son père.
Comment ?	Comment ?
IPHIGENIE.	IPHIGENIE.
ORESTE.	ORÊTE.
Agamemnon vainqueur de tant de Rois', Revenon Giomphant jouir de .	Agamemnon vainqueur de tant de Rois, Revenon Giomphant jouir de .
Iesezploits.	Jésezploits.
Egiſte en ſon ableuce ayant ſeduit la Reine, De ſes amours fartifs appreheudant la peine, Au ſein de ce grand Roy, digne d’un ſort plusbeau, Iuſpira Cliremneſtre à porter le coûteau, Ptoteſtant, pour couvrit ſa lâche perfidie, Quelle vangeoit ſur luy le ſang d’Iphigenie.	Égiste en son ableuce ayant séduit la Reine, De ses amours fartifs appréheudant la peine, Au sein de ce grand Roi, digne d'un sort plusbeau, Juspira Cliremnêtre à porter le couteau, Ptôtestant, pour couvrit sa lâche perfidie, Quelle vengeait sur sang le sang d'Iphigénie.
TPHIGENIE.	TPHIGENIE.
Malheureuſe!	Malheureuse!
à quel meurtre as-tu preſté tou nom?	à quel meurtre as-tu prêté tou nom?
Oreſte aura ſuivy le, ſort d’Agamemnon:	Oreste aura suivi le, sort d'Agamemnon:
Il n’aura pû ſurvivre à l’offront de ſon pere,	Il n'aura pu survivre à l'offront de son père,
ORESTE.	ORÊTE.
Oreſte traîne encor ſa honte, & ſa miſere.	Oreste traîne encor sa honte, et sa misère.
Craint des hommes, chaſle de leur ſocieté Prophane, exclus des droits.	Craint des hommes, châle de leur société Prophane, exclus des droits.
de l'hoſpitalité:	de l'hospitalité:
Bãnuy des laints Autels, & des ſacrez Myſteres,.	Bannui des laints Autels, et des sacrés Mystères,.
Privé des feux divins, & des eaux ſalutaires, Des vagues, de des vents depiorable joüet, Il cherche à fuir le jour qu’il ne voit qu’à regrer.	Privé des feux divins, et des eaux salutaires, Des vagues, de des vents dépiorable jouet, Il cherche à fuir le jour qu'il ne voit qu'à régrer.
IPHIGENIE.	IPHIGENIE.
Funeſtes châtimehs des crimes d’une mere!	Funestes châtimehs des crimes d'une mère!
Femme, oſes-tu joü't du Soleil qui t’éclaire!	Femme, oses-tu jouret du Soleil qui t'éclaire!
ORESTE.	ORÊTE.
On bras determine, pat la lage conduit, A plongé la coupable en l’éternelle nuit.	On bras détermine, pat la ge conduit, A plongé la coupable en l'éternelle nuit.
IPHIGENIE.	IPHIGENIE.
O crime!	Ô crime!
qui ſurpaſſe, encor le crime même,.	qui surpasse, encor le crime même,.
Souverains prorecteurs du ſacré Diadéme, A-t-on pû leſoüiller?	Souverains prorecteurs du sacré Diadème, A-t-on pu lesoüiller?
l’avez-vous approuvé?	l'avez-vous approuvé?
TESTE.	TESTE.
Non.	Non.
Mais le châtiment vous en eſt reſervé.	Mais le châtiment vous en est réservé.
Vous voyez devant vous le criminel.	Vous voyez devant vous le criminel.
IPHIGENIE Impie, As-tu pû, ſans fremir, attenter à ſa vie?	IPHIGENIE Impie, As-tu pu, sans frémir, attenter à sa vie?
Diff-mé par un meurtre horrible à reciter?	Diff-mé par un meurtre horrible à réciter?
Aprés l’avoir commis oſes-tu t’en vanter.	Après l'avoir commis oses-tu t'en vanter.
Senſible à ton abord, je pleurois ta diſgrace;	Sensible à ton abord, je pleurais ta disgrâce;
Je loüois da s mon cœur ta genereuſe audace, Je plaignois la rigueur qui t’alloit accabler:	Je louais da s mon cœur ta généreuse audace, Je plaignais la rigueur qui t'allait accabler:
Ce n’eſtoit qu’à regret que j’allois t’immoler:	Ce n'était qu'à regret que j'allais t'immoler:
Mais l’horrible ferfait avoüe par ta bouche, Cruel, va diſſiper la pitiéqui me touche Avec des yeux vangeurs ſur tes crimes ouverts;	Mais l'horrible ferfait avoue par ta bouche, Cruel, va dissiper la pitiéqui me touche Avec des yeux vengeurs sur tes crimes ouverts;
, Je vais d’un monſtie affreux délivrer l’Univers, Avant la fin du jour ton ame déteſtable, Verra dans les Enfers ſon Juge épouvantable.	, Je vais d'un montie affreux délivrer l'Univers, Avant la fin du jour ton âme détestable, Verra dans les Enfers son Juge épouvantable.
Hetetis ſion onthe,	Hetetis sion onthe,
SCENE VII.	SCÈNE VII.
ORESTE ſeul.	ORÊTE seul.
OU vont ces tranſports furieux:	OÙ vont ces transports furieux:
Guel intereſt prend-elle au ſort de mes ayeux?	Guel intérêt prend-elle au sort de mes aïeux?
Ciel!	Ciel!
Mais pourquoy vouloir en penetrer la cauſe:	Mais pourquoi vouloir en pénétrer la cause:
Elle m’offie la mott.	Elle m'offie la mott.
demanday-je autre choſe?	demandai-je autre chose?
Voicy de mon bon-heur le moment fortuné, Dieux!	Voici de mon bonheur le moment fortuné, Dieux!
reprenez le ſang que vous m’avez donné.	reprenez le sang que vous m'avez donné.
Qu’il expie en coulant mon crime, & vôtre haine.	Qu'il expie en coulant mon crime, et votre haine.
Et toy, dont l’amitié compagne de ma peine, A voulu, malg:	Et toi, dont l'amitié compagne de ma peine, À voulu, malg:
é moy, partager mes malheurs:	é moi, partager mes malheurs:
Pur te rejoindre enfin, cher Pilade, je meurs.	Pur te rejoindre enfin, cher Pilade, je meurs.
Né pour un ſort plus beau, vertueux, magnanime, D’un amy plus heureux tu meritois l’eſtime, Ta mort.	Né pour un sort plus beau, vertueux, magnanime, D'un ami plus heureux tu méritais l'estime, Ta mort.
La mienne approche.	La mienne approche.
On vient, J'entens du bruit.	On vient, J'entends du bruit.
SCENE VIII.	SCÈNE VIII.
ORESTE, PILADE, HIDASPE, TAXIS.	ORÊTE, PILADE, HIDASPE, TAXIS.
PILADE.	PILADE.
Se lie demauuer vous r où m’avez-vous conduit?	Se lie demauver vous r où m'avez-vous conduit?
Croit-on m’épouvanter de menaces pareilles?	Croit-on m'épouvanter de menaces pareilles?
RESTE Qu'entens-je!	RESTE Qu'entends-je!
quelle voix vient fraper mes oreil	quelle voix vient frapper mes oreil
HIDASPE à Pilads.	HIDASPE à Pilads.
Voyez ce Grec:	Voyez ce Grec:
domptez ſes farouches eſprits:	domptez ses farouches esprits:
Opuont puel eſt ſon nom:	Opuont puel est son nom:
vos jours ſont à ce prix.	vos jours sont à ce prix.
SCENE IX.	SCÈNE IX.
ORESTE, PILADE.	ORÊTE, PILADE.
PILADE.	PILADE.
H!	H!
pour moy le trépas n’a plus rien de fuA neſte.	pour moi le trépas n'a plus rien de fuA nête.
c’eſt Pilade, grands Dieux!	c'est Pilade, grands Dieux!
E.	E.
PTLADE.	PTLADE.
Que vois-je!	Que vois-je!
c’eſt Oreſte.	c'est Oreste.
ESTE.	ESTE.
Pilade entre mes bras, qui l’auroit pû penſer?	Pilade entre mes bras, qui l'aurait pu penser?
ILADE.	ILADE.
Quel bonneur de vous von, & de vousembraſſer!	Quel bonneur de vous von, et de vousembrasser!
E Fortune accable-moy, ceſſe de te contraindre, Tu me rens mon amy, je n’ay plus à me plaindre,	 Fortune accable-moi, cesse de te contraindre, Tu me rends mon ami, je n'ai plus à me plaindre,
PILADE.	PILADE.
Quel Dieu nous a rejoint?	Quel Dieu nous a rejoint?
o fortuné moment!	ô fortuné moment!
Mais quel chagrin s’oppoſe à mon raviſſement:	Mais quel chagrin s'oppose à mon ravissement:
De vos prochains malheurs je ſens mon ame émeuë, Je fremis du bonheur qui vous offre à ma veuß.	De vos prochains malheurs je sens mon âme émue, Je frémis du bonheur qui vous offre à ma vu.
Deſtin, où ton eour roux-nous fait-il parvenir?	Destin, où ton eour roux-nous fait-il parvenir?
Ne nous raſlembles-tu que pour nous deſunir.	Ne nous râlembles-tu que pour nous désunir.
Sans ceſſe fatiguez d’éternelles allarmes, Nos yeux ne s’ouvrent plus que pour verſer des larmes.	Sans cesse fatigués d'éternelles alarmes, Nos yeux ne s'ouvrent plus que pour verser des larmes.
Quelles rigueurs encor allons-nous éprouver:	Quelles rigueurs encor allons-nous éprouver:
Ah Prince!	Ah Prince!
ſous quels Cieux venez-vous d’arriver.	sous quels Cieux venez-vous d'arriver.
ORESTE.	ORÊTE.
J'y-vay trouver la mort, c’eſt ce que je deſire.	J'y-vay trouver la mort, c'est ce que je désire.
Une Preſtreſſe, amy, vient de me la preſcrire.	Une Prêtresse, ami, vient de me la prescrire.
Quelque loin qu’elle ait pris à me remplir d’effroy Le trépas de ſa main eſt un bonheur pour moy.	Quelque loin qu'elle ait pris à me remplir d'effroi Le trépas de sa main est un bonheur pour moi.
iADE, J’entens.	iDE, J'entends.
Elle a ſoudiin adoucy vos allarmes;	Elle a soudiin adouci vos alarmes;
Vous avez dans ſes yeux trouvé les mêmes charmes.	Vous avez dans ses yeux trouvé les mêmes charmes.
Qu’Agamemnon trouva dans ceux de Briſcïs.	Qu'Agamemnon trouva dans ceux de Briscays.
ORE.	ORE.
S-TE:	STE:
Que me dis-tu?	Que me dis-tu?
Chargé de crimes inouïs, Deteſté, meritant la celeſte diſgrace, Ay-je e cœur où l’amour puiſſe encor.	Chargé de crimes inouïs, Detesté, méritant la céleste disgrâce, Ai-je e eur où l'amour puisse encor.
trouves p lac.	trouves p lac.
PILADE.	PILADE.
Quel effort d’avoir pû reſiſter à ſes coups?	Quel effort d'avoir pu résister à ses coups?
Cher Prince, que Pilade eſt encor loin de vousa Seduit par les attraits de la même Preſtreſſe, Mon cœur a ſuccombé.	Cher Prince, que Pilade est encor loin de vousa Seduit par les attraits de la même Prêtresse, Mon cœur a succombé.
Mais où va ma tendreſſe, 'Eſt-ce à de tels penſers que je dois recourir, Quand je vois vos perils, quand nous allons mourir?	Mais où va ma tendresse, 'Est-ce à de tels pensers que je dois recourir, Quand je vois vos périls, quand nous allons mourir?
PRESTE.	PRÊTE.
Toy mourir!	Toi mourir!
Que mon cœur conſente à cette Ou lile.	Que mon cœur consente à cette Ou lile.
N’ajoûte point ta mort aux crimes de ma vie:	N'ajoute point ta mort aux crimes de ma vie:
Le trépas que j’attens ne demande que moy;	Le trépas que j'attends ne demande que moi;
La douceur qui me reſte, eſt de revivre en toy.	La douceur qui me reste, est de revivre en toi.
Vy, mon cœur t’en conjure, au nom de la Preſtreſſe.	Vi, mon cœur t'en conjure, au nom de la Prêtresse.
PILADE.	PILADE.
Ah!	Ah!
ne me faites plus rougir de ma foibleſſe.	ne me faites plus rougir de ma faiblesse.
Son image en mon ame a pû vous balancer:	Son image en mon âme a pu vous balancer:
vous cniereu vange y mon mug va l’effacer.	vous cniereu vange y mon mug va l'effacer.
Mourons, n’attendons plus nulle pitié des hommes.	Mourons, n'attendons plus nulle pitié des hommes.
Mourons, mais en mourant declarons qui nous ſommes.	Mourons, mais en mourant déclarons qui nous sommes.
Que les Scythes cruels, que ees fiers inhumains, Connoiſſent dans quel ſang ils vont tremper leurs mains.	Que les Scythes cruels, que ces fiers inhumains, Connaissent dans quel sang ils vont tremper leurs mains.
Allons, Seigneur.	Allons, Seigneur.
ORESTE.	ORÊTE.
Amy, que vas-tu faire?	Ami, que vas-tu faire?
arreſte.	arrête.
PILADE.	PILADE.
Du coup qui va tombet ſuſpendons la tempeſte.	Du coup qui va tombet suspendons la tempête.
Qu’au nom d’Agamemnon étonnez, & ſurpris, Ils retiennenc le bras qui va fraper ſon fils:	Qu'au nom d'Agamemnon étonnés, et surpris, Ils retiennenc le bras qui va frapper son fils:
Ou qu’au moins l’immolant au milieu de leur Ils craignent plus de maux que n’en a ſouffert Troye.	Ou qu'au moins l'immolant au milieu de leur Ils craignent plus de maux que n'en a souffert Troie.
On vient.	On vient.
DZD X.	DZD X.
ORESTE, PILADE, HIDASPE, TAXIS.	ORÊTE, PILADE, HIDASPE, TAXIS.
HIDASPE.	HIDASPE.
NyOus eſtes-vous acquité de l'employ.	NiOus êtes-vous acquité de l'emploi.
ILADE.	ILADE.
Pour en eſtre informé, qu’on nous conduiſe an Roy.	Pour en être informé, qu'on nous conduise an Roi.
Fin du troiſième Acte.	Fin du troisième Acte.
ACTE	ACTE
ANSAE IVIS SCENE PREMIERE.	ANSAE IVIS SCÈNE PREMIÈRE.
IPHIGENIE ſeule.	IPHIGENIE seule.
Répondre à mes vœux que Cyane eſt tardive:	Répondre à mes vœux que Cyane est tardive:
Qu'en un cœur outragé la vangeance eſt active:	Qu'en un cœur outragé la vengeance est active:
Quoy qu’indigne du jour, Clitemneſtre au tombeau, Intereſſe ſa fille à punir ſon bourreau.	Quoi qu'indigne du jour, Clitemnêtre au tombeau, Intéresse sa fille à punir son bourreau.
En vain, pour aſſouvir le courroux qui m’anime, Des yeux, de toutes parts, je cherche la victime.	En vain, pour assouvir le courroux qui m'anime, Des yeux, de toutes parts, je cherche la victime.
Qui la retient;	Qui la retient;
contraire à mes reſſentimens, Le Ciel a-t-il des cœurs éteint les mouvemens?	contraire à mes ressentiments, Le Ciel a-t-il des cœurs éteint les mouvements?
De ces retardemens cherchons la certitude:	De ces retardements cherchons la certitude:
Mais où va le torrent de ton inquietude?	Mais où va le torrent de ton inquiétude?
As-tu bien démeſſé dans le fond de ton cœur, Ce qui donne naiſſance à cette vive ardeur?	As-tu bien démessé dans le fond de ton cœur, Ce qui donne naissance à cette vive ardeur?
Pour couvrir autrefois les amours de ta mere, Tu ſervis de prétexte à la mort de ton pere.	Pour couvrir autrefois les amours de ta mère, Tu servis de prétexte à la mort de ton père.
Pour l’un de ces captifs ayant pris ce poiſon, N’immole-tu point l’autre par la même raiſon.	Pour l'un de ces captifs ayant pris ce poison, N'immole-tu point l'autre par la même raison.
Ah !	Ah !
Qu’ils meurent tous deux, ma bouche le prononce.	Qu'ils meurent tous deux, ma bouche le prononce.
SCANE II.	SACNE II.
IPHIGENIE, CYANE.	IPHIGENIE, CYANE.
IPHIGENIE.	IPHIGENIE.
Ue vous tatdez, Cyane, à me rendre réponſe;	Que vous tatdez, Cyane, à me rendre réponse;
OThoas ſçait-il mon ordre, en eſt-il informe?	OThoas sait-il mon ordre, en est-il informe?
YANE, Thoas avec les Grecs, Madame, eſt enfermé.	YANE, Thoas avec les Grecs, Madame, est enfermé.
Hidaſpe irreſolu, quand je me ſuis montrée, De ſon apartement m’a defendu l’entrée:	Hidaspe irrésolu, quand je me suis montrée, De son appartement m'a défendu l'entrée:
En vain à les rerus jay voulu rentter;	En vain à les rerus jay voulu renter;
Il a reçû voſtre ordre, & l’eſt allé porter.	Il a reçu votre ordre, et l'est allé porter.
I’eſperois de Thoas une prompte audiance;	J'espérais de Thoas une prompte audience;
Mais ſans vouloir répondre à mon impatience, Le Roy m’afait ſçavoir que dans quelques mo*mens, On vous informeroit de ſes commandemens,	Mais sans vouloir répondre à mon impatience, Le Roi m'afait avoir que dans quelques mo*ments, On vous informerait de ses commandements,
PHIGENIE.	PHIGENIE.
Le ſacrifice eſt preſt, la pompe eſt avancée.	Le sacrifice est prêt, la pompe est avancée.
Que veut-il ?	Que veut-il ?
Attend-il que l'heure en ſoit paſſée?	Attend-il que l'heure en soit passée?
S çait-il que ces delais ſont des momens perdus?	 Sait-il que ces délais sont des moments perdus?
Que l’ardeur qu’il avoit ne retrouvera plus?	Que l'ardeur qu'il avait ne retrouvera plus?
Allons, Cyane, allons haſter noſtre vangeance Mais qui vient s’oppoſer à mon impatience?	Allons, Cyane, allons hâter notre vengeance Mais qui vient s'opposer à mon impatience?
SCENE III.	SCÈNE III.
THOMIRIS, IPHIGENIE, CYANE, ERINE.	THOMIRIS, IPHIGENIE, CYANE, ÉRINE.
THOMIRIS.	THOMIRIS.
E bruir qui ſe répand par voſtre oidre en ces L ieux Madame, m’a contraint à paroiſtre à vos yeux.	E bruir qui se répand par votre oidre en ces jeux Madame, m'a contraint à paraître à vos yeux.
Quoy que la certitude en toſt par tout ſemce, J’ay crù que je devois, pour en eſtre informée, De mon deſtin par vous ſçavoir la verité.	Quoi que la certitude en tôt par tout semée, J'ai crù que je devais, pour en être informée, De mon destin par vous savoir la vérité.
Je vous vois un viſage interdit, agité;	Je vous vois un visage interdit, agité;
Vous paroiſſez contrainte, étonnée, inquiete, Madame, ma venuë eſt peut-eſtre indiſcrete.	Vous paraissez contrainte, étonnée, inquiète, Madame, ma venue est peut-être indiscrète.
IPHIGENIE.	IPHIGENIE.
Madame, à voſtre rang je ſçay ce que je doy;	Madame, à votre rang je sais ce que je dois;
Mais, je vous l’avoüray, je ne ſuis pas à moy.	Mais, je vous l'avouerai, je ne suis pas à moi.
Diane en ce moment m’ordonne un ſacrifice:	Diane en ce moment m'ordonne un sacrifice:
Elle en attend l’offrande, en preſſe la juſtice;	Elle en attend l'offrande, en presse la justice;
Cet ordre ſouverain ne laiſſe en mon pouvoir Que le temps qu’il me faut pour remplir mon devoir.	Cet ordre souverain ne laisse en mon pouvoir Que le temps qu'il me faut pour remplir mon devoir.
THOMIRIS.	THOMIRIS.
Il eſt donc vray, Madame, & ce Gtec qu’on opprime, De divers intereſts déplorable victime, Sur ces funeſtes bords eſt à peine arrivé, Que du jour, par vos mains, il ſe vavoir privé Avez-vous pronoucé cet Arreſt ſauguinaire?	Il est donc vrai, Madame, et ce Grec qu'on opprime, De divers intérêts déplorable victime, Sur ces funestes bords est à peine arrivé, Que du jour, par vos mains, il se vavoir privé Avez-vous pronoucé cet Arrêt sauguinaire?
Madame, il eſt bien prompt pour eſtre lans myſtere.	Madame, il est bien prompt pour être lans mystère.
IPHIGENIE.	IPHIGENIE.
Ce qu’il a de profoud & de myſteri eux, Eſt un compte que j’ay, Madame, à rendre aux Dieux	Ce qu'il a de profoud et de mystéri eux, Est un compte que j'ai, Madame, à rendre aux Dieux
THOMIRIS.	THOMIRIS.
On abuſe ſouvent des ſuprêmes ſageſſes, Souz ces voiles pompeux nous cachons nos foibleſſes;	On abuse souvent des suprêmes sagesses, Sourz ces voiles pompeux nous cachons nos faiblesses;
Ce u’eſt qu’à ces dehors que nous ſacrifions, Et quelquefois nos Dieux ce ſont nos paſſions.	Ce Çu'est qu'à ces dehors que nous sacrifions, Et quelquefois nos Dieux ce sont nos passions.
Je prens ſut nos vertus une aſſurance entiere, De ce Trône uſurpé legitime heritiere.	Je prends sut nos vertus une assurance entière, De ce Trône usurpé légitime héritière.
Pour me laiſſer tranquile en mes propres Etats, J’ay vu voſtre grand cœur reſiſter à Thoas:	Pour me laisser tranquille en mes propres États, J'ai vu votre grand cœur résister à Thoas:
Vous avez dédaigné l’hymen qu’il vous propoſe, Charmée à ces refus, j’en admire la cauſe.	Vous avez dédaigné l'hymen qu'il vous propose, Charmée à ces refus, j'en admire la cause.
Les Scythes étonnez vous loüoient avec moy;	Les Scythes étonnés vous louaient avec moi;
Mais lors qu’enfin ſoûmiſe aux volontez du Roy, Vous allez de ce Grec trancher la deſtinée.	Mais lors qu'enfin soumise aux volontés du Roi, Vous allez de ce Grec trancher la destinée.
Que Thoas ſur ſa mort fonde voſtre hymenée.	Que Thoas sur sa mort fonde votre hyménée.
Le peuple qui ſçait mal juger du fond des cœurs, Sur voſtre changement préſage ſes malheurs.	Le peuple qui sait mal juger du fond des cœurs, Sur votre changement présage ses malheurs.
Vous le ditay-je enfin, Madame, on vous ſoupçonne De vouloir, par ſa perte, uſurper la Couronne.	Vous le ditai-je enfin, Madame, on vous soupçonne De vouloir, par sa perte, usurper la Couronne.
J’ay crû, de ce qu’on craint, devoir vous informer, Quelque ſoit ce ſoupçon vous pouvez le calmer.	J'ai cru, de ce qu'on craint, devoir vous informer, Quelque soit ce soupçon vous pouvez le calmer.
Differez cette moit où Thoas vous engage, Par là vous ferez taire un bruit qui vous outrage.	Différez cette moit où Thoas vous engage, Par là vous ferez taire un bruit qui vous outrage.
IPHIGENIE.	IPHIGENIE.
Souvent ſur l’apparence on tombe dans l’erreur;	Souvent sur l'apparence on tombe dans l'erreur;
Mais par l’évenement on connoiſtra mon cœur.	Mais par l'événement on connaîtra mon cœur.
Ce n'eſt pas loin des lieux où je fus élevée, Qu’on me rendra le rang dont le ſort m’a privée.	Ce n'est pas loin des lieux où je fus élevée, Qu'on me rendra le rang dont le sort m'a privée.
Celuy qu’on m’offre encor, malgré tous mes méris Pour vous le diſputer n’eſt pas d’aſſez haut prix;	Celui qu'on m'offre encor, malgré tous mes méris Pour vous le disputer n'est pas d'assez haut prix;
Et ſi pour moy ce Trône avoit eu quelques charmes Je n’autois pas ſi tard-confirmé vos allarmes.	Et si pour moi ce Trône avait eu quelques charmes Je n'autais pas si tard-confirmé vos alarmes.
Dianc & mon devoir m’appellent à l’Autel;	Dianc et mon devoir m'appellent à l'Autel;
Je vay ſur l’ktranger porter le coup mortel:	Je vais sur l'ktranger porter le coup mortel:
On ne peut l’arracher à la mott qu’il merite:	On ne peut l'arracher à la mott qu'il mérite:
Le remps preſſe:	Le remps presse:
on m’attend:	on m'attend:
ſouffrez que je vous quitte.	souffrez que je vous quitte.
THOMIRIS.	THOMIRIS.
Madame ſur le ſang que vous allez verſer, Je ne dis plus qu’un mot, c’eſt à vous d’y penſer.	Madame sur le sang que vous allez verser, Je ne dis plus qu'un mot, c'est à vous d'y penser.
bblis lia protectiout j ay prie voſtre victime, Suſpendez la rigueur du deſtin qui l’opprime, Sans emprunter des Dieux d’inutiles détours, Accordez ma priere, ou tremblez pour vos jours.	bblis lia protectiout j' ai prie votre victime, Suspendez la rigueur du destin qui l'opprime, Sans emprunter des Dieux d'inutiles détours, Accordez ma prière, ou tremblés pour vos jours.
CENE IV.	CÈNE IV.
IPHIGENIE, CYANE.	IPHIGENIE, CYANE.
IPHIGENIE Uoy donc!	IPHIGENIE Uoi donc!
elle menace, & de ce Grec imElle prend la deffenſe, & protege la vie.	elle menace, et de ce Grec imElle prend la défense, et protege la vie.
Quand de juſtes raiſons n’armeroient point mon bras, Quand mon cœur n’auroit point reſolu ſon trépas, Son audace, la peur qu’elle prétend me faire, Haſteroient cette mort qu’elle veut qu’on differe.	Quand de justes raisons n'armeraient point mon bras, Quand mon cœur n'aurait point résolu son trépas, Son audace, la peur qu'elle prétend me faire, Hâteraient cette mort qu'elle veut qu'on diffère.
Rien ne peut m’ébranler.	Rien ne peut m'ébranler.
Allons, Cyane, allons.	Allons, Cyane, allons.
La juſtice à toujouts guide vos palſions.	La justice à toujouts guide vos palsions.
De tous leurs mouvemens elle eſt inſéparable, Tantoſt pout l’un des Grecs vous étiez équitable;	De tous leurs mouvements elle est inséparable, Tantôt pout l'un des Grecs vous étiez équitable;
Quel intereſt pour l’autte arme voſtre rigueur?	Quel intérêt pour l'autte arme votre rigueur?
IPHIGENIE.	IPHIGENIE.
Ah!	Ah!
ne rappelle point ce qui me fait horteur.	ne rappelle point ce qui me fait horteur.
Contre luy mon courroux à chaque inſtant s’augmente.	Contre lui mon courroux à chaque instant s'augmente.
Il a tué ma mere, il l’avouë, il s’en vante:	Il a tué ma mère, il l'avoue, il s'en vante:
Il me l’a dit, Cyane.	Il me l'a dit, Cyane.
A cette impieté Oſes-tu m’acculer de trop de cruauté.	À cette impiété Oses-tu m'acculer de trop de cruauté.
YANE.	YANE.
Je demeure interdite & muette à ce crime:	Je demeure interdite et muette à ce crime:
Voſtre fureur eſt juſte, & ſa mort legirime.	Votre fureur est juste, et sa mort légirime.
Il ne ſçautoir trop toſt expirer ſous vos coups.	Il ne savoir trop tôt expirer sous vos coups.
Mais, ô Ciel!	Mais, ô Ciel!
que la ſuite eſt à craindre pour vous.	que la suite est à craindre pour vous.
Le Roy de cette mort attend ſa deſtinée, Et vous n'en pourtez plus fetaruer l’hymenée.	Le Roi de cette mort attend sa destinée, Et vous n'en pourtez plus fétaruer l'hyménée.
PHIGENIE.	PHIGENIE.
Pour reſiſter, Cyane, aux tranſports de Thoas, Mon courage, les Dieux ne me manqueront pas.	Pour résister, Cyane, aux transports de Thoas, Mon courage, les Dieux ne me manqueront pas.
Bravons la tyrannie où mon malheur m’expoſe, Aux cœurs comme le mien la vie eſt pen de choſe.	Bravons la tyrannie où mon malheur m'expose, Aux cœurs comme le mien la vie est pen de chose.
Quoy vous.	Quoi vous.
CYANE.	CYANE.
IPHIGENIE.	IPHIGENIE.
Allons ſçavoir par quel ſoudain appuy Ce Grec.	Allons sçavoir par quel soudain appui Ce Grec.
CYANE.	CYANE.
Hidaſpe vient, vous l’apprendrez de luy.	Hidaspe vient, vous l'apprendrez de lui.
DODE V.	DODE V.
IPHIGENIE, HIDASPE, CYANE.	IPHIGENIE, HIDASPE, CYANE.
IPHIGENIE.	IPHIGENIE.
U donc eſt l’Etranger, & par quelle injuſtiThoas recule-t-il ce fatal ſacrifice?	V donc est l'Étranger, et par quelle injustiThoas recule-t-il ce fatal sacrifice?
Ne craint-il point ſur luy que les Dieux irritez.	Ne craint-il point sur luique les Dieux irrités.
HIDASPE.	HIDASPE.
Le Roy pluſque jamais a beſoin de clartez.	Le Roi plusque jamais a besoin de clartés.
Rien n’égale l’horreur du trouble qu’il éprouve, Dans l’un de ces deux Grecs ſon ennemy ſe trouIl le voit, & ne peut diſcerner quel il eſt;	Rien n'égale l'horreur du trouble qu'il éprouve, Dans l'un de ces deux Grecs son ennemi se trouIl le voit, et ne peut discerner quel il est;
Il le cherche avee ſoin, chacun d’eux le paroiſt:	Il le cherche ave soin, chacun d'eux le paraît:
Et tous deux pour mourir prennaut ce nom impie Aucun ne veut celuy qui l’attache à la vie.	Et tous deux pour mourir prennaut ce nom impie Aucun ne veut celui qui l'attache à la vie.
Dans ce trouble mortel.	Dans ce trouble mortel.
Mais les voicy tous deux.	Mais les voici tous deux.
Sçachez quel eſt celuy.	Sachez quel est celui.
IPHIGENIE.	IPHIGENIE.
Qu'on me laiſſe avee eux.	Qu'on me laisse avée eux.
OBNDVI.	ÔBNDVI.
IPHIGENIE, ORESTE, PILADE.	IPHIGENIE, ORÉTE, PILADE.
IPHIGENIE.	IPHIGENIE.
JOus vous obſtinez donc à refuſer ma grace, VToujours dans vos regards je voy la même audace, Et que vous preferez une ſanglante mort, Au ſoin que ma pitié prenoit de voſtre ſort.	JOus vous obstinez donc à refuser ma grâce, VToujours dans vos regards je vois la même audace, Et que vous préférez une sanglante mort, Au soin que ma pitié prenait de votre sort.
PILADE, Que mon deſtin, Madame, a bien changé de face.	PILADE, Que mon destin, Madame, a bien changé de face.
Cet amy, dont tantoſt je pleurois la diſgrace, Echapé de Neptune & d’Eole en coutroux, Suivy de ſes malheurs, Madame, eſt devant vous.	Cet ami, dont tantôt je pleurais la disgrâce, Échappé de Neptune et d'Éole en coutroux, Suivi de ses malheurs, Madame, est devant vous.
PHIGENIE.	PHIGENIE.
Qu’entens-je?	Qu'entends-je?
où cet aveu porte-t-il mon idée?	où cet aveu porte-t-il mon idée?
Pitié mal reconnuë, où m’aviez-vous guidée?	Pitié mal reconnue, où m'aviez-vous guidée?
Je plaignois un mortel, qui co:	Je plaignais un mortel, qui connais:
te pour amy, Un monſtre furieux que l’Enfer a vomy.	te pour ami, Un montre furieux que l'Enfer a vomi.
Indigne que mon bras, au deffaut du tonnerre, Soit choiſi par les Dieux pour en purger la terre.	Indigne que mon bras, au défaut du tonnerre, Soit choisi par les Dieux pour en purger la terre.
PILADE.	PILADE.
Madame, cet amy ne vous eſt pas connu.	Madame, cet ami ne vous est pas connu.
Si dans quelques honneurs mon nom eſt parvenu, Et ſi pa:	Si dans quelques honneurs mon nom est parvenu, Et si pa:
my les Grecs je ſuis recommandable, C’eſt à ſon amitié que t’en ſuis redevable:	mi les Grecs je suis recommandable, C'est à son amitié que t'en suis redevable:
L’un à l’autre liez par le plus ſaint des nœuds, Ou nous vivrons enſemble, ou nous mourrons tous deux.	L'un à l'autre liés par le plus saint des nœuds, Ou nous vivrons ensemble, ou nous mourrons tous deux.
IPHIGENIE.	IPHIGENIE.
N’attens pas que ma main te joigne à ce perfide :	N'attends pas que ma main te joigne à ce perfide :
Je vais devant tes yeux punir ſon parrieide, Dans les flots de ſon ſang éteindie mon courroux.	Je vais devant tes yeux punir son parrieide, Dans les flots de son sang éteindie mon courroux.
Tu le verras tomber ſous l’effort de mes coups, Sans que ton lâche cœur, preſent au ſacrifice, Puiſſe obtenir la mort par grace, ou par ſupplice.	Tu le verras tomber sous l'effort de mes coups, Sans que ton lâche cœur, présent au sacrifice, Puisse obtenir la mort par grâce, ou par supplice.
Venez.	Venez.
PILADE.	PILADE.
Craignez vous-même, & tremblez d'y penſer.	Craignez vous-même, et tremblez d'y penser.
C'eſt le pur ſang des Lieux que vous allez verſer.	C'est le pur sang des Lieux que vous allez verser.
Son bras, à vos deſſeins, peut ſervir mieux qu’un autre:	Son bras, à vos desseins, peut servir mieux qu'un autre:
Sa haine, pour Thoas, eſt égale à la vôtre;	Sa haine, pour Thoas, est égale à la vôtre;
Et ce motif m’oblige à ne vous plus cacher, Ce que tous les tourmens ne ſçauroient m’arracher.	Et ce motif m'oblige à ne vous plus cacher, Ce que tous les tourments ne sauraient m'arracher.
Du grand Agamemnon reſpectez ce qui reſte, Heritier de ſon rang, c’eſt ſon ſils, c’eſt Oreſte.	Du grand Agamemnon respectez ce qui reste, Héritier de son rang, c'est son sils, c'est Oreste.
Oreſte!	Oreste!
IPHIGENIE.	IPHIGENIE.
ORESTE.	ORÊTE.
A cet amy n’ajoûtez point de foy, Il vous peint des vertus qui ne ſont point en moy:	À cet ami n'ajoutez point de foi, Il vous peint des vertus qui ne sont point en moi:
Ce n’eſt que par pitié que ſa bouche me louë.	Ce n'est que par pitié que sa bouche me loue.
Je ſuis du ſang des Dieux, il eſt vray, je l’avouë.	Je suis du sang des Dieux, il est vrai, je l'avoue.
Mais que ce même ſang des mortels reveré, Par mes cruels ayeux s’eſt vû deshonoré.	Mais que ce même sang des mortels révéré, Par mes cruels aïeux s'est vu déshonoré.
Leur rage a fiit fremir juſqu’aux Aſtres celeſtes, Meurtres, impietez, adulteres, inceſtes, Sout de ce ſaug impur les crimes les plus doux;	Leur rage a fiit frémir jusqu'aux Astres célestes, Meurtres, impiété, adultères, incestes, Sout de ce saug impur les crimes les plus doux;
Né parmy leurs fotfaits, je les ſurpaſſe tous:	Né parmi leurs fotfaits, je les surpasse tous:
Parricide alteré d’une ſoif ſanguinaire, J’ay pouſſé le poignard dans le ſein de ma mere;	Parricide altéré d'une soif sanguinaire, J'ai poussé le poignard dans le sein de ma mère;
J’ay ſoü lle ſans reſpect les flancs quiim’ont porté, Et j’en ay retité mor bras enſanglanté:	J'ai sou lé sans respect les flancs quiimont porté, Et j'en ai retité mór bras ensanglanté:
Iy ceouter tur ma iuoſe ny pitie, ny priere, Ouy, je vous la demande à genoux.	Ji ceouter tur ma juose ni pitié, ni prière, Oui, je vous la demande à genoux.
IPHIGENIE.	IPHIGENIE.
Ah mon frere!	Ah mon frère!
REGIE.	RÉGIE.
Juſte Ciel!	Juste Ciel!
de quel nom vient-on de m’honorer!	de quel nom vient-on de m'honorer!
L’ay-je bien entendu, dois-je m’en aſſurer!	L'ai-je bien entendu, dois-je m'en assurer!
Moy.	Moi.
voſtre frere!	votre frère!
moy, quel Dieu, quel ſang nous lie?	moi, quel Dieu, quel sang nous lie?
PYAAIGENTE.	PYAIGENTE.
Voyez, reconnoiſſez la triſte Iphigenie, Que ſon pete en aulide a livrée au trépas:	Voyez, reconnaissez la triste Iphigénie, Que son pete en aulide a livrée au trépas:
Que Diane ſauva des fureurs de Calchas.	Que Diane sauva des fureurs de Calchas.
C’eſt cette même ſœur qui s’offre à vôtre veuë:	C'est cette même sœur qui s'offre à votre vue:
auais nelas :	auais nélas :
datis a'ier te mps vous eſt-elle renduë?	datis a'ier te mens vous est-elle rendue?
O miracle étonnant!	Ô miracle étonnant!
ò ſurprenant bon-heur!	Ce surprenant bonheur!
Iphigenie icy retrouvé:	Iphigénie ici retrouvé:
ah ma ſœur!	ah ma sœur!
PILADE.	PILADE.
Surpris d’étonnement, de ſurpriſe, & de joye, Je prens part au bonheut que le Ciel vous envoye.	Surpris d'étonnement, de surprise, et de joie, Je prends part au bonheut que le Ciel vous envoie.
IPHIGENIE.	IPHIGENIE.
Où nous emportez-vous, mou vemens imprevûs?	Où nous emportez-vous, mou vements imprévus?
Plût au Ciel que jamais nous ne nous fuſſions vûs.	Plût au Ciel que jamais nous ne nous fussions vus.
Le Tyran à mon bras impoſe un ſacrilege.	Le Tyran à mon bras impose un sacrilège.
Où tombera mon choix, & ſur qui fraperay-je?	Où tombera mon choix, et sur qui frapperai-je?
Sut mon frere;	Sut mon frère;
à ce nom je tremble, je fremis:	à ce nom je tremble, je frémis:
Sur ſon amy, quel crime, ô Ciel!	Sur son ami, quel crime, ô Ciel!
a-t-il commis?	a-t-il commis?
Pour ſauver à mon bras cet affreux parricide, Que la mort m’eûteſté ſavorable en Aulide.	Pour sauver à mon bras cet affreux parricide, Que la mort m'eûtesté savorable en Aulide.
PILADE.	PILADE.
Entre ce frere & moy pouvez-vous balancer.	Entre ce frère et moi pouvez-vous balancer.
Ignorez-vous le ſang que vous devez verſer.	Ignorez-vous le sang que vous devez verser.
Vous connoiſſez mon cœur, du feu qui le devote, J’eſtois tantôt coupable, & je le ſuis encore.	Vous connaissez mon cœur, du feu qui le dévote, J'étais tantôt coupable, et je le suis encore.
Helas!	Hélas!
IPHIGENIE.	IPHIGENIE.
ORESTE.	ORÊTE.
Il n’eſt plus temps de répandre des pleurs, A l’eſpoir dont le Ciel nous flate, ouvrons nos cœurs:	Il n'est plus temps de répandre des pleurs, À l'espoir dont le Ciel nous flatte, ouvrons nos cœurs:
Je me ſens inſpiré par ſes vives lumieres, Et dans l’évenement de ſes profonds myſteres, Le deſtin qui ſe cache à nos ſens aveuglez, Ne nous a point icy vainement raſſemblez.	Je me sens inspiré par ses vives lumières, Et dans l'événement de ses profonds mystères, Le destin qui se cache à nos sens aveuglez, Ne nous a point ici vainement rassemblés.
Armous-nous d’une noble & ſainte confiance, L’image de Diane eſt en vôtre puiſſance.	Amous-nous d'une noble et sainte confiance, L'image de Diane est en votre puissance.
Pour expier l’horreur dont mon nom eſt taché, A ſon enlevement mon ſort eſt attaché.	Pour expier l'horreur dont mon nom est taché, À son enlèvement mon sort est attaché.
Livrez-la moy.	Livrez-la -moi.
Comblez de gloire & d’allegreſſe, Prenant heureuſement les chemins de la Grece, Où mon crime par là doit enfin s’effacęr.	Comblez de gloire et d'allégresse, Prenant heureusement les chemins de la Grèce, Où mon crime par là doit enfin s'effacr.
Ma Sœur, parmy nos Dieux nous irons la placer.	Ma Sœur, parmi nos Dieux nous irons la placer.
IPHIGENIE.	IPHIGENIE.
Loin de blâmer en vous certe ardeur empreſſée, J’approuverois, mon frere, une telle penſée, Si je voyois aſſez la faveur des deſtins, De l’Empire d’Argos nous tracer les chemins:	Loin de blâmer en vous certe ardeur empressée, J'approuverais, mon frère, une telle pensée, Si je voyais assez la faveur des destins, De l'Empire d'Argos nous tracer les chemins:
Mais ſeuis & deſarmez, ſans vaiſſeaux, ſans défenſe Croyez-vous d’un Tyran tromper la vigilance.	Mais sévis et désarmés, sans vaisseaux, sans défense Croyez-vous d'un Tyran tromper la vigilance.
Combattre & traverſer un monde d’ennemis, Vous ouvrir un paſſage à ſes ordres ſoûmis.	Combattre et traverser un monde d'ennemis, Vous ouvrir un passage à ses ordres soumis.
Du Temple & de l’Autel enlever la Statuë, Où ſa fottune attache & ſes loins, & ſa vûë.	Du Temple et de l'Autel enlever la Statue, Où sa fottune attache et ses loins, et sa vue.
Contre taut de perils qu’oſerez-vous tenter ?	Contre taut de périls qu'oserez-vous tenter ?
Quel miracie!	Quel miracie!
quel Dieu pourroient les ſurmiouter	quel Dieu pourraient les surmiouter
PILADE.	PILADE.
Madame, n’ayez point ces indignes allarmes, Livrez-nous ſeulement la Statuë, & des armes, Les Dieux de ce peril ſçauront nous dégager:	Madame, n'ayez point ces indignes alarmes, Livrez-nous seulement la Statue, et des armes, Les Dieux de ce péril sauront nous dégager:
Qui ne craint point la mort ſurmonte le danger:	Qui ne craint point la mort surmonte le danger:
Enflamez du deſir qu’inſpire la victoire, Le fer nous ouvrira les ſentiers de la gloire, Qu’ie tupicme nomeul d’une eciatante mort.	Enflamés du désir qu'inspire la victoire, Le fer nous ouvrira les sentiers de la gloire, Qu'ie tupicme nomeul d'une eciatante mort.
1.	1.
Souffrez, au nom des Dieux, que l’un ou l’autre ſort, Epargne à vôtre main l’horreur d’un ſacrilege, Qu’aux ordres de Thoas.	Souffrez, au nom des Dieux, que l'un ou l'autre sort, Épargne à votre main l'horreur d'un sacrilège, Qu'aux ordres de Thoas.
IPHIGENIE.	IPHIGENIE.
Et moy que deviendray-je?	Et moi que deviendrai-je?
Sanglant, enorgueilly d’un triomphe inhumain, Je verray le Tyran vos teſtes à la main, M’impoſer un hymen que mon ame déreſte, Tombe plûtoſt ſur moy la colere celeſte.	Sanglant, enorgueilly d'un triomphe inhumain, Je verrai le Tyran vos têtes à la main, M'imposer un hymen que mon âme déreste, Tombe plutôt sur moi la colère celeste.
Eſperons toutefois, maiſtreſſe de vos jours, Je puis, de quelque temps, en prolonger le cours.	Espérons toutefois, maîtresse de vos jours, Je puis, de quelque temps, en prolonger le cours.
Quoy que Thoas, avide & de ſang & de crimes, N’ait pour Religion que ſes fieres maximes, Il n’oſe, aux yeux du peuple, avec impunité, Découvrir tout l’excés de ſon impieté.	Quoi que Thoas, avide et de sang et de crimes, N'ait pour Religion que ses fières maximes, Il n'ose, aux yeux du peuple, avec impunité, Découvrir tout l'excès de son impiété.
Ma preſence, le frein du ſacré miniſtere, Abaiſſe ſes regards, trouble ſon front ſevere.	Ma présence, le frein du sacré ministère, Abaisse ses regards, trouble son front sévère.
Du temps que j’obtiendray par mes retardemens, Songeons à ménager les precieux momens.	Du temps que j'obtiendrai par mes retardements, Songeons à ménager les précieux moments.
Allons lever au Ciel nos yeux baignez de larmes, Pour fléchir ſa rigueur ce ſont nos ſeules armes:	Allons lever au Ciel nos yeux baignés de larmes, Pour fléchir sa rigueur ce sont nos seules armes:
Que ſi toujours ſevere au ſang d’Agamemnon, Pour ce malheureux reſte il n’eſt plus de pardon, Fermant, ſans murmurer les yeux ſur nos myſteDeſcendons au tombeau, victimes de nos Peres;	Que si toujours sévère au sang d'Agamemnon, Pour ce malheureux reste il n'est plus de pardon, Fermant, sans murmurer les yeux sur nos mystèreDescendons au tombeau, victimes de nos Pères;
Mais Mais vous, qui n’avez point de part à leurs forBalio Vivez, Prince, étouffez d’inutiles ſouhaits.	Mais Mais vous, qui n'avez point de part à leurs forBalio Vivez, Prince, étouffez d'inutiles souhaits.
Sans la haine des Dieux, croyez qu’Iphigenie, Pour eſtre unie à vous, auroit aimé la vie.	Sans la haine des Dieux, croyez qu'Iphigénie, Pour être unie à vous, aurait aimé la vie.
PILADE.	PILADE.
Que je vves mauaun, deſeiplle laas vous?	Que je veues mavaun, desejple laas vous?
Ah!	Ah!
plûtoſt tout mon ſang.	plutôt tout mon sang.
IPHIGENIE.	IPHIGENIE.
Le Tyran vient à nous.	Le Tyran vient à nous.
OGBEDIII.	OGBEDII.
THOAS, IPHIGENIE, ORESTE, PILADE, ANTHENOR, HIDASPE, TAXIS.	THOAS, IPHIGENIE, ORESTE, PILADE, ANTHÉNOR, HIDASPE, TAXIS.
LIOn 3.	LIOn 3.
E bien, Madame, Oreſte enfin va-t-il paET roiſtre;	E bien, Madame, Oreste enfin va-t-il payT roître;
S’obſtinent-ils encor tous deux à vouloir l’eſtre?	S'obstinent-ils encor tous deux à vouloir l'être?
Avez-vous dévoilé cette funeſte erreur, Qui le montre à mes yeux, & le cache à mon cœur?	Avez-vous dévoilé cette funeste erreur, Qui le montre à mes yeux, et le cache à mon cœur?
IPHIGENIE.	IPHIGENIE.
N’eſpere pas par moy voir ton erreur ceſſée, Autant, & plus que toy, je ſuis embaraſſée.	N'espère pas par moi voir ton erreur cessée, Autant, et plus que toi, je suis embarrassée.
Mon ame eſt ſuſpenduë entre ces deux amis, Tous deux d’un ſaint devoir également épris, De mourir l’un pour l’autre ont la perſeverence, Aucun ne veut devoir la vie à ta clemence.	Mon âme est suspendue entre ces deux amis, Tous deux d'un saint devoir également épris, De mourir l'un pour l'autre ont la persévérence, Aucun ne veut devoir la vie à ta clémence.
THOAS.	THOAS.
Cette comuntou conmiouce me llaſſer, Madame, c’eſt à vous de la faire ceſſer.	Cette comuntou commiouce me lasser, Madame, c'est à vous de la faire cesser.
Faites-moy voir Oreſte, & me livrez ſa teſte, Ou pour tomber ſur eux la foudré eſt toute prête.	Faites-moi voir Oreste, et me livrez sa tête, Ou pour tomber sur eux la foudré est toute prête.
PILADE.	PILADE.
Faut-il te le redire, Oreſte eſt devant toy, Il ne ſe cache point:	Faut-il te le redire, Oreste est devant toi, Il ne se cache point:
frape.	frappe.
Tyran, c’eſt moy.	Tyran, c'est moi.
C’eſt moy, qui devoré d’une noble furie, Venois pour t’enlever & tes Dieux, & ta vie;	C'est moi, qui dévoré d'une noble furie, Venais pour t'enlever et tes Dieux, et ta vie;
Et qui pour aſſouvir ces tranſports immortels, Irois percer ton cœur juſques ſur les Autels:	Et qui pour assouvir ces transports immortels, Irois percer ton cœur jusques sur les Autels:
Si tu veux t’obſtiner dans ton erreur extrême, Aprés un tel aveu ne t’en prend qu’à toy-même.	Si tu veux t'obstiner dans ton erreur extrême, Après un tel aveu ne t'en prend qu'à toi-même.
ORESTE.	ORÊTE.
Admire d’un grand cœur les nobles mouvemens:	Admire d'un grand cœur les nobles mouvements:
Connois la verité dans ſes empreſſemens!	Connais la vérité dans ses empressements!
Dépoüillé quelque temps des tranſports de ta rage, Voy juſqu’où l'amitié porte un noble courage.	Dépouillé quelque temps des transports de ta rage, Vois jusqu'où l'amitié porte un noble courage.
Il veut, preuant mon nom, blaſphemant contre S’attirer une mort qui ne cherche que moy:	Il veut, preuant mon nom, blasphémant contre S'attirer une mort qui ne cherche que moi:
Mais ſi tu veux joüir du fruit de ta vangeance, Dans ton aveuglement diſcerne l’innocence.	Mais si tu veux jouir du fruit de ta vengeance, Dans ton aveuglément discerne l'innocence.
Sur le coupable ſeul fais tomber ta fureur, Ou des Dieux offencez crains le foudre vangeur:	Sur le coupable seul fais tomber ta fureur, Ou des Dieux offensez crains le foudre vengeur:
THOAS.	THOAS.
Ah!	Ah!
c’eſt trop devant moy reſpirer l’impoſture, Madame, il faut vanger noſtre commune injure:	c'est trop devant moi respirer l'imposture, Madame, il faut venger notre commune injure:
Qu’à l’inſtant voſtre bras les immole tous deux:	Qu'à l'instant votre bras les immole tous deux:
Mon rang, ma ſeureté l’exigent:	Mon rang, ma sûreté l'exigent:
je le veux.	je le veux.
Que de leurs Dieux aprés la fureur ſe déploye, La Tauride verra ce qu’on vit devant.	Que de leurs Dieux après la fureur se déploie, La Tauride verra ce qu'on vit devant.
Troye.	Troie.
Ils ſe partageront en ce commun effroy Et s’il en eſt pour eux, il en ſera pour moy.	Ils se partageront en ce commun effroi Et s'il en est pour eux, il en sera pour moi.
IPHIGENIE.	IPHIGENIE.
Quel es-tu pour tenir ce ſuperbe langage?	Quel es-tu pour tenir ce superbe langage?
Oſes-tu commander à qui tu dois hommage?	Oses-tu commander à qui tu dois hommage?
Plus haut que ton pouvoir n’éleves point ta voix, C’eſt du Ciel, non de toy, que j’écoûte les loix, Luy ſeul peut prononcer des decrets legitimes;	Plus haut que ton pouvoir n'élèves point ta voix, C'est du Ciel, non de toi, que j'écoute les lois, Lui seul peut prononcer des décrets légitimes;
je vais, pour deeſuen du fort de ces victimes, Sçavoir ſes volontez, atbitre entre-eux & toy.	je vais, pour deesuen du fort de ces victimes, Savoir ses volontés, atbitre entre-eux et toi.
Thoas, attens mon ordre:	Thoas, attends mon ordre:
& vous Grecs, ſuivezmoy.	et vous Grecs, suivezmoi.
SCENE VIII.	SCÈNE VIII.
THOAS, HIDASPE, ANTHENOR, TAXIS.	THOAS, HIDASPE, ANTHENOR, TAXIS.
AS.	AS.
Ui ſuis je?	Oui suis -je?
eſt-ce à Thoas qu’un tel diſcours s’adreſſe;	est-ce à Thoas qu'un tel discours s'adresse;
A quoy m’expoſes-tu malheureuſe rendreſſe?	À quoi m'exposes-tu malheureuse rendresse?
Je puis tout, & malgré mon nom, ma dignité, Une ſimple Preſtreſſe étonne ma fierté.	Je puis tout, et malgré mon nom, ma dignité, Une simple Prêtresse étonne ma fierté.
Quand d’un ton plein d’audace elle oſe me confondre, Ma bouche eſt interdite, & ne ſçait que répondre.	Quand d'un ton plein d'audace elle ose me confondre, Ma bouche est interdite, et ne sait que répondre.
Ah!	Ah!
c’eſt trop abuſer de mes indignes feux, Ses Grecs ſont mes captifs, que le Ciel ſoit pour eux:	c'est trop abuser de mes indignes feux, Ses Grecs sont mes captifs, que le Ciel soit pour eux:
Ils recevront demain la mort qu'elle rerarde;	Ils recevront demain la mort qu'elle rerarde;
Taxis autour du Temple allez ranger ma Garde 3.	Taxis autour du Temple allez ranger ma Garde 3.
Obſervez avec elle un ſilence profond, Veillez mes ennemis, voſtre teſte en répond.	Observez avec elle un silence profond, Veillez mes ennemis, votre tête en répond.
SCLNE IA.	SCLNE IA.
THOAS, ANTHENOR, HIDASPE.	THOAS, ANTHÉNOR, HIDASPE.
HIDASPE.	HIDASPE.
Voſtre ſeureté cet ordre eſt neceſſaire, A Seigneur;	Votre sûreté cet ordre est nécessaire, A Seigneur;
mais d’un peril qu’on ne peut plus vous taite, V.	mais d'un péril qu'on ne peut plus vous taite, V.
ſtre Peuple allarmé ſemble vous menacer:	stre Peuple alarmé semble vous menacer:
Il ctoit pour Thomiris devoir s’intereſſer:	Il ctait pour Thomiris devoir s'intéresser:
De ſon départ futtif il ſe fait une injure, Il y veut mettre obſtacle, il s’aſſcmnble, il murmure, Et ſi l'on ne s’oppoſe à cette émotion.	De son départ futtif il se fait une injure, Il y veut mettre obstacle, il s'asscennble, il murmure, Et si l'on ne s'oppose à cette émotion.
Elle pourra cauſer quelque ſedition.	Elle pourra causer quelque sédition.
OAS.	ÔAS.
Non, il ebeïra.	Non, il ebeïra.
Je ſuis ſeut de ſou zele, Anthenor, la iincelle à mes vœux moins rebelle.	Je suis seut de sou zèle, Anthenor, la jincelle à mes vœux moins rebelle.
Ne verta point l’hymen qui trahit ſon eſpoir, Vous pouvez de ma patr le luy faire ſçavoir.	Ne verta point l'hymen qui trahit son espoir, Vous pouvez de ma patr le lui faire sçavoir.
Allez.	Allez.
ANTHENOR.	ANTHENOR.
Juſques au Temple, où ſon tele s’empreſſe D’allet pour ſon voyage implorer la Deeſſe, Je vais de vos bontez, Seigneur, luy faire patt.	Jusqu' au Temple, où son télé s'empresse D'allét pour son voyage implorer la Déesse, Je vais de vos bontés, Seigneur, lui faire patt.
Dites-luy que ſur tout elle ſonge au départ.	Dites-lui que sur tout elle songe au départ.
SENDA.	SENDA.
THOAS, HIDASPE.	THOAS, HIDASPE.
THOAS.	THOAS.
T toy, favoriſé de l'ombre & du ſilence, L Au peuple adroitenient dérobe ſa preſence;	 Toi, favorisé de l'ombre et du silence, L Au peuple adraitenient dérobe sa présence;
J’atteudray tou retour dans cet appartement.	J'atteudrai tou retour dans cet appartement.
Va, cours tout préparer pour ſon embarquement,.	Va, cours tout préparer pour son embarquement,.
Et ſonge, en ménageant cette importante ſuite, Que mon ſort cette nuit dépend de ta conduite.	Et songe, en ménageant cette importante suite, Que mon sort cette nuit dépend de ta conduite.
APeRE SCENE PREMIERE.	APPPRE SCÈNE PREMIÈRE.
THOAS ſeul.	THOAS seul.
IEUX!	JEUX!
que l’impatience eſt un cruel tourment ?	que l'impatience est un cruel tourment ?
Qu’Hidaſpe répond mal à mon empreſſement!	Qu'Hidaspe répond mal à mon empressement!
Hidaſpe à mes tegards ne paroît point encore, Luy qui dans ce Palais doit devancer l’Aurore?	Hidaspe à mes tegards ne paraît point encore, Lui qui dans ce Palais doit devancer l'Aurore?
Qu'une nuit inquiete eſt cruelle à paſſer?	Qu'une nuit inquiète est cruelle à passer?
Que de triſtes objets viennent la traverſer?	Que de tristes objets viennent la traverser?
Mon cœur, dans l’embarras qui le trouble, l’agiCherche ce qui le fuit, trouve ce qu’il évite.	Mon cœur, dans l'embarras qui le trouble, l'agiCherche ce qui le fuit, trouve ce qu'il évite.
La crainte, la terreur me ſuivent en tous lieux,.	La crainte, la terreur me suivent en tous lieux,.
Et tou jours le ſommeil ſe refuié à mes yeux.	Et tou jours le sommeil se refuyé à mes yeux.
Mortels ambitieux dont les deſirs rapides N’ont que vos paſſions pour objets, & pour guides Qui de l’amour du Trône avidement épris, N’enviſagez la gloire & l’honneur qu’à ce prix, Et qui des plus grands noms enveloppant vos crimes, Ne ſuivez, pour regner, que d’injuſtes maxime:	Mortels ambitieux dont les désirs rapides N'ont que vos passions pour objets, et pour guides Qui de l'amour du Trône avidement épris, N'envisagés la gloire et l'honneur qu'à ce prix, Et qui des plus grands noms enveloppant vos crimes, Ne suivez, pour régner, que d'injustes maxime:
Temeraires tremblez, & craignez d’obtenir Ce qui vous eſt donné des Dieux pour vous punir.	Temeraires tremblez, et craignez d'obtenir Ce qui vous est donné des Dieux pour vous punir.
Le ſeul empreſſement d’éloigner la Princeſſe, De perdre mes captifs, d’épouſer la Preſtreſſe, Tyranniſe mon ame avec tant de pouvoir, Que je n’écoûte plus ny raiſon, ny devoir.	Le seul empressement d'éloigner la Princesse, De perdre mes captifs, d'épouser la Prêtresse, Tyrannise mon âme avec tant de pouvoir, Que je n'écoute plus ni ainsi, ni devoir.
Mille fâcheux objets roulent dans ma penſée.	Mille fâcheux objets roulent dans ma pensée.
Hidaſpe ne vient point, la nuit eſt avancée.	Hidaspe ne vient point, la nuit est avancée.
Qui le retient?	Qui le retient?
Le peuple à mon ordre oppoſé, Pour en troubler l’effet eſt-il aſſez oſe?	Le peuple à mon ordre opposé, Pour en troubler l'effet est-il assez ose?
Je ne puis demeurer dans cette incertitude, Elle augmente ma peine & mon inquietude.	Je ne puis demeurer dans cette incertitude, Elle augmente ma peine et mon inquiétude.
Allons.	Allons.
Mais je le vois.	Mais je le vois.
SCENE II.	SCÈNE II.
THOAS, HIDASPE.	THOAS, HIDASPE.
PAr quels retardemens.	PAr quels retardements.
HIDASPE.	HIDASPE.
Tout ſuecede, Seigneur, à vos empreſſemens.	Tout succède, Seigneur, à vos empressements.
La Princeſſe livrée au pouvoir du Sarmate, Ne mettra plus d’obſtacle à l’hymen qui vous flate, Ie l’ay trouvée au Temple, où du pied de l’Autel Eile s’eſt impoſée un exil éteruel, Muette, & pour cacher ou ſa honte, ou ſa rage, De ſes voiles baiſſez ſe couvrant le viſage, Elle a ſuivy mes pas ſans contrainte, & ſans btuit, Par de ſecret, détours dans l’ombre de la nuit.	La Princesse livrée au pouvoir du Sarmate, Ne mettra plus d'obstacle à l'hymen qui vous flatte, Je l'ai trouvée au Temple, où du pied de l'Autel Eile s'est imposée un exil éteruel, Muette, et pour cacher ou sa honte, ou sa rage, De ses voiles baissez se couvrant le visage, Elle a suivi mes pas sans contrainte, et sans btuit, Par de secret, détours dans l'ombre de la nuit.
Alors l’Ambaſſadeur, & ſa nombreuſe ſuite, Que menoit Anthenor, chargé de leur conduite;	Alors l'Ambassadeur, et sa nombreuse suite, Que menait Anthénor, chargé de leur conduite;
Traverſant un grand Peuple aſſemblé ſut le Port, Sans obſtacle, avec elle, ont paſſe ſur leur bord.	Traversant un grand Peuple assemblé sut le Port, Sans obstacle, avec elle, ont passe sur leur bord.
Le Pilote attentif au devoir qui le guide, N’attend plus que le vent pour quitter la Tauride:	Le Pilote attentif au devoir qui le guide, N'attend plus que le vent pour quitter la Tauride:
Mais craignaut que le jour qui va tout déclarer, Ne retrouvaſt un peuple ardent à murmurer:	Mais craignaut que le jour qui va tout déclarer, Ne retrouvât un peuple ardent à murmurer:
J’ay laiſſé ſur le port une garde fidelle, Et vous viens annoncer cette heureuſe nouvelle.	J'ai laissé sur le port une garde fidèle, Et vous viens annoncer cette heureuse nouvelle.
H Ah!	H Ah!
je reſpire, Hidaſpe, & j’en rends grace aux Dieux, Thomiris ſuſpendoit mon pouvoir en ces lieux.	je respire, Hidaspe, et j'en rends grâce aux Dieux, Thomiris suspendait mon pouvoir en ces lieux.
Quoy que fortifié de la toute-puiſſance, Mon genie étonné trembloit en ſa preſence:	Quoi que fortifié de la toute-puissance, Mon génie étonné tremblait en sa présence:
Mais retourne au rivage, & ne quitte ſon bord, Qu’aprés que le Vaiſſeau ſera party du port;	Mais retourne au rivage, et ne quitte son bord, Qu'après que le Vaisseau sera parti du port;
Qu’aprés que tu l’auras long-temps perdu de veuë:	Qu'après que tu l'auras longtemps perdu de vue:
Et ſi dans ſa fureur le peuple continuë, Montrant pour ſa Princeſſe un front ſeditieux, N’épargne point le ſang des plus audacieux.	Et si dans sa fureur le peuple continue, Montrant pour sa Princesse un front séditieux, N'épargne point le sang des plus audacieux.
va, cours, te dis-je.	va, cours, te dis-je.
Et moy pour rompre ceobſtacle, Ie m’en vais l’actirer par un autre ſpectacle	Et moi pour rompre ceobstacle, Je m'en vais l'actirer par un autre spectacle
SCENE III.	SCÈNE III.
THOAS ſeul.	THOAS seul.
Eja l'Aſtre naiſſant, qui luit ſur mes deſſeins, Du Temple, en m’éclairant, me montre les  Mirs.	Éjà l'Astre naissant, qui luit sur mes desseins, Du Temple, en m'éclairant, me montre les Mirs.
Aairono y contmeneer certe neureuſe journée:	Avairono y contèneer certe neureuse journée:
Et par un ſacriſſee, & par un hymenée, Mes peuples attirez par cette nouveauté Viendront.	Et par un sacrissee, et par un hyménée, Mes peuples attirez par cette nouveauté Viendront.
Mais que me veut Taxis épouvanté?	Mais que me veut Taxis épouvanté?
CENE IV.	CÈNE IV.
211eAbs PAXIS.	211eAbs PAXIS.
TAXIS.	TAXIS.
H!	H!
Seigneur, quels malheurs menacent vôAtte Empire!	Seigneur, quels malheurs menacent vôAtte Empire!
Quels troubles.	Quels troubles.
Sans horteur je ne puis vous le dite.	Sans horteur je ne puis vous le dite.
THOAS.	THOAS.
Dieux!	Dieux!
qu’ay-je à craindre encor, Taxis, explique toy.	qu'ai-je à craindre encor, Taxis, explique toi.
TAXIS.	TAXIS.
Je rempliſſois les ſoins confiez à ma foy.	Je remplissais les soins confiés à ma foi.
Voſtre garde fidelle imitoit mon exemple, Le ſilence avec nous regnoit autour du Temple, Déja la nuit obſcure alloit ſe diſſiper, Quand un biuit étonnant eſt venu nous fraper.	Votre garde fidèle imitait mon exemple, Le silence avec nous régnait autour du Temple, Déjà la nuit obscure allait se dissiper, Quand un biuit étonnant est venu nous frapper.
On n’entend que des cris dans l’enceinte ſacrée, J’en approche en tremblant, on m’en livre l’entrée.	On n'entend que des cris dans l'enceinte sacrée, J'en approche en tremblant, on m'en livre l'entrée.
Quels ſpectacles, grands Dieux!	Quels spectacles, grands Dieux!
que d’affreuſes douleuis!	que d'affreuses douleuis!
Les Miniitres contus, les Preſtreſſes en pleurs, Ont triſtement fait voir à mon ame abatuë, Qu'on avoit de Diane enlevé la ſtatuë.	Les Miniitres contus, les Prêtresses en pleurs, Ont tristement fait voir à mon âme abattue, Qu'on avait de Diane enlevé la statue.
enit THOAS.	enit THOAS.
TAXIS.	TAXIS.
Accuſant les Grecs de cette impieté, A les chercher par tout mon zele m’a porté.	Accusant les Grecs de cette impiété, À les chercher par tout mon zèle m'a porté.
yuhaieutendre en vain par toue ieur nom funeſte, Aucun ne me répond quand je demande Oreſte.	yuhaitendre en vain par toue jeur nom funeste, Aucun ne me répond quand je demande Oreste.
IOAS.	JOAS.
Peut-on donner azile à ces noirs attentats?	Peut-on donner asile à ces noirs attentats?
On menace mes jours, mon Peuple, mes Etats, Et mon lâche ennemy trouve qui le protege.	On menace mes jours, mon Peuple, mes États, Et mon lâche ennemi trouve qui le prote.
Quer montre dals ma Cout.	Quer montre dals ma Cout.
.	.
TAXIS.	TAXIS.
Seigneur, vous le diray-je, Une impie, une ingrate, une fiere beauté, Se vante, ſans fremir, de cette impieré:	Seigneur, vous le dirai-je, Une impie, une ingrate, une fière beauté, Se vante, sans frémir, de cette impieré:
Elle oſe aux yeux de tous avoüer ſon offenſe.	Elle ose aux yeux de tous avouer son offense.
Dépoüillé du reſpect qu’on doit à ſa naiſſance;	Dépouillé du respect qu'on doit à sa naissance;
Je viens de l’amener dans voſtre apartement.	Je viens de l'amener dans votre appartement.
THOAS.	THOAS.
Quelle entre!	Quelle entre!
A ce forfait commis impunément, Je connois ton audace, infidelle Preſtreſſe:	À ce forfait commis impunément, Je connais ton audace, infidèle Prêtresse:
Mais tu mourras.	Mais tu mourras.
Que vois-je?	Que vois-je?
ò Ciel!	§ Ciel!
c’eſt la Princeſſe.	c'est la Princesse.
oGf lviy .	oGf lui .
THOAS, THOMIRIS, TAXIS.	THOAS, THOMIRIS, TAXIS.
Gardes.	Gardes.
THOMIRIS.	THOMIRIS.
y perfide, c’eſt moy, diſſipe ton erreut, OC'eſt moy qui viens joüir de ta vaine fureur:	y perfide, c'est moi, dissipe ton erreut, OC'est moi qui viens jouir de ta vaine fureur:
C’eſt moy, c’eſt cette main que les Dieux ont choiſie Pour former le tiſſu des malheurs de ta vie,	C'est moi, c'est cette main que les Dieux ont choisie Pour former le tissu des malheurs de ta vie,
AOAS.	ÀOAS.
Hidaſpe.	Hidaspe.
Ah:	Ah:
malheureux, tu m’as manqué de	malheureux, tu m'as manqué de
THOMIRIS.	THOMIRIS.
Si tu te vois trahy n’en accuſe que toy.	Si tu te vois trahi n'en accuse que toi.
Ton artificieuſe & coupable conduite, Ta lâche politique à dérober ma fuite, Ce ſont les mêmes traits que j’ay ſçû ménager, Pour te percer le cœur, Tyran, & me vanger.	Ton artificieuse et coupable conduite, Ta lâche politique à dérober ma fuite, Ce sont les mêmes traits que j'ai su ménager, Pour te percer le cœur, Tyran, et me venger.
Aprés t’eſtre emparé du Sceptre de ta Reine, Aprés que tes mépris ont merité ma haine, As-tu pû concevoir que ſoûmiſe à ta voix, J’accepterois ailleurs un Empire à ton choix.	Après -t-être emparé du Sceptre de ta Reine, Après que tes mépris ont mérité ma haine, As-tu pu concevoir que soumise à ta voix, J'accepterais ailleurs un Empire à ton choix.
Et que de tes forfaits volontaire victime, Je te ferois du mien poſſeſſeur legitime.	Et que de tes forfaits volontaire victime, Je te ferais du mien possesseur légitime.
Cette nuit, ptofitant de ſon obſeurité, Sur mon départ ta haine avoit déja conté.	Cette nuit, ptofitant de son obseurité, Sur mon départ ta haine avait déjà conté.
Mais loin de conſentir à ta coupable envie, Je l’avois conſacrée à t’arracher la vie.	Mais loin de consentir à ta coupable envie, Je l'avais consacrée à t'arracher la vie.
Lors qu’au Temple, où ma bouche alloit ſe déclarer, Un plus noble tranſport eſt venu m’inſpirer.	Lors qu'au Temple, où ma bouche allait se déclarer, Un plus noble transport est venu m'inspirer.
Ton ſang, que l’on devoit m’offrit en ſacrifice;	Ton sang, que l'on devait m'offrit en sacrifice;
Ne me paroiſſoit point un aſſez grand ſupplice.	Ne me paraissait point un assez grand supplice.
Pour t’en faire un, Tyran, où ton cœur inhumain, Sentiſt du deſeſpoir le plus eruel venin.	Pour t'en faire un, Tyran, où ton cœur inhumain, Sentît du désespoir le plus ervel venin.
Leur ouvrant juſqu’au port une ſecrete iſſuë, Entre les mains des Grecs j’ay remis la Statuë.	Leur ouvrant jusqu'au port une secrète issue, Entre les mains des Grecs j'ai remis la Statue.
J’ay d’une même ardeur, m’oppoſant à tes vœux, Arfache la Preſtreſſe à tes indignes feux.	J'ai d'une même ardeur, m'opposant à tes vœux, Arfache la Prêtresse à tes indignes feux.
J’ay fait que ſous mon nom, favoriſant ſa fuite, Au Vaiſſeau du Sarmate Hidaſpe l’a conduite, Et qu'ene vag iajant la Couromie & ta foy, Vivre ſous d’autres Cieux pour un autre que toy	J'ai fait que sous mon nom, favorisant sa fuite, Au Vaisseau du Sarmate Hidaspe l'a conduite, Et qu'ène vag ajant la Couromie et ta foi, Vivre sous d'autres Cieux pour un autre que toi
THOAS.	THOAS.
Gardes, qu’on la pourſuive, allez.	Gardes, qu'on la poursuive, allez.
Ettoy, barbare.	Ettoi, barbare.
THOMIRIS.	THOMIRIS.
Penſes-te que pour toy le deſtin ſe declare?	Penses-te que pour toi le destin se déclare?
Penſes-tu que le Ciel, qui conduit ſes deſſeins, D’Argos en ta faveur, luy ferme les chemins.	Penses-tu que le Ciel, qui conduit ses desseins, D'Argos en ta faveur, quelque ferme les chemins.
Fille d’Agamemnon, c’eſt cette Iphigenie, Que l’on croit en Aulide avoir perdu la vie.	Fille d'Agamemnon, c'est cette Iphigénie, Que l'on croit en Aulide avoir perdu la vie.
De ces Grecs que j’arrache à ton ardent courroux:	De ces Grecs que j'arrache à ton ardent courroux:
L’un eſt ſon frere Oreſte, & l’autre eſt ſon époux.	L'un est son frère Oreste, et l'autre est son époux.
L’hymen les a liez d’une chaîne éternelle:	L'hymen les a liés d'une chaîne éternelle:
Je viens d’eſtre témoin de leur foy mutuelle.	Je viens d'être témoin de leur foi mutuelle.
Quel Quel ſpectacle à mes yeux!	Quel Quel spectacle à mes yeux!
quel triomphe pour moy!	quel triomphe pour moi!
D'avoir forgé les trairs qui me vangent de toy.	D'avoir forgé les trairs qui me vengent de toi.
Le Ciel, en ce grand jour, met le comble à ma De tourmens infinis tu vas eſtre la proye.	Le Ciel, en ce grand jour, met le comble à ma De tourments infinis tu vas être la proie.
Sur ce Trône où ton cœur ſe croyoit affermy, le te verray toujours craindre ton ennemy;	Sur ce Trône où ton cœur se croyait affermi, le te verrai toujours craindre ton ennemi;
Je verray le venin de la plus noire envie;	Je verrai le venin de la plus noire envie;
Te montrer ton Rival aimé d’Iphigenie, Et dans ton cœur jaloux répandre les remorde, Qu’Oteſte en s’enfuyant t’a laiſſé ſur ces bords.	Te montrer ton Rival aimé d'Iphigénie, Et dans ton cœur jaloux répandre les remorde, Qu'Oteste en s'enfuyant t'a laissé sur ces bords.
Ouy, ce m’eſt un plaiſir qui flatte ma diſgrace, D’avoir ſçû par mes ſoins couſondre ton audace.	Oui, ce m'est un plaisir qui flatte ma disgrâce, D'avoir su par mes soins cousondre ton audace.
THOAS.	THOAS.
Ah!	Ah!
je t’épargneray ce funeſte plaiſir.	je t'épargnerai ce funeste plaisir.
Si bien-toſt dans l’horreur dont je me ſens ſaiſirs Je ne vois ces caprifs partis ſous ta conduite, Ta mort ſera le prix d’avoir tramé leur fuite.	Si bientôt dans l'horreur dont je me sens saisirs Je ne vois ces caprifs partis sous ta conduite, Ta mort sera le prix d'avoir tramé leur fuite.
THOMIRIS.	THOMIRIS.
Aprés ce que j’ay fait je brave ta fureur, Je ne crains rien cruel, frape.	Après ce que j'ai fait je brave ta fureur, Je ne crains rien cruel, frappe.
SCENE VI.	SCÈNE VI.
THOAS,THOMIRIS, TAXIS.	THOAS,THOMIRIS, TAXIS.
VEnez, Seigneur, Le jour nous a fait voir la troupe fugitive, Qu’un orage imprévû retient prés de la rive.	VEnez, Seigneur, Le jour nous a fait voir la troupe fugitive, Qu'un orage imprévu retient près de la rive.
Hïdaſpe par les vents les voyant arreſtez, Entoure leur Vaiſſeau, les prend de tous côrez:	Haidaspe par les vents les voyant arrêtés, Entoure leur Vaisseau, les prend de tous côrez:
Mais le peuple à grand cris ſuſpend vôtre vangeance, Le perfide Anthenor embraſſe leur deffence, A leur perte prochaine il prétend s’oppoſer, Et ſans voſtre preſence ils peuvent tout oſer.	Mais le peuple à grand cris suspend votre vengeance, Le perfide Anthénor embrasse leur défense, À leur perte prochaine il prétend s'opposer, Et sans votre présence ils peuvent tout oser.
THOAS.	THOAS.
Ah!	Ah!
courons dans leur ſang éteindre leur furie, Et toy dans ce Palais garde mon ennemie.	courons dans leur sang éteindre leur furie, Et toi dans ce Palais garde mon ennemie.
DOEND VII.	DOND VII.
THOMIRIS, TAXIS.	THOMIRIS, TAXIS.
THOMIRIS.	THOMIRIS.
Ieux!	Jeux!
eſt-ce l’innocence à qui vous en vouD ia:	est-ce l'innocence à qui vous en vouD ja:
Aprés tant de ſermens & de droits violez, N’ayant dans ſes tranſports aucune retenuë, Parmy tant de forfaits commis à voſtre veuë, Un Tyran trouve-t’il la faveur des deſtins, Contre des malheureux qui vous levent les mains.	Après tant de serments et de droits violés, N'ayant dans ses transports aucune retenue, Parmi tant de forfaits commis à notre vue, Un Tyran trouve-t-il la faveur des destins, Contre des malheureux qui vous levent les mains.
Ah!	Ah!
courons empêcher le ſort qui les menace.	courons empêcher le sort qui les menace.
Courcuorr?	Courcuorr?
Q uej inaieureux d’où te viens cette audace?	 uej injaieureux d'où te viens cette audace?
Oſes-tu m’arreſter, & ton zele obſtiné.	Oses-tu m'arrêter, et ton zèle obstiné.
TAXIS.	TAXIS.
.	.
Madame, vous ſçavez ce qui m’eſt ordonné.	Madame, vous savez ce qui m'est ordonné.
THOMIRIS.	THOMIRIS.
Ne te ſouvient-il plus du ſang qui m’a fait naître.	Ne te souvient-il plus du sang qui m'a fait naître.
En faveur de Thoas m’oſes-tu méconnoître.	En faveur de Thoas m'oses-tu méconnaître.
Attens-tu que ſur moy ſon bras enſanglanté Vienue.	Attends-tu que sur moi son bras ensanglanté Vienve.
Mais c’eſt-trop craindre en cette extrémité.	Mais c'est-trop craindre en cette extrémité.
Tu me retiens en vain, ta lâche obéïſſance.	Tu me retiens en vain, ta lâche obéissance.
SCENE VIII.	SCÈNE VIII.
ACIOMTRCIO, PAIIe, ERINE.	ACIOMTRCIO, PAIe, ÉRINE.
ERINE.	ÉRINE.
Adame, de Thoas fuyez la violence.	Adame, de Thoas fuyez la violence.
THOMIRIS.	THOMIRIS.
De ces Grecs malheureux, Erine eſt-il vainqueur?	De ces Grecs malheureux, Erine est-il vainqueur?
Les a-t-on immolez à ſa noire fureur?	Les a-t-on immolés à sa noire fureur?
ERINE.	ÉRINE.
Ne me demandez rien.	Ne me demandez rien.
Etonnée, interdite, Je ne puis revenir du trouble qui m’agite, Le tumulte, le fer, le deſordre, les cris,, Delcrainte, de terreur glacent tous les eſprits.	Étonnée, interdite, Je ne puis revenir du trouble qui m'agite, Le tumulte, le fer, le désordre, les cris, Delcrainte, de terreur glacent tous les esprits.
Parmy tous ces objets dont mon ame eſt émeuë;	Parmi tous ces objets dont mon âme est émue;
Le Tyran en fureur a ſeul frapé ma veuë;	Le Tyran en fureur a seul frappé ma vue;
con mereplunte m'aran trembler pour vous:	con mèreplunte m'aran trembler pour vous:
Fuyez, fuyez, Madame, évitez ſon courroux.	Fuyez, fuyez, Madame, évitez son courroux.
THOMIRIS.	THOMIRIS.
Que je fuye.	Que je fuie.
Ah!	Ah!
plûtôt courons ſur le rivage, Des Scythes, par ma veuë, animer le courage C’eſt aujourd’huy le Sceptre, ou la mort que j’attens.	plutôt courons sur le rivage, Des Scythes, par ma vue, animer le courage C'est aujourd'hui le Sceptre, ou la mort que j'attends.
ERINEAh!	ERINEAh!
prévénez.	prévénez.
Que dis-je?	Que dis-je?
on vient.	on vient.
Il n’eſt plus temps.	Il n'est plus temps.
SCENE DERNIERE.	SCÈNE DERNIÈRE.
THOMIRIS, ANTHENOR.	THOMIRIS, ANTHENOR.
ERINE.	ÉRINE.
ANTHENOR.	ANTHENOR.
Nl Ous tromphes, mauame, ce le Ciel équitable, A l’innocence enfin s’eſt montré favorable.	Nl Ous tromphes, maume, ce le Ciel équitable, A l'innocence enfin s'est montré favorable.
THOMIRIS.	THOMIRIS.
Dieux!	Dieux!
que viens-je d’entendre, & que me ditesvous?	que viens-je d'entendre, et que me ditesvous?
ANTHENOR.	ANTHENOR.
Que les Dieux hautement ſe déclarent pour nous.	Que les Dieux hautement se déclarent pour nous.
Jamais jour aux mortels ne parut plus funeſte, Et plus propre à marquer la colere celeſte.	Jamais jour aux mortels ne parut plus funeste, Et plus propre à marquer la colère celeste.
On'eut dit que les Dieux contre nous animez, S’oppoſoient aux deſſeins que nous avions formez.	On'eut dit que les Dieux contre nous animés, S'opposaient aux desseins que nous avions formés.
Les flats impetueux, & les vents en futie, Du Sarmate & des Grecs empeſchoient la ſortie.	Les flats impétueux, et les vents en futie, Du Sarmate et des Grecs empêchaient la sortie.
Hidaſpe dans ce trouble informé de leur ſort, S’approche du Vaiſſeau l’atraque avec tranſport, Re demande à grands cris les Grecs, & la Statuë.	Hidaspe dans ce trouble informé de leur sort, S'approche du Vaisseau l'atraque avec transport, Re demande à grands cris les Grecs, et la Statue.
Oreſte fierement ſe preſente à ſa veuë, Au courage du Seythe oppoſe ſa valeur, Il fait face par tout, par tout il eſt vainqueur:	Oreste fièrement se présente à sa vue, Au courage du Seithe oppose sa valeur, Il fait face par tout, par tout il est vainqueur:
J’atrive accompagné d’une eſcorte fidelle, De l’innocence, alors j’embiaſſe la querelle, Le Peuple autour de moy courant de toutes parts, Quand Thoas arrivé ſur le fatai rivage, Aux ſiens épouvantez rameint le courage.	J'atrive accompagné d'une escorte fidèle, De l'innocence, alors j'embjasse la querelle, Le Peuple autour de moi courant de toutes parts, Quand Thoas arrivé sur le fatai rivage, Aux siens épouvantez ramèint le courage.
Dans toute ſon horreur la mort ſe montre à tous Pilade fait tomber Hidaſpe ſous ſes coups.	Dans toute son horreur la mort se montre à tous Pilade fait tomber Hidaspe sous ses coups.
Le l'yran qui du Bord voit ce trépas funeſte, Sans ſonger qui le ſuit s’avanco vers Oreſte, Il le joint;	Le l'iran qui du Bord voit ce trépas funeste, Sans songer qui le suit s'avanco vers Oreste, Il le joint;
mais bien-toſt il a le même ſort, Sous le fer de ce Prince il ex pire.	mais bientôt il a le même sort, Sous le fer de ce Prince il ex ire.
THOMIRIS.	THOMIRIS.
Il eſt mort.	Il est mort.
ANTHENOR.	ANTHENOR.
Ouy, Madame, & la mer juſqu’alors ſoûlevée, De ſon ſang qui s’écoule eſt à peine abreuvée, Que les vens, dans les airs, ne ſont plus déchaînez:	Oui, Madame, et la mer jusqu'alors soulevée, De son sang qui s'écoule est à peine abreuvée, Que les vents, dans les airs, ne sont plus déchaînés:
Les ſlots impetueux ne ſont plus mutinez.	Les slots impétueux ne sont plus mutinés.
Le Ciel devient tranquille,, & les Grecs pleins de gloire, Vont joüir dans Argos du fruit de leur victoiTandis que remontant au rang de vos ayeux, Vous allezcommander dans ces paiſibles lieux, Et qu’un peuple enuemy des ſanglantes maximes Diule de necetontos ordres legitimes.	Le Ciel devient tranquille, et les Grecs pleins de gloire, Vont jouir dans Argos du fruit de leur victoiTandis que remontant au rang de vos aïeux, Vous allezommander dans ces paisibles lieux, Et qu'un peuple envemi des sanglantes maximes Divle de necetontos ordres légitimes.
THOMIRIS.	THOMIRIS.
Ciel!	Ciel!
pour perdre un Tyran quelle eſt ton équiMais allons dans le Temple adorer ſa bonté;	pour perdre un Tyran quelle est ton équiMais allons dans le Temple adorer sa bonté;
Sur là rebellion que ma elemence éclate, Et de noſtre bonheur faiſons parran sarmate.	Sur là rébellion que ma élémence éclate, Et de notre bonheur faisons parran sarmate.
.	.
11 SVES:	11 SUÊ:
niſ f Quand Thoas arrivé ſur le fatai rivage, Aux ſiens épouvantez rameint le courage.	nis f Quand Thoas arrivé sur le fatai rivage, Aux siens épouvantez ramèint le courage.
Dans toute ſon horreur la mort ſe montre à tous Pilade fait tomber Hidaſpe ſous ſes coups.	Dans toute son horreur la mort se montre à tous Pilade fait tomber Hidaspe sous ses coups.
Le l'yran qui du Bord voit ce trépas funeſte, Sans ſonger qui le ſuit s’avanco vers Oreſte, Il le joint;	Le l'iran qui du Bord voit ce trépas funeste, Sans songer qui le suit s'avanco vers Oreste, Il le joint;
mais bien-toſt il a le même ſort, Sous le fer de ce Prince il ex pire.	mais bientôt il a le même sort, Sous le fer de ce Prince il ex ire.
THOMIRIS.	THOMIRIS.
Il eſt mort.	Il est mort.
ANTHENOR.	ANTHENOR.
Ouy, Madame, & la mer juſqu’alors ſoûlevée, De ſon ſang qui s’écoule eſt à peine abreuvée, Que les vens, dans les airs, ne ſont plus déchaînez:	Oui, Madame, et la mer jusqu'alors soulevée, De son sang qui s'écoule est à peine abreuvée, Que les vents, dans les airs, ne sont plus déchaînés:
Les ſlots impetueux ne ſont plus mutinez.	Les slots impétueux ne sont plus mutinés.
Le Ciel devient tranquille,, & les Grecs pleins de gloire, Vont joüir dans Argos du fruit de leur victoiTandis que remontant au rang de vos ayeux, Vous allezcommander dans ces paiſibles lieux, Et qu’un peuple enuemy des ſanglantes maximes Diule de necetontos ordres legitimes.	Le Ciel devient tranquille, et les Grecs pleins de gloire, Vont jouir dans Argos du fruit de leur victoiTandis que remontant au rang de vos aïeux, Vous allezommander dans ces paisibles lieux, Et qu'un peuple envemi des sanglantes maximes Divle de necetontos ordres légitimes.
THOMIRIS.	THOMIRIS.
Ciel!	Ciel!
pour perdre un Tyran quelle eſt ton équiMais allons dans le Temple adorer ſa bonté;	pour perdre un Tyran quelle est ton équiMais allons dans le Temple adorer sa bonté;
Sur là rebellion que ma elemence éclate, Et de noſtre bonheur faiſons parran sarmate.	Sur là rébellion que ma élémence éclate, Et de notre bonheur faisons parran sarmate.
.	.
11 SVES:	11 SUÊ:
niſ f	nis f
