A PARIS, Chez ANTHOINE DE SOMMAVILLE, Au Palais, dans la petite Salle, à l’Eſcu de France.	À PARIS, Chez ANTHOINE DE SOMAVILLE, Au Palais, dans la petite Salle, à l'Écu de France.
M.	M.
DC.	DC.
XXXVI.	XXXVI.
AVEC PRIVILEGE DV ROY.	AVEC PRIVILÈGE DU ROY.
A DV.	À DU.
SOROOEEVN LE COMTE DE TIYI A Pr IRAND-MAISTRE de la Garderobe du Roy, &c.	SOROOEUN LE COMTE DE -TII À Pr RAND-MAÎTRE de la Garderobe du Roi, etc.
3 ONSIEVR.	3 ONSIEUR.
EIIOTRD.	EIIOTRD.
la juſte deffiance que i’ay de mon Eſprit, m’ayt fait iuſques icy redouter l’abord du voſtre, ſi generalement eſtimé de tout le monde;	la juste défiance que j'ai de mon Esprit, m'ait fait jusques ici redouter l'abord du vôtre, si généralement estimé de tout le monde;
ie ne puis toutefois refuſer à ma Celimene, la permiſſion de ſe preſenter à vous, & de vous baizer les mains, en recognoiſſance de la faueur que vous luy aués faite de la loüer de quelque beauté.	Ne ne puis toutefois refuser à ma Celimène, la permission de se présenter à vous, et de vous baizer les mains, en reconnaissance de la faveur que vous lui avez faite de la louer de quelque beauté.
Vn de mes amis à qui vous auez pris la peine de parler d’elle, l’a comblée de tant de gloire, par le rapport qu’il m’en a fait, qu’elle ne peut ſans ingratitude, eſtre ſans reſſentiment;	Un de mes amis à qui vous avez pris la peine de parler d'elle, l'a comblée de tant de gloire, par le rapport qu'il m'en a fait, qu'elle ne peut sans ingratitude, était sans ressentiment;
outre que cét honneur luy venant de vous, luy vient d’vne perſonne dont la renommée a faict vn pourtraict, qui demande des adorations pour l’original.	outre que cet honneur lui venant de vous, lui vient d'une personne dont la renommée a fait un pourtrait, qui demande des adorations pour l'original.
En effect, il eſt bien certain que la France, cette fameuſe nourrice d’vne ſi belle, & ſi genereuſe Nobleſſe, a porté des hommes qui ſembloient eſtre nés pour la commune honte de tous les autres Royaumes, & pour la gloire du noſtre:	En effet, il est bien certain que la France, cette fameuse nourrice d'une si belle, et si généreuse Noblesse, a porté des hommes qui semblaient être nés pour la commune honte de tous les autres Royaumes, et pour la gloire du vôtre:
mais par quelques efforts que la nature s’y ſoit ſignalée, il faut auoüer.	mais par quelques efforts que la nature s'y soit signalée, il faut auoüer.
d’vne generale confeſſion, qu'elle n’auoit point encor mis en vne ieuneſſe comme la -.	d'une générale confession, qu'elle n'avait point encor mis en une jeunesse comme la -.
voſtre auec de ſi rares qualités du corps, vn eſprit merueilleux, vn iugement admirable, & vn courage grand, au poinct où ces conditions ſont en vous;	votre esprit de si rares qualités du corps, un esprit merveilleux, un jugement admirable, et un courage grand, au point où ces conditions sont en vous;
ſi voſtre modeſtie me permettoit de vous peindre vous meſme, à vous meſme ſur voſtre reputation, ie ſerois mauuais Peintre, ſi ie ne faiſois le plus bel ouurage qu’on ayt encor entrepris;	si votre modestie me permettait de vous peindre vous rendre, à vous même sur votre réputation, quelque serais mauvais Peintre, si personne ne faisais le plus bel ouvrage qu'on ait encor entrepris;
mais ic ceſſe, MONSIEVR, de parler de vous, par la crainte que i’ay de vous déplaire;	mais ic cesse, MONSIEUR, de parler de vous, par la crainte que j'ai de vous déplaire;
ie laiſſe vn ſi bel employ à toutes les bouches de la Cour, & me contente de vous teſmoigner l’incomparable eſtime que ie faits de voſtre merite, par vn mauuais preſent:	ie laisse un si bel emploi à toutes les bouches de la Cour, et me contente de vous témoigner l'incomparable estime que sans faits de votre mérite, par un mauvais présent:
mais le plus cher que ie vous puis faire, puis qu’en effect ſoit par vne inclination aueugle, ſoit par quelque ſorte de raiſon, i'ay touſiours tenu Celimene pour la moins mauuaiſe de mes œuures, ſi vous la voyez auec ces grandes lumieres dont on vante voſtre eſprit, il eſt certain qu’elle vous deſplaira, & que vous trouueriez des taclies lur le piue oouu viſage de France;	mais le plus cher que je vous puis faire, puis qu'en effet soit par un inclination aveugle, soit par quelque sorte de raison, j'ai toujours tenu Celimène pour la moins mauvaise de mes œuvres, si vous la voyez avec ces grandes lumières dont on vante rendre esprit, il est certain qu'elle vous déplaira, et que vous trouveriez des tacliez lur le pive oou visage de France;
mais traictés la fauorablement:	mais traitez la favorablement:
Voyez-la, & ne la conſiderés pas.	Voyez-la, et ne la considérez pas.
Enfin, MONSIEVR, laiſſés-luy l’aduantage que les fauſſes beautés tirent d’vn faux iour;	Enfin, MONSIEUR, laissez-lui l'avantage que les fausses beautés tirent d'un faux jour;
c’eſt de cette ſorte qu’elle vous pourra plaite, & que les deuoirs de la fille pourront obtenir au pere la permiilion de ſe dire,	c'est de cette sorte qu'elle vous pourra plaite, et que les devoirs de la fille pourront obtenir au père la permiilion de se dire,
Voſtre tres-humble, & tres-obeyſſont ſeruiteur, ROTROV.	Votre très-humble, et très-obeyssont serviteur, ROTROU.
M A VS VI SARONRUVI Sur ſa Celimene.	M A VS VI SARONRUI Sur sa Celimène.
ELEGIE.	ÉLÉGIE.
&OTROV, ta Celimene à des vers ſi charl D mants, Qu'on ne les ſçauroit voir ſans des rauiſſemants, Et ſans dire tout haut qu’on ne peut ſans manie Refuſer les honneurs qu’on doit à ton genie.	ETOTROU, ta Celimène à des vers si charl D ans, Qu'on ne les saurait voir sans des ravissemants, Et sans dire tout haut qu'on ne peut sans manie Refuser les honneurs qu'on doit à ton génie.
Mais d’où me peut venir cette temerité, De loüer par mes vers vn ſujet ſi vanté?	Mais d'où me peut venir cette témérité, De louer par mes vers un sujet si vanté?
Suis-ie pas ridicule, & plus que vain, de croire, Qu’il ſe puiſſe adiouſter quelque choſe à ta gloire?	Suis-je pas ridicule, et plus que vain, de croire, Qu'il se puisse ajouter quelque chose à ta gloire?
Elle t’eſt trop aquiſe, & tu te dois vanter, Que le plus meſdiſant ne te la peut oſter.	Elle t'est trop aquise, et tu te dois vanter, Que le plus médisant ne te la peut ôter.
Ne blaſme point pourtant vn ſi mauuais ouurage, Vne mouche ſert bien à parer vn viſage, L’eſclat de tes beaux vers preZ des miens fera voir Que le blanc paroiſt mieux, auprez, d’vn peu de noir;	Ne blâme point pourtant si mauuais ouurage, mouche sert bien parer visage, éclat de tes beaux vers preZ des miens fera voir Que Ne blâme point pou, auprez, un si mauvais ouvrage,
Les plus viues couleurs ſe releuent par l’ombre, Et le iour brille plus apres vne nuict ſombre.	Les plus vives couleurs se relèvent par l'ombre, Et le jour brille plus après une nuit sombre.
Eſtime-les amy, daigne en dire du bien, Puiſque ce ſont des fruicts de ton doux entretien;	Estime-les ami, daigne en dire du bien, Puisque ce sont des fruits de ton doux entretien;
Depuis ſept ans entiers, ROTROV, que ie te hante, Ma Muſe veut pareſtre, & fait la ſuffiſante, Et croit aſſeurément que le plus hebeté, Ne peut eſtre ignorant apres t'auoir hanté.	Depuis sept ans entiers, ROTROU, que ie te hante, Ma Muse veut paraître, et fait la suffisante, Et croit assurément que le plus hébeté, Ne peut -être ignorant après t'avoir hanté.
Mais pour hanter les grands on n’en eſt pas plus riche;	Mais pour hanter les grands on n'en est pas plus riche;
Ce Dieu qui te cherit enuers tout autre eſt chiche:	Ce Dieu qui te chérit envers tout autre est chiche:
S’il donne à quelques-uns;	S'il donne à quelques-uns;
il leur fait des preſens Qui ſeruent ſeulement à leur troubler les ſens.	il leur fait des présents Qui servent seulement à leur troubler les sens.
Mais ie voy qu’à toy ſeul Phœbus faitdes careſſes;	Mais ici vois qu'à toi seul Phœbus faites caresses;
D’vne main liberale il t’offre ſes richeſſes, Et ne reſeruant rien, il te donne le fruict, Des plus rares treſors que l’Helicon produit;	D'une main libérale il t'offre ses richesses, Et ne réservant rien, il te donne le fruit, Des plus rares trésors que l'Hélicon produit;
Cela fait Ccher Amy) que le monde te priſe, Qu’on adore tes vers, qu’vn chacun te courtiſe, Et qu’ils ont ſur mes ſens aquis un tel pouuoir, Que ie ne ſçaurois eſtre vn moment ſans te voir.	Cela fait Ccher Ami) que le monde te prise, Qu'on adore tes vers, qu'un chacun te courtise, Et qu'ils ont sur mes sens aquis un tel pendant, Que on ne saurais chang un moment sans te voir.
Ie ne hante que ceux de qui te me propoſe, Par vn docte entretien d’apprendre quelque choſe;	Je ne hante que ceux de qui te me propose, Par un docte entretien d'apprendre quelque chose;
Mais pour les ignorants, ie les ſçay deſdaigner, Ie fais gloire d’apprendre, & non pas d’enſeigner;	Mais pour les ignorants, ie les sais dédaigner, Je fais gloire d'apprendre, et non pas d'enseigner;
Si comme toy i’eſtois au bout de la carriere, I'auroi pitié de ceux que ie verrois derriere:	Si comme toi j'étais au bout de la carrière, I' auroi pitié de ceux que ie derrais derrière:
Et pouuant approcher de ta capacité, Ie les aßiſterois par generoſité;	Et pouvant approcher de ta capacité, Je les assisterais par générosité;
C’eſt ainſi, cher ROTROV, que ton ſecours i’implore, Inſtruits moy, ie te prie, aux choſes que i'ignore;	C'est ainsi, cher ROTROU, que ton secours j'implore, Instruits moi, Seigneur te prie, aux choses que j'ignore;
Monſtre moy la façon de polir vn eſcrit, Et de faire à chacun admirer mon eſprit.	Montre moi la façon de polir un écrit, Et de faire à chacun admirer mon esprit.
De tenir tout le monde enchaiſné par l’oreille:	De tenir tout le monde enchaîné par l'oreille:
D’vne choſe commune, en faire vne merueille:	D'une chose commune, en faire une merveille:
De rendre comme toy les hommes aſſeruis;	De rendre comme toi les hommes asservis;
Et de rauir les ſens, comme tu les rauis.	Et de ravir les sens, comme tu les ravis.
Mais quand tu taſcherois à releuer ma veine, Tu n’y ferois que perdre, & ton temps, & ta peine, Et tout ne ſeruiroit qu’a faire ſeulement Cognoiſtre plus à clair mon peu de iugement.	Mais quand tu tâcherais à relever ma veine, Tu n'y ferais que perdre, et ton temps, et ta peine, Et tout ne servirait qu'a faire seulement Cognoistre plus à clair mon peu de jugement.
Mais tous n’ont pas le droit de monter ſur Parnaſſe:	Mais tous n'ont pas le droit de monter sur Parnasse:
Penſe-t’on que les Dieux facent à tous la grace, De les rendre ſçauans en cet art merueilleux?	Pense-t-on que les Dieux fassent à tous la grâce, De les rendre Savants en cet art merveilleux?
Il est benin aux vns, aux autres perilleux.	Il est bénin aux uns, aux autres périlleux.
Moy ie ſuis de ceux-là que la docte Deeſſe, Autant comme elle peut, traite auecque rudeſſe:	Mo ie suis de ceux-là que la docte Déesse, Autant comme elle peut, traite auecque rudesse:
Et ſi pas vn de ceux qui reſpirent le iour, Pour les hommes d’eſprit n’eut iamais plus d’amour;	Et si pas un de ceux qui respirent le jour, Pour les hommes d'esprit n'eut jamais plus d'amour;
Ie hay les ignorants, dont l’aueugle manie Les porte à meſpriſer l’art diuin d’Uranie.	Je hais les ignorants, dont l'aveugle manie Les porte à mépriser l'art divin d'Uranie.
approuue fort l’honneur qu’aux bons Poetes l’on rend, Et ie ne penſe point paſſer pour ignorant.	approuve fort l'honneur qu'aux bons Poètes l'on rend, Et personne ne pense point passer pour ignorant.
Puiſque i’ay bien l’eſprit de ſçauoir recognoiſtre, Ceux qui ſont eſtimez, & ceux qui doiuent l’eſtre;	Puisque j'ai bien l'esprit de savoir reconnaître, Ceux qui sont estimez, et ceux qui doivent l'être;
Touts les esprits communs me ſont indifferents.	Touts les esprits communs me sont indifférents.
Quand ie voy la vertu loger parmyles grands, Lors ie leur fais la Cour, ie priſe leurs careſſes, I'eſtime leur eſprit, & non pas leurs richeſſes;	Quand ici vois la vertu loger parmiles grands, Lors ie leur fais la Cour, était prise leurs caresses, J'estime leur esprit, et non pas leurs richesses;
Si l’on me voit par tout adorer comme vn Dieu, Ce fameux Cardinal, ce docte RICHELIEV, Croy que ie ne fais point la Cour à ſa fortune.	Si l'on me voit par tout adorer comme un Dieu, Ce fameux Cardinal, ce docte RICHELIEU, Crois que je ne fais point la Cour à sa fortune.
Ses rares qualitez, ſa vertu non commune, Et ſon eſprit diuin, ont pour moy des appas, Que ſa grandeur, ſa pourpre, & ſa faueur n’ont pas.	Ses rares qualités, sa vertu non commune, Et son esprit divin, ont pour moi des appas, Que sa grandeur, sa pourpre, et sa faveur n'ont pas.
C’eſt par là ſeulement, ROTROV, que ie veux croire, Que ie dois meriter quelque eſpece de gloire, Qu’on ne doit point du tout meſpriſer mon humeur, Puis qu’on me voit cherir vn ſi docte rimeur;	C'est par là seulement, ROTROU, que sans veux croire, Que je dois mériter quelque espèce de gloire, Qu'on ne doit point du tout mépriser mon humeur, Puis qu'on me voit chérir un si docte rimeur;
Et ie te veux iurer quoy que tu ſçaches dire, Que ie croy mieux valoir depuis que ie t’admire.	Et grande te veux jurer quoi que tu saches dire, Que ie crois mieux valoir depuis que ie t'admire.
Ie penſe eſtre ſçauant pouir ſçauoir t’eſtimer, Et que la Vertu giſt ſeulement à t’aymer, A priſer ton merite, & que c’eſt trop pour eſtre Au delà du commun, de te pouuoir cognoiſtre.	Je pense être savant pouir savoir t'estimer, Et que la Vertu gît seulement à t'aimer, A priser ton mérite, et que c'est trop pour être Au delà du commun, de te pouvoir connaître.
Si les Dieux de la terre eſtoyent faicts comme moy, On te feroit la Cour plus qu’on ne fait au Roy.	Si les Dieux de la terre étaient faits comme moi, On te ferait la Cour plus qu'on ne fait au Roi.
Pour moy ie recognoy l’excez de ma miſere,	Pour moi ici reconnais l'excès de ma misère,
De m’auoir tellement mis l’esprit de trauers, Qu’il ne puiſſe enfanter le moindre de tes vers.	De m'avoir tellement mis l'esprit de travers, Qu'il ne puisse enfanter le moindre de tes vers.
Que me ſert mal-heureux, de prendre tant de peine.	Que me sert malheureux, de prendre tant de peine.
Pour taſcher d’imiter & ton ſtile, & ta veine?	Pour tâcher d'imiter et ton style, et ta veine?
Si ie ſuis mauuais ſinge, & ſi ie ne puis pas Te ſuiure que de loing, ny marcher ſur tes pas, C’eſt de mon peu d’eſprit vne preuue etſſeZ ample.	Si tu suis mauvais singe, et si ici ne puis pas Te suivre que de loin, ni marcher sur tes pas, C'est de mon peu d'esprit une preuve etssez ample.
De n’eſtre pas ſçauant aupres d’vn tel exemple.	De n'être pas savant auprès d'un tel exemple.
Pour moy ſi i’eſtois Roy ie voudrois faire vn vœu, De ne donner iamais l’Ordre du cordon bleu, Qu'à ceux que le merite & la valeur appelle A poſſeder le prix d’vne gloire immortelle.	Pour moi si j'étais Roy ie voudrais faire un vœu, De ne donner jamais l'Ordre du cordon bleu, Qu'à ceux que le mérite et la valeur appelle A posséder le prix d'une gloire immortelle.
Pour me plaire il faudroit que leur eſclat vint d’eux, Sans tirer leur splendeur des faits de leurs a yeux.	Pour me plaire il faudrait que leur éclat vint d'eux, Sans tirer leur splendeur des faits de leurs a yeux.
Si quelqu’vn d’eux s’eſt veu ſignalé dans l’hiſtoire, Les ſiens heritent-ils pour cela de ſa gloire?	Si quelqu'un d'eux s'est vu signalé dans l'histoire, Les siens héritent-ils pour cela de sa gloire?
Ccœur, Quelqu’vn d’eux quoy qu’il ſoit ſans adreſſe & ſans Croira deuoir paſſer pour homme de valeur;	Ccœur, Quelqu’ avait d'eux quoi qu'il soit sans adresse et sans Croira devoir passer pour homme de valeur;
L’inſolent penſera par vn orgueil extreſme, Meriter que l’honneur en reuienne à luy-meſme:	L'insolent pensera par un orgueil extrême, Mériter que l'honneur en revienne à lui-même:
Et fera quoy qu’il ait le courage abatu, Paſſer cette valeur pour ſa propre vertu.	Et fera quoi qu'il ait le courage abattu, Passer cette valeur pour sa propre vertu.
Tout de meſme le mal nous eſt hereditaire, Le Fils porte ſouuent l’iniquité du Pere, Et s’il eſt vertueux, il n'a rien merité, Parce que ſon a yeul ne l’aura pas eſté.	Tout de même le mal nous est héréditaire, Le Fils porte souvent l'iniquité du Père, Et s'il est vertueux, il n'a rien mérité, Parce que son a yeul ne l'aura pas été.
C’eſt un tres grand defaut de ce ſiecle où nous ſommes, On n'y fait plus d’eſtat du merite des hommes, Et de tous les mortels les plus de fectueux, Quand ils ſont opulens ſont aſſez vertueux.	C'est un très grand défaut de ce siècle où nous sommes, On n'y fait plus d'état du mérite des hommes, Et de tous les mortels les plus de fectueux, Quand ils sont opulents sont assez vertueux.
On les eſtimera, ſi leur effronterie Leur fait mal à propos dire vne raillerie:	On les estimera, si leur effronterie Leur fait mal à propos dire une raillerie:
Ou l’eſprit le mieux fait paſſera pour vn ſot, On ſe rira de luy s’il dit quelque bon mot, S’il n’eſt reſpectueux, s’il ne baiſſe la veuë, Si deuant vn brutal il n'a la teſte nuë;	Ou l'esprit le mieux fait passera pour un sot, On se rira de même s'il dit quelque bon mot, S'il n'est respectueux, s'il ne baisse la vue, Si devant un brutal il n'a la tête nue;
S’il ne rend des deuoirs bien plus abjets encor, Bre fcomme les Hebreux s’il n’adore vn veau d’or;	S'il ne rend des devoirs bien plus abjets encor, Bre fcomme les Hebreux s'il n'adore un veau d'or;
Un qui peut-eſtre aura moins que luy de naiſſance;	Un qui peut-être aura moins que lui de naissance;
Dont le pere aura mis les mains dans ſa finance, Et qui n’auroit de ſoy dequoy ſe ſignaler, Si ſon pere ſe fuſt ompeſché de voler.	Dont le père aura mis les mains dans sa finance, Et qui n'aurait de soi dequoy se signaler, Si son père se fût ompesché de voler.
Ie confeſſe pour moy que i’ay trop de courage, Pour iouër ayſément ce laſche perſonnage.	Je confesse pour moi que j'ai trop de courage, Pour jouer aisément ce lâche personnage.
Ie ne ſçaurois ſouffrir qu’vn me donne la loy, Qui ſans cette faueur ſeroit moindre que moy:	Je ne saurais souffrir qu'une me donne la loi, Qui sans cette faveur serait moindre que moi:
Mais quoy, dans le tracas de la Cour où nous ſommes, Tous ſe rendent ſujets au caprice des hommes.	Mais quoi, dans le tracas de la Cour où nous sommes, Tous se rendent sujets au caprice des hommes.
Il faut eſtre d’accord auec ce qui leur plaiſt, Publier vn ſujet plus laid, ou beau qu’il n’eſt;	Il faut être d'accord auec La qui leur plaît, Publier un sujet plus laid, ou beau qu'il n'est;
Vanter le plus ſouuent vne extreſme ſotiſe, Et blaſmer un diſcours encor qu’il ſoit de miſe.	Vanter le plus souvent une extrême sottise, Et blâmer un discours encor qu'il soit de mise.
Si celuy qui l’a dit n’eſt pas au gré de tous, Ou ſi pour le loüer on fait quelque ialoux, Dont la condition eſt plus con ſiderable;	Si celui qui l'a dit n'est pas au gré de tous, Ou si pour le louer on fait quelque jaloux, Dont la condition est plus con siderable;
Dy moy, n’eſt-ce pas eſtre en ce point miſerable, D’auoir l’eſprit ſeruile, & geſné tellement, Qu'on ne puiſſe parler ſelon ſon ſentiment?	Dis -moi, n'est-ce pas être en ce point misérable, D'avoir l'esprit servile, et gêné tellement, Qu'on ne puisse parler selon son sentiment?
Apres cela vantez, les biens de la fortune, Son aueugle faueur me faſche, & m'importune:	Après cela vantez, les biens de la fortune, Son aveugle faveur me fâche, et m'importune:
Toute aymable qu’elle eſt, i’aymerois mieux mourir, Que de faire iamais vn pas pour l’acquerir.	Toute aimable qu'elle est, j'aimerais mieux mourir, Que de faire jamais un pas pour l'acquérir.
Elle eſt tou ſiours tardiue, & le plus ſouuent vaine:	Elle est tou siours tardive, et le plus souvent vaine:
Nous languiſſons apres vne attente incertaine, Car la mort nous ſurprend, & nous nous tourmentons, Pour ce qui ne nous vient que lors que nous partons.	Nous languissons après une attente incertaine, Car la mort nous surprend, et nous nous tourmentons, Pour ce qui ne nous vient que lors que nous partons.
C’eſt lors que ſa rigueur nous eſt bien plus ſenſible:	C'est lors que sa rigueur nous est bien plus sensible:
Pluſieurs trauailleront autant qu’il eſt poßible, Qui n’attraperont rien;	Plusieurs travailleront autant qu'il est possible, Qui n'attraperont rien;
aux autres ſeulement, Les biens, & les honneurs arriuent en dormant;	aux autres seulement, Les biens, et les honneurs arrivent en dormant;
Ie voy que c'eſt par tout que regne l’iniuſtice, La Fortune & Pnuvnes pont pujorc un caprice:	Je vois que c'est par tout que règne l'injustice, La Fortune et Pnuvnes pont pujorc un caprice:
L'vne faict à pluſieurs ſouuent perdre les pas, Eſleuant aux honneurs ceux qui n’y penſent pas.	L'une fait à plusieurs souvent perdre les pas, Élevant aux honneurs ceux qui n'y pensent pas.
Et de meſme ie voy qu'Apollon & Minerue Donnent à qui leur plaiſt la faconde & la verue, De ſniants leurs faueurs à mille eſprits diuers, Qui ſe laſſent en vain a vouloir fatre vn vers.	Et de même ici vois qu'Apollon et Minerve Donnent à qui leur plaît la faconde et la verve, De sniants leurs faveurs à mille esprits divers, Qui se lassent en vain a vouloir fatre un vers.
Phœbus eſt trop exact, & l’on voit la fortune Eſtre à ſes courtiſans encore plus commune.	Phœbus est trop exact, et l'on voit la fortune Être à ses courtisans encore plus commune.
Nous voyons à milliers les hommes proſperer, Et quelques-vns d’entre eux n’ont rien à deſirer;	Nous voyons à milliers les hommes prospérer, Et quelques-uns d'entre eux n'ont rien à désirer;
Mais vn esprit parfait eſt extremement rare, Apollon eſt cent fois de ſes biens plus auare, Que n’eſt cette inconſtante, & l’on voit auiourd’hu y Que pluſieurs ſont contents, plus d’elle que de luy.	Mais un esprit parfait est extrêmement rare, Apollon est cent fois de ses biens plus avare, Que n'est cette inconstante, et l'on voit aujourd'hu y Que plusieurs sont contents, plus d'elle que de lui.
Au moins ay-je eu l’honneur dés mon apprentiſſage, D’auoir eu de ſes mains vn tres bel aduantage:	Au moins ai-je eu l'honneur dès mon apprentissage, D'avoir eu de ses mains un très bel avantage:
Pouuoit-elle me mettre en vn plus digne lieu, Qu’en me faiſant cognoiſtre à ce grãd RICHELIEVT Pouuoit-elle ſe rendre à mes vœux plus propice, Que de m’auoir iugé digne de ſon ſeruice?	Pouvait-elle me mettre en un plus digne lieu, Qu'en me faisant connaître à ce grand RICHÉLIEUT Pouvait-elle se rendre à mes vœux plus propice, Que de m'avoir jugé digne de son service?
Si donc i’ay receu d'elle vn ſi bon traitement, Que ne dois-je esperer d’vn tel commencement?	Si donc j'ai reçu d'elle un si bon traitement, Que ne dois-je espérer d'un tel commencement?
I'ay du ſujet aſſez d’eſtre ſatisfait d’elle, D'eſleuer à ſon nom vne gloire immortelle.	J'ai du sujet assez d'être satisfait d'elle, D'élever à son nom une gloire immortelle.
Mais non pas à Phœbus:	Mais non pas à Phœbus:
tous les iours dans Parit, Ie hante ſes mignons, ie voy ſes fauoris:	tous les jours dans Parit, Je hante ses mignons, Elle vois ses favoris:
Et pour les imiter nuict & iour ie trauaille, Et ſi ie ne puis rien imaginer qui vaille;	Et pour les imiter nuit et iour jour travaille, Et si tu ne puis rien imaginer qui vaille;
Tant plus i’y prens de peine, & tant plus ie cognoy, Que toutes les neuf ſœurs ſont ingrates pour moy;	Tant plus j'y prends de peine, et tant plus ie cognoy, Que toutes les neuf sœurs sont ingrates pour moi;
Et ſi ie ſuis ſi vain, que ie n’ay cognoiſſance Ny de mon peu d’esprit, ny de mon ignorance,	Et si ici suis si vain, que ainsi n'ai connaissance Ni de mon peu d'esprit, notre de mon ignorance,
Que quand ie ly tes vers, ROTROV, qui ſont ſi doux, Que ie ne puis celer que ie n'en ſois ialoux.	Que quand ici li tes vers, ROTROU, qui sont si doux, Que personne ne puis celer que ie n'en sois jaloux.
Quand ie les oy pourtant tonner ſur vn theatre, Ie ſuis rauy d’en voir tout le peuple idolatre, Je priſe ſeulement de tous les ſpectateurs, Ceux qui de tes heaux vers ſont les admirateurs;	Quand ici les ois pourtant tonner sur un théâtre, Je suis ravi d'en voir tout le peuple idolatre, Je prise seulement de tous les spectateurs, Ceux qui de tes heaux vers sont les admirateurs;
Meſme tes enuieux ſçauent que ie m’irrite, Quand i’entends froidement parler de tonmer ite:	Même tes envieux savent que je m'irrite, Quand j'entends froidement parler de tonmer ite:
Et l’eſtime qu'en font tes amis plus parfaits, Eſt encore au deſſous de celle que i’en faits.	Et l'estime qu'en font tes amis plus parfaits, Est encore au dessous de celle que j'en faits.
Vn ouurage poly, de quelque main qu’il vienne, Ne me peut contenter s’il ne ſort de la tienne.	Un ouvrage poli, de quelque main qu'il vienne, Ne me peut contenter s'il ne sort de la tienne.
Ce que mille autres font, me ſemble impertinent, Le diſcours plat & rude, & le vers mal ſonnant.	Ce que mille autres font, me semble impertinent, Le discours plat et rude, et le vers mal sonnant.
C’eſt pourquoy, cher amy, cont ente mon enuie, Trauaille inceſſamment, le peuple t’y conuie, Puis qu’en ſi peu de temps tu fais tant de beaux vers, Tis respondras vn jour des momens que tu pers:	C'est pourquoi, cher ami, cont ente mon envie, Travaille incessamment, le peuple t'y convie, Puis qu'en si peu de temps tu fais tant de beaux vers, Tis répondras un jour des moments que tu perds:
Les employant ailleurs, ce ſont, tu le dois croire, Auiunt de purs iartins que in fais a lagloire;	Les employant ailleurs, ce sont, tu le dois croire, Aviunt de purs jartins que in fais a lagloire;
Ceſſant de trauailler, c’eſt vn illuſtre enfant, Que tu mettrois au iour que tu vas eſtouffant.	Cessant de travailler, c'est un illustre enfant, Que tu mettrais au jour que tu vas étouffant.
Rauy touſiours nos ſens du doux fruict de tes veilles Et ne te laſſe point de faire des merueilles.	Ravi toujours nos sens du doux fruit de tes veilles Et ne te lasse point de faire des merveilles.
Tu feras plus pour toy, car cette charité	Tu feras plus pour toi, car cette charité
C IN	Ç IN
ACTEVRS.	ACTEURS.
FEL CIL ALIDOR.	FEL CIL ALIDOR.
FLORIDAN.	FLORIDAN.
LE LACQVAIS.	LE LACQUAIS.
Niepce d’Orante.	Niepce d'Orante.
Tante de rſorante.	Tante de rsorante.
Seruiteur de Florante.	Serviteur de Florante.
Sœur de Celimene.	Sœur de Celimène.
ſeruiteur de Celimene.	serviteur de Celimène.
ieruiteur de Felicie.	jerviteur de Félicie.
Florante en habit d’homme.	Florante en habit d'homme.
LA CAVAMEVA, MEDIE	LA CAVAMEUA, MEDIE
HCTE TREMIER.	HCTE TREMIER.
SCENE PREMIERE.	SCÈNE PREMIÈRE.
FLORANTE.	FLORANTE.
ORANTE ſa tante.	ORANTE sa tante.
FLORANTE.	FLORANTE.
OVS gouſteZ bien icy les douceurs de la vie, Souffrez, que ie vous parle auec vn peu d’enuie;	OUS goûtez bien ici les douceurs de la vie, Souffrez, que je vous parle avec un peu d'envie;
Que ces lieux ſont charmans!	Que ces lieux sont charmants!
au prix de vos maiſons, Les villes à mes yeux ne ſont que des priſons.	au prix de vos maisons, Les villes à mes yeux ne sont que des prisons.
A Icy, tout m’entretient, tout me rit, tout m’enchante, La diuerſité meſme à mes yeux ſe preſente, Et de quelque coſté que ie dreſſe mes pas, La ſolitude, en ſoy, ne ſe rencontre pas.	À Ici, tout m'entretient, tout me rit, tout m'enchante, La diversité même à mes yeux se présente, Et de quelque côté que je dresse mes pas, La solitude, en soi, ne se rencontre pas.
La ſeule peur que i'ay de vous eſtre importune, Modere les douceurs de ma bonne fortune.	La seule peur que j'ai de vous être importune, Molère les douceurs de ma bonne fortune.
Ma Tante, Vous pourrez par vn mot ſeulemens Borner cette viſite, & mon contentement:	Ma Tante, Vous pourrez par un mot seulements Borner cette visite, et mon contentement:
Car ſi vous eſperez de la voir terminée, dan auoir la deſſus la ſenſence donnée, Vous voulez qu'vn captif eſchappé de ſes fers, De ſoy-meſme s'expoſe aux maux qu’il a ſouffers.	Car si vous espérez de la voir terminée, dan avoir la dessus la sensence donnée, Vous voulez qu'un captif échappé de ses fers, De soi-même s'expose aux maux qu'il a soufferts.
ORANTE.	ORANTE.
Ie commence à vous voir, & vous n’auez, qu’à peins Ceßé de reſpirer le doux air de la Seine.	Je commence à vous voir, et vous n'avez, qu'à peins Cessé de respirer le doux air de la Seine.
Vous arriuez,, ma fille, en cét heureux ſejour, Et vous pouuez, desjà me parler du retour:	Vous arrivez, ma fille, en cet heureux séjour, Et vous pouvez, déjà me parler du retour:
Non ſi ce lieu vous plaiſt, n'en habitez point d’autre, Et prolongez mon bien en prolongeant le voſtre.	Non si ce lieu vous plaît, n'en habitez point d'autre, Et prolongez mon bien en prolongeant le vôtre.
Mon inclinaſion ſecondera vos vœux, Et touſiours vos parens voudront ce que ie veux.	Mon inclinasion secondera vos vœux, Et toujours vos parents voudront ce que donne veux.
Ce lieu, comme Paris, a toutes ſes delices, La Cour n’a rien de plus, que des ſoins & des vices;	Ce lieu, comme Paris, a toutes ses délices, La Cour n'a rien de plus, que des soins et des vices;
Il fournit aux eſprits des diuertiſſemens, On y voit des beauteZ, on y voit des amants.	Il fournit aux esprits des divertissements, y On voit des beautés, on y voit des amants.
On entend cõme ailleurs des plaintes de leurs bouches, Et rien n’eſt inſenſible ences bois que les ſouches, Entre-eux vn jeune Amant vous plaira deſſus tous:	On entend comme ailleurs des plaintes de leurs bouches, Et rien n'est insensible ences bois que les souches, Entre-eux un jeune Amant vous plaira dessus tous:
Car ſonhumeur eſt telle, & ſon esprit ſi doux, Que ſi vous n’enuieZ l’honneur de ſa Maiſtreſſe, ſleſt bien mal-ayſé qu'vn autre object vous bleſſe.	Car sonhumeur est telle, et son esprit si doux, Que si vous n'enviez l'honneur de sa Maîtresse, slest bien mal-aysé qu'un autre object vous blesse.
Pourquoy rougiſſeZ-vous?	Pourquoi rougissez-vous?
FLORANTE.	FLORANTE.
Ce deffaut indecent, Paroiſt ſans mon adueu ſur ce front innocent.	Ce défaut indécent, Paraît sans mon aveu sur ce front innocent.
Ie rougis, quoy qu’on die, & quoy qu'on me propoſe, Sans en pouuoir moy-meſme imaginer la cauſe.	Je rougis, quoi qu'on die, et quoi qu'on me propose, Sans en pouvoir moi-même imaginer la cause.
ORANTE.	ORANTE.
Vous la ſçauez pourtant;	Vous la sçauez pourtant;
c’eſt que iuſqu’à ce jour, On ne vous a parleny a Amant, ny d Amour;	c'est que jusqu'à ce jour, On ne vous a parleni a Amant, ni d Amour;
Vous ignorez, ces noms, & dans cette innocence, Le diſcours que ie faicts vous trouble, & vous offence.	Vous ignorez, ces noms, et dans cette innocence, Le discours que je faits vous trouble, et vous offense.
FLORANTE.	FLORANTE.
Que n'eſt-il vray, Filandre?	Que n'est-il vrai, Filandre?
ORANTE.	ORANTE.
Hauſſez vn peu la voix.	Haussez un peu la voix.
ELORANTE.	ÉLORANTE.
Je dy qu’il fait beau voir l’épaiſſeur de ce bois, A ij Et ces oyſeaux diuers dont la douce muſique dajoeron pespiit le pina Mhetantondae,	Je dis qu'il fait beau voir l'épaisseur de ce bois, A j à ces oiseaux divers dont la douce musique dajoeron pespiit le pina Mhetantondae,
ORANTE.	ORANTE.
O Dieux qu’elle eſt ruſée!	Ô Dieux qu'elle est rusée!
il eſt vray que leurs chants Rendent Paris jaloux de la douceur des champs.	il est vrai que leurs chants Rendent Paris jaloux de la douceur des champs.
Außi mille Amoureux, en cette ſolitude Viennent perdre leurs ſoings, & leur inquietude!	Aussi mille Amoureux, en cette solitude Viennent perdre leurs soings, et leur inquiétude!
Ges lieux ont chaque jour de nouueaux habitans, Ils yriennent faſchez, & J’y treuuent contens.	Ges lieux ont chaque jour de nouveaux habitants, Ils yriennent fâchés, et J'y trouvent contents.
Les cœurs ſont enchanteZ de l’air qu’on y respire, Chacun y faict l’amour, peu de monde y ſouspire.	Les cœurs sont enchanteZ de l'air qu'on y respire, Chacun y fait l'amour, peu de monde y soupire.
Ce Dieu de tous ſes traicts y choiſit les meilleurs, Ileſt Roy parmy nous, il eſt tyran ailleurs.	Ce Dieu de tous ses traits y choisit les meilleurs, Ilest Roi parmi nous, il est tyran ailleurs.
Mais entre les Amants, qui viennent ſur ces riues, Aux doux chants des oyſeaux, joindre leurs voix pleintiues.	Mais entre les Amants, qui viennent sur ces rives, Aux doux chants des oiseaux, joindre leurs voix pleintiues.
Filandre, vn Caualier, de qui les qualitez Ont du Ciel & du Sort les efforts limitez.	Filandre, un Cavalier, de qui les qualités Ont du Ciel et du Sort les efforts limités.
FLORANTE.	FLORANTE.
Comment le nommez-vous?	Comment le nommez-vous?
LORANTE tout bas.	LORANTE tout bas.
.	.
Ole perfide!	Ole perfide!
A	À
ORANTE.	ORANTE.
Touſiours triſte, & penſif, & touſiours l’œil humide Rend tous les cœurs atteints d’amour, & de prtié, Si le Cielles a faicts capables d’amitié.	Toujours triste, et pensif, et toujours l'œil humide Rend tous les cœurs atteints d'amour, et de prtié, Si le Cielles a faits capables d'amitié.
La plus forte froideur, cede à ſon eloquence, Et contre ſes eſcrits vne ame eſt ſans deffence, I'en liray quelques-vns, Eſcoutez;	La plus forte froideur, cède à son éloquence, Et contre ses écrits une âme est sans défense, J'en lirai quelques-uns, Écoutez;
FLORANTE.	FLORANTE.
O malheur!	Ô malheur!
ORANTE.	ORANTE.
Son viſage à ces mots a changé de couleur.	Son visage à ces mots a changé de couleur.
FLORANTE toutba On m'a pris mes papiers.	FLORANTE toutba On m'a pris mes papiers.
14 8	14 8
Il eſt vray.	Il est vrai.
ORANTE lit.	ORANTE lit.
Adorable Maiſtreſſe,	Adorable Maîtresse,
FLORANTE.	FLORANTE.
C’eſt à vous que cêt eſcrit s’adreſſe D.	C'est à vous que cet écrit s'adresse D.
A	À
ORANTE.	ORANTE.
Non, vous l’allez apprendre --	Non, vous l'allez apprendre --
Eettre de Fiſandre, à Florante.	Éettre de Fisandre, à Florante.
ORANTE la lit.	ORANTE la lit.
Dorable Maiſtreſſe, EXIl eſt vray que la Cour, Offre aux yeux mille objets d’amour;	Dorable Maîtresse, EXIl est vrai que la Cour, Offre aux yeux mille objets d'amour;
Mais l’extreſme triſteſſe Que j’ay de ton eſloignement, Ferme les miens ou les dément, Rien ne touche mon ame,  eli laaull deu e paay Rien ne me plaiſt que tes appas.	Mais l'extrême tristesse Que j'ai de ton éloignement, Ferme les miens ou les dément, Rien ne touche mon âme, elle laaull du e aï Rien ne me plaît que tes appas.
Tu partages ma flamme, Partage mon humeur auſſi Et vy, comme ie fais icy.	Tu partages ma flamme, Partage mon humeur aussi Et vis, comme tu fais ici.
FILANDRE.	FILANDRE.
Elle continuë.	Elle continue.
A-t’il bien exprimé la douleur qui le preſſe?	A-t-il bien exprimé la douleur qui le presse?
Et ſçait-il bien toucher le cœur d’vne Maiſtreſſe?	Et sçait-il bien toucher le cœur d'une Maîtresse?
FLORANTE.	FLORANTE.
Si bien, que ce perfide eſt le ſeul qui luy plaiſt, Et qu'elle l’ayme encor, tout vollage qu'il eſt, Tous les jours ſes eſcrits luy font verſer des larmes, Et l’ingrat porte ailleurs ſon amour, & ſes charmes.	Si bien, que ce perfide est le seul qui lui plaît, Et qu'elle l'aime encor, tout vollage qu'il est, Tous les jours ses écrits ses font verser des larmes, Et l'ingrat porte ailleurs son amour, et ses charmes.
ORANTE.	ORANTE.
Vous ſçauez donc ſon nom?	Vous savez donc son nom?
FLORANTE.	FLORANTE.
Uous le ſçauez außi;	Uous le savez aussi;
Las, ie n’ay point deſſein de cacher mon ſoucy.	Las, Seigneur n'ai point dessein de cacher mon souci.
Ie vous dois confeſſer le mal qui me poſſede;	Je vous dois confesser le mal qui me possède;
Ie ſçay qu’il faut parler pour trouuér du remede.	Je sais qu'il faut parler pour trouver du remède.
Et c’eſt l’intention de ce cœur deſolé;	Et c'est l'intention de ce cœur désolé;
Ie ne me taiſois pas, mes yeux vous ont parlé.	Je ne me tais pas, mes yeux vous ont parlé.
Mon mala ſur mon front eſcrit ſa violence, Vous ne pouuez qu’à tort condamner mon ſilence.	Mon mala sur mon front écrit sa violence, Vous ne pouvez qu'à tort condamner mon silence.
Il eſt vray que Filandre a ce cœur enflammé;	Il est vrai que Filandre à ce cœur enflammé;
I'ayme, ie le confeſſe, hé qui n’a pas aymé?	J'aime, Madame le confesse, hé qui n'a pas aimé?
I'ay reſiſté long-temps à cette ardeur ſecrette Et mon intention n'a pas faict ma desfaicte, La force du vaincœur, excuſe le vaincu, Ie cognois maintenant l’erreur où i’ay veſcu;	J'ai résisté longtemps à cette ardeur secrète Et mon intention n'a pas fait ma défaite, La force du vaincœur, excuse le vaincu, Je connais maintenant l'erreur où j'ai vécu;
Ie croyois que l’Amour n’eſtoit qu’vne chymere, Que l’esprit ſe forgeoit pour ſe laiſſer desfaire:	Je croyais que l'Amour n'était qu'une chimère, Que l'esprit se forgeait pour se laisser défaire:
Que l’eſtre de ce Dieu conſiſtoit en pourtraicts, Ie ne craignois alors, ny ſon arc, ny ſes traicts.	Que l'être de ce Dieu consistait en pourtraits, Je ne craignais alors, toujours son arc, Seigneur ses traits.
Et lors que ie voyois mes compagnes atteintes, Ie blaſmois leurs ſouſpirs, & i’accuſois leurs pleintes.	Et lors que je voyais mes compagnes atteintes, Je blasmois leurs soupirs, et j'accusais leurs pleintes.
Mais i’ignorois le mal qui m'eſtoit deſtiné, I’authoriſe à preſent ce que i’ay condamné.	Mais j'ignorais le mal qui m'était destiné, J'autorise à présent ce que j'ai condamné.
Ie croy qu’on me doit pleindre, & que ſans injuſtice, La plus froide ne peut accuſer mon caprice.	Je crois qu'on me doit pleindre, et que sans injustice, La plus froide ne peut accuser mon caprice.
Dneux:	Dneux:
comvien te peraron, en perdant-ces eſerus, Qui vous les a baillez, & qui me les a pris?	comvien te peraron, en perdant-ces erus, Qui vous les a baillez, et qui me les a pris?
ORANTE.	ORANTE.
Moy-meſme en vos habits, quand vous fuſtes couchée;	Moi-même en vos habits, quand vous fûtes couchée;
Et c.	Et ç.
eſt où i’ay cogneu, qu'Amour vous a touchée.	est où j'ai connu, qu'Amour vous a touchée.
Certes ie fais eſtat de voſtre eſlection, On ne peut condamner cette inclination.	Certes ie fais état de votre élection, On ne peut condamner cette inclination.
Filandre, eſt d’vne humeur & d’vn esprit aymable, Et ſa condition à la voſtre eſt ſortable.	Filandre, est d'une humeur et d'un esprit aimable, Et sa condition à la vôtre est sortable.
Il merite beaucoup:	Il mérite beaucoup:
mais en peu de diſcours, Contez-moy de vos vœux la naiſſance & le cours.	mais en peu de discours, Comptez-moi de vos vœux la naissance et le cours.
FLORANTE.	FLORANTE.
En vn bal dont Tirſis honoroit Liſimene, Ie vis, & i’admiray, cét autheur de ma peine.	En un bal dont Tirsis honorait Lisimène, Je vis, et j'admirai, cet auteur de ma peine.
Il me pleüt Cie dy tout) & ie ne pourrois pas Conterſes complimens, ny figurer ſes pas.	Il me pleüt Cie s tout) et ie ne pourrais pas Conterses compliments, toujours figurer ses pas.
Son adreſſe à dançer n’auoit point de ſeconde, Et ſa grace attiroit les yeux de tout le monde.	Son adresse à dançer n'avait point de seconde, Et sa grâce attirait les yeux de tout le monde.
Il rempliſſoit les cœurs d’ayſe & d’eſtonnement, Et tout l’honneur du bal, fut pour luy ſeulement.	Il remplissait les cœurs d'aise et d'étonnement, Et tout l'honneur du bal, fut pour venir seulement.
L’Amour L’Amour fit naiſtre en luy des ardeurs mutuelles, Il quitta pour le mien, l’entretien des plus belles.	L'Amour L'Amour fit naître en vertu des ardeurs mutuelles, Il quitta pour le mien, l'entretien des plus belles.
Ie ſçay bien qu’il m’aymoit, & ſans preſomption, Je m'aſſeuray depuis de ſon affection.	Je sais bien qu'il m'aimait, et sans présomption, Je m'assurai depuis de son affection.
Ses diſcours n'eſtoient pas mon plus ſeur teſmoignage, Ses moindres actions m’en diſoient dauantage, Sa peine, & ſes deuoirs m’ont confirmé ce poinct, Ses pleurs m'en aſſeuroient, quand ie ne riois point.	Ses discours n'étaient pas mon plus sûr témoignage, Ses moindres actions m'en disaient davantage, Sa peine, et ses devoirs m'ont confirmé ce point, Ses pleurs m'en assuraient, quand je ne riais point.
Et de tous les mortels, c’eſt le plus deteſtable, S’il ne ſentoit alors vne ardeur veritable:	Et de tous les mortels, c'est le plus détestable, S'il ne sentait alors une ardeur véritable:
Mais que c’eſt vn eſprit ſujet au changement:	Mais que c'est un esprit sujet au changement:
Dieux!	Dieux!
il vient, ie le voy.	il vient, Seigneur le vois.
ORANIL.	ORANIL.
CacheZ-vous ſeulement.	Cachez-vous seulement.
Elle ſe cache dertiere des arbres.	Elle se cache dertière des arbres.
SCENE DEVXIESME.	SCÈNE DEUXIÈME.
FILANDRE.	FILANDRE.
ORANTE	ORANTE
FILANDEGE.	FILANDEGE.
V'on void changer ſouuent, L’eſtat de noſtre vie, Touſiours de quelque vent, Sa bonnace eſt ſuiuie, Et l’on void rarement le ſoir, & le matin Dépendre d’vn meſme Deſtin.	V'on voit chang souvent, L'état de notre vie, Toujours de quelque vent, Sa bonnace est suivie, Et l'on voit rarement le soir, et le matin Dépendre d'H mesme Destin.
Ie ſuis heureux vn iour, L’autre ie ſuis en peine, I’ay donné de l’amour, ae doilie de ste deſee.	Je suis heureux un jour, L'autreois suis en peine, J'ai donné de l'amour, ae doilie de site dese.
Florante m’adoroit;	Florante m'adorait;
ie l'adorois außi, Mais i’ayme, & l’on me hait ici.	Je l'adorais aussi, Mais j'aime, et l'on me hait ici.
Dbuueuuujorouuojeu, O uien-heureuſe hayne!	Dbuueuuujorouuojeu, Ô uien-heureuse haine!
Si ie touche à la fin le cœur de Celimene.	Si ici touche à la fin le cœur de Celimène.
La peine & les efforts de l’acquiſition, Sont vn doux ſouuenir, en la poſſeßion.	La peine et les efforts de l'acquisition, Sont un doux souvenir, en la possession.
Il continuë.	Il continue.
ORANTE l’abordant.	ORANTE l'abordant.
Qui terend ſi penſif?	Qui terend si pensif?
RILANDRE.	RILANDRE.
Vne ingratte Maiſtreſſe;	Une ingrate Maîtresse;
ORANTE.	ORANTE.
Etouffe tes ſouſpirs, & banny ta triſte Tout ſuccede a tes vœux.	Étouffe tes soupirs, et banni ta triste Tout succède à tes vœux.
ſe,	se,
EILANDRE.	EILANDRE.
O Dieux!	Ô Dieux!
qu’ay-ie entendu?	qu'ai-je entendu?
ORANTE.	ORANTE.
L veut t’accorder le bon-heur qui t’eſt deu;	L veut t'accorder le bonheur qui t'est dev;
Ta Maiſtreſſe aujourd’huy fauoriſe ta flame.	Ta Maîtresse aujourd'hui favorise ta flamme.
FILANDRE.	FILANDRE.
Que i'ay d’impatience;	Que j'ai d'impatience;
auez-vous veu Madame?	avez-vous vu Madame?
ORANTE.	ORANTE.
87.	87.
243 benpiaxentor?	243 benpiaxentor?
FILANDRE.	FILANDRE.
Et quoy?	Et quoi?
ORANTE.	ORANTE.
Certains eſcrits En tut ienon vitntner, & quim ont tout apeus.	Certains écrits En tut ienon vitnter, et qui ont tout apeus.
Ole charmant eſprit, que celuy de Filandre!	Ole charmant esprit, que celui de Filandre!
Qui ne luy cederoit, qui s’en pourroit deffendre?	Qui ne notre céderait, qui s'en pourrait défendre?
Combien ceſte beauté montre de iugement En l’acqui ſition d’vn ſi parfaict Amant!	Combien cette beauté montre de jugement En l'acqui sition d'un si parfait Amant!
FILANDRE.	FILANDRE.
Epargnés mes ennuys, heureuſe, & ſage Orante, Ieſuis trop aſſeuré de ſa haine apparente, Elle rit de mes vœux la ſuperbe qu'elle eſt.	Épargnez mes ennuis, heureuse, et sage Orante, Jésuis trop assuré de sa haine apparente, Elle rit de mes vœux la superbe qu'elle est.
Et ſon propre merite, eſt tout ce qui luy plaiſt.	Et son propre mérite, est tout ce qui lui plaît.
B ii Uous voulez, que i’eſpere, & ceste ame inhumaine Me deffend ſeulement de parler de ma peine:	BI ji Uous voulez, que j'espère, et cette âme inhumaine Me défend seulement de parler de ma peine:
L’inſenſible, cauſant ce qui me fait mourir, A peur de le ſçauoir, de peur de le guerir.	L'insensible, causant ce qui me fait mourir, A eur de le savoir, de peur de le guérir.
ORANTE.	ORANTE.
Vne fille, Filandre, eſt d’humeur plus diſcrette Que de pouuoir ſi-toſt aduouer ſa deffaicte, Elle cache ſon feu, mais le ſent en effect, Et le confeſſe tard à celuy qui l’a faict.	Une fille, Filandre, est d'humeur plus discrette Que de pouvoir sitôt avouer sa défaite, Elle cache son feu, mais le sent en effet, Et le confesse tard à celui qui l'a fait.
Il en a rarement la premiere ouuerture;	Il en a rarement la première ouverture;
La beauté que tu ſers eſt de ceſte nature.	La beauté que tu sers est de cette nature.
Elle te parle peu, meſme fuit ton abord, Comme d’vn doux meurtrier, qui luy donne la mort.	Elle te parle peu, même fuit ton abord, Comme d'un doux meurtrier, qui lui donne la mort.
ecuuuley puquuquuuu,juquu, & ſon ſuence, De ſon affection prennent la violence.	ecuuuley puquuquuuu,juquu, De son suence, De son affection prennent la violence.
Elle s'eſt declarée, & ne me croy iamais, Si ton cœur n'eſt l'object de ſes plus doux ſouhaits;	Elle s'est déclarée, et ne me crois jamais, Si ton cœur n'est l'object de ses plus doux souhaits;
Me remercieras tu, ſi de ſa propre bouche L Tu ſçais dans vn moment, que ton amour la touche?	Me remercieras -tu, si de sa propre bouche L Tu sais dans un moment, que ton amour la touche?
Ie vous adorerois.	Je vous adorerais.
FILANDRE.	FILANDRE.
ORANTE luymonſtre Florante.	ORANTE luymonstre Florante.
Adore ſes appas, La voilà;	Adore ses appas, La voilà;
que faits-tu?	que faits-tu?
tu ne l’abordes pas?	tu ne l'abordes pas?
Quele humeur a ſioſtionamt reproidie?	Quele humeur a sitôtionamt reproidie?
SCENE TROISIESME.	SCÈNE -TROISIÈME.
FILANDRE.	FILANDRE.
FLORANTE.	FLORANTE.
ORANTE.	ORANTE.
FLORANTE.	FLORANTE.
Raiſtre, que tu ſçais mal cacher ta perfidie!	Raître, que tu sais mal cacher ta perfidie!
Pue Es-tu ſans artifice?	Pue Es-tu sans artifice?
& puis-je auoir ſurpris munN L’excellence, & l’honneur, des plus rares eſAu moins, qu’vn ris forcé te change le viſage!	et puis-je avoir surpris munN L'excellence, et l'honneur, des plus rares esAu moins, qu'un ris forcé te change le visage!
Iprits?	Iprits?
Teſmoigne du plaiſir, & benys mon voyage.	Témoigne du plaisir, et bénis mon voyage.
Dy que tu ſouhaittois ce bon-heur ſans pareil;	Di que tu souhaitais ce bonheur sans pareil;
Apprutne, appeue moy tes yeux & ton ſoleil!	Apprutne, appève moi tes yeux et ton soleil!
Quoy, tu ne peux forcer cette inutile honte?	Quoi, tu ne peux forcer cette inutile honte?
montu vemspimpoſon qououmcuſ bonconte.	montu vemspimposon qoumcus bonconte.
Tu treuuois à Paris des traits ſi delicats, Et tu m'as ſçeu ſi bien prouuer ce qui n'eſt pas,	Tu treuuois Paris des traits si délicats, Et tu m'as sçeu si Tu trouver ce qui n'est pas,
FILANDRE.	FILANDRE.
O Dieux, ie voy Florante!	Ô Dieux, ie était Florante!
FLORANTE.	FLORANTE.
Il va conter merueilles, Et ſa fidelité n'aura point de pareilles.	Il va compter merveilles, Et sa fidélité n'aura point de pareilles.
FILANDRE.	FILANDRE.
Me diſpenſerés-vous de diſcours ſuperflus?	Me dispenseriez-vous de discours superflus?
Le diray-ie en vn mot, ie ne vous ayme plus.	Le dirai-je en un mot, Seigneur ne vous aime plus.
FLORANTE en riant.	FLORANTE en riant.
O ſenſible douleur!	Ô sensible douleur!
ô perte irreparable!	ô perte irréparable!
Eſt-il à mes ennuys vn tourment comparable.	Est-il à mes ennuis un tourment comparable.
Qui m'ouure les enfers?	Qui m'ouvre les enfers?
qui me perce le ſein?	qui me perce le sein?
FILANDRE.	FILANDRE.
O vous n'en mourés pas!	Ô vous n'en mourez pas!
FLORANTE.	FLORANTE.
Ce n’eſt pas mon deſſein.	Ce n'est pas mon dessein.
FILANDRE.	FILANDRE.
Ileſt vray que vos yeux ont des graces exquiſes;	Ilest vrai que vos yeux ont des grâces exquises;
Qu'vne autre ne peut mieux meriter nos franchiſes, Et que vous comparant à celle qui m'a pris, On auroit de la peine à qui donner le pris.	Qu'une autre ne peut mieux mériter nos franchises, Et que vous comparant à celle qui m'a pris, On aurait de la peine à qui donner le pris.
Mais quelques doux appas, dont vous ſoyez, pourueué En m'oſtant la raiſon, I'amour m’oſta la veue.	Mais quelques doux appas, dont vous soyez, pourueué En m'ôtant la raison, J'amour m'ôta la vue.
Ie pre fere ma Dame à toute autre beauté, Mes yeux ſont eſbloüys, & mon cœur enchanté;	Je pré sere ma Dame à toute autre beauté, Mes yeux sont éblouis, et mon cœur enchanté;
I'accorde, que ie quitte vn bien incomparable, Pour ſemer ſur du vent & baſtir ſur du ſable.	J'accorde, que ainsi quitte un bien incomparable, Pour semer sur du vent et bâtir sur du sable.
Ie receurois chez, vous des traictemens meilleurs, avtan on ſecret ue pin pone mes vteux ailleurs.	Je recevrais chez, vous des traitements meilleurs, autan on secret ue pin pone mes vteux ailleurs.
FLORANTE.	FLORANTE.
Dy qu’un ſecret deſtin, porte ailleurs ta folie:	Dis qu'un secret destin, porte ailleurs ta folie:
PAEſ1vORus Florante eſt touſiours gaye, & ſans melancholie.	PAs1vORhus Florante est toujours gaie, et sans mélancolie.
FLORANTE.	FLORANTE.
Non, non, croy qu’en riant ie dy la verité;	Non, non, crois qu'en riant ici dis la vérité;
Et qui ne riroit pas de ta legereté?	Et qui ne rirait pas de ta légèreté?
Quelle plaiſante humeur agite ainſi ton ame?	Quelle plaisante humeur agite ainsi ton âme?
On pourroit l’excuſer en l’esprit d’vne femme, Puiſque ſelon l’erreur de voſtre iugement, Elle eſt de ſon inſtinc ſuſete an changement.	On pourrait l'excuser en l'esprit d'une femme, Puisque selon l'erreur de votre jugement, Elle est de son instinc susète an changement.
Mais que ces esprits forts, ces miroüers de conſtance, Faſſent au moindre vent ſi peu de reſiſtance;	Mais que ces esprits forts, ces miroüers de constance, Fassent au moindre vent si peu de résistance;
Que leur fidèlité manque aux premiers effets, C’eſt vn ſuiet de rire ou l’on n’en euſt iamais.	Que leur fidèlité manque aux premiers effets, C'est un sujet de rire ou l'on n'en eût jamais.
FILANDRE.	FILANDRE.
Si tu conſiderois combien l’abſence eſt forte, On ne te verroit pas diſcourir de la ſorte.	Si tu considérais combien l'absence est forte, On ne te verrait pas discourir de la sorte.
Ta pre ſence auroit pù diuertir ce mal-heur:	Ta pré sence aurait phu diuertir ce malheur:
Car qui void le.	Car qui voit le.
Soleil, ſent touſiours ſa chaleur.	Soleil, sent toujours sa chaleur.
Mais quand on s’en eſloigne, & qu’vn espais nuage Arreſte ſon effect, & cache ſon viſage, eeeuee vecuuaeauegasey Et recourir au feu n'eſt pas legereté.	Mais quand on s'en éloigne, et qu'un épais nuage Arrête son effet, et cache son visage, eeeuee vecuaeauégasei Et recourir au feu n'est pas légèreté.
FLORANTE.	FLORANTE.
Il eſt vray, ton amour est la conſtance meſme!	Il est vrai, ton amour est la constance même!
Traiſtre t'eſtois abſente, & tu voys que ie t'ayme.	Traître t'étais absente, et tu vois que notre t'aime.
J’ay les meſmes ardeurs, & le meſme ſoucy:	J'ai les mêmes ardeurs, et le Seigneur souci:
I'ay veſcu ſans te voir, & ſans changer außy.	J'ai vécu sans te voir, et sans changer aussi.
Sans te voir!	Sans te voir!
ie mabuſe, & ma triſte penſée Doupcu v Pruuory vne lmux vtracée.	ie mabuse, et ma triste pensée Douptu v Pruori une lumux tracée.
Ie t ay veu tous les jours, ie t’ay parlé cent fois.	Je t ai vu tous les jours, ie t'ai parlé cent fois.
FI LANDRE.	FI LANDRE.
Aanc dr eu jondlenspont.	Aanc dr eu jondlentspont.
FLORANTE.	FLORANTE.
Mais ſans yeux & ſans voix, Je n'eſtois pour mon mal que trop ingenieuſe, Ma inemoire trop bonne, & tropofficieuſe.	Mais sans yeux et sans voix, Je n'étais pour mon mal que trop ingénieuse, Ma inémoire trop bonne, et tropofficieuse.
FILANDRE.	FILANDRE.
Et moy ie ne ſçaurois me vanter de ce poinct, I'aybien-toſt oublié ce que ie ne voy point.	Et moi ici ne saurais me vanter de ce point, J'aibien-tôt oublié ce que ie ne vois point.
Excuſe en ton malheur ma memoire infeconde Ou que de ce deffaut la nature responde.	Excuse en ton malheur ma mémoire inféconde Ou que de ce défaut la nature réponde.
Mais Mais le voy Celimene, admire ſa beauté, Et ne condamne piua mon infaeſne.	Mais Le vois le Celimène, admire sa beauté, Et ne condamne piva mon infaes.
FLORANTE.	FLORANTE.
Va, Barbare à mes yeux, luy conter ton martyre, Obtien de cét objet ce que ton cœur deſire;	Va, Barbare à mes yeux, Seigneur conter ton martyre, Obtien de cet objet ce que ton cœur désire;
I'y conſents, infidelle, adore ſes appas.	J'y consens, infidèle, adore ses appas.
FILANDRE allant à Celimene.	FILANDRE allant à Celimène.
Tu profiteroir peu de n’y conſentir pas.	Tu profiteroir peu de n'y consentir pas.
ABONANIL.	ÀBONANIL.
Cachons-nous pour l’ouyr.	Cachons-nous pour l'ouïr.
Elle va dans les arbtes.	Elle va dans les arbtes.
SCENE QVATRIESME.	SCÈNE QUATRIÈME.
CELIMENE.	CELIMENE.
FILANDRE.	FILANDRE.
FILANDIRE.	FILANDIRE.
Dorable merueille;	Dorable merveille;
En beauté ſans exemple, en rigueur ſans pareille.	En beauté sans exemple, en rigueur sans pareille.
Quand vouleZ-vous tarir la ſource de mes pleurs?	Quand voulez-vous tarir la source de mes pleurs?
Quand ſera voſtre eſprit ſenſible à mes douleurs?	Quand sera votre esprit sensible à mes douleurs?
Ces rochers ongueilleux en des ruiſſeaux ſe fondę Ils entendent mes erts, leurs Echo me reſpondent, Et quand i’aydemandé, ſi mon mal inoüy Finiroit quelque iour, elles m’ont dit oüy.	Ces rochers ongueilleux en des ruisseaux se fond Ils entendent mes erts, leurs Écho me répondent, Et quand j'aidemandé, si mon mal infini Finirait quelque jour, elles m'ont dit oui.
cut vonſeruez, pourtant voſtre rigueur extreſme, Et ie n’oſe eſperer que vous parliez de meſme.	cut vonservez, pourtant votre rigueur extrême, Et tu n'ose espérer que vous parliez de même.
CELIMENE.	CELIMENE.
Où peut eſtre ma ſaur?	Où peut -être ma saur?
FILANDRE.	FILANDRE.
I’implore du ſecours, daſuiuolo Geuuieue ieuendeSmes uaſcours.	J'implore du secours, dasuiuolo Geuuieue ieuendeSmes uascours.
CELIMENE.	CELIMENE.
DEn em seneseys	DEn em seneseys
FILANDRE.	FILANDRE.
Vous me fermez, l’oreille, Pour ne pas aduouër mon ardeur ſans pareille.	Vous me fermez, l'oreille, Pour ne pas avouer mon ardeur sans pareille.
CELIMENE.	CELIMENE.
Où la puis-je treuuer?	Où la puis-je trouver?
FILANDRE.	FILANDRE.
Dieux que de cruauté?	Dieux que de cruauté?
Ie parte de mon mal, inhumaine Beauté.	Je parte de mon mal, inhumaine Beauté.
CELIMENE.	CELIMENE.
Ie la cherche par bouf.	Je la cherche par bous.
FILANDRE.	FILANDRE.
Cruelle, oyez ma plainte.	Cruelle, oyez ma plainte.
Donnez, vn mot, au mal dont mon ame eſt atteinte.	Donnez, un mot, au mal dont mon âme est atteinte.
CELIMENE.	CELIMENE.
Dieux que ces importuns me dérobent de temps, Ie les fais tous ſouffrir, ils ſont tous meſcontens.	Dieux que ces importuns me dérobent de temps, Je les fais tous souffrir, ils sont tous mécontents.
Cen'eſt que de moncęur que leurs plaiſirs dependent, Ie n'en poſſede qu’vn, & tous me le demandent.	Cen'est que de moncur que leurs plaisirs dépendent, Je n'en possède qu'un, et tous me le demandent.
Qui le doit obtenir?	Qui le doit obtenir?
qui ſeront les jaloux?	qui seront les jaloux?
Nul de vous ne l’aura pour vous accorder tous.	Nul de vous ne l'aura pour vous accorder tous.
FILANDRE.	FILANDRE.
CompareZ nos tourmens, conſiderez nos peines, S’ils ont verſé des pleurs i’en verſe des fontaines, S’ils ſentent quelque ardeur, ie me ſens conſommer, Jle ayment froidement, & ie ſçay ſeul aymer.	Comparez nos tourments, considérez nos peines, S'ils ont versé des pleurs j'en verse des fontaines, S'ils sentent quelque ardeur, une me sens consommer, Jle aiment froidement, et ie maire seul aimer.
CELIMENE.	CELIMENE.
Tous en diſent de meſme.	Tous en disent de même.
FILANDRE.	FILANDRE.
Et ſeul ie le dois dire;	Et seul ici le dois dire;
1 Si la plainte eſt plus iuſte où la fortune eſt pire.	1 Si la plainte est plus juste où la fortune est pire.
Philandre ſçait mourir, s’ils ſçauent endurer, Son inclination ne ſe peut comparer.	Philandre sait mourir, s'ils savent endurer, Son inclination ne se peut comparer.
Pour vous i’ay violé l’amitié la plus ſaincte, Dont iamais ic ybas vne ame fut atteinte.	Pour vous j'ai violé l'amitié la plus sainte, Dont jamais ic y âme fut atteinte.
Il n'eſtoit rien d’égal à mes contentemens, Ie cauſois de l’enuie aux plus heureux Amans.	Il n'était rien d'égal à mes contentements, Je causais de l'envie aux plus heureux Amants.
Ie pouuois loin de vous deffier la Fortune, Tovngeos Trop Fiorame, &it von importune.	Je pouuois loin de vous défier la Fortune, Tovngeos Trop Fiorme, etit von importune.
Tous mes vœux l’honoroient, & vous les refuſez.	Tous mes vœux l'honoraient, et vous les refusez.
Ie les voyois cheris, ie les voy mespriſez.	Je les voyais chéris, ie les voyais méprisés.
CELIMENE.	CELIMENE.
Adieu, ie hay l’amour d’vn esprit infidelle, Et ie ne pretens rien au bien de cette Belle.	Adieu, Seigneur haï l'amour d'un esprit infidèle, Et tu ne prétends rien au bien de cette Belle.
Reportez-luy ce cœur que vous me preſentez;	Reportez-lui ce cœur que vous me présentez;
Vous me pourriez quitter comme vous la quittez.	Vous me pourriez quitter comme vous la quittez.
Elle s’en va, & Filandre demeure confus.	Elle s'en va, et Filandre demeure confus.
SCENE CINQVIESME.	SCÈNE CINQUIÈME.
ORANTE.	ORANTE.
FLORANTE.	FLORANTE.
FILANDRE.	FILANDRE.
FLORANTE ſortant d’entreles arbres.	FLORANTE sortant d'entreles arbres.
Qu’il eſt ſatis faict!	Qu'il est satî fait!
& qu’il profite au change!	et qu'il profite au change!
& Soy-meſme il ſe punit, & m'offençãt me vãge.	et Soi-même il se punit, et m'offensant me venge.
L’abordant.	L'abordant.
Filandre, qui meſpriſe eſt en fin meſpriſé.	Filandre, qui méprise est en fin méprisé.
FI LANDRE.	FI LANDRE.
Ie n’attendois pas mieux que d’eſtre reſuſé.	Je n'attendais pas mieux que d'être ressusé.
Et ie iure le Ciel, que s’il m'eſtoit poßible, Ie me deſgagerois de cette ame inſenſible.	Et beau jure le Ciel, que s'il m'était possible, Je me dégagerais de cette âme insensible.
Que ce cœur bruſleroit de ces feux anciens, Que ie m’enchaiſnerois de mes premiers liens.	Que ce cœur brûlerait de ces feux anciens, Que tu m'enchaînerais de mes premiers liens.
FLORANTE.	FLORANTE.
Oüy, ſi la chaiſne außi t’eſtoit encore offerte;	Oui, si la chaîne aussi t'était encore offerte;
Et ſi ie deſirois de recouurer ma perte.	Et si ici désirais de recouvrer ma perte.
Mais ce ſoing me trauaille aſſez legerement, Un bien que chacun fuit ſe conſerue ayſément.	Mais ce soins me travaille assez légèrement, Un bien que chacun fuit se conserve aisément.
I'ay veu le peu d’eſtat qu'on fait de ton ſeruice, Et ie ne crains pas fort qu'aucune te rauiſſe.	J'ai vu le peu d'état qu'on fait de ton service, Et tu ne crains pas fort qu'aucune te ravisse.
C .	Ç .
uj Ie meure, il eſt biẽ vra y que l’Amour n’a point d’yeux, Ie reputois jadis mon deſtin glorieux.	Ouij à point, il est bien vra y que l'Amour n'a point d'yeux, Je reputois jadis mon destin glorieux.
Quand ton affection s’offroit à ma memoire, Je croyois tout Paris enuieux de ma gloire.	Quand ton affection s'offrait à ma mémoire, Je croyais tout Paris envieux de ma gloire.
Que Filandre eſcriuiſt, que Filandre parlaſt, Ie ne croyois iamais qu’vn autre l’égalaſt.	Que Filandre écrivît, que Filandre parlât, Je ne croyais jamais qu'un autre l'égalât.
Opinion bien fauſſe!	Opinion bien fausse!
& que ie n'ay plus euè̈, Depuis que la raiſon m'a deſillé la veuë.	et que ici n'ai plus euè̈, Depuis que la raison m'a desillé la vue.
Ie n’estime plus tant les charmes de ta voix, Ie m’eſtonne bien plus de l’erreur où i’eſtois.	Je n'estime plus tant les charmes de ta voix, -Je m'étonne bien plus de l'erreur où j'étais.
Mon ame s’eſt renduë à de foibles atteintes, Tu ſçais mal careſſer, & mal faire des plaintes.	Mon âme s'est rendue à de faibles atteintes, Tu sais mal caresser, et mal faire des plaintes.
Ne ſigurant pas mieux ta peine & ton ſoucy, Celimene a raiſon de te traicter ainſi, Tu luy parlois de pleurs, & c’eſt honte à Filandre, D'eſtre creu ſeulement capable d en respandre.	Ne sigurant pas mieux ta peine et ton souci, Celimène a raison de te traicter ainsi, Tu lui parlais de pleurs, et c'est honte à Filandre, D'être cru seulement capable en répandre.
Eſt-ce par ces diſcours, & par cette action, Qu'vn homme doit prouuer ſon inclinatiom?	Est-ce par ces discours, et par cette action, Qu'un homme doit prouver son inclinatiom?
Me tenant ces propos, Cpermets moy de le dire, De ſi froids compliments m’exciteroient à rire.	Me tenant ces propos, Cpermets moi de le dire, De si froids compliments m'exciteraient à rire.
FILANDRE.	FILANDRE.
Eſpargne vn malheureux, & quelque qualité, Dont jadis ton esprit ayt le mien enchanté.	Épargne un malheureux, et quelque qualité, Dont jadis ton esprit ait le mien enchanté.
Croy que tu pourrois peu ſur cette ame inhumaine, Qu'en mon lieu, tu ſerois en vne meſme peine.	Crois que tu pourrais peu sur cette âme inhumaine, Qu'en mon lieu, tu serais en une autre peine.
Elle n’eſtime rien que ſes propres appas, Venus ſous mes habits ne la toucheroit pas.	Elle n'estime rien que ses propres appas, Venus sous mes habits ne la toucherait pas.
Tous objets ſont communs à ce cœur inſenſible,	Tous objets sont communs à ce cœur insensible,
FLORANTE.	FLORANTE.
Et ſi ie luy plaiſois,	Et si ici Seigneur plaisais,
TILANDRE.	TILANDRE.
Tu ferois l’impoßible.	Tu ferais l'impossible.
FLORANTE à Orante.	FLORANTE à Orante.
Madame, agrerez-vous ces diuertiſſemens.	Madame, agrérez-vous ces divertissements.
Quę Filandre m’enuoye vn de ſes veſtemens.	Qu' Filandre m'envoie un de ses vêtements.
Vous rirez de la feinte, & ie ſuis aſſeZ vaine, Pour esperer Thonneur de toucher Celimene.	Vous rirez de la feinte, et je suis assez vaine, Pour espérer Thonneur de toucher Celimène.
Sous le tiltre d’Amant & d’vun de vos nepueux, Croyez qu’en peu de iours i’obtiendray de ces vœux.	Sous le titre d'Amant et d'un de vos neveux, Croyez qu'en peu de jours j'obtiendrai de ces vœux.
Ie n'arriuay qu'hier, & n'eſtant pas cogneué, Il m'eſt ayſé de feindre & de tromper ſa veuë.	Je n'arrivai qu'hier, et n'étant pas cogneué, Il m'est aisé de feindre et de tromper sa vue.
ORANTE.	ORANTE.
Ce diuertiſſement ne peut eſtre que doux, De voir Florante amant, & Filandre jaloux.	Ce divertissement ne peut être que doux, De voir Florante amant, et Filandre jaloux.
FILANDRE.	FILANDRE.
Ta force en cét effet ſeroit incomparable, Tu ne me ſerois plus qu'vn objet adorable.	Ta force en cet effet serait incomparable, Tu ne me serais plus qu'un objet adorable.
De tels vœux dependroit tout mon contentement, Ebe meſprifero t'Amame pourt Aman.	De tels vœux dépendroit tout mon contentement, Ébe méprifero t'Amme pourt Aman.
FLORANTE.	FLORANTE.
Ie ne t’oblige à rien, & faicts cette entrepriſe, Sans deſſein que ton cœur me rende ſa franchiſe, Ne dy point qui ie ſuus aux Beautez, de ce lieu, Et m'enuoye unhabit.	Je ne t'oblige à rien, et faits cette entreprise, Sans dessein que ton cœur me rende sa franchise, Ne dis point qui te suus aux Beautés, de ce lieu, Et m'envoie unhabit.
FILANDRE.	FILANDRE.
Dans vn moment.	Dans un moment.
FLORANTE.	FLORANTE.
Fin du premier Acte.	Fin du premier Acte.
Adieu.	Adieu.
ACTE II.	ACTE II.
TE I OVENETREMIERE.	TE I VENETREMIERE.
CELIMENE.	CELIMENE.
FELICIE Sœurs.	FELICIE Sœurs.
CELIMENE.	CELIMENE.
Ourquoy m’accuſés-vous de trop de retenuë?	Ourquoy m'accusez-vous de trop de retenue?
Ie ne reſerue rien, & mon humeur eſt nuë.	Je ne réserve rien, et mon humeur est nue.
Duse Qui peut (ſi ce n’eſt vous) cherir mes intereſts?	Duse Qui peut (si ce n'est vous) chérir mes intérêts?
Et qui doit que ma ſœur partager mes ſecrets?	Et qui doit que ma sœur partager mes secrets?
FELICIE.	FELICIE.
Quelque ſi libre humeur dont vn eſprit puiſſe eſtre, Il eſt bien mal-a yſé qu’il faſſe tout paroiſtre.	Quelque si libre humeur dont un esprit puisse être, Il est bien mal-a ysé qu'il fasse tout paraître.
Tou ſiours quelque ſecret ſe reſerue au dedans, Qui meſmes n'eſt pas ſten ues pim thers confidens.	Tou siours quelque secret se réserve au dedans, Qui mêmes n'est pas sten ues pim thers confidents.
Et ſur tout en amour la plus libre eſt ſecrette, Et comme elle eſt aueugle elle eſt außi muette.	Et sur tout en amour la plus libre est secrète, Et comme elle est aveugle elle est aussi muette.
On ne s’oze fier à ſon meilleur amy, Et le cœur le plus franc ne s’ouure qu'à demy.	On ne s'ose fier à son meilleur ami, Et le cœur le plus franc ne s'ouvre qu'à demi.
Poſſeder tant d’attraits, eſtre ſi recherchée, Captiuer mille eſprits, & n’eſtre poinct touchée!	Posséder tant d'attraits, être si recherchée, Captiver mille esprits, et n'être point touchée!
Ha ma ſœur!	Ha ma sœur!
croyez vous qu’on le puiſſe eſtimer?	croyez -vous qu'on le puisse estimer?
Le Ciel vous a-t’il faicte incapable d’aymer?	Le Ciel vous a-t-il faite incapable d'aimer?
Euitez-vous les coups dont toutes ſont bleſſées?	Euitez-vous les coups dont toutes sont blessées?
Et n'euſtes-vous iamais de pareilles penſées?	Et n'eûtes-vous jamais de pareilles pensées?
L’Amour eſt vn archer qui n’a iamais failly.	L'Amour est un archer qui n'a jamais failli.
Si le cœur ne ſe rend quand il eſt aſſailly, Il prend vne autre voye, il le force, il le bleſſe, Et l’orgueilleuſe alors recognoiſt ſa foibleſſe.	Si le cœur ne se rend quand il est assailli, Il prend un autre voie, il le force, il le blesse, Et l'orgueilleuse alors reconnaît sa faiblesse.
bt boms ne bom renuit uux umnnts de ces lieux, Ce Dieu pour vous toucher ſuſciteroit des Dieux.	bt boms ne bom renuit uux umnts de ces lieux, Ce Dieu pour vous toucher susciterait des Dieux.
Il faut que tout deffere à ſa force indomptée, E fonimanttonne penremeeuneo.	Il faut que tout défère à sa force indomptée, E fonimantonne penremeeuneo.
CELIMENE.	CELIMENE.
mapumupicupocauns qui pomiſendompier.	mapumupicupocauns qui pomisendompier.
Mais quand on le veut fuir, on le peut éuiter.	Mais quand on le veut fuir, on le peut éviter.
FELICIE.	FELICIE.
Ce Dieu, comme il lu y plaiſt atteint les plus cruelles, On prend la fuitte en vain (ma Sœur) il a des aiſles.	Ce Dieu, comme il lu y plaît atteint les plus cruelles, On prend la fuite en vain (ma Sœur) il a des ailes.
CELIMENE.	CELIMENE.
Mais les aiſles qu’il a ſont courtes quand il naiſt.	Mais les ailes qu'il a sont courtes quand il naît.
Cét enſant vole-t’il, foible encor comme il eſt?	Cet ensant vole-t-il, faible encor comme il est?
FELICIE.	FELICIE.
On neſent pas l’Amour au poinct de ſa naiſſance, Et qui ne le ſent pas ne craint point ſa puiſſance.	On nésent pas l'Amour au point de sa naissance, Et qui ne le sent pas ne craint point sa puissance.
CELIMENE.	CELIMENE.
Mais ſi-toſt qu'on le ſent on l’éuite ayſément.	Mais sitôt qu'on le sent on l'évite aisément.
FELRCIE.	FELRCIE.
Alors il ſçait vôler, & l’on fuit vainement.	Alors il sait vôler, et l'on fuit vainement.
CELIMENE.	CELIMENE.
Au ßi ie n’ay iamais ſa force mespriſée, Et mon ame à ſes traicts eſt toute dispoſée.	Au ssi ici n'ai jamais sa force méprisée, Et mon âme à ses traits est toute disposée.
Mais de les preuenir, les prendre en ſon carquoit, Et de ma propre main me ranger ſous ſes loix.	Mais de les prévenir, les prendre en son carquait, Et de ma propre main me ranger sous ses lois.
Qui me voudroit (ma Sœur) conſeiller de le faire, Ne me donneroit pas vn aduis ſalutaire.	Qui me voudrait (ma Sœur) conseiller de le faire, Ne me donnerait pas un avis salutaire.
I’approuue qu'vn Esprit mette les armes bas, ''approuue fort außi qu’il ne ſe rende pas.	J'approuve qu'un Esprit mette les armes bas, '' approuve fort aussi qu'il ne se rende pas.
Ie n'aymeray iamais qu'Amour ne m’ait bleßée.	Je n'aimerai jamais qu'Amour ne m'ait blessée.
Si ie lu y dois ceder, i’y veux eſtre forcée.	Si deux lu y dois céder, j'y veux être forcée.
FELICIE.	FELICIE.
Auoüez, toutes fois, que parmy tant d’amans, Qui reuerent en vous des attratts ſi charmans;	Auoüez, toutes fois, que parmi tant d'amants, Qui révèrent en vous des attrats si charmants;
Il s’en trouue quelqu’vn, qui vous plaiſt dauantage, Et dont piu vuiomiers vous agreériez, l’hommage.	Il s'en trouve quelqu'un, qui vous plaît davantage, Et dont pive vuiomiers vous agreériez, l'hommage.
CELIMENE.	CELIMENE.
Alidor vaut beaucoup.	Alidor vaut beaucoup.
TEEIOIE.	TEIOIE.
Que ſes attraits ſont doux!	Que ses attraits sont doux!
CELIMENE.	CELIMENE.
Mais ie le voias qui vien, ma jœur, retirons nous,	Mais ie le voias qui viens, ma jœur, retirons nous,
FELICIE.	FELICIE.
CraigneZ-vous ſon abord?	Craignez-vous son abord?
ALIDOR.	ÀLIDOR.
Ie la void l’inhumaine.	Je la voit l'inhumaine.
FELICIE à Alidor.	FELICIE à Alidor.
Ie trauaillois pour vous, mais i’ay perdu ma peine.	Je travaillais pour vous, mais j'ai perdu ma peine.
SCENE DEVXIESME.	SCÈNE DEUXIÈME.
ALIDOR.	ÀLIDOR.
LYSIS ſon ams.	LYSIS son ams.
ALIDOR.	ÀLIDOR.
E Elas cruël amy, que ma douleur te plaiſt!	 Élas cruel ami, que ma douleur te plaît!
Void cõme elle me fuit, l’inſenſible qu’elle eſt!	Void comme elle me fuit, l'insensible qu'elle est!
Imon& Et tu dis que le temps la rẽdra plus traicfable!	Imonet Et tu dis que le temps la rẽdra plus traifable!
En reiarue, varreſt ue mon ſort lamentable!	En reiarue, varrêt ce tte sort lamentable!
Tu me retiens le bras;	Tu me retiens le bras;
tu differes ma mort:	tu diffères ma mort:
Tu voy, tu voy Lyſis, ſi ie me plains à tort,	Tu vois, tu vois Lysis, si belle me plains à tort,
LYSIS.	LYSIS.
Alidor, elle eſt fille, & la fille est changeante, Nous la verrons vn iour t’eſtre plus indulgente.	Alidor, elle est fille, et la fille est changeante, Nous la verrons un jour t'être plus indulgente.
Le temps amolira ce courage inhumain, Elle fuit aujourd’huy, tu l’atteindras demain.	Le temps amolira ce courage inhumain, Elle fuit aujourd'hui, tu l'atteindras demain.
Il faut long-temps ſouffrir, la respecter, la craindre, Ne l’auoir point ſuiuie eſt un pas pour l’atteindre.	Il faut longtemps souffrir, la respecter, la craindre, Ne l'avoir point suivie est un pas pour l'atteindre.
Les preuues de respect ſont de puiſſans appas, Tu t’eſloignerois d’elle ozant ſuiure ſes pas.	Les preuves de respect sont de puissants appas, Tu t'éloignerais d'elle oz suivre ses pas.
Fay tes vers ſeulement, reſue ſur ſa loüange, Prefere ſes attraits à la beauté d’un Ange.	Fais tes vers seulement, rêve sur sa louange, Préfère ses attraits à la beauté d'un Ange.
D .	D .
iij Parle de ſon eſprit, de ſon teint, de ſa voix, Puiſque c’eſt le deſſein qui t’ameine en ces bois.	ij Parle de son esprit, de son teint, de sa voix, Puisque c'est le dessein qui t'amène en ces bois.
Deſcri tous les attraits dont le Ciel l’a douée, Vne fille, Alidor, ayme d’eſtre loüée.	Descri tous les attraits dont le Ciel l'a douée, Une fille, Alidor, aime d'être louée.
Tu traictes ſans deſſein mille ſubjects diuers, Et ta Maiſtreſſe encor n’a point eu de tes vers.	Tu traites sans dessein mille sujets divers, Et ta Maîtresse encor n'a point eu de tes vers.
Ne crains point de faillir, ny de perdre ta peine, On n'eſtime aujourd’huy que les fruicts de ta veine.	Ne crains point de faillir, ni de perdre ta peine, On n'estime aujourd'hui que les fruits de ta veine.
ALIDOR.	ÀLIDOR.
Il eſt vray que i’ay l’art de flatter qui me plaiſt, Ie peints quãd bõ me ſemble vn œil plus beau qu’il n’eſt.	Il est vrai que j'ai l'art de flatter qui me plaît, Je peints quand me semble œil plus beau qu'il n'est.
Ie dore des cheueux, ou ma plume ſe jouë A noircir vn ſourcil, & farder vne jouë.	Je dore des cheveux, ou ma plume se joue À noircir un sourcil, et farder une joue.
I’ay touſiours de la neige, & quelques fois i’en mets Sur vn ſein qui n’eneut, & n’en aura iamais.	J'ai toujours de la neige, et quelques fois j'en mets Sur un sein qui n'en, et en aura jamais.
Ie preſte à qui ie veux des œillets & des roſes, Ie donne de l’éclat aux plus communes choſes;	Je prête à qui belle veux des œillets et des roses, Je donne de l'éclat aux plus communes choses;
Ei i’ay fait eſtimer cent viſages diuers Qui n’auoient toutes fois rien de beau qu’en mes vers.	Éi j'ai fait estimer cent visages divers Qui n'avaient toutes fois rien de beau qu'en mes vers.
Mais tout eſt au deſſous de ſa beauté parfaicte, Ma Muſe en ce trauail eſt timide & muette, I'admire les effects de cét objet vaincœur, Qui me glace la veine & m’eſchauffe le cœur, Touſiours le premier mot a ma plume arreſtée, Ie l’ay mille fois priſe, & mille fois quittée.	Mais tout est au dessous de sa beauté parfaite, Ma Muse en ce travail est timide et muette, J'admire les effets de cet objet vaincœur, Qui me glace la veine et m'échauffe le cœur, Tousiours le premier mot a ma plume arrêtée, Je l'ai mille fois prise, et mille fois quittée.
Mon iugement s’égare en ſes moindres appas;	Mon jugement s'égare en ses moindres appas;
L'eſcriraJromes ſons.	L'écriraJromes sons.
mau ne r'eſoigne pas.	mau ne résoigne pas.
LYSIS.	LYSIS.
I'attendra y cependant en ce lieu frais & proche;	J'attendra y cependant en ce lieu frais et proche;
Mais voy ſi tu n’as point quelques vers en ta poche;	Mais vois si tu n'as point quelques vers en ta poche;
Ie me diuertiray par ce doux entretien;	Je me divertirai par ce doux entretien;
Ie ne puis eſtimer de ſtyle que le tien.	Je ne puis estimer de style que le tien.
Il prend des papiers qu’Alidor luy baille, & ſe retire à l’autre coſte du bois, où a yant deſployé le premier, il lit eſtant aſſis.	Il prend des papiers qu'Alidor lui baille, et se retire à l'autre côte du bois, où a yant déployé le premier, il lit étant assis.
Vn iour Filene, dden Dores ets dosise, Pour ſoulager ſon amoureuſe peine, Diſoit (voyant couler cette belle onde) C’eſt ainſi que nos iours paſſent au monde.	Un jour Filène, dden Dores ets dosise, Pour soulager son amoureuse peine, Disait (voyant couler cette belle onde) C'est ainsi que nos jours passent au monde.
L’ingrate dame Qui m'oſte l’ame Vn iour ne pourra plus donner de flamme, Comme elle eſt maintenant, ſourde à qui l’ayme, Le temps la traictera bien-toſt de meſme.	L'ingrate dame Qui m'ôte l'âme Un jour ne pourra plus donner de flamme, Comme elle est maintenant, sourde à qui l'aime, Le temps la traitera bientôt de même.
Mon œil humide, Belle homicide, Ne verra pas touſiours ce front ſans ride, Le temps effacera ces belles choſes, Et ne te laiſſera ny lys, ny roſes.	Mon œil humide, Belle homicide, Ne verra pas toujours ce front sans ride, Le temps effacera ces belles choses, Et ne te laissera ici lys, ni roses.
Voyant ta face Seiche & ſans grace, Tit voudras de deſpit, rompre ta glace;	Voyant ta face Seiche et sans grâce, Tit voudras de dépit, rompre ta glace;
Ton aage aura blanchy ces treſſes blondes, Tu ne les feras plus friſer en ondes.	Ton âge aura blanchi ces tresses blondes, Tu ne les feras plus friser en ondes.
Lors ta manie Sera punie Ie ne enemuy pins ta tompagnie;	Lors ta manie Sera punie Je ne enemuy pins ta tompagnie;
Et dans ce changement de ma fortune Ie ſeray l’inhumain, toy l’importune.	Et dans ce changement de ma fortune Je serai l'inhumain, toi l'importune.
ALIDOR.	ÀLIDOR.
Je ne puis que loüer de ſa rare beauté!	Je ne puis que louer de sa rare beauté!
Mon abondance icy fait ma ſterilité.	Mon abondance ici fait ma stérilité.
ALIPOR.	ÀLIPOR.
LYSIS deſploye vn autrepapier, &lit.	LYSIS déploie un autrepapier, etlit.
A CALISTE.	À CALISTE.
De quelques ornemens que l’Aurore ſe pare, Quoy que l’œil du iour ayt de rare Quelque beauté qui puiſſe aſſeruir les eſprits.	De quelques ornements que l'Aurore se pare, Quoi que l'œil du jour ait de rare Quelque beauté qui puisse asservir les esprits.
Dequoy, que la nature au printemps ſoit pourueuë, Caliſte, tout n'eſt rien à ceux qui vous ont veuë, Qu'vn object de mespris.	Dequoy, que la nature au printemps soit pourvue, Caliste, tout n'est rien à ceux qui vous ont vue, Qu'un object de mépris.
N'allez N'alleZ point à la Cour pour veoir de belles choſes;	N'allez N'allés point à la Cour pour voir de belles choses;
Et n'eſtimez ny lys, ny roſes;	Et n'estimez ici lys, ni roses;
Rien ne peut eſgaler voſtre moindre ornement, Jl n'eſt point de beautez à la voſtre pareilles;	Rien ne peut égaler votre moindre ornement, Jl n'est point de beautés à la vôtre pareilles;
Si vous deſirez, veoir d’admirables merueilles, Mirez-vous ſeulement.	Si vous désirez, voir d'admirables merveilles, Mirez-vous seulement.
Lors vous verrez, en vous, la ſeule creature, Qui nous faict priſer la nature.	Lors vous verrez, en vous, la seule créature, Qui nous fait priser la nature.
L’obiect ſeul que iamais elle ayt faict ſans deffauts:	L'objet seul que jamais elle ait fait sans défauts:
Par vous elle n'eſt plus à ſcy meſme imitable, Et ſi vous ne trouuez que ie ſois veritable, Voſtre mirouer eſt faux.	Par vous elle n'est plus à sci même imitable, Et si vous ne trouvez que je sois véritable, Votre mirouer est faux.
Que les plus grands eſprits me porteroient d’enuie!	Que les plus grands esprits me porteraient d'envie!
Que i'aurois vne longue vie!	Que j'aurais une longue vie!
Que ie ſerois chery, que mes vers ſeroient doux!	Que ici serais chéri, que mes vers seraient doux!
Que ie loüerois le Sort qu'inceſſamment i’accuſe!	Que quelque louerais le Sort qu'incessamment j'accuse!
Et qu’on m’eſtimeroit, ſi l’on trouuoit ma Muſe Außi belle que vous.	Et qu'on m'estimerait, si l'on trouvait ma Muse Aussi belle que vous.
Il n’eſt point de bon-heur, comparable à mon ayſe;	Il n'est point de bonheur, comparable à mon aise;
S’il arriue, qu’elle vous plaiſe;	S'il arrive, qu'elle vous plaise;
Mille charmes nouueaux paroiſtront dans mes vers, Jls n’auront plus ny mot, ny lettre qui ne touche, Quand ils ſęront priſez par la plus belle bouche Qui ſoit en l'Vniuers.	Mille charmes nouveaux paraîtront dans mes vers, Ils n'auront plus m mot, ni lettre qui ne touche, Quand ils sauront prisez par la plus belle bouche Qui soit en l'Univers.
Il vient à Alidor.	Il vient à Alidor.
E FI.	E FI.
ALIDOR.	ÀLIDOR.
Iamais pauure riſmeur Ny ent Tant d'ambimione, & muins ut vonne humeur:	Jamais pauvre rismeur Ni ent Tant d'ambimione, et muins ut vonne humeur:
I'ay faict ce peis de vers depuis que ie trauaille;	J'ai fait ce péis de vers depuis que je travaille;
Eſcoute, ſi i'ay rien imaginé qui vaille.	Écoute, si j'ai rien imaginé qui vaille.
Il lit.	Il lit.
En ſin qu’ordonnez-vous inhumaine beauté, Quand ne verray-je plus en voſtre cruauté Des ſujets de me plaindre & d’eſpãdre des larmes?	En sin qu'ordonnez-vous inhumaine beauté, Quand ne verrai-je plus en votre cruauté Des sujets de me plaindre et d'espendre des larmes?
puupie puuuuenuvoſtre œil mo veincœur?	puupie puuuuenuvostre œil mo veincœur?
Quand ſera voſtre cœur Außi doux que vos charmes?	Quand sera votre cœur Aussi doux que vos charmes?
Ne finirez-vous point le cours de ma miſere, Dois-je chercher la mort	Ne finirez-vous point le cours de ma misère, Dois-je chercher la mort
Il continuë.	Il continue.
Mon amour me fournit mille penſers diuers, Et ie n'en puis trouuer pour acheuen ce vers.	Mon amour me fournit mille pensers divers, Et ici n'en puis trouver pour acheuen ce vers.
LYSIS.	LYSIS.
Cét œuure eſt au deſſus de ton ſt yle ordinaire, Ie t’attens au logis, ie crains de te diſtraire;	Cet œuvre est au dessus de ton st île ordinaire, Je t'attends au logis, Se crains de te distraire;
Acheue, cher amy, ie te nuis en ces lieux.	Achève, cher ami, Seigneur te nuis en ces lieux.
Sur tout, exprime bien la douceur de ces yeux,	Sur tout, exprime bien la douceur de ces yeux,
Il s’en va.	Il s'en va.
ALIDOR ſeul, aſſis & appuyé contre vn arbre.	ÀLIDOR seul, assis et appuyé contre un arbre.
Quitte, quitte Alidor, ce penible exercice, De tes pleurs ſeulement eſcry ſon injuſtice;	Quitte, quitte Alidor, ce pénible exercice, De tes pleurs seulement écri son injustice;
Seuls ils peuuent prouuer tes transports innocens;	Seuls ils peuvent prouver tes transports innocents;
Seuls ils peuuent parler des ennuys que tu ſents.	Seuls ils peuvent parler des ennuis que tu sents.
Et c’eſt bien vainement qu’vn malheureux pre ſume De fendre un cœur ſi dur, auec des traits de plume.	Et c'est bien vainement qu'autre malheureux pré me De fendre un cœur si dur, avec des traits de plume.
Iettez, arbres, voyant comme ie bruſle icy, Les pleurs, que vous ietteZ quand vous bruſlez au ßi.	Jettez, arbres, voyant comme je brûle ici, Les pleurs, que vous jettez quand vous brûlez au .
Si d’Amour autrefois vous ſentiſtes la force, Si vous auez, eſté ſans mouſſe et ſans eſcorce;	Si d'Amour autrefois vous sentîtes la force, Si vous avez, été sans mousse et sans écorce;
Tremblez, ſoyez atteints au recit de mes maux:	Tremblez, soyez atteints au récit de mes maux:
Eſt-il quelque mart yre égal à mes trauaux?	Est-il quelque mart ire égal à mes travaux?
Mais que mon œil eſt las de ſouffrir la lumiere:	Mais que mon œil est las de souffrir la lumière:
Quel aſſoupiſſement me ferme la paupiere?	Quel assoupissement me ferme la paupière?
Dieux, appelleZ mon ame, en cét heureux ſommeil;	Dieux, appelez mon âme, en cet heureux sommeil;
Accordez à mes yeux vn dormir ſans réveil.	Accordez à mes yeux un dormir sans réveil.
Il s’eudort.	Il s'eudort.
SCENE TROISIESME, FELICIE.	SCÈNE -TROISIÈME, FELICIE.
CELIMENE.	CELIMENE.
CELIMENE.	CELIMENE.
Ieux!	Jeux!
que ces importuns ont peu de complaiſance?	que ces importuns ont peu de complaisance?
Et qu’il eſt mal-ayſé d’éuiter leur preſence.	Et qu'il est mal-aysé d'éviter leur présence.
Ma ſœur, n’y ſont-ils plus?	Ma sœur, n'y sont-ils plus?
Adieu.	Adieu.
FELICIE.	FELICIE.
Oüy ie les voy là bas.	Oui ici les vois là bas.
CELIMENE.	CELIMENE.
FELICIE.	FELICIE.
Reuiens, ie ris, & ie ne les voys pas.	Reviens, Seigneur ris, et ie ne les vois pas.
CELIMENE.	CELIMENE.
Ie m’ayme aujourd’huy ſeule, & ſi pas vn ſe monſtre.	Je m'aime aujourd'hui seule, et si pas un se montre.
FELICIE.	FELICIE.
Dieux!	Dieux!
quelle peur at-tu?	quelle peur at-tu?
	
CELIMENE.	CELIMENE.
Celle de leur rencontré.	Celle de leur rencontré.
FELICIE.	FELICIE.
Alidor fe deplaiſt?	Alidor se déplaît?
cruelle tu le fuis?	cruelle tu le fuis?
CELIMENE.	CELIMENE.
Par fois ſelon le temps, & l’humeur où ie ſuis, En de certains moments, i’ayme d’ouyr ſes plaintes, Ie luy reſponds des yeux, & ie flatte ſes craintes.	Par fois selon le temps, et l'humeur où je suis, En de certains moments, j'aime d'ouïr ses plaintes, Je avait réponds des yeux, et quelque flatte ses craintes.
Ie vante ſon esprit, i’eſtime ſes diſcours.	Je vante son esprit, j'estime ses discours.
Mais cette bonne humeur ne dure pas touſiours.	Mais cette bonne humeur ne dure pas toujours.
J’abhorre bien ſouuent vn ſi triſte langage, Vn homme plm ſoſenx me piairoit d’auantage.	J'abhorre bien souvent un si triste langage, Un homme plm sosenx me piairoit d'avantage.
PELICIE.	PELICIE.
Tu te peux rendre tel.	Tu te peux rendre tel.
CELIMENE.	CELIMENE.
Comment?	Comment?
FELICIE.	FELICIE.
Paye ce que tu dois à ſa chaſte amitié.	Paye ce que tu dois à sa chaste amitié.
Par ta pitié, Ie le paye à l’amour que ſon amy me porte;	Par ta pitié, Je le paie à l'amour que son ami me porte;
Jmite mon humeur, traite-le de la ſorte.	Imite mon humeur, traite-le de la sorte.
Lyſis, s’il t’en ſouuient, n’eſtoit pas ſi joyeux, Alors que te trouuois ſon abord ennu yeux;	Lysis, s'il t'en souvient, n'était pas si joyeux, Alors que te trouvais son abord ennu yeux;
E C iij En la plus belle humeur il respandoit des larmes.	 Ç En la plus belle humeur il répandait des larmes.
Mais depuis que l’Amour m’a fait rendre les armes;	Mais depuis que l'Amour m'a fait rendre les armes;
Il ne dit plus, ie bruſle;	Il ne dit plus, Seigneur brûle;
il ne dit plus, ie meurs, Et nous rions tous deux, en nos pires humeurs.	il ne dit plus, Seigneur meurs, Et nous rions tous deux, en nos pires humeurs.
Mais i’auiſe Alidor ſous ce diuin feüillage, Voycomme les ennuys ont changé ſon viſage.	Mais j'avise Alidor sous ce divin feuillage, Voicomme les ennuis ont changé son visage.
Le Ciel ferme ſes yeux pour arreſter ſes pleurs, Et tu ne ſeras point ſenſible à ſes douleurs?	Le Ciel ferme ses yeux pour arrêter ses pleurs, Et tu ne seras point sensible à ses douleurs?
Ly ces vers qu’il t'adreſſe.	Li ces vers qu'il t'adresse.
CELIMENE.	CELIMENE.
O Dieux!	Ô Dieux!
cette importune M’imputera touſiours ma mauuaiſe fortune!	cette importune M'imputera toujours ma mauvaise fortune!
FELICIE.	FELICIE.
Eſcoute;	Écoute;
A Celimene.	À Celimène.
CELIMENE.	CELIMENE.
Acheue;	Achève;
i'y conſents.	j'y consens.
FELICIE.	FELICIE.
L’agreable ſuject des ennuys, que ie ſents.	L'agréable sujet des ennuis, que sans sents.
Et bien ay-ie raiſon?	Et bien ai-je raison?
CELIMENE.	CELIMENE.
Ly-toſt, ou ie telaiſſe.	Lis-tôt, ou ainsi telaisse.
FELICIE.	FELICIE.
Qu'elle ſrait bien cacher le tourment qui la preſſe!	Qu'elle srait bien cacher le tourment qui la presse!
Elle lit.	Elle lit.
En fin qu’ordonnez-vous, &c.	En fin qu'ordonnez-vous, etc.
Elle continuë.	Elle continue.
Vois-tu comme ta grace a touché ſes esprits, En compoſant ces vers, le ſommeil l’a ſurpris.	Vois-tu comme ta grâce a touché ses esprits, En composant ces vers, le sommeil l'a surpris.
Par deux mots adjouſtez, tu peux flatter ſa peine, Et perdre enlt fanuunt te titre u inhumaine.	Par deux mots ajoutés, tu peux flatter sa peine, Et perdre enlt fanuunt te titre inhumaine.
CELIMENE.	CELIMENE.
Eſcris-les de ta main.	Écris-les de ta main.
FELICIE.	FELICIE.
La tienne l’a bleßé.	La tienne l'a blesié.
CELIMENE.	CELIMENE.
Bonne-donc, i'eſcriray.	Bonne-donc, j'écrirai.
FELICIE.	FELICIE.
Quoy?	Quoi?
CELIMENE.	CELIMENE.
Qu’il eſt inſenſé.	Qu'il est insensé.
Qu'il a peu de raiſon d’aymer ce qui le bleſſe, Que mon peu de deſſein teſmoigne ſa foibleſſe,	Qu'il a peu de raison d'aimer ce qui le blesse, Que mon peu de dessein témoigne sa foiblesse,
en fin	en fin
FELICIE.	FELICIE.
N'acheue pas, donne-moy cét eſcrit, Bons Dieux?	N'achève pas, donne-moi cet écrit, Bons Dieux?
on ne peut rien ſur ce farouche eſprit!	on ne peut rien sur ce farouche esprit!
Elle eſcrit.	Elle écrit.
Qu’y mets-tu?	Qu'y mets-tu?
CELIMENE.	CELIMENE.
FELICIE.	FELICIE.
Cntaperes	Cntapières
CELIMENE.	CELIMENE.
Eſperances friuoles.	Espérances frivoles.
FELICIE.	FELICIE.
Et ſi, ie te veux faire auoüer ces paroles.	Et si, Seigneur te veux faire auoüer ces paroles.
Ie veux à cét Amant procurer ta pitié;	Je veux à cet Amant procurer ta pitié;
quigneray ta hayne, ou luy ton amitié.	quignerai ta haine, ouï luy ton amitié.
Ie iure a ton humeur vne eternelle guerre.	Je jure a ton humeur une éternelle guerre.
Cruelle as-tus deſſein de dépeupler la terre, Et ſeras-tu conſtante, en ce rigoureux poinct De bleſſer tous les cœurs, & de n’en guerir poinct.	Cruelle as-tus dessein de dépeupler la terre, Et seras-tu constante, en ce rigoureux point De blesser tous les cœurs, et de n'en guérir point.
Eſperes-tu du prix à ta froideur extreſme?	Espères-tu du prix à ta froideur extrême?
Et vaux-je moins que toy pour auouër que i’ayme?	Et vaux-je moins que toi pour avouer que j'aime?
CELI	CELI
CELIMENE.	CELIMENE.
L’amour te paye-t’il du ſoucy que tu prends De le rendre adorable aux cœurs indifferends.	L'amour te paie-t-il du souci que tu prends De le rendre adorable aux cœurs indifférends.
Te charges-tu du ſoin d’eſtablir ſon Empire?	Te charges-tu du soin d'établir son Empire?
Ta voix peut-elle plus, que les traits qu’il nous tire?	Ta voix peut-elle plus, que les traits qu'il nous tire?
Si i’aymois Alidor, il deuroit ſon ſecours A ſon propre merite, & non à tes diſcours.	Si j'aimais Alidor, il devrait son secours À son propre mérite, et non à tes discours.
Son pouuoir t’eſt ſuſpect, prenant pour luyles armes:	Son pouvoir t'est suspect, prenant pour luyles armes:
Et penſant l’obliger, tu fais tort à ſes charmes.	Et pensant l'obliger, tu fais tort à ses charmes.
Son humeur ſeulement a de puiſſants appas, Et peut plus que ta voix.	Son humeur seulement a de puissants appas, Et peut plus que ta voix.
FELICIE.	FELICIE.
Et tu ne t’yrends pas?	Et tu ne t'irends pas?
CEEIMENE.	CEIMENE.
En voudrois-tu iurer?	En voudrais-tu jurer?
FELICIE.	FELICIE.
Ouy, ſi ie te dois croire.	Oui, si belle te dois croire.
CELIMENE.	CELIMENE.
Il peut beaucoup ſans toy, n’oſte rien à ſa gloires	Il peut beaucoup sans toi, n'ôte rien à sa gloires
FELICIE.	FELICIE.
Qu'elle eſt dißimulée!	Qu'elle est dissimulée!
–	
ALIDOR reſuant.	ÀLIDOR rêvant.
Ha!	Ha!
tu ſçais mon tourment.	tu sais mon tourment.
Vnmot, belle inhumaine, vn regard ſeulement.	Unmot, belle inhumaine, un regard seulement.
a auxasas Il reſue, eſcoutons-le.	a auxas Il rêve, écoutons-le.
ALIDOR.	ÀLIDOR.
Ie pourrois toute choſe Tane peux meſchapper, mat quoy que ie propoſe,	Je pourrais toute chose Tane peux méchapper, mat quoi que je propose,
CELIMENE.	CELIMENE.
Ie crains peu cPdanger.	Je crains peu cÉdanger.
ALIDOR.	ÀLIDOR.
Ie tremble à ton aſpect.	Je tremble à ton aspect.
Quoy rien à mon amour?	Quoi rien à mon amour?
quoyrien à mon reſpect?	quoirien à mon respect?
Cruelle, oſte-moy donc ta preſence fatalle, Et ne m'oblige point au tourment de Tantalle:	Cruelle, ôte-moi donc ta présence fatalle, Et ne m'oblige point au tourment de Tantale:
Adieu, laiſſe-moy ſeul.	Adieu, laisse-moi seul.
CELIMENE.	CELIMENE.
Voy combien il me plaiſt:	Vois combien il me plaît:
Ie luy veux obeir, tout endormy qu’il eſt.	Je te veux obéir, tout endormi qu'il est.
FELICIE.	FELICIE.
Cahendons fonteſueit.	Cahendons fontesueit.
CELIMENE.	CELIMENE.
Pour moy ie me retire.	Pour moi vertu me retire.
Et tu m'as obligés à beaucoup de martyre:	Et tu m'as obligez à beaucoup de martyre:
Mais t'apperçois Orante, & quelqu'vn qui la ſuit.	Mais t'aperçois Orante, et quelqu'un qui la suit.
SCENE QVATRIESME, ORANTE.	SCÈNE QUATRIÈME, ORANTE.
FLORIDAN.	FLORIDAN.
CELIMENE.	CELIMENE.
FELICIE.	FELICIE.
Do M ORANTE.	Do M ORANTE.
E l’auiſe à propos, & le Ciel nous conduit.	E l'avise à propos, et le Ciel nous conduit.
Elle parle aux deux Sœurs.	Elle parle aux deux Sœurs.
Nous allions vous tronuer, agreez ia viſite Que ce beau Caualier doit à voſtre merite;	Nous allions vous tronuer, agréez ja visite Que ce beau Cavalier doit à votre mérite;
C'eſt vn de mes nepueux, arriué fraiſchement.	C'est un de mes neveux, arrivé fraîchement.
CELIMENE.	CELIMENE.
Ilm'oblige beaucoup.	Ilm'oblige beaucoup.
FELICIE.	FELICIE.
O Dieux qu’il eſt charmant!	Ô Dieux qu'il est charmant!
FLORIDAN.	FLORIDAN.
Surpris, ſaiſi, confus aupres tant d’excellence, Mon meilleur compliment depend de mon ſilence.	Surpris, saisi, confus auprès tant d'excellence, Mon meilleur compliment dépend de mon silence.
Ie voy d’vn œil charmé vos diuines beauteZ, Et ie croy me treuuer en des lieux enchantez.	Je vois d'une œil charmé vos divines beautés, Et tu crois me trouver en des lieux enchantez.
Ce bois eſt-il, Amour, le ſejour de ta Mere?	Ce bois est-il, Amour, le séjour de ta Mère?
Eſt-ce le bois de Paphe, ou celuy de Cithere.	Est-ce le bois de Paphe, ou celui de Cithère.
Ha!	Ha!
qu’icy ton pouuoir a d’effect ſur les ſens!	qu'ici ton pouvoir a d'effet sur les sens!
Et que ces deux Beautez, te font donner d’Encens.	Et que ces deux Beautés, te font donner d'Encens.
Quentes vehx taraiſvn aa muides armes!	Quentes vehx taraisvn a muides armes!
Qu'on y pouſſe de vœux!	Qu'on y pousse de vœux!
qu’ony reſpand de larmes!	qu'oni répand de larmes!
Et que ma Tante, helast aymoit peu ma ſanté, enors qu'att denon ſonconjenm a porte.	Et que ma Tante, hélât aimait pu ma santé, enors qu'att denon sonconjenm à porte.
CELIMENE.	CELIMENE.
Voſtre diſcours eſt ſain, quoy qu’il nous perſuade, Et ce beau teint n’eſt pas la couleur d’vn malade.	Votre discours est sain, quoi qu'il nous persuade, Et ce beau teint n'est pas la couleur d'un malade.
FLORIDEC Helas!	FLORIDEC Hélas!
ſi la raiſon me manque de ſecours, Que vous verrez changer, mon teint, & mes diſcours;	si la raison me manque de secours, Que vous verrez changer, mon teint, et mes discours;
Uous voir, ſans vous aymer, n’eſt pas vn bien poßible, Ie ne ſuis pas de roche, & ce cœur eſt ſenſible.	Uous voir, sans vous aimer, n'est pas un bien passible, Je ne suis pas de roche, et ce cœur est sensible.
Madame, pardonnez, à ma temerité, Mes vœux ſeront bornez de voſtre volonté.	Madame, pardonnez, à ma témérité, Mes vœux seront bornez de votre volonté.
Vous n’accuſerez, point vne langue indiſcrette, de Jaurayuen ajmer a onc ammement,	Vous n'accuserez, point une langue indiscrette, de Jauraiven ajmer a onc ammement,
CELIMENE.	CELIMENE.
Ie treuue en vos diſcours de ſi charmans appas, Que vous me hayrieZ de ne me parler pas.	Je trouve en vos discours de si charmants appas, Que vous me haïriez de ne me parler pas.
Le ſilence ſied mal aux bouches ſi diſcretes,ouAoru, Et l’on voudroit, Mõſieur, les voir touſiours ouuertes.	Le silence sied mal aux bouches si discrètes,ouAoru, Et l'on voudrait, Monsieur, les voir toujours ouvertes.
FELICIE.	FELICIE.
O Dieux qu’il eſt charmant!	Ô Dieux qu'il est charmant!
FLORIDAN.	FLORIDAN.
Mon ſilence & ma voix, De vos commandemens prendront touſiours des loix:	Mon silence et ma voix, De vos commandements prendront toujours des lois:
Voyant Alidor endormy, il dit.	Voyant Alidor endormi, il dit.
Hhmospomuruiubumnommo maux que tu m'apreſtes, Ie voy deſià (Madame) vne de vos conqueſtes.	Hhmospomuruibumnommo maux que tu m'aprêtes, Je vois déjà (Madame) une de vos conquêtes.
Cipeint vosviumexou umue mes pas, Que voylà qu’à vos pieds ie uoy des gens à bas.	Cypeint vosviumexou umue mes pas, Que voilà qu'à vos pieds ie uoy des gens à bas.
Que cette veuë, helas!	Que cette vue, hélas!
menaçe ma franchiſe, Et que ie ſeray fort ſti'empeſche ma priſe!	menaçe ma franchise, Et que sans serai fort sti'empêche ma prise!
GELIMENE.	GELIMENE.
Ie n’ay point de deſſein ſur voſtre liberté,	Je n'ai point de dessein sur votre liberté,
FLORIDAN Vous me deffendez donc de voir voſtre beauté.	FLORIDAN Vous me défendez donc de voir votre beauté.
12	12
CELIMENE.	CELIMENE.
Vous redoutez, Monſieur, vne foible ennemie.	Vous redoutez, Monsieur, une faible ennemie.
FLORIDAN.	FLORIDAN.
Ie ſens deſià l’effect de ſa force infinie.	Je sens déjà l'effet de sa force infinie.
1osc.	1osc.
lo TELICIE.	lo TELICIE.
Que ſes yeux ſont charmans!	Que ses yeux sont charmants!
que ſa voix a d’attraits!	que sa voix a d'attraits!
CELIMENE.	CELIMENE.
Nous ſouffrons le Soleil, & le logis eſt prés.	Nous souffrons le Soleil, et le logis est près.
Vous plaiſt-ilde le voir?	Vous plaît-ilde le voir?
FLORIDAN.	FLORIDAN.
Acceptez ma conduitte.	Acceptez ma conduite.
ORANTE tout bas.	ORANTE tout bas.
L’heureux effect!	L'heureux effet!
ô Dieux fauoriſez la ſuitte.	ô Dieux favorisez la suitte.
SCENE CINOVTEDME.	SCÈNE CINOUTEDME.
ALIDOR eſueillé.	ÀLIDOR éveillé.
Ommeil heureux charmeur des ennuys que ie ſens, SPourquoy m'at-tu rendu la liberté des ſens?	Ommeil heureux charmeur des ennuis que ici sens, SPourquoi m'at-tu rendu la liberté des sens?
F7, Helas par te faueur ie parlois à Madame, A ſes yeux inhumains i'ay deſcouuert ma flamme.	F7, Hélas par te faveur on parlais à Madame, À ses yeux inhumains j'ai découvert ma flamme.
Et quoy que ſa rigueur eſtouffaſt mon espoir, Ie joüyſſois pourtant du bon-heur de la voir.	Et quoi que sa rigueur étouffât mon espoir, Je joüyssois pourtant du bonheur de la voir.
I’aymalgré ſes efforts ſa belle main preſſée, Cti Xrsasse Joixca ſmase ma penjee;	J'aimalgré ses efforts sa belle main pressée, Cti Xrsasse Joixca smase ma penjee;
De ce bien maintenant mes deſirs ſont priuez:	De ce bien maintenant mes désirs sont privés:
Mais, ô Dieux!	Mais, ô Dieux!
quelle main a ces vers acheuez?	quelle main a ces vers achevez?
Il lit.	Il lit.
Ne finirez-vous point le cours de ma miſere, Dois-je chercher la mort?	Ne finirez-vous point le cours de ma misère, Dois-je chercher la mort?
non, Alidor, espere.	non, Alidor, espère.
Pourrois-je de ſormais voir le Ciel ſans mespris, Si la main de Madame;	Pourrais-je de sormais voir le Ciel sans mépris, Si la main de Madame;
auoit ces mots eſcris?	avait ces mots écris?
Non, Alidor, eſpere;	Non, Alidor, espère;
â Dieux!	â Dieux!
le dois-je croire?	le dois-je croire?
Puis-je ſans vanité me donner cette gloire?	Puis-je sans vanité me donner cette gloire?
Non, quelqu'un qui paſſoit, touché de mon tourment A ces vers acheueZ par diuertiſſement.	Non, quelqu'un qui passait, touché de mon tourment A ces vers achevez par divertissement.
Ie ne me flatte point de ce bon-heur inſigne, L’ozer imaginer, c'eſt en paroiſtre indigne;	Je ne me flatte point de ce bonheur insigne, L'oser imaginer, c'est en paraître indigne;
I'espereray pourtant, & croyray que le Sort Sa ſert de ce moyen pour diuertir ma mort.	J'espérerai pourtant, et crois que le Sort Sa sert de ce moyen pour divertir ma mort.
Ein du ſecond Acte	Ein du second Acte
IA.	IA.
1 C L 1 1 DODETDERAMIERE.	1 Ç L 1 1 DODETDERAMIÈRE.
CELIMENE ſuiuie d’ALIDOR, qui l’entend ſans ſe monſtrer à elle.	CELIMENE suivie d'ALIDOR, qui l'entend sans se montrer à elle.
CELIMENE.	CELIMENE.
EN eſt faict, ma raiſon eſt laſſe, De tenir contre tant de grace;	EN est fait, ma raison est lasse, De tenir contre tant de grâce;
Ider, Mõ courage eſt trop foible, il ne me peut ayEt le dieu des amãts m’a tiré la plus forte, De toutes les fleches qu’il porte.	Ider, Momme courage est trop faible, il ne me peut aiEt le dieu des amants m'a tiré la plus forte, De toutes les flèches qu'il porte.
Et bien ( Amour) il faut ceder.	Et bien ( Amour) il faut céder.
ALIDOR, tout bas.	ÀLIDOR, tout bas.
Dieux!	Dieux!
eſt-ce enma faueur qu’elle tient ce diſcours?	est-ce enma faveur qu'elle tient ce discours?
Puis-je apres tant de maux esperer du ſecours?	Puis-je après tant de maux espérer du secours?
CELIMENE.	CELIMENE.
En fin toſt ou tard ce Dieu touche Et la facille, & la farouche.	En fin tôt ou tard ce Dieu touche Et la facille, et la farouche.
On peut eraindre ſon mal, on le peut retarder;	On peut eraindre son mal, on le peut retarder;
Mais d’eſtre touſiours froide, & dans l’indifference, C’eſt vne friuole eſperance, Et bien, Amour, il faut ceder.	Mais d'être toujours froide, et dans l'indifférence, C'est une frivole espérance, Et bien, Amour, il faut céder.
ALIDOR.	ÀLIDOR.
Amant le plus heureux qui ſoit en l'Vniuers!	Amant le plus heureux qui soit en l'Univers!
Ce diſcours fauorable eſt l’effet de tes vers.	Ce discours favorable est l'effet de tes vers.
CELIMENE.	CELIMENE.
En vain noſtre cœur prend les armes, Contre d'ineuitables charmes, I ſe rend à celuy qui le doit poſſeder, Et l’orgueilleux qu’il eſt, blaſme apres ſa deffaicte, La reſiſtance qu’il a faicte.	En vain notre cœur prend les armes, Contre d'inévitables charmes, I se rend à celui qui le doit posséder, Et l'orgueilleux qu'il est, blâme après sa défaite, La résistance qu'il a faite.
Et bien, Amour, il faut ceder.	Et bien, Amour, il faut céder.
ALIDOR.	ÀLIDOR.
Enfin le Ciel me rit, mes vaux ſont approuueZ:	Enfin le Ciel me rit, mes vaux sont approuvés:
Et ſa main fauorable a mes vers acheuez.	Et sa main favorable a mes vers achevés.
CELIMENE.	CELIMENE.
Toutes nos deffenſes ſont vaines, Et tes loix ſont ſi ſouueraines, Qu'on void meſme des Mieux forcez, de les garder, Il n'eſt ame ſi dure, & ſi pleine deglace, Efbien, aAmont JaulMaer.	Toutes nos défenses sont vaines, Et tes lois sont si souveraines, Qu'on voi même des Mieux forcés, de les garder, Il n'est âme si dure, et si pleine deglace, Efbien, aAmont JaulMaer.
ALIDOR l'abbrdant.	ÀLIDOR l'abrdant.
Abordons-là ſans crainte, obligé deſormais, A vous offrir des vœux, ſi ie le fis iamais.	Abordons-là sans crainte, obligé désormais, À vous offrir des vœux, si iele fis jamais.
Que ie baiſe a genoux ceſte main fauorable, Qui vient de releuer l’eſpoir d’vn miſerable:	Que était baise a genoux cette main favorable, Qui vient de relever l'espoir d'un misérable:
Donc ces beaux yeux ſont las de me voir ſouſpirer?	Donc ces beaux yeux sont las de me voir soupirer?
Donc il m’eſt ordonné de viure & d’esperer?	Donc il m'est ordonné de vivre et d'espérer?
El(comme vn doux Painqueur coferuer ſa conqueſte) Vous auez diuerty la mort qui m'eſtoit preſte?	Elaircomme un doux Painqueur coferver sa conquête) Vous avez diverti la mort qui m'était prête?
Oüy, ie vis, & i'espere vn deſtin plus humain;	Oui, Seigneur vis, et j'espère un destin plus humain;
Puis qu’il faut obeir à cette belle main, 22	Puis qu'il faut obéir à cette belle main, 22
CELIMENL.	CELIMENL.
Quoy, i’ay tracé ces mots?	Quo, j'ai tracé ces mots?
l'a croyance indiſcrette!	l'a croyance indiscrète!
Voyez, comme ayſement on croit ce qu’on ſouhaitte;	Voyez, comme aisément on croit ce qu'on souhaite;
PerdeZ vn peu, Monſieur, de cette vanité, Et ne me loüez point de tant de charité.	Perdez un peu, Monsieur, de cette vanité, Et ne me louez point de tant de charité.
ALIDORRC.	ÀLIDORC.
Voulez-vous plus long-temps prolonger mon ſupplice?	Voulez-vous plus longtemps prolonger mon supplice?
Et vous repentez,-vous d’vn acte de iuſtice?	Et vous repentez,-vous d'un acte de justice?
Suis-je trop peu diſeret pour cacher vos bienfaicts?	Suis-je trop peu disèret pour cacher vos bienfaits?
Quand meſme vous rendrieZ mes deſirs ſatis-faicts;	Quand même vous rendriez mes désirs satî-faits;
Dieuxi qu’à ſe declarer vne fille a de peine.	Dieuxi qu'à se déclarer une fille a de peine.
Vous ne deffendez-pas, qu’on vous nomme inhumaine, Quand ie vous appellois ſourde, ingrate & ſans yeux, C’eſtoit là vous donner des tiltres glorieux, Vous trouuiez des appas en nion Sort lamentable, Et vous vous offencez, du tiltre d’equitable;	Vous ne défendez-pas, qu'on vous nomme inhumaine, Quand ie vous appelais sourde, ingrate et sans yeux, C'était là vous donner des titres glorieux, Vous trouviez des appas en nion Sort lamentable, Et vous vous offensez, du titre d'équitable;
Vous n'ozez, auoüer vne bonne action Que vous auez rendué à mon affection.	Vous n'osez, auoüer une bonne action Que vous avez rendué à mon affection.
CELIMENE.	CELIMENE.
uou puuouuouemuqumnuuijenybonne, Je n'ordonne la vie, & ne l'oſte à perſonne, C’eſt aſſez, Alidor, que chacun ſonge à ſoy, Ie ne conſerue point ce qui n'eſt point à moy.	Çou puuouuouemuqumnuuijenybonne, Je n'ordonne la vie, et ne l'ôte à personne, C'est assez, Alidor, que chacun songe à soi, Je ne conserve point ce qui n'est point à moi.
ALIDOR.	ÀLIDOR.
Mais par la loy d’amour, ie ſuis à Celimene;	Mais par la loi d'amour, je suis à Celimène;
CELIMENE.	CELIMENE.
En n'a iamais eu, n'y d’amour, ny de hayne;	En n'a jamais eu, n'y d'amour, ni de haine;
Vous ſçauez, mon humeur, ie fuis ces paßions Et ie ſuy ſeulement mes inclinations.	Vous savez, mon humeur, je fuis ces passions Et ici suivi seulement mes inclinations.
ALIDOR.	ÀLIDOR.
Quoy touſiours inſenſible;	Quoi toujours insensible;
& ſourde à nos prieres?	et sourde à nos prières?
CELIMENE.	CELIMENE.
Touſiours ferme & cõſtãte en mes humeurs premieres,	Toujours ferme et compte en mes humeurs premières,
ALIDOR.	ÀLIDOR.
Vn peis moins qu’autrefois?	Un péis moins qu'autrefois?
CELIMENE.	CELIMENE.
Touſiours egalement.	Toujours également.
ALIDOR.	ÀLIDOR.
Aidorn'eſt pas ſourd.	Aidorn'est pas sourd.
CELIMENE.	CELIMENE.
Ny moy pareillemente.	Ni moi pareillemente.
ALIDOR.	ÀLIDOR.
Non, car vous m’entendez:	Non, car vous m'entendez:
Adieu, viuez heureuſe, Soyez impitoyable à ma peine amoureuſe, Eſtouffez tout l’eſpoir qui me peut ſecourir, Ie porte à moncoſté le moyen de guerir.	Adieu, vivez heureuse, Soyez impitoyable à ma peine amoureuse, Étouffez tout l'espoir qui me peut secourir, Je porte à moncosté le moyen de guérir.
1a Ils'enva	1a Ils'enva
CELIMENE ſeule.	CELIMENE seule.
O Dieux!	Ô Dieux!
cét importun a ma voix entenduë, Alors que i’auouoys que ie me ſuis renduë.	cet importun a ma voix entendue, Alors que j'auouoys que ici me suis rendue.
Il a receu pourluy cette confeßion, Et croit eſtre l’obiect de mon affection.	Il a reçu pourlui cette confession, Et croit être l'objet de mon affection.
Mais las !	Mais las !
quoy que ie doiue à ſon amour extreſme,i H'eſt bien abuzé, quand il croit que ie l’ayme;	quoi que ici doive à son amour extrême, HI est bien abuzé, quand il croit que ie aime.
Vn amant bien plus rare occupe mes eſprits, Il me demande vn cœur, qu’vn autre a de ſia pris;	Un amant bien plus rare occupe mes esprits, Il me demande un cœur, qu'un autre a de zia pris;
Floridan l’a forcé, mais auec tant de gloire, Qu’il n’a que d’vn moment acheté ſa victoire:	Floridan l'a forcé, mais avec tant de gloire, Qu'il n'a que d'un moment acheté sa victoire:
Et qu’ayant iuſqu’icy meſpriſé tant d’amours le mnt renus uunppaxut fespremtrs urfcours;	Et qu'ayant jusqu'ici méprisé tant d'amours le mennt renus unpaxut fespremtrs urfours;
uluns qmunau omcreurte yymes pins onures penſées Par cét autre importun ſont touſiours trauerſées.	uluns qmunau omcreurte yymes pins onures pensées Par cet autre importun sont toujours traversées.
	
SCENE DEVXIESME.	SCÈNE DEUXIÈME.
FILANDRE.	FILANDRE.
VIvons nena fipenpuer	VIvons nena fipenpuer
GELIMENE.	GELIMENE.
Vn autre obiect que vous.	Un autre objet que vous.
Alidor ou Tircis, EILANDRE.	Alidor ou Tircis, EILANDRE.
CELIMENE, Non, vn obiect plus doux, u	CELIMENE, Non, un objet plus doux, 
Contraste insuffisant NF Z 43-120-14	Contraste insuffisant NIN Z 43-120-14
Pagination incorrecte - date incorrecte NF2 43-120-12	Pagination incorrecte - date incorrecte N2 43-120-12
Paris, ou Filidor?	Paris, ou Fidor?
FILANDRE.	FILANDRE.
CELIMENE.	CELIMENE.
Nons	Nons
ETLANDRE.	ETLANDRE.
Timandre, ou Geronde?	Timandre, ou Géronde?
CELIMENE.	CELIMENE.
Vvus les pourrieZ trouuer en nommant tout le monde.	Veuvus les pourriez trouver en nommant tout le monde.
FILANDRE.	FILANDRE.
Que i’apprenne ſon nom, & mes vœux ſont contens.	Que j'apprenne son nom, et mes vœux sont contents.
CELIMENE.	CELIMENE.
Adieu, deuinez-le, ie vous donne du temps.	Adieu, devinez-le, je vous donne du temps.
FILANDRE l’arreſtant.	FILANDRE l'arrêtant.
Vn mot, belle inhumaine, vn certain Gentil-homme Nommé Flo.	Un mot, belle inhumaine, un certain Gentilhomme Nommé Flo.
Floridan, c’eſt ainſi qu’il ſe nomme;	Floridan, c'est ainsi qu'il se nomme;
Venu depuis deux iours en ces lieux écartez, N'a-t’il point ſalüé vos diuines beautez?	Venu depuis deux jours en ces lieux écartés, N'a-t-il point salué vos divines beautés?
CELIMENE.	CELIMENE.
Il en a pris la peine.	Il en a pris la peine.
FILANDRE.	FILANDRE.
2 Eſt-il fort agreable?	2 Est-il fort agréable?
CELIMENE.	CELIMENE.
C'eſt vn homme diuin, charmant, incomparable;	C'est un homme divin, charmant, incomparable;
ETLANDRE.	ETLANDRE.
On en faict de l’eſtat.	On en fait de l'état.
SELIMENE.	SELIMENE.
Il eſtla vertu meſme.	Il estlà vertu même.
Uous parlez froidement.	Uous parlez froidement.
FILANDRE.	FILANDRE.
En vn mot voſtre amant.	En un mot votre amant.
CELIMENE.	CELIMENE.
Filandre, parlez, mieux, vous rire, & me deſplaire, Ne ſont pas les moyens d’auançer voſtre affaire, On arriue autrement à noſtre affection Que par la raillerie & l’indiſcretion.	Filandre, parlez, mieux, vous rire, et me déplaire, Ne sont pas les moyens d'auançer votre affaire, On arrive autrement à notre affection Que par la raillerie et l'indiscrétion.
Il eſt vray que la mienne, eſt vn but où Filandre Auec tous ſes efforts, eſt bien fou de pretendre.	Il est vrai que la mienne, est un but où Filandre Avec tous ses efforts, est bien fou de prétendre.
ILANDRE Adieu, car ie l’auiſe;	ILANDRE Adieu, car apprendre l'avise;
ô Dieu qu’il eſt charmant.	ô Dieu qu'il est charmant.
Plus que vous.	Plus que vous.
FILANDRE.	FILANDRE.
Ie le croy.	Je le crois.
CELIMENE.	CELIMENE.
Mais plus infiniment.	Mais plus infiniment.
FILANDRE, s’en allant dit à Floridan.	FILANDRE, s'en allant dit à Floridan.
On aftend voſtre veue auecimpatience	On aftend votre vue avecimpatience
FLORIDAN tout bas.	FLORIDAN tout bas.
Filandre ſe cache & les entend.	Filandre se cache et les entend.
Aciniu juiopuroureyanme, ſans conſcience.	Aciniv juiopuroureyanme, sans conscience.
SCENE TROISIESME, FLORIDAN, CELIMENE.	SCÈNE -TROISIÈME, FLORIDAN, CELIMENE.
CELIMENE.	CELIMENE.
VE Floridan eſt triſte!	VE Floridan est triste!
FLORIDAN.	FLORIDAN.
Et qu’il l’eſt iuſtement.	Et qu'il l'est justement.
Ha!	Ha!
ſejour mal-heureux	séjour malheureux
CELI	CELI
CELIMENE.	CELIMENE.
O Dieux quel changement:	Ô Dieux quel changement:
Ces plaines que tantoſt vous auez, tant priſées, Et que vous preferiez, aux riues Elyſées, N'ont-eues pasencorleur premiere beauté?	Ces plaines que tantôt vous avez, tant prisées, Et que vous préfériez, aux rives Elysées, N'ont-eues pasencorleur première beauté?
D’où vient à voſtre humeur cette inegalité?	D'où vient à votre humeur cette inégalité?
FLORIDAN.	FLORIDAN.
Que ce lieu ſoit charmant, qu’il ſoit incomparable, Madame, ſa beaute m'eſt peu conſiderable:	Que ce lieu soit charmant, qu'il soit incomparable, Madame, sa beauté m'est peu considérable:
Ce ſont des appas morts, ſubiects au moindre vent, uiquiionemnttes jeua, ſuns puſer pius auant;	Ce sont des appas morts, sujets au moindre vent, uiquiionemnttes jeua, suns puser pius ant;
Mais i’en treuue,	Mais j'en trouve,
CELIMENE.	CELIMENE.
AcheueZ	Achevez
FLORIDAN.	FLORIDAN.
Helas!	Hélas!
que puis-je dire?	que puis-je dire?
Si ie n’oze parler, & ſi ie le de ſire?	Si ici n'ose parler, et si tu le de sire?
CELIMENE.	CELIMENE.
Et que deuez-vous taire, où tout vous eſt permis?	Et que devez-vous taire, où tout vous est permis?
FLORIDAN.	FLORIDAN.
Que diray-je plutoſt deuant mes ennemis!	Que dirai-je plutôt devant mes ennemis!
CELIMENE.	CELIMENE.
Enante-vomley;	Enante-vomley;
FLORIDAN.	FLORIDAN.
De puiſſants, d’indomptables, Et dont les coups mortels me ſont ineuitables.	De puissants, d'indomptables, Et dont les coups mortels me sont inévitables.
I'ay touſiours ſouhaitté de viure en ces deſerts, yener tuou aurepos, O teſt puie le perds.	J'ai toujours souhaité de vivre en ces déserts, yener tuou aurepos, Ô test puie le perds.
Ie ne puis oppoſer, ny deffenſe, nylarmes, uftunove paue ue moueu ucleurs armes.	Je ne puis opposer, ni deffense, nilarmes, uftunove paue ue moueu ucleurs armes.
CELIMENE.	CELIMENE.
Qui donc vous peut ſeruir en ce cuiſant ſoucy?	Qui donc vous peut servir en ce cuisant souci?
Vous ſeulle.	Vous seulle.
alu ses	alu ses
CELIMENE.	CELIMENE.
Contre qui?	Contre qui?
FLORIDAN.	FLORIDAN.
Contre vous ſeule außi:	Contre vous seule aussi:
CELIMENE.	CELIMENE.
ParleZ plus clairement.	Parlez plus clairement.
.	.
.	.
	
FLORIDAN.	FLORIDAN.
Diuin charme des ames!	Divin charme des âmes!
Adorable ſubiect de mes nouuelles flammes!	Adorable sujet de mes nouvelles flammes!
Mais faut-il acheuer?	Mais faut-il achever?
à quoy tant de propos?	à quoi tant de propos?
Et bien, ce ſont vos yeux qui troublent mon repos.	Et bien, ce sont vos yeux qui troublent mon repos.
Ces diuins ennemis attaquent ma penſée, Et leurs premiers regards ont ma raiſon forcée.	Ces divins ennemis attaquent ma pensée, Et leurs premiers regards ont ma raison forcée.
Pardonnez, toutes fois à ma temerité, Ma raiſon garde encor de ſon authorité;	Pardonnez, toutes fois à ma témérité, Ma raison garde encor de son autorité;
Et me peut contenir dans l’eſtroicte limite Qu’impoſe à mon amour, voſtre rare merite.	Et me peut contenir dans l'étroite limite Qu'impose à mon amour, votre rare mérite.
En mes plus vifs accez, ie ne me plaindray pas, Et pour voſtre repos i’euiteray vos pas.	En mes plus vifs accès, je ne me plaindrai pas, Et pour votre repos j'éviterai vos pas.
Ie n'augmenteray point cette trouppe importune, Dont vous tenez en main l’espoir & la fortune.	Je n'augmenterai point cette troupe importune, Dont vous tenez en main l'espoir et la fortune.
Ie ne reclameray ny vos vœux, ny vos ſoins, Je ſçauray mieux aymer, & le teſmoigneray moins.	Je ne réclamerai ici vos vœux, ni vos soins, Je saurai mieux aimer, et le témoignerai moins.
C’eſt deſià trop parler, Dieux quelle ardeur me preſſe!	C'est déjà trop parler, Dieux quelle ardeur me presse!
Que meſme en promettant i'enfraigne ma promeſſe!	Que même en promettant j'enfraigne ma promesse!
CELIMENE.	CELIMENE.
Las!	Las!
d’exercer ailleurs ceſte eloquente voix, La venez, vous (Monſieur )'exercer dans ces bois?	d'exercer ailleurs cette éloquente voix, La venez, vous (Monsieur ) exercer dans ces bois?
Eſpargnés nos esprits dont les mœurs inciuiles, Ont bien peu de rapport auec celles des villes.	Espargnés nos esprits dont les mœurs inciviles, Ont bien peu de rapport avec celles des villes.
H ij Et ne m’obligez point aux meſmes complimens, Que celles de Paris rendent à leurs amants:	H Haj Et ne m'obligez point aux mêmes compliments, Que celles de Paris rendent à leurs amants:
Iut jui vient mal fondeZ, & ie reçoy les voſtres Comme vn propos commun que vous teneZ à d’autres.	Iut jui vient mal fondez, et ainsi reçois les vôtres Comme un propos commun que vous tenez à d'autres.
FLORIDAN, feignant de s’en aller.	FLORIDAN, feignant de s'en aller.
I’ay promis de me taire.	J'ai promis de me taire.
Adieu;	Adieu;
mais quelque iour, On ne vous verra plus douter de mon Amour.	mais quelque jour, On ne vous verra plus douter de mon Amour.
CLLEMLICL.	CLLEMLICL.
Non, non, encor un mot;	Non, non, encor un mot;
ô Dieuxiqu’il ſçait biẽ feindret On diroit qu'en effet ſon cœur ſe laiſſe atteindre.	ô Dieuxiqu'il sçait bien feindret On dirait qu'en effet son cœur se laisse atteindre.
FLORIDAN.	FLORIDAN.
Il eſt atteint deſià, Madame, & permettez, Puis que ma voix vous plaiſt, & que vous l’eſcoutez, Que i’atteſte le Ciel, & toute la nature, Que vous eſtes l’object du tourment que i’endure.	Il est atteint déjà, Madame, et permettez, Puis que ma voix vous plaît, et que vous l'écoutez, Que j'atteste le Ciel, et toute la nature, Que vous êtes l'object du tourment que j'endure.
Si vous n’aués cauſé la miſere où te ſuis, Si voſtre occaſion ne fait tous mes ennuys, Si ie cognois que vous, pour ſujet de ma peine, Puiſſay-je eſtre des Dieux, & t'norteur O ta haine;	Si vous n'avez causé la misère où te suis, Si votre occasion ne fait tous mes ennuis, Si ie connais que vous, pour sujet de ma peine, Puissai-je être des Dieux, et t'norteur Ô ta haine;
Et qu'apres mille morts, vne eternelle mort, Faſſe endurer mon ame, & deplorer mon ſort:	Et qu'après mille morts, une éternelle mort, Fasse endurer mon âme, et déplorer mon sort:
Mais que ie pouſſe en l’air d’inutiles paroles, Vous tiendrés mes ſermens, pour des ſermẽts friuolles!	Mais que ici pousse en l'air d'inutiles paroles, Vous tiendrés mes serments, pour des serments frivolles!
Car on dit que les Dieux, impoſant des tourmens N en oruumerent puint anx paiſures Amants.	Car on dit que les Dieux, imposant des tourments N en orvumèrent puint anx paisures Amants.
CELIMENE.	CELIMENE.
C’eſt qu’ils n’en treuuent point d’égaux à leur offence, Et ce poinct ſeulement a borné leur puiſſance.	C'est qu'ils n'en trouvent point d'égaux à leur offense, Et ce point seulement a borné leur puissance.
Le traiſtre, & l’homicide ont leur peine aux enfers, L’impie & le volleur, ont leurs feux, & leurs fers.	Le traître, et l'homicide ont leur peine aux enfers, L'impie et le volleur, ont leurs feux, et leurs fers.
On ne peut euiter la ſupreſme iu ſtice, Qui touſiours au forfaict meſure le ſupplice.	On ne peut éviter la suprême ju stice, Qui toujours au forfait mesure le supplice.
Mais vn parjure Amant a faict vne action, Qui n’a point de meſure & de proportion.	Mais un parjure Amant a fait une action, Qui n'a point de mesure et de proportion.
Une eternelle flame eſt pour luy trop humaine, L’excés de ſon peché le ſauue de la peine.	Une éternelle flamme est pour venir trop humaine, L'excès de son péché le sauve de la peine.
Au ßi quel honneſte homme a ces crimes conceus.	Au ssi quel honnête homme a ces crimes conçus.
Mais allons au chaſteau diſcourir la deſſus.	Mais allons au château discourir la dessus.
Le Soleil en ces lieux ne laiſſe plus d’ombrage.	Le Soleil en ces lieux ne laisse plus d'ombrage.
FLORANTE.	FLORANTE.
Que ie reçois d’honneur!	Que quelque reçois d'honneur!
CELIMENE.	CELIMENE.
I’en reçois dauantage	J'en reçois davantage
H iij	H Hijà
SCENE QVATRIESME.	SCÈNE QUATRIÈME.
FILANDRE ſeul les ayant eſcoutez.	FILANDRE seul les ayant écoutez.
Ieux!	Jeux!
auec quelle grace elle fait le tranſit, DCelimene eſt touchée, & ie le ſuis außi.	avec quelle grâce elle fait le transit, DCelimène est touchée, et Seigneur le suis aussi.
Il n'eſt rien de pareil à ſon rare merite, Contre moy-meſme en fin, moy-meſme ie m’irrite.	Il n'est rien de pareil à son rare mérite, Contre moi-même en fin, moi-même un m'irrite.
Peſant ces qualitez, d’vn esprit plus raßis, Ie n'aurois pas changé mes roſes en ſoucys, Elle preſideroit à ma flame amoureuſe, Et ma condition ſeroit encore heureuſe;	Pesant ces qualités, d'un esprit plus rassis, Je n'aurais pas changé mes roses en soucis, Elle présiderait à ma flamme amoureuse, Et ma condition serait encore heureuse;
Mais que veut Felicie?	Mais que veut Félicie?
SCENE CINQVIESME.	SCÈNE CINQUIÈME.
FILANDRE.	FILANDRE.
FELICIE cherchant ſa ſœur.	FELICIE cherchant sa sœur.
FELICIE.	FELICIE.
CLLE n’eſt pas icy.	CLLE n'est pas ici.
FILANDRE.	FILANDRE.
Que cherchez-vous?	Que cherchez-vous?
FELICIE.	FELICIE.
Ma ſœur.	Ma sœur.
FILANDRE.	FILANDRE.
Elle a bien du ſoucy!	Elle a bien du souci!
FELICIE.	FELICIE.
Et d’où luy prouient-il?	Et d'où beau provient-il?
FILANDRE.	FILANDRE.
D'amour.	D'amour.
FELICIE.	FELICIE.
Qu'elle vous porte?	Qu'elle vous porte?
FILANDRE.	FILANDRE.
Non, ie ſerois bien vain de parler de la ſorte, Car iamais vn regard ny la moindre action, Ne m'a faict eſperer ſon inclination.	Non, Seigneur serais bien vain de parler de la sorte, Car jamais un regard ni la moindre action, Ne m'a fait espérer son inclination.
A qui donc?	À qui donc?
FELICIE.	FELICIE.
FILANDRE.	FILANDRE.
A l’object le plus parfaict du monde, Pont l’eſprit eſt charmant,la beauté ſans ſeconde.	À l'object le plus parfait du monde, Pont l'esprit est charmant,la beauté sans seconde.
En fin à Floridan,	En fin à Floridan,
FELICIE.	FELICIE.
Qui vous l’a dit?	Qui vous l'a dit?
FILANDRE.	FILANDRE.
Leur voix, metons uena puiſemmenc uis fortent de ce bois.	Leur voix, métons ouvena puisemmenc is sortent de ce bois.
Ces fueillages eſpais me cachoient à leur veuë, Et i’ay fortclairement Celimene entenduë.	Ces fueillages épais me cachaient à leur vue, Et j'ai fortclairement Celimène entendue.
FELICIE.	FELICIE.
Qu’vn jaloux a de peine, il croit tout ce qu’il craint?	Qu'un jaloux a de peine, il croit tout ce qu'il craint?
TILANDRE.	TILANDRE.
Uos yeux vous diront mieux ſi ſon cœur eſt atteint.	Uos yeux vous diront mieux si son cœur est atteint.
Adieu, craignés vous meſme vne pareille peine, Puis qu’il a bien touché cette belle inhumaine.	Adieu, craignez -vous même une pareille peine, Puis qu'il a bien touché cette belle inhumaine.
Il s’en va,	Il s'en va,
Que	Que
FELICIE ſeule.	FELICIE seule.
O conſeil inutile à mon cœur languiſſant!	Ô conseil inutile à mon cœur languissant!
On ne craint plus vn mal, alors qu’on le reſſent.	On ne craint plus un mal, alors qu'on le ressent.
Cét aymable vainqueur a mon ame charmée.	Cet aimable vainqueur a mon âme charmée.
O ſupreſme mal-heur!	Ô suprême malheur!
ma ſœur en eſt aymée.	ma sœur en est aimée.
Et ſa rare beauté me deffend d’esperer Le fruict de le cherir & de le reuerer.	Et sa rare beauté me défend d'espérer Le fruit de le chérir et de le révérer.
Que n’ay-je ſes attraits?	Que n'ai-je ses attraits?
pourquoy nature auare, Ne me puis-je vanter d’vn viſage außi rare?	pourquoi nature avare, Ne me puis-je vanter d'un visage aussi rare?
Que ne l’ay-je pourueu d’vne égalle douceur?	Que ne l'ai-je pourvu d'une égale douceur?
Cruelle, deuois-tu dauantage à ma ſœur?	Cruelle, devais-tu davantage à ma sœur?
Ie le carreſſerois, il m’ouuriroit ſon Ame, Ie le diuertirois de ſa premiere flame.	Je le carresserais, il m'ouvrirait son Âme, Je le divertirais de sa première flamme.
D'un deſir mutuel nos cœurs ſeroient atteints, Je trahirois ma ſœur, ie romprois ces deſſeins.	D'un désirais mutuel nos cœurs seraient atteints, Je trahirais ma sœur, Seigneur romprais ces desseins.
Oüy;	Oui;
Mais qu’auroit Lyſis?	Mais qu'aurait Lysis?
que dois-je à ſa conſtance?	que dois-je à sa constance?
Sont-ce là ces ardeurs & cette reſiſtance?	Sont-ce là ces ardeurs et cette résistance?
Où nos vœux mutuels obligent nos esprits.	Où nos vœux mutuels obligent nos esprits.
Un autre me peut-hejeute quumapru?	Un autre me peut-héjute quumapru?
O friuole diſcours!	Ô frivole discours!
ie ſuy ce qui m'attire;	Ne suis ce qui m'attire;
Ce n'eſt pas mon deſſein qui fait ce doux martyre;	Ce n'est pas mon dessein qui fait ce doux martyre;
Et la nece ßité d’eſtimer ce qui plaiſt, Excuſe mon eſprit tout vollage qu’il eſt.	Et la nece ssité d'estimer ce qui plaît, Excuse mon esprit tout volage qu'il est.
LYSIS la ſurprenant.	LYSIS la surprenant.
U ſongeoit mon ſoucy?	V songeait mon souci?
SCENE SIXIESME.	SCÈNE SIXIÈME.
LYSIS.	LYSIS.
FELICIE.	FELICIE.
FELICIE.	FELICIE.
Ie ſongeois à vous-meſme.	Je songeais à vous-même.
LYSIS.	LYSIS.
Que ie ſuis redeuable à ton amour extreſme;	Que ie suis redevable à ton amour extrême;
Combien tu faits d’efforts pour vn indigne Amant, Et que peu de ton ſexe ayment ſi conſtamment.	Combien tu faits d'efforts pour un indigne Amant, Et que peu de ton sexe aiment si constamment.
Mille font vanité du tiltre de parjure, Ce nom eſt maintenant vne honnorable injure, Toutes changent ſans honte, & ta ſeulle beauté, Ade l’auerſion pour l’infidelité;	Mille font vanité du titre de parjure, Ce nom est maintenant une honorable injure, Toutes changent sans honte, et ta seulle beauté, Ade l'aversion pour l'infidélité;
Mais ie ne te vois poinct en l’humeur ordinaire, Et meſme des l’abord, i’ay ſemblé te d’eſplaire.	Mais ici ne te vois point en l'humeur ordinaire, Et même des l'abord, j'ai semblé te d'éplaire.
imporinnayieieys	imporinnayieieys
FELICIE.	FELICIE.
Ie ne m'y tiendrois pas	Je ne m'y tiendrais pas
LYSIS.	LYSIS.
Qtiqnt foncypout iant tnunge tes doux appas;	Qtiquent foncipout jant tunge tes doux appas;
Tu me voys à regret,veux-tu que ie le die?	Tu me vois à regret,veux-tu que ie le die?
Ie croy que ton amour eſt un peu refroidie.	Je crois que ton amour est un peu refroidie.
FELICIE.	FELICIE.
Ie rirois comme toy, mais vn mal de coſté;	Je rirais comme toi, mais un mal de côté;
LYSIS.	LYSIS.
Dy que ton humeur ſouffre, & non pas ta ſanté.	Dis que ton humeur souffre, et non pas ta santé.
On laiſſe rarement promener des malades, (des, Leurs chambres, & leurs lits bornent leurs promena Tu tiens les yeux baißés, tu parles froidement.	On laisse rarement promener des malades, (des, Leurs chambres, et leurs lits bornent leurs promena Tu tiens les yeux baissés, tu parles froidement.
O le jaloux esprit!	Ô le jaloux esprit!
FELICIE.	FELICIE.
LYSIS.	LYSIS.
Peut eſtre iuſtement.	Peut être justement.
FELICIE.	FELICIE.
A Dieu, mon mal s’accroiſt.	À Dieu, mon mal s'accroît.
LYSIS.	LYSIS.
Ie te ſuy,	Je te suis,
FELICIE.	FELICIE.
Non demeure, Permets-moy ſeulement de repoſer vne heure, Peut eſtre en ce ſommeil, mon mal s'appaiſera.	Non demeure, Permets-moi seulement de reposer une heure, Peut être en ce sommeil, mon mal s'apaisera.
Ie ne te quitte point.	Je ne te quitte point.
LYSIS.	LYSIS.
FELICIE.	FELICIE.
Fay ce qu’il te plaira.	Fais ce qu'il te plaira.
LYSIS la conduiſant, dit tout bas.	LYSIS la conduisant, dit tout bas.
O Dieux!	Ô Dieux!
diuertiſſés les ſubiects de ma crainte, Et ne trahiſſés pas, vne amitié ſi ſaincte.	divertissez les sujets de ma crainte, Et ne trahissés pas, une amitié si sainte.
A C T 27 * SCENETREMIERE.	À Ç T 27 * SCENETREMIÈRE.
FELICIE.	FELICIE.
FLORIDAN.	FLORIDAN.
FELICIE.	FELICIE.
VE Floridan ſçait bien feindre des paßions!	VE Floridande sais bien feindre des passions!
O Dieux!	Ô Dieux!
comme il contraint toutes ſes actions!	comme il contraint toutes ses actions!
Auec combien d’adreſſe, & combien d’artifice, Il promet à mes vœux un fidelle ſeruice?	Avec combien d'adresse, et combien d'artifice, Il promet à mes vœux un fidèle service?
Le plus iudicieux à le voir ſi tranßy Croyroit que mon ſubiect luy cauſe vn vray ſoucy.	Le plus judicieux à le voir si transix Croyroit que mon sujet même cause un vrai souci.
Que la franchiſe eſt rare, en ce ſiecle où nous ſommes!	Que la franchise est rare, en ce siècle où nous sommes!
La feinte ſeullement eſt la vertu des hommes.	La feinte seullement est la vertu des hommes.
L’Amour eſtoit iadis le Roydes immortels:	L'Amour était jadis le Roydes immortels:
Au Cielcomme en la terre, il auoit des Autels, On reueroit ſes loix, on craignoit ſa puiſſance, Et ſes pires ſubjets viuoient dans l’innocence;	Au Cielcomme en la terre, il avait des Autels, On révérait ses lois, on craignait sa puissance, Et ses pires sujets vivaient dans l'innocence;
Mais ce Dieu deſormais eſt vn nom ſeulement Et nous voyons à peine vn veritable amant.	Mais ce Dieu désormais est un nom seulement Et nous voyons à peine un véritable amant.
L’vn pour paſſer le temps, ſe fait vne maiſtreſſe, L’autre pour ſignaler ſa grace, & ſon adreſſe.	L'un pour passer le temps, se fait une maîtresse, L'autre pour signaler sa grâce, et son adresse.
L com par cimtte, lautre parimere, En fin tous ſont Amants, & ſi pas vn ne l’eſt.	L com par cimtte, lautre parimère, En fin tous sont Amants, et si pas un ne l'est.
FLORIDAN.	FLORIDAN.
Ie vous atteſte ô Dieux!	Je vous atteste ô Dieux!
Mais qu’eſt-il neceſſaire De prouuer par ſermens vne flame ſi claire?	Mais qu'est-il nécessaire De prouver par serments une flamme si claire?
Pouuez,-vous iuſtement douter de mon amour?	Pouvez,-vous justement douter de mon amour?
Ne la voyez-vous pas, ſi vous voyez, le iour.	Ne la voyez-vous pas, si vous voyez, le jour.
FELICIE.	FELICIE.
Oüy, quelques paßions deſſus ce front ſont peintes, Vous ſouspireZ par fois, & vous pouſſez, des pleintes.	Oui, quelques passions dessus ce front sont peintes, Vous soupirez par fois, et vous poussez, des pleintes.
Si ie croy vos diſcours, vous eſtes tout de feu En fin vous feignés bien, ou vous aymés vn peu.	Si personne crois vos discours, vous êtes tout de feu En fin vous feignez bien, ou vous aimez un peu.
Mais vous me repaiſſés d’vn espoir inutile, Vous n'en aymez, pas vne, ou vous en aymés milleZ.	Mais vous me repaissez d'une espoir inutile, Vous n'en aimez, pas une, ou vous en aimez milleZ.
Vous tenez à ma ſœur, de ſemblables diſcours.	Vous tenez à ma sœur, de semblables discours.
Ie vous ay veu moy-meſme implorer ſon ſecours.	Je vous ai vu moi-même implorer son secours.
FLORIDAN.	FLORIDAN.
O la foible raiſont ſi vous y prenés garde, Luy parlay:	Ô la faible raisont si vous y prenez garde, Lui parlai:
ie iamais, que te ne vous regarde?	Ne jamais, que te ne vous regarde?
I iij Si ma voix parle bien, mes regards parlent mieux, Ou vous entendés mal le langage des yeux?	I Ij à ma voix parle bien, mes regards parlent mieux, Ou vous entendez mal le langage des yeux?
Luy jurant que ie ſens des ardeurs ſi parfaictes, Mon œil vous dit-il pas, que c’eſt vous qui les faictes.	Lui jurant que Seigneur sens des ardeurs si parfaites, Mon œil vous dit-il pas, que c'est vous qui les faites.
Alors qu’on ayme bien, ſouffre-t’on des teſmoins?	Alors qu'on aime bien, souffre-t-on des témoins?
Craindrois-je qu'on nous veiſt, ſi ie vous aymois moins?	Craindrais-je qu'on nous vit, si ici vous aimais moins?
Non, ie ne tiendrois pas mon Amour ſi ſecrette, Et ie vous traitterois ainſi que ie la traicte.	Non, Seigneur ne tiendrais pas mon Amour si secrète, Et ici vous traiterais ainsi que m on traite.
LYSIS, caché auec Alidor.	LYSIS, caché A Lidor.
Dieuas qu'eſtte que Pemtendss	Dieuas qu'estte que Pemtendss
ALIDOR.	ÀLIDOR.
Vos affaires vont mal.	Vos affaires vont mal.
LYSIS.	LYSIS.
Prepare-toy mon bras à punir ce riual.	Prépare-toi mon bras à punir ce rival.
FELICIE.	FELICIE.
Les effects, Floridan, prouueront vos promeſſes;	Les effets, Floridan, prouveront vos promesses;
Faictes-luy cependant vn peu moins de carreſſes.	Faites-lui cependant un peu moins de carresses.
Si vous l’aymez ſi peu ne luy parlez point tant, Elle a des qualiteZ à faire vn inconſtant.	Si vous l'aimez si peu ne lui parlez Roi tant, Elle a des qualité à faire un inconstant.
Toute froide qu’elle eſt, ie ſçay qu'elle vous priſe, Et ne craindroit pas fort de me rauir ma priſe.	Toute froide qu'elle est, Seigneur sais qu'elle vous prise, Et ne craindrait pas fort de me ravir ma prise.
Adieu.	Adieu.
3	3
FLORIDAN.	FLORIDAN.
Ie vous conduicts.	Je vous conduits.
FILICIE.	FILICIE.
Non, retournez, cheZ vous, Ne faiſons point d’ombrage à céteſprit jaloux,	Non, retournez, chez vous, Ne faisons point d'ombrage à cétesprit jaloux,
FEORIDAN.	FEORIDAN.
fe vous obey donc,	se vous obéi donc,
LYSIS.	LYSIS.
Dieux!	Dieux!
qui l’euſt iugé d’elle!	qui l'eût jugé d'elle!
FELICIE, s’en allant:	FELICIE, s'en allant:
C’eſt me bien obeyr, que de m’eſtre fidelle.	C'est me bien obéir, que de m'être fidèle.
FLORIDAN.	FLORIDAN.
Ie renonce, Madame, au bien de la clarté, --.	Je renonce, Madame, au bien de la clarté, --.
SCENE DEVXIESME.	SCÈNE DEUXIÈME.
LYSIS.	LYSIS.
ALIDOR.	ÀLIDOR.
FLORIDAN.	FLORIDAN.
LYSIS, tirant ſon elpée.	LYSIS, tirant son elpée.
Aut en voir vn effect, traitre, tu deliberes,	Aut en voir un effet, traître, tu délibères,
1 Que voulez-vous?	1 Que voulez-vous?
FLORIDAN.	FLORIDAN.
LYSIS.	LYSIS.
Finir ta vie, & nos miſeres, Lâche, & vil ſuborneur des Eſprits de ces lieux,	Finir ta vie, et nos misères, Lâche, et vil suborneur des Esprits de ces lieux,
FLORIDAN.	FLORIDAN.
Qui vous fait ces rapports?	Qui vous fait ces rapports?
1513.	1513.
Tu conſultes encores?	Tu consultes encore?
Mon oreille, & mes yeux.	Mon oreille, et mes yeux.
FLORIDAN, ſans tirer l'eſpée.	FLORIDAN, sans tirer l'épée.
Arreſte, cette eſpée Ne fuſt iamais en vain par ces bras occupée:	Arrête, cette épée Ne fût jamais en vain par ces bras occupée:
Voſtre Voſtre temerité s’appreſte vn chaſtiment, An ne me iu ſatt poim tirer impunément.	Votre Votre témérité s'apprête un châtiment, An ne me ju sat poim tirer impunément.
LYSIS.	LYSIS.
O le vaillant guerrier!	Ô le vaillant guerrier!
RRORDEIAIC.	RRORDEIAIC.
Ouy vaillant, mais modeſte.	Oui vaillant, mais modeste.
LYSIS.	LYSIS.
Soſſomuuroſjoummom,qunoninpormnet du reſte.	Sossomuurosjoummom,qunoninpormnet du reste.
Ne croy pas m'appaiſer par ce lâche entretien;	Ne crois pas m'apaiser par ce lâche entretien;
Et ne redoute pas mon mal-heur, mais le tien.	Et ne redoute pas mon malheur, mais le tien.
Nous verrons les effects que le Ciel nous deſtine.	Nous verrons les effets que le Ciel nous destine.
FLORIDAN à Alidor.	FLORIDAN à Alidor.
Remonſtrez-luy.	Remonstrez-lui.
Monſieur, qu’il cherche ſa ruyne.	Monsieur, qu'il cherche sa ruine.
ALIDOR Dieux!	ÀLIDOR Dieux!
le plaiſant combat.	le plaisant combat.
LYSIS.	LYSIS.
Il ne m’eſtonne pas.	Il ne m'étonne pas.
FLORIDAN.	FLORIDAN.
f'ay couſtume de rire alors que ie me bats.	s'ai coutume de rire alors que mille me bats.
R	R
LYSIS.	LYSIS.
C'eſt trop deliberer, lache object de ma haine.	C'est trop délibérer, lache object de ma haine.
FLORIDAN.	FLORIDAN.
Et moy, c’eſt tropgauſſer, & vous laiſſer en peine.	Et moi, c'est tropgausser, et vous laisser en peine.
Ie ſçay quelle raiſon excite ce courroux, C’eſt vn effect, Monſieur, de vos ſoupçons jaloux.	Je sais quelle raison excite ce courroux, C'est un effet, Monsieur, de vos soupçons jaloux.
Vous aymez Felicie, & ſçachant qu’elle m’ayme, CroyeZ que ie respons à ſon amour extreſme.	Vous aimez Félicie, et sachant qu'elle m'aime, Croyez que ie répons à son amour extrême.
Mais qu’apprehendez,-vous?	Mais qu'appréhendez,-vous?
mettez les armes bas, mhnndquaummomununpumans mes bras.	mettez les armes bas, mhnndquaummomununpumans mes bras.
Et vous qui n'aſpirez qu’à flechir Celimene, Ne ſuis-je point außi l’object de voſtre haine?	Et vous qui n'aspirez qu'à fléchir Celimène, Ne suis-je point aussi l'object de votre haine?
De ce mal apparent l’effect vous ſera doux, En trauaillant pour moy, ie trauaille pour vous.	De ce mal apparent l'effet vous sera doux, En travaillant pour moi, ie trauaille pour vous.
ALIDOR.	ÀLIDOR.
Comment, toutes les deux reçoiuent ton hommage?	Comment, toutes les deux reçoivent ton hommage?
FLORIDAN.	FLORIDAN.
Que ie ſois diſpenſé d’en dire dauantage.	Que quelque sois dispensé d'en dire davantage.
Si vous les poſſedez ſerez-vous ſatis faicts?	Si vous les possédez serez-vous satî faits?
Rien ne peut diuertir le deſſein que t'en faicts.	Rien ne peut divertir le dessein que t'en faits.
Vous ſerez obligé à ces heureuſes feintes, Et les remerciements ſuccederont aux plaintes.	Vous serez obligé à ces heureuses feintes, Et les remerciements succéderont aux plaintes.
I'aura y mis du remede à nos communs ennuys, Vous loüerez mon eſprit, & ſçaurez, qui ie ſuis, Voſtre mal & le mien également me touche, La peur ne me met point ces diſcours en la bouche.	J'aura y mis du remède à nos communs ennuis, Vous louerez mon esprit, et saurez, qui ie suis, Votre mal et le mien également me touche, La peur ne me met point ces discours en la bouche.
Si dans peu les effects ne ſurpaſſent vos vœux, Vniſſez vos efforts, & m'attaquez, tous deux.	Si dans peu les effets ne surpassent vos vœux, Unissez vos efforts, et m'attaqués, tous deux.
Aile ala Que t’en ſemble, Lyſis?	Aile ala Que t'en semble, Lysis?
18IS.	18IS.
O Dieux!	Ô Dieux!
quelle apparence?	quelle apparence?
oun ia joya onminat jonder fen eſperance s	oun ja joya onminat jonder sen espérance s
FLORIDAN.	FLORIDAN.
Vous me cognoiſſez mal?	Vous me connaissez mal?
Si le terme n'eſt long.	Si le terme n'est long.
LYSIS.	LYSIS.
Attendons toutes fois,	Attendons toute fois,
FLORIDAN.	FLORIDAN.
Dunu ronne,mnuotros.	Dunu ronne,mnuoctros.
ALIDOR.	ÀLIDOR.
Adieu, fais que l’effet ſuccede à ta promeſſe, Et i'éterniſeray ton nom, & ton adreſſe.	Adieu, fais que l'effet succède à ta promesse, Et j'éterniserai ton nom, et ton adresse.
SCENE TROISIESME, FILANDRE.	SCÈNE -TROISIÈME, FILANDRE.
FLORIDAN.	FLORIDAN.
FLORIDAN.	FLORIDAN.
Ourquoy viens-tu ſi tard?	Ourquoy viens-tu si tard?
ie t’aybiẽ ſouhaitté, Etiu mt manques oun en ianeceſsité.	ie t'aibien souhaité, Éiv mt manques oun en janecessité.
Comment?	Comment?
FILANDRE.	FILANDRE.
FLORIDAN.	FLORIDAN.
Deux m’attaquoient, tu m'aurois ſecondée.	Deux m'attaquaient, tu m'aurais secondée.
FILANDRE.	FILANDRE.
Et la querelle en fin?	Et la querelle en fin?
FLORIDAN.	FLORIDAN.
Nous l’auons accordée:	Nous l'avons accordée:
Admire mon esprit, recognoy mon pouuoir, Ce n’eſt qu’vn en ces lieux, que m’aymer, & me voir.	Admire mon esprit, reconnais mon pouvoir, Ce n'est qu'un en ces lieux, que m'aimer, et me voir.
Ie fay mille jaloux, & toutes vos Maiſtreſſes Sont prodigues pour moy de veux & de carreſſes.	Je fais mille jaloux, et toutes vos Maîtresses Sont prodigues pour moi de veux et de carresses.
Les esprits les plus froids ſe ſont laiſſez dompter, Filandre bien-heureux, s’il s’en pouuoit vanter, Toute esperance alors me ſeroit bien oſtée,	Les esprits les plus froids se sont laissez dompter, Filandre bienheureux, s'il s'en pouvait vanter, Toute espérance alors me serait bien ostée,
FILANDRE.	FILANDRE.
l’aybien plus faict que toy.	l'aibien plus fait que toi.
FLORIDAN.	FLORIDAN.
Comments	Comments
Ie t’aydomptée.	Je t'aydomptée.
FLORIDAN.	FLORIDAN.
C’eſt où ie recognois mon pouuoir inégal, Ie ſfaybien attaquer, & ie me deffens mal.	C'est où tu reconnais mon pouvoir inégal, Je sfaybien attaquer, et aux me défens mal.
I'abats, & l’on m’abat, ie fais aymer, & i'ayme, Ie fais que tout ſe rend, & ie me rends moy-meſme.	J'abats, et l'on m'abat, Elle fais aimer, et j'aime, Je fais que tout se rend, et Seigneur me rends moi-même.
FILANDRE.	FILANDRE.
Il eſt vray que tout cedde à des charmes ſi beaux, Et ie me ſents atteint de mille traicts nouu eaux.	Il est vrai que tout cédde à des charmes si beaux, Et tu me sents atteint de mille traits nouu eaux.
Ie ſçay que ton merite a touché Celimene, L amour qu'elle a pour toy ne m'eſt plus incertaine.	Je sais que ton mérite a touché Celimène, L amour 'elle a pour toi ne m'est plus incertaine.
Ie la cogneus hier, & caché dans ce bois, I'entendis clairement ſes ſouſpirs, & ſa voix.	Je la connus hier, et caché dans ce bois, J'entendis clairement ses soupirs, et sa voix.
Ie le cede, Florante, à ton merite extreſme, Et croy que tu ſçais mieux mo mepier que moymeſme, Tu traictes mieux l’amour auec moins de ſoucy:	Je le cède, Florante, à ton mérite extrême, Et crois que tu sais mieux mo mepier que moymesme, Tu traites mieux l'amour était moins de souci:
Mais ie voy Felicie & Celimene außi.	Mais ici vois Félicie et Celimène aussi.
K iij	§ jijà
FLORIDAN.	FLORIDAN.
Adieu.	Adieu.
	
FILANDRE.	FILANDRE.
Quoyiu les crains, Dieux que de retenuëi	Quoiiv les crains, Dieux que de retenue
FLORIDAN.	FLORIDAN.
Cette reigle d’amour t’eſt encore incognuë, Ie trompe l’vne & l’autre, & toutes deux m'aymant, Ie dois à toutes deux parler ſeparément.	Cette règle d'amour t'est encore inconnue, Je trompe l'une et l'autre, et toutes deux m'aimant, Je dois à toutes deux parler séparément.
SCENE QVATRIESME.	SCÈNE QUATRIÈME.
CELIMENE.	CELIMENE.
FELICIE.	FELICIE.
FELICIE.	FELICIE.
Ous ne meſpriſés plus l’amour, ny ſon enfãce, Ie ne vous entends plus défier ſa puiſſance.	Ous ne méprisez plus l'amour, Seigneur son enfance, Je ne vous entends plus défier sa puissance.
M Vous aymez, à reſver, ce viſage eſt changé, Ie m’abuſe, ma ſœur, ou l’Amour s’eſt vangé.	M Vous aimez, à rêver, ce visage est changé, Je m'abuse, ma sœur, ou l'Amour s'est vengé.
Et ne ſe ſiant pas au pouuoir de ces charmes, A faict à Floridan prendre pour luy les armes.	Et ne se siant pas au pouvoir de ces charmes, A fait à Floridan prendre pour ton les armes.
CELIMENE.	CELIMENE.
Ie ne vous entends plus eſtimer vos liens, Lyſis n'a plus de part en tous vos entretiens.	Je ne vous entends plus estimer vos liens, Lysis n'a plus de part en tous vos entretiens.
Uoſtre humeur chaque iour deuient plus ſolitaire, Ie m'abuſe, ma ſœur, ou cette amour s’altere.	OUotre humeur chaque jour devient plus solitaire, Je m'abuse, ma sœur, ou cette amour s'altère.
L’humeur de Floridan a de certains appas.	L'humeur de Floridan a de certains appas.
Qui,ſi vons tauhontz, ne vous déplaiſent pas,	Qui,si vons tauhonts, ne vous déplaisent pas,
FELICIE.	FELICIE.
Il plaiſt à tout le monde.	Il plaît à tout le monde.
OBEIMEIE, Jl faut donc qu’il me plaiſe.	ÔBEIMEIE, Il faut donc qu'il me plaise.
FELICIE.	FELICIE.
Mais ne craignez-vous plus ce tyran de noſtre ayſe.	Mais ne craignez-vous plus ce tyran de notre aise.
Cet aueugle Demon, ce poiſon des eſprits, Dont les fauſſes douceurs vous eſtoient à meſpris.	Cet aveugle Démon, ce poison des esprits, Dont les fausses douceurs vous étaient à mépris.
CELIMENE.	CELIMENE.
Le craignez-vous ma ſœur?	Le craignez-vous ma sœur?
FELICIE.	FELICIE.
I'ay franchy cét orage.	J'ai franchi cet orage.
CELIMENE.	CELIMENE.
Pour le franchir de meſme ay-je moins de courage?	Pour le franchir de même ai-je moins de courage?
Dois-je auotr en horreur ce que vous approuues Et ne pourray-je pas tout ce que vous pouuez,?	Dois-je auotr en horreur ce que vous approuvez Et ne pourrai-je pas tout ce que vous pouvez,?
FELICIE.	FELICIE.
Pourquoy donc mille amants, qui vous ont tant aymée, N'ont-ils rien profité?	Pourquoi donc mille amants, qui vous ont tant aimée, N'ont-ils rien profité?
CELIMENE.	CELIMENE.
Vous m'en auez, blaſmée.	Vous m'en avez, blasmée.
Vous me peignieZ l’amour plein d’appas & d’attraits, Ie vous croy maintenant, & ie cede à ſes traicts.	Vous me peigniez l'amour plein d'appas et d'attraits, Je vous crois maintenant, et et cede à ses traits.
FELICIE.	FELICIE.
En vn mot, Floridan a voſtre ame touchée, Son merite vous plaiſt.	En un mot, Floridan a Seigneur âme touchée, Son mérite vous plaît.
CELIMENE.	CELIMENE.
En eſtes-vous faſchée?	En êtes-vous fâchée?
Au moins ce choix eſt iuſte, & mon cœur enflammé muomopuuopoumbuuuire, apres l’auoir aymé.	Au moins ce choix est juste, et mon cœur enflammé muomopuuopoumbuuuire, après l'avoir aimé.
Ie n’ay point de Lyſis, dont la flamme fidelle De ma premiere amour doiue eſtre le modelle.	Je n'ai point de Lysis, dont la flamme fidèle De ma première amour doive être le modèle.
Ie n’ay point engagé mes inclinations, Doe ononcepuorceucendutco[uions.	Je n'ai point engagé mes inclinations, Doe ononcepuorceucendutco[uions.
FELICIE.	FELICIE.
I'approuue ce de ſſein, & croy que Celimene Ne ſe peut ennuyer d’une ſi belle peine.	J'approuve ce de sin, et crois que Celimène Ne se peut ennuyer d'une si belle peine.
J'eſiime infiniment ſes rares qualitez.	J'estiime infiniment ses rares qualités.
CELIMENE.	CELIMENE.
Vous les eſtimez tant que vous les reſſentez.	Vous les estimez tant que vous les ressentez.
FELICIE.	FELICIE.
Non pas fort.	Non pas fort.
CELIMENE.	CELIMENE.
Plus que moy.	Plus que moi.
ABulor.	ÀBulor.
J’aurois beaucoup d’affaires,	J'aurais beaucoup d'affaires,
CELIMENE.	CELIMENE.
Vous en auez außi plus que les ordinaires, Vous conſiderez, trop toutes mes actions, Et vous m'importunez, de trop de queſtions.	Vous en avez aussi plus que les ordinaires, Vous considérez, trop toutes mes actions, Et vous m'importunez, de trop de questions.
Pourquoy m'espiez-vous?	Pourquoi m'épiez-vous?
FELICIE.	FELICIE.
O la folle croyance!	Ô la folle croyance!
Voyez combient Amour tauſé de deſſiance.	Voyez combient Amour tausé de dessiance.
Mais ne vous plaignez point, ie vous laiſſe en ce lieu, Et ne vous ſuiuray plus.	Mais ne vous plaignez point, Seigneur vous laisse en ce lieu, Et ne vous suivrai plus.
CELIMENE.	CELIMENE.
Vous m’obligez, Adieu.	Vous m'obligez, Adieu.
Eſtant ſeule.	Étant seule.
Elle a beau ſe contraindre, on void en ſon viſage, De ſa nouuelle flamme vn trop clair teſmoignage.	Elle a beau se contraindre, on voit en son visage, De sa nouvelle flamme un trop clair témoignage.
L Depuis que Floridan s’eſt fait voir en ces lieux, Son amant l’importune, & deſplaiſt à ſes yeux:	 Depuis que Floridan s'est fait voir en ces lieux, Son amant l'importune, et déplaît à ses yeux:
Elle ne peut cacher le ſouc y qui la touche, Son cœur à tous moments eſt trahy par ſa bouche, Et tant de queſtions font aſſez preſumer, Le deſplaiſir qu'elle nde me le voir aymer.	Elle ne peut cacher le souc y qui la touche, Son cœur à tous moments est trahi par sa bouche, Et tant de questions font assez présumer, Le déplaisir qu'elle nède me le voir aimer.
Ie l’aymeray pourtant, & ſi l’effect ſuccede, A mes chaſtes deſirs, il faudra qu’elle cede, Ie n'eſpargnera y plus, ny carreſſes ny vœux.	Je l'aimerai pourtant, et si l'effet succède, À mes chastes désirs, il faudra qu'elle cède, Je n'épargnera y plus, ni carresses sans vœux.
Mais il vient iuſtemient à l’heure que ie vœux.	Mais il vient justemient à l'heure que sans vœux.
SCENE CINQVIESME.	SCÈNE CINQUIÈME.
FLORIDAN.	FLORIDAN.
CELIMENE.	CELIMENE.
FLORIDAN.	FLORIDAN.
Ve ce teint eſt changé!	Ve ce teint est chargé!
quelle douleur vous preſſe?	quelle douleur vous presse?
Dieux i'qu’eſt-ce que ie voy?	Dieux j'est-ce que tu vois?
CELIMENE.	CELIMENE.
Uous cauſez ma triſteſſe.	Uous causez ma tristesse.
FLORI DHEI.	FLORI DHÉI.
Quoy!	Quoi!
vous ſuis-je importun?	vous suis-je importun?
CELIMENE.	CELIMENE.
Voſtre ciuilité Ne paſſe point, Monſieur, pour importunité.	Votre civilité Ne passe point, Monsieur, pour importunité.
Et l’on ſouhaitte plus, qu’on ne craint vos viſites Depuis qu'on a iugé de vos rares merites.	Et l'on souhaite plus, qu'on ne craint vos visites Depuis qu'on a jugé de vos rares mérites.
FLORIDAN.	FLORIDAN.
Madame, eſpargnés-moy, puiſque les compliments Doiuent eſtre banis d’entre les vrays amans.	Madame, espargnés-moi, puisque les compliments Doivent être banis d'entre les vrais amants.
Ma ſeule affection vous eſt conſiderable, Et le moindre merite eſt au mien pre ferable;	Ma seule affection vous est considérable, Et le moindre mérite est au mien pré vérable;
Ie cognois mes deffauts;	Je connais mes défauts;
pour me bien eſtimer AuoüeZ ſeulement que ie ſçaybien aymer;	pour me bien estimer AuoüeZ seulement que Ne sçaybien aimer;
I'ay peu de vanité, mais au ſoin de vous plaire, Il faut que tout me cede, & que tout me defere.	J'ai peu de vanité, mais au soin de vous plaire, Il faut que tout me de, et que tout me défère.
De quelque inſigne Amour qu’on ayt iamais parlé, L’ardente paßion, pour qui Troye a bruſlé;	De quelque insigne Amour qu'on ait jamais parlé, L'ardente passion, pour qui Troie a brûlé;
Ces violents transports, ces furieux caprices, Qui font à tant d’humains mespriſer les ſupplices;	Ces violents transports, ces furieux caprices, Qui font à tant d'humains mépriser les supplices;
Tout ce qui fait reſoudre à d’extremes efforts, Ces aueugles ardeurs qui cauſent tant de morts, Les amours de jadis, & toutes les trauerſes, Qui faiſoient prendre aux Dieux tant de formes diterſes, Leurs accez les plus forts,leurs feux les plus preſſants, Sont l’ombre ſeulement des ardeurs que ie ſents.	Tout ce qui fait résoudre à d'extrêmes efforts, Ces aveugles ardeurs qui causent tant de morts, Les amours de jadis, et toutes les traverses, Qui faisaient prendre aux Dieux tant de formes diterses, Leurs accès les plus forts,leurs feux les plus pressants, Sont l'ombre seulement des ardeurs que ie sents.
Il faut vn autre nom à mon amour extreſme, Et c’eſt dire trop peu, que de dire que i’ayme.	Il faut un autre nom à mon amour extrême, Et c'est dire trop peu, que de dire que j'aime.
L	L
CELIMENE.	CELIMENE.
t ous promteinesocantonp.	 tous promteinesocantonp.
FLORIDAN.	FLORIDAN.
Ie fais encore plus:	Je fais encore plus:
Mais teneZ pour ſuspects ces propos ſuperflus, Doutez ſi ie vous ayme, & m'ordonnez, Madame, De prouuer à vos yeux cette immortelle flamme.	Mais teneZ pour suspects ces propos superflus, Doutez si sens vous aime, et m'ordonnez, Madame, De prouver à vos yeux cette immortelle flamme.
Quel effet de valeur vous en peut aſſeurer?	Quel effet de valeur vous en peut assurer?
Baiſeray-je vos pas, vous ſaut-il adorer?	Baiserai-je vos pas, vous saut-il adorer?
M’ouuriray-je le ſein?	M'ouvrirai-je le sein?
ſçauez-vous quelque ſigne Qui prouuaſt mieux encor ma paßion inſigne?	sçauez-vous quelque signe Qui prouvât mieux encor ma passion insigne?
I'atteſterois en vain les hommes & les Dieux, Ie ne deſire point de teſmoins que vos yeux.	J'attesterais en vain les hommes et les Dieux, Je ne désire point de témoins que vos yeux.
CELIMENE.	CELIMENE.
Ie croy que vous m’aymez, & ſans ingratitude Je ne puis plus donter de voſtre inquietude:	Je crois que vous m'aimez, et sans ingratitude Je ne puis plus donter de votre inquiétude:
Mais vous ne ſouffreZ rien que ie ne ſouffre außi, Ie ſens la meſme ardeur, & le meſme ſoucy.	Mais vous ne souffrez rien que sans ne souffre aussi, Je sens la même ardeur, et le même souci.
D’autres n’ont plus pour moy qu'un deſſein inutile, Et veus eſtouffez ſeul l’esperance de mille.	D'autres n'ont plus pour moi qu'un dessein inutile, Et veux étouffez seul l'espérance de mille.
FLORIDAN.	FLORIDAN.
Puis-je, ô rare beauté!	Puis-je, ô rare beauté!
ſans indiſcretionDemander vne preuue à voſtre affection?	sans indiscrétionDemander une preuve à votre affection?
Depuis que i'’ay conceu l’amour que ie vous vouë, Ie n’ay pas eu l’honneur d’approcher cette jouë.	Depuis que j'ai conçu l'amour que je vous voue, Je n'ai pas eu l'honneur d'approcher cette joue.
Vous m’auez, refuſe les moindres priuautez, Comment donc traicteZ-vous ceux que vous rejettez?	Vous m'avez, refuse les moindres privautés, Comment donc traitez-vous ceux que vous rejettez?
CELIMENE.	CELIMENE.
Tu priſe des baiſers, des regards, des parolles, Aompout uu puu epeunde puuouro ppiuoles, Prefere à leurs appas des plaiſirs infinis, Et tendons au bon-heur d’eſtre à jamais vnis.	Tu prise des baisers, des regards, des paroles, Aompout u puu épeunde puvouro les, Préfère à leurs appas des plaisirs infinis, Et tendons au bonheur d'être à jamais unis.
FLORIDAN.	FLORIDAN.
Ma Tante m’a promis d’obtenir de mon pere, L’aueu dont i’ay beſoin pour cette heureuſe affaire.	Ma Tante m'a promis d'obtenir de mon père, L'aveu dont j'ai besoin pour cette heureuse affaire.
I'ay pourueu là deſſus, accordeZ ſeulement Ces premieres faueurs à l’ardeur d’vn Amant.	J'ai pourvu là dessus, accordez seulement Ces premières faveurs à l'ardeur d'un Amant.
Baiſant de cette main la blancheur ſans ſeconde.	Baisant de cette main la blancheur sans seconde.
Ceqouepuuſeumnonenuyu puuo mureux du monde.	Ceqouepuuseumnonenuyu puvo mureux du monde.
Il luy baiſe la main.	Il lui baise la main.
Garde ce bracelet.	Garde ce bracelet.
CELIMENE.	CELIMENE.
FLORIDAIN le banlant.	FLORIDAIN le banlant.
Faueur digne d’vn Dieu!	Faveur digne d'un Dieu!
CELIMENE.	CELIMENE.
Et ce ſoir vn peu tard trouuons-nous en ce lieu.	Et ce soir un peu tard trouvons-nous en ce lieu.
L iij Fuyons l’oreille, & l’œil d’vne ſœur indiſcrette, Qui ne pourroit tenir ma paßion ſecrette.	 Lijà Fuyons l'oreille, et l'œil d'une sœur indisterette, Qui ne pourrait tenir ma passion secrète.
Sans reſerue, mon cœur pourra s’ouurir au tien, Et rienn'interrompra noſtre doux entretien.	Sans réserve, mon cœur pourra s'ouvrir au tien, Et rienn'interrompra notre doux entretien.
FLORIDAN.	FLORIDAN.
Ie n’y manqueray pas.	Je n'y manquerai pas.
CELIMENE.	CELIMENE.
Adieu.	Adieu.
FLORIDAN eſtant ſeul.	FLORIDAN étant seul.
L’heureuſe feinte!	L'heureuse feinte!
Et que profondement cette belle eſt atteinte!	Et que profondément cette belle est atteinte!
Que ie ſouhaiterois de pouuoir amortir La violente ardeur que ie luy faicts ſentir!	Que était souhaiterais de pouvoir amortir La violente ardeur que je était faits sentir!
Cette aßignation prouue aſſeZ ſon enuie:	Cette assignation provue assez son envie:
Hais ie n'eſpere pas le pouuoir de ma vie.	Hais ie n'espère pas le pouvoir de ma vie.
Elle ſe peut fier en mon honne ſteté, Et meſme entre mes bras dormir en ſeureté.	Elle se peut fier en mon honne steté, Et même entre mes bras dormir en sûreté.
Mais ce garçon qui vuen eſt'a mon autte amante.	Mais ce garçon qui vuen est'a mon autte amante.
SCENE SIXIESME.	SCÈNE SIXIÈME.
LE LACQVAIS.	LE LACQUAIS.
FLORIDAN.	FLORIDAN.
LE LACQVAIS.	LE LACQUAIS.
E vous cherchois, Monſieur, & i’allois chez Orante, TUous porter cette Lettre.	VOUS vous cherchais, Monsieur, et j'allais chez Orante, TUous porter cette Lettre.
FLORIDAN lit.	FLORIDAN lit.
L.	L.
e contenu.	e contenu.
Si tu veux, Floridan, me plaire infiniment, Accorde-moy ce ſoir le bien de ta preſence;	Si tu veux, Floridan, me plaire infiniment, Accorde-moi ce soir le bien de ta présence;
Ma priere t'oblige à cette complaiſance, Ie veuxt'entretenir vne heure ſeulement.	Ma prière t'oblige à cette complaisance, Je veuxt'entretenir une heure seulement.
Monte ſeul en ma chambre, & mon affection Par des vœux infinis te ſera confirmee, Et ſi la meſme ardeur a ton ame enflammée;	Monte seul en ma chambre, et mon affection Par des vœux infinis te sera confirmée, Et si la même ardeur a ton âme enflammée;
Tu me le prouueras par ta diſcretion.	Tu me le prouveras par ta discrétion.
FELICIE.	FELICIE.
Il dit au Lacquais.	Il dit au Lacquais.
Adieu, ie l’iray veoir,	Adieu, Seigneur l'irai voir,
Il continüe eſtant ſeul.	Il continue étant seul.
Pourquoy ne puis-je, ô Dieuxt respondre à leur eſpoir?	Pourquoi ne puis-je, ô Dieuxt répondre à leur espoir?
Qu'vn facile moyen a leur ame abuſée!	Qu'un facile moyen a leur âme abusée!
Que toucher vne fille eſt vne choſe ayſée!	Que toucher une fille est une chose aisée!
Et qu'vn Amant bien fait a peu d’inuention, Quand il n’attire pas ſon inclination.	Et qu'un Amant bien fait a pu d'invention, Quand il n'attire pas son inclination.
Si iamais i’eus ſubiect d’accuſer la Nature, Eſtant ce que ie ſius, c’eſt en cette aduenture.	Si jamais j'eus sujet d'accuser la Nature, Étant ce que si jus, c'est en cette aventure.
Ie ſuis leur ſeul espoir, & leur vnique bien.	Je suis leur seul espoir, et leur unique bien.
Ie leur promets beaucoup, & ne puis donner rien.	Je leur promets beaucoup, et ne puis donner rien.
Fin du quatrieſme Acte.	Fin du quatrième Acte.
A I SCENE PREMIERE.	À I SCÈNE PREMIÈRE.
LYSIS ſeul.	LYSIS seul.
Ombien ie ſuis facile!	Ombien Seigneur suis facile!
ô Dieux le dois-je croire?	ô Dieux le dois-je croire?
Que pour mõ intereſt il renonce à ſa gloire.	Que pour mon intérêt il renonce à sa gloire.
C’eſt bien manquer d’esprit, & meriter ſon Que de traicter l’Amour par ſon propre riual.	C'est bien manquer d'esprit, et mériter son Que de traiter l'Amour par son propre rival.
mal, Qu'il me rende les vœux d’vne ingratte Maiſtreſſe Me les ayant oſtés?	mal, Qu'il me rende les vœux d'une ingrate Maîtresse Me les ayant ôtés?
ô la vaine promeſſe!	ô la vaine promesse!
Il eſt adoré d’elle, & ſon intention, Eſt d’arriuer par feinte à ſa poſſeßion.	Il est adoré d'elle, et son intention, Est d'arriver par feinte à sa possesiion.
Et puis apres l’honneur de cette jouyſſance, Ahandonner ces lieux, & vanter ſa puiſſance:	Et puis après l'honneur de cette jouissance, Ahandonner ces lieux, et vanter sa puissance:
Mais, qu’il craigne l’effect de mon iu ſte courroux, Et qu’il n’irrite pas vn amoureux jaloux.	Mais, qu'il craigne l'effet de mon ju site courroux, Et qu'il n'irrite pas un amoureux jaloux.
Jl fis yroit vainement, & n’auroit point d’azile, Qui rendiſt contre luy ma pourſuitte inutile.	Il fis yrait vainement, et n'aurait point d'asile, Qui rendît contre notre ma poursuite inutile.
SCENE	SCÈNE
SCENE DEVXIESME.	SCÈNE DEUXIÈME.
FLORIDAN.	FLORIDAN.
LYSIS.	LYSIS.
FLORIDAN.	FLORIDAN.
E fay tous mes efforts, mais ie trauaille en L vain:	E fais tous mes efforts, mais Seigneur travaille en L vain:
Elle demeure ferme en ſon premier deſſein.	Elle demeure ferme en son premier dessein.
Ie blaſme ſon humeur, i’excite ſa colere, Et par tous ces moyens, ie ne lu y peux desplaire.	Je blâme son humeur, j'excite sa colère, Et par tous ces moyens, toujours ne lu y peux déplaire.
Ie luy ſuis plus charmant, & plus cher que le iour, Et vous ne pouuez pas esperer ſon amour.	Ie Je suis plus charmant, et plus cher que le jour, Et vous ne pouvez pas espérer son amour.
Yamauanapsc.	Yamauanapsc.
Ie ne puis plus außi differer le ſupplice, Que mon juſte courroux doit à ton artifice.	Je ne puis plus aussi différer le supplice, Que mon juste courroux doit à ton artifice.
Par ton inuentlon, mes veux ſont meſpriſés:	Par ton inventlon, mes veux sont méprisés:
Traiſtre, tu plains mes maux, & tu les as cauſés.	Traître, tu plains mes maux, et tu les as causés.
FLORIDAN.	FLORIDAN.
Ne vous haſtez pas tant, ſans arme & ſans deffence, Ie ſçay parer les coups, & punir qui m'offence;	Ne vous hâtez pas tant, sans arme et sans défense, Je sais parer les coups, et punir qui m'offense;
Que voſtre repentir finiſſe nos debats, Et qu’on mette l’eſpée & les genoux à bas.	Que votre repentir finisse nos débats, Et qu'on mette l'épée et les genoux à bas.
Deteſtez à mes pieds voſtre inſolente enuie, Et confeſſez tout haut de me deuoir la vie.	Dettez à mes pieds votre insolente envie, Et confessez tout haut de me devoir la vie.
M	M
E AG0.	 ÉG0.
Dienxsia punr le rend jon.	Dienxsia punr le rend jon.
FLORIDAN.	FLORIDAN.
Perdez ce ſentiment, Et me croyeZ.	Perdez ce sentiment, Et me croisez.
Lyſis, ie parle ſainement.	Lys, Seigneur parle sainement.
Mais ie tiens trop long-temps voſtre eſprit en balance, Te cognoy voſire amonz, ren ſça va violence.	Mais ici tiens trop longtemps votre esprit en balance, Te connais vos amonz, ren sça va violence.
Et veux que vous deuieZ à ma compaßion, Le fruict que vous aurez de voſtre affection.	Et veux que vous deviez à ma compassion, Le fruit que vous aurez de votre affection.
Monſtrant la Lettre:	Monstrant la Lettre:
Voyez, ce qu’en deux mots m’ordonne cette Belle, Et receuez de moyce que i’ay receu d’elle.	Voyez, ce qu'en deux mots m'ordonne cette Belle, Et recevez de moice que j'ai reçu d'elle.
Allez la voir ce ſoir, monſtrez-luy cét eſcrit, Dictes qu’vn prompt effet a changé mon eſprit.	Allez la voir ce soir, montrez-lui cet écrit, Dictes qu'un prompt effet a changé mon esprit.
Que ie n’eſtime plus ſa grace, & ſon merite, Et que ie ſuis eſpris des beaux yeux de Charite;	Que était n'estime plus sa grâce, et son mérite, Et que tu suis épris des beaux yeux de Charite;
Qu'elle reſſent pour moy, de vaines paßions Que ie vante par tout ſes aßignations, Qu'elle à tort de me croire, & de ſe rien promettre;	Qu'elle ressent pour moi, de vaines passions Que on vante par tout ses assignations, Qu'elle à tort de me croire, et de se rien promettre;
Que moy-meſme en vos mains i'ayremis cette lettre.	Que moi-même en vos mains j'airemis cette lettre.
Iurez-luy que ie ris de ſes vœux ſuperflus, Ie confeſſeray tout quand vous aurez dit plus, IugeZ apres cela, ſi Floridan vons ayme, Et ſi vous luy deueZ vne faüeur extreſme.	Jurez-lui que ie ris de ses vœux superflus, Je confesserai tout quand vous aurez dit plus, Jugez après cela, si Floridan vons aime, Et si vous lui deueZ une feueur extrême.
Que ie liſe ces mots, LYSIS.	Que quelque lise ces mots, LYSIS.
Il littoutbas.	Il littoutbas.
Ayant leu, il dit.	Ayant lu, il dit.
L’infidelle beauté!	L'infidèle beauté!
Oüy ie vous dois, Monſieur, le bien de la clarté, Et ie' ſtois criminel vous traictant de la ſorte, Eut.	Oui ici vous dois, Monsieur, le bien de la clarté, Et tu stais criminel vous traitant de la sorte, Eut.
que vom invonorts a vnt amtttt eforfé.	que vom invonorts a vnt eût eforfé.
Accuſez de mon mal vn enfant indiſcret, Qui conſeillant les ſiens ignore ce qu’il fait.	Accusez de mon mal un enfant indiscret, Qui conseillant les siens ignore ce qu'il fait.
FLORIDAN.	FLORIDAN.
Et bien ay-ie ayſément reprimé voſtre audace?	Et bien ai-je aisément reprimé votre audace?
nuy pur quuemume gounuu menaceſ Et tous les Caualiers les plus cheris du Sort, Feroient-ils tant d’effet auec ſi peu d’effort?	nui pur quuemume gounu menaces Et tous les Cavaliers les plus chéris du Sort, Feraient-ils tant d'effet avec si peu d'effort?
Adieu, viuez, heureux, & vous ſerués des armes, Que ie mets en vos mains, pour r'acquerir ſes charmes.	Adieu, vivez, heureux, et vous servez des armes, Que personne mets en vos mains, pour racquérir ses charmes.
LYSIS.	LYSIS.
Homme le plus courtois d’entre tous les mortels, Si ie change ſon cœur, que ie te dois d’autels!	Homme le plus courtois d'entre tous les mortels, Si tu change son cœur, que ie te dois d'autels!
Il s’en va.	Il s'en va.
FLORIDAN ſeul.	FLORIDAN seul.
Jl reſte qu'Alidor, apres ſa longue peine, M’ait l’obligation de flechir Celimene.	Il reste qu'Alidor, après sa longue peine, M'ait l'obligation de fléchir Celimene.
I’ay fait à cét amant, eſpęrerdu repos, D JJa d lservinsaprepos.	J'ai fait à cet amant, espęrerdu repos, D E d lservinsaprepos.
SCENE TROISIESME.	SCÈNE -TROISIÈME.
ALIDOR.	ÀLIDOR.
FLORIDAN.	FLORIDAN.
ALIDGR.	ÀLIDGR.
& Onſieur, ſans m’abuſer d’inutilles parolles, Flattés-vous pas mon mal deſperances fri uolles?	et Onsieur, sans m'abuser d'inutilles paroles, Flattez-vous pas mon mal desperances fry volles?
Croyez-vous que ſon cœur ſoit touché de mes pleurs, Et qu'elle doiue vn iour alleger mes douleurs?	Croyez-vous que son cœur soit touché de mes pleurs, Et qu'elle doive un jour alléger mes douleurs?
FLORIDAN.	FLORIDAN.
Vous me croyrez, bien-toſt, puiſque tout vous ſuccede, Et qu'on a pour vos maux preparé du remede.	Vous me croirez, bientôt, puisque tout vous succède, Et qu'on a pour vos maux préparé du remède.
I'ay dispoſé ſon cœur, à n’eſtimer que vous, Uous cauſés maintenant ſes penſers les plus doux.	J'ai disposé son cœur, à n'estimer que vous, Uous causez maintenant ses pensers les plus doux.
Et vous verrez ce ſoir l’effect de ma promeſſe, Si l’amour vous perriet aſſez, de hardieſſe.	Et vous verrez ce soir l'effet de ma promesse, Si l'amour vous perriet assez, de hardiesse.
ALIDOR.	ÀLIDOR.
Aduoüé de Madame, il n’eſt point de danger Où mon affection ne me fiſt engager;	Aduoüé de Madame, il n'est point de danger Où mon affection ne me fît engager;
Et les chaſtes ardeurs dont i’ay l’ame enflammée, Diſpoſeroient ce bras à combatre vne armée.	Et les chastes ardeurs dont j'ai l'âme enflammée, Disposeraient ce bras à combattre une armée.
FLORIDAN.	FLORIDAN.
La voyant au milieu des lyons, & des ours, Pourriez vous l’en tirer & conſeruer ſes iours?	La voyant au milieu des lions, et des ours, Pourriez -vous l'en tirer et conserver ses jours?
ALIDOR.	ÀLIDOR.
I'employrois mes efforts, & ie vaincrois leur rage, Si la force & l’adreſſe égalloient mon courage.	J'emploierais mes efforts, et ainsi vaincrois leur rage, Si la force et l'adresse égalloient mon courage.
FLORIDAN.	FLORIDAN.
ui ſeoous tn vo ſeo uuns un braſier ardent;	Oui seoous tun vœo seo uuns un brasier ardent;
ALIDOR.	ÀLIDOR.
Ie m’irois expoſer à cét autre accident.	Je m'irais exposer à cet autre accident.
FLORIDAN.	FLORIDAN.
Il eſt beſoing de plus.	Il est besoin de plus.
ALIDOR.	ÀLIDOR.
De rien que ie ne fiſſe, Pour elle ie voudrois franchir vn precipice, Ie vaincrois tout obſtacle, irois dans les enfers:	De rien que ici ne fisse, Pour elle -même voudrais franchir un précipice, Je vaincrais tout obstacle, irais dans les enfers:
Affronterois la parque, & l’oſterois des fers, St iamais elle eſtoit ſur ces riuages ſombres, Et qu’vn ſi beau Soleil deuſt viure entre les ombres, Sus, decouurez moy tout, & m'oſtez de ſoucy,	Affronterais la parque, et l'ôterais des fers, St jamais elle était sur ces rivages sombres, Et qu'un si beau Soleil dût vivre entre les ombres, Sus, découvrez -moi tout, et m'ôtés de souci,
FLORIDAN.	FLORIDAN.
Celimene ce ſoir vous attend ſeule icy.	Celimène ce soir vous attend seule ici.
Cette rare beauté cherit voſtre ſeruage, Et le ſoing que i'ay pris vous procure ce gage.	Cette rare beauté chérit votre servage, Et le soing que j'ai pris vous procure ce gage.
Amenes ſeuiement à t'aßignation, Luy donnant le bracelet.	Amènes seuiement à t'assignation, Lui donnant le bracelet.
L’Amour, la Retenuë, & la Diſcretion.	L'Amour, la Rétenue, et la Discrétion.
ALIDOR.	ÀLIDOR.
OD ieux!	OD jeux!
que dites-vous?	que dites-vous?
FLORIDAN.	FLORIDAN.
Que ie tiens ma promeſſe, Serués fidellement cette belle Maiſtreſſe.	Que quelque tiens ma promesse, Servez fidèlement cette belle Maîtresse.
Adieu, viués contant, & gardés ces cheueux.	Adieu, vivez contant, et gardez ces cheveux.
Ils en va.	Ils en va.
ALIDOR.	ÀLIDOR.
Si mon bon-heur n’eſt faux, que ie vous dois de vœux!	Si mon bonheur n'est faux, que je vous dois de vœux!
Auoir tant obtenu de cette ame de roche.	Avoir tant obtenu de cette âme de roche.
Mais deſià la ſoirée, & mon repos approche;	Mais déjà la soirée, et mon repos approche;
Attendant le bon-heur de receuoir ſés loix, Ie vais reſver vne heure au profond de ce bois.	Attendant le bonheur de recevoir sez lois, Je vais rêver une heure au profond de ce bois.
SCENVEOVATTESME,	SCENVEOUATTESME,
CELIMENE ſeulle.	CELIMENE seulle.
E Ciel laiſſe à nos yeux paroiſtre ſes Eſtoilles, DLe Soleil eſt dans l’onde, & la nuict tẽd ſes voiles.	E Ciel laisse à nos yeux paraître ses Étoilles, DLe Soleil est dans l'onde, et la nuit tend ses voiles.
Il eſt de ſià bien tard, cét agreable Amant, S’il ayme autant que moy, viendra dans vn momant.	Il est de si bien tard, cet agréable Amant, S'il aime autant que moi, viendra dans un momant.
C’eſt icy que nos cœurs deſcouuriront leurs flammes, Et qu’vn libre entretien charmera nos deux ames.	C'est ici que nos cœurs découvriront leurs flammes, Et qu'un libre entretien charmera nos deux âmes.
Que nous n'en verrons plus alterer la douceur, Par l’importunité d’vne ialouſe Sœur.	Que nous n'en verrons plus altérer la douceur, Par l'importunité d'une jalouse Sœur.
C’eſt là que ie le veux aſſeurer que ie l’ayme, Que ie ne dois plus rien à ſon amour extreſme.	C'est là que Ce le veux assurer que personne l'aime, Que tu ne dois plus rien à son amour extrême.
Que la peine où ie ſuis égalle ſes trauaux, Et que nos deux esprits bruſlent de feux égaux.	Que la peine où je suis égale ses travaux, Et que nos deux esprits brûlent de feux égaux.
Dieux!	Dieux!
le parfait Amant!	le parfait Amant!
que ſa grace eſt aymable!	que sa grâce est aimable!
Que ſon viſage eſt doux!	Que son visage est doux!
& ſa voix agreable!	et sa voix agréable!
I'ayme vne Deïté, ſous l’habit d’vn mortel, Et ie croy que le Ciel n’en peut plus faire vn tel, Il a pour le former ſes graces épuiſées:	J'aime un Deïté, sous l'habit d'un mortel, Et ie crois que le Ciel n'en peut plus faire un tel, Il a pour le former ses grâces épuisées:
Ses pires qualiteZ doiuent eſtre priſées.	Ses pires qualités doivent être prisées.
Et iamais la vertu n'a plus abſolument En l’eſprit d’vn ieune homme eu du commandement,	Et jamais la vertu n'a plus absolument En l'esprit d'un jeune homme eu du commandement,
SCENE CINQVIESME, DES VOLLEVRS.	SCÈNE CINQUIÈME, DES VOLEURS.
CELIMENE.	CELIMENE.
PREMIER VOLLEVR.	PREMIER VOLLEUR.
Renons vn peu d’haleine:	Renons un peu d'haleine:
lisne nons junen pas, nen ſoyons pius en peine.	lisne nons junen pas, nen soyons pius en peine.
Tant de chemins diuers ont leurs pas abuſez, Et nous auons ſuiuy des ſentiers mal-ayſeZ e	Tant de chemins divers ont leurs pas abusés, Et nous avons suivi des sentiers mal-ayseZ eés
2.	2.
VOLLEVR.	VOLEUR.
O Dieux trien n’auroit peû nous ſauuer de la corde, Car ce luge eſt ſeuere, & ſans miſericorde.	Ô Dieux trien n'aurait pu nous sauver de la corde, Car ce luge est saur, et ait miséricorde.
CELIMENE.	CELIMENE.
Où me dois-je cacher?	Où me dois-je cacher?
PREM.	PREM.
VOLLEVR.	VOLEUR.
Amy, ne vois-tu pas Cét agreable obiet?	Ami, ne vois-tu pas Cet agréable objet?
courrons, ſuiuons ſes pas.	courrons, suivons ses pas.
CELIMENE.	CELIMENE.
Que vous plaiſt-il Meßieurs?	Que vous plaît-il Messieurs?
PREMIER VOLLEVR.	PREMIER VOLLEUR.
Nous deſirons deux choſes, Cuelllir mille baiſers ſur ces lys, & ces roſes;	Nous désirons deux choses, Cuelllir mille baisers sur ces lys, et ces roses;
Er deſchi por vos uoigis ue ious ces diamants.	Er déchi por vos oigis ue jous ces diamants.
Donnez, donnez, la main ſans autres compliments.	Donnez, donnez, la main sans autres compliments.
CELIMENE.	CELIMENE.
O Ciell ie ſuis perduë, au ſecourst qui m’aßiſte?	Ô Ciell ie suis perdue, au secours qui m'assiste?
2.	2.
VOLLEVR.	VOLEUR.
moue fuſons pis, mauamt, alors qu'on nous reſiſte,	moue fusons pis, mavamt, alors qu'on nous résiste,
CELIMENE.	CELIMENE.
Au ſecours!	Au secours!
aux volleurs:	aux volleurs:
Ieux!	Jeux!
qu’eſt-ce que ie voy?	qu'est-ce que ie cy?
Que luy veullent ces gens ?	Que était veullent ces gens ?
à moy, traiſtres, à moy.	à moi, traîtres, à moi.
SCENE SIXIESME.	SCÈNE SIXIÈME.
CELIMENE.	CELIMENE.
LES VOLLEVRS.	LES VOLEURS.
ALIDOR ALIDOR, accourant.	ÀLIDOR ALIDOR, accourant.
PREM.	PREM.
VOLLEVR.	VOLEUR.
Ne deliberons point, il faut prendre la fuitté.	Ne délibérons point, il faut prendre la fuité.
ALIDOR, courant apres.	ÀLIDOR, courant après.
vous te pountez vouenes euner mapourſuitte.	vous te pourtez vouenes euner mapoursuite.
CELIMENE ſeule.	CELIMENE seule.
En quel eſtat i’eſtois?	En quel état j'étais?
qui ſont ces gens?	qui sont ces gens?
ô Dieux, Iamais cét accident n'arriua dans ces lieux.	ô Dieux, Jamais cet accident n'arriva dans ces lieux.
On n’y commit iamais vne pareille offence, Ils perdent àujourd’huy leur premiere innocence:	On n'y commit jamais une pareille offense, Ils perdent àujourd'hui leur première innocence:
Et ce coup m'oſtera le plaiſir que i'auois De reſuer ſi ſouuent aux riues de ce bois:	Et ce coup m'ôtera le plaisir que j'avais De rêver si souvent aux rives de ce bois:
SCENE SEPTIESME.	SCÈNE SEPTIÈME.
CELIMENE.	CELIMENE.
ALIDOR.	ÀLIDOR.
ALIDOR tout eſchauffé.	ÀLIDOR tout échauffé.
Fauorable iour ſur tous ceux de ma vie!	Favorable jour sur tous ceux de ma vie!
I’ay l’honneur, une fois de vous auoir ſeruie.	J'ai l'honneur, une fois de vous avoir servie.
I'aytrempé ceſte lame au ſang de ces volleurs, Et ie trouue en leur mort le pris de mes douleurs.	J'aitrempé cette lame au sang de ces volleurs, Et tu trouve en leur mort le pris de mes douleurs.
CELIMENE.	CELIMENE.
Qu’eſtois-je deuenuë?	Qu'étais-je devenue?
ô Dieux que cette eſpée A fauorablemant ma crainte dißipée!	ô Dieux que cette épée A favorablemant ma crainte dissipée!
Quel bon-heur.	Quel bonheur.
Alidor, guidlant icy vos pas, M'a preſté du fecours que ie n'esperois pas?	Alidor, guidglant ici vos pas, M'a prêté du secours que ie n'espérais pas?
rALIDOR.	rALIDOR.
Ce bon-heur eſt l’effect de mon obeïſſance, Sur voſtre mandement i'ay pris cette licence.	Ce bonheur est l'effet de mon obéissance, Sur votre mandement j'ai pris cette licence.
mauis quo ingere vons ue mon uffection, M'eſtant trouué ſi tard à l’aßignation?	mavis quo ingère vons ue mon uffection, M'estant trouué si tard assignation?
CELIMENE.	CELIMENE.
Quelle a ßignation?	Quelle a assignation?
quelle de vos maiſtreſſes, Attendoit en ce lieu vos vœux, & vos careſſes?	quelle de vos maîtresses, Attendait en ce lieu vos vœux, et vos caresses?
ALIDOR.	ÀLIDOR.
Ie n’adore que vous, & iamais ma raiſon N’abandonna mon cœur dans vne autre priſon.	Je n'adore que vous, et jamais ma raison N'abandonna mon cœur dans une autre prison.
Mon inclination, eſt trop pure, & trop forte, Pour auoir partagé l’amour que ie vous porte;	Mon inclination, est trop pure, et trop forte, Pour avoir partagé l'amour que ie vous porte;
Et i'ay de vos appas des ſentimens meilleurs, Que de les comparer, & que d’aymer ailleurs.	Et j'ai de vos appas des sentiments meilleurs, Que de les comparer, et que d'aimer ailleurs.
Ce viſage, l’honneur, & la gloire du monde, N’eſt pas vne beauté qui ſouffre de ſeconde.	Ce visage, l'honneur, et la gloire du monde, N'est pas une beauté qui souffre de seconde.
Et ceſte extreſme ardeur qui cauſe mon ſoucy, Ne ſouffre pas, Madame, vne ſeconde außy.	Et cette extrême ardeur qui cause mon souci, Ne souffre pas, Madame, une seconde aussi.
CELIMENE.	CELIMENE.
Quoy, ie vous attendois ſi tard en cette pleine?	Quoi, Seigneur vous attendais si tard en cette pleine?
ALIDOR.	ÀLIDOR.
Ouy, ſi vous eſtes iuſte aymable Celimene.	Oui, si vous êtes juste aimable Celimène.
Si vous eſtes ſenſible aux rigueur it mon .	Si vous êtes sensible aux rigueur it mon .
Sort, Enfin ſi Floridan m'a fait vn vra y rapport.	Sort, Enfin si Floridan m'a fait un vra y rapport.
CELIMENE.	CELIMENE.
Et que vous à-t’il dit?	Et que vous a-t-il dit?
ALIDOR.	ÀLIDOR.
Qu'à la fin mon martyre, Uous auoit diſpoſée, au bien que ie deſire;	Qu'à la fin mon martyre, Uous avait disposée, au bien que personne désire;
uquubons ſoummtis, (evon neur infinyp Qu'vn iour à voſtre Sort mon deſtin fuſt vny.	uquubons soumîtis, (évon neur infinip Qu'âme jour à votre Sort mon destin fût uni.
Que vous ſeriez ce ſoir au bord de ce boccage, Preparée à ſouffrir ma veuë & mon hommage.	Que vous seriez ce soir au bord de ce bocage, Préparée à souffrir ma vue et mon hommage.
CELIMENE.	CELIMENE.
Vous croyez Alidor, vn peu legerement, Ie ne l’ay point chargé de ce commandement.	Vous croyez Alidor, un peu légèrement, Je ne l'ai point chargé de ce commandement.
L’amour ne permet pas à voſtre reſuerie, De diſcerner le vray, d’auec la raillerie.	L'amour ne permet pas à votre rêverie, De discerner le vrai, d'avec la raillerie.
Floridan vous gauſſoit.	Floridan vous gaussait.
ALIDOR.	ÀLIDOR.
Ces cheueux toutes fois, Me doiuent confirmer le rapport de ſa voix.	Ces cheveux toutes fois, Me doivent confirmer le rapport de sa voix.
Jl a receu pour moy ce fauorable gage, Par qui vons teſmoigneZ de cherir mon ſeruage,	Il a reçu pour moi ce favorable gage, Par qui vons témoignez de chérir mon servage,
CELIMENE.	CELIMENE.
Donnez que ie le voye.	Donnez que personne le voie.
AEIDOR.	AEIDOR.
Il vient de vous.	Il vient de vous.
Ohurſiunn.	Ohursiunn.
O Dieux!	Ô Dieux!
Don-ſe auoner ioy monoriide, & mes yeuxs	Don-se avoner joi monoride, et mes yeuxs
ALIDOR.	ÀLIDOR.
D’ou naiſſent vos ſouſpirs, & voſtre inquietude?	D'ou naissent vos soupirs, et votre inquiétude?
CELIMENE.	CELIMENE.
Eſt-il vn crime égal à ton ingratitude, Traiſtre, aueugle, t'yran de mes affections, Tu recognois ainſi mes chaſtes paßions.	Est-il un crime égal à ton ingratitude, Traître, aveugle, t'iran de mes affections, Tu reconnais ainsi mes chastes passions.
Barbare, indigne objet du ſejour où nous ſommes, Peſte de l’Vniuers le plus meſchant des hommes.	Barbare, indigne objet du séjour où nous sommes, Peste de l'Univers le plus méchant des hommes.
ALIDOR.	ÀLIDOR.
O Dieux!	Ô Dieux!
qui rend ainſi voſtre eſprit furieux?	qui rend ainsi votre esprit furieux?
Laurq̃cer me donnez-vous ces noms injurieux?	Laurq̃cer me donnez-vous ces noms injurieux?
N iij Dittes ſi ie vous porte à ce courroux extre ſme, Et ie vous vangeray moy-meſme, de moy-mneſme;	 iij Dittes si ici vous porte à ce courroux extrê me, Et je vous vengerai moi-même, de moi-mnême;
De cette propre main, ie veux percer ce flanc, Et lauer à vos yeux mon crime de mon ſang.	De cette propre main, je veux percer ce flanc, Et lauer à vos yeux mon crime de mon sang.
CELIMENE.	CELIMENE.
Ie ne vous parle pas, i’adreſſe ces injures Alu plus vil des mortels, au pire des parjures, Uni meritoit le moins Thonneur de mon amour;	Je ne vous parle pas, j'adresse ces injures Alu plus vil des mortels, au pire des parjures, Uni méritait le moins Thonneur de mon amour;
Et le pliu beau pohrtant qui re ſpire le iour.	Et le pliv beau -phrtant qui ré pire le jour.
SCENE HVICTIESME.	SCÈNE HVICTIESME.
TLORIDAN.	TLORIDAN.
FILAIDRE.	FILAIDRE.
GELIMENE, ALIDOR	GELIMENE, ALIDOR
FLORIDAN, ſans ſe faire voir.	FLORIDAN, sans se faire voir.
V n’en peux plus douter, entens d’icy ſa plainte, 4 Et louë auec moy cette agreable feinte.	V V'en peux plus douter, entends d'ici sa plainte, 4 Et loue auté moi cette agréable feinte.
CELIMENE.	CELIMENE.
Quelle rage eſt pareille à mon reſſentiment?	Quelle rage est pareille à mon ressentiment?
Et qui me vangera de ce perſide Amant?	Et qui me vengera de ce perside Amant?
Si vous ſerueZ, Monſieur, mon amour outragée, Et ſi par voſtre bras ie puis eſtre vangée;	Si vous servez, Monsieur, mon amour outragée, Et si par votre bras Se puis estre vengée;
Voite ne pouſſerez plus d’inutiles ſouſpirs, Mon inclination ſe range à vos deſirs:	Voite ne pousserez plus d'inutiles soupirs, Mon inclination se range à vos désirs:
Vn mariage heureux terminera vos plaintes, Si comme ſes ardeurs les voſtres ne ſont feintes.	Un mariage heureux terminera vos plaintes, Si comme ses ardeurs les vôtres ne sont feintes.
Apportez-moy ſon cœur, c’eſt par cette action, Que vous m’aſſeurerez, de voſtre affection.	Apportez-moi son cœur, c'est par cette action, Que vous m'assurerez, de votre affection.
Qu’vn deffy genereux l’oblige de paroiſtre.	Qu'un défi généreux l'oblige de paraître.
Las!	Las!
vãgeZ mon affrõt, n’espargnez point vn traiſtre, Fendez ce laſche ſein, que ie n’ay ſceu bleſſer.	vangez mon affront, n'épargnez point un traître, Fendez ce lâche sein, que ie ay sceu blesser.
ELORIDAN venant à elle.	ÉLORIDAN venant à elle.
Il m’obligeroit fort s’il s’en pouuoit paſſer.	Il m'obligerait fort s'il s'en pouvait passer.
CELIMENE.	CELIMENE.
Quoy tu parois encor, deteſtable parjure?	Quoi tu parais encor, détestable parjure?
Et tu n'espere pas qu’on venge mon injure?	Et tu n'espère pas qu'on venge mon injure?
FLORIDAN.	FLORIDAN.
y om m'accuſeZ dibri, auorable beaute, Filandre respondra de ma fidelité.	y om m'accuse dibri, avorable beauté, Filandre répondra de ma fidélité.
Jl eſt l’vnique object de l’ardeur qui m’enflamme, Il poſſede tout ſeul & mon cœur & mon ame.	Il est l' opject de l'ardeur qui m'enflamme, Il possède tout seul et mon cœur et mon âme.
Nos deſtins ſont vnis par vn meſme lien:	Nos destins sont unis par un même lien:
Et ſi quetecu vn m'attaque, il deffendra ſon bien.	Et si quetecu un m'attaque, il défendra son bien.
CELIMENE.	CELIMENE.
A-t’il perdu le ſens?	A-t-il perdu le sens?
FLORIDAN.	FLORIDAN.
Oux, car i’aqme un voliage, Qui trahiſſoit pour vous vne foy qui l’engage Mais il reſſent enſin ſa premiere amitié;	Oux, car j'aqme un voliage, Qui trahissait pour vous une foi qui l'engage Mais il ressent ensin sa première amitié;
Et foniuperzgieranremapine.	Et foniuperzgieranremappine.
CELIMENE.	CELIMENE.
Dieux!	Dieux!
qu’il eſtinſenſé, croit-il eſtre vne femme?	qu'il estinsensé, croit-il être une femme?
Lue Rienide Iugez-le par mon ſein.	Lue Riende Jugez-le par mon sein.
CELIMENE.	CELIMENE.
O merueille tô Madame!	Ô merveille tô Madame!
Qu’vne agreable feinte a nos yeux abuſez, I'excuſe maintenant ſi vous me meſpriſez.	Qu'une agréable feinte a nos yeux abusez, J'excuse maintenant si vous me méprisez.
ALIDOR.	ÀLIDOR.
O Dieux!	Ô Dieux!
qui l’euſt penſé?	qui l'eût pensé?
FLORIDAN.	FLORIDAN.
Pour bannir ma triſteſſe, I’ay voulu dans ces lieux eſprouuer mon adreſſe, Et Filandre doutoit, ſçachant voſtre rigueur, Que i’euſſe aſſez, d’attraits, pour toucher voſtre cœur.	Pour bannir ma tristesse, J'ai voulu dans ces lieux éprouver mon adresse, Et Filandre doutait, sachant votre rigueur, Que j'eusse assez, d'attraits, pour toucher votre cœur.
Par diuertiſſement, i’entrepris cette feinte, I’ay ſignalé ma force, & vous eſtiez, atteinte.	Par divertissement, j'entrepris cette feinte, J'ai signalé ma force, et vous étiez, atteinte.
Mais quels ſont vos deſirs, & que puis-je pour vous?	Mais quels sont vos désirs, et que puis-je pour vous?
Alidor vous promet des peſſe-temps plus doux, Et i’ay deu luy ceder, ſçachant comne il vous ayme, Tout ce que ie pretends en voſtre amour extreſme.	Alidor vous promet des pessetemps plus doux, Et j'ai de vez céder, sachant comne il vous aime, Tout ce que je prétends en votre amour extrême.
Si vous m'aymez, encor, comme ie vous promets, Qué mon affection ne ceſſera iamais:	Si vous m'aimez, encor, comme je vous promets, Qué mon affection ne cessera jamais:
Que ie vom cheriray a vne atdeur eternelle, Soyez ſenſible aux maux d’vn Amant ſi fidelle.	Que personne vom chérirai a une atdeur éternelle, Soyez sensible aux maux d'un Amant si fidèle.
CELIMENE.	CELIMENE.
Oüy ie reçoy, Monſieur, voſtre cœur de ſa main, Vous n’accuſerez plus nyrigueur, ny deſdain, Me voylà diſpoſée, à vous rendre iuſlice;	Oui ici reçois, Monsieur, votre cœur de sa main, Vous n'accuserez plus nirigueur, ni dédain, Me voilà disposée, à vous rendre juslice;
Et vous denez ce bien à ce doux arttfice.	Et vous denez ce bien à ce doux artfice.
FLORIDAN.	FLORIDAN.
Que demandez-vous plus?	Que demandez-vous plus?
ALIDOR Cet vnique diſcours Me pouuoit rendre heureux, & conſeruer mes ioüts.	ÀLIDOR Cet unique discours Me pouvait rendre heureux, et conserver mes jouts.
Apres mes longs ennuys ma joye eſt ſans ſeconde, Et ie paſſe en bon-heur, tous les Amans du monde.	Après mes longs ennuis ma joie est sans seconde, Et tu passe en bonheur, tous les Amants du monde.
CELIMENE.	CELIMENE.
Adieu retirons-nous, & viuons tous contens.	Adieu retirons-nous, et vivons tous contents.
FLORIDAN.	FLORIDAN.
Non non veneZ jouyr d’vn autre paſſe-temps,	Non non venez jouir d'une autre passe-temps,
SCENE NEVFIESME.	SCÈNE NEUFIESME.
LA NVICT.	LA NVICT.
FELICIE ſeule.	FELICIE seule.
Ombre s’eſtend par tout, & le Soleil qui fuit LAcedé ſes maiſons aux filles de la nuit;	Ombre s'étend par tout, et le Soleil qui fuit LAcédé ses maisons aux filles de la nuit;
Que Floridan eſt longt que l’ardeur qui le preſſe, Maintenant paroiſt fauſſe, ou lente en ſa pareſſe!	Que Floridan est longt que l'ardeur qui le presse, Maintenant paraît fausse, ou lente en sa paresse!
Ie l’attendois là haut, mais enfin le ſoucy De l’y mener ſans bruit m'a fait deſcendreicy;	Je l'attendais là haut, mais enfin le souci De l'y mener sans bruit m'a fait descendreici;
Chacun me croit au lit, ma Sœur eſt endormie, Et ie puis maintenant tromper cette ennemie;	Chacun me croit au lit, ma Sœur est endormie, Et personne puis maintenant tromper cette ennemie;
Iurant à ce Vainqueur vne impunable foy, Et rangeant ſa raiſon ſoubs vne meſme lo I'entends du bruit, c'eſt luy.	Jurant à ce Vainqueur une impunable foi, Et rangeant sa raison sous nos armes lo J'entends du bruit, c'est lui.
e-	E-
SCENE DIXIESME.	SCÈNE DIXIÈME.
LYSIS.	LYSIS.
FELICIE.	FELICIE.
LYSIS.	LYSIS.
Auiſe ceſte belle.	Auise cette belle.
Eſt-ce vous Floridan?	Est-ce vous Floridan?
FELICIE.	FELICIE.
LYSIS.	LYSIS.
Et vous m’eſtes fidelle?	Et vous m'êtes fidèle?
Ie plais ſeul a vos yeuxt vous m'aymez conſtamment?	Je plais seul a vos yeuxt vous m'aimez constamment?
Et ma jalouſe humeur n’a point de fondement?	Et ma jalouse humeur n'a point de fondement?
FELICIE.	FELICIE.
ui minse Jeyj	Oui minse Jeij
LYSIS.	LYSIS.
Tionuan pen, Mladume, Receuoir dù ſecours à l’ardeur qui l’enflamme;	Tionvan pen, Mladume, Recvoir dù secours à l'ardeur qui l'enflamme;
Et pour vous diuertir, i’ay deuancé ſes pas:	Et pour vous divertir, j'ai devancé ses pas:
Vous le verrez bien-toſt, ne vous ennu yez pas.	Vous le verrez bientôt, ne vous ennu yez pas.
FELICIE.	FELICIE.
Qu'eſt-ce que tu veux dire?	Qu'est-ce que tu veux dire?
LYSIS.	LYSIS.
Oles ardeurs parfaictes, Dont il recognoiſtra l’honneur que vous lu y faictes!	Oles ardeurs parfaites, Dont il reconnaîtra l'honneur que vous lu y faites!
L’incomparable Amant, qu’il à de paßion!	L'incomparable Amant, qu'il a de passion!
Et que vous eſtes iuſte en cętte election!	Et que vous êtes juste en cętte élection!
Que dit cét inſenſé?	Que dit cet insensé?
2110 22	2110 22
LYSIS:	LYSIS:
Faut-il que ie le die?	Faut-il que venir le die?
Le Ciel, ame ſans foy, punit ta perfidie.	Le Ciel, âme sans foi, punit ta perfidie.
Floridan s’eſt mocqué, ce Vainqueur glorieux Te faict ſeruir de fable aux Amans de ces lieux;	Floridan s'est moqué, ce Vainqueur glorieux Te fait servir de fable aux Amants de ces lieux;
Ilrit de tes faueurs, meſpriſe tes carreſſes, Et ne te daigne meitre au rang de ſes maiſtreſſes;	Ilrit de tes faveurs, méprise tes carresses, Et ne te daigne meitre au rang de ses maîtresses;
Le ſuperbe qu’il eſt, ne conſidere pas, Entre tant de beauit Sut frjoibies appas;	Le superbe qu'il est, ne considère pas, Entre tant de beauit Sut frjoibies appas;
Il te plaint en ſon cœur, quand tu crois qu’il t’adore.	Il te plaint en son cœur, quand tu crois qu'il t'adore.
Voy cette lettre!	Vois cette lettre!
FELVCTE.	FELUCTE.
O Dieux?	Ô Dieux?
LYSIS:	LYSIS:
Et tu m’aymes encore?	Et tu m'aimes encore?
Ie me plaignois à tort, la conſtante beauté!	Je me plaignais à tort, la constante beauté!
O miracle d'amour, & de fidelité!	Ô miracle d'amour, et de fidélité!
Il t’a donné la lettre?	Il t'a donné la lettre?
FELICIE.	FELICIE.
LYSIS.	LYSIS.
Oüy, luy-meſine, & ie jure, L'eſclat de tes beaux yeux qui m'ont fait ceſte injure;	Oui, Seigneur-mène, et ainsi jure, L'éclat de tes beaux yeux qui m'ont fait cette injure;
Qu’il traictoit ton amour auec tant de meſpris, Qu'vn courroux furieux enflammoit mes eſpris;	Qu'il traitait ton amour avec tant de mépris, Qu'un courroux furieux enflammait mes épris;
Ie nele pouuois voir, ny ſouffrir ſon langage!	Je nele pouvais voir, ni souffrir son langage!
Et ie t’allois vanger, s'il euſt dit d’auantage.	Et beau t'allais venger, s'il eût dit davantage.
Je ne pouuois ſouffrir, qu’il aymaſt tes appas, Et ſi i’eſtois faſché qu’il ne les aymaſt pas.	Je ne pouvais souffrir, qu'il aimât tes appas, Et si j'étais fâché qu'il ne les aimât pas.
L’orgueilleux eſt charmé de certaine Carite, Dont il iure que rien n’eſgalle le merite;	L'orgueilleux est charmé de certaine Carite, Dont il jure que rien n'égale le mérite;
Et penſant obliger ma chaſte affection, Jl m'enuoye à ſa place à l’aßignation;	Et pensant obliger ma chaste affection, Jl m'envoie à sa place à l'assignation;
Faicts eſtat maintenant du beau nœud qui t’areſte, Voy s'il t’eſt glorieux de vanper ta conqueſte.	Faits état maintenant du beau nœud qui t'arrête, Vois s'il t'est glorieux de vanper ta conquête.
FELICIE.	FELICIE.
Surpriſe à cerapport, & reduite à ce poinct, Que diray-je, ou plutoſt, que ne diray-ie poinct?	Surprise à cerapport, et réduite à ce point, Que dirai-je, ou plutôt, que ne dirai-je point?
A quoyme reſoudra le courroux qui m'enſſamme?	À quoime résoudra le courroux qui m'enssamme?
Mais ce reſſentiment m’oſte la voix, & l’ame?	Mais ce ressentiment m'ôte la voix, et l'âme?
Elle s’euanoüyt.	Elle s'euanoüyt.
LYSIS la ſouſtenant.	LYSIS la soutenant.
Madame, ô Ciel!	Madame, ô Ciel!
ô Dieuxt où dois-je auoir recours?	ô Dieuxt où dois-je avoir recours?
Par quelle inuention luy donner du ſecours?	Par quelle invention lui donner du secours?
uospurnne un moijo Mieuat oqurant cauemjer Den Iefpeuu pouuousjudau epemdormis,	uospurnne un moiio Mieuat oqurant cavemjer Den Iefpeuu pouuousjudau épemdormis,
SCENE DERNIERE.	SCÈNE DERNIÈRE.
LYSIS.	LYSIS.
FELICIE.	FELICIE.
CELIMENE.	CELIMENE.
ALIDOR.	ÀLIDOR.
FILANDRE.	FILANDRE.
FLORANTE.	FLORANTE.
CELIMENE.	CELIMENE.
On, non, ie ne dors pas.	On, non, Madame ne dors pas.
FILANDRE.	FILANDRE.
Dieux!	Dieux!
qu’eſt-ce que ie voy?	qu'est-ce que ie cy?
CELIMENE.	CELIMENE.
Cherchez du feu là haut:	Cherchez du feu là haut:
ma Sœur parlez, à moy.	ma Sœur parlez, à moi.
Ne m'entendeZ-vous pas?	Ne m'entendez-vous pas?
i’ameine ce perfide Qui ſur nos liberteZ ſi laſchement preſide.	j'amène ce perfide Qui sur nos liberté si lâchement préside.
Floridaneſticy, puniſſons ſes deſdains;	Floridanétici, punissons ses dédains;
Vangeons nous, eſtou ffons cette horreur des humains;	Vengeons -nous, étou font cette horreur des humains;
all deye	all deye
FELICIE reuenant de ſa paſmoiſon.	FELICIE revenant de sa pâmoison.
Ha perfide tha parjure!	Ha perfide tha parjure!
I'aſſouuiray ma rage, & vangeray l’injure.	J'assouvirai ma rage, et vengerai l'injure.
A Alidor luy voulantoſter ſon eſpée.	A Alidor lui voulantôter son épée.
DonneZ, preſtez, ce fer, que t’arrache ſon cœur, Et que ie foulle aux pieds ce ſuperbe Uainqueur.	Donnez, prêtez, ce fer, que t'arrache son cœur, Et que ie joulle aux pieds ce superbe Uainqueur.
FLORANTE.	FLORANTE.
Qu'eſt-ce?	Qu'est-ce?
que voulez-vous?	que voulez-vous?
FELICIE.	FELICIE.
Ce que ie veux infame?	Ce que ici veux infâme?
Laiſſez, donnez ce fer, ou m'en arrachez, l’ame.	Laissez, donnez ce fer, ou m'en arrachez, l'âme.
Mon affront vous plaiſt-il?	Mon affront vous plaît-il?
& me deniez-vous Le moyen d’alleger vn ſi iuſte courroux?	et me déniez-vous Le moyen d'alléger un si juste courroux?
FLORANTE.	FLORANTE.
Quoy vous eſt-ce vn affront que mon indifference?	Quoi vous est-ce un affront que mon indifférence?
Qu'eſt-ce qu'vn incognu doit à voſtre eſperance?	Qu'est-ce qu'un inconnu doit à votre espérance?
Dois-je aymer à la fois mille ieunes beautez, Dont mes yeux, ſans deſſein, forcent les libertez?	Dois-je aimer à la fois mille jeunes beautés, Dont mes yeux, sans dessein, forcent les libertés?
Eſperez-vous l’effect de mes vaines promeſſes?	Espérez-vous l'effet de mes vaines promesses?
Et voullez-vous qu’vn homme eſpouſe cent maiſtreſſes?	Et voullez-vous qu'Hommes homme épouse cent maîtresses?
ALIDOR.	ÀLIDOR.
E aymable paſeeremps:	E aimable paseèremps:
CELIMENE.	CELIMENE.
Ha!	Ha!
ma Sœur, c’eſt aſſez, Auoir de vains diſcours vos deſirs trauerſez.	ma Sœur, c'est assez, Avoir de vains discours vos désirs traversez.
Floridan vous adore, & quoy qu’il dißimule, Meſſeos vono prommerute veun pen quile bruſle.	Floridan vous adore, et quoi qu'il dissimule, Messeos vono promerute veun pen quile brûle.
L’honneur de vos baiſers eſt ſonbien le plus doux, Et cette meſme nuict il couche auecque vous?	L'honneur de vos baisers est sonbien le plus doux, Et cette belle nuit il couche avec vous?
FELICIE.	FELICIE.
Ce qui vous ſera bon, ne l’offrez point à d’autres, Et ne preferez, point mes intereſts aux voſtres.	Ce qui vous sera bon, ne l'offrez point à d'autres, Et ne préférez, point mes intérêts aux vôtres.
Qui vous charge ma Sœur, d’vn ſemblable ſoucy.	Qui vous charge ma Sœur, d'un semblable souci.
Et quelle humeur vous porte à me parler ainſi?	Et quelle humeur vous porte à me parler ainsi?
CELIMENE.	CELIMENE.
Comment?	Comment?
̀ vous deſdaignez, ces faueurs infinies, Uoſtre cœur, a deſia ſes paßions bannies, Uoſtre flamme eſt eſteinte, & vos fers ſont vſez?	 vous dédaignez, vos faveurs infinies, Uotre cœur, a déjà ses passions bannies, Uotre flamme est éteinte, et vos fers sont vsez?
Ie l’accepteray donc, ſi vous le refuſez.	Je l'accepterai donc, si vous le refusez.
ça prenons cent baiſers ſur cette belle bouche, Ie ſuis à vous, Monſieur, & vous offre ma couche.	ça prenons cent baisers sur cette belle bouche, Je suis à vous, Monsieur, et vous offre ma couche.
FELICIE.	FELICIE.
Elle a perdu l’eſprit!	Elle a perdu l'esprit!
Dieux qu’eſt-ce que i’entends?	Dieux qu'est-ce que j'entends?
CELIMENE.	CELIMENE.
Ae parte tunt deson.	Ae parte tunt déson.
FILANDRE.	FILANDRE.
O le doux paſſe-temps!	Ô le doux passetemps!
FLORIDAN.	FLORIDAN.
Madame, i’ayme außi cette rare merueille, Et pour vos deux beautez, mon ardeur eſt pareille.	Madame, j'aime aussi cette rare merveille, Et pour vos deux beautés, mon ardeur est pareille.
Vous deuez, toutes deux accorder à mes maux De pareilles faueurs, & des plaiſirs égaux.	Vous devez, toutes deux accorder à mes maux De pareilles faveurs, et des plaisirs égaux.
Que dit cét inſenſé?	Que dit cet insensé?
FELICIE.	FELICIE.
TEORIDAN monſtrant ſon ſein.	TEORIDAN montrant son sein.
Dittes cette inſenſée, VoyeZ par quelle erreur, i’ay voſtre ame bleſſée, Appr onmuiovommne nam poumertiſſement, Puis-je pas auec vous coucher innocemment?	Dites cette insensée, VoyeZ par quelle erreur, j'ai reste âme blessée, Appr onmuiovommne nam oumertissement, Puis-je pas avec vous coucher innocemment?
FELICIE.	FELICIE.
O Dieux lie doute icy, ſi ie voy la lumiere?	Ô Dieux lie doute ici, si ie ici la lumière?
CELIMENE.	CELIMENE.
Il ſe faut conſoler, i’ay failly la premiere, Ie la croyois vnhomme, & tous l’ont eſtimé;	Il se faut consoler, j'ai failli la première, Je la croyais vnhomme, et tous l'ont estimé;
Certes vn tel Amant deuroit bien eſtre aymé.	Certes un tel Amant devrait bien être aimé.
Mais reprenez, Lyſis.	Mais reprenez, Lysis.
L1919.	L1919.
O merueille incroyable!	Ô merveille incroyable!
FELICLE.	FELICLE.
XPei veuxeanguiele:	XPei veuxeanguiele:
Excuſe, cher Lyſis, mon infidelité, Ou bien de cette offence accuſe ſa beauté.	Excuse, cher Lysis, mon infidélité, Ou bien de cette offense accuse sa beauté.
LYSIS.	LYSIS.
Luy uou-ſe ce paruont uutauame, pour vous plaire, Et pour me plaire au ßi, ie force ma cholere.	Lui use ce parvont utaume, pour vous plaire, Et pour me plaire au , Et pour me plaire au
novenuvunes peeuuves.	novenuvunes peeuuves.
puumuquuums appas, Mais à condition de n'y retomher pas.	puumuquums appas, Mais à condition de n'y retomher pas.
FILANDRE.	FILANDRE.
Et moy?	Et moi?
tous mes deſſeins retournent à Florante.	tous mes desseins retournent à Florante.
I’aymeray conſtamment cette beauté charmante.	J'aimerai constamment cette beauté charmante.
à Celimene.	à Celimène.
Ie ne troubleruy plus voſtre contentement, Vous n’accuſerez, plus vn importun Amant.	Je ne troublerui plus votre contentement, Vous n'accuserez, plus un importun Amant.
CheriſſeZ Alidor.	Chérissez Alidor.
dont le m'erite extreſme, Doit à ſa paßion acquerir ce qu’il ayme.	dont le m'érite extrême, Doit à sa passion acquérir ce qu'il aime.
Vous luy deuez des vœux ayánt cauſe ſon mal, Et ce parfaict Amant n’aura plus de riual.	Vous avez devez des vœux ayánt cause son mal, Et ce parfait Amant n'aura plus de rival.
CETIMENE.	CETIMENE.
ay promis de l'aymer.	ai promis de l'aimer.
ALIDOR.	ÀLIDOR.
O faueur ſans pareille!	Ô faveur sans pareille!
BIEANDRE, à Torante.	BIEANDRE, à Torante.
Me pardonnez-vous pas agreable merueille?	Me pardonnez-vous pas agréable merveille?
FLORIDAN.	FLORIDAN.
J'en doute, & cette nuict me donnera conſeil.	J'en doute, et cette nuit me donnera conseil.
à Lyſis, & Alidor.	à Lysis, et Alidor.
Et bien eſperiez-vous vn changement pareil?	Et bien espériez-vous un changement pareil?
Et quand vous ſongerez à ces effects eſtranges, Me refuſerez-vous d’eternelles loüanges?	Et quand vous songerez à ces effets étranges, Me refuserez-vous d'éternelles louanges?
LT3I3.	LT3I3.
Cracutlvaul,pmccuuve.	Cracutlvaul,pmccuuve,
seeur, Qui m'a cauſé tantoſt, cette aueugle fureur.	seûr, Qui m'a causé tantôt, cette aveugle fureur.
Ie vant eray par tout cette feinte agreable.	Je vant erai par tout cette feinte agréable.
ALIDOR.	ÀLIDOR.
Nom vom fommes temie a vnbuenincomparable.	Nom vom fommes témie a mébuenincomparable.
FLORIDAN.	FLORIDAN.
Adieu retirons-nous, & demain tout le iour, Il faut ſacri fier an pouuoir de l’amour.	Adieu retirons-nous, et demain tout le jour, Il faut sacri fier an pouvoir de l'amour.
CELIMENE.	CELIMENE.
Il eſt bien tard, Adieu.	Il est bien tard, Adieu.
FLORIDAN dit à Lyſis.	FLORIDAN dit à Lysis.
Menez-moy chez ma Tante, Cette nuict va changer Floridan à Florante.	Menez-moi chez ma Tante, Cette nuit va changer Floridan à Florante.
FIN.	FIN.
Cuisilerale Mesyj	Cuisilerale Mesyj
Ar grace & Priuilege du Roy donné à Roye, en 2datte du dernier Septembre, 1636.	Ar grâce et Privilège du Roi donné à Roye, en 2datte du dernier Septembre, 1636.
Et Signé, Par le MAPn Roy en ſon Conſeil.	Et Signé, Par le MAPn Roi en son Conseil.
DE MONSSEAVX, Il eſt permis à ANTOINE DE SOMMAVILLE, Marchand Libraire à Paris, d’imprimer ou faire imprimer,vendre & diſtribuer vne piece de Theatre de la compoſition du Sieur de ROTROV, intituléc LA CRLIMENE, durant le temps & eſpace de ſept ans, à comptet du iour qu’elle ſera acheuée d’imprimer.	DE MONSEAUX, Il est permis à ANTOINE DE SOMMAVILE, Marchand Libraire à Paris, d'imprimer ou faire imprimer,vendre et distribuer une pièce de Théâtre de la composition du Sieur de ROTROU, intituléc LA RLIMENE, durant le temps et espace de sept ans, à comptet du jour qu'elle sera achevée d'imprimer.
Et deffences ſont faictes à tous Imprimeurs, Libraires, & autres, de contrefaire ladite piece, ny en vẽdre ou expoſer en vente de contrefaicte,à peine de trois mille liures d’amende, de tous ſes deſpens, dommages & intereſts;	Et défenses sont faites à tous Imprimeurs, Libraires, et autres, de contrefaire ladite pièce, notre en vendre ou exposer en vente de contrefaite,à peine de trois mille livres d'amende, de tous ses dépens, dommages et intérêts;
ainſi qu’il eſt plus amplement porté par leſdites Lettres qui ſont en vertu du preſent Extralet tenues pour bien & deuëment ſignihées, à ce qu’aucun n’en pretende cauſe d’ignorance.	ainsi qu'il est plus amplement porté par lesdites Lettres qui sont en vertu du présent Extralet tenues pour bien et duement signihées, à ce qu'aucun n'en prétende cause d'ignorance.
Ledit Sommauille a aſſocié au Priuilege cy deſſus Touſſainct Quinet auſſi Marchand Libraire, pour moitié, ſuiuant l’accord à cét effect faict entr’eux.	Ledit Sommauille a associé au Privilège cy -dessus Toussaint Quinet aussi Marchand Libraire, pour moitié, suivant l'accord à cet effet fait entr'eux.
