A A R Q Chez PIERRE LE MO NIER, au Palais,) vis à vis la onte de l’Egliſe de la Sainte Chapelle, à l’Image S.	A À R Q Chez PIERRE LE MO NIER, au Palais,) vis -à -dix la onte de l'Église de la Sainte Chapelle, à l'Image S.
Louis, & au feu divin.	Louis, et au feu divin.
M.	M.
DC.	DC.
LXXI.	LXXI.
AVEC PRIVILEGE DV ROY.	AVEC PRIVILÈGE DU ROY.
’Ouuerture ſe fait par Eraſte, qui Lconduit vn grand Concert de Voix & d’Inſtrumens, pour vne Serenade, dont les Paroles chantées par trois Voix en maniere de Dialogue, ſont faites ſur le Sujet de la Comedie, & expriment les ſentimens de deux Amans, qui eſtans bien enſemble, ſont trauerſez par le caprice des Parens.	Ouuerture se fait par Eraste, qui Lconduit un grand Concert de Voix et d'Instruments, pour venir Serenade, dont les Paroles chantées par trois Voix en manière de Dialogue, sont faites sur le Sujet de la Comédie, et expriment les sentiments de deux Amants, qui étant bien ensemble, sont traversez par le caprice des Parents.
Premiere Voix.	Première Voix.
Répans, charmante nuit, répans ſur tous les yeux, De tes pauots la douce violence, Et ne laiſſeveiller en ces aimables lieux Que les cœurs que l’Amour ſoûmet à ſa puiſſance.	Répans, charmante nuit, répans sur tous les yeux, De tes pauots la douce violence, Et ne laisseiller en ces aimables lieux Que les cœurs que l'Amour soumet à sa puissance.
lei ſrrellle.	le srrellle.
Plus beau que le plus beau jour, Offrent de doux momens à ſoûpirer d’amour.	Plus beau que le plus beau jour, Offrent de doux moments à soupirer d'amour.
Que ſoûpirer d’amour Eſt vne douce choſe, Quand rien à nos vœux ne s’oppoſe!	Que soupirer d'amour Est une douce chose, Quand rien à nos vœux ne s'oppose!
A d’aimables penchans noſtre cœur nous diſpoſe, Mais on a des Tyrans à qui l’on doin le jour:	À d'aimables penchants notre cœur nous dispose, Mais on a des Tyrans à qui l'on doin le jour:
Que ſoûpirer d’amour Eſt vne douce choſe, Quand rien à nos vœux ne s’oppoſe!	Que soupirer d'amour Est une douce chose, Quand rien à nos vœux ne s'oppose!
Troiſiéme.	Troisième.
Voix.	Voix.
Tout ce qu’à nos vœux on oppoſe, Contre vn parfait amour ne gagne iamais rien;	Tout ce qu'à nos vœux on oppose, Contre un parfait amour ne gagne jamais rien;
Et pour vaincre toute choſe, I ne faut que s’aimer bien.	Et pour vaincre toute chose, I ne faut que s'aimer bien.
Aimons-nous donc d’vne ardeur eternelle, Les rigueurs des Parens, la contrainte cruelle, L’abſence, les trauaux, la fortune rebelle, Ne font que redoubler vne amitiè fidelle:	Aimons-nous donc d'une ardeur éternelle, Les rigueurs des Parents, la contrainte cruelle, L'absence, les travaux, la fortune rebelle, Ne font que redoubler une amitiè le:
Aimons-nous donc d’vne ardeur eternelle.	Aimons-nous donc d'une ardeur éternelle.
Quand deux cœur, S aimen vien, Tout le reſte n’eſt rien.	Quand deux cœur, S aimen viens, Tout le reste n'est rien.
La Serenade eſt ſuiuie d’vne Dance de deux Pages, pendant laquelle quatré Curieux de Spectacles ayans pris querelle enſemble, mettent l’épée à la main.	La Serenade est suivie d'une Dance de deux Pages, pendant laquelle quatré Curieux de Spectacles ayant pris querelle ensemble, mettent l'épée à la main.
Apres vn aſſez agreable Combat, ils ſont ſeparez par deux Suiſſes, qui les ayant mis d’accord dançent auec eux, au ſon de tous les Inſtrumens.	Après un assez agréable Combat, ils sont séparés par deux Suisses, qui les ayant mis d'accord dançent avec eux, au son de tous les Intruments.
m em t& &ra:	m em tomb etra:
te tur tutx tal te Extrait du Priuilege du Roy.	te tur tutx tal te Extrait du Privilège du Roi.
DAR Grace & Priuilege du Roy, Donné à PaI ris, le 20.	DAR Grâce et Privilège du Roi, Donné à PaI ris, le 20.
iour de Fevriet, l’an de grace 1670.	jour de Févriet, l'an de grâce 1670.
Signé, Par le Roy en ſon Conſeil, BOVCHÉT.	Signé, Par le Roi en son Conseil, BOVCHÉT.
Il eſt permis à Jean Baptiſte Pocquelin de Moliere, l’vn de nos omediens, de faire imprimer, vendre & debiter vne Piece de Theatre, intitulée MONSIEVR DE POVRCEAVGNAC;	Il est permis à Jean Baptiste Pocquelin de Molière, l'un de nos omédiens, de faire imprimer, vendre et débiter une Pièce de Théâtre, intitulée MONSIEUR DE POURCEAUGNAC;
& ce par tel imprimeur, ou Libraire qu’il voudra choiſir, pendant le temps & eſpace de cinq années entieres & accomplies, à compter du iour que ladite Piece ſera acheuée d’imprimer pour la premiere fois:	et ce par tel imprimeur, ou Libraire qu'il voudra choisir, pendant le temps et espace de cinq années entières et accomplies, à compter du jour que ladite Pièce sera achevée d'imprimer pour la première fois:
Et defenſes ſont faites à toutes Perſonnes, de quelque qualité & condition qu’ils ſoient, d’imprimer, faire imprimer, vendre, ny debiter ladite Piece, ſans le conſentement de l’Expoſant, ou de ceux qui auront droict de luy, à peine de ſix mil liures d’amende, confiſcation des Exemplaires contrefaits, & de tous deſpens, dommages & intereſts, ainſi que plus au long il eſt porté audit Priuilege.	Et défenses sont faites à toutes Personnes, de quelque qualité et condition qu'ils soient, d'imprimer, faire imprimer, vendre, ni débiter ladite Pièce, sans le consentement de l'Exposant, ou de ceux qui auront droit de Seigneur, à peine de six mille livres d'amende, confiscation des Exemplaires contrefaits, et de tous dépens, dommages tous dépens, ou de ceux qui auront il est porté audit Privilège.
Regiſtré ſur le Liure de la Communauté, ſuiuant l’Arreſt de la Cour du 8 Avril 1653.	Registré sur le Livre de la Communauté, suivant l'Arrest de la Cour du 8 Avril 1653.
le 28.	le 28.
Fevrier 1670.	Février 1670.
Signé, André Soubron, Syndic.	Signé, André Soubron, Syndic.
Acheué d’impr mer pour la premiere fois, le 3.	Achevé d'impr mer pour la première fois, le 3.
jour de Mars 1670.	jour de Mars 1670.
ACTEVRS.	ACTEURS.
MONS EVR DE POVRCEAVGNAC,	MONS EUR DE POURCEAUGNAC,
IVLIE, Fille d’Oronte.	IVLIE, Fille d'Oronte.
NERINE, Fiinii dii gues	NERINE, Fiini dii gués
Lvourre Mu Gurtoier	Lévourre Mu Gurtoyer
ERACTE, Amant de Iulie.	ERACTE, Amant de Julie.
BRIGANI, Napolitain, Homme d’intrigue.	BRIGANI, Napolitain, Homme d'intrigue.
REMTER MEDECIN.	REMTER MÉDECIN.
SECOND MEDECIN.	SECOND MÉDECIN.
L’APOTIQ VAIRE.	L'APOTIQ VAIRE.
PAYS (1	PAYS (1
E PAI SANE.	E PAI ZANE.
REMIER MVSICIEN.	REMIER MUSICIEN.
ECOND MVSICIEN.	ECOND MUSICIEN.
X ARCHERS.	X ARCHERS.
PLVSIEVRS VSICIENS, IOVEVRS D'INSTRVMINS, & DANCEVRS.	PLUSIEURS VSICIENS, IOVEVRS D'INSTRUMINS, et DANCEURS.
MONSIEVR DE POVRCEAVGNAC.	MONSIEUR DE POURCEAUGNAC.
COMEDIE.	COMÉDIE.
ACTE I DDHNDAREMIHNE.	ACTE I DHNDAREMIHNE.
IVLIE, ERASTE,NERINE.	IVLIE, ERASTE,NERINE.
IVLIE.	IVLIE.
ON Dieu, Eraſte, gardons d’eſtre ſurpris;	ON Dieu, Éraste, gardons d'être surpris;
ie tremble qu’on ne nous voye enſemble, & tout ſeroit perdu, apres la defenſe que l’on m’a faite.	ie tremble qu'on ne nous voit ensemble, et tout serait perdu, après la défense que l'on m'a faite.
ERASTE.	ERASTE.
Ie regarde de tous côtez, & ie n’apperçoy rien.	Je regarde de tous côtés, et Seigneur n'aperçois rien.
IVLIE.	IVLIE.
Aye auſſi l’œil au guet, Nerine, & prens bien garde qu’il ne vienne perſonne.	Aye aussi l'œil au guet, Nerine, et prends bien garde qu'il ne vienne personne.
NERINE.	NERINE.
Repoſez-vous ſur moy, & dites nardiment ce que vous auez à vous dire.	Reposez-vous sur moi, et dites nardiment ce que vous avez à vous dire.
IVLIE.	IVLIE.
Auez-vous imaginé pour noſtre affaire quelque choſe de fauorable?	Avez-vous imaginé pour notre affaire quelque chose de favorable?
& croyez-vous, Eraſte, pouuoir veiſſl à bout de detourner ce fâcheux Mariage que mon Pere s’eſt mis en teſte?	et croyez-vous, Erâte, pouvoir véissl à bout dé tourner ce fâcheux Mariage que mon Père s'est mis en tête?
ERASTE.	ERASTE.
Au moins y trauaillons-nous fortement;	Au moins y travaillons-nous fortement;
& déja nous auons preparé vn bon nombre de Batteries pour renuerſer ce deſſein ridicule.	et déjà nous avons préparé un bon nombre de Batteries pour renverser ce dessein ridicule.
NERINE.	NERINE.
r'ar iia foy, voila voſtre Pere;	rar jia foi, voilà votre Père;
IVLIE.	IVLIE.
Ah ſeparons-nous viſte.	Ah séparons-nous vite.
NERINE.	NERINE.
Ttoni;	Ttoni;
non, non, ne bougez, ie m’eſtois trompée.	non, non, ne bougez, Seigneur m'étais trompée.
IVLIE.	IVLIE.
Mon Dieu, Nerine, que tu es ſotte, de nous donner' de ces frayeurs:	Mon Dieu, Nerine, que tu es sotte, de nous donner de ces frayeurs:
ERASTE.	ERASTE.
Oüy, belle Iulie, nous auons dreſſé pour cela quantité de Machines, & nous ne feignons point de mettre tout en vſage, ſur la permiſſion que vous m’auez donnée.	Oui, belle Julie, nous avons dressé pour cela quantité de Machines, et nous ne feignons point de mettre tout en usage, sur la permission que vous m'avez donnée.
Ne nous demandez point tous les reſſorts que nous ferons joüer, vous en aurez le diuertiſſement;	Ne nous demandez point tous les ressorts que nous ferons jouer, vous en aurez le divertissement;
& comme aux Comedies, il eſt bon de vous laiſſer le plaiſir de la ſurpriſe, & de ne vous auertir point de tout ce qu’on vous fera voir, c’eſt aſſez de vous dire que nous auons en main diuers ſtratagémes tous preſts à produire dans l’occaſion, & que l’ingenieuſe Nerine & l’adroit Sbrigani entreprennent l’affaire.	et comme aux Comédies, il est bon de vous laisser le plaisir de la surprise, et de ne vous avertir point de tout ce qu'on vous fera voir, c'est assez de vous dire que nous avons en main divers stratagèmes tous prêts à produire dans l'occasion, et que l'ingénieuse Nerine et l'adroit Srigani entreprennent l'affaire.
NERINE.	NERINE.
Aſſurément.	Assurément.
Voſtre Pere ſe moque-t-il, de vouloir vous anger de ſon Auocat de Limoges Monſieur de Pourceaugnac, qu’il n’a veu de ſa vie, & qui vient par le Coche vous enleuer à noſtre barbe?	Votre Père se montre-t-il, de vouloir vous anger de son Avocat de Limoges Monsieur de Pourceaugnac, qu'il n'a vu de sa vie, et qui vient par le Coche vous enlever à notre barbe?
Faut-il que trois ou quatre mille eſcus de plus, ſur la parole de voſtre Oncle, luy faſſent rejetter vn Amant qui vous agrée?	Faut-il que trois ou quatre mille écus de plus, sur la parole de votre Oncle, te fassent rejeter un Amant qui vous agrée?
& vne Perſonne comme vous, eſt-elle nuico poul in Eſioim?	et une Personne comme vous, est-elle nuico poul in Sioim?
S’il a enuie de ſe marier, que ne prend-il vne Limoſine, & ne laiſſe-t-il en repos les Chreſtiens?	S'il a envie de se marier, que ne prend-il une Limine, et ne laisse-t-il en repos les Chrétiens?
Le ſeul nom de Monſieur de Pourceaugnac m’a mis dans vne colere effroyable.	Le seul nom de Monsieur de Pourceaugnac m'a mis dans une colère effroyable.
I'enrage de Monſieur de Pourceaugnac.	J'enrage de Monsieur de Pourceaugnac.
Quand il n’y auroit que ce nom-là Monſieur de Pourceaugnac, i’y bruleray mes Liures, ou ie rompray ce Mariage, & vous ne ſerez point Madame de Pourceaugnac.	Quand il n'y aurait que ce nom-là Monsieur de Pourceaugnac, j'y brûlerai mes Livres, ou ainsi romprai ce Mariage, et vous ne serez point Madame de Pourceaugnac.
Pourceaugnac!	Pourceaugnac!
cela ſe peut-il ſouffrir?	cela se peut-il souffrir?
Non, Pourceaugnac eſt vne choſe que ie ne ſçaurois ſuporter, & nous luy joüerons tant de pieces, nous luy feroiis cant cte menco rurncnes, que nous renuoyerons à Limoges Monſieur de Pourceaugnac.	Non, Pourceaugnac est une chose que je ne saurais supporter, et nous reste jouerons tant de pièces, nous lui feroyis cant cite menco rurnes, que nous renvoyerons à Limoges Monsieur de Pourceaugnac.
ERASTE.	ERASTE.
Voicy noſtre ſubtil Napolitain, qui nous dira des nouuelles.	Voici notre subtil Napolitain, qui nous dira des nouvelles.
A iij	À jijà
SCENE II.	SCÈNE II.
SBRIGANI, IVLIE, ERASIES NERINE.	SBRIGANI, IVLIE, ERASIES NERINE.
SBRIGANI.	SBRIGANI.
Onſieur, voſtre Homme IV Tarriue, ie l’ay veu à trois lieuës d’icy, où a couché le Coche;	Onsieur, votre Homme IV Tarrive, Elle l'ai vu à trois lieues d'ici, où a couché le Coche;
& dans la Cuiſine où il eſt deſcendu pour déjeuner, ie l’ay étudié vne bonne groſſe demie heure, & ie le ſçay déja par cœur.	et dans la Cuisine où il est descendu pour déjeuner, je l'ai étudié une bonne grosse demie heure, et apprendre le sais déjà par cœur.
Pour ſa figure, ie ne veux point vous en parler, vous verrez de quel air là Nature l’a deſſeinée, & ſi l’ajuſtement qui l’accompagne y répond comme il faut:	Pour sa figure, je ne veux point vous en parler, vous verrez de quel air là Nature l'a desseinée, et si l'ajustement qui l'accompagne y répond comme il faut:
mais pour ſon Eſprit, ie vous auertis par auance qu’il eſt des plus épais qui ſe faſſent;	mais pour son Esprit, je vous avertis par avance qu'il est des plus épais qui se fassent;
que nous trouuons en luy vne matiere tout-à-fait diſpoſée pour ce que nous voulons, & qu’il eſt Homme enfin à donner dans tous les paneaux qu’on huly preſentera.	que nous trouvons en vain une matière tout-à-fait disposée pour ce que nous voulons, et qu'il est Homme enfin à donner dans tous les paneaux qu'on huli présentera.
E le lxe ads.	E le lxe ads.
Nous dis-tu vray?	Nous dis-tu vrai?
SDRIGANE Oüy, ſi ie me connois en Gens.	SDRIGANE Oui, si personne me connais en Gens.
NERINE.	NERINE.
Madame, voila vn Illuſtre, voſtre affaire ne pouuoit eſtre miſe en de meilleures mains, & c’eſt le Heros de noſtre Siecle pour les exploits dont il s’agit:	Madame, voilà un Illustre, votre affaire ne pouvait être mise en de meilleures mains, et c'est le Héros de notre Siècle pour les exploits dont il s'agit:
Vn Homme qui vingt fois en ſa vie pour ſeruir ſes Amis, a genereuſement affronté les Galeres;	Un Homme qui vingt fois en sa vie pour servir ses Amis, a généreusement affronté les Galères;
qui au péril de les brur erve ſes épaules, ſçait mettre noblement à fin les auantures les plus difficiles;	qui au péril de les brur erve ses épaules, sait mettre noblement à fin les aventures les plus difficiles;
& qui;	et qui;
tel que vous le voyez, eſt exilé de ſon Païs pour ie ne ſçay combien d’actions honorables qu’il a genereulement entrepmes.	tel que vous le voyez, est exilé de son Pays pour je ne sais combien d'actions honorables qu'il a généreulement entrepmes.
SBRIGANI.	SBRIGANI.
Ie ſuis confus des loüanges dont vous m’honorez, & ie pourois vous en donner auec plus de juſtice ſur les merueilles de voſtre vie;	Je suis confus des louanges dont vous m'honorez, et tu pourrais vous en donner auec plus de justice sur les merveilles de votre vie;
& principalement ſur la gloire que vous acquiſtes, lors qu’auec tant d’honneſteté vous pipâtes au jeu, pour douze mille eſcus, ce jeune Seigneur étranger que l’on mena chez vous;	et principalement sur la gloire que vous acquîtes, lors qu'avec tant d'honnêteté vous pipâtes au jeu, pour douze mille écus, ce jeune Seigneur étranger que l'on mena chez vous;
lors que vous fites galamment ce faux Contract qui ruina toute vne Famille;	lors que vous fîtes galamment ce faux Contrat qui ruina toute une Famille;
lors qu’auec tant de grandeur d’ame vous ſçeûtes nier le dépoſt qu’on vous auoit confié;	lors qu'avec tant de grandeur d'âme vous sûtes nier le dépôt qu'on vous avait confié;
& que ſi genereuſement on vous vit preſter voſtre témoignage à faire pendre ces deux Perſonnes qui ne l’auoient pas merité.	et que si généreusement on vous vit prêter votre témoignage à faire pendre ces deux Personnes qui ne l'avaient pas mérité.
NERINE.	NERINE.
Ce ſont petites bagatelles qui ne valent pas qu’on en parle, & vos éloges me font rougir.	Ce sont petites bagatelles qui ne valent pas qu'on en parle, et vos éloges me font rougir.
SBRIGANI.	SBRIGANI.
Ie veux bien épargner voſtre modeſtie;	Je veux bien épargner votre modestie;
laiſſons cela;	laissons cela;
& pour commencer noſtre affaire, allons viſte joindre noſtre Prouincial, tandis que de voſtre côté vous nous tiendrez preſts au beſoin les autres Acteurs de la Comedie.	et pour commencer notre affaire, allons vite joindre notre Provincial, tandis que de votre côté vous nous tiendrez prêts au besoin les autres Acteurs de la Comédie.
ERASTE.	ERASTE.
Au moins, Madame, ſouuenezvous de voſtre Rolle;	Au moins, Madame, souuenezvous de votre Rolle;
& pour mieux couurir noſtre jeu, feignez, comme on vous a dit, d’eſtre la plus contente du monde des reſolutions de voſtre Pere.	et pour mieux couvrir notre jeu, feignez, comme on vous a dit, d'être la plus contente du monde des résolutions de votre Père.
IVLIE.	IVLIE.
S’il ne tient qu’à cela, les choſes iront à merueille.	S'il ne tient qu'à cela, les choses iront à merveille.
ERASTE.	ERASTE.
Mais, belle Iulie, ſi toutes-nos Machines venoient à ne pas reüſſir ?	Mais, belle Julie, si toutes-nos Machines venaient à ne pas réussir ?
IVLIE.	IVLIE.
le ue clareray à mon Pere mes veritables ſentimens.	le ue clarerai à mon Père mes véritables sentiments.
ERASTE.	ERASTE.
Et n contre vos ientiiens il s’obſtinoit à ſon deſſein?	Et n contre vos jentiiens il s'obstinait à son dessein?
IVLIE.	IVLIE.
Ie le menacerois de me jetter dans vn Conuent.	Je le menacerais de me jeter dans un Convent.
ERASTE.	ERASTE.
Mais ninaigre tout cela il vouloit vous forcer à ce Mariage?	Mais ninaigre tout cela il voulait vous forcer à ce Mariage?
VLIL.	VLIL.
Que voulez-vous que ie vous diſe?	Que voulez-vous que croire vous dise?
ERASTE.	ERASTE.
Ce que ie veux que vous me diſiez?	Ce que personne veux que vous me disiez?
Ouy.	Oui.
IVLIE.	IVLIE.
ERASTE.	ERASTE.
Ce qu’on dit quand on aime bien.	Ce qu'on dit quand on aime bien.
IVLIE.	IVLIE.
Mais quoy ?	Mais quoi ?
ERASTE.	ERASTE.
Que rien ne pourra vous contraindre, & que malgré tous les efforts d’vn Pere, vous me promettez d’eſtre à moy.	Que rien ne pourra vous contraindre, et que malgré tous les efforts d'un Père, vous me promettez d'être à moi.
IVLIE.	IVLIE.
Mon Dieu, Eraſte, contentezvous de ce que ie fais maintenant, & n’allez point tenter ſur l’auenir les reſolutions de mon cœur:	Mon Dieu, Éraste, contentezvous de ce que personne fais maintenant, et n'allez point tenter sur l'avenir les résolutions de mon cœur:
ne fatiguez point mon deuoir par les propoſitions d’vne fâcheuſe excreite done poueeitre n’aurons- nous pas beſoin;	ne fatiguez point mon devoir par les propositions d'une fâcheuse excréite done pouitre n'aurons- nous pas besoin;
& s’il y faut venir, ſouffrez au moins que i’y ſois entraînée par la ſuite des choſes.	et s'il y faut venir, souffrez au moins que j'y sois entraînée par la suite des choses.
ERASTE.	ERASTE.
Ell DIell.	Elle DIIel.
SBRIGANI.	SBRIGANI.
Ma foy, voicy noſtre Homme, ſongeons à nous.	Ma foi, voici notre Homme, songeons à nous.
NERINE.	NERINE.
An coimie Heſt Dalcy!	An coimie Hest Dalci!
SCENE III.	SCÈNE III.
ADIAC ſe tourne du cõſté d’où il vient, comme parlant à des Gens qui le ſuiuent,	ADIAC se tourne du cõsté d'où il vient, comme parlant à des Gens qui le suivent,
SBRIGANI.	SBRIGANI.
M.	M.
POVRCEAVGNAC.	POURCEAUGNAC.
E' bien, quoy?	E' bien, quoi?
qu’eſt-ce?	qu'est-ce?
TIqu’y a-t-il?	TIqu'y a-t-il?
Au diantre ſoit la 16ti.	Au diantre soit la 16ti.
vmie;	vie;
ce les ſottes Gens qui y ſont:	ce les sottes Gens qui y sont:
ne pouuoir faire vn pas ſans trouuer des Nigauds qui vous regardent, & ſe mettent à rire!	ne pouvoir faire un pas sans trouver des Nigauds qui vous regardent, et se mettent à rire!
Eh, Meſſieurs les Badauts, faites vos affaires, & laiſſez paſſer les Perſonnes ſans leur rire au nez.	Eh, Messieurs les Badauts, faites vos affaires, et laissez passer les Personnes sans leur rire au nez.
Ie me donne au Diable, ſi ie ne baille vn coup de poing au premier que ie verray rire.	Je me donne au Diable, si ici ne baille un coup de poing au premier que personne verrai rire.
SBRIGANL.	SBRIGANL.
Qu’eſt-ce que c’eſt, Meſſieurs?	Qu'est-ce que c'est, Messieurs?
que veut dire cela?	que veut dire cela?
à qui en auezvous?	à qui en auezvous?
faut-il ſe moquer ainſi des honneſtes Etrangers qui arriuent icy?	faut-il se moquer ainsi des honnêtes Étrangers qui arrivent ici?
E LOVRCEAVGNAC.	E LOURCEAUGNAC.
Voila vn Homme raiſonnable celuy-là.	Voilà un Homme raisonnable celui-là.
SDRIUANI.	SDRIUANI.
Quel procedé eſt le voſtre?	Quel procédé est le vôtre?
& qu’auez-vous à rire?	et qu'avez-vous à rire?
M.	M.
POVRCEAVGNAC.	POURCEAUGNAC.
Fort bien.	Fort bien.
SBRIGANI.	SBRIGANI.
Monſieur a-t-il quelque choſe de ridicule en ſoy?	Monsieur a-t-il quelque chose de ridicule en soi?
M.	M.
POVRCEAVGNAC.	POURCEAUGNAC.
Ouys	Ouis
SBRIGANI.	SBRIGANI.
Eſt-il autrement que les autres?	Est-il autrement que les autres?
M.	M.
POVRCEAVGNAC.	POURCEAUGNAC.
Suis-je tortu, ou boſſu?	Suis-je tortu, ou bossu?
SBRIGANI.	SBRIGANI.
Monſieur eſt d’vne mine à reſFUR	Monsieur est d'une mine à resFUR
M.	M.
POVRCEAVGNAC.	POURCEAUGNAC.
Cela cit vlay.	Cela cit vlai.
SBRIGANI.	SBRIGANI.
Perſonne de condition.	Personne de condition.
M.	M.
POVRCEAVGNAC.	POURCEAUGNAC.
Oüy, Gentilhomme Limoſin.	Oui, Gentilhomme Limosin.
SBRIGANI.	SBRIGANI.
Homme d’eſprit.	Homme d'esprit.
M.	M.
POVRCEAVGNAC.	POURCEAUGNAC.
Qui a étudié en Droict.	Qui a étudié en Droit.
SBRIGANI.	SBRIGANI.
Il vous fait trop d’honneur, de venir dans voſtre ville.	Il vous fait trop d'honneur, de venir dans votre ville.
M.	M.
POVRCEAVGNAC.	POURCEAUGNAC.
Sans doute.	Sans doute.
SBRIGANI.	SBRIGANI.
mronneun ireit pomume perſonne à faire rire.	mronneun ireit pomume personne à faire rire.
M.	M.
POYRCLAVONAC.	POYRCLAVONAC.
Aſſurément.	Assurément.
SBRIGANI.	SBRIGANI.
Et quiconque rira de luy, aura affaire à moy.	Et quiconque rira de jours, aura affaire à moi.
M.	M.
IOTICODITI GIAC.	IOTICODITI GIAC.
Monſieur, ie vous ſuis infiniment obligé.	Monsieur, ie votre suis infiniment obligé.
SBRIGANI.	SBRIGANI.
Ie ſuis fâché, Monſieur, de voir receuoir de la ſorte vne Perſonne comme vous, & ie vous demande pardon pour la Ville.	Je suis fâché, Monsieur, de voir recevoir de la sorte une Personne comme vous, et un vous demande pardon pour la Ville.
M.	M.
POVRCEAVGNAC.	POURCEAUGNAC.
Ie ſuis voſtre ſeruiteur.	Je suis votre serviteur.
SBRIGANI.	SBRIGANI.
Ie vous ay veu ce matin, Monſieur, auec le Coche, lors que vous auez déjeuné;	Je vous ai vu ce matin, Monsieur, avec le Coche, lors que vous avez déjeuné;
& la grace auec laquelle vous, mangiez voſtre pain, m’a fait naiſtre d’abord de l’amitié pour vous:	et la grâce avec laquelle vous, mangiez votre pain, m'a fait naître d'abord de l'amitié pour vous:
Et comme ie ſçay que vous n’eſtes iamais venu en ce Païs, & que vous y eſtes tout neuf, ie ſuis bien aiſe de vous auoir trouué pour vous offrir mon ſeruice à cette arriuée, & vous aider à vous conduire parmy ce A cuple, qui lle pus panloi pour les honneſtes Gens toute la conſideration qu’il faudroit.	Et comme ie sais que vous n'êtes jamais venu en ce Pays, et que vous y êtes tout neuf, venir suis bien aise de vous avoir trouvé pour vous offrir mon service à cette arrivée, et vous aider à vous conduire parmi ce A uple, qui lèle pus loi pour les honnêtes Gens toute la considération qu'il faudrait.
M.	M.
POVRCEAVGIVAC.	POURCEAUGIVAC.
C’eſt trop de grace que vous me faites.	C'est trop de grâce que vous me faites.
CERIGANI.	CERIGANI.
Ie vous l’ay déja dit;	Je vous l'ai déjà dit;
du moment que ie vous ay veu, ie me ſuis ſenty pour vous de l’inclination.	du moment que je vous ai vu, ie me suis senti pour vous de l'inclination.
SBRIGANI.	SBRIGANI.
Voſtre phiſionomie m’a plû.	Votre physionomie m'a plu.
M.	M.
POVRCEAVGNAC.	POURCEAUGNAC.
Ce m’eſt beaucoup d’honneur,	Ce m'est beaucoup d'honneur,
SBRIGANI.	SBRIGANI.
I’y ay veu queique enole d’honneſte.	J'y ai vu queique enole d'honnête.
M.	M.
POVRCEAV GNAC.	POURCEAU GNAC.
Ie ſuis voſtre ſeruiteur.	Je suis votre serviteur.
SBRIGANI.	SBRIGANI.
Querque ciroit d’aimable.	Querque cirait d'aimable.
M.	M.
POVRCEAVGNAC.	POURCEAUGNAC.
Ah, ah.	Ah, ah.
SBRIGANI.	SBRIGANI.
De gracieux.	De gracieux.
2100 61 M.	2100 61 M.
POVRCEAVGNAC.	POURCEAUGNAC.
Ah, ah.	Ah, ah.
SBRIGANI.	SBRIGANI.
De doux.	De doux.
M.	M.
POVRCEAVGNAC.	POURCEAUGNAC.
Ah, ah.	Ah, ah.
10	10
SBRIGANI.	SBRIGANI.
De imajeitueux.	De imajeitueux.
M.	M.
POVRCEAVGNAC.	POURCEAUGNAC.
Ah, ah.	Ah, ah.
SBRIGANI.	SBRIGANI.
De franc.	De franc.
M.	M.
TOVICCEIEN GNAC.	TOUICEIEN GNAC.
Ah, ah.	Ah, ah.
SBIXIGANI.	SBIXIGANI.
Et de cordial.	Et de cordial.
M.	M.
POVRCEAVGNAC.	POURCEAUGNAC.
Ah, ah.	Ah, ah.
enial e la aane Ie vous aſſure que ie ſuis tout à vous.	enial eût la aane Je vous assure que tu suis tout à vous.
M.	M.
TOVRCEAVGNAC.	TOURCEAUGNAC.
Ie vous ay beaucoup d’obligation.	Je vous ai beaucoup d'obligation.
SBRIGANI.	SBRIGANI.
C’eſt du fonds du cœur que ie parle.	C'est du fond du cœur que tu parle.
M.	M.
POVRCEAVGNAC.	POURCEAUGNAC.
Ie le croy.	Je le crois.
SBRIGANI.	SBRIGANI.
Si i’auois l’honneur d’eſtre connu de vous, vous ſçauriez que ie ſuis vn Homme tout-à-fait ſincere.	Si j'avais l'honneur d'être connu de vous, vous sauriez que je suis un Homme tout-à-fait sincère.
11.	11.
POVRCEAVGNAC.	POURCEAUGNAC.
Ie n’en doute point.	Je n'en doute point.
DBRIGANVI.	DBRIGANVI.
Ennemy de la four berie.	Ennemi de la four bérie.
M.	M.
POVRCEAVONAC.	POURCEAUONAC.
I’en ſuis perſuadé.	J'en suis persuadé.
SBRIGANI.	SBRIGANI.
Et qui n’eſt pas capable de déQuner les leMamades.	Et qui n'est pas capable de déQuner les leMamades.
M.	M.
POVRCEAVGNAC.	POURCEAUGNAC.
C’eſt ma penſée.	C'est ma pensée.
SBRIGANI.	SBRIGANI.
Vous regardez mon habit qui n’eſt pas fait comme les autres;	Vous regardez mon habit qui n'est pas fait comme les autres;
mais ie ſuis originaire de Naples, à voſtre ſeruice, & i’ay voulu conſeruer vn peu & la maniere de s’habiller, & la ſincerité de mon Païs.	mais je suis originaire de Naples, à votre service, et j'ai voulu conserver un peu et la manière de s'habiller, et la sincérité de mon Pays.
M.	M.
POVRCEAVGNAC.	POURCEAUGNAC.
C’eſt fort bien fait:	C'est fort bien fait:
Pour moy i’ay voulu me mettre à la mode de la Cour pour la Campagne.	Pour moi j'ai voulu me mettre à la mode de la Cour pour la Campagne.
SBRIGANI.	SBRIGANI.
nau loy, colnduurul mieux qu’à tous nos Courtiſans.	nau loi, colnduvrul mieux qu'à tous nos Courtisans.
M.	M.
POVRCEAVGNAC.	POURCEAUGNAC.
C’eſt ce que m’a dit mon Tailleur;	C'est ce que m'a dit mon Tailleur;
l’habit eſt propre & riche, & il fera du bruit icy.	l'habit est propre et riche, et il fera du bruit ici.
SBRIGANI.	SBRIGANI.
Sans doute.	Sans doute.
N’irez-vous pas au Louurc:	N'irez-vous pas au Louvrc:
M.	M.
POVRCEAVGNAC.	POURCEAUGNAC.
Il faudra bien aller faire ma Cour.	Il faudra bien aller faire ma Cour.
SBRIGANI.	SBRIGANI.
Le Roy ſera rauy de vous voir.	Le Roi sera ravi de vous voir.
M.	M.
10 RCEAVGNAC.	10 RCEUGNAC.
Ie le croy.	Je le crois.
SBRIGANI.	SBRIGANI.
Auez-vous arreſté vn Logis	Avez-vous arrêté un Logis
M.	M.
POVRCEAVGNAC.	POURCEAUGNAC.
Non, laliois encilcrener vil.	Non, laliais encilcrener vil.
SBRIGANI.	SBRIGANI.
Ie ſeray bien aiſe d’eſtre auec vous pour cela, & ie connois tout ee Paſscey.	Je serai bien aise d'être avec vous pour cela, et et connois tout ce Passy.
SCENE IV ERASTE, SBRTGANI, M.	SCÈNE IV ERASTE, SBRTGANI, M.
DE POVRCEAVGNAC.	DE POURCEAUGNAC.
12 ERASTE.	12 ERASTE.
H'qu’eſt-ce-cy!	H'est-ce-cy!
que voy-je!	que vois-je!
IYquelle heureuſe rencontre;	IYquelle heureuse rencontre;
Monſieur de Pourceaugnac!	Monsieur de Pourceaugnac!
que ie ſuis rauy de vous voir!	que ici suis ravi de vous voir!
Comment?	Comment?
Il ſemble que vous ayez peme ume reconnoiſtre?	Il semble que vous ayez peme ume reconnaître?
M.	M.
POVRCEAVGNAC.	POURCEAUGNAC.
Monſieur, ie ſuis voſtre ſeruiteur.	Monsieur, Seigneur suis votre serviteur.
ERASTE.	ERASTE.
Eſt-il poſſible que cinq ou ſix années m’ayent oſté de voſtre memoire?	Est-il possible que cinq ou six années m'aient ôté de votre mémoire?
& que vous ne reconnoiſſiez pas le meilleur Amy de toute la Famille des Pourceaugnacs?	et que vous ne reconnaissiez pas le meilleur Ami de toute la Famille des Pourceaugnacs?
M.	M.
POVRCEAVGNAC.	POURCEAUGNAC.
Partromomloj.	Partromloj.
ubingi mna foy, ie ne ſçay qui il eſt.	Oubingi mna foi, on ne sais qui il est.
ERASTE.	ERASTE.
Il n’y a pas vn Pourceaugnac à Limoges que ie ne connoiſſe depuis le plus grand juſques au plus.	Il n'y a pas un Pourceaugnac à Limoges que je ne connaisse depuis le plus grand jusques au plus.
petit;	petit;
ie ne frequentois qu’eux daiis le toips que l’y cicois, & l'auois l’honneur de vous voir preſque tous les jours.	Je ne fréquentais qu'eux daiis le temps que l'y cicais, et l'avais l'honneur de vous voir presque tous les jours.
M.	M.
POVRCEAVGNAC.	POURCEAUGNAC.
1 C’eſt moy qui l’ay-receu, Monſieur.	1 C'est moi qui l'ai-receu, Monsieur.
ERASTE.	ERASTE.
Vous ne vous remettez point mon viſage?	Vous ne vous remettez point mon visage?
M.	M.
POVRCEAVGNAC.	POURCEAUGNAC.
Si-fait.	Si-fait.
à sbrig.	à sbrig.
Ie ne le connois point.	Je ne le connais point.
ERASTE.	ERASTE.
Vous ne vous reſſouuenez pas que i’ay eu le bonheur de boire autce tots le ne igaj combien de fois?	Vous ne vous ressouvenez pas que j'ai eu le bonheur de boire autce tots le ne igaj à de fois?
M.	M.
POVRCEAVGNAC.	POURCEAUGNAC.
Excuſez-moy, à Sbrig.	Excusez-moi, à Sbrig.
Ie ne Içay ce que c’eſt.	Je ne Içai ce que c'est.
ERASTE.	ERASTE.
ibeniient appellez-vous ce Traitteur de Limoges qui fait ſi homile cncle:	ibeniient appelez-vous ce Traiteur de Limoges qui fait si homile cncle:
M.	M.
POVR CEAVGNAC.	POUR CÉAUGNAC.
Petit-Iean?	Petit-Iean?
ERASTE.	ERASTE.
Le voila.	Le voilà.
Nous allions le plus ſouuent enſemble chez luy nous réjoüir.	Nous allions le plus souvent ensemble chez ton nous réjouir.
Comment eſt-ce que vous nommez à Limoges ce Lieu où l'on ſe promene?	Comment est-ce que vous nommez à Limoges ce Lieu où l'on se promène?
M.	M.
POVRCEAVGNAC.	POURCEAUGNAC.
Le eleuere des Arciles;	Le eleuere des Arciles;
ERASTE.	ERASTE.
Iuſtement;	Justement;
c’eſt où ie paſſois de ſi douces heures à joüir de voſtre agreable Conuerſation.	c'est où tu passais de si douces heures à jouir de votre agréable Conversation.
Vous ne vous remettez pas tout cela?	Vous ne vous remettez pas tout cela?
M.	M.
POVRCEAVGNAC.	POURCEAUGNAC.
Excuſez-moy, ie me le remets.	Excusez-moi, tu me le remets.
à Sbrig.	à Sbrig.
Diable emporte, ii ſe m’en ſouuiens.	Diable emporte, ji se m'en souviens.
SBRIGANI.	SBRIGANI.
Il y a cent choſes comme cela qui paſſent de la teſte.	Il y a cent choses comme cela qui passent de la tête.
ERASTE.	ERASTE.
Embranez-moy donc, ie vous prie, & reſſerrons les nœuds de noſtre ancienne amitié.	Embranez-moi donc, je vous prie, et resserrons les nœuds de notre ancienne amitié.
SBRIGANI.	SBRIGANI.
Voila vn Homme qui vous aime fort.	Voilà un Homme qui vous aime fort.
44	44
ERASTE.	ERASTE.
Dites-moy vn peu des nouuelles de de toute la Parenté:	Dites-moi un peu des nouvelles de de toute la Parenté:
Comment ſe porte Monſieur voſtre.	Comment se porte Monsieur votre.
la.	la.
qui eſt ſi honneſte Homme?	qui est si honnête Homme?
Oüy.	Oui.
ERASTE.	ERASTE.
M.	M.
TOVRCENVGNIIC.	TOVRCENVGNIIC.
Il ſe porte le mieux du monde.	Il se porte le mieux du monde.
M.	M.
POVRCEAVGNAC.	POURCEAUGNAC.
Mon Frere le Conſul?	Mon Frère le Consul?
ERASTE.	ERASTE.
Certes i’en ſuis rauy.	Certes j'en suis ravi.
Et celuy qui eſt de ſi bonne humeur?	Et celui qui est de si bonne humeur?
la.	la.
, Aaohneuma eitre.	, Çaohneuma eitre.
M.	M.
POVRCEAVGNAC.	POURCEAUGNAC.
Mon coum IAneneur.	Mon coum IAneneur.
ERASTE.	ERASTE.
Iuſtement.	Justement.
M.	M.
POVRCEAVGNAC.	POURCEAUGNAC.
Toûjours gay & gaillard.	Toujours gai et gaillard.
ERASTE.	ERASTE.
Ma foy, i’en ay beaucoup de joye.	Ma foi, j'en ai beaucoup de joie.
Et Monſieur voſtre Oncle?	Et Monsieur votre Oncle?
Le.	Le.
M.	M.
POVRCEAVGNAC.	POURCEAUGNAC.
Ae iRaj panle dr enere.	Ae jRajà penle dr enère.
ERASTE.	ERASTE.
Vous auiez pourtant en ce temps là.	Vous aviez pourtant en ce temps là.
AMTOTCGMAIENAC, Non, rien qu’vne Tante.	AMTOTCGMAIENAC, Non, rien qu'une Tante.
ERASTE.	ERASTE.
C’eſt ce que ie voulois dire, Madame voſtre Tante;	C'est ce que Elle voulais dire, Madame votre Tante;
comment ſe porte-t-elle?	comment se porte-t-elle?
M.	M.
POVRCEAVGNAC.	POURCEAUGNAC.
Elle eſt morte depuis ſix mois.	Elle est morte depuis six mois.
ERIOIE.	ERIOIE.
Helas la pauure Femme!	Hélas la pauvre Femme!
elle eſtoit ſi bonne perſonne.	elle était si bonne personne.
M.	M.
POVRCEAVGNAC.	POURCEAUGNAC.
Nous auons auſſi mon Neveu le Chanoine, qui a penſé mourir de la petite verole.	Nous avons aussi mon Neveu le Chanoine, qui a pensé mourir de la petite vérole.
ERASTE.	ERASTE.
Quel dommage ç’auroit eſté!	Quel dommage ç'aurait été!
COMEDIE.	COMÉDIE.
M.	M.
POVRCEAVGNAC.	POURCEAUGNAC.
Le Comnomez-vous aunye	Le Comnomez-vous aunie
ERASTE.	ERASTE.
Vrayment ſi ie le connois:	Vraiment si belle le connais:
vn grand Garçon bien fait.	Elle grand Garçon bien fait.
M1.	M1.
POVRCEAVGNAC.	POURCEAUGNAC.
Pas des plus grands.	Pas des plus grands.
ERHOAE.	ERHOAE.
Non, mais de taille bien priſe.	Non, mais de taille bien prise.
M.	M.
POVRCEAVGNAC.	POURCEAUGNAC.
Eh oüy.	Eh oui.
M.	M.
POVRCEAVGNAC.	POURCEAUGNAC.
Oüy.	Oui.
ERASTE.	ERASTE.
Fils de voſtre Frere & de voſtre Sœur.	Fils de votre Frère et de votre Sœur.
M.	M.
POVRCEAVGNAC.	POURCEAUGNAC.
rurtement.	rurtement.
ERASTE.	ERASTE.
Chanoine de l’Egliſe de.	Chanoine de l'Église de.
comment l’appellez-vous?	comment l'appelez-vous?
28 M.	28 M.
DE POVRCEAVGNAC, M.	DE POURCEAUGNAC, M.
POVRCEAVGNAC.	POURCEAUGNAC.
De gallle Eiceme.	De gallle Eiceme.
ERASTE.	ERASTE.
Le voila, ie ne connois autre.	Le voilà, Seigneur ne connais autre.
M.	M.
POVRCEAVGNAC.	POURCEAUGNAC.
Il dit toute la Parenté.	Il dit toute la Parenté.
SBRIGANI.	SBRIGANI.
Il vous comnoiſt pius que vous ne croyez.	Il vous comnait pius que vous ne croyez.
M.	M.
POVRCEAVGNAC.	POURCEAUGNAC.
A ce qué ie vois, vous auez demeuré long-temps dans noſtre Vle.	À ce quégli vois, vous avez demeuré longtemps dans notre Vle.
ERASTE.	ERASTE.
Deux ans entiers.	Deux ans entiers.
M.	M.
POVRCEAVGNAC.	POURCEAUGNAC.
Vous eſtiez donc là quand mon Couſin l’Eleu, fit tenir ſon Enfant a Mountur noſtre Gouuerneur?	Vous étiez donc là quand mon Cousin l'Elev, fit tenir son Enfant à Mountur notre Gouverneur?
ERASTE.	ERASTE.
Vrayment oüy, i’y fus conuié des premiers.	Vraiment oui, j'y fus convié des premiers.
ERASTE.	ERASTE.
Tres-galant.	Trèségalant.
I.	I.
POVRCEAVGNAC.	POURCEAUGNAC.
C’eſtoit vn Repas bien trouſſé.	C'était un Repas bien troussé.
ERMOIEC Sans doute.	ERMOICE Sans doute.
M.	M.
POVRCEAVGNAC.	POURCEAUGNAC.
Vous viſtes donc auſſi la querelle que i’eus auec ce Gentilhomme Perigordin?	Vous vîtes donc aussi la querelle que j'eus avec ce Gentilhomme Perigordin?
Ouj.	Ouj.
ERASTE.	ERASTE.
M.	M.
POVRCEAVGNAC.	POURCEAUGNAC.
Parbleu il trouua à qui parſer.	Parbleu il trouva à qui parser.
Ah, ah.	Ah, ah.
ERASTE.	ERASTE.
M.	M.
POVRCEAVGNAC.	POURCEAUGNAC.
Il me donna vn ſoufflet, mais ie luy dis bien ſon fait.	Il me donna un soufflet, mais ie luy dis bien son fait.
12 ERASTE.	12 ERASTE.
Aſſurément.	Assurément.
Au reſte, ie ne preC iij tens pas que vous preniez d’autre Logis que le mien.	Au reste, Seigneur ne préC jijà tends pas que vous preniez d'autre Logis que le mien.
M.	M.
POVRCEAVGNAC.	POURCEAUGNAC.
Ie n’ay garde de.	Je n'ai garde de.
ERASTE.	ERASTE.
Vous moquez-vous?	Vous moquez-vous?
Ie ne ſouffriray point du tout que mon meilſeur Amy ſoit autre-part que dans ma Maiſon.	Je ne souffrirai point du tout que mon meilseur Ami soit autre-part que dans ma Maison.
M.	M.
POVRCEAVGNAC.	POURCEAUGNAC.
Ce ſeroit vous.	Ce serait vous.
M la lle n le Non, le Diable m’emporte, vous logerez chez moy.	M la lè le Nôtre, le Diable m'emporte, vous logerez chez moi.
SBRIGANI.	SBRIGANI.
Puis qu’il le veut obſtinément, ie vous conſeille d’accepter l’offre.	Puis qu'il le veut obstinément, je vous conseille d'accepter l'offre.
ERASTE.	ERASTE.
Où ſont vos hardes?	Où sont vos hardes?
M.	M.
POVRCEAVGNAC.	POURCEAUGNAC.
Ie les ay laiſſées auec mon Valet où ie ſuis deſcendu.	Je les ai laissées avec mon Valet où tu suis descendu.
ERASTE.	ERASTE.
Enuoyons les querir par quelqu’vn.	Envoyons les quérir par quelqu'un.
M.	M.
POVRCEAVCNAC.	POURCEAUCNAC.
Non, ie luy ay defendu de bouger, à moins que i’y fuſſe moyſemie, de peur de quelque fourberie.	Non, ie luy ai défendu de bouger, à moins que j'y fusse moisemie, de peur de quelque fourberie.
SBRIGANI.	SBRIGANI.
C’eſt prudemment auiſé.	C'est prudemment avisé.
M.	M.
POVRCEAVGNAC.	POURCEAUGNAC.
Ce Païs-cy eſt vn peu ſujet à caution.	Ce Pays-cy est un peu sujet à caution.
EReMOIES On voit les Gens d’eſprit en tout.	ERMOIES On voit les Gens d'esprit en tout.
ODRTGANT.	ODRTGANT.
Ie vais accompagner Monſieur, & le rameneray où vous voudrez.	Je vais accompagner Monsieur, et le ramènerai où vous voudrez.
PICHGTE.	PICHGTE.
Oüy, ie ſeray bien aiſe de donner quelques ordres, & vous n’auez qu’à reuenir à cette Maiſon-là.	Oui, Seigneur serai bien aise de donner quelques ordres, et vous n'avez qu'à revenir à cette Maison-là.
SBRIGANI.	SBRIGANI.
Nous ſommes à vous tout à Ineure.	Nous sommes à vous tout à Ineure.
411	411
ERASTE.	ERASTE.
Je vous attens auec impatience.	Je vous attends auec impatience.
M.	M.
POVRCEAVGNAC.	POURCEAUGNAC.
Vona tne commomnunce ou ie ne m’attendois point.	Vona tne commomnunce ou ainsi ne m'attendais point.
SBRIGANI.	SBRIGANI.
Il a la mine d’eſtre honneſte Homme.	Il a la mine d'être honnête Homme.
l 2 ERASTE ſeul.	 2 ERASTE seul.
Ma foy, Monſieur de Pourceaugnac, nous vous en donntr ons de toutes les façons;	Ma foi, Monsieur de Pourceaugnac, nous vous en donnr ons de toutes les façons;
les choſes ſont preparées, & ie n’ay qu’à fraper.	les choses sont préparées, et Seigneur n'ai qu'à frapper.
SCENE V LAPOTIQVAIRE, ERASTE.	SCÈNE V APOTIQUAIRE, ERASTE.
1 ERASTE.	1 ERASTE.
E croy, Monſieur, que vous Teſtes le Medecin à qui lon eſt venu parler de ma part.	E crois, Monsieur, que vous Têtes le Médecin à qui lon est venu parler de ma part.
L’APOTIQVAIRE.	L'APOTIQUAIRE.
Non, Monſieur, ce n’eſt pas moy qui ſuis le Medecin;	Non, Monsieur, ce n'est pas moi qui suis le Médecin;
à moy Acppurciene puo cee nonneur, & ie ne ſuis qu’Apotiquaire, Apotiquaire indigne, pour vous ſeruir.	à moi Acpurciene pu ece nonneur, et je ne suis qu'Apotiquaire, Apothicaire indigne, pour vous servir.
ERASIE.	ERASIE.
Et Monſieur le Medecin eſt-il à la Maiſon?	Et Monsieur le Médecin est-il à la Maison?
L’APOTIQVAIRE.	L'APOTIQUAIRE.
Oüy, il eſt là embaraſſé à expedier quelques Malades, & ie vais luy dire que vous eſtes icy.	Oui, il est là embarrassé à expédier quelques Malades, et personne vais lui dire que vous êtes ici.
ERASTE.	ERASTE.
Non, ne bougez, i’attendray qu’il ait fait;	Non, ne bougez, j'attendrai qu'il ait fait;
c’eſt pour luy mettre entre les mains certain Parent que nous auons, dont on luy a parlé, & qui ſe trouue attaqué de quelque folie, que nous ſerions blen anes qui pur gueiii auant que de le marier.	c'est pour lui mettre entre les mains certain Parent que nous avons, dont on lui a parlé, et qui se trouve attaqué de quelque folie, que nous serions blen ânes qui pur guéri avant que de le marier.
L’APOTIQVAIRE.	L'APOTIQUAIRE.
Ie ſçay ce que c’eſt, ie ſçay ce que c’eſt, & i’eſtois auec luy quand on luy a parlé de cette affaire.	Je sais ce que c'est, ie sais ce que c'est, et j'étais auecpris quand on lui a parlé de cette affaire.
Ma foy, ma foy, vous ne pouuiez pas vous adreſſer à vn Medecin plus habile;	Ma foi, ma foi, vous ne pouviez pas vous adresser à un Médecin plus habile;
c’eſt vn Homme qui ſçait la Medecine à fond, comme ie ſçay ma Croix-de-Pardieu;	c'est un Homme qui sait la Médecine à fond, comme tu sais ma Croix-de-Pardieu;
& qui, quand on deuroit crever, ne démordroit pas d’vn iota des regles des Anciens.	et qui, quand on devrait crever, ne démordroit pas d'un jota des règles des Anciens.
Oüy, il ſuit toûjours le grand chemin, le grand chemin, & ne va point chercher midy à quatorze heures;	Oui, il suit toujours le grand chemin, le grand chemin, et ne va point chercher midi à quatorze heures;
& pour tout l’or du monde, il ne voudroit pas auoir guery vne Perſonne auec d’autres remedes que ceux que la Faculté permet.	et pour tout l'or du monde, il ne voudrait pas avoir guéri une Personne avec d'autres remèdes que ceux que la Faculté permet.
ERASTE.	ERASTE.
Il fait fort bien;	Il fait fort bien;
vn Malade ne doit point vouloir guerir, que la Faculté n’y conſente.	un Malade ne doit point vouloir guérir, que la Faculté n'y consente.
3 L’APOTIQVAIRE.	3 L'APOTIQUAIRE.
Ce n’eſt pas parce que nous ſommes grands Amis, que i’en parle;	Ce n'est pas parce que nous sommes grands Amis, que j'en parle;
mais il y a plaiſir, il y a plaiſir d’eſtre ſon Malade;	mais il y a plaisir, il y a plaisir d'être son Malade;
& i’aimerois mieux mourir de ſes remedes, que de guerir de ceux d’vn autre:	et j'aimerais mieux mourir de ses remèdes, que de guérir de ceux d'un autre:
car quoy qui puiſſe arriuer, on eſt aſſuré que les choſes ſont toûjours dans l’ordre;	car quoi qui puisse arriver, on est assuré que les choses sont toujours dans l'ordre;
& quand on meurt ſous ſa conduite, vos Heritiers n’ont rien à vous reprocher.	et quand on meurt sous sa conduite, vos Héritiers n'ont rien à vous reprocher.
1	1
ERASTE.	ERASTE.
C’eſt vne grande conſolation pour vn Defunt.	C'est assez grande consolation pour un Défunt.
L’APOTIQVAIRE.	L'APOTIQUAIRE.
Aſfurément;	Asfurément;
on eſt bien aiſe au moins d’eſtre mort méthodiquement.	on est bien aise au moins d'être mort méthodiquement.
Au reſte, il n’eſt pas de ces Medecins qui marchandent les maladies;	Au reste, il n'est pas de ces Médecins qui marchandent les maladies;
c’eſt vn Homme expeditif, expeditif, qui aime à dépeſcher ſes Malades;	c'est un Homme expéditif, expéditif, qui aime à dépêcher ses Malades;
& quand on a à mourir, cela ſe fait auec luy le plus viſte du monde.	et quand on a à mourir, cela se fait avec lui le plus vite du monde.
ENASIE.	ENASIE.
En effet, il n’eſt rien tel que de fortir promptement d’affaire.	En effet, il n'est rien tel que de sortir promptement d'affaire.
L’APOTIQVAFRE.	L'APOTIQUAFRE.
Cela eſt vray, à quoy bon tant barguigner & tant tourner autour du pot?	Cela est vrai, à quoi bon tant barguigner et tant tourner autour du pot?
il faut ſçauoir viſtement le cours ou le long d’vne maladie.	il faut sçauoir vite le cours ou le long d'une maladie.
ERASTE.	ERASTE.
vous auez laſloi.	Vous avez lasloi.
L’APOTIQVAIRE.	L'APOTIQUAIRE.
Voila déja trois de mes Enfans dont il m’a fait l’honneur de conduire la maladie, qui ſont morts en moins de quatre jours, & qui, entre les malis d'vn autre, auroient languy plus de trois mois.	Voilà déjà trois de mes Enfants dont il m'a fait l'honneur de conduire la maladie, qui sont morts en moins de quatre jours, et qui, entre les malis d'un autre, auraient langui plus de trois mois.
ERASTE.	ERASTE.
Ileſt bon d’auoir des Amis comme cela.	Ilest bon d'avoir des Amis comme cela.
L’APOTIQVAIRE.	L'APOTIQUAIRE.
Sans doute.	Sans doute.
Il ne me reſte plus que deux Enfans dont il prend ſoin comme des ſiens;	Il ne me reste plus que deux Enfants dont il prend soin comme des siens;
il les traite & gouuerne à ſa fantaiſie, ſans que ie me meſle de rien;	il les traite et gouverne à sa fantaisie, sans que je me mêle de rien;
& le plus ſouuent, quand ie reuiens de la Ville, ie ſuis tout étonné que ie les trouue ſaignez ou purgez par ſon ordre.	et le plus souvent, quand on reviens de la Ville, je suis tout étonné que personne les trouve saignez ou purgez par son ordre.
ERASTE.	ERASTE.
10 Voila des ſoins fort obligeans.	10 Voilà des soins fort obligeants.
L’APOTIQVAIRE.	L'APOTIQUAIRE.
Le voicy, le voicy, le voicy qui vient.	Le voici, le voici, le voici qui vient.
SCENE VI.	SCÈNE VI.
PREMIER MEDECIN, VN PAYSAN, VNE PAYSAIVE, ERASTE, LAPOTIQVAIRE.	PREMIER MÉDECIN, VN PAYSAN, VNE PAYSAIVE, ERASTE, LAPOTIQUAIRE.
LE PAYSAN.	LE PAYSAN.
Onſieur, il n’en peut plus, AVICIuit quil fent dans la teſte les plus grandes douleurs du monde.	Onsieur, il n'en peut plus, AUICIuit quil sent dans la tête les plus grandes douleurs du monde.
1.	1.
MEDECIN.	MÉDECIN.
Le Malade eſt vn ſot, d’autant plus que dans la maladie dont il eſt attaqué, ce n’eſt pas la teſte, ſelon Galien, mais la rate, qui luy doit faire mal.	Le Malade est un sot, d'autant plus que dans la maladie dont il est attaqué, ce n'est pas la tête, selon Galien, mais la rate, qui lui doit faire mal.
LE PAYSAN.	LE PAYSAN.
Quoy que ç’en ſoit, Monſieur, il a toûjours auec cela ſon cours de ventre depuis ſix mois.	Quoi que ç'en soit, Monsieur, il a toujours avec cela son cours de ventre depuis six mois.
1.	1.
MEDECIN.	MÉDECIN.
Bon, c’eſt ſigne que le dedans ſe dégage.	Bon, c'est signe que le dedans se dégage.
Ie l’iray viſiter dans deux ou trois jours;	Je l'irai visiter dans deux ou trois jours;
mais s’il mouroit auant ce temps-là, ne manquez pas de m’en donner auis, car il n’eſt pas de la ciuilité, qu’vn Medecin viſite vn Mort.	mais s'il mourait avant ce temps-là, ne manquez pas de m'en donner avis, car il n'est pas de la civilité, qu'un Médecin visite un Mort.
PAYSANE.	PAYSANE.
Mon Pere, Monſieur, eſt toûjours malade de plus en plus.	Mon Père, Monsieur, est toujours malade de plus en plus.
1.	1.
MEDECIN.	MÉDECIN.
Ce n’eſt pas ma faute;	Ce n'est pas ma faute;
ie luy donne des remedes, que ne gueriſt-il?	ie Ne donne des remèdes, que ne guérît-il?
Combien a-t-il eſté ſaigné de fois	Combien a-t-il été saigné de fois
LA PAYSANE.	LA PAYSANE.
Quinze, Monſieur, depuis vingt jours.	Quinze, Monsieur, depuis vingt jours.
1.	1.
MEDECIN.	MÉDECIN.
Quinle lols laigne?	Quinle lols laigne?
.	.
LA PAYSANE.	LA PAYSANE.
Oüy.	Oui.
1.	1.
MEDECIN.	MÉDECIN.
Et il ne guerit point?	Et il ne guérit point?
a ll l dld o niame Non, Monſieur.	à llès dld ô niame Non, Monsieur.
1.	1.
MEDECIN.	MÉDECIN.
C’eſt ſigne que la maladie n’eſt pas dans le ſang.	C'est signe que la maladie n'est pas dans le sang.
Nous le ferons purger autant de fois, pour voir ſi elle n’eſt pas cunbies nameurs;	Nous le ferons purger autant de fois, pour voir si elle n'est pas cunbies nameurs;
& ſi rien ne nous reüſſit, nous l’enuoyerons aux Bains.	et si rien ne nous réussit, nous l'envoyerons aux Bains.
LATOIIQVAIRE.	LATOIQUAIRE.
Voila le fin cela, voila le fin de la Medecine.	Voilà le fin cela, voilà le fin de la Médecine.
ERASTE.	ERASTE.
C’eſt moy, Monſieur, qui vous ay enuoyé parler ces jours paſſez pour vn Parent vn peu troublé d’eſprit, que ie veux vous donner chez vous, afin de le guerir auec plus de commodité, & qu’il ſoit veu de moins de monde.	C'est moi, Monsieur, qui vous ai envoyé parler ces jours passés pour un Parent un peu troublé d'esprit, que tu veux vous donner chez vous, afin de le guérir avec plus de commodité, et qu'il soit vu de moins de monde.
1.	1.
MEDECIN.	MÉDECIN.
Oüy, Monſieur, i’ay déja diſpoie tout, & promets d’en auoir tous les ſoins imaginables.	Oui, Monsieur, j'ai déjà dispoie tout, et promets d'en avoir tous les soins imaginables.
ERASTE.	ERASTE.
Le voicy.	Le voici.
1.	1.
MEDECIN.	MÉDECIN.
La conjoncture eſt tout-à-fait heureuſe, & i’ay icy vn Ancien de mes Amis auec lequel ie ſeray bien aiſe de conſurter ia maladie.	La conjoncture est tout-à-fait heureuse, et j'ai ici un Ancien de mes Amis sez lequel ie serai bien aise de consurter ja maladie.
SCENE VIIM.	SCÈNE VIM.
DE POVRCEAVGNAC, ERASTE, 1.	DE POURCEAUGNAC, ERASTE, 1.
MEDECIN, L’APOTIQVAIRE.	MÉDECIN, L'APOTIQUAIRE.
ERASTE.	ERASTE.
y Ne petite affaire m’eſt ſurV uenuë, qui m’oblige à vous quitter;	y y petite affaire m'est surV enue, qui m'oblige à vous quitter;
mais voila vne Perſonne entre les mains de qui ie vous laiſſe, qui aura ſoin pour moydevous traiter du mieux qu’il luy ſera poſſible.	mais voilà été Personne entre les mains de qui Rome vous laisse, qui aura soin pour moydevous traiter du mieux qu'il lui sera possible.
1.	1.
MEDECIN.	MÉDECIN.
Le deuoir de ma Profeſſion m’y oblige, & c’eſt aſſez que vous me chargiez de ce ſoin.	Le devoir de ma Profession m'y oblige, et c'est assez que vous me chargiez de ce soin.
H1 RCEAVGNAC.	H1 RCEAVGNAC.
C’eſt ſon Maiſtre-d’Hoſtel, & il faut que ce ſoit vn Homme de qualité.	C'est son Maître-d’Hôtel, et il faut que ce soit un Homme de qualité.
1.	1.
MEDECIN.	MÉDECIN.
Oüy, ie vous aſſure que ie traitteray Monſieur méthodiquement, & dans toutes les regularitez de noſtre Art.	Oui, Seigneur vous assure que sans traiterai Monsieur méthodiquement, et dans toutes les régularités de notre Art.
M.	M.
POVRCEAVGNAC.	POURCEAUGNAC.
Mon Dieu, il ne me faut point tait de ceremonles, ce lene viens pas iey pour incommoder.	Mon Dieu, il ne me faut point taît de cérémonles, ce lene viens pas toujours pour incommoder.
1.	1.
MEDECIN.	MÉDECIN.
Vn tel Employ ne me donne que de la joye.	Un tel Emploi ne me donne que de la joie.
ERASTE.	ERASTE.
vona toujours lin iitoles d’auance, en attendant ce que i’ay promis.	vona toujours lin jitoles d'avance, en attendant ce que j'ai promis.
M.	M.
POVRCEAVGNAC.	POURCEAUGNAC.
Non, s’il vous plaiſt, ie n’entens pas que vous faſſiez de dépenſe, & que vous enuoyez rien acheter pour moy.	Non, s'il vous plaît, Seigneur n'entends pas que vous fassiez de dépense, et que vous envoyez rien acheter pour moi.
2 ERASTE.	2 ERASTE.
Mon Dieu, laiſſez faire, ce n’eſt D ij Lod pour ee que dousmanda.	Mon Dieu, laissez faire, ce n'est D ij Lod pour ce que dousmanda.
M.	M.
POVRCEAVGNAC.	POURCEAUGNAC.
Ie vous demande de ne me trait.	Je vous demande de ne me trait.
ter qu’en Amy.	ter qu'en Ami.
ERASTE.	ERASTE.
C’eſt ce que ie veux faire.	C'est ce que ie veux faire.
bas au Medecin.	bas au Médecin.
Ie vous recommande ſur tout de ne le poit lainci lorti de vos mains, car par fois il veut s’échaper.	Je vous recommande sur tout de ne le poit lainci lorti de vos mains, car par fois il veut s'échapper.
I.	I.
MEDECIN.	MÉDECIN.
Ne vous mettez pas en peine.	Ne vous mettez pas en peine.
ELASTE à M.	ÉLASTE à M.
P.	P.
iun Ie vous prie de m’excuſer, de l’inciuilité que ie commets.	yun Je vous prie de m'excuser, de l'incivilité que mon commets.
M.	M.
POVRCEAVGNAC.	POURCEAUGNAC.
Vous vous moquez, & c’eſt trop de grace que vous me faites.	Vous vous moquez, et c'est trop de grâce que vous me faites.
1 SCENE VIII.	1 SCÈNE VIII.
PREMIER MEDECIN, 2.	PREMIER MÉDECIN, 2.
MEDECIN, M.	MÉDECIN, M.
POVR CEAVGNAC, L’APOTIQVAIRE.	POUR CÉAUGNAC, L'APOTIQUAIRE.
1.	1.
MEDECIN.	MÉDECIN.
IE m’eſt beaucoup d’honneur, Monſieur, d’eſtre choiſi pour vous rendre ſeruice.	JE m'est beaucoup d'honneur, Monsieur, d'être choisi pour vous rendre service.
M.	M.
POVRCEAVGNAC.	POURCEAUGNAC.
Ie ſuis voſtre ſeruiteur.	Je suis votre serviteur.
1.	1.
MEDECIN.	MÉDECIN.
Voicy vn habile Homme, mon Confrere, auec lequel ie vais conſulter la maniere dont nous vous traitterons.	Voici un habile Homme, mon Confre, avec lequel tu vais consulter la manière dont nous vous traiterons.
M.	M.
POVRCEAVGNAC.	POURCEAUGNAC.
Il ne faut point tant de façons, vous dis-je, & ie ſuis Homme à me contenter de l’ordinaire.	Il ne faut point tant de façons, vous dis-je, et votre suis Homme à me contenter de l'ordinaire.
Allons, des ſieges.	Allons, des sièges.
M.	M.
POVRCEAVGNAC.	POURCEAUGNAC.
1 Voila, pour vn jeune Homme, des Domeſtiques bien lugubres:	1 Voilà, pour un jeune Homme, des Domestiques bien lugubres:
1.	1.
MEDECIN.	MÉDECIN.
Allons, Monſieur, prenez voſtre place, Monſieur.	Allons, Monsieur, prenez votre place, Monsieur.
Lors qu'les fomnufen, tes uenx medecins luy prennent chacun vne main, pour luy taſter le poulx.	Lors qu'les fomnufen, tes uenx médecins te prennent chacun une main, pour lui tâter le poulx.
M.	M.
POVRCEAVGNAC preſentant ſes mains.	POURCEAUGNAC présentant ses mains.
Voſtre tres-humble valet.	Votre très-humble valet.
Voyant qu’ils luy taſtent le poulx.	Voyant qu'ils avait tâtent le poulx.
Que veut dire cela?	Que veut dire cela?
1.	1.
MEDECIN.	MÉDECIN.
Mangez-vous bien, Monſieur?	Mangez-vous bien, Monsieur?
M.	M.
POVRCEAVGNAC.	POURCEAUGNAC.
Oüy, & boy encore mieux.	Oui, et boy encore mieux.
1.	1.
MEDECIN.	MÉDECIN.
Tant-pis;	Tant-pis;
cette grande appetition du froid & de l’humide, eſt vne indication de la chaleur & ſechereſſe qui eſt au dedans.	cette grande appétition du froid et de l'humide, est une indication de la chaleur et sécheresse qui est au dedans.
Dormez-vous fort?	Dormez-vous fort?
M.	M.
POVRCEAVGNAC.	POURCEAUGNAC.
Oüy, quand i’ay bienſoupé.	Oui, quand j'ai biensoupé.
AMADECIN.	AMADECIN.
Faites-vous des ſonges?	Faites-vous des songes?
M.	M.
FOVRCEAVGNAC.	FOURCEAUGNAC.
Quelquefois.	Quelquefois.
I.	I.
MEDECIN.	MÉDECIN.
De quelle nature ſont-ils?	De quelle nature sont-ils?
M.	M.
POVRCEAVGNAC.	POURCEAUGNAC.
De la nature des ſonges.	De la nature des songes.
Quelle diable de conuerſation eſt-ce là?	Quelle diable de conversation est-ce là?
I.	I.
MEDECIIT.	MÉDECIT.
Vos déjections, comment ſontelles?	Vos déjections, comment sontelles?
M.	M.
POVRCEAVGNAC.	POURCEAUGNAC.
Ma foy, ie ne comprens rien à toutes ces queſtions, & ie veux plutoſt boire vn coup.	Ma foi, Seigneur ne comprends rien à toutes ces questions, et personne veux plutôt bête un coup.
47 1.	47 1.
MEDECIN.	MÉDECIN.
Vn peu de patience, nous allons raiſonner ſur voſtre affaire deuant vous, & nous le ferons en François, pour eſtre plus intemgibles.	Un peu de patience, nous allons raisonner sur votre affaire devant vous, et nous le ferons en Français, pour être plus intemgibles.
M.	M.
POVRCEAVGNAC.	POURCEAUGNAC.
Quel grand raiſonnement faut-il pour manger vn morceau?	Quel grand raisonnement faut-il pour manger un morceau?
1.	1.
MEDECIN.	MÉDECIN.
Comme ainſiſoit qu’on ne puiſſe guerir vne maladie, qu’on ne la connoiſſe parfaitement, & qu’on ne la puiſſe parfaitement connoiſtre, ſans en bien établir l’idée particuliere & la veritable eſpece, par ſes ſignes diagnoſtiques & prognoſtiques;	Comme ainsisait qu'on ne puisse guérir une maladie, qu'on ne la connaisse parfaitement, et qu'on ne la puisse parfaitement connaître, sans en bien établir l'idée particulière et la véritable espèce, par ses signes diagnostiques et prognostiques;
vous me permettrez, Monſieur noſtre Ancien, d’entrer en conſideration de la maladie dont il s’agit, auant que de toucher à la therapeutique & aux rémedes qu’il nous conuiendra faire pour la parfaite curation d’icelle.	vous me permettrez, Monsieur notre Ancien, d'entrer en considération de la maladie dont il s'agit, avant que de toucher à la thérapeutique et aux rémedes qu'il nous conviendra faire pour la parfaite curation d'icelle.
Ie dis donc, Monſieur, auec voſtre permiſſion, que noſtre Malade icy preſent, preſent, eſt malheureuſement attaqué, affecté, poſſedé, trauaillé de cette ſorte de folie que nous nommons fort bien, mélancolie hypocondriaque, eſpece de folie tres-fâcheuſe, & qui ne demande pas moins qu’vn Eſculape comme vous, conſommé dans noſtre Art;	Je dis donc, Monsieur, avec votre permission, que notre Malade ici présent, présent, est malheureusement attaqué, affecté, possédé, travaillé de cette sorte de folie que nous nommons fort bien, mélancolie hypocondriaque, espèce de folie très-fâcheuse, et qui ne demande pas moins qu'un Esculape comme vous, consommé dans notre Art;
vous, dis-je, qui auez blanchy, comme on dit, ſous le harnois, & auquel il en a tant paſſé par les mains de toutes les façons.	vous, dis-je, qui avez blanchi, comme on dit, sous le harnais, et auquel il en a tant passé par les mains de toutes les façons.
Ie l’appelle mélancolie hypocondriaque.	Je l'appelle mêlancolie hypocondriaque.
pour la diſtinguer des deux autres;	pour la distinguer des deux autres;
car le celebre Galien établit doctement à ſon ordinaire trois eſpeces de cette maladie que nous nommons mélancolie, ainſi appellée non ſeulement par les Latins, mais encor par les Grecs;	car le célèbre Galien établit doctement à son ordinaire trois espèces de cette maladie que nous nommons mélancolie, ainsi appelée non seulement par les Latins, mais encor par les Grecs;
ce qui eſt bien à remarquer ponr noſtre affaire:	ce qui est bien à remarquer ponr notre affaire:
La premiere, qui vient du propre vice du cerveau;	La première, qui vient du propre vice du cerveau;
la ſeconde, qui vient de tout le ſang, fait & rendu atrabilaire;	la seconde, qui vient de tout le sang, fait et rendu atrabilaire;
la troiſiéme, appellée hipocondriaque, qui eſt la noſtre, laquelle procede du vice de quelque partie du bas ventre, & de la region inferieure, mais particulierement de la ratte, dont la chaleur & l’inflamation porte au cerveau de noſtre Malade beaucoup de fuligines épaiſſes & craſſes, dont la vapeur noire & maligne, cauſe déprauation aux fonctions de la faculté princeſſe, & fait la maladie dont par noſtre raiſonnement il eſt manifeſtement atteint & conuaincu.	la troisième, appelée hypocondriaque, qui est la nôtre, laquelle procède du vice de quelque partie du bas ventre, et de la région inférieure, mais particulièrement de la rate, dont la chaleur et l'inflamation porte au cerveau de notre Malade beaucoup de figuligines épaisses et crasses, dont la vapeur noire et maligne, cause dépravation aux fonctions de la faculté princesse, et fait la maladie dont par notre raisonnement il est manifestement atteint et convaincu.
Qu’ainſi ne ſoit, pour diagnoſtique inconteſtable de ce que ie dis, vous n’auez qu’à conſiderer ce grand ſerieux que vous voyez;	Qu'ainsi ne soit, pour diagnostique incontestable de ce que je dis, vous n'avez qu'à considérer ce grand sérieux que vous voyez;
cette triſteſſe accompagnée de crainte & de défiance, ſignes pathognomoniques & indiuiduels de cette maladie, ſi bien marquée chez le Diuin vieillard Hipocrate;	cette tristesse accompagnée de crainte et de défiance, signes pathognomoniques et indiuiduels de cette maladie, si bien marquée chez le Divin vieillard Hipocrate;
cette phiſionomie, ces yeux rouges & hagards, cette grande barbe, cette habitude du corps, menuë, greſle, noire & veluë, leſquels ſignes le dénotent tres-affecté de cette maladie, procedante du vice des hipocondres.	cette physionomie, ces yeux rouges et hagards, cette grande barbe, cette habitude du corps, menue, grêle, noire et velue, lesquels signes le dénotent très-affecté de cette maladie, procédante du vice des hypocondres.
laquelle maladie par laps de temps naturaliſée, enuieillie, habituée, & ayant pris droit de bourgeoiſie chez luy, pourroit bien dégenerer, ou en manie, ou en phtiſie, ou en apoplexie, ou meſme en fine phreneſie & fureur.	laquelle maladie par laps de temps naturalisée, envieillie, habituée, et ayant pris droit de bourgeoisie chezîle, pourrait bien dégénérer, ou en manie, ou en phtisie, ou en apoplexie, ou même en fine phrénésie et fureur.
Tout cecy ſupoſé, puis qu’vne maladie bien connuë eſt à demy guerie, car ignoti nulla eſt curatio morbi, il ne vous ſera pas difficile de conuenir des remedes que nous deuons faire à Monſieur.	Tout ceci suposé, puis qu'une maladie bien connue est à demi guérie, car ignoti nulla est curatio morbi, il ne vous sera pas difficile de convenir des remèdes que nous devons faire à Monsieur.
Premierement, pour remedier à cette pletore obturante, & à cette cacochimie luxuriante par tout le corps, ie ſuis d’auis qu’il ſoit phlebotomiſé liberalement;	Premièrement, pour remédier à cette pletore obturante, et à cette cacochimie luxuriante par tout le corps, ils suis d'avis qu'il soit phlebotomisé libéralement;
c’eſt à dire que les ſaignées ſoient frequentes & plantureuſes:	c'est -à -dire que les saignées soient fréquentes et plantureuses:
En premier lieu de la baſilique, puis de la cephalique;	En premier lieu de la basilique, puis de la céphalique;
& meſme ſi le mal eſt opiniaſtre, de luy ouurir la veine du front, & que l’ouuerture ſoit large, afin que le gros ſang puiſſe ſortir;	et même si le mal est opiniâtre, de lui ouvrir la veine du front, et que l'ouverture soit large, afin que le gros sang puisse sortir;
& en meſme temps, de le purger, deſopiler, & éuacũer par purgatifs propres & conuenables;	et en même temps, de le purger, désopiler, et éuacũer par purgatifs propres et convenables;
c’eſt à dire par cholagogues, melanogogues, & cætera;	c'est -à -dire par cholagogues, melanogogues, et cætera;
& comme la veritable ſource de tout le mal, eſt ou vne humeur craſſe & feculente, ou vne vapeur noire & groſſiere qui obſcurcit, infecte & ſalit les eſprits animaux, il eſt à propos en ſuite qu’il prenne vn bain d’eau pure & nette, auec force petit lait clair, pour purifier par l’eau la feculence de l’humeur craſſe, & éclaircir par le lait clair la noirceur de cette vapeur;	et comme la véritable source de tout le mal, est ou une humeur crasse et féculente, ou une vapeur noire et grossière qui obscurcit, infecte et salit les esprits animaux, il est à propos en suite qu'il prenne un bain d'eau pure et nette, avec force petit lait clair, pour purifier par l'eau la féculence de l'humeur crasse, et éclaircir par le l' eau la noirceur de cette vapeur;
mais auant toute choſe, ie trouue qu’il eſt bon de le réjoüir par agreables Conuerſations, Chants & Inſtrumens de Muſique, à quoy il n’y a pas d’inconuenient de joindre des Danſeurs, afin que leurs mouuemens, diſpoſition & agilité puiſſent exciter & réueiller la pareſſe de ſes eſprits engourdis.	mais avant toute chose, ie trouve qu'il est bon de le réjouir par agréables Conversations, Chants et Instruments de Musique, à quoi il n'y a pas d'inconvénient de joindre des Danseurs, afin que leurs mouvements, disposition et agilité puissent exciter et réveiller la paresse de ses esprits engourdis.
qui occaſionne l’épaiſſeur de ſon ſang, d’où procede la malâdie.	qui occasionne l'épaisseur de son sang, d'où procède la malâdie.
Voila les remedes que i’imagine, auquel pourront eſtre adjoutez beaucoup d’autres meilleurs par Monſieur noſtre Maiſtre & Ancien, ſuiuant ſ’experience, jugement, lumiere & ſuffiſance qu’il s’eſt acquiſe dans noſtre Art.	Voilà les remèdes que j'imagine, auquel pourront être ajoutez beaucoup d'autres meilleurs par Monsieur notre Maître et Ancien, suivant s'expérience, jugement, lumière et suffisance qu'il s'est acquise dans notre Art.
Dixi.	Dixi.
2.	2.
MEDECIN.	MÉDECIN.
A Dieu ne plaiſe, Monſieur, qu’il me tombe en penſée d’ajouE iij ter rien à ce que vous venez de dire:	À Dieu ne plaise, Monsieur, qu'il me tombe en pensée d'ajouE jij ter rien à ce que vous venez de dire:
vous auez ſi bien diſcouru ſur tous les ſignes, les ſimptoſmes & les cauſes de la maladie de Monſieur;	Vous avez si bien discouru sur tous les signes, les symptômes et les causes de la maladie de Monsieur;
le raiſonnement que vous en auez fait eſt ſi docte & ſi beau, qu’il eſt impoſſible qu’il ne ſoit pas fou, & mélancolique hypocondriaque;	le raisonnement que vous en avez fait est si docte et si beau, qu'il est impossible qu'il ne soit pas fou, et mélancolique hypocondriaque;
& quand il ne le ſeroit pas, il faudroit qu’il le deuint, pour la beauté des choſes que vous auez dites, & la juſteſſe du raiſonnement que vous auez fait.	et quand il ne le serait pas, il faudrait qu'il le devint, pour la beauté des choses que vous avez dites, et la justesse du raisonnement que vous avez fait.
Oüy, Monſieur, vous auez dépeint fort graphiquement, graphice depinxiſti, tout ce qui appartient à cette maladie;	Oui, Monsieur, vous avez dépeint fort graphiquement, graphice dépinxisti, tout ce qui appartient à cette maladie;
il ne ſe peut rien de plus doctement, ſagement, ingenieuſement conceu, penſé, imaginé, que ce que vous auez prononcé au ſujet de ce mal, ſoit pour la diagnoſe, ou la prognoſe, ou la therapie;	il ne se peut rien de plus doctement, sagement, ingénieusement conçu, pensé, imaginé, que ce que vous avez prononcé au sujet de ce mal, soit pour la diagnose, ou la prognose, ou la thérapie;
& il ne me reſte rien icy, que de feliciter Monſieur, d’eſtre tombé entre vos mains, & de luy dire qu’il eſt trop heureux d’eſtre fou, pour éprouuer l’efficace & la douceur des remedes que vous auez ſi judicieuſement propoſez:	et il ne me reste rien ici, que de féliciter Monsieur, d'être tombé entre vos mains, et de lui dire qu'il est trop heureux d'être fou, pour éprouver l'efficace et la douceur des remèdes que vous avez si judicieusement proposez:
Ie les approuue tous, manibus & pedibus deſcendo in tuam ſententiam.	Je les approuve tous, manibus et pédibus descendo in tuam sententiam.
Tout ce que i’y voudrois, c’eſt de faire les ſaignées & les purgations en nombre impair, Numero Deus impari gaudet:	Tout ce que j'y voudrais, c'est de faire les saignées et les purgations en nombre impair, Numero Deus impari gaudet:
de prendre le lait clair auant le bain;	de prendre le lait clair avant le bain;
de luy compoſer vn fronteau où il entre du ſel;	de grands composer un fronteau où il entre du sel;
le ſel eſt ſimbole de la ſageſſe:	le sel est symbole de la sagesse:
de faire blanchir les murailles de ſa chambre, pour diſſiper les tenebrés de ſes eſprits, Album eſt diſgregatiuum vifus, & de luy donner tout à rneure in petit Lauement, pour ſeruir de prélude & d’introduction à ces judicieux remedes, dont s’il a à guerir, il doit receuoir du foulagement.	de faire blanchir les murailles de sa chambre, pour dissiper les tenebrés de ses esprits, Album est disgrégativum vifus, et de lui donner tout à rheure in petit Lauement, pour servir de prélude et d'introduction à ces judicieux remèdes, dont s'il a à guérir, il doit recevoir du soulagement.
Faſſe le Ciel, que ces remedes, Monſieur, qui ſont les voſtres, réüſſiſſent au Malade ſelon noſtre intention.	Fasse le Ciel, que ces remèdes, Monsieur, qui sont les vôtres, réussissent au Malade selon notre intention.
M.	M.
POVRCEAVGNAC.	POURCEAUGNAC.
Meſſieurs, il y a vne heure que ie joüons icy vne Comedie?	Messieurs, il y a une heure que je jouons ici ici Comédie?
1.	1.
MEDECIN.	MÉDECIN.
Non, Monſieur, nous ne joüons point.	Non, Monsieur, nous ne jouons point.
M.	M.
POVRCEAVGNAC Queit ce que tout cecy?	POURCEAUGNAC Queit ce que tout ceci?
& que voulez-vous dire auec voſtre galimathias & vos ſottiſes?	et que voulez-vous dire auec jours galimathias et vos sottises?
1.	1.
MEDECIN.	MÉDECIN.
Bon, dire des injures.	Bon, dire des injures.
Voila vn diagnoſtique qui nous manquoit pour la confirmation de ſon mal, & cecy pourroit bien tourner en manie.	Voilà un diagnostique qui nous manquait pour la confirmation de son mal, et ceci pourrait bien tourner en manie.
M.	M.
POVRCEAVGNAC.	POURCEAUGNAC.
Auec qui m’a-t-on mis icy?	Avec qui m'a-t-on mis ici?
Il erache deux ou trois fois.	Il erache deux ou trois fois.
1.	1.
MEDECIN.	MÉDECIN.
Autre diagnoſtique:	Autre diagnostique:
La ſputation frequente.	La sputation fréquente.
M.	M.
POVRCEAVGNAC.	POURCEAUGNAC.
Laiſſons cela, & ſortons d’icy.	Laissons cela, et sortons d'ici.
1.	1.
MEDECIN.	MÉDECIN.
arucidoncunimiſuletude de changer de place.	arvcidoncunimisuletude de changer de place.
M.	M.
POVRCEAVGNAC.	POURCEAUGNAC.
Qu’eit-ce donc que toute cette affaire?	Qu'est-ce donc que toute cette affaire?
& que me voulez-vous?	et que me voulez-vous?
1.	1.
MEDECIN.	MÉDECIN.
Vous guerir, ſelon l’ordre qui dlo tio de cice donmou	Vous guérir, selon l'ordre qui do de cice nmou
M.	M.
POVRCEAVGNAC.	POURCEAUGNAC.
Me guen.	Me guen.
1.	1.
MEDECIN.	MÉDECIN.
Oüy.	Oui.
M.	M.
POVRCEAVGNAC.	POURCEAUGNAC.
Parbleu ie ne ſuis pas malade.	Parbleu Peu ne suis pas malade.
1.	1.
MEDECIN.	MÉDECIN.
Mauuais ſigne, lors qu’vn Malade ne ſent pas ſon mal.	Mauvais signe, lors qu'un Malade ne sent pas son mal.
M.	M.
POVRCEAVGNAC.	POURCEAUGNAC.
re vous dis que le me porte bien.	re vous dis que le me porte bien.
1.	1.
MEDECIN.	MÉDECIN.
Nous ſçauons mieux que vous comment vous vôus portez, & nous ſommes Medecins, qui voyons clair dans voſtre conſtitution.	Nous sçauons mieux que vous comment vous vôus portez, et nous sommes Médecins, qui voyons clair dans votre constitution.
M.	M.
POVRCEAVGNAC.	POURCEAUGNAC.
Si vous eſtes Medecins, ie n’ay que faire de vous;	Si vous êtes Médecins, Seigneur n'ai que faire de vous;
& ie me moque de la Medecine.	et Elle me moque de la Médecine.
1.	1.
MEDECIN.	MÉDECIN.
Hon, hon;	Hon, hon;
voicy vn Homme plus fou que nous ne penſons.	voici un Homme plus fou que nous ne pensons.
M.	M.
POVRCEAVGNAC.	POURCEAUGNAC.
Mon Pere & ma Mere n’ont iamais voulu de remedes, & ils ſont morts tous deux ſans l’aſſiſtance des Medecins.	Mon Père et ma Mère n'ont jamais voulu de remèdes, et ils sont morts tous deux sans l'assistance des Médecins.
1.	1.
MEDECTIT.	MÉDECTIT.
Ie ne m’étonne pas s’ils ont engendré vn Fils qui eſt inſenſé.	Je ne m'étonne pas s'ils ont engendré un Fils qui est insensé.
Allons, procedons à la curation, & par la douceur exhilarante de l’harmonie, adouciſſons, lenifions & accoiſons l’aigreur de ſes eſprits, que ie voy preſts à s’enflamer.	Allons, procédons à la curation, et par la douceur exhilarante de l'harmonie, adoucissons, lénifions et accoisons l'aigreur de ses esprits, que sans voy que sans s'enflamer.
SCENE IX.	SCÈNE IX.
M.	M.
POVRCEAVGNAC.	POURCEAUGNAC.
Ve Diable eſt-ce là?	Ve Diable est-ce là?
Les Gens de ce Païs-cy ſont-ils inſenſez?	Les Gens de ce Pays-cy sont-ils insensés?
Ie n’ay iamais rien veu de tel, & ie n’y comprens rien du tout.	Je n'ai jamais rien vu de tel, et notre n'y comprends rien du tout.
SCENE X.	SCÈNE X.
DEVX MVSICIENS Italiens, en Medecins croteſques, ſuiuis de HVIT MATASSINS, chantent von Purovey, jourendés de la Symphonie d’vn mélange d’Inſtrumens.	DEUX MUSICIENS Italiens, en Médecins crotesques, suivis de HVIT MATASSINS, chantent von Purovei, jourendez de la Symphonie d'un mélange d'Instruments.
Les deux Muſiciens.	Les deux Musiciens.
On di, bon di, bon di, I)Non vi laſciate vccidere D’al dolor malinconico, Noi vi farcmo ridere Col noſtro canto harmonico, Sol per guarirui Siamo venuti qui Bon di, bon di, bon di.	On di, bon di, bon di, I)Non vi lasciate vccière D'al dolor malinconico, Noi vi farco ridere Col ontro canto harmonico, Sol per garirui Siamo venuti qui Bon di, bon di, bon di.
1.	1.
Muſicien.	Musicien.
Altro non é la pazzia Che malinconia.	Altro non é la zia Che malinconia.
Il malato Non é diſperato, Se vol pigliar vn poco d’allegria Altro non é la pazzia Che malinconia.	Il malato Non é disperato, Se vol pigliar ! Toco d'allegria Alo non é la passia Che malinconia.
2.	2.
Muſicien.	Musicien.
Sû, cantate, ballate ridete Et ſe far meglio volete, Quando ſentite il deliro vicins, Pigliate del viao, E qualche volta vn po po di tabac Alegramente Monſu Pourceaugnac.	Sû, cantate, ballate ridète Et se far meglio vole, Quando sentite il déliro vicins, Pigliate del viao, E qualque volta un pô pô di tabac Alégramente Mons Ieurceaugnac.
SCENE XI.	SCÈNE XI.
L’APOTI AIRE, M.	L'APOTI AIRE, M.
POVRCEAVGNAC.	POURCEAUGNAC.
M.	M.
POVRCEAVGNAC.	POURCEAUGNAC.
Comment?	Comment?
Ie n’ay que faire de cela.	Je n'ai que faire de cela.
L’APOTIQVAIRE.	L'APOTIQUAIRE.
Il a eſté ordonné, Monſieur, il a eſté ordonné.	Il a été ordonné, Monsieur, il a été ordonné.
1SP1GEIIVGNAC.	1SP1GEIIUGNAC.
Ah, que de bruit.	Ah, que de bruit.
L’APOTIQVAIRE.	L'APOTIQUAIRE.
Prenez-le, Monſieur, prenez-le:	Prenez-le, Monsieur, prenez-le:
Il ne vous fera point de mal, il ne vous fera point de mal.	Il ne vous fera point de mal, il ne vous fera point de mal.
M.	M.
POVRCEAVCNAC.	POURCEAUCNAC.
Ah.	Ah.
L’APOTIQVAIRE.	L'APOTIQUAIRE.
C’eſt vn petit Clyſtere, vn petit Cliſtere, benin, benin;	C'est un petit Clystère, un petit Clystère, bénin, bénin;
il eſt benin, benin:	il est bénin, bénin:
là, prenez, prenez, prenez, Monſieur;	là, prenez, prenez, prenez, Monsieur;
c’eſt pour deſterger, pour deſterger, deſterger.	c'est pour déterger, pour déterger, déterger.
Les deux Muſiciens accompagnez des Mataſſins & des Inſtrumens, dancent à l’entour de M.	Les deux Musiciens accompagnés des Matassins et des Instruments, dancent à l'entour de M.
de Pourceaugnac, & s’arreſtans deuant luy, chantent, Piglia lo ſu Signor Monſu, Piglia-lo, piglia-lo, piglia-loſú, Che non ti fara male, Piglia-lo ſu queſto ſervitiale, Piglia-lo ſu Signor Monſu, Piglia-lo, piglia-lo, piglia-lo ſu.	de Pourceaugnac, et s'arrêtant devant lui, chantent, Piglia lo su Signor Monsu, Piglia-lo, plia-lo, piglia-losú, Che non ty fara male, Piglia-l su questo servitiale, Piglia-lo su Ignor Monsu, Piglia-lo, piglia-lo, Pigla-lo su-
M.	M.
POVRC.	POURC.
fuyant.	fuyant.
Allez vous-en au Diable.	Allez vous-vous au Diable.
L’Apotiquaire, les deux Muſiciens, & les Mataſſins le ſuiuent, tous vne Seringue à la main.	L'Apotiquaire, les deux Musiciens, et les Matassins le suivent, tous une Seringue à la main.
ACTE II.	ACTE II.
SCENE PREMIERE.	SCÈNE PREMIÈRE.
SBRIGANI, 1.	SBRIGANI, 1.
MEDECIN.	MÉDECIN.
1.	1.
MEDECIN.	MÉDECIN.
L a forcé tous les obſtacles que i’auois mis;	L a forcé tous les obstacles que j'avais mis;
& yeit derobe aux remedes que ie commençois de luy faire.	et yeit derobe aux remèdes que personne commençais de jours faire.
SBRIGANI.	SBRIGANI.
C’eſt eſtre bien ennemy de ſoymeſme, que de fuit des remedes auſſi ſalutaires que les voſtres.	C'est être bien ennemi de soymesme, que de fuit des remèdes aussi salutaires que les vôtres.
1.	1.
MEDECIN.	MÉDECIN.
Marque d’vn cerueau démonté, & d’vne raiſon déprauée, que de ne votion pas guein.	Marque d'un cerveau démonté, et d'une raison dépravée, que de ne votion pas guein.
SBRIGANI.	SBRIGANI.
Vous l’auriez guery haut la main.	Vous l'auriez guéri haut la main.
1.	1.
MEDECIN.	MÉDECIN.
Sans doute, quand il y auroit eu complication de douze maladies.	Sans doute, quand il y aurait eu complication de douze maladies.
SBRIGANI.	SBRIGANI.
Cependant voila cinquante Piſtoles bien acquiles, qu’Il vous fait perdre.	Cependant voilà cinquante Pistoles bien acquiles, qu'Il vous fait perdre.
1.	1.
MEDECIN.	MÉDECIN.
Moy, ie n’entens point les perdre, & pretens le guerir en dépit qu’il en ait.	Moi, Seigneur n'entends point les perdre, et prétends le guérir en dépit qu'il en ait.
Il eſt lié & engagé à mes remedes, & ie veux le faire ſaiſir où ie le trouueray, comme Deſerteur de la Medecine, & Infracteur de mes Ordonnances.	Il est lié et engagé à mes remèdes, et fort veux le faire saisir où on le trouverai, comme Déserteur de la Médecine, et Infracteur de mes Ordonnances.
SEIIGANI.	SEIGANI.
Vous auez raiſon, vos remedes eſtoient vn coup ſeur, & c’eſt de l’argent qu’il vous vole.	Vous avez raison, vos remèdes étaient un coup sûr, et c'est de l'argent qu'il vous vole.
1.	1.
MEDECIN.	MÉDECIN.
Où puis-je en auoir des noudelles?	Où puis-je en avoir des nouvelles?
SBRIGANI.	SBRIGANI.
Chez le bon Homme Oronte, aſſurément, dont il vient épouſer la Fille, & qui ne ſçachant rien de l’infirmité de ſon Gendre futur, vouura peut-eitre le faiter de conclure le Mariage.	Chez le bon Homme Oronte, assurément, dont il vient épouser la Fille, et qui ne sachant rien de l'infirmité de son Gendre futur, vouira peut-éitre le faiter de conclure le Mariage.
1.	1.
MEDECIN.	MÉDECIN.
Ie vais luy perler tout à l’heure.	Je vais quelque perler tout à l'heure.
SBRIGANI.	SBRIGANI.
Vous ne ferez point mal.	Vous ne ferez point mal.
1.	1.
MEDECIN.	MÉDECIN.
Teit lypotneque a mies Conſultations;	Tit lypotneque a mies Consultations;
& vn Malade ne ſe moquera pas d’vn Medecin.	et un Malade ne se moquera pas d'Han Nédecin.
SBRIGANI.	SBRIGANI.
C’eſt fort bien dit à vous;	C'est fort bien dit à vous;
& ſi vous m’en croyez, vous ne ſouffrirez point qu’il ſe marie, que vous ne l’ayez panſé tout voſtre ſoû	et si vous m'en croyez, vous ne souffrirez point qu'il se marie, que vous ne l'ayez pansé tout votre sou
SBRIGANI.	SBRIGANI.
Ie vais de mon coſté dreſſer vne autre batterie, & le Beau-pere eſt auſſi dupe que le Gendre.	Je vais de mon côté dresser une autre batterie, et le Beau-père est aussi dupe que le Gendre.
SCENE II.	SCÈNE II.
ORONTE, I.	ORONTE, I.
MEDECIN.	MÉDECIN.
1.	1.
MEDECIN.	MÉDECIN.
Y Ous auez, Monſieur, vn cery caſnMomneur de Pounccaugnac, qui doit épouſer voſtre Fille.	Y Ous avez, Monsieur, un ceri casnMomneur de Pouncaugnac, qui doit épouser votre Fille.
ORONTE.	ORONTE.
Oüy, ie l’attens de Limoges, & il deuroit eſtre arriué.	Oui, Seigneur l'attends de Limoges, et il devrait été arrivé.
1.	1.
MEDECIN.	MÉDECIN.
Auſſi l’eſt-il, & il s’en eſt fuy de chez moy, apres y auoir eſté mis, 1 1 mais ie vous defens de la part de la Medecine, de proceder au mariage que vous auez conclu, que ie ne l’aye deuëment preparé pour cela, & mis en eſtat de procréer des Enfans bien conditionnez & de corps & d’eſprit.	Aussi l'est-il, et il s'en est fuis de chez moi, après y avoir été mis, 1 1 mais encore vous défends de la part de la Médecine, de procéder au mariage que vous avez conclu, que je ne l'aie dé paré pour cela, et mis en état de procréer des Enfants bien conditionnez et de corps et d'esprit.
ORONTE.	ORONTE.
Comment donc?	Comment donc?
1.	1.
MEDECIN.	MÉDECIN.
Voſtre pretendu Gendre a eſté conſtitué mon Malade:	Votre prétendu Gendre a été constitué mon Malade:
Sa Maladie qu’on m’a donné à guerir, eſt vn meuble qui m’appartient, & que ie compte entre mes effets;	Sa Maladie qu'on m'a donné à guérir, est un m qui 'appartient, et que ie compte entre mes effets;
& ie vous declare que ie ne pretens point qu’il ſe marie, qu’au prealable il n’ait ſatisfait à la Medecine, & ſuby les remedes que ie luy ay ordonnez.	et petit vous déclare que ici ne prétends point qu'il se marie, qu'au préalable il n'ait satisfait à la Médecine, et subi les remèdes que ie lui ai ordonnez.
ORONTE.	ORONTE.
Il a quelque mal?	Il a quelque mal?
1.	1.
MEDECIN.	MÉDECIN.
Ouy.	Oui.
ORONTE.	ORONTE.
Et quel mal, s’il vous plaiſt?	Et quel mal, s'il vous plaît?
1.	1.
MEDECIN.	MÉDECIN.
Ne vous en mettez pas en peine.	Ne vous en mettez pas en peine.
ORONTE.	ORONTE.
Eſt-ce quelque mal.	Est-ce quelque mal.
1.	1.
MEDECIN.	MÉDECIN.
Les Medecins ſont obligez au ſecret:	Les Médecins sont obligés au secret:
Il ſuffit que ie vous ordonne, à vous & à voſtre Fille, de ne point celebrer, ſans mon conſentement, vos Nopces auec luy, ſur peine d’encourir la diſgrace de la Pacunte, & d’eitre accabiez de toutes les Maladies qu’il nous plaira.	Il suffit que je vous ordonne, à vous et à votre Fille, de ne point célébrer, sans mon consentement, vos Noces avec mieux, sur peine d'encourir la disgrâce de la Pacunte, et d'eitre accabiez de toutes les Maladies qu'il nous plaira.
ORONTE.	ORONTE.
tomuj garue;	tomuj garue;
n cela eſt, de faire le Mariage.	n cela est, de faire le Mariage.
1.	1.
MEDECIN.	MÉDECIN.
On me l’a mis entre les mains, & freit obnge d'eitre mon Malade.	On me l'a mis entre les mains, et frit obnge d'éitre mon Malade.
ORONTE.	ORONTE.
A la bonne heurc.	À la bonne heurc.
1.	1.
MEDECIN.	MÉDECIN.
Il a beau fuïr, ie le feray condamner par Arreſt à ſe faire guerir par moy.	Il a beau fuir, ie le ferai condamner par Arrêt à se faire guérir par moi.
ORONVTE.	ORONUTE.
I’y conſens.	J'y consens.
1.	1.
MEDECIN.	MÉDECIN.
Oüy, il faut qu’il creve, ou que ie le gueriſſe.	Oui, il faut qu'il crève, ou que sans le guérisse.
ORONTE.	ORONTE.
Ie le veux bien.	Je le veux bien.
1.	1.
MEDECIN.	MÉDECIN.
Et ſi ie ne le trouue, ie m’en prendray à vous, & ie vous gueriray au lieu de luy.	Et si ici ne le trouve, ie m'en prendrai à vous, et je vous guérirai au lieu de lui!
ORONTE.	ORONTE.
Ie me porte bien.	Je me porte bien.
1.	1.
MEDECIN.	MÉDECIN.
Il n’importe, il me faut vn Malade, & ie prendray qui ie pouray.	Il n'importe, il me faut un Malade, et Seigneur prendrai qui était pourai.
ORONTE.	ORONTE.
Prenez qui vous voudrez, mais ce ne ſera pas moy.	Prenez qui vous voudrez, mais ce ne sera pas moi.
Voyez vn peu la belle raiſon.	Voyez un peu la belle raison.
SCENE III.	SCÈNE III.
Iee IIuien Marchand Flaman, ORONTE.	Jee IIvien Marchand Flaman, ORONTE.
SBRIGANI.	SBRIGANI.
Ontſir, auec le voſtre perIVImiſſione, ie ſuiſſe vn I’ranchel Marciſant Fiaiſfane, qui voudroit bienne vous temandair vn petit nouuel.	Ontsir, était le vôtre pérIVImissione, Elle suisse un J'anchel Marcisant Fiaisefane, qui voudrait bien vous témandair un petit nouvel.
ORONTE.	ORONTE.
Quoy, Monſieur?	Quoi, Monsieur?
SBRIGANI.	SBRIGANI.
Mettez le voſtre chapeau ſur le teſte, Montſir, ſi ve plaiſt.	Mettez le vôtre chapeau sur le tête, Montsir, si ve plaît.
ORONTE.	ORONTE.
Dites-moy, Monſieur, ce que vous voulez.	Dites-moi, Monsieur, ce que vous voulez.
SBRIGANI.	SBRIGANI.
Moy le dire rien, Montſir, ſi vous le mettre pus le chapeau ſur le teſte.	Moi le dire rien, Montsir, si vous le mettre pus le chapeau sur le tête.
CICONEL.	CICONEL.
Soit.	Soit.
Qu’y a-t-il, Monſieur?	Qu'y a-t-il, Monsieur?
SBRIGANI.	SBRIGANI.
Fous connoiſtre point en ſti File vn certe Montſir Oronte?	Fous connaître point en sti File un certe Montsir Oronte?
ORONTE.	ORONTE.
Oüy, ie le connoy.	Oui, Seigneur le connais.
SDRCIOANVT.	SDRCIOANUT.
Et quel Homme eſt-ile, Montſir, ſi ve plaiſt?	Et quel Homme est-île, Montsir, si ve plaît?
ORONTE.	ORONTE.
C’eſt vn Homme comme les autres.	C'est un Homme comme les autres.
SBRIGANI.	SBRIGANI.
Ie vous temande, Montſir, s’il eſt vn Homme riche qui a du bienne?	Je vous témande, Montsir, s'il est un Homme riche qui a du bien?
ORONTE.	ORONTE.
Mais riche beaucoup grandement, Montſir?	Mais riche beaucoup grandement, Montsir?
Oüy.	Oui.
ORCOIUHL.	ORCOIUHL.
SBRIGANI.	SBRIGANI.
I’en ſuy aiſe beaucoup, Montſir.	J'en su aise beaucoup, Montsir.
ORONTE.	ORONTE.
Mais pourquoy cela?	Mais pourquoi cela?
SBRIGANI.	SBRIGANI.
Dert, Montn, pour vn petit raiſonne de conſequence pour nous.	Dert, Montn, pour un petit raisonne de conséquence pour nous.
ORONTE.	ORONTE.
Mais encore, pourquoy?	Mais encore, pourquoi?
SBRIGANI.	SBRIGANI.
l’eſt, Montſir, que ſti Montſir Oronte donne ſon Fille en mariage à vn certe Montſir de Pourcegnac.	l'est, Montsir, que sti Montsir Oronte donne son Fille en mariage à un certe Montsir de Pourcegnac.
ORONTE.	ORONTE.
Tie bien.	Tie bien.
SBRIGANI.	SBRIGANI.
Et ſti Montſir de Pourcegnac, Montſir, l’eſt vn Homme que doivre beaucoup grandement à dix ou doult Marcnamme Flamane qui eſtre venu icy.	Et sti Montsir de Pourcegnac, Montsir, l'est un Homme que doivre beaucoup grandement à dix ou doult Marcnamme Flamane qui être venu ici.
ORONTE.	ORONTE.
Ce Monſieur de Pourceaugnac doit beaucoup à dix ou douze Marchands?	Ce Monsieur de Pourceaugnac doit beaucoup à dix ou douze Marchands?
SBRIGANI.	SBRIGANI.
Oüy, Montſir;	Oui, Montsir;
& depuis huite mois nous auoir obtenir vn petit Santence contre luy, & luy à remettre à payer tou ce Creanciers de ſti Mariage que ſti Montſir Oronte donne pour ſon Fille.	et depuis huite mois nous avoir obtenir un petit Santence contre lui, et même à remettre à payer tou ce Créanciers de sti Mariage que sti Montsir Oronte donne pour son Fille.
ORONTE.	ORONTE.
Hon, hon, il a remis là à payer ſes Creanciers?	Hon, hon, il a remis là à payer ses Créanciers?
SBRIGANI.	SBRIGANI.
Oüy, Montſir, & auec vn grant deuotion nous tous attendre ſti Mariage.	Oui, Montsir, et Seigneur un grant dévotion nous tous attendre sti Mariage.
ORONTE.	ORONTE.
muuis n'ert pas mauuais.	muuis n'ert pas mauvais.
Ie vous donne le bon-jour.	Je vous donne le bonjour.
SBRIGANI.	SBRIGANI.
le remercle, Montiir, de la faueur grande.	le remercle, Montiir, de la faveur grande.
ORONTE.	ORONTE.
Voſtre tres-humble valet.	Votre très-humble valet.
Cela ne va pas mal;	Cela ne va pas mal;
quittons noſtre ajuſtement de Flamant pour ſonger à d’autres machines, & tâchons de ſemer tant de ſoupçons & de diuiſion entre le Beaupere & le Gendre, que cela rompe le Mariage pretendu.	quittons notre ajustement de Flamant pour songer à d'autres machines, et tâchons de semer tant de soupçons et de division entre le Beaupère et le Gendre, que cela rompe le Mariage prétendu.
Tous deux	Tous deux
SBRIGANI.	SBRIGANI.
Ie le ſuis, Montſir, obliger plus que beaucoup du bon nouuel que Montſir m’auoir donné.	Je le suis, Montsir, obliger plus que beaucoup du bon nouvel que Montsir m'avoir donné.
également ſont propres à gober les hameçons qu’on leur veut tendre;	également sont propres à gober les hameçons qu'on leur veut tendre;
& entre nous autres Fourbes de la premiere Claſſe, nous ne faiſons que nous joüer, lors que nous trouuons vn Gibier auſſi facile que celuy-la.	et entre nous autres Fourbes de la première Classe, nous ne faisons que nous jouer, lors que nous trouvons un Gibier aussi facile que celui-la.
SCENE IV.	SCÈNE IV.
M.	M.
POVRCE AVGNAC, SBRIGANI.	POURCE AUGNAC, SBRIGANI.
M.	M.
POVRCEAVGNAC.	POURCEAUGNAC.
JAgna-to ju, pigna-to ju, Signor Y Monſu.	JAgna-to ju, pigna-to ju, Signor Y Monsu.
Que diable eſt-ce là?	Que diable est-ce là?
Ah!	Ah!
SBRIGANI.	SBRIGANI.
Qu’eſt-ce, Monſieur, qu’auezvous?	Qu'est-ce, Monsieur, qu'auezvous?
M.	M.
POVRCEAVGNAC.	POURCEAUGNAC.
Tout ce que ie voy, me ſemble Lauement.	Tout ce que ici vois, me semble Lavement.
SBRIGANI.	SBRIGANI.
Comment ?	Comment ?
M.	M.
POVRCEAVGNAC.	POURCEAUGNAC.
Vous ne ſçauez pas ce qui m’eſt arriué dans ce Logis à la porte duquel vous m’auez conduit?	Vous ne savez pas ce qui m'est arrivé dans ce Logis à la porte duquel vous m'avez conduit?
SBRIGANI.	SBRIGANI.
Nonl viayment, queittée que c’eſt ?	Nonl viaiment, queittée que c'est ?
M.	M.
POVRCEAVGNAC.	POURCEAUGNAC.
Ie penſois y eſtre regalé comme il faut.	Je pensais y être régalé comme il faut.
SBRIGANI.	SBRIGANI.
Hé bien ?	Hé bien ?
M.	M.
POVRCEAVGNAC.	POURCEAUGNAC.
Ie vous laiſſe entre les mains de Monſieur.	Je vous laisse entre les mains de Monsieur.
Des Medecins habillez de noir.	Des Médecins habillez de noir.
Dans vne chaiſe.	Dans une chaise.
Tâter le poulx.	Tâter le poulx.
Comme ainſi ſoit.	Comme ainsi soit.
Il eſt fou.	Il est fou.
Deux gros jouffus.	Deux gros jouffus.
Grands chapeaux.	Grands chapeaux.
Bon di, bon di.	Bon di, bon di.
Six Pantalons.	Six Pantalons.
Ta, ra, ta, ta:	Ta, ra, ta, ta:
Ta, ra, ta, ta.	Ta, ra, ta, ta.
Alegramente Monſu Pourceaugnas.	Alégramente Monsu Pourceaugnas.
Apotiquaire.	Apotiquaire.
Lauement.	Lavement.
Prenez.	Prenez.
Monſieur, prenez, prenez.	Monsieur, prenez, prenez.
Il eſt benin, benin, benin.	Il est bénin, bénin, bénin.
C’eſt pour déterger, pour déterger, déterger.	C'est pour déterger, pour déterger, déterger.
Piglia-lo ſu, Signor Monſu, piglia-lo, piglia-lo, piglia-lo ſú.	Piglia-lo su, Signor Monsu, piglia-lo, piglia-lo, piglia-lo somme.
Iamais ie n’ay eſté ſi ſaoul de ſottiſes.	Jamais ici n'ai été si saoul de sottises.
SBRIGANI.	SBRIGANI.
Qu'eit-ce que tout ceit veut dire ?	Qu'est-ce que tout ceit veut dire ?
M.	M.
POVRCEAVGNAC.	POURCEAUGNAC.
Cela veut dire que cet Hommelà, auec ſes grandes embraſſades, cit ril Fourbe qui m’a mis dans vne Maiſon pour ſe moquer de moy, & ine lahe vne plece.	Cela veut dire que cet Hommélà, avec ses grandes embrassades, cit ril Fourbe qui m'a mis dans une Maison pour se moquer de moi, et ine lahe une plece.
SBRIGANI.	SBRIGANI.
Cela eſt-il poſſible?	Cela est-il possible?
M.	M.
POVRCEAVGNAC.	POURCEAUGNAC.
cuns doute, ils eſtoient vne douzaine de Poſſedez apres mes chauſſes;	cuns doute, ils étaient une douzaine de Possédés après mes chausses;
& i’ay eu toutes les peines du monde à m’échaper de leurs pates.	et j'ai eu toutes les peines du monde à m'échapper de leurs pates.
SBRIGANI.	SBRIGANI.
Voyez-vn peu, les mines ſont bien trompeuſes!	Voyez-un peu, les mines sont bien trompeuses!
Ie l’aurois crû le plus affectionné de vos Amis.	Je l'aurais crû le plus affectionné de vos Amis.
Voila vn de mes étonnemens, comme m oit poſſible qu’il y ait des Fourbes comme cela dans le Monde.	Voilà un de mes étonnements, comme m oit possible qu'il y ait des Fourbes comme cela dans le Monde.
M.	M.
POVRCEAVGNAC.	POURCEAUGNAC.
Ne lens-je ponlt le Lauehient?	Ne lens-je ponlt le Lavehient?
voyez, ie vous prie.	voyez, Seigneur vous prie.
SBRIGANI.	SBRIGANI.
Eh il y a quelque petite choſe qui approche de cela.	Eh il y a quelque petite chose qui approche de cela.
M.	M.
POVRCEAVGNAC.	POURCEAUGNAC.
I’ay l’odorat & l’imagination tout remply de cela, & il me ſemble toujours que ie voy vne douzaine de Lauemens qui me couchent en jouë.	J'ai l'odorat et l'imagination tout rempli de cela, et il me semble toujours que ie éclaine douzaine de Lavements qui me couchent en joue.
SBRIGANI.	SBRIGANI.
Voila vne meſchanceté bien grande!	Voilà une méchanceté bien grande!
& les Hommes ſont bien traîtres & ſcelerats!	et les Hommes sont bien traîtres et scélérats!
M.	M.
POVRCEAVGNAC.	POURCEAUGNAC.
Enſeignez-moy, de grace, le Logis de Monſieur Oronte;	Enseignez-moi, de grâce, le Logis de Monsieur Oronte;
ie ſuis bien aiſe d’y aller tout à l’heure.	Je suis bien aise d'y aller tout à l'heure.
SBRIGANI.	SBRIGANI.
Ah, ah, vous eſtes donc de complexion amoureuſe, & vous adez ouy parier que ce Monſieur Oronte a vne Fille.	Ah, ah, vous êtes donc de complexion amoureuse, et vous adez ouï parier que ce Monsieur Oronte a une Fille.
M.	M.
POVRCEAVGNAC.	POURCEAUGNAC.
Oüy, ie viens l’épouſer.	Oui, Seigneur viens l'épouser.
SBRIGANI.	SBRIGANI.
Eeiss lammer.	ÉRiss lammer.
M.	M.
POVRCEAVGNAC.	POURCEAUGNAC.
Ouj.	Ouj.
SBRIGANI.	SBRIGANI.
En mariage ?	En mariage ?
M.	M.
POVRCEAVGNAC.	POURCEAUGNAC.
De quelle façon donc?	De quelle façon donc?
SBRIGANI.	SBRIGANI.
Ah c’eſt vne autre choſe, & ie vous demande pardon.	Ah c'est autre chose, et Seigneur vous demande pardon.
M.	M.
POVRCEAVGNAC.	POURCEAUGNAC.
Qu’eſt-ce que cela veut dire?	Qu'est-ce que cela veut dire?
M.	M.
POVRCEAVGNAC.	POURCEAUGNAC.
Mais encor?	Mais encor?
SBRIGANI.	SBRIGANI.
Ren, vous dis-je;	Ren, vous dis-je;
l’ay vn peu parlé trop viſte.	l'ai un peu parlé trop vite.
M.	M.
POVRCEAVGNAC.	POURCEAUGNAC.
Ie vous prie de me dire ce qu’il y uia deſſous.	Je vous prie de me dire ce qu'il y uia dessous.
SBRIGANI.	SBRIGANI.
Avon, cela i’ert pas necenaire.	Avon, cela j'ert pas necénaire.
M.	M.
POVRCEAVGNAC.	POURCEAUGNAC.
De grace.	De grâce.
SBRIGANT.	SBRIGANT.
Point, ie vous prie de m’en diſpenſer.	Point, je vous prie de m'en dispenser.
M.	M.
POVRCEAVGNAC.	POURCEAUGNAC.
Eſt-ce que vous n’eſtes pas de mes Amis?	Est-ce que vous n'êtes pas de mes Amis?
SBRIGANI.	SBRIGANI.
Si-fait, on ne peut pas l’eſtre dauantage.	Si-fait, on ne peut pas l'être davantage.
M.	M.
POVRCEAVGNAC.	POURCEAUGNAC.
Vous deuez donc ne me rien cacher.	Vous devez donc ne me rien cacher.
SBRIGANI.	SBRIGANI.
Ceit vne enoie ou ny va de l’intereſt du prochain.	Ceit une enoie ou ainsi va de l'intérêt du prochain.
M.	M.
POVRCEAVGNAC.	POURCEAUGNAC.
Afin de vous obliger à m’ouurir voſtre cœur, voila vne petite Bague que ie vous prie de garder pour l’amour de moy.	Afin de vous obliger à m'ouvrir votre cœur, voilà un petite Bague que ie vous prie de garder pour l'amour de moi.
SBRIGANI.	SBRIGANI.
Laiſſez-moy conſulter vn peu ſi ie le puis faire en conſcience.	Laissez-moi consulter un peu si tu le puis faire en conscience.
C’eſt vn Homme qui cherche ſon bien, qui tâche de pouruoir ſa Fille le plus auantageuſement qu’il eſt poſſible;	C'est un Homme qui cherche son bien, qui tâche de pourvoir sa Fille le plus avantageusement qu'il est possible;
& il ne faut nuire à perſonne.	et il ne faut nuire à personne.
Ce ſont des choſes qui ſont connuës à la ve8, rité, mais i’iray les découurir à vn Homme qui les ignore, & il eſt defendu de ſcandaliſer ſon prochain:	Ce sont des choses qui sont connues à la ve8, rité, mais j'irai les découvrir à un Homme qui les ignore, et il est défendu de scandaliser son prochain:
Cela eſt vray;	Cela est vrai;
mais d’autre part voila vn Etranger qu’on veut ſurprendre, & qui de bonne foy vient ſe marier auec vne Fille qu’il ne connoiſt pas, & qu’il n’a iamais veuë;	mais d'autre part voilà un Etranger qu'on veut surprendre, et qui de bonne foi vient se marier avec une Fille qu'il ne connaît pas, et qu'il n'a jamais vue;
vn Gentilhomme plein de franchiſe, pour qui ie me ſens de l’inclination, qui me fait l’honneur de me tenir pour ſon Amy, prend confiance en moy, & me donne vne Bague à garder pour l’amour de luy.	Un Gentilhomme plein de franchise, pour qui Elle me sens de l'inclination, qui me fait l'honneur de me tenir pour son Ami, prend confiance en moi, et me donne une Bague à garder pour l'amour de lui.
Oüy, ie trouue que ie puis vous dire les choſes ſans bleſſer ma conſcience;	Oui, Seigneur trouve que on puis vous dire les choses sans blesser ma conscience;
mais tâchons de vous les dire le plus doucement qu’il nous ſera poſſible, & d’épargner les Gens le plus que nous pourons.	mais tâchons de vous les dire le plus doucement qu'il nous sera possible, et d'épargner les Gens le plus que nous pourrons.
De vous dire que cette Fille-là mene vne vie deſ-honneſte, cela ſeroit vn peu trop fort;	De vous dire que cette Fille-là mène R vie des-honnête, cela serait un peu trop fort;
cherchons pour nous expliquer, quelques termes plus doux.	cherchons pour nous expliquer, quelques termes plus doux.
Le mot de Galante auſſi n’eſt pas aſſez;	Le mot de Galante aussi n'est pas assez;
celuy de Coquette acheuée, me ſemble propre à ce que nous voulons, & ie m’en puis ſeruir, pour vous dire honneſtement ce qu’elle eſt.	celui de Coquette achevée, me semble propre à ce que nous voulons, et notre m'en puis servir, pour vous dire honnêtement ce qu'elle est.
M.	M.
POVRCEAVGNAC.	POURCEAUGNAC.
Lon me veur done prendre pour dupe?	Lon me veut donce prendre pour dupe?
SBRIGANI.	SBRIGANI.
Peut-eſtre dans le fond n’y a-t-il pas tant de mal que tout le monde croit;	Peut-être dans le fond n'y a-t-il pas tant de mal que tout le monde croit;
& puis il y a des Gens, apres tout, qui ſe mettent au deſſus de ces ſortes de choſes, & qui ne croyent pas que leur honneur dépende.	et puis il y a des Gens, après tout, qui se mettent au dessus de ces sortes de choses, et qui ne croient pas que leur honneur dépende.
M.	M.
POVRCEAVGNAC.	POURCEAUGNAC.
Ie ſuis voſtre ſeruiteur, ie ne me veux point mettre ſur la teſte vn chapeau comme celuy-là, & l’on aime à aller le front leué dans la Famille des Pourceaugnacs.	Je suis votre serviteur, ie ne me veux point mettre sur la tête un chapeau comme celui-là, et l'on aime à aller le front levé dans la Famille des Pourceaugnacs.
SBRIGANI.	SBRIGANI.
Ouy, le ille fethe.	Oui, le ille fethe.
11 SCENE V ORONTE, M.	11 SCÈNE V ORONTE, M.
POVRC.	POURC.
M.	M.
PEVRSEI GNAC.	PEURSEI GNAC.
On-jour, Monſieur, bonDjour.	Onjour, Monsieur, bonDour.
ORONTE.	ORONTE.
Seruiteur, Monſieur, ſeruiteur.	Serviteur, Monsieur, serviteur.
M.	M.
POVRCEAVGNAC.	POURCEAUGNAC.
Vous eſtes Monſieur Oronte, n’eſt-ce pas?	Vous êtes Monsieur Oronte, n'est-ce pas?
Oüy.	Oui.
ORONTE.	ORONTE.
M.	M.
POVRCEAVGNAC.	POURCEAUGNAC.
Et moy, Monſieur de Pourceaugnac.	Et moi, Monsieur de Pourceaugnac.
ORONTE.	ORONTE.
A la bonne heure.	À la bonne heure.
M.	M.
POVRCEAVGNAC.	POURCEAUGNAC.
Cre penvous, Monhoul Sfonte, que les Limoſins ſoient des ſots?	Cre penvous, Monhoul Sfonte, que les Limosins soient des sots?
ORONTE.	ORONTE.
Croyez-vous, Monſieur de Pourceaugnac, que les Pariſiens ſoient des beſtes?	Croyez-vous, Monsieur de Pourceaugnac, que les Parisiens soient des bêtes?
M.	M.
POVRCEAVGNAC.	POURCEAUGNAC.
y Sun Milg mentoun, Monfieur Oronte, qu’vn Homme comme moy ſoit ſi affamé de Femme?	y Sun Milg mentoun, Monfieur Oronte, qu'un Homme comme moi soit si affamé de Femme?
ORONTE.	ORONTE.
Vous imaginez-vous, Monſieur de Pourceaugnac, qu’vne Fille comme la mienne ſoit ſi affamée de Mary?	Vous imaginez-vous, Monsieur de Pourceaugnac, qu'une Fille comme la mienne soit si affamée de Mari?
SCENE VI.	SCÈNE VI.
DIEORONTE, M.	DIEORONTE, M.
POVRCEAVGNAC.	POURCEAUGNAC.
IVLIE.	IVLIE.
N vient de me dire, mon APere, que Monſieur de Pourceaugnac eſt arriué.	N vient de me dire, mon APère, que Monsieur de Pourceaugnac est arrivé.
Ah le voila ſans doute, & mon cœur me le dit.	Ah le voilà sans doute, et mon cœur me le dit.
Qu’il eſt bien fait:	Qu'il est bien fait:
qu’il a bon air!	qu'il a bon air!
& que le luis contemte d'uuoir vii tel Epous;	et que le luis contemte d'uoir vii tel Épous;
Souffrez que ie l’embraſſe, & que ie luy témoigne.	Souffrez que venir l'embrasse, et que Ne lui témoigne.
ORONTE.	ORONTE.
Doucement, ma Fille, doucement.	Doucement, ma Fille, doucement.
M.	M.
POVRCEAVGNAC.	POURCEAUGNAC.
Tu-dieu, quelle Galante!	Tudieu, quelle Galante!
comtme elle prend feu d’abord:	comtme elle prend feu d'abord:
ORONTE.	ORONTE.
Ie voudrois bien ſçauoir, Monſieur de Pourceaugnac, par quelle raiſon vous venez.	Je voudrais bien savoir, Monsieur de Pourceaugnac, par quelle raison vous venez.
IVLIE.	IVLIE.
Que ie ſuis aiſe de vous voir & que ie brule d’impatience.	Que ie suis aise de vous voir et que je brule d'impatience.
ORONTE.	ORONTE.
An, flia Fiile, oitez-vous de là, vous dis-je.	An, flia Fiile, oitez-vous de là, vous dis-je.
M.	M.
POVRCEAVGNAC, sapv- Ho, ho, quelle égrillarde!	POURCEAUGNAC, sapv- Ho, ho, quelle égrillarde!
ORONTE.	ORONTE.
e voucirois bien, coeje, ſçauoir corde par quelle raiſon, s’il vous plaiſt, vous auez la nardienede.	Je voucirais bien, coeuje, savoir corde par quelle raison, s'il vous plaît, vous avez la nardienede.
ruißãt, M.	rivant, M.
POVRCEAVGNAC.	POURCEAUGNAC.
Vercu de ma vie?	Vercu de ma vie?
ORONTE.	ORONTE.
Encor, qu’eſt-ce à dire cela?	Encor, qu'est-ce à dire cela?
IVLIE.	IVLIE.
Ne voulez-vous pas que ie careſſe l’Epous que vous m’auez choiſy?	Ne voulez-vous pas que ici caresse l'Épous que vous m'avez choisi?
ORONTE.	ORONTE.
Nvon, Ientrez la-dedans.	Névon, Jentrez la-dedans.
IVLIE.	IVLIE.
Laiſſez-moy le regarder.	Laissez-moi le regarder.
ORONTE.	ORONTE.
Rentrez, vous dis-je.	Rentrez, vous dis-je.
IVLIE.	IVLIE.
le veun deneurer luy oAvous plaiſt.	le veun denurer lui vOus plaît.
ORONTE.	ORONTE.
Ie ne veux pas, moy;	Je ne veux pas, moi;
& ſi tu ne rentre tout à l’heure, ie.	et si tu ne rentre tout à l'heure, Elle.
IVLIE.	IVLIE.
Hé bien, ie rentre.	Hé bien, Seigneur rentre.
URCONTDS Ma Fille eſt vne ſotte, qui ne ſçait pas les choles.	OURCONTDS Ma Fille est quelque sotte, qui ne sait pas les choles.
M.	M.
POVRCEAVGNAC.	POURCEAUGNAC.
Comme nous luy plaiſons!	Comme nous nous plaisons!
ORONTE.	ORONTE.
Tu ne veux pas te retirer?	Tu ne veux pas te retirer?
IVLIE.	IVLIE.
Quand eſt-ce donc que vous H Illc Melieren duce Monneux?	Quand est-ce donc que vous H Illc Melieren duce Monneux?
ORONTE.	ORONTE.
Iamlais;	Jamlais;
& tu nes pas pour luy.	et tu nés pas pour venir.
IVLIE.	IVLIE.
Ie le veux auoir, moy, puis que vous me l’auez promis.	Je le veux avoir, moi, puis que vous me l'avez promis.
ORONTE.	ORONTE.
or le.	or le.
te Pay promis, leſte le dépromets.	te Pai promis, leste le dépromets.
M.	M.
POVNCEAVGNAC.	POUNCEAUGNAC.
Elle voudroit bien me tenir.	Elle voudrait bien me tenir.
IVLIE.	IVLIE.
ons’auez beau faire, nous ſerons mariez enſemble en dépit de tout le monde.	ons'avez beau faire, nous serons mariés ensemble en dépit de tout le monde.
ORONTE.	ORONTE.
Ie vous en empeſcheray bien tout deux, ie vous aſſure.	Je vous en empêcherai bien tout deux, je vous assure.
Voyez vn peu quel vertigo luy prend.	Voyez un peu quel Vigo eux prend.
M.	M.
POVRCÉAVGNAC.	POVRCÉAVGNAC.
Mon Dieu, noſtre Beaupere pretendu, ne vous fatiguez point tant;	Mon Dieu, notre Beaupère prétendu, ne vous fatiguez point tant;
on n’a pas eniue de vous enleuer voſtre Fille, & vos griIlaces Hatrapcrone Mlen.	on n'a pas enive de vous enlever votre Fille, et vos griIlaces Hatrapcrape Mlen.
ORONTE.	ORONTE.
Toutes les voſtres n’auront pas grand effet.	Toutes les vôtres n'auront pas grand effet.
M.	M.
POVRCEAVGNAC.	POURCEAUGNAC.
Vous eſtes-vous mis dans la teſte que Leonard de Pourceaugnac ſoit vn Homme à acheter Chat en poche?	Vous êtes-vous mis dans la tête que Léonard de Pourceaugnac soit un Homme à acheter Chat en poche?
& qu’il n’ait pas là-dedans quelque morceau de judiciaire pour ſe conduire, pour ſe faire informer de l’hiſtoire du M'ionde, ce touun in Mariant, ſi ſon honneur a bien toutes ſes ſeuretez?	et qu'il n'ait pas là-dedans quelque morceau de judiciaire pour se conduire, pour se faire informer de l'histoire du M'onde, ce touun in Mariant, si son honneur a bien toutes ses sûretés?
ORONTE.	ORONTE.
Ie ne ſçay pas ce que cela veut dire:	Je ne sais pas ce que cela veut dire:
mais vous eſtes-vous mis dans la teſte, qu’vn Homme de ſoixante & trois ans ait ſi peu de cervelle, & conſidere ſi peu ſa Fille, que de la marier auec vn Homme qui a ce que vous ſçauez, & qui a eſté mis chez vn MMedcein pour eſtre panſe:	mais vous êtes-vous mis dans la tête, qu'un Homme de soixante et trois ans ait si peu de cervelle, et considère si peu sa Fille, que de la marier avec un Homme qui a ce que vous savez, et qui a été mis chez un MÈdcein pour être panse:
M.	M.
POVRCEAVGNAC.	POURCEAUGNAC.
C’eſt vne piece que l’on m’a faite, & ie n’ay aucun mal.	C'est une pièce que l'on m'a faite, et Madame n'ai aucun mal.
ORONTE.	ORONTE.
E Meucein me ra uit luymeſme.	E Meucein me ra uit Seigneur.
M.	M.
POVRCEAVGNAC.	POURCEAUGNAC.
Le Medecin en a menty;	Le Médecin en a menti;
ie ſuis Gentilhomme, & ie le veux voir l’épée à la main.	Ne suis Gentilhomme, et ainsi le veux voir l'épée à la main.
ORONTE.	ORONTE.
Ie ſçay ce que i’en dois croire, & vous ne m’abuſerez pas là-deſſus, non plus que ſur les debtes que vous auez aſſignées ſur le Mariage de ma Fille.	Je sais ce que j'en dois croire, et vous ne m'abuserez pas là-dessus, non plus que sur les débtes que vous avez assignées sur le Mariage de ma Fille.
M.	M.
POVRCEAVGNAC.	POURCEAUGNAC.
Quelles debtes?	Quelles débtes?
ORONTE.	ORONTE.
La feinte icy eſt inutile, & i’ay veu le Marchand Flaman, qui, auec les autres Creanciers, a obtenu depuis huit mois Sentence contre vous.	La feinte ici est inutile, et j'ai vu le Marchand Flaman, qui, avec les autres Créanciers, a obtenu depuis huit mois Sentence contre vous.
M.	M.
POVRCEAVGNAC.	POURCEAUGNAC.
Quel Marchand Flaman?	Quel Marchand Flaman?
quels Oreuncicis querle Sentence obtenuë contre moy?	quels Oreuncicis querle Sentence obtenue contre moi?
ORONTE.	ORONTE.
Vous ſçauez bien ce que ie veux dire.	Vous savez bien ce que ici veux dire.
SCENE VII.	SCÈNE VII.
LVCETTE, ORONTE, M.	LUCETTE, ORONTE, M.
POVRCEAVGNAC.	POURCEAUGNAC.
LVCETTE.	LUCETTE.
ritu es aſſy, & à la fy yeu IAte trobi aprés abé fait tant de paſſés.	ritu es assi, et à la fi y JAte trobi après abé fait tant de passés.
Podes-tu, ſcelerat, podes-tu ſouſteni ma biſto?	Podes-tu, scélérat, podes-tu souteni ma bisto?
M.	M.
POVRCEAVGNAC.	POURCEAUGNAC.
Qu’eſt-ce que veut cette Femme Ia ?	Qu'est-ce que veut cette Femme Ia ?
LVCETTE.	LUCETTE.
Que te boli, infame!	Que te boli, infâme!
tu fas ſemblan de nou me pas counoüyſſe, & nou rougiſſes pas, impudent que tu ſios, tu ne rougiſſes pas de me beyre?	tu sas semblan de nouv me pas counoüysse, et nou rougisses pas, impudent que tu sios, tu ne rougisses pas de me beire?
Nou ſaby pas, Mouſſur, ſaquos bous dont m’an dit que boüillo eſpouſa la Fillo;	Nou sabi pas, Moussur, saquos bous dont m'an dit que boüillo épousa la Fillo;
may yeu bous declari que yeu ſoun ſa Fenno, & que ya ſet ans, Mouſſur, qu’en paſſan à Pezenas el auguet l’adreſſe dambé ſas mignardiſos, commo ſap tapla fayre, de me gaigna lou cor, & m’oubligel pra quel moüyen à ly douna la ma per l’eſpouſa.	mais yeu bous déclari que yeu soun sa Fenno, et que ya set ans, Moussur, qu'en passan à Pezenas elle auguet l'adresse dambé sas mignardisos, commo sap tappla fais, de me gagna lou cor, et m'oubligel pra quel mouïen à li douna la ma per l'épousa.
ORONTE.	ORONTE.
Oh, oh.	Oh, oh.
M.	M.
POVRCEAVGNAC.	POURCEAUGNAC.
Que Diable eſt-ce-cy?	Que Diable est-ce-cy?
LVCETTE.	LUCETTE.
Lou trayté me quitel trés ans aprés, ſul preteſte de qualques affayrés que l’apelabon dins ſoun Païs, & deſpey noun ly reſçau put quaſo de noubelo;	Lou traité me quitel très ans après, sul près de qualques affairés que l'appelabon dins soun Pays, et dépei noun li resçau put quaso de noubelo;
may dins lou tens qui ſoungeabi lou mens, m’an dounat abiſt, que begnio dins aqueſto Bilo, per ſe remarida danbé vn autro joüena Fillo, que ſous Parens ly an proucurado, ſenſſe ſaupré res de ſou prumié mariatge.	mais dins lou tents qui soungeabi lou mens, m'an dounat abît, que begnio dins aquêto Bilo, per se remarida danbé un autro jouena Fillo, que sous Parents li an proucurado, sensse saupré rés de sou prumié mariatge.
Yeu ay tout quitat en diligenſſo, & me ſoüy rendu dodins aqueſte Loc lou pu leu qu’ay pouſcut, per m’oupouſa en âquel criminel mariatge, & confondre as ely de tout le mounde lou plus méchant des Hommes.	Yeu ai tout quitat en diligenso, et me soüy rendu dodins aquête Loc lou pu leu qu'ai pouscut, per m'oupousa en âquel criminel mariatge, et confondre as ali de tout le mounde lou plus louchant des Hommes.
M.	M.
POVRCEAVGNAC.	POURCEAUGNAC.
Voila vne étrange effrontée!	Voilà quelque étrange effrontée!
LVCETTE.	LUCETTE.
Impudent, n’as pas honte de m’injuria, alloc d’eſtre confus day reproches ſecrets que ta conſlleſiſo te deu fayre ?	Impudent, n'as pas honte de m'injuria, alloc d'être confus dai reproches secrets que ta consllesiso te de vaire ?
M.	M.
POVRCEAVGNAC.	POURCEAUGNAC.
Moy, ie ſuis voſtre Mary?	Moi, Seigneur suis votre Mari?
LVCETTE.	LUCETTE.
Infame, gauſos-tu dire lou contrari?	Infâme, gausos-tu dire lou contrari?
He tu ſabes be, per ma penno, que n’es que trop bertat;	He tu sabes be, per ma penno, que n'es que trop bertat;
& plagueſſo al Cel qu’aco nou fougeſſo pas, & que m’auqueſſos layſſado dins l’eſcat d’innouſſenço, & dins la tranquillitat oun moun amo bibio daban que tous charmes & tas trounpariés nou m’en bengueſſon malhurouſomen fayre fourty;	et plaguesso al Cel qu'aco nou fougesso pas, et que m'auquessos layssado dins l'écat d'innoussenço, et dins la tranquillitat oun moun amo bibio daban que tous charmes et tas trounpariés nouvs nou m' en faire fourty;
yeu nou ſerio pas reduito à fayré lou triſté perſſounatgé quyeu faue preſentomen;	yeu nouv serio pas réduito à fayré lou tristé perssounatgé quieu fave présentomen;
à beyre vn Marit cruel meſpreſa touto l’ardou que yeu ay per el, & me laiſſa ſenſſe cap de pietat abandounado à las mourtéles doulous que yeu reſſenty de ſas perfidos accus.	à beinre un Marit cruel mespresa touto l'ardou que yeu ai per el, et me laissa sensse cap de piétât abandounado à las mourtéles doulous que yeu ressenti de sas perfidos accus.
ORONTE.	ORONTE.
Ie ne ſçaurois m’empeſcher de pleurer.	Je ne saurais m'empêcher de pleurer.
Allez, vous eſtes vn méchant Homme.	Allez, vous êtes un méchant Homme.
MH.	MH.
TE RCEAVGNAC.	TE RCEUGNAC.
Ie ne connoy rien à tout cecy.	Je ne connais rien à tout ceci.
SCENE VIII.	SCÈNE VIII.
NERINE en Picarde, LVCETTE, ORONTE, M.	NERINE en Picarde, LUCETTTE, ORONTE, M.
POVRC.	POURC.
NERINE.	NERINE.
H ie n’en pis plus, ie ſis toute IYeſſoflée.	H ie n'en pis plus, Seigneur sis toute IYessoflée.
Ah finfaron, tu m’as bien fait courir, tu ne m’écaperas imie.	Ah finfaron, tu m'as bien fait courir, tu ne m'écaperas imie.
rurtree;	rurtree;
jaſtice;	jastice;
ie bouté empeſchement au Mariage.	ici bouté empêchement au Mariage.
Ches mon Mery, Monſieur, & ie veux faire pindre che bon pindar là.	Ches mon Mery, Monsieur, et Seigneur veux faire pindre che bon pindar là.
M.	M.
POVRCEAVGNAC.	POURCEAUGNAC.
Eheor.	Eheor.
ORONTE.	ORONTE.
Quel diable d’Homme eſt-ce-cy?	Quel diable d'Homme est-ce-cy?
LVCETTE.	LUCETTE.
Et que boulés-bous dire, ambe boſtre empachomen, & boſtro pencanle!	Et que boulés-bous dire, ambe botre empachomen, et bostro pencanle!
Que quer rremo es boſtre Marit?	Que quer rémo ès botre Marit?
NERINE.	NERINE.
Oüy, Medeme, & ie ſis ſa Femme.	Oui, Mème, et Seigneur sis sa Femme.
LVCETTE.	LUCETTE.
Aquo es faus, aquos yeu que ſoun ſa Fenno;	Aquo es faus, aquos yeu que soun sa Fenno;
& ſe deûeſtre pendut, aquo iera yeu que lou lala y penda.	et se deûestre pendut, aquo jera yeu que lou lala y penda.
NERINE.	NERINE.
Ie n’entains mie che baragoin là.	Je n'entains mie che baragoin là.
LVCETTE.	LUCETTE.
Y eu bous diſy que yeu ſoun ſa Fenno.	Y eu bous dis que yeu soun sa Fenno.
NERINE.	NERINE.
Sa Femme?	Sa Femme?
Oy.	Oi.
LVCETTE.	LUCETTE.
NERINE.	NERINE.
Ie vous dis que cheſt my, encor in coup, qui le ſis.	Je vous dis que chêt mi, encor in coup, qui le sis.
LVCETTE.	LUCETTE.
ne jou bous ſouſteni yeu, qu’aquos yeu.	ne jou bous souteni yeu, qu'aquos yeu.
NERINVE.	NERINE.
Il y a quetre ans qu’il m’a époſée.	Il y a quetre ans qu'il m'a éposée.
LVCETTE.	LUCETTE.
Et yeu ſet ans ya que m’a preſo per Fenno.	Et yeu set ans ya que m'a preso per Fenno.
XVBICINVL.	XVBICINUL.
I’ay des gairents de tout ce que ie dy.	J'ai des gairents de tout ce que de mi.
LVCETTE.	LUCETTE.
Iout mon Pais lo ſap.	Jout mon Pais lo sap.
NERINE.	NERINE.
No Ville en eſt témoin.	No Ville en est témoin.
LVCETTE.	LUCETTE.
Tout Pezenas a biſt noſtre mariatge.	Tout Pezenas a bît notre mariatge.
NERINE.	NERINE.
Tout Chin Quentin a aſſiſté à no Noce.	Tout Chin Quentin a assisté à nô Ce.
LVCETTE.	LUCETTE.
Nou ya res de tan beritable.	No ya rés de tan béritable.
NERINE.	NERINE.
Il gn’y a rien de plus chertain.	Il gn'y a rien de plus chertain.
LVCETTE.	LUCETTE.
Gauſos-tu dire ioù contrari, valiſquos?	Gaus-tu dire joiù contrari, valisquos?
NERINE.	NERINE.
Eſt-che que tu me démaintiras.	Est-che que tu me démaintiras.
mocilaile Momme?	mocilaile Momme?
M.	M.
POVRCEAVGNAC.	POURCEAUGNAC.
Il eſt auſſi vray l’vn que l’autre.	Il est aussi vrai l'Heure que l'autre.
LVCETTE.	LUCETTE.
Quaigninpudenſſo!	Quaigninpudensso!
Et couſſy, miſerable, nou te ſoubenes plus de la pauro Françon, & del paure Ieanet, que ſoun lous fruirs de noſtre mariatge?	Et coussy, misérable, nouve te soubenes plus de la pauro Françon, et dél aure Jeanet, que soun ous fruirs de notre mariatge?
NERINE.	NERINE.
Bayez vn peu l’inſolence.	Bayez un peu l'insolence.
Quoy tu ne te ſouuiens mie de chette pauure ainfain, no petite Madelaine, que tu m’as laichée pour gaige de tafoy?	Quoi tu ne te souviens mie de chette pauvre ainfainf, nô petite Madelaine, que tu m'as laichée pour gagnes de tafoi?
M.	M.
POVRCEAVGNAC.	POURCEAUGNAC.
Voila deux impudentes carognes!	Voilà deux impudentes carognes!
LVCETTE.	LUCETTE.
Beny Françon, beny Ieanet, beny touſtou, beny touſtoune, beny fayre beyre à vn Payre dénaturat, la duretat quel à per nautres.	Béni Françon, béni -Jeanet, béni tous, béni toustoune, beny fais beire à un Payre dénaturat, la duretat quel à per nautres.
NERINE.	NERINE.
verſez Madelalie, rrie ll aifaiil, venez-veſen ichy faire honte à vo Pere de l’inpudainche qu’il a.	versez Madélalie, ronie l' aifaill, venez-vênesen ichy faire honte à vo Père de l'inpudainche qu'il a.
IEA.	JEA.
FAN.	FAN.
MAG.	MAG.
Ah mon Papa, mon Papa, mon Papa.	Ah mon Papa, mon Papa, mon Papa.
M.	M.
POVRCEAVGNAC.	POURCEAUGNAC.
Diantre ſoit des petits Fils de Putains.	Diantre soit des petits Fils de Putains.
LVCETTE.	LUCETTE.
Couſſy, trayte, tu nou ſios pas dins la darniere confuſiu, de reſſaupre à tal tous Enfans, & de ferma l’aureillo à la tendreſſo paternello?	Coussi, traite, tu nou sios pas dins la darnière confusiv, de ressaupre à tal tous Enfants, et de ferma l'aureillo à la tendresso paternello?
Tu nou m’eſcaperas pas.	Tu nouv m'écaperas pas.
infame, yeu te boly ſeguy per tout, & te reproucha ton crime juſquos à tant que me ſio beniado, & que t’ayo fayt penia, couqui, te boly fayré penia.	infâme, yeu te boli segui per tout, et te reproucha ton crime jusquos à tant que me si béniado, et que t'ayo fais pénia, couqui, te boli fayré pénia.
NERINE Ne rougis-tu mie de dire ches mots là, & d’eſtre inſainſible aux caireſſes de chette pauure ainfain?	NERINE Ne rougis-tu mie de dire chez mots -là, et d'être insainsible aux cairesses de chette pauvre ainfain?
Tu ne te ſauueras mie de mes pates;	Tu ne te sauveras mie de mes pates;
& en dépit de tes dains, ie feray bien voir que ie ſis ta Femme, & ie te feray peindre.	et en dépit de tes dains, je ferai bien voir que je sis ta Femme, et toujours te ferai peindre.
Les Enfans tous enſemble.	Les Enfants tous ensemble.
Mon Papa, mon Papa, mon Papa.	Mon Papa, mon Papa, mon Papa.
M.	M.
POVRCEAVGNAC.	POURCEAUGNAC.
Au ſecours, au ſecours, où fuiray-je?	Au secours, au secours, où fuirai-je?
ie n’en puis pius.	Elle n'en puis pius.
ORONTE.	ORONTE.
Allez, vous ferez bien de le faire puilli, cehihente d eltre peneu.	Allez, vous ferez bien de le faire puilli, cehihente d' elletre péneu.
SCEND IA.	SCEND IA.
SBRIGANI.	SBRIGANI.
E conduis de l’œil toutes choIſes, & tout cecy ne va pas mal.	E conduis de l'œil toutes choIses, et tout ceci ne va pas mal.
Nous fatiguerons tant noſtre Prouincial, qu’il faudra, ma foy, qu’il déguerpiſſe.	Nous fatiguerons tant notre Provincial, qu'il faudra, ma foi, qu'il déguerpisse.
Il iiij	Il jijà
SCENE X.	SCÈNE X.
M.	M.
POVRCEAVGNAC, SBRIGANI.	POURCEAUGNAC, SBRIGANI.
M.	M.
POVRCEAVGNAC.	POURCEAUGNAC.
H ie ſuis aſſommé.	H Que suis assommé.
Quelle I Apeine!	Quelle I Peine!
quelle maudite Ville!	quelle maudite Ville!
Aſſaſſiné de tous coſtez!	Assassiné de tous côtés!
EEINI.	EEINI.
Qu’eſt-ce, Monſieur, eſt-il encor arriué quelque choſe?	Qu'est-ce, Monsieur, est-il encor arrivé quelque chose?
M.	M.
TOVRCLAVGNAC.	TOURCLAUGNAC.
Oüy.	Oui.
Il pleut en ce Païs des Femmes & des Lauemens.	Il pleut en ce Pays des Femmes et des Lavements.
SBRIGANI.	SBRIGANI.
Comment donc?	Comment donc?
M.	M.
POVRCEAVGNAC.	POURCEAUGNAC.
Deux Carognes de baragoüinneuſes me ſont venu accuſer de les auoir épouſé toutes deux, & me Hlelacent de la fuicec.	Deux Carognes de baragouineuses me sont venu accuser de les avoir épousé toutes deux, et me Hlacent de la fuicec.
SBRIGANI.	SBRIGANI.
Voila vne méchante affaire, & la Iuſtice en ce Païs-cy eſt rigourete en diable contre cette ſorte de crime.	Voilà écl méchante affaire, et la Justice en ce Pays-cy est rigourete en diable contre cette sorte de crime.
M.	M.
POVRCEAVGNAC.	POURCEAUGNAC.
Oüy:	Oui:
Mais quand il y auroit Information, Ajournement, Decret & Iugement obtenu par ſurpriſe, Defaut & Contumace, i’ay la voye de Conflit de Iuriſdiction, pour tempornen cerouir aux Moyens de nullité qui ſeront dans les Procedures.	Mais quand il y aurait Information, Ajournement, Décret et Jugement obtenu par surprise, Défaut et Contumace, j'ai la voie de Conflit de Juridiction, pour tempornen cerouir aux Moyens de nullité qui seront dans les Procedures.
1 SBRIGANI.	1 SBRIGANI.
Voila en parler dans tous les termes;	Voilà en parler dans tous les termes;
& l’on voit bien, Monſieur, que vous eſtes du meſtier.	et l'on voit bien, Monsieur, que vous êtes du métier.
M.	M.
POVRCEAVGNAC.	POURCEAUGNAC.
Moy, point du tout, ie ſuis Gentilhomme.	Moi, point du tout, je suis Gentilhomme.
SBRIGANI.	SBRIGANI.
Il faut bien pour parler ainſi, que vous ayez etudie la Fratique.	Il faut bien pour parler ainsi, que vous ayez étudie la Fratique.
M.	M.
POVRCEAVGNAC.	POURCEAUGNAC.
Point, ce n’eſt que le ſens commun qui me fait juger que ie ſeray toûjours receu à mes Faits juſtificatifs, & qu’on ne me ſçauroit condamner ſur vne ſimple accuſation, lans vn récollement & confron.	Point, ce n'est que le sens commun qui me fait juger que je serai toujours reçu à mes Faits justificatifs, et qu'on ne me saurait condamner sur une simple accusation, lans un récollement et confron.
ration auec mes Parties.	ration avec mes Parties.
SBRIGANI.	SBRIGANI.
En voila du plus fin encore.	En voilà du plus fin encore.
M de MemtOnieo Ces mots là me viennent ſans que ie les ſçache.	M de MémtOnieo Ces mots là me viennent sans que je les sache.
SBRIGANI.	SBRIGANI.
Il me ſemble que le ſens commun d’vn Gentilhomme peut bien aller à conceuoir ce qui eſt du droict & de l’ordre de la Iuſtice;	Il me semble que le sens commun d'être Gentilhomme peut bien aller à concevoir ce qui est du droit et de l'ordre de la Justice;
mais non pas à ſçauoir les vrays termes de la Chicane.	mais non pas à savoir les vrais termes de la Chicane.
M.	M.
POVRCEAVGNAC.	POURCEAUGNAC.
Ce ſont quelques mots que i’ay retenus en liſant les Romans.	Ce sont quelques mots que j'ai retenus en lisant les Romans.
SBRIGANI.	SBRIGANI.
Ie le veux, & vais vous conduire chez deux Hommes fort habiles;	Je le veux, et vais vous conduire chez deux Hommes fort habiles;
mais i’ay auparauant à vous auertir de n’eſtre point ſurpris de leur maniere de parler;	mais j'ai auparavant à vous avertir de n'être point surpris de leur manière de parler;
ils ont contracté du Barreau certaine habitude de Declamation, qui fait que l’on diroit qu’ils chantent, & vous prendrez pour Muſique tout ce qu’ils vous diront.	ils ont contracté du Barreau certaine habitude de Déclamation, qui fait que l'on dirait qu'ils chantent, et vous prendrez pour Musique tout ce qu'ils vous diront.
108 M.	108 M.
DE POVRCEAVGNAC, M.	DE POURCEAUGNAC, M.
POVRCEAVGNAC.	POURCEAUGNAC.
Qu’importe comme ils parlent.	Qu'importe comme ils parlent.
pourueu qu’ils me diſent ce que ie veta isauon.	pourvu qu'ils me disent ce que Dieu veta isavon.
SCENE XI.	SCÈNE XI.
SBRIGANI, M.	SBRIGANI, M.
POVRC.	POURC.
DEVX ADVOCATS Muſiciens dont l’vn parle fort lentement, & l’autre fort viſte, accompagnez de	DEUX ADVOCATS Musiciens dont l'un parle fort lentement, et l'autre fort vite, accompagnés de
2.	2.
PROCVR.	PROCUR.
& de 2.	et de 2.
SERG.	SERG.
Diluoque eruillane les puroſes.	Dilvoque ervillane les puroses.
A Poligamie eſt vn cas,  Eſt vn cas pendable.	À Poligamie est un cas, Est un cas pendable.
L’Auocat bredoüilleur.	L'Avocat bredouilleur.
Voſtre fait Eſt clair & net, Et tout de droit Sur cet endroit Conclut tout droit.	Votre fait Est clair et net, Et tout de droit Sur cet endroit Conclut tout droit.
Si vous conſultez nos Autheurs, Legiſlateurs & Gloſſateurs, Iuſtinian, Papinian, Vlpian & Tribonian, Fernand, Rebuffe, Iean Imole, Paul, Caſtie, Iulian, Barthole, Iaſon, Alciat & Cujas, Ce grand Homme ſi capable;	Si vous consultez nos Auteurs, Législateurs et Glossateurs, Justinian, Papinian, Vlépian et Tribonian, Fernand, Rebuffe, Jean Imole, Paul, Castie, Julian, Barthole, Jason, Alciat et Cujas, Ce grand Homme si capable;
La Polygamie eſt vn cas Eſt vn cas pendable.	La Polygamie est un cas Est un cas pendable.
Tous les Peuples policez, Et bien ſenſez;	Tous les Peuples policez, Et bien sensé;
Les François, Anglois, Hollandois, Danois, Suedois, Polonois, Portugais, Eſpagnols, Flamans, Italiens, Allemans, Sur ce fait tiennent loy ſemblable, Et l’affaire eſt ſans embarras;	Les Français, Anglais, Hollandais, Danois, Suedais, Polonais, Portugais, Espagnols, Flamants, Italiens, Allemands, Sur ce fait tiennent loi semblable, Et l'affaire est sans embarras;
La Polygamie eſt vn cas, Eſt vn cas pendable.	La Polygamie est un cas, Est un cas pendable.
Monſieur Pourceaugnac les bat.	Monsieur Pourceaugnac les bat.
Deux Procureurs & deux Sergens dancent vne Entrée, qui finit l’Acte.	Deux Procureurs et deux Sergents dancent une Entrée, qui finit l'Acte.
Fin du Second Acte.	Fin du Second Acte.
ACTE III.	ACTE III.
SCENE PREMIERE, ERASTE, SBRIGANI.	SCÈNE PREMIÈRE, ERASTE, SBRIGANI.
BN SBRIGANI.	BN SBRIGANI.
3VY, les choſes s’acheminent où nous voulons:	3UY, les choses s'acheminent où nous voulons:
Et comme ſes lumieres ſont fort petites, & ſon ſens le plus borné du monde, ie luy ay fait prendre vne frayeur ſi grande de la ſeuerité de la Iuſtice de ce Païs, & des apreſts qu’on faiſoit déja pour ſa mort, qu’il veut prendre la fuite;	Et comme ses lumières sont fort petites, et son sens le plus borné du monde, ie luitaît fait prendre une frayeur si grande de la sévérité de la Justice de ce Pays, et des apprêts qu'on faisait déjà pour sa mort, qu'il veut prendre la fuite;
& pour ſe dérober auec plus de facilité aux Gens que ie luy ay dit qu’on auoit mis pour l’arreſter aux Portes de da Ville, il s’eſt reſolu à ſe déguiſer, & le déguiſement qu’il a pris eſt l’habit d’vne Femme.	et pour se dérober avec plus de facilité aux Gens que ie lui promit d'on avait mis pour l'arrêter aux Portes de da Ville, il s'est résolu à se déguiser, et le déguisement qu'il a pris est l'habit d'une Femme.
ERASTE.	ERASTE.
Ie voudrois bien le voir en cet équipage.	Je voudrais bien le voir en cet équipage.
SBRIGANI.	SBRIGANI.
Songez de voſtre part à acheuer la Comedie;	Songez de votre part à achever la Comédie;
& tandis que ie joüeray mes Scenes auec luy, allez-vous-en.	et tandis que ici jouerai mes Scères avec Elle, allez-vous-en.
vous entendez bien?	vous entendez bien?
Oüy.	Oui.
ERASTE.	ERASTE.
SBRIGANI.	SBRIGANI.
Et lors que ie l’atray mis où ie veux.	Et lors que ie l'atrai mis où tu veux.
ERASTE.	ERASTE.
Fort bien.	Fort bien.
SBRIGANI.	SBRIGANI.
Et quand le Pere aura eſté auerty par moy.	Et quand le Père aura été averti par moi.
ERASTE.	ERASTE.
cela va le fleux du Moide.	cela va le fleux du Moide.
SBRIGANI.	SBRIGANI.
Voicy noſtre Demoiſelle, allez viſte, qu’il ne nous voye enſemDies	Voici notre Demoiselle, allez vite, qu'il ne nous voie ensemDies
SCENE II.	SCÈNE II.
M.	M.
POVRCEAVG.	POURCEAUG.
en Femme, SBRIGANI.	en Femme, SBRIGANI.
MI.	MI.
POVRCEAVGNAC.	POURCEAUGNAC.
Voila qui m’étonne, qu’en ce Païs-cy les formes de la Iuſtice ne ſoient point obſeruées.	Voilà qui m'étonne, qu'en ce Pays-cy les formes de la Justice ne soient point observées.
SBRIGANI.	SBRIGANI.
Oüy, ie vous l’ay déja dit, ils commencent icy par faire pendre vn Homme, & puis ils luy font ſon Procés.	Oui, Seigneur vous l'ai déjà dit, ils commencent ici par faire pendre un Homme, et puis ils nous font son Procès.
11 RCEAVGNAC.	11 RCEUGNAC.
Voila vne Iuſtice bien injuſte.	Voilà une Justice bien injuste.
SBRIGANI.	SBRIGANI.
Elle eſt ſeuere comme tous les Diables, particulierement ſur ces ſortes de crimes.	Elle est sévère comme tous les Diables, particulièrement sur ces sortes de crimes.
M.	M.
POVRCEAVGNAC.	POURCEAUGNAC.
Mais quand on eſt innocent?	Mais quand on est innocent?
SBRIGANI.	SBRIGANI.
N’importe, ils ne s’enqueſtent point de cela;	N'importe, ils ne s'enquêtent point de cela;
& puis ils ont en cette Ville vne haine effroyable pour les Gens de voſtre Pais, & ils ne ſont point plus rauis que de voir pendre vn Limoſin.	et puis ils ont en cette Ville une haine effroyable pour les Gens de votre Pais, et ils ne sont point plus ravis que de voir pendre un Limin.
M.	M.
POVRCEAVGNAC.	POURCEAUGNAC.
Qu’eſt-ce que les Limoſins leur ont fait?	Qu'est-ce que les Limosins leur ont fait?
SBRIGANI.	SBRIGANI.
Ce ſont des brutaux, ennemis de la gentilleſſe & du merite des autres Villes.	Ce sont des bruts, ennemis de la gentillesse et du mérite des autres Villes.
Pour moy ie vous auouë que ie ſuis pour vous dans vne peur épouuantable;	Pour moi ici vous avoue que ie suis pour vous dans une peur épouvantable;
& ie ne fi comorrois de liies vie, il vous veniez à eſtre pendu.	et personne ne fi comorrais de liiez vie, il vous veniez à être pendu.
M.	M.
POVRCEAVGNAC.	POURCEAUGNAC.
Ce n’eſt pas tant la peur de la mort qui me fait fuir, que de ce qu’il eſt fâcheux à vn GentilMoriniommoluns pondu, ce qu’vnc preuue comme celle-là feroit tort à nos Titres de Nobleſſe.	Ce n'est pas tant la peur de la mort qui me fait fuir, que de ce qu'il est fâcheux à un GentilMoriniommoluns pondu, ce qu'unc preuve comme celle-là ferait tort à nos Titres de Noblesse.
SBRIGANI.	SBRIGANI.
Vous auez raiſon, on vous conteſteroit apres cela le Titre d’Eſcuyer.	Vous avez raison, on vous contesterait après cela le Titre d'Écuyer.
Au reſte, étudiez-vous, quand ie vous meneray par la main, à bien marcher comme vne Femme, & prendre le langage & toutes les manieres d’vne Perſonne de qualité.	Au reste, étudiez-vous, quand je vous mènerai par la main, à bien marcher comme une Femme, et prendre le langage et toutes les manières d'une Personne de qualité.
M.	M.
POVRCEAVGNAC.	POURCEAUGNAC.
Laiſſez, moy faire, i’ay veu les Perſonnes du bel air;	Laissez, moi faire, j'ai vu les Personnes du bel air;
tout ce qu’il y a, c’eſt que i’ay vn peu de barbe.	tout ce qu'il y a, c'est que j'ai un peu de barbe.
SBRIGANI.	SBRIGANI.
Voſtre barbe n’eſt rien, & il y a des Femmes qui en ont autant que vous.	Votre barbe n'est rien, et il y a des Femmes qui en ont autant que vous.
Ca, voyons vn peu comme vous ferez.	Ça, voyons un peu comme vous ferez.
Bon.	Bon.
M.	M.
POVRCEAVGNAC.	POURCEAUGNAC.
Allons donc, mon Caroſſe;	Allons donc, mon Carosse;
où eſt-ce qu’eſt mon Caroſſe?	où est-ce qu'est mon Carosse?
Mon Dieu, qu’on eſt miſerable, d’auoir des Gens comme cela!	Mon Dieu, qu'on est misérable, d'avoir des Gens comme cela!
Eſt-ce qu’on me fera attendre toute la journée ſur le paué, & qu’on ne me fera point venir mon Caroſſe?	Est-ce qu'on me fera attendre toute la journée sur le pavé, et qu'on ne me fera point venir mon Carosse?
SBRIGANI.	SBRIGANI.
Fort bien.	Fort bien.
K ij	§ ij
M.	M.
POVRCEAVGNAC.	POURCEAUGNAC.
Hola ho, Cocher, petit Laquais.	Hola ho, Cocher, petit Laquais.
Ah petit fripon, que de coups de foüet ie vous feray donner tantoſt;	Ah petit fripon, que de coups de fouet je vous ferai donner tantôt;
Petit Laquais, petit Laquais;	Petit Laquais, petit Laquais;
où eſt-ce donc qu’eſt ce petit Laquais?	où est-ce donc qu'est ce petit Laquais?
ce petit Laquais ne ſe trouuera-t-il point?	ce petit Laquais ne se trouvera-t-il point?
ne me fera-t-on point venir ce petit Laquais?	ne me fera-t-on point venir ce petit Laquais?
eſt-ce que ie n’ay point vn petit Laquais dans le monde?	est-ce que ici n'ai point un petit Laquais dans le monde?
SBRIGANI.	SBRIGANI.
Voila qui va à merueille:	Voilà qui va à merveille:
mais ie remarque vne choſe, cette Coiffe eſt vn peu trop deliée, i’en vais quein vne vn peu pius epaiſſe, pour vous mieux cacher le viſage, en cas de quelque rencontre.	mais quelque remarque une chose, cette Coiffe est un peu trop déliée, j'en vais quein q peu pius épaisse, pour vous mieux cacher le visage, en cas de quelque rencontre.
M.	M.
POVRCEAVGNAC.	POURCEAUGNAC.
Que deuiendray-je cependant?	Que deviendrai-je cependant?
EERCANI.	EERCANI.
Attendez-moy là, ie ſuis à vous dans vn moment;	Attendez-moi là, je suis à vous dans un moment;
vous n’auez qu’à vous promener.	vous n'avez qu'à vous promener.
SCENE III.	SCÈNE III.
MMOVILES.	MOUILES.
M.	M.
TOVNCEAVGNAC.	TOUNCEAUGNAC.
I.	I.
SVISSE.	SVISSE.
Llons, dépeſchons, CameI Arade, ly faut allair tout deux nous à la Creve pour regarter vn peu chouſticier ſti Monſiu de rourtegnac qui l’a eſté contané par Ortonnance à l’eſtre pendu par ſon cou.	Llons, dépêchons, CameI Arade, li faut allair tout deux nous à la Crève pour regarter un peu choûticier sti Monsieur de rourtegnac qui l'a été contané par Ortonnance à l'être pendu par son cou.
2.	2.
SVTS3E.	SUTS3E.
Ly faut nous loër vn feneſtre pour foir ſti Chouſtice.	Ly faut nous loer un fenêtre pour soir s Choustice.
I.	I.
SVISSE.	SVISSE.
Ly diſent que l’on fait téja planter vn grand potence tout neuve pour ly acrocher ſti Porcegnac.	Ly disent que l'on fait téjà planter un grand potence tout neuve pour li acrocher sti Porcegnac.
2.	2.
SVISSE.	SVISSE.
Ly ſira, ma foy, vn grand plaiſir, dy legarter pendie Iu Emolin.	Ly sira, ma foi, un grand plaisir, dis légarter pendie Ju Emolin.
I.	I.
SVISSE.	SVISSE.
Oüy, de ly foir gambiller les pieds en haut teuant tout le monde.	Oui, de li soir gambiller les pieds en haut teuant tout le monde.
2.	2.
SVISSE.	SVISSE.
Ly eſt vn plaiſant drole, oüy;	Li est un plaisant drôle, oui;
Iy dilent que c’eſtre marie troy foye.	Ji dilent que c'être marie troy ie.
I.	I.
SVISSE.	SVISSE.
Sui diabie ry vouloir troy Femmes à ly tout ſeul;	Sui diabie ri vouloir trois Femmes à li tout seul;
ly eſt bien aſſez e tilie.	li est bien assez e ilie.
2.	2.
SVISSE.	SVISSE.
An pon chour, Mamelelle.	An pon chour, Mamèlelle.
I.	I.
SVISSE.	SVISSE.
Que faire fous là tout ſeul?	Que faire fous là tout seul?
M.	M.
POVRCEAVGNAC.	POURCEAUGNAC.
I’attens mes Gens, Meſſieurs.	J'attends mes Gens, Messieurs.
2.	2.
SVISSE.	SVISSE.
Ly eſt belle, par mon foy.	Li est belle, par mon foi.
1.	1.
SVISSE.	SVISSE.
Fous, Mameſelle, fouloir finir réchoüir fous à la Creve?	Fous, Mameselle, fouloir finir réchoüir fous à la Creve?
nous faire foir à fous vn petit pendement pien choly.	nous faire soir à fous un petit pendement pien choli.
M POMVONVIC.	M MOMVONVIC.
Ie vous rens grace.	Je vous rends grâce.
2.	2.
SVISSE.	SVISSE.
L’eſt vn Gentilhoume Limoſſin qui ſera pendu chantiment à vn grand potence.	L'est un Gentilhoume Limossin qui sera pendu chantiment à un grand potence.
M.	M.
POVRCEAVGNAC.	POURCEAUGNAC.
Ie n’ay pas de curioſité.	Je n'ai pas de curiosité.
L.	L.
SVI3JE.	SVI3JE.
Ly eſt là vn petit teton qui l’eſt drole.	Lis est là un petit téton qui l'est drôle.
M.	M.
POVRCEAVGNAC.	POURCEAUGNAC.
Tout-beau.	Toutbeau.
I.	I.
SVISSE.	SVISSE.
Mon foy, moy couchair pien auec fous.	Mon foi, moi couchair pien avec fous.
M.	M.
POVRCEAVGNAC.	POURCEAUGNAC.
Ah ç’en eſt trop, & ces ſortes d’ordures-là ne ſe diſent point à vne Femme de ma condition.	Ah ç'en est trop, et ces sortes d'ordures-là ne se disent point à une Femme de ma condition.
2.	2.
SVISSE.	SVISSE.
Laiſſe-toy, l’eſt moy ſurle veut couchair auec elle.	Laisse-toi, l'est moi surle veut couchair avec elle.
NOVISSE.	NOUISE.
Moy ne vouloir pas laiſſer.	Moi ne vouloir pas laisser.
2.	2.
SVISSE.	SVISSE.
Moy ly vouloir, moy.	Moi li vouloir, moi.
SVISSE.	SVISSE.
Moy ne faire rien.	Moi ne faire rien.
2.	2.
SVISSE.	SVISSE.
Toy l’auoir menty.	Toi l'avoir menti.
I.	I.
SVISSE.	SVISSE.
Toy l’auoir menty toy-meſme.	Toi l'avoir menti toi-même.
SCENE IV.	SCÈNE IV.
VN EXEMPT, 2.	UN EXEMPT, 2.
ARCHERS, I.	ARCHERS, I.
&2.	et2.
SVISSES, M.	SVISSES, M.
POVRC.	POURC.
L’EXEMPT.	L'EXEMPT.
V’eſt-ce?	V'est-ce?
quelle violence L'eſt-ce-là?	quelle violence L'est-ce-là?
& que voulezvous faire à Madame?	et que voulezvous faire à Madame?
Allons, que l’on ſorte de la, ſi vous ne voulez que ie vous mette en priſon.	Allons, que l'on sorte de la, si vous ne voulez que je vous mette en prison.
I.	I.
SVISSE.	SVISSE.
Party pon, toy ne l’auoir point.	Parti pon, toi ne l'avoir point.
OVIGSL.	OUIGSL.
Party pon auſſi, toy ne l’auoir point encorc.	Parti pon aussi, toi ne l'avoir point encor.
M.	M.
POVRCEAVGNAC.	POURCEAUGNAC.
Ie vous ſuis bien obligée, Monſieur, de m’auoir deliurée de ces inſolens.	Je vous suis bien obligée, Monsieur, de m'avoir délivrée de ces insolents.
L’EXEMPT.	L'EXEMPT.
Oüay, voila vn viſagequi reſſẽble bien à celuy que l’on m’a dépeint.	Oui, voilà un visagequi ressẽble bien à celui que l'on m'a dépeint.
M.	M.
POVRCEAVGNAC.	POURCEAUGNAC.
Ce neit pas ilioy, Ie vous dſſure.	Ce neit pas iliais, Je vous disssure.
L’EXEMPT.	L'EXEMPT.
Ah, ah, qu’eſt-ce que ie veux dire?	Ah, ah, qu'est-ce que tu veux dire?
M.	M.
POVRCEAVGNAC.	POURCEAUGNAC.
Ie ne ſçay pas.	Je ne sais pas.
L’EXEMPT.	L'EXEMPT.
Pourquoy donc dites-vous cela?	Pourquoi donc dites-vous cela?
M.	M.
TOVRCEAYGNAC.	TOURCEAYGNAC.
Pour rien.	Pour rien.
L’EXEMPT.	L'EXEMPT.
eila vn diſcours qui marque quelque choſe, & ie vous arreſte pihonmier.	eila un discours qui marque quelque chose, et votre vous arrête pihonmier.
M.	M.
POVRCEAVGNAC.	POURCEAUGNAC.
Eh, Monſieur, de grace.	Eh, Monsieur, de grâce.
L’EXEMPT.	L'EXEMPT.
Non, non, à voſtre mine, & à vos diſcours, il faut que vous ſoyez ce Monſieur de Pourceaugnac que nous cherchons, qui ſe ſoit déguiſé de la ſorte;	Non, non, à votre mine, et à vos discours, il faut que vous soyez ce Monsieur de Pourceaugnac que nous cherchons, qui se soit déguisé de la sorte;
& vous viendrez en priſon tout-à-l’heure.	et vous viendrez en prison tout-àute heure.
COMEDIEM.	COMEDIEM.
POVRCEAVGNAC.	POURCEAUGNAC.
Helas!	Hélas!
SBRIGANI.	SBRIGANI.
H Cieli que veut dire cela?	H Cieli que veut dire cela?
LIM.	LIM.
POVRCEAVGNAC.	POURCEAUGNAC.
Ils m’ont reconnu.	Ils m'ont reconnu.
SCENE V.	SCÈNE V.
L’EXEMPT, ARCHERS, SBRIGANI, M.	L'EXEMPT, ARCHERS, SBRIGANI, M.
POVRC.	POURC.
L LALERAILe Oüy, oüy, c’eſt dequoy ie ſuis rauy.	 LALÈRAILe Oui, oui, c'est dequoy son suis ravi.
SBRIGANI.	SBRIGANI.
Eh, Monſieur, pour l’amour de moy;	Eh, Monsieur, pour l'amour de moi;
vous ſçauez que nous ſommes Amis il y a long-temps;	Vous savez que nous sommes Amis il y a longtemps;
ie vous conjure de ne le point mener en priſon.	Hé vous conjure de ne le point mener en prison.
L’EXEMPT.	L'EXEMPT.
Non, il m’eſt impoſſible.	Non, il m'est impossible.
L ij	 Léj
SBRIGANI.	SBRIGANI.
Vous eſtes Homme d’accommodement;	Vous êtes Homme d'accommodement;
n’y a-t-il pas moyen d’ajuſter cela auec quelques Piſtolès?	n'y a-t-il pas moyen d'ajuster cela avec quelques Pistolès?
L ElIEMPT à ſes Archers.	 ElIEMPT à ses Archers.
Retirez-vous vn peu.	Retirez-vous un peu.
SBRIGANI.	SBRIGANI.
Il faut luy domner de largent pour vous laiſſer aller;	Il faut nos domner de largent pour vous laisser aller;
Faites viſte.	Faites vite.
M.	M.
POVRCEAVGNAC, Ah maudite Ville!	POURCEAUGNAC, Ah maudite Ville!
SBRIGANI.	SBRIGANI.
Tencu, ionliear.	Tensu, ionliearie.
L’EXEMPT.	L'EXEMPT.
Combien y a-t-il?	Combien y a-t-il?
SBRIGANT.	SBRIGANT.
Vn, deux, trois, quatre, cinq, ſix, ſept, huit, neuf, dix.	Un, deux, trois, quatre, cinq, six, sept, huit, neuf, dix.
L’EXEMPT.	L'EXEMPT.
Non, mon ordre eſt trop exprés,	Non, mon ordre est trop exprès,
SBRIGANI.	SBRIGANI.
Mon Dieu attendez.	Mon Dieu attendez.
Dépeſchez, donnez-luy-en encore autant.	Dépêchez, donnez-lui-en encore autant.
M.	M.
POVRCEAVGNAC.	POURCEAUGNAC.
Mais.	Mais.
SBRIGANI.	SBRIGANI.
Dépeſchez-vous, vous dis-je, & ne perdez point de temps:	Dépêchez-vous, vous dis-je, et ne perdez point de temps:
Vous auriez vn grand plaiſir, quand vous ſeriez pendu.	Vous auriez un grand plaisir, quand vous seriez pendu.
M.	M.
POVRCEAVGNAC.	POURCEAUGNAC.
AhT SBRTGANT.	AhT SBRTGANT.
Tenez, Monſieur.	Tenez, Monsieur.
L’EXEMPT.	L'EXEMPT.
Il faut donc que ie m’enfuye uucoruy;	Il faut donc que je m'enfuie ucorui;
car il n’y auroit point icy de ſeureté pour moy.	car il n'y aurait point ici de sûreté pour moi.
Laiſſez-le moy conduire, & ne bougez d’icy.	Laissez-le moi conduire, et ne bougez d'ici.
SDRIGANI.	SDRIGANI.
Ie vous prie donc d’en auoir vn grand ſoin.	Je vous prie donc d'en avoir un grand soin.
L’EXEMPT.	L'EXEMPT.
Ie vous promets de ne le point quitter, que ie ne l’aye mis en lieu de ſeureté.	Je vous promets de ne le point quitter, que je ne l'aie mis en lieu de sûreté.
M.	M.
POVRCEAVGNAC.	POURCEAUGNAC.
Adieu.	Adieu.
Voila le ſeul honneſte E iij Homme que i’ay trouué en cette vHe.	Voilà le seul honnête E jà Homme que j'ai trouvé en cette vHe.
SBRIGANI.	SBRIGANI.
Ne perdez point de temps;	Ne perdez point de temps;
ie vous aime tant, que ie voudrois que vous fuſſiez déja bien loin.	Il vous aime tant, que ici voudrais que vous fussiez déjà bien loin.
Que le Ciel te conduiſe!	Que le Ciel te conduise!
Par ma foy, voila vne grande dupe.	Par ma foi, voilà une grande dupe.
Mais voicy.	Mais voici.
SCENEVI ORONTE, SBRIGANI.	SCENEUI ORONTE, SBRIGANI.
SBRIGANI.	SBRIGANI.
H quelle étrange auanture!	H quelle étrange aventure!
A Aquellefâcheuſe nouuelle pour vn Pere!	A Aquellefâcheuse nouvelle pour un Père!
Pauure Oronte, que ie te plains!	Pauvre Oronte, que sans te plains!
Que diras-tu?	Que diras-tu?
& de quelle façon pourras-tu ſuporter cette douleur mortelle?	et de quelle façon pourras-tu suporter cette douleur mortelle?
ORONTE.	ORONTE.
Qu’eſt-ce?	Qu'est-ce?
quel malheur me preſages-tu?	quel malheur me présages-tu?
SBRIGANI.	SBRIGANI.
Ah, Monſieur, ce perfide de Limoſin, ce traiſtre de Monſieur de Pourceaugnac, vous enleue voſtre Fille.	Ah, Monsieur, ce perfide de Limosin, ce traître de Monsieur de Pourceaugnac, vous enlève votre Fille.
ORONTE.	ORONTE.
Il m’enleue ma Fille !	Il m'enlève ma Fille !
SBRIGANI.	SBRIGANI.
Oüy;	Oui;
elle en eſt deuenuë ſi fole, qu’ellevousquitte pour le ſuiure;	elle en est devenue si sole, qu'ellevousquitte pour le suivre;
& l’on dit qu’il a vn Caractere pour ſe faire aimer de toutes les Femmes.	et l'on dit qu'il a un Caractère pour se faire aimer de toutes les Femmes.
ORONTE.	ORONTE.
Allons viſte à la Iuſtice.	Allons vite à la Justice.
Des Allehels aples edar.	Des Allehels aples édar.
SCENE VII.	SCÈNE VII.
ERASTE, IVLIE, SB.	ERASTE, IVLIE, SB.
ORON.	ORON.
ERASTE.	ERASTE.
Llons, vous viendrez malgre L Avous, & ie veux vous remettre entre les mains de voſtre Pere.	Llons, vous viendrez malgré L Vous, et votre veux vous remettre entre les mains de votre Père.
L.	L.
iiij Tenez, Monſieur, voila voſtre Fille que i’ay tirée de force d’entre les mains de l’Homme audc qui elle s’enfuyoit;	jij Our, Monsieur, voilà votre Fille que j'ai tirée de force d'entre les mains de l'Homme audame qui elle s'enfuyait;
non pas pour l’amour d’elle, mais pour voſtre ſeule conſideration:	non pas pour l'amour d'elle, mais pour votre seule considération:
car apres l’action qu’elle a faite, ie dois la mépriſer, ce me gueri ubrortiment de l’amour que i’auois pour elle.	car après l'action qu'elle a faite, Elle dois la mépriser, ce me guéri brortiment de l'amour que j'avais pour elle.
ONONIE.	ONONIE.
Ah infame que tu es!	Ah infâme que tu es!
ERASTE.	ERASTE.
Comment?	Comment?
me traiter de la ſorte apres toutes les marques d’amitié que ie vous ay données!	me traiter de la sorte après toutes les marques d'amitié que je vous ai données!
Ie ne vous blâme point de vous eſtre ſoûmiſe aux volontez de Monſieur voſtre Pere;	Je ne vous blâme point de vous être soumise aux volontés de Monsieur votre Père;
il eſt ſage & judicieux dans les choſes qu’il fait, & ie ne me plains point de luy de m’auoir rejetté pour vn autre.	il est sage et judicieux dans les choses qu'il fait, et tu ne me plains point de même de m’avoir rejetté pour un autre.
S’il a manqué à la parole qu’il m’auoit donnée, il a ſes raiſons pour cela.	S'il a manqué à la parole qu'il m'avait donnée, il a ses raisons pour cela.
On luy a fait croire que cet autre eſt plus riche que moy de quatre ou cinq mille écus;	On a a fait croire que cet autre est plus riche que moi de quatre ou cinq mille écus;
& quatre ou cinq mille écus eſt vn denier conſiderable, & qui vaut bien la peine qu’vn Homme manque à ſa parole:	et quatre ou cinq mille écus est un denier considérable, et qui vaut bien la peine qu'un Homme manque à sa parole:
Mais oublier en vn moment toute l’ardeur que ie vous ay montrée, vous laiſſer d’abord enflâmer d’amour pour vn nouueau venu, & le ſuiure honteuſement ſans le conſentement de Monſieur voſtre Pere, apres les crimes qu’on luy impute, c’eſt vne choſe condamnée de tout le monde, & dont mon cœur ne peut vous faire d’aſſez ſanglans reproches.	Mais oublier en un moment toute l'ardeur que je vous ai montrée, vous laisser d'abord enflâmer d'amour pour un nouveau venu, et le suivre honteusement sans le consentement de Monsieur votre Père, après les crimes qu'on était impute, c'est une chose condamnée de tout le monde, et dont mon cœur ne peut vous faire d'assez sanglants reproches.
IVLIE.	IVLIE.
Hé bien oüy, i’ay conçeu de l’amour pour luy, & ie l’ay voulu ſuiure, puis que mon Pere me l’auoit choiſy pour Epous.	Hé bien oui, j'ai conçu de l'amour pour lui, et tu l'ai voulu suivre, puis que mon Père me l'avait choisi pour Épous.
Quoy que rous me diſiez, c’eſt vn fort honneſte Homme, & tous les crimes dont on l’accuſe, ſont fauſſetez épouuantables.	Quoi que rous me disiez, c'est un fort honnête Homme, et tous les crimes dont on l'accuse, sont fausseté épouvantables.
ORONTE.	ORONTE.
Taiſez-vous;	Taisez-vous;
vous eſtes vne ima pertinente, & ie ſçay mieux que vous ce qui en eit.	vous êtes ima pertinente, et Seigneur sais mieux que vous ce qui en eit.
IVLIE.	IVLIE.
Ce ſont ſans doute des pieces qu’on luy fait, & c’eſt peut-eſtre larj quiu erduuu cet artince pour vous en dégoûter.	Ce sont sans doute des pièces qu'on était fait, et c'est peut-être larj quiu erdu cet artince pour vous en dégoûter.
ERASTE.	ERASTE.
Moy, ie ſerois capable de cela!	Moi, Seigneur serais capable de cela!
IVLIE.	IVLIE.
Oüy, vous.	Oui, vous.
a lad ſls Taiſez-vous, vous dis-je?	à lad sels Taisez-vous, vous dis-je?
vous eſtes vne ſotte.	vous êtes un sotte.
ERASTE.	ERASTE.
Non, non, ne vous imaginez pas que i’aye aucune enuie de détour.	Non, non, ne vous imaginez pas que j'aie aucune envie de détour.
ner ce Mariage, & que ce ſoit ma paſſion qui m’ait forcé à courir apres vous.	ner ce Mariage, et que ce soit ma passion qui m'ait forcé à courir après vous.
Ie vous l’ay déja dit, ce n’eſt que la ſeule conſideration que i’ay pour Monſieur voſtre Pere, & ie n’ay pû ſouffrir qu’vn honneſte Homme comme luy fut expoſé à la honte de tous les bruits qui pourroient ſuiure vne action coiiime la voltie.	Je vous l'ai déjà dit, ce n'est que la seule considération que j'ai pour Monsieur votre Père, et apprendre n'ai pu souffrir qu'un honnête Homme comme lui fut exposé à la honte de tous les bruits qui pourraient suivre une action coiime la voltie.
ORONTE.	ORONTE.
Ie vous fuis, Seigneur Lraſte, infiniment obligé.	Je vous fuis, Seigneur Lraste, infiniment obligé.
ERASTE.	ERASTE.
Adieu, Monſieur, i’auois toutes les ardeurs du monde d’entrer dans voſtre Alliance;	Adieu, Monsieur, j'avais toutes les ardeurs du monde d'entrer dans votre Alliance;
i’ay fait tout ce que i’ay pû pour obtenir vn tel honneur, mais i’ay eſté malheureux, & vous ne m’auez pas jugé digne de cette grace.	j'ai fait tout ce que j'ai pu pour obtenir un tel honneur, mais j'ai été malheureux, et vous ne m'avez pas jugé digne de cette grâce.
Cela n’empeſchera pas que ie ne conſerue pour vous les ſentimens d’eſtime & de veneration où voſtre Perſonne m’oblige;	Cela n'empêchera pas que je ne conserve pour vous les sentiments d'estime et de vénération où votre Personne m'oblige;
& ſi ie n’ay pû eſtre voſtre Gendre, au moins ſeray-je eternellement voſtre Seruiteur.	et si ici n'ai pu être votre Gendre, au moins serai-je éternellement votre Serviteur.
ORONTE.	ORONTE.
Arreſtez, Seigneur Eraſte, voſtre procedé me touche l’ame, & ie vous donne ma Fiſle en mariage.	Arrêtez, Seigneur Eraste, votre procédé me touche l'âme, et un vous donne ma Fîle en mariage.
IVLIE.	IVLIE.
Ie ne veux point d’autre Mary que Monſieur de Pourceaugnac.	Je ne veux point d'autre Mari que Monsieur de Pourceaugnac.
ORONTE.	ORONTE.
Et ie veux moy, tout-à-l’heure, que tu prenes le Seigneur Eraſte.	Et grande veux -moi, tout-à-l’heure, que tu prenez le Seigneur Eraste.
Cà, la main.	Çà, la main.
IVLIE.	IVLIE.
*vonj le n’en feray nen.	*vonj le n'en ferai nen.
ORONTE.	ORONTE.
Ie te donneray ſur les oreilles.	Je te donnerai sur les oreilles.
ERASIE.	ERASIE.
Non, non, Monſieur, ne luy faites point de violence, ie vous en prie.	Non, non, Monsieur, ne lui faites point de violence, Elle vous en prie.
ORONTE.	ORONTE.
C’eſt à elle à m’obeïr, & ie ſçay	C'est à elle à m'obéir, et notre sais
ERASTE.	ERASTE.
Ne voyez-vous pas l’amour qu’elle a pour cet Homme-là?	Ne voyez-vous pas l'amour qu'elle a pour cet Homme-là?
& voulez-vous que ie poſſede vn Corps, dont vn autre poſſedera le cœur:	et voulez-vous que ici possède un Corps, dont un autre possédera le cœur:
ORONTE.	ORONTE.
C’eſt vn ſortilege qu’il luy a donné, & vous verrez qu’elle changera de ſentiment auant qu’il ſoit peu.	C'est un sortilège qu'il a a donné, et vous verrez qu'elle changera de sentiment avant qu'il soit peu.
Domez- moy voſtre main.	Domez- moi votre main.
Allons.	Allons.
IVLIE.	IVLIE.
Ie ne.	Je ne.
ORONTE.	ORONTE.
Ah que de bruit.	Ah que de bruit.
Cà, voſtre main, vous dis-je.	Çà, votre main, vous dis-je.
Ah, ah, ah.	Ah, ah, ah.
ERASTE.	ERASTE.
Ne croyez pas que ce ſoit pour l’amour de vous que ie vous donne la main;	Ne croyez pas que ce soit pour l'amour de vous que je vous donne la main;
ce n’eſt que Monſieur voſtre Pere dont ie ſuis amoureux, & c’eſt luy que i’épouſe.	ce n'est que Monsieur votre Père dont je suis amoureux, et c'est lui que j'épouse.
DICEIIE.	DICEIIE.
Ie vous ſuis beaucoup obligé, & i’augmente de dix mille écus le Mariage de ma Fille.	Je vous suis beaucoup obligé, et j'augmente de dix mille écus le Mariage de ma Fille.
Allons, qu’on faſſe venir le Notaire pour dreſſer le Contrace.	Allons, qu'on fasse venir le Notaire pour dresser le Contrace.
ERASTE.	ERASTE.
En attendant qu’il vienne, nous pouuons joüir du diuertiſſement de la Saiſon, & faire entrer les Maſques que le bruit des Nopces de M.	En attendant qu'il vienne, nous pouvons jouir du divertissement de la Saison, et faire entrer les Masques que le bruit des Noces de M.
de Pourceaugnac a attiré icy de tous les endroits de la Ville.	de Pourceaugnac a attiré ici de tous les endroits de la Ville.
SCENE VIII.	SCÈNE VIII.
PLVSIEVRS MASQVES de toutes les manieres, dont les vns occupent pluſieurs Balcons, & les autres ſont dans la Place, qui par pluſieurs Chanſons & diuerſes Dances & Ieux, cherchent à ſe donner des plaiſirs innocens.	PLUSIEURS MASUQUES de toutes les manières, dont les uns occupent plusieurs Balcons, et les autres sont dans la Place, qui par plusieurs Chansons et diverses Dances et Jeux, cherchent à se donner des plaisirs innocents.
VNE EGYPTIENNE.	VNE ÉGYPTIENNE.
Olters jortez de ces lieux, OSoucis, chagrins & triſteſſe, Venez, venez ris & jeux, Plaiſirs, amour & tendreſſe, Ne ſongeons qu’à nous réjoüir, La grande aſfatre eſt te praiſir.	Olters jortez de ces lieux, ÔSoucis, chagrins et tristesse, Venez, venez ris et jeux, Plaisirs, amour et tendresse, Ne songeons qu'à nous réjouirons, La grande asfatre est te praisir.
Chœur des Muſiciens.	Chœur des Musiciens.
Ne ſo ngeons qu’à nous réjoüir, La grande affaire eſt le plaiſir.	Ne so geons qu'à nous réjouir, La grande affaire est le plaisir.
L’EGYPTIENNE.	L'ÉGYPTIENNE.
A me ſuiure tous icy, Voſtre ardeur eſt non commune, Et vous eſtes en ſoucy De voſtre bonne fortune:	À me suivre tous ici, Votre ardeur est non commune, Et vous êtes en souci De votre bonne fortune:
Soyez toujours amoureux, C’eſt le moyen d’eſtre heureux.	Soyez toujours amoureux, C'est le moyen d'être heureux.
EGYPTIEN.	ÉGYPTIEN.
Aimons juſques au trèpas, La raiſon nous y conuie:	Aimons jusques au trépas, La raison nous y convie:
Helais!	Hélais!
ſi l’on n’aimoit pas, Que ſeroit-ce de la vie?	si l'on n'aimait pas, Que serait-ce de la vie?
Ah!	Ah!
perdons plutoſt le jour, Que de perdre noſtre amour.	perdons plutôt le jour, Que de perdre notre amour.
L’EGYPTIENNE.	L'ÉGYPTIENNE.
La Gloire.	La Gloire.
L’EGYPTIEN.	L'ÉGYPTIEN.
Ces Grandears,	Ces Grandears,
L’EGYPTIENNE.	L'ÉGYPTIENNE.
Les Sceptres qui font tant d’enuie.	Les Sceptres qui font tant d'envie.
L’EGYPTIEN.	L'ÉGYPTIEN.
un'eſt rien, ſi l’amour n’y meſle ſes ardeurs.	un'est rien, si l'amour n'y mêle ses ardeurs.
L’EGYPTIENNE.	L'ÉGYPTIENNE.
An'eſt point, ſans t'amour, ue plaiſir dans la vie.	An'est point, sans t'amour, ue plaisir dans la vie.
Tous deux enſemble.	Tous deux ensemble.
Soyons toújours amoureux, C’eſt le moyen d’eſtre heureux.	Soyons toujours amoureux, C'est le moyen d'être heureux.
Le petit Chœur chante apres ces	Le petit Chœur chante après ces
deun dernlers vero.	deun derners vero.
Sus, ſus, chantons tous enſemble, Danſons, ſautons, joüons-nous.	Sus, sus, chantons tous ensemble, Dansons, sautons, jouons-nous.
Vn Muſicien ſeul.	Un Musicien seul.
Lors que pour rire on s’aſſemble, Les plus ſages, ce me ſemble;	Lors que pour rire on s'assemble, Les plus sages, ce me semble;
Sont ceux qui ſont les plus fous.	Sont ceux qui sont les plus fous.
Tous enſemble.	Tous ensemble.
Ne ſongeons qu’à nous féjoüir, La grande affaire eſt le phaiſtr.	Ne songeons qu'à nous féjoüir, La grande affaire est le phaîtr.
ance	ance
