AILITI Maot.	ÀILITI Maot.
I le ſuccés d’un Ouvrage doit le defendre contre la critique, &t ſi la premiere, & la plus infaillible regle du Theatie eſt celle de plaire, j’oſe dire que Scipion l’Africain ayant eu ce bonheur, je pourois me diſpenſer de répondre aux critiques qu’on en a faites.	I le succès d'un Ouvrage doit le défendre contre la critique, ett si la première, et la plus infaillible règle du Théatie est celle de plaire, j'ose dire que Scipion l'Africain ayant eu ce bonheur, je croyais me dispenser de répondre aux critiques qu'on en a faites.
Cependant ſans me prévaloir, des aplaudiſſemens que le pablie luy a donnez, je vais tâcher en peu de mots d’en juſtifier la conduite.	Cependant sans me prévaloir, des applaudissements que le pablie vertu a donnés, je vais tâcher en peu de mots d'en justifier la conduite.
On me reproche d’avoir fait Scipion amoureux;	On me reproche d'avoir fait Scipion amoureux;
mais je ſoûtiens que le mettant ſur la Scene, j'ay dû luy donner ce caractere, qui releve ſon action principale, qui eſt de vainere ſa paſſion, &t de rendre ſa Maîtreſſe a, ſon Rival.	mais je soutiens que le mettant sur la Scène, j'ai dû lui donner ce caractère, qui relève son action principale, qui est de vaine sa passion, ett de rendre sa Maîtresse a, son Rival.
Ariſtote nous aprend qu’on peut ajouter quelque choſé de vray-ſemblable au vray;	Aristote nous apprend qu'on peut ajouter quelque chosé de vrai-semblable au vrai;
& il eſt vray-ſemblable que Scipion a l’age de vingt-quatre ans, ayant pris la plus belle perſonne de l’Univers, ait éſté ſenſible à ſa beauté,  qu’il ait rendu quelques combats?	et il est vrai-semblable que Scipion a l'age de vingt-quatre ans, ayant pris la plus belle personne de l'Univers, ait ésté sensible à sa beauté, qu'il ait rendu quelques combats?
avant que de la rendre à Lucejus Peince des Celtiberiens, à qui elle eſtoit promiſe.	avant que de la rendre à Lucejus Peince des Celtibériens, à qui elle était promise.
D’ailleurs ſi Scipion avoit remis ſa captive ſans la voir, ſon action n’auroit pas été ſi belle, que ce vue prlurcupvoouveunauo, C apuuron que uibement touché;	D'ailleurs si Scipion avait remis sa captive sans la voir, son action n'aurait pas été si belle, que ce vue prlurcupvoouveunauo, Ç apuvron que uibement touché;
car comme dit le grand Corneille, Ce n’eſt qu'en ces aſſauts qu’éclate la vertu, Et l’on doute d’un cœur qui n’a point combatu:	car comme dit le grand Corneille, Ce n'est qu'en ces assauts qu'éclate la vertu, Et l'on doute d'un cœur qui n'a point combattu:
Il me ſemble même que Scipion auroit bien douté de ſa vertu, & du pouvoir qu’il avoit ſur luy de n’oſer voir une tres-belle perſonne, depeur d’en être tenté.	Il me semble même que Scipion aurait bien douté de sa vertu, et du pouvoir qu'il avait sur deux de n'oser voir une très-belle personne, dépeur d'en être tenté.
Comme l’Hiſtoire ne nomme point cette belle captive, je la fais Niéce d’Annibal, pour donner un plus grand contraſte à l’amour de Scipion qu’il combat, et dont enfin il triomphe, & je puis dire que cette action a plû trop generalement dans le cinquiéme Acte pour me repentir de l’avoir fait.	Comme l'Histoire ne nomme point cette belle captive, je la fais Nièce d'Hannibal, pour donner un plus grand contraste à l'amour de Scipion qu'il combat, et dont enfin il triomphe, et je puis dire que cette action a plu trop généralement dans le cinquième Acte pour me repentir de l'avoir fait.
Il a des gens qui s’étonnent qu'Annibal vienne demander la Paix avecque une aſſez groſſe Armée;	Il a des gens qui s'étonnent qu'Hannibal vienne demander la Paix avec une assez grosse Armée;
mais il n'eſt pas permis d’ignorer un ait hiſtorique auſſi connu que celuyà.	mais il n'est pas permis d'ignorer un ait historique aussi connu que celuià.
Il eſt conſtant qu'Annibal fut rapellé par le Senat de Cartage pour défendre ſa patrie, qu’il quitta l’Italie, qu'il revint en Afrique, & qu’il y trouva les affaires en un ſi mau vais état, qu’il n'eut point d’autre party à prendre pour ſauver Cartage, que celuy de demander la Paix;	Il est constant qu'Hannibal fut rappelé par le Sénat de Carthage pour défendre sa patrie, qu'il quitta l'Italie, qu'il revint en Afrique, et qu'il y trouva les affaires en un si mau vais état, qu'il n'eut point d'autre parti à prendre pour sauver Carthage, que celui de demander la Paix;
mais il la demande d’une maniere aſſez noble, & cette Scene à bien conduite;	mais il la demande d'une manière assez noble, et cette Scène à bien conduite;
Je ne doute point qu’il n'y ait bien des choſes qui auroient pus être mieux dans cette Piece, mais je ne ſuis pas infaillible, & je ne donne point cecy pour un ouvrage achevé.	Je ne doute point qu'il n'y ait bien des choses qui auraient pus être mieux dans cette Pièce, mais je ne suis pas infaillible, et je ne donne point ceci pour un ouvrage achevé.
Il ſu ffit qu’il aitréuſſi, pour en devoir étre centent, & pourm'encourager à travailler à l’avenir avec encor plus de ſoin & plus d’e	Il su fit qu'il aitréussi, pour en devoir être cent, et pourm'encourager à travailler à l'avenir avec encor plus de soin et plus d'e
AR Grace & Privilege du Roy, donné à Paris T le vingt-uniéme Mars 1697.	AR Grâce et Privilège du Roi, donné à Paris T le vingt-unième Mars 1697.
Signé, Par le Roy en ſon Conſeil, LE FIVRE.	Signé, Par le Roi en son Conseil, LE FIVRE.
Il eſt permis à THOMAS GUILLAIN, Marchand Libraire à Paris, de faire imprimer, vendre & debiter le Recueil des Tragedies du Sieur PRADON, pendant le temps de ſix années, à compter du jour qu’elles ſeront achevées d’imprimer pour la premiere fois, en vertu des preſentes, pendant lequel temps tresexpreſſes inhibitions & défenſes ſont faites à toutes perſonnes de quelque qualité & condition qu’elles ſoient;	Il est permis à THOMAS GUILLAIN, Marchand Libraire à Paris, de faire imprimer, vendre et débiter le Recueil des Tragédies du Sieur PRADON, pendant le temps de six années, à compter du jour qu'elles seront achevées d'imprimer pour la première fois, en vertu des présentes, pendant lequel temps tresexpresses inhibitions et défenses sont faites à toutes personnes de quelque qualité et condition qu'elles soient;
de faire imprimer, vendre ny debiter deſdites Tragedies conjointement, ou ſeparément, d’autre Edition que celles de l'Expoſant, ou de ceux qui auront droit de luy, à peine de quinze cens livres d’amende, payable ſans déport par chacun des Contrevenans, de conſiſcation des Exemplaires contrefaits, & de tous dépent, dommages & intereſts, & autres peines portées plus au long par leſdites Lettres de Privilege.	de faire imprimer, vendre ici débiter dédites Tragédies conjointement, ou séparément, d'autre Édition que celles de l'Exposant, ou de ceux qui auront droit de lui, à peine de quinze cens livres d'amende, payable sans déport par chacun des Contrevenants, de consiscation des Exemplaires contrefaits, et de tous dépent, dommages tous intérêts, et autres peines portées plus au long par les Lettres de Privilège.
Regiſtre ſur le Livre de la Communautt des Imprimeurs & Libraires de la Ville de Parit , le 26.	Registre sur le Livre de la Communaut des Imprimeurs et Libraires de la Ville de Parit , le 26.
Bun.	Bun.
27973	27973
ACTEURS.	ACTEURS.
SCIPION, ſurnommé l’AFRICAIN, Conſul & General de l’Armée des Romains.	SCIPION, surnommé l'AFRICAIN, Consul et Général de l'Armée des Romains.
ANNIBAL, General de l’Atmée des Cartaginols.	ANNIBAL, Général de l'Atmée des Carthaginols.
EOCEJOS, Pruce ues Ceſtibemens, Amant d’Iſperie Niéce d’Annibal.	EOCEJOS, Pruce utes Cestibements, Amant d'Ispérie Nièce d'Hannibal.
BPERIE, Niéce d’Annibal, promiſe à Lucejue, priſonniere daus le Camp de Scipion.	BPERIE, Nièce d'Hannibal, promise à Lucejue, prisonnière daus le Camp de Scipion.
Chchatiu, ele d’Hannon, ennemy d’Annibal, priſonniere dans le Camp de Scipion.	Chchativ, éle d'Hannon, ennemi d'Hannibal, prisonnière dans le Camp de Scipion.
AURILCAR, Envoyé d’Annibal vers Selpion	AURILCAR, Envoyé d'Hannibal vers Selpion
LEPIDE, Confident de Scipion.	LEPIDE, Confident de Scipion.
SEXTUS, Capitaine de l’Armée de Scipion	SEXTUS, Capitaine de l'Armée de Scipion
CELSUS Romain, amy de Lucejus.	CELSUS Romain, ami de Lucejus.
ERMILIE, Confidente d’Iſperie.	ERMILIE, Confidente d'Ispérie.
BARCE', Confidente d’Erixene.	BARCE', Confidente d'Erixène.
M6S.	M6S.
Le Scene eſt dans le Camp de Scipion, prés de Zama.	Le Scène est dans le Camp de Scipion, près de Zama.
SCIPION	SCIPION
3 AM M A LAFRICAIN A	3 AM M A FRICAIN A
ACTE' I D.	ACTE I D.
LEPIDE, AURILCAR.	LÉPIDE, AURILCAR.
LEPIDE.	LÉPIDE.
EIONEUR, en attendant que Scipion vous voye, Je me tiens honoré de l'ordre qu’il m’envoye, De vous entretenir pendant quelques momens, Nous ſçaurons d’Annibal les ſecrets ſentimens, C’eſt vous qui dans ce Camp annoncez ſa venue.	EIONEUR, en attendant que Scipion vous voie, Je me tiens honoré de l'ordre qu'il m'envoie, De vous entretenir pendant quelques moments, Nous saurons d'Hannibal les secrets sentiments, C'est vous qui dans ce Camp annoncez sa venue.
AURILCAR.	AURICAR.
Oüy, Seigneur, Annibal ſouhaite une entreveue, Je viens la demander, c’eſt ſon intention Que de voir aujourd’huy le fameux Scipion;	Oui, Seigneur, Hannibal souhaite une entrevue, Je viens la demander, c'est son intention Que de voir aujourd'hui le fameux Scipion;
Aux plaines de Zama nous ſommes l’un & l’autre, Nôtre Armée eſt campée aſſez prés de la vôtre;	Aux plaines de Zama nous sommes l'un et l'autre, Notre Armée est campée assez près de la vôtre;
Mais Annibal prétend avec luy conferer, Et je viens en ce Camp pour en déliberer,, Avaut que de rien faire & de rien entrepreudre.	Mais Hannibal prétend avec lui conférer, Et je viens en ce Camp pour en délibérer, Avaut que de rien faire et de rien entrepreudre.
LEPIDE.	LÉPIDE.
Sans doute qu’on ne peut refuſer de l’entendre;	Sans doute qu'on ne peut refuser de l'entendre;
Nous verrons aujourd’huy ces deux grands Citoyens, Tous deux de leur païs la gloire & les ſoûtiens, Donner ce peu de tréve à cette longue guerte, Pour décider entre-eux du deſtin de la terre, Et de leur conference on attend deſormais Le jour de la bataille, ou celuy de la paix.	Nous verrons aujourd'hui ces deux grands Citoyens, Tous deux de leur pays la gloire et les soutiens, Donner ce peu de trêve à cette longue guerte, Pour décider entre-eux du destin de la terre, Et de leur conférence on attend désormais Le jour de la bataille, ou celui de la paix.
AURILCAR.	AURICAR.
Je ne m’explique point des deſſeins de mon Maître, Il paroîtra luy-même, & les fera connoltre, Il marche ſur mes pas:	Je ne m'explique point des desseins de mon Maître, Il paraîtra fait-même, et les fera connaître, Il marche sur mes pas:
mais que d’heureux ſucces, Seigneur, de Scipion ont remply les projets?	mais que d'heureux succès, Seigneur, de Scipion ont rempli les projets?
La victoire en tous lieux à ſon bras enchaînée Semble de l’Univers faire la deſtinée;	La victoire en tous lieux à son bras enchaînée Semble de l'Univers faire la destinée;
Jeune encor, on a vû ſes grandes actiolis Suivre, & même paſſer celles des Scipions, Et digne rejeton de cette illuſtre race, A vingt ans on l’a vû commander en leur place;	Jeune encore, on a vu ses grandes actiolis Suivre, et même passer celles des Scipions, Et digne rejeton de cette illustre race, A vingt ans on l'a vu commander en leur place;
Il nous chaſſa d’Eſpagne aprés quatre combats, Où Rome triompha par l'effort de ſon bras, Le voicy dans l’Affrique étonnée, affoiblie, Il arrache Annibal du ſein de l'Italie.	Il nous chassa d'Espagne après quatre combats, Où Rome triompha par l'effort de son bras, Le voici dans l'Afrique étonnée, affaiblie, Il arrache Hannibal du sein de l'Italie.
Et contraint ce Heros de voler en ces lieux, Tourocseuste xton tour de pautecelce suux.	Et contraint ce Héros de voler en ces lieux, Tourocseute xton tour de pautecelce succ.
LEPIDE.	LÉPIDE.
s’il acheve, Seigneur, cette heureuſe campagne, Dans l’Affrique il fera ce qu’il fit en Eſpagne:	s'il achève, Seigneur, cette heureuse campagne, Dans l'Afrique il fera ce qu'il fit en Espagne:
Un des plus puiſſans Rois qui fut dans l’Univers, L’infidelle Syphax a pery daus ſes fers, Aſdrubal;	Un des plus puissants Rois qui fût dans l'Univers, L'infidèle Syphax a péri daus ses fers, Asdrubal;
& Xantus ont perdu trois batailles, Cartage va nous voir au pied de ſes murailles, Cette ſuperbe ville eſt contrainte aujourd’huy D’appeller Annibal pour luy ſervir d’appuy;	et Xantus ont perdu trois batailles, Carthage va nous voir au pied de ses murailles, Cette superbe ville est contrainte aujourd'hui D'appeler Hannibal pour lui servir d'appui;
Scipion la menace, & l’on voit ce grand homme Luy rendre tout l’eſfroy qu’Annibal ſit à Rome.	Scipion la menace, et l'on voit ce grand homme Lui rendre tout l'efroi qu'Hannibal à Rome.
AURILCAR.	AURICAR.
Il vient de ſes ſuccés interrompre le cours, Et promet à l’Affrique un fidele ſecours.	Il vient de ses succès interrompre le cours, Et promet à l'Afrique un fidèle secours.
Son nom ſeul raffermit nos Provinces craintives;	Son nom seul raffermit nos Provinces craintives;
Mais puis-je m’informer des illuſtres captives Quę guula plis d'unaut va tomveruaus vos fers;	Mais puis-je m'informer des illustres captives Quel guula plis d'unaut va tomveruaus vos fers;
La Niéce d’Annibal les a-t-elle ſouffets?	La Nièce d'Hannibal les a-t-elle souffets?
Et la Fille d’Hannon, la ſuperbe Etixene, S’eſt-elle accoûtumée à porter une chaîne?	Et la Fille d'Hannon, la superbe Etixene, S'est-elle accoutumée à porter une chaîne?
LEPIDE.	LÉPIDE.
Que leur chaîne, Seigneur, eſt facile à porter!	Que leur chaîne, Seigneur, est facile à porter!
Elles ont des vertus qui les font reſpecter, Au Camp de Scipion elles ſont ſouveraines, Il les traite bien moins en eſclaves qu’en Reines, Il n’a plus de fierté ſi-tôt qu’il eſt vainqueur, Sa bonté, ſa clemence égalent ſa valeur;	Elles ont des vertus qui les font respecter, Au Camp de Scipion elles sont souveraines, Il les traite bien moins en esclaves qu'en Reines, Il n'a plus de fierté sitôt qu'il est vainqueur, Sa bonté, sa clémence égalent sa valeur;
Oüy, ſon bras aux vaincus ne fut jamais funeſte, La victoire ne ſert qu’à le rendre modeſte, Egal dans la fortune & dans l’adverſité, Il n’eſt jamais ſuperbe en la proſperité.	Oui, son bras aux vaincus ne fut jamais funeste, La victoire ne sert qu'à le rendre modeste, Égal dans la fortune et dans l'aversité, Il n'est jamais superbe en la prospérité.
La Niéce d’Annibal, l’adorable Iſperie, Fit briller tant d’éclat & tant de modeſtie Qu’il en fut ébloüy:	La Nièce d'Hannibal, l'adorable Ispérie, Fit briller tant d'éclat et tant de modestie Qu'il en fut ébloui:
mais enfin ſa beauté Porte un charme ſecret dont on eſt enchanté.	mais enfin sa beauté Porte un charme secret dont on est enchanté.
Au Prince Lucejus elle ſe vit promiſe, Il devoit l’épouſer quand Zama fut ſurpriſe;	Au Prince Lucejus elle se vit promise, Il devait l'épouser quand Zama fut surprise;
Ce jour infortuné ſi funeſte pour eux Sépara ces Amans ſur le point d’eſtre heureux, Elle ignore où ce Prince a ſçû porter ſes armes, Et ſouvent ſes beaux yeux pour luy verſent des larmes:	Ce jour infortuné si funeste pour eux Sépara ces Amants sur le point d'être heureux, Elle ignore où ce Prince a su porter ses armes, Et souvent ses beaux yeux pour lui versent des larmes:
Mais, Seigneur, Erixene en ce lieu doit venir, dcipion luy pemeede vous entietemr, Je vois qu’elle s’avance, & vous laiſſe avecque elle	Mais, Seigneur, Erixène en ce lieu doit venir, dcipion Seigneur pemède vous entiétemr, Je vois qu'elle s'avance, et vous laisse avec elle
SCENE II.	SCÈNE II.
ERIXENE, BARSE', AURILCAR.	ERIXENE, BARSE', AURILCAR.
ERIXENE.	ERIXENE.
N nous vient d’annoncer une grande nouvelle, Annibal en Affrique eſt enfin de retour.	N nous vient d'annoncer une grande nouvelle, Hannibal en Afrique est enfin de retour.
AURILCAR.	AURICAR.
Vous le verrez, Madame;	Vous le verrez, Madame;
avant la fin du jour.	avant la fin du jour.
ERIXENE.	ERIXENE.
Je ſçay que dans l’état où l’Affrique eſt reduite, Elle n’eſpere plus qu’en ſa ſeule conduite;	Je sais que dans l'état où l'Afrique est réduite, Elle n'espère plus qu'en sa seule conduite;
Ne me déguiſez rien ſur ſes nouveaux projets, Je prévois, Aurilcar, qu’ils tendent à la paix.	Ne me déguisez rien sur ses nouveaux projets, Je prévois, Aurilcar, qu'ils tendent à la paix.
AURILCAR.	AURICAR.
Vous avez penetré ce que veut ſa prudence, Une paix de Cartage eſt l’unique eſperance;	Vous avez pénétré ce que veut sa prudence, Une paix de Carthage est l'unique espérance;
Mais, Madame, que dit, & que fait Scipion?	Mais, Madame, que dit, et que fait Scipion?
Son jeune cœur n’a-t-il que de l’ambition?	Son jeune cœur n'a-t-il que de l'ambition?
Les charmes d’Erixene, ou les yeux d’Iſperie None-ns pu Teudic encor la graude ame attendrie?	Les charmes d'Erixène, ou les yeux d'Ispérie None-ns pu Teudic encor la graude âme attendrie?
Pardonnez.	Pardonnez.
ERIXENE.	ERIXENE.
Apprenez un ſecret important, Sans doute Scipion n’eſt plus indiſſetent.	Apprenez un secret important, Sans doute Scipion n'est plus indissent.
Depuis peu dans ſon Camp ſa ſlâme eſt allumée, Bien que ſa paſſion dans ſon cœur renfermée Prenne ſoin à nos yeux toujours de ſe cacher, Qu’iltaſſé des eſtorts en vain pour Tasfacher.	Depuis peu dans son Camp sa slâme est allumée, Bien que sa passion dans son cœur renfermée Prenne soin à nos yeux toujours de se cacher, Qu'iltassé des étorts en vain pour Tâfacher.
J’ay conuu cependant, même par ſa contrainte, Que d’un ſeu violent ſon ame étoit atteinte.	J'ai convu cependant, même par sa contrainte, Que d'un seu violent son âme était atteinte.
AURILCAR.	AURICAR.
Il faut d’un tel ſecret qu’Annibal ſoit inſtruit, Sa prudence pouroit en titer quelque fruit;	Il faut d'un tel secret qu'Hannibal soit instruit, Sa prudence pourrait en titer quelque fruit;
Car ſi de Scipion on ſléchit le courage, Il pouroit s’adoucir en faveur de Caitage.	Car si de Scipion on sléchit le courage, Il pourrait s'adoucir en faveur de Caitage.
Hé quoy?	Hé quoi?
ſi de l’amour il reſſentoit les coups?	si de l'amour il ressentait les coups?
Et s’il étoit charmé d’Iſperie, ou de vous, Sans doute que la paix en ſeroit plus facile.	Et s'il était charmé d'Ispérie, ou de vous, Sans doute que la paix en serait plus facile.
ERIXENE.	ERIXENE.
A connoitre les cœurs je ne ſuis pas habile;	À connaître les cœurs je ne suis pas habile;
Mais j’ay erû démeſler dans ſon trouble ſecret, Qu’il aime une des deux, & qu’il l’aime à regret 3 Plus j’obſerve pour nous ſes yeux & ſa conduite, Plus je vois qu’il nous cherche alors qu’il nous évite;	Mais j'ai ervu démêler dans son trouble secret, Qu'il aime une des deux, et qu'il l'aime à regret 3 Plus j'observe pour nous ses yeux et sa conduite, Plus je vois qu'il nous cherche alors qu'il nous évite;
Quand il nous voit enſemble il demeure interdis, Il rougit quelquefois de honte & de dénit 7 Et quand il s’aperçoit du trouble de ſon ame, Il ſemble s’indigner de ſa naiſſante flâme, Il fremit de ſentir l’amour qu’il veut dompter, Et que tout ſon courage a peine à ſurmonter.	Quand il nous voit ensemble il demeure interdis, Il rougit quelquefois de honte et de dénit 7 Et quand il s'aperçoit du trouble de son âme, Il semble s'indigner de sa naissante flamme, Il frémit de sentir l'amour qu'il veut dompter, Et que tout son courage a peine à surmonter.
Voila.	Voilà.
le plan d’un cœur difficile à connoître;	le plan d'un cœur difficile à connaître;
Mais pour aprofondir qui peut en eſtre maître, Je ſçay trop qu’Iſperie a des charmes puiſſans, Que ſa beauté d’abord peut enchanter les ſens, Mais à ſon cher Amant elle eſt trop attachée, Et par nul autre objet n’en peut eſtre arrachée, scipion le connoît.	Mais pour approfondir qui peut en être maître, Je sais trop qu'Ispérie a des charmes puissants, Que sa beauté d'abord peut enchanter les sens, Mais à son cher Amant elle est trop attachée, Et par nul autre objet n'en peut être arrachée, scipion le connaît.
AURILCAR.	AURICAR.
Madame, & plût aux Dieux!	Madame, et plût aux Dieux!
Que ce Vainqueur ſentit le pouvoir de vos yeux?	Que ce Vainqueur sentit le pouvoir de vos yeux?
ERIXENE.	ERIXENE.
Je ne m’en ſlatte point, mais ſans eſtre trop vaine, Scipion ſans rougir pouroit porter ma chaîne, Que dis-je?	Je ne m'en slatte point, mais sans être trop vaine, Scipion sans rougir pourrait porter ma chaîne, Que dis-je?
ce Heros, le plus grand des mortels, A qui Rome déja conſacre des Autels, D’un cœur tel que le mien peut devenir le maître, Et s’il n’eſt mon Amant il eſt digne de l’eſtre.	ce Héros, le plus grand des mortels, À qui Rome déjà consacre des Autels, D'un cœur tel que le mien peut devenir le maître, Et s'il n'est mon Amant il est digne de l'être.
Peut-eſtre j’en dis trop, & j'avouẗ à regret Un-foible, dont mon cœur me faiſoit un ſecret;	Peut-être j'en dis trop, et j'avouẗ à regret Un-foible, dont mon cœur me faisait un secret;
Mais quoy?	Mais quoi?
Si l'on faiſoit la paix avec Cartage, Plût au Ciel!	Si l'on faisait la paix avec Carthage, Plût au Ciel!
que l’amour en ébauchât l’ouvrage, Et du moins je vouuiois pour flater ma fierté, Que l’heureuſe Erixene eût part à ce traité.	que l'amour en ébauchât l'ouvrage, Et du moins je vouais pour flatter ma fierté, Que l'heureuse Erixène eût part à ce traité.
Adieu, Scipion vient, & vous allez l’entendre.	Adieu, Scipion vient, et vous allez l'entendre.
SCENEIII.	SCENEII.
SCIPTON, LEPIDE, AORIECAR.	SCIPTON, LEPIDE, AORIECAR.
SCIPION.	SCIPION.
ooirdono uuy, ocignieur, ce qu’on vient de L m’apprendre, Que le graud Annibal cherche à m’entretenir?	ooirdono uuy, ocignieur, ce qu'on vient de L 'apprendre, Que le graud Hannibal cherche à m'entretenir?
AURILCAR Seigneur, ſur ce ſujet je viens vous prévenir, Occupé tout entier du ſoin de ſa patrie, Annibal, par ma bouche aujourd’huy vous en prie;	AURILCAR Seigneur, sur ce sujet je viens vous prévenir, Occupé tout entier du soin de sa patrie, Hannibal, par ma bouche aujourd'hui vous en prie;
One sume emsnovsde delle e don pala, Et même neceſſaire à tous les deux partis, Pouroit en ce grand jour décidant de la guerre, Donner un plein repos au reſte de la terte.	Ône sume emnovsède delle e on pála, Et même nécessaire à tous les deux partis, Pourrait en ce grand jour décidant de la guerre, Donner un plein repos au reste de la terte.
SCIPION.	SCIPION.
Annibal me ſurprend par ce nouveau deſſein, Je ne le croyois voir que le fer à la main, Et ſeur de ſa valeur & de ſa renommée, Je l'attendois toujours en tête d’une Armée.	Hannibal me surprend par ce nouveau dessein, Je ne le croyais voir que le fer à la main, Et sûr de sa valeur et de sa renommée, Je l'attendais toujours en tête d'une Armée.
AURILCAR.	AURICAR.
Elle approche de vous, & marche ſur ſes pas;	Elle approche de vous, et marche sur ses pas;
Avant que de tenter le deſtin des combats, Il a cru pour le bien de chaque Republique, Qu’il devoit avec vous en ſage politique, Examiner à, fonds les divers intereſts Qui troublent noi Etats par des reſſors ſecrets, Ec les ayant tous mis dans la juſte balance, En peſer à loiſir les raiſons, l’importance, Pour garder à chacun & ſa gloire & ſon rang;	Avant que de tenter le destin des combats, Il a cru pour le bien de chaque République, Qu'il devait avec vous en sage politique, Examiner à, fond les divers intérêts Qui troublent noi Etats par des ressors secrets, Ec les ayant tous mis dans la juste balance, En peser à loisir les raisons, l'importance, Pour garder à chacun et sa gloire et son rang;
Souvent une entreveuë épargne bien du ſang, Ainſi pour Annibal je la demande encore.	Souvent une entrevue épargne bien du sang, Ainsi pour Hannibal je la demande encore.
SCIPION.	SCIPION.
Hé bien?	Hé bien?
pour luy marquer à quel point je l'honore J'accepte l'entreveuë, & veux bien diſterer La bataille où j’ay cru devoir me préparer;	pour Elle marquer à quel point je l'honore J'accepte l'entrevue, et veux bien disterer La bataille où j'ai cru devoir me préparer;
Pour lever tout ombrage & toute défiance, Qu’il choiſiſſe un lieu propre à cette conferenee, Je m’y rendray, Seigneur, au jour qu’il nommera, ide ne lerey lenyeueumne quule snt	Pour lever tout ombrage et toute défiance, Qu'il choisisse un lieu propre à cette conférence, Je m'y rendrai, Seigneur, au jour qu'il nommera, ide ne lèvrei lenyeueumne que snt
AURILCAR.	AURICAR.
Il prétend dans ce Camp venir bien-tôt luy-même.	Il prétend dans ce Camp venir bientôt lui-même.
SCIPION.	SCIPION.
Quoy!	Quoi!
luy-même en mon Camp, ma ſurpriſe eſt extrême?	lui-même en mon Camp, ma surprise est extrême?
Mais quel ôtage encor exige-t-il de moy?	Mais quel otage encor exige-t-il de moi?
Que demande-t-il qui puiſſe.	Que demande-t-il qui puisse.
AURILCAR.	AURICAR.
Vôtre foy.	Votre foi.
SCIPION.	SCIPION.
Hé quoy?	Hé quoi?
donc Annibal ne veut point d’autre ôtage?	donc Hannibal ne veut point d'autre otage?
AURILCAR.	AURICAR.
Il veut de Scipion la parole pour gage, Hé quel ôtage peut remplacer Annibal?	Il veut de Scipion la parole pour gage, Hé quel otage peut remplacer Hannibal?
SCIPION.	SCIPION.
je ſçay qu’il n’en eſt point pour un tel General, Et puiſqu’il ſe confie en ma ſeule parole, Je jure par les Dieux appuis du Capitole, Qu’il peut en ſeureté ſe fier à maſoy, I n’aura dant mon Camp pour Otage que moy.	je sais qu'il n'en est point pour un tel Général, Et puisqu'il se confie en ma seule parole, Je jure par les Dieux appuis du Capitole, Qu'il peut en sûreté se fier à mazais, I J'aura dant mon Camp pour Otage que moi.
AURILCAR.	AURICAR.
Seigneur, c’en eſt aſſez.	Seigneur, c'en est assez.
SCIPION.	SCIPION.
Allez, je vais l’attendre, Je me fais un plaiſir de le voir, de l’entendte.	Allez, je vais l'attendre, Je me fais un plaisir de le voir, de l'entendte.
Mais preſſez l’entreveuë où j’ay dû conſentin Et voyez Iſperie avant que de partir.	Mais pressez l'entrevue où j'ai dû consentin Et voyez Ispérie avant que de partir.
SCENE IV.	SCÈNE IV.
SCIPION, LEPIDE.	SCIPION, LEPIDE.
SCIPION.	SCIPION.
Epide, que crois-tu de cette conference LQu’Annibal me demande avecque tant d’inſcance;	Épide, que crois-tu de cette conférence LQu'Hannibal me demande avec tant d'inscance;
Son invincible bras, la terreur des Romaini, Son grand cœur, ſa conduite, & ſes vaſtes deſſeins Avoient mis l’Italie aux bords du précipice, Long-temps de la fottune il fixa le captice;	Son invincible bras, la terreur des Romaini, Son grand cœur, sa conduite, et ses vastes desseins Avaient mis l'Italie aux bords du précipice, Longtemps de la fottune il fixa le captice;
De Trebie, & ſur tout de Cannes le malheur, Monumens éternels de ſa rate valeur, Sur les deux Scipions ſa derniere victoire, Tout enſin a ſervy de trophée à ſa gloire:	De Trébie, et sur tout de Cannes le malheur, Monuments éternels de sa rate valeur, Sur les deux Scipions sa dernière victoire, Tout ensin a servi de trophée à sa gloire:
Cependant ce vainqueur aptés tant de combats Envoye à Scipion, & fait les premiers pas, Il dément la fietté de ſon ame hautaine.	Cependant ce vainqueur aptés tant de combats Envoie à Scipion, et fait les premiers pas, Il dément la fietté de son âme hautaine.
Que me vient propoſer ce fameux Capitaine?	Que me vient proposer ce fameux Capitaine?
Dieux!	Dieux!
ſeroit-ce la paix?	serait-ce la paix?
mon eſprit agité Fremit en ce moment du ſeul mot de traité.	mon esprit agité Frit en ce moment du seul mot de traité.
LEPIDE.	LÉPIDE.
S’il demande la paix, n’eſtes-vous pas le maître D'accepter, d’impoſer.	S'il demande la paix, n'êtes-vous pas le maître D'accepter, d'imposer.
SCIPION.	SCIPION.
Apprens à me connoître.	Apprends à me connaître.
Si dans cette entreveuë il propoſe la paix, Ma gloire me déſend d’y conſentir lamais.	Si dans cette entrevue il propose la paix, Ma gloire me désend d'y consentir lamais.
Quelques conditions que j’impoſe à Cartage, Quand Rome la verroit reduite à l’eſclavage, Je ne fais rien pour moy, ſi dans un jour fatal Scipion n’eſt vainqueur de l’illuſtre Annibal:	Quelques conditions que j’ impose à Carthage, Quand Rome la verrait réduite à l'esclavage, Je ne fais rien pour moi, si dans un jour fatal Scipion n'est vainqueur de l'illustre Hannibal:
voila donc l’intereſt le premier de ma gloire;	voila donc l'intérêt le premier de ma gloire;
j'en ay d'autles ſecrets que tu ne pouras croire, Je ne ſçay ſi mon cœur ſe ſeroit démenty, Je ſens ce que fainais je n’avois reſſenty.	j'en ai d'autles secrets que tu ne pourras croire, Je ne sais si mon cœur se serait démenti, Je sens ce que fainais je n'avais ressenti.
LEPIDE.	LÉPIDE.
Vous, Seigneur?	Vous, Seigneur?
SCIPION.	SCIPION.
Je te veux ouvrir toute mona:	Je te veux ouvrir toute mona:
ne, Je ne ſçay ſi je dois donner le nom de flâme A ce trouble mortel dont je ſuis agité;	ne, Je ne sais si je dois donner le nom de flamme À ce trouble mortel dont je suis agité;
Qu’on l’ignore à jamais dans la poſterité?	Qu'on l'ignore à jamais dans la postérité?
Que toy ſeul ſois témoin de ma foibleſſe extrême?	Que toi seul sois témoin de ma faiblesse extrême?
Lepide, quelquefois j’ay pitié de moy-même, Je combats, mais en vain un rapide penchant, Qni de tous mes choits en toujouis triomphant;	Lépide, quelquefois j'ai pitié de moi-même, Je combats, mais en vain un rapide penchant, Quni de tous mes choits en toujouis triomphant;
Je rougis d’en ſentir les mottelles atteintes, ay voulu te cacher mon deſordre, mes craintes;	Je rougis d'en sentir les mottelles atteintes, ai voulu te cacher mon désordre, mes craintes;
Mais il faut t’avoüer mon foible avec douleur.	Mais il faut t'avouer mon faible avec douleur.
La priſe de Zama coûte cher à mon cœur.	La prise de Zama coûte cher à mon cœur.
LEPIDE.	LÉPIDE.
Je vous entends, Seigneur, des atteintes ſi vives Sont de l’amour.	Je vous entends, Seigneur, des atteintes si vives Sont de l'amour.
SCIPION.	SCIPION.
Ecoûte, une de mes captives, Je tremble ſeulement d’en prononcer le nom, A ſoumis, a vaincu le cœur de Scipion;	Écoute, une de mes captives, Je tremble seulement d'en prononcer le nom, A soumis, a vaincu le cœur de Scipion;
Pourois-je t’en tracer une aſſez vive image?	Pourrais-je t'en tracer une assez vive image?
Un charme ébloüiſſant brille ſur ſon viſage, Un air plein de grandeur, une noble fierté, L'éclat & la douceur jointe à la majeſté, Mille & mille vertus, une grace infinie.	Un charme éblouissant brille sur son visage, Un air plein de grandeur, une noble fierté, L'éclat et la douceur jointe à la majesté, Mille et mille vertus, une grâce infinie.
Enfin ne dois-tu pas reconnoître Iſperie.	Enfin ne dois-tu pas reconnaître Ispérie.
LEPIDE.	LÉPIDE.
Herqui pouroit la von tans eu enle Iaipiis.	Herqui pourrait la von tans eu enle Jaipiis.
Seigneur, avec raiſon vous en eſtes épris, Ses yeux.	Seigneur, avec raison vous en êtes épris, Ses yeux.
SCIPION.	SCIPION.
Ne flates point mon panchant, ma foibleſſe, Et loin de me laiſſer languir dans la moleſſe, Contre un feu ſi fatal prête-moy du ſecours, Sauve moy, s’il ſe peut, de l’ablme où je cours:	Ne flatte point mon penchant, ma faiblesse, Et loin de me laisser languir dans la mollesse, Contre un feu si fatal prête-moi du secours, Sauve moi, s'il se peut, de l'ablme où je cours:
D'Iſperie, il eſt vray, je redoutois la veuë, le ſentois à ſes yeux mon ame trop émeuë, ’ay voulu l’éviter, vaine précaution!	D'Ispérie, il est vrai, je redoutais la vue, le sentais à ses yeux mon âme trop émue, 'ai voulue l'éviter, vaine précaution!
Par l’abſence j’ay cru vaincre ma paſſion, j’ay tenu quelque temps contre de ſi doux charmes;	Par l'absence j'ai cru vaincre ma passion, j'ai tenu quelque temps contre de si doux charmes;
Mais enfin je la vis, elle verſoit des larmes, C’eſtoit pour ſon Amant, & j’en fus offenſé, D’un mouvement jaloux je me ſentis preſſé, Et ſes pleurs, ſes ſoûpirs, ſa langueur, ſa triſteſſe, Me fitent vivement reſſentir ma foibleſſe, Je n’en ſuis plus le maître, & malgré mes effort Je ſuccombe, Lepide, à de ſi doux tranſports.	Mais enfin je la vis, elle versait des larmes, C'était pour son Amant, et j'en fus offensé, D'un mouvement jaloux je me sentis pressé, Et ses pleurs, ses soupirs, sa langueur, sa tristesse, Me fitent vivement ressentir ma faiblesse, Je n'en suis plus le maître, et malgré mes effort Je succombe, Lépide, à de si doux transports.
LEPIDE.	LÉPIDE.
Il eſt vray qu’elle eſt belle, & digne d’eſtfe aimée,	Il est vrai qu'elle est belle, et digne d'estée aimée,
SCIPION.	SCIPION.
Plus je reſiſte, & plus j’en ay l’ame charmée, L’effort que je me fais irrite mes deſirs, Prés d’elle je contrains, j’étouffe mes ſoûpirs:	Plus je résiste, et plus j'en ai l'âme charmée, L'effort que je me fais irrite mes désirs, Prés d'elle je contrains, j'étouffe mes soupirs:
Mais dieux!	Mais dieux!
elle eſt ſans ceſſe en de triſtes allarmes, Je me vois aujourd’huy la cauſe de ſes larmes, Ma fatale victoire a trahy ſes deſſeins, Elle doit me haïr, Lepide, & je le crains.	elle est sans cesse en de tristes alarmes, Je me vois aujourd'hui la cause de ses larmes, Ma fatale victoire a trahi ses desseins, Elle doit me haïr, Lépide, et je le crains.
LEPIDE.	LÉPIDE.
vVous pouriez vois, seiglieur, vorſe name ſompée, Du Prince Lucejus elle eſt préocupée, Vous l’avez enlevée aux bras de cet époux.	vOus pourriez vois, seiglieur, vorse name sompée, Du Prince Lucejus elle est préoccupée, Vous l'avez enlevée aux bras de cet époux.
CIPION.	CIPION.
Il l'épouſoit?	Il l'épousait?
ah Ciel!	ah Ciel!
que ſon ſort étoit doux?	que son sort était doux?
Qu’il alloit eſtre heureux?	Qu'il allait être heureux?
& qu’Iſperie eſt belle?	et qu'Ispérie est belle?
Eſt-il dans l’univers rien qui ſoit digne d’elle?	Est-il dans l'univers rien qui soit digne d'elle?
Mais que veut Aanibal?	Mais que veut Aanibal?
quel accord, quel traité?	quel accord, quel traité?
Voudra-t-il de ſa Niéce avoir la liberté?	Voudra-t-il de sa Nièce avoir la liberté?
Eſt-ce pour Lucejus, pour elle, ou pour Cartage Qu’il vient.	Est-ce pour Lucejus, pour elle, ou pour Carthage Qu'il vient.
dure à jamais plûtôt ſon eſclavage!	dure à jamais plutôt son esclavage!
Apprens que Scipion ne la rendra jamais, auue cis leus, au couen .	Apprends que Scipion ne la rendra jamais, aveu cis lus, au couen .
i.	y.
paix;	paix;
Ainſi donc plus d’accord, ny même d’entreveuë.	Ainsi donc plus d'accord, ni Seigneur d'entrevue.
LEPIDE.	LÉPIDE.
Mais vous l’avez promiſe, & dans peu la venut D’Annibal en ce Camp.	Mais vous l'avez promise, et dans peu la venut D'Hannibal en ce Camp.
SCIPION.	SCIPION.
Il eſt vray, j’ay promis D'entendre le plus fier de tous nos ennemis;	Il est vrai, j'ai promis D'entendre le plus fier de tous nos ennemis;
Mais jé dois pour ma gloire oublier Iſperie, Je dois la regarder en mortelle ennemle, La Niéce d’Annibal tenteroit ma vertu?	Mais jé dois pour ma gloire oublier Ispérie, Je dois la regarder en mortelle ennemle, La Nièce d'Hannibal tenterait ma vertu?
Le plus grand ennemy que jamais Rome ait eu?	Le plus grand ennemi que jamais Rome ait eu?
Non, Lepide, aujourd’huy je dois briſer ma chaîne,	Non, Lépide, aujourd'hui je dois briser ma chaîne,
LEPIDE.	LÉPIDE.
Seigneur portez vos vœux du côté d’Erixene.	Seigneur portez vos vœux du côté d'Erixène.
Elle eſt fille d’Hannon ennemy d’Annibal, Dans Cartage ce Chef fut toujours ſon rival.	Elle est fille d'Hannon ennemi d'Hannibal, Dans Carthage ce Chef fut toujours son rival.
Toujours dans le Senat à ce Heros contraire, Dans Rome il n’eut jamais de plus grand adverſaire, Et s'oppoſant ſans ceſſe à ſes juſtes deſſeins, Il paroiſſoit plûtôt l’allié des Romains;	Toujours dans le Sénat à ce Héros contraire, Dans Rome il n'eut jamais de plus grand adversaire, Et s'opposant sans cesse à ses justes desseins, Il paraissait plutôt l'allié des Romains;
Aux charmes d’Iſperie oppoſez Erixene, Et pienez un amour conforme à vôtre haine, Elle peut balancer vos deſirs à ſon tour, Et même elle pouroit répondre à vôtre amour.	Aux charmes d'Ispérie opposez Erixène, Et pienez un amour conforme à votre haine, Elle peut balancer vos désirs à son tour, Et même elle pourrait répondre à votre amour.
Erixene!	Erixène!
SCIPION.	SCIPION.
LEPIDE.	LÉPIDE.
Oüy, Seigneur, & j’ay eru le connoître, Toute ſa fierté tombe en nous voyant paroître:	Oui, Seigneur, et j'ai erv le connaître, Toute sa fierté tombe en nous voyant paraître:
Quand on parle de vous, il le faut avoüer, Elle prend du plaiſir, Seigneur, à vous loüer, Et lotſque vos regards tournent vers Iſperie, Elle voudroit bien voir ſes charmes effacez, Elle la hait enfin, en eſt-ce pas aſſez?	Quand on parle de vous, il le faut avouer, Elle prend du plaisir, Seigneur, à vous louer, Et lotsque vos regards tournent vers Ispérie, Elle voudrait bien voir ses charmes effacés, Elle la hait enfin, en est-ce pas assez?
SCIPION.	SCIPION.
Elle hait Iſperie, ah Ciel!	Elle hait Ispérie, ah Ciel!
quelle injuſtice?	quelle injustice?
Par qu’elle jalouſie, ou plûtôt quel caprice, Malgré tant de beautez cette Erixene hait Ce que la main des Dieux forma de plus parfait.	Par quelle jalousie, ou plutôt quel caprice, Malgré tant de beautés cette Erixène hait Ce que la main des Dieux forma de plus parfait.
Je m’égare, Lepide, & tu vois ma foibleſſe, C’eſt envain que je veux déguiſer ma tendreſſe;	Je m'égare, Lépide, et tu vois ma faiblesse, C'est envain que je veux déguiser ma tendresse;
Apprenons cependant ce qu’Aurilcar a fait, Peut-eſtre qu’Iſperie aura ſçû quel projet Annibal peut former, & qu'elle eſt ſa conduite, De ſes deſſeins ſans doute elle doit eſtre inſtruite;	Apprenons cependant ce qu'Aurilcar a fait, Peut-être qu'Ispérie aura su quel projet Hannibal peut former, et qu'elle est sa conduite, De ses desseins sans doute elle doit être instruite;
veux ſondet ſon cœur, je veux eſtre éclairey Des ſecretes raiſons qui l’amenent icy.	veux sondet son cœur, je veux être éclairei Des secrètes raisons qui l'amènent ici.
ACTE II.	ACTE II.
SCENE PREMIERE.	SCÈNE PREMIÈRE.
ISPERIE, ERMILIE.	ISPERIE, ERMILIE.
8 ET ISPERIE ANGUIRAIS-je toujours en des craintes mortelles?	8 ET ISPERIE ANGUIRAIS-je toujours en des craintes mortelles?
Du Prince Lucejus on n’a point de nouvelles, Aurilear m’a parlé ſans m’avoir rien appris Qui puiſſe redonner le calme à mes eſprits;	Du Prince Lucejus on n'a point de nouvelles, Aurilear m'a parlé sans m'avoir rien appris Qui puisse redonner le calme à mes esprits;
Il m’apprend qu’Annibal, ce Heros que j’honore, Viendra;	Il m'apprend qu'Hannibal, ce Héros que j'honore, Viendra;
mais Lucejus ne paroît point encore;	mais Lucejus ne paraît point encore;
Devoit-il pas aller au devant de ſes pas?	Devait-il pas aller au devant de ses pas?
Le joindre dans ſon Camp, y mener ſes ſoldats?	Le joindre dans son Camp, y mener ses soldats?
Que fait-il?	Que fait-il?
en quels lieux avec indifference, Depuis deux mois entiers ſouffre-t-il mon abſence?	en quels lieux avec indifférence, Depuis deux mois entiers souffre-t-il mon absence?
Il n’oſe tien tentu il n’a rien entrepris, Sans doute que mon cœur eſt d’un trop foible prix;	Il n'ose tien tentu il n'a rien entrepris, Sans doute que mon cœur est d'un trop faible prix;
Et ne devoit-il pas au peril de ſa teſte, Ravir à Scipion une telle conqueſte;	Et ne devait-il pas au péril de sa tête, Ravir à Scipion une telle conquête;
Il n’a rien fait encor pour me prouver ſa foy, Je ne merite pas qu’il s’expoſe pour moy.	Il n'a rien fait encor pour me prouver sa foi, Je ne mérite pas qu'il s'expose pour moi.
DI.	DI.
ERMILIE.	ERMILIE.
Eh?	Eh?
pouvez-vous douter que ce Prince vous aime, Madamé, rapellez ſon deſeſpoir extrême, Quand Zama pris d’aſſaut le ſépara de vous:	pouvez-vous douter que ce Prince vous aime, Madamé, rappelez son désespoir extrême, Quand Zama pris d'assaut le sépara de vous:
Ce malheureux Amant dans ſon juſte couroux, Guidé par ſa fureur s’alloit ôter la vie, 2 Je deſarmay ſon bras au ſeul nom d’Iſperie, Et peut-eſtre.	Ce malheureux Amant dans son juste courroux, Guidé par sa fureur s'allait ôter la vie, 2 Je désarmai son bras au seul nom d'Ispérie, Et peut-être.
ISPERIE.	ISPERIE.
Dequoy viens-tu m’entretenir?	Dequoy viens-tu m'entretenir?
Pourquoy me rapeller ce triſte ſouvenir?	Pourquoi me rappeler ce triste souvenir?
O nuit!	Ô nuit!
qui preceda la fatale journée Qui devoit éclairer un heureux hymenée!	qui précéda la fatale journée Qui devait éclairer un heureux hyménée!
Au lieu de me livrer au malheur qui me ſuit, Que n’es-tu devenuë.	Au lieu de me livrer au malheur qui me suit, Que n'es-tu devenue.
une éternelle nuit?	une éternelle nuit?
Lors qu’on vint nous donner de ſi vives allarmes, Que tout retentiſloit de l’affreux bruit des armes, Que le fer à la main je vis tant de ſoldats En foule en mon Palais précipiter leurs pas;	Lors qu'on vint nous donner de si vives alarmes, Que tout retentislait de l'affreux bruit des armes, Que le fer à la main je vis tant de soldats En foule en mon Palais précipiter leurs pas;
Il t’en doit ſouvenir, dans tes bras Ermilie Je demeuray long-temps immobile & ſans vie, Scipion m’aperçlit, ſon zele officieux Me prêta du ſecours, me fit ouvrir les yeux, A ſon air, à ſon port je connus ce grand homme, La terreur de Cartage & la gloire de Romne, Et ſans qu’il eût beſoin qu’on prononçât ſon nom, Son front majeſtueux découvſScipion, Depuis de mille ſoins je luy ſuis redevable;	Il t'en doit souvenir, dans tes bras Ermilie Je demeurai longtemps immobile et sans vie, Scipion m'aperçlit, son zèle officieux Me prêta du secours, me fit ouvrir les yeux, À son air, à son port je connus ce grand homme, La terreur de Carthage et la gloire de Romaine, Et sans qu'il eût besoin qu'on prononçât son nom, Son front majestueux découvsScipion, Depuis de mille soins je lui suis redevable;
Cependant aujourd’huy c’eſt luy ſeul qui m’accable Il fait couler mes pleurs malgré tant de vertus, Et ſans luy je ſerois unie à Lucejus.	Cependant aujourd'hui c'est lui seul qui m'accable Il fait couler mes pleurs malgré tant de vertus, Et sans lui je serais unie à Lucejus.
2	2
ERMILIE.	ERMILIE.
Madame pouvez-vous murmurer de ſa chaîne?	Madame pouvez-vous murmurer de sa chaîne?
Ce Heros vous regarde & traite en ſouveraine, Vôtre nom dans Zama ſeroit moins reſpecté, Vous eſtes dans ſon Camp en pleine liberté, Sans gardes, ſans témoins, il met toute ſa gloire A vous faire oublier cette triſte victoite, Et ſi je m’en raporte à des regards plus doux, Le ſeul reſpect n’eſt pas tout ce qu’il ſent pour vous.	Ce Héros vous regarde et traite en souveraine, Votre nom dans Zama serait moins respecté, Vous êtes dans son Camp en pleine liberté, Sans gardes, sans témoins, il met toute sa gloire À vous faire oublier cette triste victoite, Et si je m'en rapporte à des regards plus doux, Le seul respect a pas tout ce qu'il sent pour vous.
ISPERIE.	ISPERIE.
Helas!	Hélas!
trop attentive à mon deſtin funeſte, Je ſonge à mon Amant & néglige le reſte, Tous les autres objets me touchent foiblement, Qu’un cœur eſt malheureux d’aimer ſi teudrement?	trop attentive à mon destin funeste, Je songe à mon Amant et néglige le reste, Tous les autres objets me touchent faiblement, Qu'un cœur est malheureux d'aimer si teudrement?
Mais ce Prince m’oublie & j’en ſuis outragée, Il n’y faut plus penſer pour en eſtre vangée, Dans un lâche repos s’il eſt enſevely, Il merite ma haine, ou plûtôt mon oubly;	Mais ce Prince m'oublie et j'en suis outragée, Il n'y faut plus penser pour en être vengée, Dans un lâche repos s'il est enseveli, Il mérite ma haine, ou plutôt mon oubli;
Me laiſſer ſi long-temps languir dans l’eſclavage?	Me laisser si longtemps languir dans l'esclavage?
Eſt-ce faute d’amour, ou faute de courage?	Est-ce faute d'amour, ou faute de courage?
Tous deux également me donnent de l’effroy, S’il manque de courage eſt-il digne de moy?	Tous deux également me donnent de l'effroi, S'il manque de courage est-il digne de moi?
Ce penſer contre luy me revolte, m’indigne, Et s’il manque d’amour en ſera-il plus digne?	Ce penser contre même me révolte, m'indigne, Et s'il manque d'amour en sera-il plus digne?
Mais que vois-je teſt-ce luy ?	Mais que vois-je test-ce même ?
grands Dieux !	grands Dieux !
, * 2 24.	, * 2 24.
:	:
i* πæ2 2 -- Source gallica.	j* æ2 2 -- Source gaillica.
bnf.	bnf.
fr ( Bibliothèque nationale de Francé	fr ( Bibliothèque nationale de Francé
SCENE II.	SCÈNE II.
LUCEJUS, ISPERIE, EMILIE, CELSUS.	LUCEJEUS, ISPERIE, EMILIE, CELS.
N'En doutez plus, Madame, & connoiſſez aujourd’huy Lucejus:	N'En doutez plus, Madame, et connaissez aujourd'hui Lucejus:
Le fidele Celſus fût captif de mon pere, Il le renvoya libre, & j’en ay le ſalaire, Ceit luy qui m a conauit prés de vous en cę lieux, je viens omer vos lcis;	Le fidèle Celsus fût captif de mon père, Il le renvoya libre, et j'en ai le salaire, Cit lui qui m' a conavit prés de vous en ç lieux, je viens ömer vos lis;
ou mouin u vos jeux.	ou mouin u vos jeux.
ISPERIE.	ISPERIE.
Ciel!	Ciel!
qu’entens-je?	qu'entends-je?
LUCEJUS.	LÙCEJEUS.
Voila le ſujet qui m’ameine, Mes ſoldats ſont cachez dans la foreſt prochaine, Juſqu’au prés de ce Camp nous ſommes parvenus Par des lieux écartez, des chemins inconnus, Je n’ay pris avec moy que des troupes d’élite, Indibilis m’attend, il en a la conduite, Avecque un Camp volant Mandonius le ſuit, Nous devons attaquer ce quartier cette nuit;	Voila le sujet qui m'amène, Mes soldats sont cachés dans la forêt prochaine, Jusqu'au prés de ce Camp nous sommes parvenus Par des lieux écartés, des chemins inconnus, Je n'ai pris avec moi que des troupes d'élite, Indibilis m'attend, il en a la conduite, Avec un Camp volant Mandonius le suit, Nous devons attaquer ce quartier cette nuit;
le n’ay fié qu’à moy le ſoin de reconnoiſtte, En quel endroit du Camp vos tentes pouvoient être, Je le ſçais à preſent, & j’en rends grace aux Dieux, Il faudra profiter & du temps & des lieux, Et ſi le Ciel répond à ce que je projete, Tout le Camp d’Annibal nous offre une retraite, Il n’eſt pas loin d’icy;	le n'ai fié qu'à moi le soin de reconnoistte, En quel endroit du Camp vos tentes pouvaient être, Je le sais à présent, et j'en rends grâce aux Dieux, Il faudra profiter et du temps et des lieux, Et si le Ciel répond à ce que je projette, Tout le Camp d'Hannibal nous offre une retraite, Il n'est pas loin d'ici;
mais j’ay voulu ſans luy Tenter ce grand effort que je fais aujourd’huy;	mais j'ai voulu sans mou Renter ce grand effort que je fais aujourd'hui;
Je craignois qu’Annibal par ſa lente prudence Ne ſervit mal ma flâme & mon impatience:	Je craignais qu'Hannibal par sa lente prudence Ne servît mal ma flamme et mon impatience:
Ainſi, ſans differer.	Ainsi, sans différer.
Madame, vous tremblez;	Madame, vous tremblez;
Vos ſens ſont interdits, vos eſprits ſont troublez, Vous he répondez rien, & vous verſez des larmes,	Vos sens sont interdits, vos esprits sont troublés, Vous hé répondez rien, et vous versez des larmes,
ISPERIE.	ISPERIE.
Que je ſenens pour vous de mortenes anarmes 3 Qu'aſlez-vous entreprendre?	Que je senends pour vous de mortenes anarmes 3 Qu'aslez-vous entreprendre?
& qui peut m’aſſurer Du ſuccés.	et qui peut m'assurer Du succès.
LUCEJUS.	LÙCEJEUS.
Ouy, Madame, il faut tout eſperer, A quiconque aime bien il n’eſt rien d’impoſſible, L'ardeur de vous ſervir doit me rendre invincible, erle loit me tranit, oun je meuis au moins, Madame, vos beaux yeux en ſeront les témoins, J'auray fait mon devoir s’il ni’en coûte la vie, Du moins je la perdray pour ſauver Iſperie.	Oui, Madame, il faut tout espérer, À quiconque aime bien il n'est rien d'impossible, L'ardeur de vous servir doit me rendre invincible, erle loit me tranit, oun je meuis au moins, Madame, vos beaux yeux en seront les témoins, J'aurai fait mon devoir s'il nien souste la vie, Du moins je la perdrai pour sauver Ispérie.
ISPERIE.	ISPERIE.
Et c’eſt ce que je crains, que pourez-vous, ah Dieux?	Et c'est ce que je crains, que pourrez-vous, ah Dieux?
vous allez auaquerun caip victoneux, Vous perirez, Seigneur, & tout me le fait croire, Vous allez contre vous irriter la victoire, Je vous verray ſanglant, & tout percé de coups, Tomber peut-être.	vous allez avaquerun caip victoneux, Vous périrez, Seigneur, et tout me le fait croire, Vous allez contre vous irriter la victoire, Je vous verrai sanglant, et tout percé de coups, Tomber peut-être.
Si je puis.	Si je puis.
LUCEJUS.	LÙCEJEUS.
Helas!	Hélas!
que mon ſort ſera doux	que mon sort sera doux
ISPERIE.	ISPERIE.
Non, Seigneur, gardez-vous d’entrepreudre, Si je l’ay ſouhalté, je dois vous le défeudre;	Non, Seigneur, gardez-vous d'entrepreudre, Si je l'ai souhalté, je dois vous le défeudre;
L’oin de vous j’accuſois vôtre trop de lenteur, J'allois juſqu’à douter même de vôtre cœur:	Loin de vous j'accusais votre trop de lenteur, J'allais jusqu'à douter même de votre cœur:
Pardonnet-moy, j'étois injuſte, criminelle, De ſoupçonner ce cœur genereux & fidelle:	Pardonnet-moi, j'étais injuste, criminelle, De soupçonner ce cœur généreux et fidèle:
Mals enfin, grace au Ciel, je vous vois de retour, Et je rettouve en vous un Hetos plein d’amour, C’eſt aſſez.	Mals enfin, grâce au Ciel, je vous vois de retour, Et je retouve en vous un Hétos plein d'amour, C'est assez.
LUEEJUS.	LUEEJUS.
Non, Madame, il faur tantôt me ſuivre, Ou choiſir de me voir dans peu ceſſer de vivre, Diſſipez vos chagrins, & n’ayez point d’effroy, Cette entrepriſe eſt digne & de vous & de moy.	Non, Madame, il saur tantôt me suivre, Ou choisir de me voir dans peu cesser de vivre, Dissipez vos chagrins, et n'ayez point d'effroi, Cette entreprise est digne et de vous et de moi.
Hé quoy donc Selpion vous peut voir à toute heuVous le ſouſſrez helas!	Hé quoi donc Selpion vous peut voir à toute heuVous le soussrez hélas!
quand il faut que je meure, Il joüit des momens qui m’eſtoient deſtinez, Je Cor deiolu de vous ote jeuse ſsostensl, Vous le voyez ſouvent, pardonnez-moy, Madame, L’éelat de ſa grandeur pouroit toucher une ame, Il a trop de vettus, & ion tranſport jaloux.	quand il faut que je meure, Il jouit des moments qui m'étaient destinés, Je Cor deiolu de vous ote jeuse ssostensl, Vous le voyez souvent, pardonnez-moi, Madame, L'éelat de sa grandeur pourrait toucher une âme, Il a trop de vettus, et an sport jaloux.
ISPERIE.	ISPERIE.
Il a tout le reſpect que j’attendrois de vous, Sa bonté, ſa elemence, enlevent mon eſtime, Je ne m’en défens point puiſqu’elle eſt legitime?	Il a tout le respect que j'attendrais de vous, Sa bonté, sa élémence, enlèvent mon estime, Je ne m'en défends point puisqu'elle est légitime?
Mais enfin Scipion n’eſt point vôtre rival, Il n’aime que la gloire, & ne hait qu’Annibal.	Mais enfin Scipion n'est point votre rival, Il n'aime que la gloire, et ne hait qu'Hannibal.
LUCEJUS.	LÙCEJEUS.
Moy, je hay ce Romain dont vous portez la chaint, Et pour luy mon eſtime eſt égale à ma haine;	Moi, je hais ce Romain dont vous portez la chaint, Et pour lu mon estime est égale à ma haine;
Mais, Madame, ſongez qu’il fait tous nos malheura, Vous devez le haïr, il vous coûts des pleurs, Il nous a ſepatez, & je ſuis à la gêne, De vous voir dans ſon Camp encor porter ſa chalne.	Mais, Madame, songez qu'il fait tous nos malheura, Vous devez le haïr, il vous coûts des pleurs, Il nous a sepattez, et je suis à la gêne, De vous voir dans son Camp encor porter sa chalne.
Non, non, & cette nuit il en faudra ſortir, Ou j’itay.	Non, non, et cette nuit il en faudra sortir, Ou j'itai.
ISPERIE.	ISPERIE.
Non, Seigneur, je n’y puis conſentir, Annibal vient bien-tôt, attendons ſa venue, Aprenons le ſuccés d’une telle entrevüe, Il va parler de paix, j’auray la liberté, Et novs ſeross tous deux compris dans le traité;	Non, Seigneur, je n'y puis consentir, Hannibal vient bientôt, attendons sa venue, Aprenons le succès d'une telle entrevue, Il va parler de paix, j'aurai la liberté, Et nous seross tous deux compris dans le traité;
Peut-eſtre ſans riſquer une ſi chere vie Demain en liberté vous verrez Iſperie, Ne précipitez rien, Seigneur, retirez-vous, Je tremble qu’en ces lieux quelqu’un ne vienne à nous;	Peut-être sans risquer une si chère vie Demain en liberté vous verrez Ispérie, Ne précipitez rien, Seigneur, retirez-vous, Je tremble qu'en ces lieux quelqu'un ne vienne à nous;
Si vous tardez long-temps on peut vous y ſurprendre;	Si vous tardez longtemps on peut vous y surprendre;
Sut tout, au nom des Dieux, avant que d’entreprendre, Si j'ay ſur vôtre cœur de veritables droits, e pretenos vous parler une Ieconde fois, Seigneur ſuivez Celſus en qui je me confie, Il poura dans ſa tente aſſurer vôtre vie, Attendez quelque temps.	Sut tout, au nom des Dieux, avant que d'entreprendre, Si j'ai sur votre cœur de véritables droits, e pretenos vous parler une Jéconde fois, Seigneur suivez Celsus en qui je me confie, Il pourra dans sa tente assurer votre vie, Attendez quelque temps.
LUCEJUS.	LÙCEJEUS.
Madame j’obéis.	Madame j'obéis.
Mais enfin, ſi vos-vœux & les miens ſont trahis Vous partirez.	Mais enfin, si vos-vœux et les miens sont trahis Vous partirez.
ISPERIE.	ISPERIE.
Seigneur, je promets de vous ſuivre, Et même de muiril ſi vous ceſſez de vivre.	Seigneur, je promets de vous suivre, Et même de muiril si vous cessez de vivre.
& 16 E Il fort avee Celſus.	et 16 E Il fort avée Celsus.
SCENE III.	SCÈNE III.
NSIERIE, ERMILIE.	NSIERIE, ERMILIE.
ISPERIE.	ISPERIE.
Preſent je reſpire!	Présent je respire!
il a rempli mes vœux, A ACet Amant que je vois ſidelle & genereux, De tant de mouvemens dont j’avois l’ame atteinte, Il ne me reſte plus que l’amour & la crainte;	il a rempli mes vœux, A CEt Amant que je vois sidelle et généreux, De tant de mouvements dont j'avais l'âme atteinte, Il ne me reste plus que l'amour et la crainte;
Mais helas!	Mais hélas!
quelle eſt vive & ſenſible à mon cœur?	quelle est vive et sensible à mon cœur?
Ie ſens mille tranſports de joye & de douleur, Il eſt digne de moy, je dois trop le connoſtrei Mais il va s’expoſer, &perira peut-eſtre;	Je sens mille transports de joie et de douleur, Il est digne de moi, je dois trop le connaîtrei Mais il va s'exposer, etperira peut-être;
Que dis-je, ſon amour va tenter un effort Qui luy feia trouver Scipion & la mort;	Que dis-je, son amour va tenter un effort Qui lui fejà trouver Scipion et la mort;
Juſtes Dieux?	Justes Dieux?
détournez ce funeſte préſage!	détournez ce funeste présage!
Inſpirez Annibal pour la paix de Caitage !	Inspirez Hannibal pour la paix de Caitage !
C’eſt ma ſeule eſperance en cette occaſion, Et ſur tout portez y le cœur de Scipion:	C'est ma seule espérance en cette occasion, Et sur tout portez y le cœur de Scipion:
Il vient, que me veut-il?	Il vient, que me veut-il?
SCENE IV.	SCÈNE IV.
SCIPION, ISPERIE,ERMILIE,	SCIPION, ISPERIE,ERMILIE,
SCIPION.	SCIPION.
E vous cherchois, Madame;	E vous cherchais, Madame;
Mais quel trouble uouveau frape & ſaiſit vôtre ame!	Mais quel trouble ouveau frappe et saisit votre âme!
Etonnée, interdite, à mon premier abord, Je vois combien pour moy vous vous faites d’effort.	Étonnée, interdite, à mon premier abord, Je vois combien pour moi vous vous faites d'effort.
ISPERIE.	ISPERIE.
Seigneur, ne croyez pas.	Seigneur, ne croyez pas.
QCIPION.	QCIPION.
Ma preſence vous gêne, Et je ſeray toujours l’objet de vôtre haine, Je la merite peu cepeudant.	Ma présence vous gêne, Et je serai toujours l'objet de votre haine, Je la mérite peu cepeudant.
ISPERIE.	ISPERIE.
Moy, Seigneur?	Moy, Seigneur?
Vous haïr?	Vous haïr?
mon reſpect vous répond de mon cœur, Et j’ay pour vos vertus une ſi haute eſtime.	mon respect vous répond de mon cœur, Et j'ai pour vos vertus une si haute estime.
SCIPION.	SCIPION.
Madame, vous croyez la haine legitime, La priſe de Zama vous a coûté des pleurs, Du Prince vôtre Amant j’ay cauſé les malheurs, Et vous vout en plaignez du moins ſans vous contraindre, Il eſt d’autres malheurs dont on n’oſe ſe plaindre.	Madame, vous croyez la haine légitime, La prise de Zama vous a coûté des pleurs, Du Prince votre Amant j'ai causé les malheurs, Et vous vout en plaignez du moins sans vous contraindre, Il est d'autres malheurs dont on n'ose se plaindre.
ISPERIE.	ISPERIE.
Seroit-il des malheurs comparables aux ſiens?	Serait-il des malheurs comparables aux siens?
Tout prêts à nous unir par les plus beaux liens, Ce jeune Prince helas!	Tout prêts à nous unir par les plus beaux liens, Ce jeune Prince hélas!
attendoit la journée Qui devoit couronner un pompeux hymenée, Pardonnez-moy, Seigneur, ce triſte ſouvenir, De ma memoire encor je ne puis le bannir, C’eſt vous qui luy cauſez les malheurs de ſa vie, Etrant, infortunê, ſeparé d’Iſperie, Il nourit loin de moy d’inutiles regrets, Peut-eſtre ſes tourmens ne ſinitont jamais;	attendait la journée Qui devait couronner un pompeux hyménée, Pardonnez-moi, Seigneur, ce triste souvenir, De ma mémoire encor je ne puis le bannir, C'est vous qui lui causez les malheurs de sa vie, Etrant, infortuné, séparé d'Ispérie, Il nourit loin de moi d'inutiles regrets, Peut-être ses tourments ne sinitont jamais;
Si vous aimiet, Seigneur, vous ſçauriez par vousmême Dans quel afreux tourment eſt un cœur quand il aime, Et qu’il eſt ſeparé de l’objet de ſes vœux?	Si vous aimiet, Seigneur, vous sauriez par vousmême Dans quel afreux tourment est un cœur quand il aime, Et qu'il est séparé de l'objet de ses vœux?
Helas!	Hélas!
qu’il eſt à plaindre?	qu'il est à plaindre?
& qu’il eſt malheureux?	et qu'il est malheureux?
Que ſon triſte deſtin.	Que son triste destin.
SCIPION.	SCIPION.
Qu’il eſt digne d’envie!	Qu'il est digne d'envie!
Peut-on rien ajoûter au bonheur de ſa vie?	Peut-on rien ajouter au bonheur de sa vie?
Lucejus eſt choiſi pour eſtre vôtre époux, Alis peu cie cop, il taue comouttse dſus vôtre ame, Et bannir pour jamais cette inutile flâme.	Lucejus est choisi pour être votre époux, Alis peu cie op, il tave comoutse dsus votre âme, Et bannir pour jamais cette inutile flamme.
ISPERIE.	ISPERIE.
Moy!	Moi!
Seigneur?	Seigneur?
SCIPION.	SCIPION.
Ouy, pour vous Rome a d’autres deſſeins, Et puiſqu’il eſt enfin ennemy des Romains Cet Amant, qu’il combat contre la Republique, Tout s’opoſe à ſes vœux, raiſon, & politique, Pouroit- Poutoit-elle ſouffrir qu’il devint vôtre époux?	Oui, pour vous Rome a d'autres desseins, Et puisqu'il est enfin ennemi des Romains Cet Amant, qu'il combat contre la République, Tout s'oppose à ses vœux, raison, et politique, Pourait-à Poutait-elle souffrir qu'il devînt votre époux?
Et d’ailleurs cet hymen eſt indigne de vous.	Et d'ailleurs cet hymen est indigne de vous.
ISPERIE.	ISPERIE.
Lucejus eſt né Prince.	Lucejus est né Prince.
SCIPION.	SCIPION.
Et fuſt-il Roy, Madame, Il ne merite point une ſi belle flâme?	Et fût-il Roi, Madame, Il ne mérite point une si belle flamme?
Que vous connoiſſez peu le prix de vôtre eœur?	Que vous connaissez peu le prix de votre eœur?
Vous igaorez encor juſqu’à quel point d’hõneur.	Vous igaorez encor jusqu'à quel point d'honneur.
Non, à vôtre merite il n’eſt rien qui réponde, Il eſt trop au deſſus de tous les Rois du monde, Et poul Micuis louceula l'houueur de votle cholx, Il faut un des vainqueurs, un des maiſtres des Rois, En un mot, un Romain.	Non, à votre mérite il n'est rien qui réponde, Il est trop au dessus de tous les Rois du monde, Et poul Micuis louceula l'houueur de votle cholx, Il faut un des vainqueurs, un des maîtres des Rois, En un mot, un Romain.
ISPERIE.	ISPERIE.
ba grandeur, la fortune Cut faire impreſſion ſur une ame commune;	ba grandeur, la fortune Cut faire impression sur une âme commune;
Mais quoy!	Mais quoi!
tout ſon éclat mis dans ſon plus beau dout.	tout son éclat mis dans son plus beau dout.
N’ébloüit point un cœur éclairé par l’amour.	N'éblouit point un cœur éclairé par l'amour.
SCIPION.	SCIPION.
Quoy?	Quoi?
vous pouriez, Madame?	Vous pourriez, Madame?
ISPERIE.	ISPERIE.
Eh!	Eh!
Seigneur, que m’importe Que ces vainqueurs des Rois.	Seigneur, que m'importe Que ces vainqueurs des Rois.
Mais helas!	Mais hélas!
je m’emporte, e uois les ſeipecter, ce je iuis uans leuts fers;	je m'emporte, e utz les seipecter, je je us luant luts fers;
Qu’à leur gré les Romains gouvernent l’Univers, Tout doit fléchir ſous eux?	Qu'à leur gré les Romains gouvernent l'Univers, Tout doit fléchir sous eux?
Mais encor à quels titres Veuleut-ils de nos cœurs devenir les arbitres?	Mais encor à quels titres Veut-ils de nos cœurs devenir les arbitres?
CIPION.	CIPION.
Il faut juſtifier, Madame, leurs deſſeins, Et vous aprendre icy l’intereſt des Romains;	Il faut justifier, Madame, leurs desseins, Et vous apprendre ici l'intérêt des Romains;
C Pour readre ſa puiſſance & ſa gloire affetmie, Rome ne peut ſouffrit d’alliance ennemie, Syphax, ce.	Ç Con readre sa puissance et sa gloire affethie, Rome ne peut souffrit d'alliance ennemie, Syphax, ce.
Roy ſuperbe a payé chęrement La fatale douceur d’un tel eugagement:	Roi superbe a payé chuerrement La fatale douceur d'un tel eugagement:
Il eſtoit nôtre amy;	Il était notre ami;
mais de dangereux charmes Luy firent contre nous ſoudain prendre les armes, Sophon ſos luy plût, il devint ſon époux, LMidame, elle eſtoit belle, & moins belle que vous La fille d’Aſdrubal a donc ſȩù le détruire, Ec vient de luy coûter la vie avec l’Empite;	mais de dangereux charmes Lui firent contre nous soudain prendre les armes, Sophon sos Ah plût, il devint son époux, LMidame, elle était belle, et moins belle que vous La fille d'Asdrubal a donc sȩù le détruire, Ec vient de lui jours la vie avec l'Empite;
D’un Chef Cartaginois, du fameux Hyerbal Iſperie eſt la fille, & niéce d’Annibal, Plus charmante cent fois, plus redoutable encore, Et Rome fouffriroit quaud Lucejus l’adore, Qu’il unit à Cartage avee de tels liens Tout le peuple nombreux des Celtiberiens;	D'un Chef Carthaginais, du fameux Hyerbal Ispérie est la fille, et nièce d'Hannibal, Plus charmante cent fois, plus redoutable encore, Et Rome souffrirait quaud Lucejus l'adore, Qu'il unît à Carthage ave de tels liens Tout le peuple nombreux des Celtibériens;
Si Sophoniſbs ſeule a couté trois batailles, Combien coûcerlez-vous de ſang, de funerailles?	Si Sophonisbs seule a couté trois batailles, Combien coucerlez-vous de sang, de funérailles?
Vous pouriez ſoûlever vingt letiotot cuuemis, Unir Mandonius avecque Indibilis, Et ſuſcitant à Rome une éternelle guerre, Vos yeux pouroient contr’elle armer toute la terre.	Vous pourriez soulever vingt letiot cuémis, Unir Mandonius avec Indibilis, Et suscitant à Rome une éternelle guerre, Vos yeux pourraient contr'elle armer toute la terre.
ISPERIB.	ISPERIB.
Mais ſi la paix, Seigneur, par de plus doux projeto Pouvoit unir nu jour.	Mais si la paix, Seigneur, par de plus doux projeto Pouvait unir nu jour.
SCIPION.	SCIPION.
Madame, point de paix, Point d’accord, c’eſt euvain en former l’eſperaute, Il faut de Rome, il faut pourſuivre la vangeance, On me l’a confiée, & j’en dois prendre ſoin, Et ſi j’en erois mon cœur je la porteray loin, Ma dame, vous pleurez.	Madame, point de paix, Point d'accord, c'est eunain en former l'espéraute, Il faut de Rome, il faut poursuivre la vengeance, On me l'a confiée, et j'en dois prendre soin, Et si j'en erais mon cœur je la porterai loin, Ma dame, vous pleurez.
I	I
ISPERIE.	ISPERIE.
Il faut bien que je pleure, Puiſque par cet Atreſt vous voulez que je meure;	Il faut bien que je pleure, Puisque par cet Atrêt vous voulez que je meure;
Vous ſerez ſatisfait, cet ordre rigoureux Dans peu ſera perir deux Amans malheureux, Nous avions dans la paix encor quelque eſperance, Mais vous voulez de Rome achever la vangeance.	Vous serez satisfait, cet ordre rigoureux Dans peu sera périr deux Amants malheureux, Nous avions dans la paix encor quelque espérance, Mais vous voulez de Rome achever la vengeance.
Achevez-là, Seigneur, mais du moins le trépas, Au deſaut de la paix ne nous manqueta pas.	Achevez-la, Seigneur, mais du moins le trépas, Au désaut de la paix ne nous manqueta pas.
SCENE.	SCÈNE.
V	V
SCIPION ſeul.	SCIPION seul.
Lle ſort,juſte Ciel!	Lle sort,juste Ciel!
& ſes yeux pleins de larmee LAtteudriſſent mon cœur, & m’atrachent les ajmes, Je ſuis pret d’oublier ma glolre, mes ptojets, Et preſqu'en ce moment je conſens à la paix;	et ses yeux pleins de larmée LAteudrissent mon cœur, et m'atrachent les ajmes, Je suis prêt d'oublier ma glolère, mes ptojets, Et presqu'en ce moment je consens à la paix;
Ouy, puiſqu'elle le veut, il faut finir la guerre, En rendre un plein repos, un plein çalme à la terte;	Oui, puisqu'elle le veut, il faut finir la guerre, En rendre un plein repos, un plein çalme à la terte;
Mais quel triſte penſer me frape en ce moment?	Mais quel triste penser me frappe en ce moment?
Elle ne veut la paix que pour voir ſon Amant, Que pour combler ſes vœux d’un heuteux hymenée, Et j’en avancerois la fatale journée?	Elle ne veut la paix que pour voir son Amant, Que pour combler ses vœux d'un heuteux hyménée, Et j'en avancerais la fatale journée?
C’eſt donc pour Lucejus qu’elle aſpire à la paix:	C'est donc pour Lucejus qu'elle aspire à la paix:
Qu’elle l’aime grands Dieux!	Qu'elle l'aime grand Dieux!
grands Dieux que je le hais?	grands Dieux que je le hais?
Mais pourquoy ſon nom ſeul me fait-il de la peine?	Mais pourquoi son nom seul me fait-il de la peine?
D’où vient que Lucejus eſt l’objet de ma haine?	D'où vient que Lucejus est l'objet de ma haine?
e i D’où vieut que contre luy je me trouve animé?	Je me J'où vieut que contre lui je me trouve animé?
Dieux!	Dieux!
par quelles raiſons?	par quelles raisons?
Lucejus eſt aimé?	Lucejus est aimé?
Les voila ces raiſons?	Les voilà ces raisons?
& mon ame ſaiſie.	et mon âme saisie.
Ah!	Ah!
je te reconnois affreuſe jalouſie, Tu viens porter la haine & le trouble en mon cœui, Et tu me fais ſentir que l’amour eſt vainqueur, Dans quel temps?	je te reconnais affreuse jalousie, Tu viens porter la haine et le trouble en mon cœui, Et tu me fais sentir que l'amour est vainqueur, Dans quel temps?
dans le temps qu’Annibal va paroitre, Et que de mes tranſports je dois eſtre le malire, pouſſe des ſoûpirs, je m’égate, ah du moins De mes égaremens je n’ay point de témoins;	dans le temps qu'Hannibal va paraître, Et que de mes transports je dois être le malire, pousse des soupirs, je m'égate, ah du moins De mes égarements je n'ai point de témoins;
Mais dois-je ſuccomber au panchant qui m’ent tralue, Puniſſons Iſperie en voyant Erixene, Mépriſons ſes attraits, & peut-être en ce jour Qu'Erixene ſçaura détrujte cet amour:	Mais dois-je succomber au penchant qui m'ent tralue, Punissons Ispérie en voyant Erixène, Méprisons ses attraits, et peut-être en ce jour Qu'Érixène saura détrujte cet amour:
Je veux rendre un hommage éclatant à ſes charmes, Abandonnons des yeux toujours noyez de larmel, Tout le veut, la faiſon, la gloire, l'équité, Il faut par d’autre fers me mettre en liberté.	Je veux rendre un hommage éclatant à ses charmes, Abandonnons des yeux toujours noyez de larmel, Tout le veut, la saison, la gloire, l'équité, Il faut par d'autre fers me mettre en liberté.
ACTE III SCENE PREMIERE, ERIXENE, RARCE,	ACTE III SCÈNE PREMIÈRE, ERIXENE, RARCE,
BARCE'.	BARCE'.
Auipis que Scipion fait ranger ſon armée, Que pour en ſoûtenir l'éclat, la renommée Il en veut étaler la pompe à ſon rival, (Spectacle digne enſin des regards d’Aunibal) En attendant qu’icy nous le voyons paroltre, De grace, aprenez-moy ſi ce ſuperbe maltre, Ce fameux Scipion qui marchoit ſur vos pas A reudu les reſpects qu’il doit à vos apass Ouy, ſon front deſatmé de la fierté Romaine Sembloit le préparer à porter vôtre chaîne;	Auipis que Scipion fait ranger son armée, Que pour en soutenir l'éclat, la renommée Il en veut étaler la pompe à son rival, (Spectacle digne ensin des regards d'Aunibal) En attendant qu'ici nous le voyons paraître, De grâce, apprenez-moi si ce superbe maltre, Ce fameux Scipion qui marchait sur vos pas A udu les respects qu'il doit à vos appass Ouy, son front des front des fierté Romaine Semblait le préparer à porter votre chaîne;
Loin de vous par reſpect je n’ay pas entendu Aſſez diſtinctement cet nomage lemau;	Loin de vous par respect je n'ai pas entendu Assez distinctement cet nomage lemau;
Mais helas!	Mais hélas!
je vous vois les yeux pleins de triſteſſe, A cacher vos chagrins vous mettez vôtre adreſſe, Vous ne répondez rien, vous devorez vos pleurs Madame, & ce ſilence.	je vous vois les yeux pleins de tristesse, A cacher vos chagrins vous mettez votre adresse, Vous ne répondez rien, vous dévorez vos pleurs Madame, et ce silence.
ERIXENE.	ERIXENE.
Aprens tous mes malheur, C iij Barcé, puiſque tu veux que je t’en rende conte, Aprens ma paſſion, ma douleur, & ma-honte;	Apprends tous mes malheurs, Ç ij Aillé, puisque tu veux que je t'en rende compte, Apprends ma passion, ma douleur, et ma-honte;
Que les yeux d’une Amante helas I, ſont clairvoyans?	Que les yeux d'une Amante hélas I, sont clairvoyants?
’ay vû de Scipion les feux les plus ardans, Il m’eſt venu jrouver pour m’en faire un homage, Mais que ſon cœur ah Dieux!	V'ai vu de Scipion les feux les plus ardans, Il m'est venu jrouver pour m'en faire un hommage, Mais que son cœur ah Dieux!
démentoit ſon lan A lon diſcours conſhs, ſon air embaraſſé, ’ay vû qu’il me rendoit un homage forcé;	démentait son lan A lon discours conshs, son air embarrassé, 'ai vu qu'il me rendait un hommage forcé;
Au nom de Lucejus toute ſa jalouſie Me l’a fait voir remply des charmes d’Iſperie, Il la cherchoit encore en voulant me parler, ATuecouuoit uy ieu qu'il tâchoit de celer, Et ſon aveu pour moy d’une ſlame fatale M'a fait voir ſeuſement qu’il aimoir ma mavale.	Au nom de Lucejus toute sa jalousie Me l'a fait voir rempli des charmes d'Ispérie, Il la cherchait encore en voulant me parler, ATuecouuoit uy jeu qu'il tâchait de celer, Et son aveu pour moi d'une slâme fatale M'a fait voir seusement qu'il aimoir ma mavale.
BARCE.	BARCE.
Que dites-vous?	Que dites-vous?
ah Ciel!	ah Ciel!
ERIXENE.	ERIXENE.
Tout ce que j’ay trop vû, Ce que mon triſte cœur avoit déja prévû, Ouy, j’ay de mes malheurs l’affreuſe certitude, Et n’ay plus la douceur de mon inquietude;	Tout ce que j'ai trop vu, Ce que mon triste cœur avait déjà prévu, Oui, j'ai de mes malheurs l'affreuse certitude, Et n'ai plus la douceur de mon inquiétude;
Ce n’eſt pas qu’il n’ait fait d’inutiles eſfors Pour s’arracher luy-même à ſes premiert tranſports:	Ce n'est pas qu'il n'ait fait d'inutiles éfors Pour s'arracher Ah-même à ses premiert transports:
Je voyois qu’iltachoit de me rendre les armes, Qu’il vouloit tout entier ſe livrer à mes chatmes, Qu’il combattoit en vain contre un cœur mutiné Qui ſuivoit malgré luy ſon panchant obſtiné:	Je voyais qu'iltachait de me rendre les armes, Qu'il voulait tout entier se livrer à mes chatmes, Qu'il combattait en vain contre un cœur mutiné Qui suivait malgré sans son penchant obstiné:
En parlant d’Iſperie un dédain legitime Affectoit un mépris qui marquoit ſon eſtime, Il vouloit à mes yeux rabaiſſer ſes attraits, Mais les ſiens me ſembloient égarez & diſtraits:	En parlant d'Ispérie un dédain légitime Affectait un mépris qui marquait son estime, Il voulait à mes yeux rabaisser ses attraits, Mais les siens me semblaient égarés et distraits:
Il nommoit Iſperie, il nommoit Erixene, Il monttoit de l’amour, il marquoit de la hainé, Il s’eſſorcoit Barcé d’aimer & de haïr, Et ſon cœur en ſuſpens refuſoit d’obéïr.	Il nommait Ispérie, il nommait Erixène, Il montait de l'amour, il marquait de la hainé, Il s'essorcait Barcé d'aimer et de haïr, Et son cœur en suspens refusait d'obéir.
RARCÉ'.	RARC'.
Mais, Madame, aprés tout s’il adore Iſperie, Son ame d’un tel feu doit eſtre aſſez puuie, Elle aime Lucejut, & leurs cœurs embraſezPunitont Scipion de vos ſeux meprilez, Sa tendreſſe.	Mais, Madame, après tout s'il adore Ispérie, Son âme d'un tel feu doit être assez puvie, Elle aime Lucejut, et leurs cœurs embrasPunitont Scipion de vos seux meprilez, Sa tendresse.
ERIXENE.	ERIXENE.
Et pourquoy ſans deſſein de luy pllird Me ravit-elle un cœur à ſes vœux ſi contraire?	Et pourquoi sans dessein de belle pllird Me ravit-elle un cœur à ses vœux si contraire?
Ou pourquoy ce Heros s’eſt-il laiſſé charmer.	Ou pourquoi ce Héros s'est-il laissé charmer.
D’un objet qui ne peut & ne dolt pas l'aimer?	D'un objet qui ne peut et ne dolt pas l'aimer?
Quand il voit aujourd'huy la ſuperbe Erixene Soûpiret s & courir au devant de ſa chaîne:	Quand il voit aujourd'hui la superbe Erixène Soupiret s et courir au devant de sa chaîne:
Iſpetie eſt aimée q ah jalouſe fureur!	Ispétie est aimée q ah jalouse fureur!
De mon cruel deſtin vois-tu toute l’horreur?	De mon cruel destin vois-tu toute l'horreur?
Il faut pour me vangér d’une ardeur ſi fatale r;	Il faut pour me venger d'une ardeur si fatale ;
Qu’il en coûte des pleurs, du ſang à ina rivale, Et mon cœur irrité ſera plus ſatisfait Si je puis la punir du vol qu’elle m’a fait:	Qu'il en coûte des pleurs, du sang à ina rivale, Et mon cœur irrité sera plus satisfait Si je puis la punir du vol qu'elle m'a fait:
Mais pourquoy la punir d’un crime involontaire?	Mais pourquoi la punir d'un crime involontaire?
C’eſt ſans doute à regret qu’elle a trop ſçû luy Phasse 2 Pourois-je l’accabler de mon inimitié Quand ſon ſort & le mien ſont dignes de pitié;	C'est sans doute à regret qu'elle a trop su feu Phasse 2 Pourais-je l'accabler de mon inimitié Quand son sort et le mien sont dignes de pitié;
On l’adore, & ſa flâme eſt ailleurs allumée 2 Et moy, j’aime un ingrat ſans eſpoir d’eſtre aimée.	On l'adore, et sa flamme est ailleurs allumée 2 Et moi, j'aime un ingrat sans espoir d'être aimée.
BARCE'.	BARCE'.
Que vôtre cœur ſi fier rapelle ſa raiſon, Madame, ſoûtenez l’éclat de vôtre nom.	Que votre cœur si fier rappelle sa raison, Madame, soutenez l'éclat de votre nom.
SCENE II.	SCÈNE II.
OUIADE, ERIAENE, BARCE,	OÙIADE, ERIANE, BARCE,
LEPIDE Noibal dans ces lieux à l'inſtant va ſe rendre, A ASelpion ſult mes pas, Madame, &vlent l’attenn J’ay dû vous avertir.	LEPIDE Noibal dans ces lieux à l'instant va se rendre, A SElpion sult mes pas, Madame, etvlent l'attenn J'ai dû vous avertir.
ERIXENE.	ERIXENE.
Bareé, retirons-nous.	Bare, retirons-nous.
Lepide, c’eſt aſſes.	Lépide, c'est asses.
Deu dcs auus.	 D auus.
SCIPION, LEPIDE.	SCIPION, LEPIDE.
SCIPION.	SCIPION.
MEsdeſirs empteſſez Seront bien-tot remplis, & ſuivant mon attente Je vais voir Annibal, Lepide, en cette tentes ’ay pour le recevoir ſait ranger mes ſoldats, Sextus va par mon ordre au devant de ſes pas, Je tends tous les honneurs qu'on doit à ce grane homme, Et je vais ſoûtenir les interêts de Rome?	MEsdesirs emptessez Seront bientôt remplis, et suivant mon attente Je vais voir Hannibal, Lépide, en cette tentes aay pour le recevoir sait ranger mes soldats, Sextus va par mon ordre au devant de ses pas, Je tends tous les honneurs qu'on doit à ce grane homme, Et je vais soutenir les intérêts de Rome?
Il faut reprendre iey toute ma fermeté, Oublier les tranſports de mon cœur agité, J’en ay tougy cent fois, & j’y fus trop ſenſible, A l’aſpect d’Annibal je dois eſtre inſlexible, Et je veux aujourd’huy plein d’une noble ardeur Malgré ma paſſion luy découvrir le cœur Iy uu Roinaus, d'uu Comus, de qui n politique Ne ſonge qu’à ſa gloire & qu’à la Republique.	Il faut reprendre Hy toute ma fermeté, Oublier les transports de mon cœur agité, J'en ai tougi cent fois, et j'y fus trop sensible, À l'aspect d'Hannibal je dois être inslexible, Et je veux aujourd'hui plein d'une noble ardeur Malgré ma passion même découvrir le cœur y Roinaus, d' Comus, de qui politique Ne songe sa gloire et la Republique.
LEPIDE.	LÉPIDE.
Sur vous de l'Univers vous attachez les yeux, Seigneur, & vos ſuccés vous font des envieux, Quine peuvent ſouffrit ſans quelque jalouſie.	Sur vous de l'Univers vous attachez les yeux, Seigneur, et vos succès vous font des envieux, Quine peuvent souffrit sans quelque jalousie.
Le éours trop éclatant de vôtre illuſtre vie:	Le épours trop éclatant de votre illustre vie:
Je n’oſe qu’à regret en prononeer le nom, Mais j'y compte, Seigneur, Fabius & Caton, Qui ſouvent contre vous animez d’un faux zele Fatiguent le Senat d’une plainte éternelle.	Je n'ose qu'à regret en prononcer le nom, Mais j'y compte, Seigneur, Fabius et Caton, Qui souvent contre vous animez d'un faux zèle Fatiguent le Sénat d'une plainte éternelle.
SCIPION.	SCIPION.
Je le ſçais trop.	Je le sais trop.
Lepide, & toujours Fabiue Atenté contre moy des efforts ſuperſlus, Il vouloit empêcher mon voyage en Affrique, Mais c’eſt l’eſprit jaloux de chaque Republiquel, Qui craint ſes citoyens dés qu’ils font trop:	Lépide, et toujours Fabive Atenté contre moi des efforts superslus, Il voulait empêcher mon voyage en Afrique, Mais c'est l'esprit jaloux de chaque Républiquel, Qui craint ses citoyens dés qu'ils font trop:
ſa:	sa:
meux, La vertu des Heros eſt un crime chez eux, Et lorſqu’on s’agrandit avec trop de courage L’éclat des Conquerans leur donne de l’ombrage?	meux, La vertu des Héros est un crime chez eux, Et lorsqu'on s'agrandit avec trop de courage L'éclat des Conquérants leur donne de l'ombrage?
Caton & Fabius en ont conçû pour moy, Et peut-eſtre en ſecret jaloux de monemploy, A me nuire au Senat l’un & l’autre s’aplique, Mais il faut terminer cette guerte d’Affrique, C’eſt à moy de remplir la gloite de mon ſort, le n’écoûteray rien ſi l’on parle d’accord, Il faut que par mon bras Cartage ſoit punie, Il faut vaincre Annibal & la guerre eſt finie, Il vient, que ſon abord inſpire de reſpect, Aux Gardes.	Caton et Fabius en ont conçu pour moi, Et peut-être en secret jaloux de monemploi, À me nuire au Sénat l'un et l'autre s'applique, Mais il faut terminer cette guerte d'Afrique, C'est à moi de remplir la gloite de mon sort, le n'écouterai rien si l'on parle d'accord, Il faut que par mon bras Carthage soit punie, Il faut vaincre Hannibal et la guerre est finie, Il vient, que son abord inspire de respect, Aux Gardes.
AIIGZ.	AIIGZ.
SCENE IV.	SCÈNE IV.
ANMDAL, SCIION, AORICCAR, LEPIDE, Gardes.	ANMDAL, SCIION, AORICAR, LÉPIDE, Gardes.
ANNIBAL recarde quelque tempi Scipion ſans parler.	ANNIBAL recarde quelque tempi Scipion sans parler.
OI j'ay paru ſurpris à vôtre aſpect, Et ſi quelques momens j’ay gardé le ſilence, Seigneur, accuſez-en vôtre auguſte preſence;	ÔI j'ai paru surpris à votre aspect, Et si quelques moments j'ai gardé le silence, Seigneur, accusez-en votre auguste présence;
On ne peut regarder ſans admiration L’éclat, la majeſté du fameux Scipion, Et mon étonnement eſt qu’en un ſi jeune âge, Vous ayez fait trembler Annibal pour Cartage:	On ne peut regarder sans admiration L'éclat, la majesté du fameux Scipion, Et mon étonnement est qu'en un si jeune âge, Vous ayez fait trembler Hannibal pour Carthage:
Il s’eſſiet.	Il s'essiét.
Ouy, Seigneur, je l’avouë, aprenant vos exploits Pour elle j’ay paly pour la premiere fois;	Oui, Seigneur, je l'avoue, apprenant vos exploits Pour elle j'ai pâli pour la première fois;
ay quitté l’Italie encor toute fumante, Et dont pendant ſeize ans mon nom ſit l’épouvantes J’avois compté pour peu tant de ſiers Generaux Qui furent ſi long-temps mes trop foibles rivaux, Et les jours de Trebie, & ceux de Thraſymene, Qui me firent raiſon de la fierté Romaine M’avoient accoûtumé d’en être le vainqueur, Tant de proſperitez devoient m'enſler le cœur;	ai quitté l'Italie encor toute fumante, Et dont pendant seize ans mon nom sit l'épouvantes J'avais compté pour peu tant de siers Généraux Qui furent si longtemps mes trop faibles rivaux, Et les jours de Trébie, et ceux de Thrasymène, Qui me firent raison de la fierté Romaine M'avaient accoutumé d'en être le vainqueur, Tant de prospérités devaient m'ensler le cœur;
Mais, Seigneur, vous venez d’un courage herolque Délivrer l’Italie en attaquant l’Affrique, Sans m’avoir combatu je vois avec regret Que vôtre bras détruit ce que le mien a fait:	Mais, Seigneur, vous venez d'un courage héroque Délivrer l'Italie en attaquant l'Afrique, Sans m'avoir combattu je vois avec regret Que votre bras détruit ce que le mien a fait:
Mon retour en ces lieux eſt vôtre grand ouvrage, Pouonton Movo isomocuudee uugc;	Mon retour en ces lieux est votre grand ouvrage, Pouonton Movovovisomocuude uugc;
Et pour elle aujourd’huy par de juſtes projets Vous voyez Annibal vous demander la paix.	Et pour elle aujourd'hui par de justes projets Vous voyez Hannibal vous demander la paix.
SCIPION.	SCIPION.
Je ne m’attendois pas qu’un ſi grand Capitaine Vint iey deſarmé de colere & de haine, Qu’Annibal ſi long-temps couronné de lauriers, Le modelle & l’effroy des plus fameux Guerriers, Noutey fronque doujoule du icinde la viccone, Put raſlentir en luy le deſir de la gloire, Et qu’un Heros illuſtre aprés tant de haut faits Pût jamais ſe reſoudre à demander la paix.	Je ne m'attendais pas qu'un si grand Capitaine Vint suivi désarmé de colère et de haine, Qu'Hannibal si longtemps couronné de lauriers, Le modèle et l'effroi des plus fameux Guerriers, Noutey fronque doujoule du icinde la viccone, Put raslentir en était le désir de la gloire, Et qu'un Héros illustre après tant de haut faits Pût jamais se résoudre à demander la paix.
ANNIBAL.	ANNIBAL.
Je le veux, je le dois:	Je le veux, je le dois:
la fortune éclatante Qui fuc aſſez long-temps pour moy ferme & conſtante, Ne m’a point ébloüy;	la fortune éclatante Qui suc assez longtemps pour moi ferme et constante, Ne m'a point ébloui;
ſes inégalitez ’ont fait voir quelquefois ſes inſi lelitez, t bien qu’elle ait paru s’attacher à mes traces, es faveuis m’ont inſtruit bien moins que ſes diſgraces.	ses inégalités aont fait voir quelquefois ses insi lelités, t bien t'elle ait paru s'attacher à mes traces, es faveuis m'ont instruit bien moins que ses disgrâces.
Pour vous, Seigneur, je crains qu’un éternel bonheur Du deſſein de la paix n’éloigne vôtre cœur, Juſqu’icy la fortune à vos vœux fût fidelle, Vous n’avez point encor eſté trompé par elle, Commandant dans un âge où l’on doit obéïr Mille & mille ſuccés ont dû vous ébloüir!	Pour vous, Seigneur, je crains qu'un éternel bonheur Du dessein de la paix n'éloigne votre cœur, Jusqu'ici la fortune à vos vœux fût fidèle, Vous n'avez point encor été trompé par elle, Commandant dans un âge où l'on doit obéir Mille et mille succès ont dû vous éblouir!
La vertu, la valeur vous fût hereditaire, Vous vangeâtes d’abord vôtre oncle & vôtre pere, (Illuſtres monumens de vôtre pieté) Cecte même valeur avec rapidité Arracha de nos mains, reconquit les Eſpagnes, L’Affrique à vôtre bras a coûté deux campagnes, e viens d’y voir perir deux freres genereux, Qui rehauſſent l’éclat de vos exploits heureux:	La vertu, la valeur vous fut héréditaire, Vous vangeâtes d'abord votre oncle et votre père, (Illustres monuments de votre piété) Cecte même valeur avec rapidité Arracha de nos mains, reconquit les Espagnes, L'Afrique à votre bras a coûté deux campagnes, e viens d'y voir périr deux frères généreux, Qui rehaussent l'éclat de vos exploits heureux:
Vous avez de Syphax conquis le vaſte Empire, L'Univers étonné vous craint & vous admire, Mais dans ce haut degré de gloire & de ſplendeur Scipſon, redoutez vôtre propre grandeur, La fortune eſt volage, il ne faut qu’un caprice, Un ſeul jour, un inſtant nous meine au précipice, Le ſort de Regulus effraya l’Univers, Du plus haut point de gloire il tomba dans nos fers, Et n’eût pas eprouvé tant d’affreuſes miſeres S’il eût donné la paix que demandoient nos peres:	Vous avez de Syphax conquis le vaste Empire, L'Univers étonné vous craint et vous admire, Mais dans ce haut degré de gloire et de splendeur Scipson, redoutez votre propre grandeur, La fortune est volage, il ne faut qu'un caprice, Un seul jour, un instant nous meine au précipice, Le sort de Regulus effraya l'Univers, Du plus haut point de gloire il tomba dans nos fers, Et n'eût pas éprouvé tant d'affreuses misères S'il eût donné la paix que demandaient nos pères:
Le ſort d’une bataille eſt toujours incertain, Mais celuy de la paix eſt tout en vôtre main, Pour Scipion, pour Rome étant pleine de gloire, Elle aura plus d’éclat pour vous qu’une victoire:	Le sort d'une bataille est toujours incertain, Mais celui de la paix est tout en votre main, Pour Scipion, pour Rome étant pleine de gloire, Elle aura plus d'éclat pour vous qu'une victoire:
Pour Cartage, j’avouë avec ſincerité Qu’elle aura moins d’honneur & plus d’utilité:	Pour Carthage, j'avoue avec sincérité Qu'elle aura moins d'honneur et plus d'utilité:
Mais j’aime mieux encor pour la cauſe cominun Suivre icy la raiſon que l’aveugle fortune;	Mais j'aime mieux encor pour la cause continun Suivre ici la raison que l'aveugle fortune;
Souffrez donc que j’en vienne aux termes d’un accord, Dont les conditions regleront nôtre ſort, Et ſi nous vous cedons tous nos droits ſur l’EſpãVous quittant la Sicile ainſi que la Sardaigne, Si nous abandonnons tant de païs conquis, Qui furent de la guerre & la cauſe, & le prix, Si nous nous reſſerrons en détroites limites, 1 Qui par l’ordre des Dieux nous võt être preſcritei, Pourons-nous à la fin obtenir une paix Qui va preſque nous mettre au rang de vos ſujets?	Souffrez donc que j'en vienne aux termes d'un accord, Dont les conditions régleront notre sort, Et si nous vous cédons tous nos droits sur l'EspãVous quittant la Sicile ainsi que la Sardaigne, Si nous abandonnons tant de pays conquis, Qui furent de la guerre et la cause, et le prix, Si nous nous resserrons en détroites limites, 1 Qui par l'ordre des Dieux nous vont être prescrite, Pourons-nous à la fin obtenir une paix Qui va presque nous mettre au rang de vos sujets?
Mais je lis dans vos yeux qu’aprés tant de batailles Vous voulez de Cartage attaquer les murailles, C’eſt là vôtre deſſein, je le vois, & je viens Ménager un accord pour mes concitoyens;	Mais je lis dans vos yeux qu'après tant de batailles Vous voulez de Carthage attaquer les murailles, C'est là votre dessein, je le vois, et je viens Ménager un accord pour mes concitoyens;
Juſqu’à vous en prier je ſléchis mon courage, Mais j’immole ma gloire au ſaiut de Cartage, Et je croy faite plus pour l’eclat de mon nom Que ſi j’avois ſoûmis & Rome, & Scipion.	Jusqu'à vous en prier je sléchis mon courage, Mais j'immole ma gloire au saisut de Carthage, Et je crois faite plus pour l'éclat de mon nom Que si j'avais soumis et Rome, et Scipion.
SCIPION.	SCIPION.
Souffrez que je démeſle avant que de répondre De preſſants interêts qu’on ne doit pas confondre.	Souffrez que je démêle avant que de répondre De pressants intérêts qu'on ne doit pas confondre.
Et je dois balancer avecque un ſoin égal Le mien, celuy de Rome, & celuy d’Annibals Pour le vôtre, Seigneur, je ſouffrirois ſans peine Que Rome par la paix pût éteindre ſa haine;	Et je dois balancer avec un soin égal Le mien, celui de Rome, et celui d'Hannibals Pour le vôtre, Seigneur, je souffrirais sans peine Que Rome par la paix pût éteindre sa haine;
Je connois vos vertus, j’admire vos exploits, Mais pour ma gloire il faut vous cõbattre uxe fois:	Je connais vos vertus, j'admire vos exploits, Mais pour ma gloire il faut vous combattre uxe fois:
Si Fabius acquit une immottelle gloire D’éviter Annibal, & de fuïr la victoire, Si Rome l’aplaudit de n’eſtre pas vaincu, n triomphant de vous quelle gloire eut-il eu?	Si Fabius acquit une immottelle gloire D'éviter Hannibal, et de fuir la victoire, Si Rome l'applaudit de n'être pas vaincu, n triomphant de vous quelle gloire eut-il eu?
Je n’oſe m’en flater, je ſerois temeraire, Mais du moins, il eſt beau de tenter de le faire, Neſſayer de vous mettre au nombre des vaincus, Et d’allet aujourd’huy plus loin que Fabius.	Je n'ose m'en flatter, je serais téméraire, Mais du moins, il est beau de tenter de le faire, Nessayer de vous mettre au nombre des vaincus, Et d'alllet aujourd'hui plus loin que Fabius.
ANNIBAL.	ANNIBAL.
Peut-être ferez-vous un effort inutlle?	Peut-être ferez-vous un effort inutlle?
Scipion, le chemin en fera difficile, je ſe rendray penible, & ſans douté fatal A quiconque voudra triompher d’Annibal.	Scipion, le chemin en fera difficile, je se rendrai pénible, et sans douté fatal A quiconque voudra triompher d'Hannibal.
CIPION.	CIPION.
Et c’eſt là ce qui doit en rehauſſer la gloire.	Et c'est là ce qui doit en rehausser la gloire.
ANNIBAL.	ANNIBAL.
J'ay bien prévû, Seigneur, qu’ardant à la victoire Vous pouriez dédaigner celle de Fabius, Mais regardez le ſort du fier Minutius;	J'ai bien prévu, Seigneur, qu'ardent à la victoire Vous pourriez dédaigner celle de Fabius, Mais regardez le sort du fier Minutius;
Ce Chef impetueux par un eſprit contraire, Emporté d’une ardeur boïillante & temeraire Accuſoit Fabius de crainte & de lenteur, J'eus bien-tôt rallenty ſon inutile ardeur, Quand le prudent Comul m'evitant par ſageſſe, Avec cette lenteur fatigua mon adreſſe, Et toujours devant moy ce grand homme ployant, Rétablit ſa patrie & ſȩût vainere en fuyant.	Ce Chef impétueux par un esprit contraire, Emporté d'une ardeur boïillante et téméraire Accusait Fabius de crainte et de lenteur, J'eus bientôt ralenti son inutile ardeur, Quand le prudent Comul m'évitant par sagesse, Avec cette lenteur fatigua mon adresse, Et toujours devant moi ce grand homme ployant, Rétablit sa patrie et sȩût vaine en fuyant.
SCIPION.	SCIPION.
Je m’accommode peu de pareille victoire, Et laiſſe à Fabius ſa lenteur & ſa gloire, Rome qui veut de moy de plus puiſſants efforts, Eſt dans un autre état qu’elle n’étoit alors;	Je m'accommode peu de pareille victoire, Et laisse à Fabius sa lenteur et sa gloire, Rome qui veut de moi de plus puissants efforts, Est dans un autre état qu'elle n'était alors;
Mais Cartage, Seigneur, & perſide, & cruelle Eſt indigne aprés tout que vous parliez pour elle;	Mais Carthage, Seigneur, et perside, et cruelle Est indigne après tout que vous parliez pour elle;
Nos Alliez pour elle indignement traitez Croyant eſtre à l’abry ſur la foy des traitez, Ont ſeſty les premiers toute ſa perfidie, Vos combats ttop heuteux l’ont depuis enhardie, Les Mammertins vaineus, les Sagontins défaits, L’Italie embraſée aprés tant de ſuccés, Nos Conſuls terraſſez, Rome preſque aſſiegée, Tout cela veut que Rome à la finſoit vangée.	Nos Alliés par elle indignement traités Croyant être à l'abri sur la foi des traités, Ont sesti les premiers toute sa perfidie, Vos combats top heuteux l'ont depuis enhardie, Les Mammertins vainus, les Sagontins défaits, L'Italie embrasée après tant de succès, Nos Consuls terrassez, Rome presque assiégée, Tout cela veut que Rome à la finsait vengée.
ANNIBAL.	ANNIBAL.
Vous ferez plus pour elle en accordant la paix, La victoire toujours ne ſuit pas nos ſouhaits;	Vous ferez plus pour elle en accordant la paix, La victoire toujours ne suit pas nos souhaits;
De plus, conſiderez qu’en l’état où nous ſommes Je me vois à la tête encor de cent mille hommes, Que je fais avancer & camper à vos yeux, Nous combatrons,le reſte eſt en la main des Dieux;	De plus, considérez qu'en l'état où nous sommes Je me vois à la tête encor de cent mille hommes, Que je fais avancer et camper à vos yeux, Nous combatrons,le reste est en la main des Dieux;
Ils ſe levent tous deux.	Ils se levent tous deux.
Elle ſçaura regler vôtre ſort & le nôtre, Mais ſongez que la paix eſt, encor en la vôtre.	Elle saura régler votre sort et le nôtre, Mais songez que la paix est, encor en la vôtre.
J’ay négligé, Seigneur, de vout parler d’abord D'un lien qui pouroit cimenter un accord;	J'ai négligé, Seigneur, de vout parler d'abord D'un lien qui pourrait cimenter un accord;
Juſqu’icy vous n’avez aucun nœud qui vous lie:	Jusqu'ici vous n'avez aucun nœud qui vous lie:
oimna Feicee;	oimna Fée;
ocigneur, m'ineureule Mperſe A ce ſuprême honneur meritoit d’aſpirer.	ocigneur, m'inureule Mperse À ce suprême honneur méritait d'aspirer.
Mais le cœur d’un Romain ne ſçait pas ſoûpirer, Et le vôtre trop fier & tiop inexorable.	Mais le cœur d'un Romain ne sait pas soupirer, Et le vôtre trop fier et toujours inexorable.
CIPION.	CIPION.
Je reſpecte Iſperie, elle eſt toute adorable, Elle pouroit ſléchir le plus ſuperbe cœur, Mais pour la meriter il faut être vainqueur, Ette ſeroit pour moy le comble de la gloire, Que l’hymen d’Iſperie aprés une victoire, Je ne m’en défens point j’adore ſes vertus, Cependant vous l’avez promiſe à Lucejus, Et vôtre foy Seigneur.	Je respecte Ispérie, elle est toute adorable, Elle pourrait sléchir le plus superbe cœur, Mais pour la mériter il faut être vainqueur, Ette serait pour moi le comble de la gloire, Que l'hymen d'Ispérie après une victoire, Je ne m'en défens point j'adore ses vertus, Cependant vous l'avez promise à Lucejus, Et votre foi Seigneur.
ANNIBAL.	ANNIBAL.
Cette promeſſe eſt aine, Ce lien eſt rompu par ſa nouvelle chaîne, D ij Elle eſt vôtre captive, & ne peut être à luy, Et pouroit ttre à vous, Seigneur, dés aujourd’huy.	Cette promesse est aine, Ce lien est rompu par sa nouvelle chaîne, D éj Elle est votre captive, et ne peut être à lui, Et pourrait ttre à vous, Seigneur, dès aujourd'hui.
Dieux T SCIPIONA part.	Dieux T CIPIONAN part.
ANNIBAL.	ANNIBAL.
Heureux !	Heureux !
ſi mon ſang avoit cet avantags De cimenter la paix que demande Cartage;	si mon sang avait cet avantags De cimenter la paix que demande Carthage;
je réponds d’iſperie, elle y doit conſentir, puttens votie lepomte avant que de partir, En l’attendant ſouffrez que je parle à ma Niéce,	je réponds d'ispérie, elle y doit consentir, puttens votie lepomte avant que de partir, En l'attendant souffrez que je parle à ma Nièce,
SCIPIGN.	SCIPIGN.
Seigneur, vous le pouvez.	Seigneur, vous le pouvez.
SCENEV.	SCENEU.
SCIPIQN ſeul.	SCIPIQN seul.
COnnoit-il ma tendtelfe?	COnait-il ma tendtelfe?
Ah Ciel!	Ah Ciel!
que m’a-t-il dit!	que m'a-t-il dit!
il prévient mon ardeur, A-t-il lû dans mes yeux le ſecret de mon cœur?	il prévient mon ardeur, A-t-il lu dans mes yeux le secret de mon cœur?
Lotſque je veux éteindre une ſervile flâme, Il vient là rallumer dans le fonds de mon ame?	Lotsque je veux éteindre une servile flamme, Il vient là rallumer dans le fond de mon âme?
Il me donne Iſperie?	Il me donne Ispérie?
ah!	ah!
quel ſaiſiſſement vient de fraper mon cœur dans ce fatal moment?	quel saisissement vient de frapper mon cœur dans ce fatal moment?
Ayant mal dans mon Camp déguiſe ma tendreſſe, Il eſt pat Aurilear inſtruit de ma foibleſſe, Et ce grand politiqué autant que grand guerrier M’a ſans doute gardé ce trait pour le dernier;	Ayant mal dans mon Camp déguise ma tendresse, Il est pat Aurilear instruit de ma faiblesse, Et ce grand politiqué autant que grand guerrier M'a sans doute gardé ce trait pour le dernier;
Mais pourquoy refuſer l’accord qu’il me demande?	Mais pourquoi refuser l'accord qu'il me demande?
Qu’y s’opoſe à mes vœux?	Quy s'oppose à mes vœux?
qu’eſt-ce que j’aprehende?	qu'est-ce que j'appréhende?
Quoy pour Rome la paix eſt-elle à dédaigner?	Quoi pour Rome la paix est-elle à dédaigner?
Que de pleurs?	Que de pleurs?
que de ſang nous pouvons éparer!	que de sang nous pouvons éparer!
Le Senat m'a remis une pleine puiſſance De faire les Traitez de paix & d’alliance, Et ménageant ſa gloire avec ſes interêts, Rome ſçaura ſouſerire à tout ce que je fais?	Le Sénat m'a remis une pleine puissance De faire les Traités de paix et d'alliance, Et ménageant sa gloire avec ses intérêts, Rome saura souserire à tout ce que je fais?
A Cartage d’ailleurs cette paix eſt honteuſe, A Rome elle ne peut être que glorieuſe, Annibal a fléchy, ſon orgueil a plié, Et par là n’eſt-il pas aſſez humilié?	À Carthage d'ailleurs cette paix est honteuse, À Rome elle ne peut être que glorieuse, Hannibal a fléchi, son orgueil a plié, Et par là n'est-il pas assez humilié?
Que ſaire cependant en ce deſordre extrême?	Que zaïre cependant en ce désordre extrême?
Dois-je Accorder la paix & m’oublier moy-même?	Dois-je Accorder la paix et m'oublier moi-même?
Dieux!	Dieux!
ſoûtenez ma gloire, & verſez dans mon ſein Un conſeil ſalutaire à l’Empire Romain.	soutenez ma gloire, et versez dans mon sein Un conseil salutaire à l'Empire Romain.
Fin du troiſiéme Atte.	Fin du troisième Atte.
ACAIT SCENE PREMIERE.	ACAIT SCÈNE PREMIÈRE.
ISPERIE, ERMILIE.	ISPERIE, ERMILIE.
EREMILIE.	EREMILIE.
UY, Madame, Annibal par l'éclat de vos charmes Du fameux Seipion a ſuſpeadu les armes;	OUI, Madame, Hannibal par l'éclat de vos charmes Du fameux Sipion a suspeadu les armes;
On dit qu’il a d’abord rejetté fieremẽt luſqu’au moindre projet d’un accomodement, Mais qu’à la fin quittant ſon ſuperbe langage, De Rome il a connu la gloire, l’avantage;	On dit qu'il a d'abord rejeté fièrement lusqu’au moindre projet d'un accommodement, Mais qu'à la fin quittant son superbe langage, De Rome il a connu la gloire, l'avantage;
Qu’il a vû que la paix qu’il tenoit en ſa main Etoit avantageuſe à l’Empire Romain, Qu’il pouvoit accorder l’amour, la politique, Et ſuivant ſon panchant ſervir ſa Republique;	Qu'il a vu que la paix qu'il tenait en sa main Était avantageuse à l'Empire Romain, Qu'il pouvait accorder l'amour, la politique, Et suivant son penchant servir sa République;
Vos yeux ont captivé cet illuſtre Vainqueur.	Vos yeux ont captivé cet illustre Vainqueur.
SPERIE Annibal veut qu’il ſoit le maître de mon cœur Juſte Dieux!	SPERIE Hannibal veut qu'il soit le maître de mon cœur Juste Dieux!
de la paix je ſeray la victime, Ou ſi je la refuſe il va m’en faire un crime, I va parler en maître, Aurilcar a voulu:	de la paix je serai la victime, Ou si je la refuse il va m'en faire un crime, I va parler en maître, Aurilcar a voulu:
Deja me preparer à cet ordte abſolu,, Je ne le vois que trop, ſa fiere politique Veut me ſacrifief au repos de l’Affrique;	Déjà me préparer à cet ordte absolu, Je ne le vois que trop, sa fière politique Veut me sacrifief au repos de l'Afrique;
Que fera Lucejus helas?	Que fera Lucejus hélas?
contre Annibal, Lorſqué dans Scipion il rencontre un rival, Ce Prince infortuné, dont j’expoſe la vie, Il va venir, ah Dieux;	contre Hannibal, Lorsqué dans Scipion il rencontre un rival, Ce Prince infortuné, dont j'expose la vie, Il va venir, ah Dieux;
que luy dire Etmilie?	que Ne dire Émilie?
Mais toy-même, va, cours au devant de ſes pas;	Mais toi-même, va, cours au devant de ses pas;
Va dire à Lucejus qu’il ne paroiſſe pas, Qu’il parte de ce Camp, qu’il m’évite, qu’il fuye Les regardi d’Annibal & les yeux d’Iſperie, Que c’eſt moy qui l'ordonne, & qu’enfin je prétens-  u Coun eſ piue temps.	Va dire à Lucejus qu'il ne paraisse pas, Qu'il parte de ce Camp, qu'il m'évite, qu'il fuie Les regardi d'Hannibal et les yeux d'Ispérie, Que c'est moi qui l'ordonne, et qu'enfin je prétends- tu Coun es pive temps.
SCENE II.	SCÈNE II.
LUCEJUS, ISPERIE, EMILIE.	LÙCEJEUS, ISPERIE, EMILIE.
LUCEJUS.	LÙCEJEUS.
E' bien, aprenez-moy quelle eſt ma deſtinée?	E bien, apprenez-moi quelle est ma destinée?
FTMadame, eſt-elle heureuſe?	FTMadame, est-elle heureuse?
eſt-elle infortunée?	est-elle infortunée?
Que j’ay ſouffert, grands Dieux!	Que j'ai souffert, grands Dieux!
attendant cemoment?	attendant cemoment?
Mais qu’a-t-on reſolu?	Mais qu'a-t-on résolu?
quel accommodement?	quel accommodement?
Quel accord Annibal a-t-il fait ?	Quel accord Hannibal a-t-il fait ?
ISPERIE.	ISPERIE.
ciel!	ciel!
je tremble?	Je tremble?
Partez, Seigneut, je crains qu’il ne nous voye enſemble, Sçavez-vous quels perils vous courez en ces lieux, rour ia dcinſelelois Iecevet mes adicuss.	Partez, Seigneut, je crains qu'il ne nous voit ensemble, Savez-vous quels périls vous courez en ces lieux, rour ja dcinselelois Iecevet mes adicuss.
LUCEJUS.	LÙCEJEUS.
Je ne partiray point, & de grace, Madame Parlez, expliquez-moy le trouble de vôtre amt,	Je ne partirai point, et de grâce, Madame Parlez, expliquez-moi le trouble de votre amt,
ISPERIE.	ISPERIE.
On veut que do la pau je roiie noud latal, C’eſt vous en dire aſſez.	On veut que do la pau je roiie nouvd latal, C'est vous en dire assez.
LOCEJUS.	LOCEJEUS.
Hé quoy donc Annibal.	Hé quoi donc Hannibal.
TSPERIE.	TSPERIE.
Me donne à Scipion.	Me donne à Scipion.
LUCEJUS.	LÙCEJEUS.
Barbare politique?	Barbare politique?
Malgré tant de ſermens voila la foy punique.	Malgré tant de serments voilà la foi punique.
Je m’en étois douté;	Je m'en étais douté;
quoy?	quoi?
malgré vôtre foy, L'aveu d’un pere helas!	malgré votre foi, L'aveu d'un père hélas!
qui vous donnoit à moy;	qui vous donnait à moi;
Le crüel vous engage en une autre alliance, Je veux le voir, je veux courir à la vangeance, Laiſſez-moy luy parler & j’y vais.	Le cruel vous engage en une autre alliance, Je veux le voir, je veux courir à la vengeance, Laissez-moi toujours parler et j'y vais.
ISPERIE.	ISPERIE.
Arreſtez, Aprenez les malheuis que vous vous apréſtez;	Arrêtez, Aprenez les malheuis que vous vous après;
Fuyez, Seigneur, fuyez de ce Camp redoutable, Où vous venez chercher un deſtin déplorable, Vous n’y pouvez trouver que la mort ou les fere.	Fuyez, Seigneur, fuyez de ce Camp redoutable, Où vous venez chercher un destin déplorable, Vous n'y pouvez trouver que la mort ou les sere.
LUCEJUS.	LÙCEJEUS.
Et qu’ais-je à ménager encor ſi je vous perds, Annibal, Scipion, je cherche l'un, ou l’autre, ye veun poicorcutce qui m'arrache le vôtre;	Et qu'ai-je à ménager encor si je vous perds? Hannibal, Scipion, je cherche l'un, ou l'autre, y veun poicorcutce qui m'arrache le vôtre;
Encor pour Scipion, s’il vous aime aujourd’huy, Madame, en vous voyant qui feroit moins que luy, Je dois luy pardonner une tendreſſe extrême, Il n’a pû l'éviter, j'on juge par moy-même, Vos yeux me répondoient qu’il ſeroit mon rivalMais je dois me vanger du perflde Annibal, C elt iul luj.	Encor pour Scipion, s'il vous aime aujourd'hui, Madame, en vous voyant qui ferait moins que lui' On dois même pardonner une tendresse extrême, Il n'a pu l'éviter, j'on juge par moi-même, Vos yeux me répondaient qu'il serait mon rivalMais je dois me venger du perflède Hannibal, Ç el l .
ISPERIE.	ISPERIE.
Moderez cette vaine colere, Attendez tout de moy quand tout vous eſt cõtraites Je ne rompray jamais le ſerment ſolemnel Que m’impoſe un lien qui doit être éternel, Ny Scipion, ny Rome, & toute ſa puiſſance N’obtiendront point de moy de lâche obéïſſance, Je réponds de mon éœur, fépondez-moy de vous, Mais de grace évitez Annibal en couroux, Partez, car je fremis, & tout mon ſang ſe glace Dans un ſi grand peril de vous voir tant d’audace;	Modérez cette vaine colère, Attendez tout de moi quand tout vous est comtraites Je ne romprai jamais le serment solennel Que m'impose un lien qui doit être éternel, Ny Scipion, ni Rome, et toute sa puissance N'obtiendront point de moi de lâche obéissance, Je réponds de mon éœur, fondez-moi de vous, Mais de grâce évitez Hannibal en courroux, Partez, car je frémis, et tout mon sang se glace Dans un si grand péril de vous voir tant d'audace;
Si vous m'aimez, Seigneur, partez au nom des Dieux, Sauvez-vous au plûtôt de ces funeſtes lieux;	Si vous m'aimez, Seigneur, partez au nom des Dieux, Sauvez-vous au plûtôt de ces funestes lieux;
Mais n’entreprenez rien pour la triſte Iſperie, Pour le prix de ſa foy conſervez vôtre vie, Peut-êtte Scipion quoyque vôtre rival, Sera bien moins pour vous à craindte qu’Annibal, Il va venir, Seigneur, évitez ſa colere,	Mais n'entreprenez rien pour la triste Ispérie, Pour le prix de sa foi conservez votre vie, Peut-être Scipion quoique votre rival, Sera bien moins pour vous à craindte qu'Hannibal, Il va venir, Seigneur, évitez sa colère,
LUCEJUS.	LÙCEJEUS.
Et je demeurerois tranquille pour vous plaire:	Et je demeurerais tranquille pour vous plaire:
l'attaqueray ce Camp, Madame, avant la nuit, Quand une mort certaine en deviendroit le fruit;	l'attaquerai ce Camp, Madame, avant la nuit, Quand une mort certaine en deviendrait le fruit;
Permettez ſeulement ſi les Dieux me ſecondent, Si d’un heureux ſuecés à mes vœux ils répondent, Si je puis penetrer juſqu’à vous dans ces lieux, Que mon bras vous atrache à ce Camp odieux, Madame, ou ſi le ſort ttahit mon entrepriſe, Conſervez-moy la foy que vous m’avez promiſe, Honorez de vos pleurs un Amant, un époux, Et ſi je meurs, du moins, ſongez que c’eſt pour vouss;	Permettez seulement si les Dieux me secondent, Si d'un heureux succès à mes vœux ils répondent, Si je puis pénétrer jusqu'à vous dans ces lieux, Que mon bras vous atrache à ce Camp odieux, Madame, ou si le sort tahit mon entreprise, Conservez-moi la foi que vous m'avez promise, Honorez de vos pleurs un Amant, un époux, Et si je meurs, du moins, songez que c'est pour vouss;
ciuica , beaicailes	ciuica , baicailes
SCENE III.	SCÈNE III.
ISPERIE, ERMILIE.	ISPERIE, ERMILIE.
FI Elast que va-t-il entreprendre:	FI Elast que va-t-il entreprendre:
Il va perir, c’eſt tout ce que j’en dois attendre?	Il va périr, c'est tout ce que j'en dois attendre?
Détournez ce malheur, guidez ſes pas grandi Dieux!	Détournez ce malheur, guidez ses pas grandi Dieux!
Donnez à cet Amantun deſtin plus heureux, Qu’il regagne ſon Camp, & qu’enfin il revienne Soûtenir dignement & ſa gloire & la mienne?	Donnez à cet Amantun destin plus heureux, Qu'il regagne son Camp, et qu'enfin il revienne Soutenir dignement et sa gloire et la mienne?
Dieuxl!	Dieux!
Annibal paroît.	Hannibal paraît.
SCENE IV.	SCÈNE IV.
ANNTDAL,STERITERMILIE	ANNTDAL,STERITERMILIE
ISPERIE.	ISPERIE.
’Embraſſe vos genoux, ocigleur, dde los bontl.	Ç'Embrasse vos genoux, ocigleur, dde los bontl.
ANNIBAL.	ANNIBAL.
Madame, levez-vous.	Madame, levez-vous.
ISPERIE.	ISPERIE.
Seigneur, ſi vous uſez par un ordre ſevere Du pouvolr que ſur moy vous a donné mon pere, uiijcrour en mourane remca volle ley ;	Seigneur, si vous usez par un ordre sévère Du pouvoler que sur moi vous a donné mon père, uiijcrour en mourane rema volle ley ;
Si vous n’avez pitié du trouble où je me voy, Et ſi vous violez une ſainte promeſſe, Sut qui mon cœur ſoûmis a reglé ſa tendreſſe.	Si vous n'avez pitié du trouble où je me vois, Et si vous violez une sainte promesse, Sut qui mon cœur soumis a réglé sa tendresse.
ANNIBAL.	ANNIBAL.
Non, ne m’opoſez point de frivolles ardeurs, L’amour ne regle pas le deſtin des grands cœurs, 21 le suue Moner auolende la paulle , Et ſongez que Cartage aujourd’huy vous en prie.	Non, ne m'opposez point de frivoles ardeurs, L'amour ne règle pas le destin des grands cœurs, 21 le suve Moner avolende la paulle , Et songez que Carthage aujourd'hui vous en prie.
ISPERIE.	ISPERIE.
Et pourquoy cette paix, Seigneur, n’avez-vous pas Cent mille hõmes encot dont les cœurs & les bras.	Et pourquoi cette paix, Seigneur, n'avez-vous pas Cent mille hommes encot dont les cœurs et les bras.
ANNIBAL.	ANNIBAL.
Oüy, je me vois encore une nombreuſe Armée, Mais Dieux:	Oui, je me vois encore une nombreuse Armée, Mais Dieux:
elle n’eſt plus à vainere acoûtumée, Madame, je u’ay plus d’intrepides ſoldats, Leurs cœurs ſont affoiblis auſſi bien que leurs bras, Fatalles voluptez, délices de Capoüe!	elle n'est plus à vainere accoutumée, Madame, je ay plus intrépides soldats, Leurs cœurs sont affoiblis aussi bien que leurs bras, Fatalles volupté, délices de Capoüe!
Vous nous coûtâtes chet, il eſt vray, je l’avoüe, Nous avions triomphé dans les adverſitez, Et nous fûmes vaincus par les proſperitez,  oorepundeomueue utonuſaut ie courage, Capoile a ſauvé Rome & menace Cartage,	Vous nous coûtâtes chet, il est vrai, je l'avoue, Nous avions triomphé dans les adversités, Et nous fûmes vaincus par les prospérités, oorepundeomue utonusaut ce courage, Capoile a sauvé Rome et menace Carthage,
SPERIE.	SPERIE.
Si le cœur des ſoldats au vôtre eſt inégal, Ils retrouvent en vous le même General;	Si le cœur des soldats au vôtre est inégal, Ils retrouvent en vous le même Général;
Seigneur, vôtre valeur & vôtre renommée.	Seigneur, votre valeur et votre renommée.
ANNIBAL.	ANNIBAL.
Qu'on me faſſe trouver auſſi la même Armée?	Qu'on me fasse trouver aussi la même Armée?
Annibal répondant de ſemblables ſuccés Ne ſeroit pas reduit à demander la paix;	Hannibal répondant de semblables succès Ne serait pas réduit à demander la paix;
Mais il me reſte peu de troupes aguerries, Dans le ſein du repos celles-cy ſont nouries, J’ay Scipion en tête avec trop de vertus, Et je n’ay plus à faire à des Flaminius.	Mais il me reste peu de troupes aguerries, Dans le sein du repos celles-cy sont nouries, J'ai Scipion en tête avec trop de vertus, Et je n'ai plus à faire à des Flaminius.
Madame, à cet aveu j’ay bien voulu deſcendre, Pour matquer l'intereſt que vous y devez prendre;	Madame, à cet aveu j'ai bien voulu descendre, Pour matquer l'intérêt que vous y devez prendre;
Il faut donc:	Il faut donc:
eu ce jour épouſer ce Heros, Pour tendre aux Africains la gloire & le repos, Il faut que de la paix vous ſoyez un iju.	eu ce jour épouser ce Héros, Pour tendre aux Africains la gloire et le repos, Il faut que de la paix vous soyez un iju.
gage, Votre hymen va ſauver & l’Afrique & Cartage, Qoutetolpuo vour eu vous iaiale dequil i Ce n’eſt plus moy, c’eſt vous qui pouvez l’affranchir.	gage, Votre hymen va sauver et l'Afrique et Carthage, Qoutétolpo vour eu vous jaiale de y Cequ'est plus moi, c'est vous qui pouvez l'affranchir.
ISPERIE.	ISPERIE.
Moy, Seigneur?	Moy, Seigneur?
ANNIBAL.	ANNIBAL.
N’ais-je pas ſacrifié ma gloire?	N'ai-je pas sacrifié ma gloire?
I'ay demandé la paix, ah Ciel!	J'ai demandé la paix, ah Ciel!
qui l’eût pû croire?	qui l'eût pu croire?
Madame, Madame, & cet eſfort a cent fois plus coûté A L’orgueil d’Annibal, à toute ſa fierte, Qu’il n’en poura jamais coûter à vôtre flâme, saey cemercacple pauuee Mdoy;	Madame, Madame, et cet esfort a cent fois plus coûté À L'orgueil d'Hannibal, à toute sa fierté, Qu'il n'en pourra jamais coûter à votre flamme, saein cemercacple pauve Moi;
Madame, Il faut ſacrifier vos feux à vôtre tour.	Madame, Il faut sacrifier vos feux à votre tour.
ISPERIE.	ISPERIE.
J'immoleray ma vie & non pas mon amour, A la perdre, Seigneur, me voila toute piête, Ordonnes de mon ſort, diſpoſez de ma téte, Je l’immole à Cartage.	J'immolerai ma vie et non pas mon amour, À la perdre, Seigneur, me voilà toute pieste, Ordonnes de mon sort, disposez de ma tête, Je l'immole à Carthage.
, & ne puis tien de plur;	, et ne puis tien de plur;
Mais je couſerveray mon cœut à Lucejus.	Mais je couserveray mon cœur à Lucejus.
ANNIBAL.	ANNIBAL.
A Lucejus?	À Lucejus?
ah Ciel!	ah Ciel!
quand Scipion vous aime, Ce Heros revêtu d’une gloire ſuprême, Se peut-il que le Chef des Celtibériens Oſe luy diſputer l’honneur de vos liens?	quand Scipion vous aime, Ce Héros revêtu d'une gloire suprême, Se peut-il que le Chef des Celtibériens Ose aux disputer l'honneur de vos liens?
Et lorſque yous voyez dans ros fels ce grand hõme Qui va mettre à vos pieds la puiſſance de Rome, En vous ſaiſant un ſort qui ſoit dignę dexous, Songez-vous que l’honneur eu relallit ſut nous?	Et lorsque yous voyez dans ros sels ce grand homme Qui va mettre à vos pieds la puissance de Rome, En vous saisant un sort qui soit dign dexous, Songez-vous que l'honneur eu relallit sut nous?
Au mua Mecel pour vous ctojez-en ma tendreſſe, Icy pour vôtre gloire Annibal s’intereſſe, Secoudez aujourd'huy de ſi juſtes deſſeins, Et prenez pour époux le plus graud des Romains.	Au mua Mecel pour vous ctojez-en ma tendresse, Ici pour votre gloire Hannibal s'intéresse, Secdez aujourd'hui de si justes desseins, Et prenez pour époux le plus graud des Romains.
ISPERIE.	ISPERIE.
2412f Me faiſant ſouvenit que je ſuis votré Nietcé na loutenir ce noin ina guones mtelcue;	2412f Me faisant souvenit que je suis voctré Nietcé na loutenir ce noin ina guones mettelcue;
Je ſuis Cartaginoiſe, & fille d’Hyeibal, *1.	Je suis Carthaginoise, et fille d'Hyibal, *1.
21 Et pour dite encor plus la Niéce d’Annibal;	21 Et pour dite encor plus la Nièce d'Hannibal;
Seigneur, j’oſe ajoûter que je ſuis Africaine, Et que mon cœul dédalgne eullh d’eſtie Ronlalne.	Seigneur, j'ose ajouter que je suis Africaine, Et que mon cœul dédalgne eullh d'étie Ronlalaine.
ANNI BAL.	ANNI BAL.
Je voy que c’eſt en vain emplorer la douceur Pour ſléchir ou pour vaiucré lin'ſt ſuperbe cœur;	Je vois que c'est en vain emplorer la douceur Pour sléchir ou pour vaicré l'st superbe cœur;
Mais il faut étouſfer cette vaine tendreſſe, Je ne dis plus qu’un mor, Madame, & je vous laiſſe.	Mais il faut étouffer cette vaine tendresse, Je ne dis plus qu'un mór, Madame, et je vous laisse.
Tournez vers Scipion vbtre cœur & vos vœux, Vous l’allez volr;	Tournez vers Scipion vattre cœur et vos vœux, Vous l'allez volr;
ſur tout ſongez que je le veux.	sur tout songez que je le veux.
I ſeit.	I seit.
ISPERIE.	ISPERIE.
Cruel?	Cruel?
à Lucolus mon cour ſera fidelle, Et je ſeray toujouis à cet ordre iebelle, Il faut dans ces momenspar un noble eouroux, Montrer que nôtre cœur ne dépend que de nous, Epus 15101 ouage, Et ſoûtenons le nom, la gloire de Cartage.	à Lucolus mon cour sera fidèle, Et je serai toujouis à cet ordre iebelle, Il faut dans ces momentspar un noble eourroux, Montrer que notre cœur ne dépend que de nous, Épus 15101 ouïage, Et soutenons le nom, la gloire de Carthage.
SCENE V SCIPION, ISPERIE, ERMILIE.	SCÈNE V CIPION, ISPERIE, ERMILIE.
SCIPION.	SCIPION.
veut que vous ſoyez le gage d’une paix, Qui ſans doute n'eſt pas conforme à-vos ſouhaits;	veut que vous soyez le gage d'une paix, Qui sans doute n'est pas conforme à-vos souhaits;
Mais, Madame, aujourd’huy je croirois faire un érime,, De ſouffrir qu'Aonibal.	Mais, Madame, aujourd'hui je croirais faire un érime, De souffrir qu'Aonibal.
vous en ſiſt la victime:	vous en zist la victime:
honore vos vertus, j’adore vos apas, Mais ſans contraindre un corur s’il ne ſe donne pas, Loin d’en etre trran j’en abhorre le aitre.	honore vos vertus, j'adore vos appâts, Mais sans contraindre un corur s'il ne se donne pas, Loin d'en être tran j'en abhorre le aytre.
De vôtre ſort, du mien, je vous laiſſe l’arbitre, Vous avez ou la paix, on la guerre en.	De votre sort, du mien, je vous laisse l'arbitre, Vous avez ou la paix, on la guerre en.
vos mains, Le deſtin de l’Afrinte & celuy ſes Romain.	vos mains, Le destin de l'Afrinte et celui ses Romain.
,.	Ç,
1	1
Que dites-vous, Seigoeur?	Que dites-vous, Seigoeur?
ah Ciel!	ah Ciel!
pourois-je croire Qu’un cœur tel que le mien metirat tant de glolre;	pourrais-je croire Qu'un cœur tel que le mien métirat tant de glolre;
Que le ſort de l’Afrique & celuy des Romains Fuſt par vous aujourd’huy remis entre mes mains?	Que le sort de l'Afrique et celui des Romains Fût par vous aujourd'hui remis entre mes mains?
Loiſque du mien, Seigneur, je ne ſuis plus maietteue, Qu’engagée à tenir une ſainte promeſſe.	Loisque du mien, Seigneur, je ne suis plus maietteue, Qu'engagée à tenir une sainte promesse.
Je vois trop.	Je vois trop.
SCRPION.	SCRPION.
SCENE VI.	SCÈNE VI.
SEXTUS, LEPIDE, SCIPION, ISPERIE, ERMILIE.	SEXTUS, LEPIDE, SCIPION, ISPERIE, ERMILIE.
SEXTUS.	SEIGNEUR.
l' Ardonnez ſi je vous interromps, Seigneur de Lucejus on voit les eſcadrons, Forourad vosua qu'u eseiseiees cote;	l' Ardonnez si je vous interromps, Seigneur de Lucejus on voit les escadrons, Forourad vosua qu'u eseiseiees cote;
Et que vers nôtre Camp à marcher il s’aprête, Qu’avec ſes étendaris on voit ceux des deux Rois.	Et que vers notre Camp à marcher il s'apprête, Qu'avec ses étendaris on voit ceux des deux Rois.
ISPERIE à part.	ISPERIE à part.
Ah!	Ah!
je reſpire enfin pour la premiere ſois.	je respire enfin pour la première sois.
SCEPION.	SCEPION.
C’en eſt aſſez, Sextus, allez les recounoltre, artens vôtre retour.	C'en est assez, Sextus, allez les recounoltre, artends votre retour.
Lucejus va paroltre, adame, & je vois bien que pour vos interets ous aurons un combat, & non pas une paix;	Lucejus va paraître, adame, et je vois bien que pour vos intérêts ous aurons un combat, et non pas une paix;
E ij Sans doute que ce Prince avauce & vient lui-même Pour rejoindre Annibal.	 Ej à doute que ce Prince avauce et vient lui-même Pour rejoindre Hannibal.
Dieux!	Dieux!
quel deſordre extréme?	quel désordre extrême?
Vous enctiez inſtruite, il vient vous ſecourir;	Vous enctiez instruite, il vient vous secourir;
nnmle Raepaveonmoeqeoovouremnoconquein, Je vois par la frayeur dont vôtre ame eſt atteinte.	nnmle Raepaveonmoeqeoovouremnoconquein, Je vois par la frayeur dont votre âme est atteinte.
SPERIE.	SPERIE.
Non, Seigneur,je commence à diſſiper ma crainte, Malgré tous mes malheurs je reprends quelque eſpoir, S’il vient me ſecourir il remplit ſon devoir.	Non, Seigneur,je commence à dissiper ma crainte, Malgré tous mes malheurs je reprends quelque espoir, S'il vient me secourir il remplit son devoir.
OCAND VITe.	OCAND VITe.
SCIPION, LEPIDE.	SCIPION, LEPIDE.
SCIPION.	SCIPION.
L remplit ſon devoir.	L remplit son devoir.
Ah- quelle conſiance?	Ah- quelle constance?
ISon Amant luy redonne unt ſiere aſſurance?	ISon Amant Seigneur redonne unt somme assurance?
Elle s’en promet tout.	Elle s'en promet tout.
Vos vœux trop empreſſez N’en ſont pas, Iſperie, encore où vous penſez?	Vos vœux trop empressez N'en sont pas, Ispérie, encore où vous pensez?
y mettray quelque obſtacle, & ce ferme courage.	y mettrai quelque obstacle, et ce ferme courage.
Ah!	Ah!
je ſens tedoubler & ma haine, & ma rage, Il faut combattre, il faut rompre ce nœud fatal:	je sens tedoubler et ma haine, et ma rage, Il faut combattre, il faut rompre ce nœud fatal:
Ce Prince étoit ſans doute attendu d’Annibal, Sous pretexte de paix, ce Chef adroit peut-être N’eſt venu dãs mon camp que pour le reconnoître, Que pour gagner du temps ſur l’eſpoir d’un traitét Dieux!	Ce Prince était sans doute attendu d'Hannibal, Sous prétexte de paix, ce Chef adroit peut-être N'est venu dans mon camp que pour le reconnaître, Que pour gagner du temps sur l'espoir d'un traitet Dieux!
de quel mouvement je me ſens agité!	de quel mouvement je me sens agité!
Par ces projets pompeux de paix & d’alliance, Il tâchoit d’endormir mes ſoins, ma vigilance, Tout m’eſt ſuſpect en luy, Lepide, je le voy, A bien d’autres qu’à nous il a manqué de foy,  deuesyu Imlsades cue.	Par ces projets pompeux de paix et d'alliance, Il tâchait d'endormir mes soins, ma vigilance, Tout m'est suspect en lui, Lépide, je le vois, À bien d'autres qu'à nous il a manqué de foi, deuesyu Imades cue.
SCENE VIII.	SCÈNE VIII.
tertaconta, AoſEohis, oGMION, LEPIDE.	tertaconta, AosEohis, oGMION, LÉPIDE.
ANNIFA L.	ANNIFA L.
E me ſoupçonnez pas d’aucune intelligence, I (Seigneur, quand Lucejus vient pour ſes interets, Les armes à la main s’opoſer à la paix, Oa a vâ ſes drapeaux, & ma juſte colere.	E me soupçonnez pas d'aucune intelligence, I (Seigneur, quand Lucejus vient pour ses intérêts, Les armes à la main s'opposer à la paix, Ça a vas ses drapeaux, et ma juste colère.
SC.	SCC.
IPION.	IPION.
Ce Piluce uc laus leu que ce qui cevo ielle, Qu’il eſt heureux ?	Ce Piluce uc laus lu que ce qui cevo jelle, Qu'il est heureux ?
’il ſert ſa gloire & ſon amour, Seigneur, il vient groſſir voire armée en ce jour, Vous atrendiez ſaus doute eneor cet avantago.	Ç'il sert sa gloire et son amour, Seigneur, il vient grossir voire armée en ce jour, Vous atrendiez saus doute eneor cet avantago.
ANNTBAE.	ANNTBAE.
Seigneur, qu’oſez-vous dire?	Seigneur, qu'osez-vous dire?
un tel ſoup çon m’ou37	un tel soup çon m'ou37
SCFPION.	SCPION.
J'oſe diſe, Seigueur, ce que j’ay dû penſen	J'ose dire, Seigueur, ce que j'ai dû pensen
ANNIBAL.	ANNIBAL.
Vous en dites aſſez euſin pour m’oſſenſer!	Vous en dites assez eusin pour m'ossenser!
SCIPFON.	SCIPFON.
Vous êtes dans mon Camp, Seigneur, je vous refpecte Mais la foy de Caitage aux Romains eſt ſuſpectos 0	Vous êtes dans mon Camp, Seigneur, je vous refecte Mais la foi de Caitage aux Romains est suspectos 0
ANNIBAL.	ANNIBAL.
aat ced eudop, lHaut.	aat céd ondop, lHaut.
s	s
SCIPION.	SCIPION.
Seigneur;	Seigneur;
n’en parlons plus, Et quittons des ſoupçons incertains & confus;	n'en parlons plus, Et quittons des soupçons incertains et confus;
3 Il faut que vôtre atdeur à la mienne reponde,.	3 Il faut que votre atdeur à la mienne réponde,.
Nous devons decider de l’Empire du Monde, Annibal, ſi les Dieux ont mis entrè nos mains Le deſtin de l’Afrique, & celuj des Romains, Il faut dant ce grand jour ſans tarder davantage;	Nous devons décider de l'Empire du Monde, Hannibal, si les Dieux ont mis entrène nos mains Le destin de l'Afrique, et celuj des Romains, Il faut dant ce grand jour sans tarder davantage;
Faire triompher Rome, ou délivrer Cartage, Il faut voir l'une ou l’autre, ou libte, ou dãs les fers, Et donner un ſeul maître enſin à l’Univers.	Faire triompher Rome, ou délivrer Carthage, Il faut voir l'une ou l'autre, ou libte, ou dans les fers, Et donner un seul maître ensin à l'Univers.
ANNIBAL.	ANNIBAL.
Vous faites voir un cœur trop avide de gloire, Et déja vous croyez courir à la victoire, Scipion, mais je veux ſecouder vos ſouhaits;	Vous faites voir un cœur trop avide de gloire, Et déjà vous croyez courir à la victoire, Scipion, mais je veux seconder vos souhaits;
1 I Vous m’avez ſoupçonné, ie renonce à la paix, Ouy, j’accepte aujourd!	1 I Vous m'avez soupçonné, Seigneur renonce à la paix, Oui, j'accepte aujourd!
huy la bataille, & j’eſpere Vous mettre aumême état où j'ay mis vorse pere;	hui la bataille, et j'espère Vous mettre aumême état où j'ai mis vorse père;
le me rends à ma haine, il faut remplir mon ſort, Lpioms ax har Nome;	le me rends à ma haine, il faut remplir mon sort, Lépioms ax har Nome;
MquaManone;	MquaManone;
En naiſſant j’ay juré la guerre au Capitole, Juſqu’au dernier ſoûpir je luy tiendray parole.	En naissant j'ai juré la guerre au Capitole, Jusqu'au dernier soupir je veux tiendrai parole.
Il ſort,	Il sort,
SCIPION.	SCIPION.
A la fin d’Anuibal j’ay piqué la fierté, .	À la fin d'Anuibal j'ai piqué la fierté, .
213 ’ay rompu grace au Ciel cet indignę traité?	213 aay rompu grâce au Ciel cet indign traité?
iis Et vous, Dieux!	jis Et vous, Dieux!
protecteurs du ſacré Capitole, Il faut dans ce combat vous vanger, g.	protecteurs du sacré Capitole, Il faut dans ce combat vous venger, g.
j'y vole:	j'y vole:
Rome, vous attendez cette graude action, Qu'Annibal ſuive un jour le char de Scipion.	Rome, vous attendez cette graude action, Qu'Hannibal suive un jour le char de Scipion.
Fin au quatritme Acte.	Fin au quatritme Acte.
.	.
i1	i1
ACTE V SCENE PREMIERE.	ACTE V CÈNE PREMIÈRE.
ASBERIE, ERMILIE.	ASBERIE, ERMILIE.
Mh.	Mh.
ISPERIE.	ISPERIE.
E m’abandonne point;	E m'abandonne point;
viens, ma chere Ermilie, Partager les ftayeurs dont mon ame eſt ſaiſie, Quel combat ?	viens, ma chère Ermilie, Partager les faiseurs dont mon âme est saisie, Quel combat ?
quelle horreur!	quelle horreur!
quelle confuſion?	quelle confusion?
Lucejus eſt aux mains avecque Scipion, Il a joint Annibal;	Lucejus est aux mains avec Scipion, Il a joint Hannibal;
ah!	ah!
fatale journée Qui va de mon Amant faire la deſtinée?	fatale journée Qui va de mon Amant faire la destinée?
Je ne dis point la mienne,ah Dieux!	Je ne dis point la mienne,ah Dieux!
vous ſçavez bien Que je n’auray jamais d’autre ſort que le ſien !	Vous savez bien Que je n'aurai jamais d'autre sort que le sien !
As-tu vû comme moi ce Heros intrepide, Animé par l’amour qui luy ſervoit de guide, Pouſſer de Lelius les eſcadrons épars, Et déja prés de nous planter ſes étendars, Quand le ſier Scipion eſt venu plein de rage De ſon Camp ebranlé ranimer le courage.	As-tu vu comme moi ce Héros intrépide, Animé par l'amour qui lui servait de guide, Pousser de Lélius les escadrons épars, Et déjà près de nous planter ses étendards, Quand le sier Scipion est venu plein de rage De son Camp ébranlé ranimer le courage.
Je l’ay vû tout d’un coup fondre ſur Lucejus, J’en ay pâly grandt Dieux?	Je l'ai vu tout d'un coup fondre sur Lucejus, J'en ai pâli grandt Dieux?
& n’ay rien vû de plus;	et n'ai rien vu de plus;
Tout s’eſt mélé pour lors, le tumulte des armes, Les perils d’un Amant m’ont fait verſer des larmes, Que je tremble pour luy malgré ſes grands efforte Men ivactombe peut-cutecaſe ſesmoits.	Tout s'est mêlé pour lors, le tumulte des armes, Les périls d'un Amant m'ont fait verser des larmes, Que je tremble pour lui malgré ses grands efforte Men ivactombe peut-cutecase sesmoits.
ERMILIE.	ERMILIE.
Raſſurez-vous, Madame, ayez quelque eſperanco;	Rassurez-vous, Madame, ayez quelque espéranco;
La valeur d’Annibal met le ſort en balance, Ce Hſeros qui combat fera voir ſon grand cœur Sans doute, & Scipion n’eſt pas encor vainqueur, Les Dieux pouront.	La valeur d'Hannibal met le sort en balance, Ce Hséros qui combat fera voir son grand cœur Sans doute, et Scipion n'est pas encor vainqueur, Les Dieux pourront.
Mais quoy?	Mais quoi?
j’aperçois Eti,xene.	j'aperçois Éti,xène.
SCENE II.	SCÈNE II.
ERIAENE, PARCE,ITERIE, ERMILIE.	ERIANE, PARCE,ITERIE, ERMILIE.
ERIXENE.	ERIXENE.
Adame c’en eſt fait, notre eſperãce eſt vaineAnnibal eſt vaincu, Scipion eſt vainqueur, Tout ſuccombe, tout cede à ſa rare valeurs.	Adame c'en est fait, notre espérance est vaineHannibal est vaincu, Scipion est vainqueur, Tout succombe, tout cède à sa rare valeurs.
Lien qu’Aunibal' ait fait un effort incroyable Four rallier les ſiens d’un ſoin infarigable, Tout ſon Camp par avance etoit ſaiſi d’eſſtoy, Tout fuit, & j'en pâlis & pour vous & pour moy Scipion triomphant va nous parler en maſ̂tre, Atcoscicioeieaodaniy esten Meur peut-cuic.	Lien qu'Aunibal ait fait un effort incroyable Four rallier les siens d'un soin infarigable, Tout son Camp par avance était saisi d'esstoi, Tout fuit, et j'en pâlis et pour vous et pour moi Scipion triomphant va nous parler en montre, Atcoscicioeieaodani esten Meur peut-cuic.
Vous fremiſſez Madame.	Vous frémissez Madame.
ISPERIE.	ISPERIE.
Hé que fait Lucejus?	Hé que fait Lucejus?
Aprenez-moy ſon ſort:	Apprenez-moi son sort:
peut-être il ne vit plus.	peut-être il ne vit plus.
ERIXENE.	ERIXENE.
’ignore ſon deſtin,ny qu’elle eſt ſa conduite, Mlais avecque Annibal les deux Rois ſont en ſuite, Peut-cere qu’avecque eux cherchat un paſeil ſort.	eux son destinli qu'elle est sa conduite, Mlais avec Hannibal les deux Rois sont en suite, Peut-cere qu'avec eux cherchât un paseil sort.
ISPERIE.	ISPERIE.
Il ne fuit point, Madame, & ſans doute il eſt mort;	Il ne fuit point, Madame, et sans doute il est mort;
Quoy?	Quoi?
Lucejus fuiroit en perdant ce qu’il aime, le connois ſa valeur & ſon amour extrême, Il aura combatu juſqu’au dernier ſoûpir, Madame, il a voulu me ſauver ou perir.	Lucejus fuirait en perdant ce qu'il aime, le connais sa valeur et son amour extrême, Il aura combattu jusqu'au dernier soupir, Madame, il a voulu me sauver ou périr.
Dieux que je ſuis en proye à mon inquietude?	Dieux que je suis en proie à mon inquiétude?
Je ne puis demeurer daus cette incertitude, Somtons, anons-ie jomdre, ce je veux aujourd huy S’il eſt parmy les morts expiter avec luy.	Je ne puis demeurer daus cette incertitude, Somtons, ânons-je jomdre, ce je veux aujourd 'il est parmi les morts expiter avec lui.
ed ls Pllo ERIXENE, BARCE'.	ed lois Pllo ERIXENE, BARCE.
ERIXENE.	ERIXENE.
Fortune!	Fortune!
O journée à toutes deux fatale!	Ô journée à toutes deux fatale!
Mais je dois envier le ſort de ma rivale;	Mais je dois envier le sort de ma rivale;
Je ne ſçautois la plaindre, & malgré ſes douleurs Pour un Amant fidelle elle verſe des:	Je ne sautais la plaindre, et malgré ses douleurs Pour un Amant fidèle elle verse des:
pleurs;	pleurs;
Du moins, ou s’il eſt mort elle n’a qu’à le ſuivre;	Du moins, ou s'il est mort elle n'a qu'à le suivre;
G’eſt.	G'est.
le moindre des maux que de ceſſer de vivre?	le moindre des maux que de cesser de vivre?
Que vais-je devenir?	Que vais-je devenir?
quel doit être mon ſort?	quel doit être mon sort?
Pour moy?	Pour moi?
de tous côtez je ne voy que la morts.	de tous côtés je ne vois que la morts.
Ouy, trop cruel amour il faut que je te domte, Retournons daus Cartage euſevelir ma honte, On la doit aſſieger, j'y finiray mes jours, J’attends de Scipion ce funeſte ſecours;	Oui, trop cruel amour il faut que je te dompte, Retournons daus Carthage eusevelir ma honte, On la doit assiéger, j'y finirai mes jours, J'attends de Scipion ce funeste secours;
e l’aperçois, parlons.	Je l'aperçois, parlons.
SCENE IV.	SCÈNE IV.
SCIPION, LEPIDE, SEXTUS, ERIXENE, BARCE'.	SCIPION, LEPIDE, SEXTUS, ERIXENE, BARCE.
SCIPIONà ſes Gardes.	SCIPIONà ses Gardes.
Uon obſerve Iſpetié?	Où observe Ispétié?
Qu'on la ſuive?	Qu'on la suive?
& ſur tout ayez ſoin de ſa vie.	et sur tout ayez soin de sa vie.
ERIXENE.	ERIXENE.
Enſin je veus revoy vainqueur & triomphant, Seigneur, & vôtre nom encor plus eclatant Par cette memorable & deruiere victoire Vous met en cegrand jour au comblè de la gloire, Vous êtes genereux, daignez briſer mes fers, Je les ay ſans regret à ma honte ſouſſers;	Ensin je veux revoi vainqueur et triomphant, Seigneur, et votre nom encor plus éclatant Par cette mémorable et deruière victoire Vous met en cegrand jour au comblé de la gloire, Vous êtes généreux, daignez briser mes fers, Je les ai sans regret à ma honte soussers;
mout vous allons bien-tot voir aſſieger Cartage, Souſſrez que ma preſence anime ſon courage, Eamour de ma patrie allumant mon ardeur,	moût vous allons bientôt voir assiéger Carthage, Soussrez que ma présence anime son courage, Eamour de ma patrie allumant mon ardeur,
SCIPION.	SCIPION.
Qu'un pareil ſentiment me touche & m'intereſſe?	Qu'un pareil sentiment me touche et m'intéresse?
Ouy, de vôtre deſtin je vous rends la maitreſſe, Soyez libre, Madame, & d’un cœur aſſermy Allez joindre Annibal mon illuſtre enaemy:	Oui, de votre destin je vous rends la maîtresse, Soyez libre, Madame, et d'un cœur assermi Allez joindre Hannibal mon illustre enaemi:
Ma victoire n’a fait qu’enſler ſa renommée;	Ma victoire n'a fait qu'ensler sa renommée;
Ruy ſeul a combatu dans toute ſon Armée, ’’ay malgré ſa défaite admiré ſa valeur, I n’a jamais été plus grand qu’en ce malheur!	Rui seul a combattu dans toute son Armée, ay malgré sa défaite admiré sa valeur, I a jamais été plus grand en ce malheur!
Vous pourez aujourd’huy le revoir dans Caitage, Contte moy je luy donne un puiſſant avantage;	Vous pourrez aujourd'hui le revoir dans Caitage, Contte moi je lui donne un puissant avantage;
Cependant vous pouvek partir, allez Sextus, Et reudez les honneurs qu’òn doit à ſes vertue.	Cependant vous pouve partir, allez Sextus, Et reudez les honneurs qu'n doit à ses vertue.
GRIXENE.	GRIXENE.
Je n’attendois pas moins d’un heros magnanime, Et j’emporte de vous une ſi haute eſtime, Que mon cœur penetté d’un ſi noble deſſein, Me fera teverer toujours le nom Romain.	Je n'attendais pas moins d'un héros magnanime, Et j'emporte de vous une si haute estime, Que mon cœur penetté d'un si noble dessein, Me fera tevérer toujours le nom Romain.
Elle ſo-t.	Elle sout.
SCENE V.	SCÈNE V.
SCIPION, LEPIDE.	SCIPION, LEPIDE.
LEPIDE.	LÉPIDE.
Inſi vous l’envoyez ſecourir ſa patrie:	Insi vous l'envoyez secourir sa patrie:
Al Mais, Seigneur, qu’allez-vous ordonnor d'Iſperie?	Al Mais, Seigneur, qu'allez-vous ordonnor d'Ispérie?
Maitre de ſon deſtin dans ce fatal moment, Vous avez dans vos mains la Maîtreſſe & l’Amant, Qu’allez-vous decider de leur ſorta	Maitre de son destin dans ce fatal moment, Vous avez dans vos mains la Maîtresse et l'Amant, Qu'allez-vous décider de leur sorta
SCIPION.	SCIPION.
Ah Lepde, Je tremble que l'amour ne me ſerve de guide, Je ne ſuis plus Romain, je ſuis foible, & je ſens Que contre ma vertu ſe revoltent mes ſens.	Ah Lépde, Je tremble que l'amour ne me serve de guide, Je ne suis plus Romain, je suis faible, et je sens Que contre ma vertu se révoltent mes sens.
La gloire, la pitié, l’amour, tout me déchire, Que je ſouffre grands Dieux!	La gloire, la pitié, l'amour, tout me déchire, Que je souffre grands Dieux!
j’en rougis, j’en ſoûplre, Qu’il me ſaut rendre encor de tetribles combats?	j'en rougis, j'en souplre, Qu'il me saut rendre encor de tetribles combats?
Aunibal eſt vaineu, mais I’amour ne l’eſt pas.	Aunibal est vain, mais J'amour ne l'est pas.
LEPI.	LÉPI.
DE.	DE.
Hé?	Hé?
Seigneur, proſitez des droits de la victoire?	Seigneur, prositez des droits de la victoire?
Pouroit-on refuſer un Heros plein de gloire?	Pourrait-on refuser un Héros plein de gloire?
Cartage va tomber, & le ſoldat Romain vous honcie dela dudde dAſsieain, Seigneur vous pouvez tout, & vous êtes le maitre.	Carthage va tomber, et le soldat Romain vous honcie déla dude dAssiez, Seigneur vous pouvez tout, et vous êtes le maître.
SCIPION.	SCIPION.
En ſlatant mon amour que me fais-tu connoltre?	En slattant mon amour que me fais-tu connaître?
Ouy, ſi j’en conſultois les tranſports de mon cœur, Peut-ctre deviendrois-je un ſuperbe vainqueur?	Oui, si j'en consultais les transports de mon cœur, Peut-ctre deviendrais-je un superbe vainqueur?
Elle viendra bien-tôt cette tendre Iſperie, De ſon heureux Amant me demander la vie;	Elle viendra bientôt cette tendre Ispérie, De son heureux Amant me demander la vie;
Elle ignore ſon ſort que je luy fais cacher, Envain paimy les morts elle le fait chercher:	Elle ignore son sort que je lui fais cacher, Envain paimi les morts elle le fait chercher:
Mais helas!	Mais hélas!
çe qui rend ſa gloire plus palfaite, Il contraint ſon vainqueur d’envier ſa defaite, Tantoſt dans le combat j’ay connu ſon grand çœur, ’ay ſenti redoubler mon amour, ma fureur;	çe qui rend sa gloire plus palaite, Il contraint son vainqueur d'envier sa défaite, Tantôt dans le combat j'ai connu son grand çœur, aay senti redoubler mon amour, ma fureur;
Il tâchoit de ſauver une Amante fidelle, Je voyois à regret qu’il étoit digne d’elle?	Il tâchait de sauver une Amante fidèle, Je voyais à regret qu'il était digne d'elle?
Il étoit des momens où malgré mon couroux Je trouvois Annibal moins digne de mes coups:	Il était des moments où malgré mon courroux Je trouvais Hannibal moins digne de mes coups:
Mais que fait cet Amant ?	Mais que fait cet Amant ?
a-t-il la même audace?	a-t-il la même audace?
De quel œil maintenant reçoit-il ſa diſgrace?	De quel œil maintenant reçoit-il sa disgrâce?
LEPIDE.	LÉPIDE.
audigue d’avon ſaic un inutile eſtore, Il nous a conjurez de luy donner la moft?	audigue d'avon saisc un inutile estore, Il nous a conjurés de ton donner la moft?
Quel ſoin cruel, dit-il, prenez-vous de ma vie?	Quel soin cruel, dit-il, prenez-vous de ma vie?
Scipion eſt vainqueur, & je perds Iſperie;	Scipion est vainqueur, et je perds Ispérie;
Lelius le conſole, & d’un ſoin genereux.	Lélius le console, et d'un soin généreux.
SCIPION.	SCIPION.
Non, c’en eſt fait, n'laut qu'ir ctoune les feux, Je veux que Lucejus abandonne Iſperie, A ce prix je metray ſa liberté, ſa vie C'eſt à luy d’obélt.	Non, c'en est fait, n'elle qu'ir ctoune les feux, Je veux que Lucejus abandonne Ispérie, À ce prix je mettrai sa liberté, sa vie C'est à lui d'oblt.
Mais quel eſt mon deſſein?	Mais quel est mon dessein?
Suis-je encor Scipion?	Suis-je encor Scipion?
ou ſuis-je encor Romain?	ou suis-je encor Romain?
luſtes Dieux?	lûtes Dieux?
eſt-ce ainſi que je ſuis les exemples Des Heros à qui Rome a couſacré des Temples?	est-ce ainsi que je suis les exemples Des Héros à qui Rome a cousacré des Temples?
Eſt-ce ainſi que je ſuis la noble auſterité Qui les rendra fameux à la poſterité?	Est-ce ainsi que je suis la noble austérité Qui les rendra fameux à la postérité?
Etouſtons un amour.	Etoustons un amour.
Ah Dieux:	Ah Dieux:
que vais-je faite?	que vais-je faite?
De ma victoire un autte aura-t-il le ſalaite?	De ma victoire un autte aura-t-il le salaite?
tuur jevai atestoquaa Eupunconionta, A ſes yeux j’ay beſoin de toute ma vertu,	tuur jevai atestoquaa Eupunconionta, À ses yeux j'ai besoin de toute ma vertu,
SCENE VI.	SCÈNE VI.
ISPERIE, ERMILIE, SCIPION, LEPIDE.	ISPERIE, ERMILIE, SCIPION, LÉPIDE.
ISPERIE.	ISPERIE.
H!	H!
Seigneur, tirez-moy du plus eruël martyre ADe grace, & m’aprenez ſi Lucejus reſpire;	Seigneur, tirez-moi du plus ervuel martyre ADe grâce, et m'apprenez si Lucejus respire;
On me refuſe helas!	On me refuse hélas!
de m’aprendre ſon ſoit, Ce Prince malheureux a-t-il trouvé la mort?	de m'apprendre son soit, Ce Prince malheureux a-t-il trouvé la mort?
Puis-je me retracer l’épouvantable image D'un vuaiup coutetede montsde sepej de cimnager Ces cadavres ſanglants toua pâles ;	Puis-je me retracer l'épouvantable image D'un vay coutetede montsde sepéj de cimnager Ces cadavres sanglants toua pâles ;
tous glacez, (2 Qui n’offioient à mes yeux que des traits effacez, Ah!	tous glacés, (2 Qui n'offiaient à mes yeux que des traits effacés, Ah!
Seigneur, concevez mon deſeſpoir extrème, Dãs toutes ſes horreurs je cherchois ce que j’aime.	Seigneur, concevez mon désespoir extrême, Dance toutes ses horreurs je cherchais ce que j'aime.
SCIPION.	SCIPION.
Ne craignez plus pour luy, diſſipez vôtre eſfroy, lucejus eſt vivant,, & plus heureux que moy.	Ne craignez plus pour lui, dissipez votre éfroi, lucejus est vivant, et plus heureux que moi.
SPERIE.	SPERIE.
Il eſt vivant, mais quoy vous enetes le maître?	Il est vivant, mais quoi vous enetes le maître?
Vous poüvez diſpoſet de ſon ſort, & peut-etre La haine d’un rival qui vous a combatu.	Vous poüvez disposet de son sort, et peut-être La haine d'un rival qui vous a combattu.
Mais je ſoupçonne à tort, Seigneur, vôtre vertu, Songez que dans vos fers il n’a pour toutes armes- Que mes triſtes ſoûpirs, & que mes foibles larmes.	Mais je soupçonne à tort, Seigneur, votre vertu, Songez que dans vos fers il n'a pour toutes armes- Que mes tristes soupirs, et que mes faibles larmes.
SCIPIONN.	SCIPIONN.
Et c’eſt ce qui me tüe:	Et c'est ce qui me tue:
Il cauſe vos douleurs Ce trop heureux Amant, il fair couler vos pleurs, IIcoüte dés ſoſpirs qui ſont dignes d’anvie, Madame, & je veudrois les payer de ma vie.	Il cause vos douleurs Ce trop heureux Amant, il fair couler vos pleurs, IIcoute dès sospirs qui sont dignes d'anvie, Madame, et je veudrais les payer de ma vie.
ISPERIE nuto mrommeyyenaymmeeplaiſſ Ie pouſſe devant vous d’inutiles ſoûpirs- Vous détouruez yos yeux.	ISPERIE nuto mrommeyyenaymmeeplaiss Je pousse devant vous d'inutiles soupirs- Vous détouruez yos yeux.
*	*
SCIPION.	SCIPION.
Eh!	Eh!
détournez les vôtres:	détournez les vôtres:
Et puiſque leurs regards sõt deſtinez pour d’autres, Laiſſez m'en éviter l’éelat imperieux;	Et puisque leurs regards sont destinés pour d'autres, Laissez m'en éviter l'éelat impérieux;
Vous voyez les combats que je rends,juſtes Dieux!	Vous voyez les combats que je rends,justes Dieux!
que dois-je faire enme je fremis quand jy penſe, Madame, j'ay beſoin de toute ma couſtance;	que dois-je faire enme je frémis quand ji pense, Madame, j'ai besoin de toute ma coûtance;
Mais c’en eſt trop, malgré tant de vœux ſuperflus Que l’on faſſe vehir le Prince Lucejus?	Mais c'en est trop, malgré tant de vœux superflus Que l'on fasse véhir le Prince Lucejus?
26 2  Quel eſt vôtre deſſein?	26 2 Quel est votre dessein?
qu’en devons-nous attendre,, Seigneur ?	qu'en devons-nous attendre, Seigneur ?
SCIPION.	SCIPION.
Dans un moment vons le pourez aprendre,	Dans un moment vons le pourrez apprendre,
ISPERIE.	ISPERIE.
que dois-je croire,ah Dieux!	que dois-je croire,ah Dieux!
dãs cette extremité?	dans cette extrémité?
Quand d’un trouble ſi grand je vous vois agité,	Quand d'un trouble si grand je vous vois agité,
Fe MA MEdi M due vos regardi ſur moy ne rõbent qu'avec peine, Devicharoie:	Fe MA MEdi M due vos regardi sur moi ne rõbent qu'avec peine, Devicharoie:
je, seigueul,, roujerde vade hainta;	je, seigueul, roujerde vade hainta;
CIP.	CIP.
ION.	JON.
Madame, & plût aux Dieux que l’on pûr vous haït?	Madame, et plût aux Dieux que l'on pur vous hait?
Que je m’épargnęrois un mortel déplaiſir l Si malgré moy j’évite une fatale veuë, on objet tel que vous poite un chamme qui tue:	Que je m'épargnęrois une mortel déplaisir l Du malgré moi j'évite une fatale vue, on objet tel que vous poite un chamme qui tue:
SCENE DERNIERE.	SCÈNE DERNIÈRE.
EUCELUSS CELUS, SCITTON LEPIDE, ISRERIE, ERMILIE	ECELUS CELUS, SCITON LEPIDE, ISRERERIE, ERMILIE
17 LUCEJUS.	17 LUCEJUS.
Eigneur, ne croyez pas que la peur de la mortz & Me faſſe repentir d’un genereux effort, Je vous ay voulu perdre, & çe bras temeraire.	Eigneur, ne croyez pas que la peur de la mortz et Me fasse repentir d'un généreux effort, Je vous ai voulu perdre, et çe bras téméraire.
S'il étoit libre encor tâcheroit de ſe faire;	S'il était libre encor tâcherait de se faire;
Vous êtes mon rival, vous m’avez tout ôté,.	Vous êtes mon rival, vous m'avez tout ôté,.
.	.
Vous devez m’immoler à vôtre ſeureté, Je ſuis vôtre captif auſſ bien qu’Iſperie, J’en fremis;	Vous devez m'immoler à votre sûreté, Je suis votre captif aussi bien qu'Ispérie, J'en frémis;
mais de grace immólez une vie Qui deviendroit funeſte à vos jours glorieux, J’irois les attaquer à la face des Dieux, Prevenez par ma mort mon deſeſpoir, mon crime;	mais de grâce immólez une vie Qui deviendrait funeste à vos jours glorieux, J'irais les attaquer à la face des Dieux, Prévenez par ma mort mon désespoir, mon crime;
Perdant ce que je perds tout ſeroit.	Perdant ce que je perds tout serait.
legitime:	légitime:
SCIPION.	SCIPION.
je pardonne aiſément à ce tranſport jaloux, Si j’étois Lucejus je l’aurois comme vous, Vous m’avez dû haïr & ce n’eſt point un crime, Prince, pour un rival la haine eſt legitime, Ie le ſuis, je l’avoüe, ah Dieux!	je pardonne aisément à ce transport jaloux, Si j'étais Lucejus je l'aurais comme vous, Vous m'avez dû haïr et ce n'est point un crime, Prince, pour un rival la haine est légitime, Je le suis, je l'avoue, ah Dieux!
vous le ſçavez De quéls feux j’ay brûlé, maja de grace, achevex?	vous le savez De quéls feux j'ai brûlé, maja de grâce, achevex?
Un triomphe immortel dont la gloire ſemée De tout ce que j’ay fait paſſe la renommée, Pour laiſſer un exemple X la poſterité Rare, mais cependant qui puiſſe être imité:	Un triomphe immortel dont la gloire semée De tout ce que j'ai fait passe la renommée, Pour laisser un exemple X la postérité Rare, mais cependant qui puisse être imité:
Oüy, Madame, aujourd’huy je veux, quoy qu’il m’en coûte, Enſeigner anx mortels cetre nouvelle route, Leut montrer comme on peut domter ſa paſſion, Et vainqueur d’Annibal vaincre encor Scipion:	Oui, Madame, aujourd'hui je veux, quoi qu'il m'en coûte, Enseigner anx mortels cet nouvelle route, Leut montrer comme on peut dompter sa passion, Et vainqueur d'Hannibal vaincre encor Scipion:
Prince, raſſurez-vous, je vous donné la vie, Je fais plus, de ma main Fécevez Iſperie.	Prince, rassurez-vous, je vous donné la vie, Je fais plus, de ma main Fécevez Ispérie.
NOCEJUS.	NOCEJUS.
Ah !	Ah !
Seigneur,permettez qu’embraſſant vos geuoux Jo Seuse ee.	Seigneur,permettez qu'embrassant vos geuroux Jo Seuse ce.
Venvepouos oo	Venvepouos oo
SCIPION.	SCIPION.
Non, Prince, levez-vous.	Non, Prince, levez-vous.
*.	*.
41.	41.
TSPERTE.	TSPERTE.
Quelle grace, Seigneur, devõs-nous pai vous rẽdie?	Quelle grâce, Seigneur, devons-nous pai vous rẽdie?
Mait du grand Scipion nous de vions tout attendre.	Mait du grand Scipion nous de vions tout attendre.
SCIPION.	SCIPION.
Retournez à Zama couronner vôtre foy, Elle eſt un preſent digne & de vous, & de moy;	Retournez à Zama couronner votre foi, Elle est un présent digne et de vous, et de moi;
Je ne demande icy pour toute recompenſe, Pour le prix & le nœud d’une étroite alliance, Prince, que vous ſoyez en luy donnant la main Amy de Scipion, & du peuple Romain;	Je ne demande ici pour toute récompense, Pour le prix et le nœud d'une étroite alliance, Prince, que vous soyez en lui donnant la main Ami de Scipion, et du peuple Romain;
Je vuls me pnomer dd onene de Cunses Par ſa priſe je dois achever mon ouvrage, Et j’eſpere dans peu la rangeant ſous mes loix Triompher d’Annibal une ſeconde fois Adieu, vivez heureux.	Je vuls me pénomer déd onene de Cunses Par sa prise je dois achever mon ouvrage, Et j'espère dans peu la rangeant sous mes lois Triompher d'Hannibal une seconde fois Adieu, vivez heureux.
LUCEJUS.	LÙCEJEUS.
Admirons ce grand, homme, Le plus perfait Heros qu’ait jam de ]batil Rome.	Admirons ce grand, homme, Le plus perfait Héros qu'ait jam de ]batil Rome.
Relivre serrée	Relivre serrée
Relivre serrée	Relivre serrée
