M.	M.
DC.	DC.
LXXIII.	LXXIII.
AVEC PRIVILEGE DV ROI.	AVEC PRIVILÈGE DU ROI.
]	]
LDcrldlro MC	LDcrédlro MC
ordonné.	ordonné.
8 ET Ouvrage n’eſt pas tout d’une main.	8 ET Ouvrage n'est pas tout d'une main.
M.	M.
Quinault a fait les Paroles qui s’y chantent MM en Muſique, à la reſerve de la Plainte Italienne.	Quinault a fait les Paroles qui s'y chantent MM en Musique, à la réserve de la Plainte Italienne.
M.	M.
Moliere a dreßé le Plan de la Piece, & reglé la diſpoſition, où il s’eſt plus attaché aux beautez & à la pompe du Spectacle, qu’à l’exacte regularité.	Molière a dresié le Plan de la Pièce, et règlé la disposition, où il s'est plus attaché aux beautés et à la pompe du Spectacle, qu'à l'exacte régularité.
Quant à la Verſification, il n’a pas eu le loiſir de la faire entiere.	Quant à la Versification, il n'a pas eu le loisir de la faire entière.
Le Carnaval approchoit, & les Ordres preſſans du Roy, qui ſe vouloit donner ce magnifique Divertiſſement pluſieurs fois avant le Careſme, l’ont mis dans la neceſſité de ſouffrir un peu de ſecours.	Le Carnaval approchait, et les Ordres pressants du Roi, qui se voulait donner ce magnifique Divertissement plusieurs fois avant le Carésame, l'ont mis dans la nécessité de souffrir un peu de secours.
Ainſi il n’y a que le Prologue, le Premier Acte, la premiere Scene du Second, & la premiere du Troiſiéme, dont les Vers ſoient de luy.	Ainsi il n'y a que le Prologue, le Premier Acte, la première Scène du Second, et la première du Troisième, dont les Vers soient de grands.
M.	M.
Corneille a employé une quinzaine au reſte;	Corneille a employé une quinzaine au reste;
& par ce moyen Sa Majeſté s’eſt trouvée ſervie dans le temps qu'elle l’avoit	et par ce moyen Sa Majesté s'est trouvée servie dans le temps qu'elle l'avait
L’AMOUR.	L'AMOUR.
ÆGIALE.	ÆGIALE.
PHAENE.	PHANE.
Graces.	Grâces.
PSICHE'.	PSICHÉE.
LE ROY, Pere de Pſiché.	LE ROY, Père de Psiché.
LE ZEPHIRE, LYCAS, LE DIEU D'UN FLEUVE.	LE ZEPHIRE, LYCAS, LE DIEU D'UN FLEUVE.
PSICHE TRAGEDIE-BALLET.	PSYCHE -TRAGÉDIE-BALLET.
PROLOGUE.	PROLOGUE.
8 34 Scene repreſente ſur le devant uu Lieu champeſtre, & dans l’enfoncement un Rocher percé à jour, à travers duquel u M on voit la Mer en éloignement.	8 34 Scène représente sur le devant u Lieu champêtre, et dans l'enfoncement un Rocher percé à jour, à travers duquel è M on voit la Mer en éloignement.
Ehm Flore paroiſt au milieu du Théatre, accompagnée de Vertumne Dieu des Arbres & des Fruits, & de Palamon Dieu des Eaux.	Ehm Flore paraît au milieu du Théâtre, accompagnée de Vertumne Dieu des Arbres et des Fruits, et de Palamon Dieu des Eaux.
Chacun do ces Dieux conduit une Troupe de Divinitez:	Chacun do ces Dieux conduit une Troupe de Divinités:
l’un mene à ſa ſuite des Dryades & des Sylvains;	l'un mène à sa suite des Dryades et des Sylvains;
& l'autre des Dieux, des Fleuves & des Nayades.	et l'autre des Dieux, des Fleuves et des Naïades.
Flora chante ce Recit pour inviter Venus à deſcendre en Terre.	Flora chante ce Recit pour inviter Venus à descendre en Terre.
E n’eſt plus le temps de la Guerre, CLe plus puiſſant des Rois Interrompt ſes Explois Pour donner la Paix à la Terre.	E n'est plus le temps de la Guerre, CLe plus puissant des Rois Interrompt ses Explois Pour donner la Paix à la Terre.
Beiconuuns Merddes Amours, Venez nous donner de beaux jours.	Beiconuuns Merdes Amours, Venez nous donner de beaux jours.
Vertumne & Palamon, avec les Divinitez qui les accompagnent, joignent leurs voix à celle de Flore, & chantent ces paroles.	Vertumne et Palamon, avec les Divinités qui les accompagnent, joignent leurs voix à celle de Flore, et chantent ces paroles.
CHOEUR DE TOUTES LES Divinitez de la Terre & des Eaux.	CHOEUR DE TOUTES LES Divinités de la Terre et des Eaux.
Compoſé de Flore, Nymphes, Palæmon, Vertumne, Sylvains, Faunes, Dryades & Nayades.	Composé de Flore, Nymphes, Palæmon, Vertne, Sylvains, Faunes, Dryades et Nayades.
Ous gouſtons une Paix profonde, NLes plus doux Jeux ſont icy bas;	Ous goûtons une Paix profonde, NLes plus doux Jeux sont ici bas;
On doit ce repos plein d’appas Au plus Grand Roy du Monde.	On doit ce repos plein d'appas Au plus Grand Roi du Monde.
Deſcendez, Mere des Amours, Venez nous donner de beaux jours.	Descendez, Mère des Amours, Venez nous donner de beaux jours.
Il ſe fatt en fuite une Entrée de Ballet, compoſée de deux Dryades, quatre Sylvains, deux Fleuves, & deux Nayades.	Il se fatt en fuite une Entrée de Ballet, composée de deux Dryades, quatre Sylvains, deux Fleuves, et deux Naïades.
Apres laquelle, Vertumne & Palamou chantent ée Dialogne.	Après laquelle, Vertumne et Pamou chantent ée Dialogne.
VERTUMNE.	VERTUMNE.
Endez-vous, Beautez cruelles, N Soûpirez à voſtre tour.	Endez-vous, Beautés cruelles, N Soûpirez à votre tour.
PALÆMON.	PALÆMON.
Voicy la Reyne des Belles, Qui vient inſpiter l’amour.	Voici la Reine des Belles, Qui vient inspiter l'amour.
VERTUMNE.	VERTUMNE.
Un bel Objet toûjours ſevere Ne ſe fait jamais bien aimer.	Un bel Objet toujours sévère Ne se fait jamais bien aimer.
PALÆMON.	PALÆMON.
C’eſt la beauté qui commence de plaire, Mais la douceur acheve de charner.	C'est la beauté qui commence de plaire, Mais la douceur achève de charner.
Ils repetent enſemble ces derniers Vers.	Ils répètent ensemble ces derniers Vers.
C’eſt la beaute qurcon mence de plaire, Mais la douceur acheve de charmer.	C'est la beauté qurcon menée de plaire, Mais la douceur achève de charmer.
VERTUMNE.	VERTUMNE.
Souffrons tous qu’Amour nous bleſſe;	Souffrons tous qu'Amour nous blesse;
Languiſſons, puis qu’il le faut.	Languissons, puis qu'il le faut.
AADDATON.	AADATON.
Que ſert un cœur ſans tendreſſe?	Que sert un cœur sans tendresse?
Eſt-il un plus grand defaut?	Est-il un plus grand défaut?
VERTOMNE.	VERTOMNE.
Un bel Objet toûjours ſevere Ne ſe fait jamais bien aimer.	Un bel Objet toujours sévère Ne se fait jamais bien aimer.
PALÆMON.	PALÆMON.
C’eſt la beauté qui commence de piaire, Mrais la uoureur aene ve de enaimer.	C'est la beauté qui commence de piaire, Mrais la ouvreur aene ve de enaimer.
Flore répond au Diaiegue de Vertumne & de Palæmon, par ce Menuet;	Flore répond au Diaiègue de Vertumne et de Palæmon, par ce Menuet;
& les autres Divi nitez y meſlent leurs Pances.	et les autres Divi tés y mêlent leurs Pances.
St-on ſage LDans le bel âge, Eſt-on ſage De n’aimer pas?	St-on sage LDans le bel âge, Est-on sage De n'aimer pas?
Que ſavs ceſſe L'on ſe preſſe De gouſter les plaiſirs icy bas:	Que savs cesse L'on se presse De goûter les plaisirs ici bas:
La íageſſe De la Jeuneſſe, C’eſt de ſçavoir joüir ce ſes appas.	La agesse De la Jeunesse, C'est de savoir jouir ce ses appas.
A:	A:
L’Amour charme Ceux qu’il deſarme;	L'Amour charme Ceux qu'il désarme;
L’Amour charme, Cedons luy tous, Noſtre peine Seroit vaine De vouloir reſiſter à ſes coups:	L'Amour charme, Cédons Seigneur tous, Notre peine Serait vaine De vouloir résister à ses coups:
Quelque chaîne Qu’un Amant prenne, La liberté n’a rien qui ſoit ſi doux.	Quelque chaîne Qu'un Amant prenne, La liberté n'a rien qui soit si doux.
Vénus deſcend du Ciel dans une grande Machine avec l’Amour ſon Fils, & deux petites Graces, nommées Ægiale & Phaéne, & les Divinitez de la Terre & des Eaux recommencent de joindre toutes leurs voix, & continuent par leurs Dances de luy témoigner la joye qu’elles reſſentent à ſon abord.	Venus descend du Ciel dans une grande Machine avec l'Amour son Fils, et deux petites Grâces, nommées Égiale et Phane, et les Divinités de la Terre et des Eaux recommencent de joindre toutes leurs voix, et continuent par leurs Dances de Se témoigner la joie qu'elles ressent à son abord.
CHOEUR DE TOUTES LES Divinitez de la Terre & des Eaux.	CHOEUR DE TOUTES LES Divinités de la Terre et des Eaux.
Ous gouſtons une Paix profonde;	Ous goûtons une Paix profonde;
IN Les plus doux Jeux ſont icy bas;	IN Les plus doux Jeux sont ici bas;
On doit ce repos plein d’appas Au plus Grand Roy du Monde.	On doit ce repos plein d'appas Au plus Grand Roi du Monde.
Delcendez, Mere des Amours, Venez nous donner de beaux jours.	Delcendez, Mère des Amours, Venez nous donner de beaux jours.
VENUS dans ſa Machine.	VENUS dans sa Machine.
Eſſez, ceſſez pour moy tous vos chãts d’allegreſſe:	Essez, cessez pour moi tous vos chants d'allégresse:
C De ſi rares honneurs ne m’appartiennent pas, Et l’hommage qu’icy voſtre bonté m’adreſſe Doit eſtre reſervé pour de plus doux appas.	Ç Ce si rares honneurs ne m'appartiennent pas, Et l'hommage qu'ici votre bonté m'adresse Doit être réservé pour de plus doux appas.
C’eſt une trop vieille methode De me venir faire ſa Cour;	C'est une trop vieille méthode De me venir faire sa Cour;
Toutes les choſes ont leur tour, Et Vénus n’eſt plus à la mode.	Toutes les choses ont leur tour, Et Venus n'est plus à la mode.
Il eſt d’autres attra its naiſſans, Où l’on va porter ſes encens;	Il est d'autres attra its naissants, Où l'on va porter ses encens;
Pſiché, Pſiché la Belle, aujourd’huy tient ma place, Déja tout l'Univers s’empreſſe à l’adorer, Et c’eſt trop que dans ma diſgrace Je trouve encor quelqu’un qui me daigne honoret.	Psiché, Psiché la Belle, aujourd'hui tient ma place, Déjà tout l'Univers s'empresse à l'adorer, Et c'est trop que dans ma disgrâce Je trouve encor quelqu'un qui me daigne honoret.
On ne balance point entre nos deux mérites, A quitter mon party tout s’eſt licencié, Et du nombreux amas de Graces favorites, Dont je traiſnois par tout les ſoins & l’amitié, Il ne m’en eſt reſté que deux des plus petites, Qui m’accompagnent par pitié.	On ne balance point entre nos deux mérites, À quitter mon parti tout s'est licencié, Et du nombreux amas de Grâces favorites, Dont je traînais par tout les soins et l'amitié, Il ne m'en est resté que deux des plus petites, Qui m'accompagnent par pitié.
Souffrez que ces Demeures ſombres Preſtent leur ſolitude aux troubles de mon cœur, Le ihe iaines purinj ledis onbies Cacher ma honte & ma douleur.	Souffrez que ces Demeures sombres Prêtent leur solitude aux troubles de mon cœur, Le ihe jas purinj ledis onbies Cacher ma honte et ma douleur.
Flore & les autres Deïtez ſe retirent, & Vénus avec ſa Suite ſort de ſa Machine.	Flore et les autres Déités se retirent, et Vénus avec sa Suite sort de sa Machine.
ÆGIALE.	ÆGIALE.
Nous ne ſçavons, Déeſſe, comment faire, Dans ce chagrin qu’on voit vous accabler:	Nous ne savons, Déesse, comment faire, Dans ce chagrin qu'on voit vous accabler:
Noſtre reſpect veut ſe taire, Noſtre zéle veut parler.	Notre respect veut se taire, Notre zèle veut parler.
VENUS.	VENUS.
Parlez, mais ſi vos ſoins aſpirent à me plaire, Laiſſez tous vos conſeils pour une autre ſaiſon, Et ne parlez de ma colere, Que pour dire que j’ay raiſon.	Parlez, mais si vos soins aspirent à me plaire, Laissez tous vos conseils pour une autre saison, Et ne parlez de ma colère, Que pour dire que j'ai raison.
C’eſtoit-la, c’eſtoit-là la plus ſenſible offence, Que ma Divinité pût jamais recevoir, A iij Mais j’en auray la vangeance, Si les Dieux ont du pouvoir.	C'était-la, c'était-là la plus sensible offense, Que ma Divinité pût jamais recevoir, A jà Mais j'en aurai la vengeance, Si les Dieux ont du pouvoir.
PHAENE.	PHANE.
Vous avez plus que nous de clartez, de ſageſſe, Pour juger qui peut eſtre digne de vous:	Vous avez plus que nous de clartés, de sagesse, Pour juger qui peut être digne de vous:
Mlais pour nioy jauto retu jaune grande Déeſſe Devroit moins ſe mettre en couroux.	Mlais pour ni jauto rétu jaune grande Déesse Devrait moins se mettre en courroux.
VENTZS.	VENTZS.
Et c’eſt la raiſon de ce couroux extréme.	Et c'est la raison de ce courroux extrême.
Plus mon rang a d'éclat, plus l’affront eſt ſanglant, Et ſi je n’eſtois pas dans ce degré ſupréme, Le dépit de mon cœur ſeroit moins violent.	Plus mon rang a d'éclat, plus l'affront est sanglant, Et si je n'étais pas dans ce degré suprême, Le dépit de mon cœur serait moins violent.
Moy ſa Fille du Dieu qui lance le Tonnerre, Mere du Dieu qui fait aimer;	Moi sa Fille du Dieu qui lance le Tonnerre, Mère du Dieu qui fait aimer;
Moy les plus doux ſouhaits du Ciel & de la Terre, Et qui ne ſuis venuë au jour que pour charmer;	Moi les plus doux souhaits du Ciel et de la Terre, Et qui ne suis venue au jour que pour charmer;
Moy, qui par tout ce qui ceſpire Ay veu de tant de vœux encenſer mes Autels, Et qui de la Beauré, par des droicts immortels, Ay tenu de tout temps le ſouverain Empire;	Moi, qui par tout ce qui cespire Ai vu de tant de vœux encenser mes Autels, Et qui de la Beauré, par des droits immortels, Aï tenu de tout temps le souverain Empire;
Moy, dont les yeux ont mis deux grandes Deïtez Au point de me ceder le prix de la plus belle, Je me voymi victoire & mes droict;	Moi, dont les yeux ont mis deux grandes Deïtez Au point de me der le prix de la plus belle, Je me voisi victoire et mes droit;
Ziſputez Par une chetive Mortelle!	Zisputez Par une chétive Mortelle!
Le ridicule excés d’un foleuteſtement Va juſqu’à m’oppoſer une petite Fille!	Le ridicule excès d'un foleutestement Va jusqu'à m'opposer une petite Fille!
our les tilits & les imens pentrytay conitamment Un temeraire jugement!	our les tits et les iments pentrytai conitamment Un téméraire jugement!
Et du haut des Cieux où je brille, J’entendray prononcer aux Mortels prévenus, Elle eſt plus belle que Vénus!	Et du haut des Cieux où je brille, J'entendrai prononcer aux Mortels prévenus, Elle est plus belle que Vénus!
ÆGIALE.	ÆGIALE.
Voila comme l’on fait, c’eſt le ſtyle des Hommes, Ils ſont impertinens dans leurs comparaiſons,	Voilà comme l'on fait, c'est le style des Hommes, Ils sont impertinents dans leurs comparaisons,
PHAENE.	PHANE.
Ils ne ſçauroient loüer dans le Siecle où nous ſommes, Qu’ils n’outragent les plus grands noms.	Ils ne sauraient louer dans le Siècle où nous sommes, Qu'ils n'outragent les plus grands noms.
VENUS.	VENUS.
Ah que de ces trois mots la rigueur inſolente Vange bien Junon & Pallas, Et conſole leurs cœurs de la gloire éclatante Que la fameuſe Pomme acquit à mes appas!	Ah que de ces trois mots la rigueur insolente Venge bien Junon et Pallas, Et console leurs cœurs de la gloire éclatante Que la fameuse Pomme acquit à mes appas!
Je les voy s’applaudir de mon inquietude, Affecter à toute heure un ris malicieux, Et d’un fixe regard chercher avec étude Ma confuſion dans mes yeux.	Je les vois s'applaudir de mon inquiétude, Affecter à toute heure un ris malicieux, Et d'un fixe regard chercher avec étude Ma confusion dans mes yeux.
Leur triomphante joye au fort d’un tel outrage, Semble me venir dire, inſultant mon couroux, Vante, vante, Vénus, les traits de ton viſage, Au jugement d’un ſeul tu l’emportas ſur nous, Mais par le jugement de tous Une ſimple Mortelle a ſur toy l’avantage.	Leur triomphante joie au fort d'un tel outrage, Semble me venir dire, insultant mon courroux, Vante, vante, Vénus, les traits de ton visage, Au jugement d'un seul tu l'emportas sur nous, Mais par le jugement de tous Une simple Mortelle a sur toi l'avantage.
Ah!	Ah!
ce coup là m’acheve, il me perce le cœur, Je n’en puis plus ſouffrir les rigueurs ſans égales, Et c’eſt trop de ſurcroiſt à ma vive douleur, Que le plaiſir de mes Rivales.	ce coup là m'achève, il me perce le cœur, Je n'en puis plus souffrir les rigueurs sans égales, Et c'est trop de surcroît à ma vive douleur, Que le plaisir de mes Rivales.
Mon Fils, ſi j’eus jamais ſur toy quelque credit, Et ſi jamais je te fus chere, Si tu portes un cœur à ſentir le dépit Qui trouble le cœur d’une Mere, Qui ſi tendrement te chérit;	Mon Fils, si j'eus jamais sur toi quelque crédit, Et si jamais je te fus chère, Si tu portes un cœur à sentir le dépit Qui trouble le cœur d'une Mère, Qui si tendrement te chérit;
Employe, employe icy l’effort de ta puiſſanee A ſoûtenir mes intereſts, Et fais à Pſiché par tes traits Sentir les traits de ma vangeance.	Emploie, emploie ici l'effort de ta puissance A soutenir mes intérêts, Et fais à Psiché par tes traits Sentir les traits de ma vengeance.
Pour rendre ſon cœur malheureux, Prens celuy de tes traits le plus propre à me plaire Le plus empoiſonné de ceux Que tu lances dans ta colere;	Pour rendre son cœur malheureux, Prends celui de tes traits le plus propre à me plaire Le plus empoisonné de ceux Que tu lances dans ta colère;
Du plus bas, du plus vil, du plus affreux Mortel, Fais que juſqu’à la rage elle ſoit enflâmée, Et qu’elle ait à ſouffrir le ſuplice cruel D’aimer & n’eſtre point aimée.	Du plus bas, du plus vil, du plus affreux Mortel, Fais que jusqu'à la rage elle soit enflammée, Et qu'elle ait à souffrir le suplice cruel D'aimer et n'être point aimée.
L'AMOUR.	L'AMOUR.
Dans le Monde on n'entend que plaintes de l’Amour.	Dans le Monde on n'entend que plaintes de l'Amour.
On m’impute par tout mille fautes commiſes, Et vous ne croiriez point le mal & les ſottiſes Que l’on dit de moy chaque jour.	On m'impute par tout mille fautes commises, Et vous ne croiriez point le mal et les sottises Que l'on dit de moi chaque jour.
Si pour ſervir voſtre colere.	Si pour servir votre colère.
TENUS.	TENUS.
Va ne reſiſte point aux ſouhaits de ta Mere, N’applique tes raiſonnemens Qu’à chercher les plus prompts momens De faire un ſacrifice à ma gloire outragée.	Va ne résiste point aux souhaits de ta Mère, N'applique tes raisonnements Qu'à chercher les plus prompts moments Il faire un sacrifice à ma gloire outragée.
Parts, pour toute réponſe à mes empreſſemens, Et ne me revoy point que je ne ſois vangée.	Parts, pour toute réponse à mes empressements, Et ne me revoi point que je ne sois vengée.
L’Amour s’envole, & Vénus ſe retire avec les Graces.	L'Amour s'envole, et Venus se retire avec les Grâces.
La Scene eſt changée en une grande ville, où l'on découvre des deux coſtez, des Palais & des Maiſons de diferens ordres d’Architestare.	La Scène est changée en une grande ville, où l'on découvre des deux côtés, des Palais et des Maisons de dierents ordres d'Architestare.
ACTE PREMIER SCENE PREMIERE.	ACTE PREMIER SCÈNE PREMIÈRE.
AGLAURE, CIDIPPE.	AGLAURE, CIDIPPE.
on AGLAURE.	on AGLAURE.
L eſt des maux, ma Sœur, que le ſilence aigrit, Laiſſons, laiſſons parler mon chagrin & le voſtre, Et de nos cœurs l’un à l’autre Exhalons le cuiſant dépit:	L est des maux, ma Sœur, que le silence aigrit, Laissons, laissons parler mon chagrin et le vôtre, Et de nos cœurs l'un à l'autre Exhalons le cuisant dépit:
Nous nous voyons Sœurs d’infortune, Et la voſtre & la mienne ont un ſi grand raport, Que nous pouvons meſler toutes les deux en une, Et dans noſtre juſte tranſport Murmurer à plainte commune Des cruautez de noſtre ſort.	Nous nous voyons Sœurs d'infortune, Et la vôtre et la mienne ont un si grand rapport, Que nous pouvons mêler toutes les deux en une, Et dans notre juste transports Murmurer à plainte commune Des cruautés de notre sort.
Quelle fatalité ſecrete, Ma Sœur, ſoîmet tout l’Univers Aurattraits de noſtre Cadette, Et de tant de Princes divers Qu’en ces lieux la Fortune jette, N’en preſente aucun a nos fers?	Quelle fatalité secrète, Ma Sœur, soîmet tout l'Univers Aurattraits de notre Cadette, Et de tant de Princes divers Qu'en ces lieux la Fortune jette, N'en présente aucun a nos fers?
Quoy, voir de toutes parts pour luy rendre les armes, Les cœurs ſe précipiter, Et paſſer devant nos charmes, Sans s’y vouloir arreſter?	Quoi, voir de toutes parts pour lui rendre les armes, Les cœurs se précipiter, Et passer devant nos charmes, Sans s'y vouloir arrêter?
Quel ſort ont nos yeux en partage, Et qu’eſt ce qu’ils ont fait aux Dieux, De ne joüir d’aucun hommage, Parmy tous ces tributs de ſoûpirs glorieux, Dont le ſuperbe avantage Fait triompher d’autres yeux?	Quel sort ont nos yeux en partage, Et qu'est ce qu'ils ont fait aux Dieux, De ne jouir d'aucun hommage, Parmi tous ces tributs de soupirs glorieux, Dont le superbe avantage Fait triompher d'autres yeux?
Eſt-il pour nous, ma Sœur, de plus rude diſgrace, Que de voir tous les cœurs mepriler nos appas, Et l’heureuſe Pſiché joüir avec audace D’une foule d’Amans attachez à ſes pas?	Est-il pour nous, ma Sœur, de plus rude disgrâce, Que de voir tous les cœurs mépriler nos appas, Et l'heureuse Psiché jouir avec audace D'une foule d'Amands attachez à ses pas?
CIDIPPE.	CIDIPE.
dlli sauauya nadeavanedio A faire perdre la raiſon, Et tous les maux de la Nature, Ne ſont rien en comparaiſon.	dlli zavia nadeavanédio A faire perdre la raison, Et tous les maux de la Nature, Ne sont rien en comparaison.
AGLAURE.	AGLAURE.
Pour moy j’en ſuis ſouvent juſqu’à verſer des larmes, Tout plaiſir, tout repos, par là m’eſt arraché, Cõtre un pareil malheur ma cõſtance eſt ſans armes, Toûjours à ce chagrin mon eſprit attaché Me tient devant les yeux la honte de nos charmes, Et le triomphe de Pſiché.	Pour moi j'en suis souvent jusqu'à verser des larmes, Tout plaisir, tout repos, par là m'est arraché, Contre un pareil malheur ma commstance est sans armes, Toujours à ce chagrin mon esprit attaché Me tient devant les yeux la honte de nos charmes, Et le triomphe de Psiché.
La nuit il m’en repaſſe une idée eternelle Qui ſur toute choſe prévaut;	La nuit il m'en repasse une idée éternelle Qui sur toute chose prévaut;
Rien ne me peut chaſſer cette image cruelle, Et dés qu’un doux ſommeil me vient délivrer d’elle, Dans mon eſprit auſſi-toſt Quelque ſonge la rappelle, Qui me reveille en lurtaut.	Rien ne me peut chasser cette image cruelle, Et dès qu'un doux sommeil me vient délivrer d'elle, Dans mon esprit aussitôt Quelque songe la rappelle, Qui me réveille en lurtaut.
CIDIPPE.	CIDIPE.
Ma Sœur, voila mon martire.	Ma Sœur, voilà mon martyre.
Dans vos diſcours je me voy, Et vous venez-là de dire Tout ce qui ſe paſſe en moy.	Dans vos discours je me vois, Et vous venez-là de dire Tout ce qui se passe en moi.
AGLAURE.	AGLAURE.
Mais encor, raiſonnons un peu ſur cette affaire.	Mais encor, raisonnons un peu sur cette affaire.
Quels charmes ſi puiſſans en elle ſont épars, Et par où, dites-moy, du grand ſecret de plaire, L’honneur eſt-il acquis à ſes moindres regards?	Quels charmes si puissants en elle sont épars, Et par où, dites-moi, du grand secret de plaire, L'honneur est-il acquis à ses moindres regards?
Que voit-on dans ſa perſonne, Pour inſpirer tant d’ardeurs?	Que voit-on dans sa personne, Pour inspirer tant d'ardeurs?
Quel droit de beauté luy donne L’Empire de tous les cœurs?	Quel droit de beauté avait donne L'Empire de tous les cœurs?
Elle a quelques attraits, quelque éclat de jeuneſſe, Ou en tombe d’accord, je n’en diſconviens pas;	Elle a quelques attraits, quelque éclat de jeunesse, Ou en tombe d'accord, je n'en disconviens pas;
Mais luy cede-t-on fort pour quelque peu d’aiſneſſe, Et ſe voit-on ſans appas?	Mais quelque cede-t-on fort pour quelque peu d'aînesse, Et se voit-on sans appas?
Eſt-on d’une figure à faire qu’on ſe raille?	Est-on d'une figure à faire qu'on se raille?
N’a-t-ou point quelques traits, &quelques agrémens, Quelque teint, quelques yeux, quelque air & quelque taille A pouvoir dans nos fers jetter quelques Amans?	N'a-t-ou point quelques traits, etquelques agrémens, Quelque teint, quelques yeux, quelque air et quelque taille À pouvoir dans nos fers jeter quelques Amants?
Ma Sœur, faites-moy la grace De nte patier tanchenent, Suis-jefaite d’an air à voſtre jugement, Que mon mérite au fien doive ceder la place, Et dans quelque ajuſtement Trouvez-vous qu’elle m’efface?	Ma Sœur, faites-moi la grâce De natte patier tanchènent, Suis-jefaite d'an air à votre jugement, Que mon mérite au sien doive céder la place, Et dans quelque ajustement Trouvez-vous qu'elle m'efface?
CIDIPPE Qui, vous, ma Sœur?	CIDIPE Qui, vous, ma Sœur?
nullement.	nullement.
Hier à la Chaſſe, pres d’elle, Jel vous egarday long-temps, Et ſans vous donner d’encens, Vous me paruſtes plus belle.	Hier à la Chasse, pres d'elle, Jel vous égardai longtemps, Et sans vous donner d'encens, Vous me parûtes plus belle.
Mais moy, dites ma Sœur, ſans me vouloir flater, Sont-ce des viſions que je me mets en teſte, Quand je me croy taillée à pouvoir meriter La gloire de quelque conqueſte?	Mais moi, dites ma Sœur, sans me vouloir flatter, Sont-ce des visions que je me mets en tête, Quand je me crois taillée à pouvoir mériter La gloire de quelque conquête?
AGLAURE.	AGLAURE.
Vous, ma Sœur, vous avez ſans nul déguiſement, Tout ce qui peut cauſer une amoureuſe flâme;	Vous, ma Sœur, vous avez sans nul déguisement, Tout ce qui peut causer une amoureuse flamme;
Vos moindres actions brillent d’un agrément Dont je meſſens toucher l’autis, Et je ſerois voſtre Amant, Si j’eſtois autre que Femme.	Vos moindres actions brillent d'un agrément Dont je mess toucher l'autis, Et je serais votre Amant, Si j'étais autre que Femme.
CIDIPPE.	CIDIPE.
D’où vient dõcqu’on la voit l’emporter ſur rous deux, Qu’à ſes premiers regards les cœurs rẽdent les armes, Et que d’aucun tribut de ſoûpirs & de vœux On ne fait honneur à nos charmes?	D'où vient dõcqu’on la voit l'emporter sur rous deux, Qu'à ses premiers regards les cœurs rẽdent les armes, Et que d'aucun tribut de soupirs et de vœux On ne fait honneur à nos charmes?
AGLAURE.	AGLAURE.
Tautes les Daines dulle vox Trouvent ſes attraits peu de choſe, Et du nombre d’Amans qu’elle tient ſous ſes loix, Ma Sœur, j’ay découvert la cauſe.	Tautes les Daines du nox Trouvent ses attraits peu de chose, Et du nombre d'Amands qu'elle tient sous ses lois, Ma Sœur, j'ai découvert la cause.
CIDIPPE.	CIDIPE.
Pour moy je la devine, & l’on doit préſumer Qu’il faut que là-deſſous ſoit caché du miſtere:	Pour moi je la devine, et l'on doit présumer Qu'il faut que là-dessous soit caché du mystère:
Ccleclet de tout chnainer N’eſt point de la Nature un effet ordinaire;	Ccleclet de tout chnainer N'est point de la Nature un effet ordinaire;
L’Art de la Theſſalie entre dans cette affaire, Et quelque main a ſçeu ſans doute luy former Un charme pour ſe faire aimer.	L'Art de la Thessalie entre dans cette affaire, Et quelque main a cheu sans doute lui former Un charme pour se faire aimer.
AGLAURE.	AGLAURE.
Sur un plus fort appuy ma croyance ſe fonde, Et le charme qu’elle a pour attirer les cœurs, C’eſt un air en tout temps deſarmé de rigueurs, Des regards careſſans que la bouche ſeconde, Un ſoûris chargé de douceurs Qui tend les bras à tout le monde, Et ne vous promet que faveurs.	Sur un plus fort appui ma croyance se fonde, Et le charme qu'elle a pour attirer les cœurs, C'est un air en tout temps désarmé de rigueurs, Des regards caressants que la bouche seconde, Un souris chargé de douceurs Qui tend les bras à tout le monde, Et ne vous promet que faveurs.
Noſtre gloire n’eſt plus aujourd’huy conſervée, Et l’on n’eſt plus au temps de ces nobles fiertez, Qui par un digne eſfay d’illuſtres cruautez, Vouloient voir d’un Amant la conſtance éprouvée.	Notre gloire n'est plus aujourd'hui conservée, Et l'on n'est plus au temps de ces nobles fierté, Qui par un digne éfai d'illustres cruautés, Voulaient voir d'un Amant la constance éprouvée.
De tout ce noble orgueil qui nous ſeyoit ſi bien, ciirent orerdeſcondu duns le oieele ou nous fommes, Et l’on en eſt reduite à n’eſperer plus rien, A moins que l’on ſe jette à la teſte des Hommes.	De tout ce noble orgueil qui nous seyait si bien, ciirent orerdescondu duns le oièle ou nous fommes, Et l'on en est réduite à n'espérer plus rien, À moins que l'on se jette à la tête des Hommes.
CIDIPPE.	CIDIPE.
Oüy, voila le ſecret de l’affaire, & je voy Que vous le prenez mieux que moy.	Oui, voilà le secret de l'affaire, et je vois Que vous le prenez mieux que moi.
C’eſt pour nous attacher à trop de bienſeance, Qu’aucun Amant, ma Sœur, à nous ne veut venir, Et nous voulons trop ſoûtenir L’honneur de noſtre Sexe, & de noſtre naiſſance.	C'est pour nous attacher à trop de bienséance, Qu'aucun Amant, ma Sœur, à nous ne veut venir, Et nous voulons trop soutenir L'honneur de notre Sexe, et de notre naissance.
Les Hommes maintenant aiment ce qui leur rit, L’eſpoir, plus que l’Amour, eſt ce qui les attire, Et c’eſt par là que Pſiché nous ravit Tous les Amans qu’on voit ſous ſon empire.	Les Hommes maintenant aiment ce qui leur rit, L'espoir, plus que l'Amour, est ce qui les attire, Et c'est par là que Psiché nous ravit Tous les Amants qu'on voit sous son empire.
Suivons, ſuivons l’exemple, ajuſtons-nous au temps, Abaiſſons-nous, ma Sœur, à faire des avances, Et ne ménageons plus de triſtes bienſeances Qui nous oſtent les fruits du plus beau de nos ans,	Suivons, suivons l'exemple, ajustons-nous au temps, Abaissons-nous, ma Sœur, à faire des avances, Et ne ménageons plus de tristes bienséances Qui nous ôtent les fruits du plus beau de nos ans,
AGLAURE.	AGLAURE.
J’aprouve la penſée, & nous avons matiere D’en faire l’épreuve premiere Aux deux Princes qui ſont les derniers arrivez.	J'approuve la pensée, et nous avons matière D'en faire l'épreuve première Aux deux Princes qui sont les derniers arrivez.
Ils ſont charmans, ma Sœur, & leur perſonne entiere	Ils sont charmants, ma Sœur, et leur personne entière
CIDIPPE.	CIDIPE.
Ah, ma Sœur, ils ſont faits tous d’eux d’une maniere.	Ah, ma Sœur, ils sont faits tous d'eux d'une manière.
Que mon ame.	Que mon âme.
Ce ſont deux Princes achevez.	Ce sont deux Princes achevés.
AGLAURE.	AGLAURE.
Je ſiouve qu’on pourroit reenerener leur tendreſſe, Sans ſe faire deſ-honneur.	Je siouve qu'on pourrait reenerener leur tendresse, Sans se faire déshonneur.
CIDIPPE.	CIDIPE.
Je trouve que ſans honte une belle Princeſſe Leur pourroit donner ſon cœur.	Je trouve que sans honte une belle Princesse Leur pourrait donner son cœur.
SCENE II.	SCÈNE II.
CLEOMENE, AGENOR.	CLÉOMENE, AGENOR.
AGLAURE, CIDIPPE.	AGLAURE, CIDIPPE.
AGLAURE.	AGLAURE.
Es voicy tous deux, & j’admire L Leur ati & leur ajuſtement.	Es voici tous deux, et j'admire L Eur ati et leur ajustement.
CIDIPPE.	CIDIPE.
Ils ne démentent nullement Tout ce que nous venons de dire.	Ils ne démentent nullement Tout ce que nous venons de dire.
AGLAURE.	AGLAURE.
D'ou vient, princes, d’ou vienit que vous fuyez ainſi?	D'ou vient, princes, d'ou vienit que vous fuyez ainsi?
Prenez-vous l’épouvante en nous voyant paroiſtre?	Prenez-vous l'épouvante en nous voyant paraître?
CLEOMENE.	CLÉOMENE.
On nous faiſoit croire qu’icy La Princeſſe Pſiché, Madame, pourroic eſtre.	On nous faisait croire qu'ici La Princesse Psiché, Madame, pourrai être.
AGLAURE.	AGLAURE.
Tous!	Tous!
ces lieux n’ont-ils rien d’agreable pour vous, Si vous ne les voyez ornez de ſa preſence?	ces lieux n'ont-ils rien d'agréable pour vous, Si vous ne les voyez ornez de sa présence?
AGENOR.	AGENOR.
Ces lieux peuvent avoir des charmes aſſez doux;	Ces lieux peuvent avoir des charmes assez doux;
Mais nous cherchons Pliché dans noſtre impatience.	Mais nous cherchons Pliché dans notre impatience.
CIDIPPE.	CIDIPE.
Quelque choſe de bien preſſant Vous doit à la chercher pouſſer tous deux ſans doute,	Quelque chose de bien pressant Vous doit à la chercher pousser tous deux sans doute,
CLEOMENE.	CLÉOMENE.
Le miocirelt aſſez puiſſant, Puis que noſtre fortune enfin en dépend toute,	Le miocirelt assez puissant, Puis que notre fortune enfin en dépend toute,
AGLAURJE.	AGLAURJE.
Ce ſeroit trop à nous, que de nous informer Du ſecret que ces mots nous peuvent enfermer.	Ce serait trop à nous, que de nous informer Du secret que ces mots nous peuvent enfermer.
CLEOMENE.	CLÉOMENE.
Nous ne pretendons point en faire de miſtere;	Nous ne prétendons point en faire de mystère;
Aui blen malgre nous paroiſtroit-il au jour, Et le ſecret ne dure guere, Madame, quand c’eſt de l’amour.	Aui blen malgré nous paraîtrait-il au jour, Et le secret ne dure guère, Madame, quand c'est de l'amour.
CIDIPPE.	CIDIPE.
Sans aller plus avant, Princes, cela veut dire, &ue vuns amiez piene tous ueux.	Sans aller plus avant, Princes, cela veut dire, etue vuns amiez pène tous ouveux.
AGENOR.	AGENOR.
Tous deux ſoûmis à ſon empire Nous allons de concert luy découvrir nos feux.	Tous deux soumis à son empire Nous allons de concert Seigneur découvrir nos feux.
AGLAURE.	AGLAURE.
C’eſt une nouveauté ſans doute aſſez bizarre, Que deux Rivaux ſi bien unis.	C'est une nouveauté sans doute assez bizarre, Que deux Rivaux si bien unis.
CLEOMENE.	CLÉOMENE.
Ireit vray que la chole clt rale, Mais non pas impoſſible à deux parfaits Amis.	Jreit vrai que la colis clét ale, Mais non pas impossible à deux parfaits Amis.
CIDIPPE.	CIDIPE.
Eſt-ce que dans ces lieux il n’eit qu’elle de belle, Et n’y trouvez-vous point à ſeparer vos vœux?	Est-ce que dans ces lieux il n'éit qu'elle de belle, Et n'y trouvez-vous point à séparer vos vœux?
AGLAURE.	AGLAURE.
Parmy l'éclat du ſang, vos yeux n’ont-ils veu qu’elle A pouvoirmemter vosieur:	Parmi l'éclat du sang, vos yeux n'ont-ils vu qu'elle À pouvoirmemêter vosieur:
CLEOMENE.	CLÉOMENE.
Eſt-ce que l’on conſulte au moment qu’on s’enflâme;	Est-ce que l'on consulte au moment qu'on s'enflamme;
Choiſit-on qui l’on veut aimer?	Choisit-on qui l'on veut aimer?
Et pour donner toute ſon ame, Regarde-t-on quel droit on a de nous charmer?	Et pour donner toute son âme, Regarde-t-on quel droit on a de nous charmer?
AGENOR.	AGENOR.
Sans qu’on ait le pouvoir d’élire;	Sans qu'on ait le pouvoir d'élire;
On ſuit dans une telle ardeur Quelque choſe qui nous attire, Et lors que l’Amour touche un cœur, On n’a point de raiſons à dire.	On suit dans une telle ardeur Quelque chose qui nous attire, Et lors que l'Amour touche un cœur, On n'a point de raisons à dire.
AGLAURE.	AGLAURE.
En verité je plains les fâcheux embarras Où je voy que vos cœurs ſe mettent;	En vérité je plains les fâcheux embarras Où je vois que vos cœurs se mettent;
Vous aimez un Objet dont les rians appas Meſſeront des chagrins à l’eſpoir qu’ils vous jettent, Et ſon cœur ne vous tiendra pas Tout ce que ſes yeux vous promettent.	Vous aimez un Objet dont les riants appas Messeront des chagrins à l'espoir qu'ils vous jettent, Et son cœur ne vous tiendra pas Tout ce que ses yeux vous promettent.
CIDIPPE.	CIDIPE.
L’eipoi qui vous appenc aulang denes Mmans Trouvera du méconte aux douceurs qu’elle étales Et c’eſt pour eſſuyer de tres-fâcheux momens, Que les ſoudains retours de ſon ame inégale.	L'éjpoi qui vous appenc aulang dénes Mmand Trouvera du méconte aux douceurs qu'elle étales Et c'est pour essuyer de très-fâcheux moments, Que les soudains retours de son âme inégale.
AGLAURE.	AGLAURE.
Un clair diſcernement de ce que vous valez Nous fait plaindre le ſort où cet amour vous guide, Et vous pouvez trouver tous deux, ſi vous voulez, Avec autant d’attraits, une ame plus ſolide.	Un clair discernement de ce que vous valez Nous fait plaindre le sort où cet amour vous guide, Et vous pouvez trouver tous deux, si vous voulez, Avec autant d'attraits, une âme plus solide.
CIDIPPE.	CIDIPE.
Par un choix plus doux de moitié Vous pouvez de l’amour ſauver voſtre amitié, Et l’on voit en vous deux un merite ſi rare, Qu'un tendre avis veut bien prevenir par pitié Ce que voitre cœur le plepare.	Par un choix plus doux de moitié Vous pouvez de l'amour sauver votre amitié, Et l'on voit en vous deux un mérite si rare, Qu'un tendre avis veut bien prévenir par pitié Que que voitre cœur le pleare.
CLEOMENE.	CLÉOMENE.
Cet avis genereux fait pour nous éclater.	Cet avis généreux fait pour nous éclater.
Des bontez qui nous touchent l’ame;	Des bontés qui nous touchent l'âme;
miuis ie ciernous reduit à ce malheur, Madame, De ne pouvoir en profiter.	mivis ie ciernous réduit à ce malheur, Madame, De ne pouvoir en profiter.
AGENOR.	AGENOR.
Voſtre illuſtre pitié veut en vain nous diſtraire D’un amour dont tous deux nous redoutons l’effet;	Votre illustre pitié veut en vain nous distraire D'un amour dont tous deux nous redoutons l'effet;
Ce que noſtre amitié, Madame, n’a pas fait, Il n’eſt rien qui le puiſſe faire	Ce que notre amitié, Madame, n'a pas fait, Il n'est rien qui le puisse faire
IDITTE.	JDITTE.
Ilfaut que le pouvoir de Pſiché.	Ilfaut que le pouvoir de Psiché.
La voicy.	La voici.
SCENE III.	SCÈNE III.
PSICHE', CIDIPPE, AGLAURE.	PSYCHÉ, CIDIPE, AGLAURE.
CLEOMENE, AGENOR.	CLÉOMENE, AGENOR.
CIDIPPE.	CIDIPE.
V Enez joüir, ma Sœur, de ce qu’on vous appreſte.	V Unez jouir, ma Sœur, de ce qu'on vous apprête.
AGLAURE.	AGLAURE.
Frepares vos attraits à recevoir icy Le triomphe nouveau d’une illuſtre conqueſte.	Frépares vos attraits à recevoir ici Le triomphe nouveau d'une illustre conquête.
CIDIPPE.	CIDIPE.
Ces Princes ont tous deux ſi bien ſenty vos coups, Qu’à vous le découvrir leur bouche ſe diſpoſe.	Ces Princes ont tous deux si bien senti vos coups, Qu'à vous le découvrir leur bouche se dispose.
SICHE'.	SICHÉE.
Du ſujet qui les tient ſi reſveurs parmy nous Je ne me croyois pas la cauſe, Et j’aurois crû toute autre choſe En les voyant parier à vous.	Du sujet qui les tient si rêveurs parmi nous Je ne me croyais pas la cause, Et j'aurais crû toute autre chose En les voyant parier à vous.
AGLAURE.	AGLAURE.
N’ayant ny beauté, ny naiſſance A pouvoir meriter leur amour & leurs ſoins, lis nous la voriſent au moins De l’honneur de la confidence.	N'ayant ici beauté, ni naissance À pouvoir mériter leur amour et leurs soins, lis nous la vorisent au moins De l'honneur de la confidence.
CLEOMENE.	CLÉOMENE.
L’aveu qu’il nous faut faire à vos divins appas, Eſt ſans doute, Madame, un aveu temeraire;	L'aveu qu'il nous faut faire à vos divins appas, Est sans doute, Madame, un aveu téméraire;
Mais tant de cœurs pres du trépas, Sont par de tels aveus forcez à vous déplaire, Que vous eſtes reduite à ne les punir pas Des foudres de voſtre colere.	Mais tant de cœurs pres du trépas, Sont par de tels aveus forcés à vous déplaire, Que vous êtes réduite à ne les punir pas Des foudres de votre colère.
Vous voyez en nous deux Amis, Qu’un doux rapport d’humeurs ſçeut joindre dés l’enEt ces tendres liens ſe ſont veus affermis (fance;	Vous voyez en nous deux Amis, Qu'un doux rapport d'humeurs Sut joindre dès l'enÉt ces tendres liens se sont veux affermis (fance;
Par cent combats d’eſtime & de reconnoiſſance.	Par cent combats d'estime et de reconnaissance.
Du Deſtin ennemy les aſſauts rigoureux, Les mépris de la mort & l’aſpect des ſupplices, Par d’illuſtres, éclats, de mutuels offices Ont de noſtre amitié ſignalé les beaux nœuds:	Du Destin ennemi les assauts rigoureux, Les mépris de la mort et l'aspect des supplices, Par d'illustres, éclats, de mutuels offices Ont de notre amitié signalé les beaux nœuds:
Mais à quelques eſſais qu'elle ſe ſoit trouvée, Son grand triomphe eſt en ce jour, Et rien ne fait tant voir ſa conſtance éprouvée, Que de ſe conſerver au milieu de l’Amour.	Mais à quelques essais qu'elle se soit trouvée, Son grand triomphe est en ce jour, Et rien ne fait tant voir sa constance éprouvée, Que de se conserver au milieu de l'Amour.
Oüy, malgré tant d’appas, ſon illuſtre conſtance Aux Loix qu’elle nous fait a ſoûmis tous nos vœux;	Oui, malgré tant d'appas, son illustre constance Aux Lois qu'elle nous fait a soumis tous nos vœux;
Elle vient d’une douce & pleine déference Remettre à voſtre choix le ſuccés de nos feux, Et pour donner un poids à noſtre concurrence, Qui des raiſons d’Eſtit entraiſne la balance Sur le choix de l’un de nous deux, Cette meſme amitié s’offre ſans répugnance Dunir nos deux Eſtats au ſort du plus heureur.	Elle vient d'une douce et pleine déférence Remettre à votre choix le succès de nos feux, Et pour donner un poids à notre concurrence, Qui des raisons d'Étit entraîne la balance Sur le choix de l'un de nous deux, Cette été amitié s'offre sans répugnance Dunir nos deux États au sort du plus heureur.
AGENOR.	AGENOR.
Oüy, de ces deux Etats, Madame, Que ſous voſtre heureux choix nous nous offrons Nous voulons faire à noſtre flâme (d’unir, Un ſecours pour vous obtenir.	Oui, de ces deux États, Madame, Que sous votre heureux choix nous nous offrons Nous voulons faire à notre flamme (d'unir, Un secours pour vous obtenir.
Ce que pour ce bonheur, pres du Roy voſtre Pere Nous nous ſacrifions tous deux, N’a rien de difficile à nos cœurs amoureux, Et c’eſt au plus heureux faire un don neceſſaire D’un pouvoir dont le malheureux, Madame, n’aura plus affaire.	Ce que pour ce bonheur, pres du Roi vôtre Père Nous nous sacrifions tous deux, N'a rien de difficile à nos cœurs amoureux, Et c'est au plus heureux faire un don nécessaire D'un pouvoir dont le malheureux, Madame, n'aura plus affaire.
PSICHE’.	PSICHÉE.
ſyeux Le choix que vous m’offrez, Princes, montre à mes Dequoy remplir les vœux de l’ame la plus fiere, Et vous me le parez tous deux d’une maniere, Qu’on ne peut rien offrir qui ſoit plus précieux.	syeux Le choix que vous m'offrez, Princes, montre à mes Dequoi remplir les vœux de l'âme la plus fière, Et vous me le parez tous deux d'une manière, Qu'on ne peut rien offrir qui soit plus précieux.
Vos feux, voſtre amitié, voſtre vertu ſupréme, Tout me releve en vous l’offre de voſtre foy, Et j’y vois un mérite à s’oppoſer luy-meſme A ce que vous voulez de moy.	Vos feux, votre amitié, votre vertu suprême, Tout me relève en vous l'offre de votre foi, Et j'y vois un mérite à s'opposer lui-même À ce que vous voulez de moi.
Ce n’eſt pas à mon cœur qu’ilfaut que ie défere Pour entrer ſous de tels liens;	Ce n'est pas à mon cœur qu'ilfaut que . défère Pour entrer sous de tels liens;
Ma main, pour ſe donner, attend l’ordre d’un Pere, Et mes Sœurs ont des droitsqui vont devãt les miens, Mais ſi l’on me rendoit ſur mes vœux abſoluë, Vous y pourriez avoir trop de part à la fois, Et toute mon eſtime entre vous ſuſpenduë, Ne pourroit ſur aucun laiſſer tomber mon choix.	Ma main, pour se donner, attend l'ordre d'un Père, Et mes Sœurs ont des droitsqui vont devant les miens, Mais si l'on me rendait sur mes vœux absolue, Vous y pourriez avoir trop de part à la fois, Et toute mon estime entre vous suspendue, Ne pourrait sur aucun laisser tomber mon choix.
A l’ardeur de voſtre pourſuite Je répondrois aſſez de mes vœux les plus doux;	À l'ardeur de votre poursuite Je répondrais assez de mes vœux les plus doux;
Mais c’eſt parmy tant de merite Trop que deux cœurs pour moy, trop peu qu’un cœur pour vous.	Mais c'est parmi tant de mérite Trop que deux cœurs pour moi, trop peu qu'un cœur pour vous.
De mes plus doux ſouhaits j’aurois l’ame geſnée.	De mes plus doux souhaits j'aurais l'âme gênée.
A l’effort de voſtre amitié, Et j’y vois l’un de vous prendre une Deſtinée A me faire trop de pitié.	À l'effort de votre amitié, Et j'y vois l'un de vous prendre une Destinée À me faire trop de pitié.
Oüy, Princes, à tous ceux dont l’amour ſuit le voſtre, Je vous prefererois tous deux avec ardeur;	Oui, Princes, à tous ceux dont l'amour suit le vôtre, Je vous préférerais tous deux avec ardeur;
Mais je n’aurois jamais le cœur De pouvoir preferer l’un de vous deux à l’autre.	Mais je n'aurais jamais le cœur De pouvoir préférer l'un de vous deux à l'autre.
A celuy que je choiſirois, Ma tendreſſe feroit un trop grand ſacrifice, Et je m’imputerois à barbare injultice, Le tort qu’à l’autre je ferois.	À celui que je choisirais, Ma tendresse ferait un trop grand sacrifice, Et je m'imputerais à barbare injultice, Le tort qu'à l'autre je ferais.
Oüy, tousdeux vous brillez de trop de grandeurd’ame.	Oui, tousdeux vous brillez de trop de grandeurd'âme.
Pour en faire aucun malheureux, Et vous devez chercher dans l’amoureuſe flâme Le moyen d’eſtre heureux tous deux.	Pour en faire aucun malheureux, Et vous devez chercher dans l'amoureuse flamme Le moyen d'être heureux tous deux.
Si voſtre cœur me conſidere Aſſez pour me ſouffrir de diſpoſer de vous, J’ay deux Sœurs capables de plaire, Qui peuvent bien vous faire un deſtin aſſez doux, Et l’amitié me rend leur perſonne aſſez chere, Pour vous ſouhaiter leurs Epoux.	Si votre cœur me considère Assez pour me souffrir de disposer de vous, J'ai deux Sœurs capables de plaire, Qui peuvent bien vous faire un destin assez doux, Et l'amitié me rend leur personne assez chère, Pour vous souhaiter leurs Époux.
CLEOMENE.	CLÉOMENE.
Un cœur dont l’amour eſt extréme Peut-il bien conſentir, helas, D’eſtre donné par ce qu’il aime!	Un cœur dont l'amour est extrême Peut-il bien consentir, hélas, D'être donné par ce qu'il aime!
Burlios deur cœurs, Madame, à vos divins appas Nous donnons un pouvoir ſupréme, Diſpoſez-en pour le trépas, Mais pounune autre que vous meſme Ayez cette bonté de n’en diſpoſer pas.	Burlios devr cœurs, Madame, à vos divins appas Nous donnons un pouvoir suprême, Disposez-en pour le trépas, Mais pounune autre que vous -même Ayez cette bonté de n'en disposer pas.
AGENOR.	AGENOR.
Aux Princeſſes, Madame, on feroit trop d’outrage, Et c’eſt pour leurs attraits un indigne partage, Que les reſtes d’une autre ardeur, Ilfaut d’un premier feu la pureté fidelle, Pour aſpirer à cet honneur Où voſtre bonté nous appelle, Et chacune merite un cœur Qui n’ait ſoûpiré que pour elle.	Aux Princesses, Madame, on ferait trop d'outrage, Et c'est pour leurs attraits un indigne partage, Que les restes d'une autre ardeur, Ilfaut d'un premier feu la pureté fidèle, Pour aspirer à cet honneur Où votre bonté nous appelle, Et chacune mérite un cœur Qui n'ait soupiré que pour elle.
AGLAURE.	AGLAURE.
Il me ſemble, ſans nul courroux, Qu’avant que de vous en defendre, Princes, vous deviez bien attendre Qu’on ſe fut expliqué ſur vous.	Il me semble, sans nul courroux, Qu'avant que de vous en défendre, Princes, vous deviez bien attendre Qu'on se fut expliqué sur vous.
Nous croyez-vous un cœur ſi facile & ſi tendre?	Nous croyez-vous un cœur si facile et si tendre?
Et lors qu’on parle icy de vous donner à nous, Sçavez-vous ſi l’on veut vous prendre?	Et lors qu'on parle ici de vous donner à nous, Savez-vous si l'on veut vous prendre?
CIDIPPE.	CIDIPE.
Je penſe que l’on a d’aſſez hauts ſentimens Pour refuſer un cœur qu’il faut qu’on ſollicite, Et qu’on ne veut devoir qu’à ſon propre merite La conqueſte de ſes Amans.	Je pense que l'on a d'assez hauts sentiments Pour refuser un cœur qu'il faut qu'on sollicite, Et qu'on ne veut devoir qu'à son propre mérite La conquête de ses Amants.
PSICHE’.	PSICHÉE.
J’ay crû pour vous, mes Sœurs, une gloire aſſez grãde, Si la poſſeſſion d’un merite ſi haut.	J'ai cru pour vous, mes Sœurs, une gloire assez grands, Si la possession d'un mérite si haut.
SOIIE IV LYCAS PSICHE, AGLAURE, CIDIPPE, CLEOMENE, AGENOR.	SOIIE IV LYCAS PSYCHE, AGLAURE, CIDIPE, CLEOMENE, AGENOR.
AH, Madame!	AH, Madame!
LYCAS.	LYCAS.
PSICHE’.	PSICHÉE.
Qu’as-tu?	Qu'as-tu?
LYCAS.	LYCAS.
Le ROy.	Le ROi.
PSICHE’.	PSICHÉE.
Quoy?	Quoi?
LYCAS.	LYCAS.
Vous demande.	Vous demande.
TSIEIIEE De ce trouble ſi grand, que faut-il que j’attende?	TSIEIIEE De ce trouble si grand, que faut-il que j'attende?
LYCAS.	LYCAS.
Vous ne le ſçaurez que trop toſt.	Vous ne le saurez que trop tôt.
PSICHE’.	PSICHÉE.
Helas!	Hélas!
que pour le Roy tu me donnes à craindre!	que pour le Roi tu me donnes à craindre!
L Tenlo.	 Lenlo.
Ne craignez que pour vous, c’eſt vous que l’on doit plaindre.	Ne craignez que pour vous, c'est vous que l'on doit plaindre.
SICHE'.	SICHÉE.
C’eſt pour loüer le Ciel, & me voir hors d’effroy, De ſçavoir que je n’aye à craindre que pour moy.	C'est pour louer le Ciel, et me voir hors d'effroi, De savoir que je n'aie à craindre que pour moi.
Mais apren-moy, Lycas, le ſujet qui te touche.	Mais appren-moi, Lycas, le sujet qui te touche.
LTeMlO.	LTeMlO.
Souffrez que j’obeïſſe à qui m’envoye icy, Madame, & qu’on vous laiſſe apprendre de ſa bouche Ce qui peut m'affliger ainſi.	Souffrez que j'obéisse à qui m'envoie ici, Madame, et qu'on vous laisse apprendre de sa bouche Ce qui peut m'affliger ainsi.
SICHE'.	SICHÉE.
Allons ſçavoir ſurquoy l’oh craint tant ma foibleſſe.	Allons savoir surquoy l'oh craint tant ma faiblesse.
SCENE AGLAONE, CIDIPTE, LICAS.	SCÈNE AGLAONE, CIDIPTE, LICAS.
AGLAURE.	AGLAURE.
I ton ordre n’eſt pas juſqu’à nous étendu, ODy-nous quel grand malheur nous couvre ta triſLYCAS.	I ton ordre n'est pas jusqu'à nous étendu, ODi-nous quel grand malheur nous couvre ta trisLYCAS.
teſſe,	tesse,
Helas!	Hélas!
ce grand malheur dans la Cour répandu, Voyez-le vous-meſme, Princeſſe, pain i'Otuere quau noy les Deſtins ont rendu.	ce grand malheur dans la Cour répandu, Voyez-le vous-même, Princesse, pain j'Otuère quau noi les Destins ont rendu.
Voicy ſes propres mots, que la douleur, Madame, A gravez au fond de mon ame.	Voici ses propres mots, que la douleur, Madame, A gravés au fond de mon âme.
Que l'on ne penſe nullement A vouloir de Pſiché conclure l’Hymenée;	Que l'on ne pense nullement A vouloir de Psiché conclure l'Hyménée;
Mais qu’au ſommet d’un Mont elle ſoit promptement En pompe funebre menée, Et que de tous abandonnée, che Pour Epoux elle at.	Mais qu'au sommet d'un Mont elle soit promptement En pompe funèbre menée, Et que de tous abandonnée, che Pour Époux elle at.
ende en ces lieux conſtamment Vn Monſtre dont on a la veuë empoiſonnée, Vn Serpent qui répand ſon venin en tous lieux, Et trouble dans ſa rage & la Terre & les Cieux.	ende en ces lieux constamment Un Montre dont on a la vue empoisonnée, Un Serpent qui répand son venin en tous lieux, Et trouble dans sa rage et la Terre et les Cieux.
Apres un Arreſt ſi ſevere.	Après un Arrêt si sévère.
Je vous quitte, & vous laiſſe à juger entre vous, l Si par de plus cruels & plus ſenſibles coups * Tous les Dieux nous pouvoient expliquer leur colere.	Je vous quitte, et vous laisse à juger entre vous, laIsse par de plus cruels et plus sensibles coups * Tous les Dieux nous pouvaient expliquer leur colère.
SCENE VI.	SCÈNE VI.
AGLAURE, CIDIPTE.	AGLAURE, CIDIPTE.
CIDIPPE.	CIDIPE.
A Sœur, que ſentez-vous a ce ſoudain malheur MOû nous voyõs Pſiché par les Deſtins plongée?	À Sœur, que sentez-vous a ce soudain malheur MOû nous voyõs Psiché par les Destins plongée?
AGLAURE.	AGLAURE.
Mais vous, que ſentez-vous, ma Sœur?	Mais vous, que sentez-vous, ma Sœur?
e la li l n.	Je la li li l'
A ne vous point mentir, je ſens que dans mon cœut Je n’en ſuis pas trop affligée.	À ne vous point mentir, je sens que dans mon cœut Je n'en suis pas trop affligée.
AGLAURE.	AGLAURE.
Moy, je ſens quelque choſe au mien Qui reſſemble aſſez à la joye.	Moi, je sens quelque chose au mien Qui ressemble assez à la joie.
Allons, le Deſtin nous envoye Un mal que nous pouvons regarder comme un bien.	Allons, le Destin nous envoie Un mal que nous pouvons regarder comme un bien.
PREMIER INTERMEDE.	PREMIER INTERMÈDE.
A Scene eſt changée en des Rochers affreux, & L fait voir en éloignement une Grotte effroyable.	À Scène est changée en des Rochers affreux, et L fait voir en éloignement une Grotte effroyable.
C’eſt dans ce Deſert que Pſiché doit eſtre expoſée pour obeïr à l’Oracle.	C'est dans ce Désert que Psiché doit être exposée pour obéir à l'Oracle.
Vne Trouppe de Perſonnes affligées y viennent déplorer ſa diſgrace.	Une Troupe de Personnes affligées y viennent déplorer sa disgrâce.
Vne partie de cette Troupe deſolée témoigne ſa pitié par des Plaintes touchantes, & par des Concerts lugubres;	Une partie de cette Troupe désolée témoigne sa pitié par des Plaintes touchantes, et par des Concerts lugubres;
& l’autre exprime ſa deſolation par une Dance pleine de toutes les marques du plus violent deſeſpotr.	et l'autre exprime sa désolation par une Dance pleine de toutes les marques du plus violent désespotr.
TRAGEDIE.	TRAGÉDIE.
PLAINTES EN ITALIEN, chantées par une Femme deſolée, & deux fiommes aſgez.	PLAINTES EN ITALIEN, chantées par une Femme désolée, et deux fiommes âgé.
Femme deſolée.	Femme désolée.
Eh, piangete al pianto mio, DSaſſi dur, antiche ſelve, Lagrimate fonti, e belve, D’un bel volto il fato rio.	Eh, piangète al pianto Dio, DAssi dur, antiche selve, Lagrimate fonti, é lve, D'un bel volto il fato riote.
1.	1.
Homme affligé.	Homme affligé.
Ahi dolore!	Ahi dolore!
2.	2.
Homme affligé.	Homme affligé.
Ahi martire!	Ahi martyre!
1.	1.
Homme affligé.	Homme affligé.
Cruda moite:	Cruda moi:
2.	2.
Homme affligé.	Homme affligé.
Empia ſorte!	Empia sorte!
TOOS INOTS.	TOOS INOTTS.
Che condanni à morir tanta beltà.	Che condamni à morir tanta beltà.
Cieli, ſtelle, ahi crudeltà.	Cieli, stelle, ahi crudeltà.
2.	2.
Homme affligé.	Homme affligé.
Com’eſſer puo fra voi, o Numi eterni, Chi voglia eſtinta una beltà innocente?	Com'esser puo fra voi, ô Numi éterni, Chi voglia estinta una beltà innocente?
Ahi!	Ahi!
che tanto rigor.	che tanto rigor.
Cielo inclemente, Vince di crudeltà gli ſteſſi Inferni.	Cielo inclémente, Vince di crudeltà gli stessi Inferni.
1.	1.
Homme affligé.	Homme affligé.
Nume fierto!	Nume fierto!
2.	2.
Homme affligé.	Homme affligé.
Dio ſevero!	Dio severo!
ENSEMBLE.	ENSEMBLE.
Perche tanto rigor Contro innocente cor?	Perche tanto rigor Contro innocente cor?
Mifijfleltellna Maartay Dar morte à la Beltà, ch' altrui da vita,	Mifijffleltellna Maartai Dar morte à la Beltà, ch' alui da vita,
Femme deſolée.	Femme désolée.
Ahi ch'indarno ſi tarda, Non reſiſte à li Dei mortale affetto, Alto impero ne sforza, Ove commanda il Ciel, l’Vuom cede à forza,	Ahi ch'indarno si tarda, Non résiste à li Dei mortale affetto, Alto impero ne sforza, Ove commanda il Ciel, l'Unuom cède à forza,
Ahi dolore!	Ahi dolore!
&c.	etc.
Come ſopra.	Come sopra.
Ces Plaintes ſont entrecoupées & finies par unt Entrée de Ballet de huit Perſonnes affligées.	Ces Plaintes sont entrecoupées et finies par unt Entrée de Ballet de huit Personnes affligées.
ACTE II.	ACTE II.
SCENE PREMIERE.	SCÈNE PREMIÈRE.
LEROT, YSICHE, AGLAURE, CIDIPPE, LYCAS, SUITE.	LÉROT, YSICHÉ, AGLAURE, CIDIPE, LYCAS, SUITE.
L PSICHE'.	 PSICHE'.
E vos larmes, Seigneur, la ſource m’eſt bien chere;	ELLE vos larmes, Seigneur, la source m'est bien chère;
Mais c’eſt trop aux bontez que vous a vez pour moy, ubai Que de laiſſer regner les tendreſſes de Juſque dans les yeux d’un grand Roy.	Mais c'est trop aux bontés que vous a vez pour mo, y Que de laisser régner les tendresses de Jusque dans les yeux un grand Roy,
[Pere Ce qu’on vous voit icy donner à la Nature Au rang que vous tenez, Seigneur, fait trop d’injure, Lejendols feldler les touchantes laveuls.	[Père Ce qu'on vous voit ici donner à la Nature Au rang que vous tenez, Seigneur, fait trop d'injure, Léjendols fêler les touchantes laveuls.
Laiſſez moins ſur voſtre ſageſſe Prendre d’empire à vos douleurs, Et ceſſez d’honorer mon deſtin pardes pleurs, Qui dans le cœur d’un Roy montrent de la foibleſſe,	Laissez moins sur votre sagesse Prendre d'empire à vos douleurs, Et cessez d'honorer mon destin pardes pleurs, Qui dans le cœur d'un Roi montrent de la faiblesse,
LE ROY.	LE ROY.
Ah!	Ah!
ma Fille, à ces pleurs laiſſe mes yeux ouverts, Mon deüil eſt raiſonnable, encor qu’il ſoit extréme, C I Et lors que pour toûjours on perd ce que je perds, La Sageſſe, croy-moy, peut pleurer elle-meſme.	ma Fille, à ces pleurs laisse mes yeux ouverts, Mon deuil est raisonnable, encor qu'il soit extrême, Ç I Et lors que pour toujours on perd ce que je perds, La Sagesse, crois-moi, peut pleurer elle-même.
En vain l’orgueil du Diadéme Veut qu’on ſoit inſenſible à ces cruels revers, En vain de la Raiſon les ſecours ſont offerts, Pour vouloir d’un œil ſec voir mourir ce qu’on aime:	En vain l'orgueil du Diadème Veut qu'on soit insensible à ces cruels revers, En vain de la Raison les secours sont offerts, Pour vouloir d'un œil sec voir mourir ce qu'on aime:
L’effort en eſt barbare aux yeux de l’Univers, Et c’eſt brutalité plus que vertu ſupréme.	L'effort en est barbare aux yeux de l'Univers, Et c'est brutalité plus que vertu suprême.
Je ne veux point dans cette adverſité Parer mon cœur d’inſenſibilité, Et cacher l’ennuy qui me touche;	Je ne veux point dans cette aversité Parer mon cœur d'insensibilité, Et cacher l'ennui qui me touche;
Je renonce à la vanité De cette dureté farouche, Que l’on appelle fermeté;	Je renonce à la vanité De cette dureté farouche, Que l'on appelle fermeté;
Et de quelque façon qu’on nomme Cette vive douleur dont je reſſens les coups, Je veux bien l’étaler, ma Fille, aux yeux de tous, Etdans le cœur d’un Roy montrer le cœurd’un Hõme.	Et de quelque façon qu'on nomme Cette vive douleur dont je ressens les coups, Je veux bien l'étaler, ma Fille, aux yeux de tous, Édans le cœur d'un Roi montrer le cœurd'un Homme.
PSICHE’.	PSICHÉE.
Je ne mérite pas cette grande douleur:	Je ne mérite pas cette grande douleur:
Oppoſez, oppoſez un peu de reſiſtance Aux droits qu’elle prend ſur un cœur Dont mille évenemens ont marqué la puiſſance.	Opposez, opposez un peu de résistance Aux droits qu'elle prend sur un cœur Dont mille événements ont marqué la puissance.
Quoy, faut-ilque pour moy vous renonciez, Seigneur, A cette Royale conſtance, Dont vous avez fait voir dans les coups du malheur Une fameuſe experience?	Quoi, faut-ilque pour moi vous renonciez, Seigneur, À cette Royale constance, Dont vous avez fait voir dans les coups du malheur Une fameuse expérience?
LE ROY.	LE ROY.
La conſtance eſt facile en mille occaſions, Toutes les révolutions Où nous peut expoſer la Fortune inhumaine, La perte des grandeurs, les perſécutions, Le poiſon de l’Envie, & les traits de la Haïne, N’ont rien qui ne puiſſent ſans peine Braver les réſolutions D’une ame où la raiſon eſt un peu ſouveraine;	La constance est facile en mille occasions, Toutes les révolutions Où nous peut exposer la Fortune inhumaine, La perte des grandeurs, les persécutions, Le poison de l'Envie, et les traits de la Haine, N'ont rien qui ne puissent sans peine Braver les résolutions D'une âme où la raison est un peu souveraine;
Mais ce qui porte des rigueurs A faire ſuccomber les cœurs Sous le poids des douleurs ameres, Ce ſont, ce ſont les rudes traits De ces fatalitez ſeveres, Qui nous enlevent pour jamais Les Perſonnes qui nous ſont cheres.	Mais ce qui porte des rigueurs A faire succomber les cœurs Sous le poids des douleurs amères, Ce sont, ce sont les rudes traits De ces fatalités sévères, Qui nous enlèvent pour jamais Les Personnes qui nous sont chères.
La Raiſon contre de tels coups N’offre point d’armes ſecourables;	La Raison contre de tels coups N'offre point d'armes secourables;
Et voila des Dieux en couroux Les foudres les plus redoutables Qui ſe puiſſent lancer ſur nous.	Et voilà des Dieux en courroux Les foudres les plus redoutables Qui se puissent lancer sur nous.
PSICHE’.	PSICHÉE.
Seigneur, une douceur icy vous eſt offerte:	Seigneur, une douceur ici vous est offerte:
Voſtre hymen a reçeu plus d’un preſent des Dieux, Et par une faveur ouverte Ils ne vous oſtent rien en m’oſtant à vos yeux, Dont ils n’ayent pris le ſoin de reparer la perte.	Votre hymen a reçu plus d'un présent des Dieux, Et par une faveur ouverte Ils ne vous ôtent rien en môtant à vos yeux, Dont ils n'aient pris le soin de réparer la perte.
Il vous reſte dequoy conſoler vos douleurs, Et cette loy du Ciel que vous nominez cruelle Dans les deux Princeſſes mes Sœurs, Laiſſe à l’amitié paternelle Où placer toutes ſes douceurs.	Il vous reste dequoy consoler vos douleurs, Et cette loi du Ciel que vous nominez cruelle Dans les deux Princesses mes Sœurs, Laisse à l'amitié paternelle Où placer toutes ses douceurs.
LE ROY.	LE ROY.
Ah, de mes maux ſoulagement frivole!	Ah, de mes maux soulagement frivole!
Rien, Iien ne s’ome aſlioy qui de toy me conlole;	Rien, Jien ne s'ome aslioi qui de toi me conlole;
C’eſt ſur mes déplaiſirs que j’ay les yeux ouverts, Et dans un deſtin ſi funeſte Je regarde ce que je perds, Et ne voy point ce qui me reſte.	C'est sur mes déplaisirs que j'ai les yeux ouverts, Et dans un destin si funeste Je regarde ce que je perds, Et ne vois point ce qui me reste.
PSICHE’.	PSICHÉE.
Vousſçavez mieuxque moy qu’aux volontezdes Dieux, C iij Seigneur, il faut regler les noſtres, Et je ne puis vous dire en ces triſtes Adieux, Que ce que beaucoup mieux vous pouvez dire aux auCes Dieux ſont maiſtres ſouverains (tres, Des preſens qu’ils daignent nous faire;	Voussçavez mieux moi qu'aux volontés Dire, Ç iij Seigneur, il faut régler les nôtres, Et je ne puis vous dire en ces tristes Adieux, Que ce que beaucoup mieux vous pouvez dire aux auCes Dieux sont maîtres souverains (tes, Des présents qu'ils daignent nous faire;
Ils ne les laiſſent dans nos mains Qu’autant de temps qu’il peut leur plaire.	Ils ne les laissent dans nos mains Qu'autant de temps qu'il peut leur plaire.
Lors qu’ils viennent les retirer, On n’a nul droit de murmurer Des graces que leur main ne veut plus nous étendre;	Lors qu'ils viennent les retirer, On n'a nul droit de murmurer Des grâces que leur main ne veut plus nous étendre;
Seigneur, je ſuis un don qu’ils ont fait à vos vœux, Et quand par cet Arreſt ils veulent me reprendre, Ils ne vous oſtent rien que vous ne teniez d’eux, Et c’eſt ſans murmurer que vous devez me rendre.	Seigneur, je suis un donc qu'ils ont fait à vos vœux, Et quand par cet Arrêt ils veulent me reprendre, Ils ne vous ôtent rien que vous ne teniez d'eux, Et c'est sans murmurer que vous devez me rendre.
LE ROY.	LE ROY.
Ah, cherche un meilleur fondement Aux conſolations que ton cœur me preſente, Et de la fauſſeté de ce raiſonnement Ne fais point un accablement A cette douleur ſi cuiſante, Dont je ſouffre icy le tourment.	Ah, cherche un meilleur fondement Aux consolations que ton cœur me présente, Et de la fausseté de ce raisonnement Ne fais point un accablement À cette douleur si cuisante, Dont je souffre ici le tourment.
Crois-tu là me donner une raiſon puiſſante, Pour ne me plaindre point de cet Arreſt des Cieux?	Crois-tu là me donner une raison puissante, Pour ne me plaindre point de cet Arrêt des Cieux?
Et dans le procedé des Dieux Dont tu veux que je me contente, Une rigueur aſſaſſinante Ne paroiſt-elle pas aux yeux?	Et dans le procédé des Dieux Dont tu veux que je me contente, Une rigueur assassinante Ne paraît-elle pas aux yeux?
Voy l’état où ces Dieux me forcent à te rendre, Et l’autre où te reçeut mon cœur infortuné:	Vois l'état où ces Dieux me forcent à te rendre, Et l'autre où te reçut mon cœur infortuné:
Tu connoiſtras par là qu’ils me viennent reprendre Bien plus que ce qu’ils m’ont donné.	Tu connaîtras par là qu'ils me viennent reprendre Bien plus que ce qu'ils m'ont donné.
Je reçeus d’eux en toy, ma Fille, Un preſent que mon cœur ne leur demandoit pas;	Je reçus d'eux en toi, ma Fille, Un présent que mon cœur ne leur demandait pas;
J’y trouvois alors peu d’appas, Et leur en vis ſans joye accroiſtre ma famille.	J'y trouvais alors peu d'appas, Et leur en vis sans joie accroître ma famille.
Mais mon cœur ainſi que mes yeux S’eſt fait de ce preſent une douce habitude:	Mais mon cœur ainsi que mes yeux S'est fait de ce présent une douce habitude:
J’ay mis quinze ans de ſoins, de veilles, & d’étude, A me le rendre précieux, Je l’ay paré de l’aimable richeſſe De mille brillantes vertus, Tous les plus beaux tréſors que fournit la Sageſſe, A luy j’ay de mon ame attaché la tendreſſe, J’en ay fait de ce cœur le charme & l’allegreſſe, La conſolation de mes ſens abbatus, Le doux eſpoir de ma vieilleſſe.	J'ai mis quinze ans de soins, de veilles, et d'étude, À me le rendre précieux, Je l'ai paré de l'aimable richesse De mille brillantes vertus, Tous les plus beaux trésors que fournit la Sagesse, Ayeux j'ai de mon âme attaché la tendresse, J'en ai fait de ce cœur le charme et l'allégresse, La consolation de mes sens abattus, Le doux espoir de ma vieillesse.
Ils m’oſtent tout cela, ces Dieux, Et tu veux que je n’aye aucun ſujet de plainte, Sur cet affreux Arreſt dont je ſouffre l’atteinte?	Ils m'ôtent tout cela, ces Dieux, Et tu veux que je n'aie aucun sujet de plainte, Sur cet affreux Arrêt dont je souffre l'atteinte?
Ah!	Ah!
leur pouvoir ſe jouë avec trop de rigueur Des tendreſſes de noſtre cœur:	leur pouvoir se joue avec trop de rigueur Des tendresses de notre cœur:
Pour m’oſter leur preſent, leur falloit-il attendre Que j’en euſſe fait tout mon bien?	Pour m'ôter leur présent, leur fallait-il attendre Que j'en eusse fait tout mon bien?
Ou plutoſt, s’ils avoient deſſein de le reprendre, Neult-il pas eſte mieux de ne me donher rien?	Ou plutôt, s'ils avaient dessein de le reprendre, Neut-il pas este mieux de ne me donher rien?
PSICHE'.	PSICHÉE.
Seigneur, redoutez la colere De ces Dieux contre qui vous oſez éclater.	Seigneur, redoutez la colère De ces Dieux contre qui vous osez éclater.
LE ROY.	LE ROY.
drisocecaar quepeaxade nolia fanes Ils m’ont mis en état de ne rien redouter.	drisocecaar quepeaxade nolia fanes Ils m'ont mis en état de ne rien redouter.
PSICHE'.	PSICHÉE.
Ah, Seigneur, je tremble des crimes Que je vous fais commettre, & je doy me haïr.	Ah, Seigneur, je tremble des crimes Que je vous fais commettre, et je dois me haïr.
LE ROY.	LE ROY.
Ah, qu’ils ſouffrent du moins mes plaintes legitimes, Ce m’eſt aſſez d’effort que de leur obeïr, Ce doit leur eſtre aſſez que mon cœur t’abandonne Au barbare reſpect qu’il faut qu’on ait pour eux, Sans pretendre geſner la douleur que me donne L’épouvantable Arreſt d’un Sort ſi rigoureux.	Ah, qu'ils souffrent du moins mes plaintes légitimes, Ce m'est assez d'effort que de leur obéir, Ce doit leur être assez que mon cœur t'abandonne Au barbare respect qu'il faut qu'on ait pour eux, Sans prétendre gêner la douleur que me donne L'épouvantable Arrêt d'un Sort si rigoureux.
Mon juſte deſeſpoir ne ſçauroit ſe contraindre, Je veux, je veux garder ma douleur à jamais, Je veux ſentir toûjours la perte que je fais, De la rigueur du Ciel je veux toûjours me plaindre, Je veux juiqu’au trepas inceſſamment pleurer Ce que tout l’Univers ne peut me reparer.	Mon juste désespoir ne saurait se contraindre, Je veux, je veux garder ma douleur à jamais, Je veux sentir toujours la perte que je fais, De la rigueur du Ciel je veux toujours me plaindre, Je veux juiqu'au trépas incessamment pleurer Ce que tout l'Univers ne peut me réparer.
PSICHE’.	PSICHÉE.
Ah, de grace, Seigneur, épargnez ma foibleſſe, J’ay beſoin de conſtance en l’eſtat où je ſuis:	Ah, de grâce, Seigneur, épargnez ma faiblesse, J'ai besoin de constance en l'état où je suis:
Ne fortifiez point l’excés de mes ennuis Des larmes de voitre tendrene, Seuls ils ſont aſſez forts, & c’eſt trop pour mon cœur, Demon deſtin & de voſtre douleur.	Ne fortifiez point l'excès de mes ennuis Es larmes de voitre tendrène, Seuls ils sont assez forts, et c'est trop pour mon cœur, Démon destin et de votre douleur.
LE ROY.	LE ROY.
Oüy, je doy t’épargner mon deüil inconſolable.	Oui, je dois t'épargner mon deuil inconsolable.
Voicy l’inſtant fatal de m’arracher de toy:	Voici l'instant fatal de m'arracher de toi:
Mais comment prononcer ce mot épouvantable?	Mais comment prononcer ce mot épouvantable?
Il le faut toutefois, le Ciel m’en fait la loy, U ne rigueur inévitable M’oblige à te laiſſer en ce funeſte lieu.	Il le faut toutefois, le Ciel m'en fait la loi, V ne rigueur inévitable M'oblige à te laisser en ce funeste lieu.
Adieu, je vais.	Adieu, je vais.
Adieu.	Adieu.
Ce qui ſuit juſqu'à la fin de la Piece, eſt de M.	Ce qui suit jusqu'à la fin de la Pièce, est de M.
C.	Ç.
à la reſerve de la premiere Scene du troiſiéme Acte, qui eſt de la meſme main que ce qui a precedé.	à la réserve de la première Scène du troisième Acte, qui est de la même main que ce qui a précédé.
SCENE II.	SCÈNE II.
PSICID, AGLAORE, CIDIFPE.	PSICID, AGLARE, CIDIFPE.
PSICHE'.	PSICHÉE.
QUivez le Roy, mes Sœurs, vous eſſuyrezlſes larmes, Vous adoucirez ſes douleurs, Et voûs l’accableriez d’alarmes Si vous vous expoſiez encor à mes malheurs.	QUivez le Roi, mes Sœurs, vous essuirezlses larmes, Vous adoucirez ses douleurs, Et us l'accableriez d'alarmes Si vous vous exposiez encor à mes malheurs.
Conſervez luy ce qui luy reſte, Le Serpent que j’attens peut vous eſtre funeſte, Vous en veloper dans mon ſort, Et me porter en vous une ſeconde mort.	Conservez homme ce qui lui reste, Le Serpent que j'attends peut vous être funeste, Vous en velopper dans mon sort, Et me porter en vous une seconde mort.
Le Ciel m’a ſeule condamnée A ſon haleine empoiſonnée, Rien ne ſçauroit me ſecourir, Et je n’ay pas beſoin d’exemple pour mourir.	Le Ciel m'a seule condamnée À son haleine empoisonnée, Rien ne saurait me secourir, Et je n'ai pas besoin d'exemple pour mourir.
AGLAURE.	AGLAURE.
Ne nous enviez pas ce cruel avant age De confondre nos pleurs avec vos déplaiſirs, De meſler nos ſoûpirs à vos derniers ſoûpirs;	Ne nous enviez pas ce cruel avant age De confondre nos pleurs avec vos déplaisirs, De mêler nos soupirs à vos derniers soupirs;
D’une tendre amitié ſouffrez ce dernier gage.	D'une tendre amitié souffrez ce dernier gage.
PSICIE.	PSICIE.
C’eſt vous perdre inutilement.	C'est vous perdre inutilement.
CIDIPPE.	CIDIPE.
C’eſt en voſtre faveur eſperer un miracle,) Ou vous accompagner juſques au monument.	C'est en votre faveur espérer un miracle,) Ou vous accompagner jusques au monument.
PSICHE’.	PSICHÉE.
Que peut-on ſe promettre apres un tel Oracle?	Que peut-on se promettre après un tel Oracle?
AGLAURE.	AGLAURE.
Un Oracle jamais n’eſt ſans obſcurité, (tendre, On l’entend d’autant moins que mieux on croit l’enEt peut-eſtre apres tout n’en devez-vous attendre Que gloire & que felicité.	Un Oracle jamais n'est sans obscurité, (tendre, On l'entend d'autant moins que mieux on croit l'enEt peut-être après tout n'en devez-vous attendre Que gloire et que félicité.
Laiſſez-nous voir, ma Sœur, par une digne iſſuë, Cette frayeur mortelle heureuſement déçeuë, Ou nioui du mois avec vous, Si le Ciel à nos vœux ne ſe montre plus doux.	Laissez-nous voir, ma Sœur, par une digne issue, Cette frayeur mortelle heureusement déçue, Ou nioui du mois avec vous, Si le Ciel à nos vœux ne se montre plus doux.
PSICHE'.	PSICHÉE.
Ma Sœur, écoutez mieux la voix de la Nature, Qui vous appelle aupres du Roy.	Ma Sœur, écoutez mieux la voix de la Nature, Qui vous appelle auprès du Roi.
Vous m’aimez trop, le devoir en murmure, Vous en ſçavez l’indiſpenſable loy, Un Pere vous doit eſtre encor plus cher que moy.	Vous m'aimez trop, le devoir en murmure, Vous en savez l'indispensable loi, Un Père vous doit être encor plus cher que moi.
Rendez-vous toutes deux l’appuy de ſa vieilleſſe, Vous luy devez chacune un Gendre, & des Neveux, Mille Rois à l’envy vous gardent leur tendreſſe, Mille Rois à l’envy vous offriront leurs vœux:	Rendez-vous toutes deux l'appui de sa vieillesse, Vous avez devez chacune un Gendre, et des Neveux, Mille Rois à l'envi vous gardent leur tendresse, Mille Rois à l'envi vous offriront leurs vœux:
Dorcele mne veutfeule, ce leule uuur je veux Mourir, ſi je puis, ſans foibleſſe, Ou ne vous avoir pas pour temoins toutes deux De ce que malgré moy la Nature m’en laiſſe.	Dorcele morte veutfeule, ce leule ouvr je veux Mourir, si je puis, sans faiblesse, Ou ne vous avoir pas pour témoins toutes deux De ce que malgré moi la Nature m'en laisse.
AGLAURE.	AGLAURE.
Partager vos malheurs, c’eſt vous importuner.	Partager vos malheurs, c'est vous importuner.
CIDIPPE.	CIDIPE.
J’oſe dire un peu plus, ma Sœur, c’eſt vous déplaire.	J'ose dire un peu plus, ma Sœur, c'est vous déplaire.
PSICHE'.	PSICHÉE.
Non, mais enfin c’eſt me geſner, Et peut-eſtre du Ciel redoubler la colere,	Non, mais enfin c'est me gêner, Et peut-être du Ciel redoubler la colère,
AGLAURE.	AGLAURE.
Vous le voulez, & nous partons.	Vous le voulez, et nous partons.
Daigne ce meſme Ciel plus juſte & moins ſevere, Vous envoyer le ſort que nous vous ſouhaitons, Et que noſtre amitié ſincere En dépit de l’Oracie & inaigre vous elpere.	Daigne ce même Ciel plus juste et moins sévère, Vous envoyer le sort que nous vous souhaitons, Et que notre amitié sincère En dépit de l'Oracie et inaigre vous élpère.
PSICHE'.	PSICHÉE.
Adieu, c’eſt un eſpoir, ma Sœur, & des ſouhaits, &adeun des Di-da ne remipura jamais.	Adieu, c'est un espoir, ma Sœur, et des souhaits, etadeun des Di-dà ne remipura jamais.
SCENE III.	SCÈNE III.
PSICHE' ſeule.	PSICHÉE seule.
ENin ſeule, & toute à moy-meſme, Je puis enviſager cet affreux changement, Qui du haut d’une gloire extréme Me précipite au monument.	ENin seule, et toute à moi-même, Je puis envisager cet affreux changement, Qui du haut d'une gloire extrême Me précipite au monument.
Cette gloire eſtoit ſans ſeconde, L’éclat s’en répãdoit juſqu’aux deux bouts du Monde, Tout ce qu’ila de Rois ſembloient faits pour m’aimer:	Cette gloire était sans seconde, L'éclat s'en répondait jusqu'aux deux bouts du Monde, Tout ce qu'ila de Rois semblaient faits pour m'aimer:
Tous leurs Sujets me prenant pour Déeſſe, Commençoient à m’accoûtumer Aux encens qu’ils m’offroient ſans ceſſe;	Tous leurs Sujets me prenant pour Déesse, Commençaient à m'accoutumer Aux encens qu'ils m'offraient sans cesse;
Leurs ſoûpirs me ſuivoient ſansqu’il m’en coûtaſt rien, Mon ame reſtoit libre en captivant tant d’ame, Et j’eſtois parmy tant de flâmes Reyne de tous les cœurs, & maiſtreſſe du mien.	Leurs soupirs me suivaient sansqu'il m'en coûtât rien, Mon âme restait libre en captivant tant d'âme, Et j'étais parmi tant de flammes Reine de tous les cœurs, et maîtresse du mien.
O Ciel!	Ô Ciel!
m’auriez-vous fait un crime De cette inſenſibilité?	m'auriez-vous fait un crime De cette insensibilité?
Déployez-vous ſur moy tant de ſeverité, Pour n’avoir à leurs vœux rendu que de l’eſtime?	Déployez-vous sur moi tant de sévérité, Pour n'avoir à leurs vœux rendu que de l'estime?
Si vous m’impoſiez cette loy, Qu’il fallut faire un choix pour ne pas vous déplaire, Puis que je ne pouvois le faire, Que ne le faiſiez-vous pour moy?	Si vous m'imposiez cette loi, Qu'il fallut faire un choix pour ne pas vous déplaire, Puis que je ne pouvais le faire, Que ne le faisiez-vous pour moi?
Que ne m’inſpiriez-vous ce qu’inſpire à tant d'autres Le mérite, l’amour, &.	Que ne m'inspiriez-vous ce qu'inspire à tant d'autres Le mérite, l'amour, et.
Mais que vois-je icy?	Mais que vois-je ici?
SCENE IV.	SCÈNE IV.
CLEOMENE, AGENOR, PSICHE',	CLÉOMENE, AGENOR, PSICHE',
CLEOMENE.	CLÉOMENE.
Eux Amis, deux Rivaux, dont l’unique ſoucy D'Eſt d’expoſer leurs jourspour conſerver les vôtres.	Eux Amis, deux Rivaux, dont l'unique souci D'Est d'exposer leurs jourspour conserver les vôtres.
PSICHE’.	PSICHÉE.
Puis-je vous écouter quand j’ay chaſſé deux Sœurs?	Puis-je vous écouter quand j'ai chassé deux Sœurs?
Princes, contre le Ciel penſez-vous me deſendre?	Princes, contre le Ciel pensez-vous me désendre?
Vous livrer au Serpent qu’icy je dois attendre, coireit quun deſeſpoir qui ſied mal aux grands Et mourir alors que je meurs, C’eſt accabler une ame tendre Qui n’a que trop de ſes douleurs.	Vous livrer au Serpent qu'ici je dois attendre, coireit quun désespoir qui sied mal aux grands Et mourir alors que je meurs, C'est accabler une âme tendre Qui n'a que trop de ses douleurs.
cœurs,	cœurs,
AGENOR.	AGENOR.
Un Serpent n’eſt pas invincible;	Un Serpent n'est pas invincible;
Cadmus qui n’aimoit rien défit celuy de Mars;	Cadmus qui n'aimait rien défit celui de Mars;
Nous aimons, & l’Amour ſçait rendre tout poſſible Au cœur qui ſuit ſes étendarts, A la main dont luy-meſme il conduit tous les dards.	Nous aimons, et l'Amour sait rendre tout possible Au cœur qui suit ses étendards, À la main dont deux-même il conduit tous les dards.
PSICHE'.	PSICHÉE.
Voulez-vous qu’il vous ſerve en faveur d’une ingrate Que tous ſes traits n’ont pû toucher?	Voulez-vous qu'il vous serve en faveur d'une ingrate Que tous ses traits n'ont pu toucher?
Qu’il dompte ſa vangeance au moment qu’elle éclate, Et vous aide à m’en arracher?	Qu'il dompte sa vengeance au moment qu'elle éclate, Et vous aide à m'en arracher?
Quand meſme vous m’auriez ſervie, Qund vous m’auriez rendu la vie, Quyel fruit eiperez-vous de qui ne peut aimer?	Quand même vous m'auriez servie, Qund vous m'auriez rendu la vie, Quel fruit eipérez-vous de qui ne peut aimer?
CLEOMENE.	CLÉOMENE.
Ce n’eſt point par l’eſpoir d’un ſi charmant ſalaire Que nous nous ſentons animer, Nous ne cherchons qu’à ſatisfaire Aux devoirs d’un amour qui n’oſe préſumer Que jamais, quoy qu’il puiſſe faire, Il ſoit capable de vous plaire, Et digne de vous enflâmer.	Ce n'est point par l'espoir d'un si charmant salaire Que nous nous sentons animer, Nous ne cherchons qu'à satisfaire Aux devoirs d'un amour qui n'ose présumer Que jamais, quoi qu’il puisse faire, Il soit capable de vous plaire, Et digne de vous enflâmer.
Vivez, belle Princeſſe, & vivez pour un autre;	Vivez, belle Princesse, et vivez pour un autre;
Nous le verrons d’un œil jaloux, Nous en mourrons, mais d’un trépas plus doux Ques’il nous falloit voir le voſtre;	Nous le verrons d'un œil jaloux, Nous en mourrons, mais d'un trépas plus doux Ques'il nous fallait voir le vôtre;
Et ſi nous ne mourrons en vous ſauvant le jour, Quelque amour qu’a nos yeux vous preſeriez au noſtre, Nous voulons bien mourir de douleur & d’amour.	Et si nous ne mourrons en vous sauvant le jour, Quelque amour qu'a nos yeux vous preseriez au nôtre, Nous voulons bien mourir de douleur et d'amour.
PSICHE’.	PSICHÉE.
Vivez, Princes, vivez, & de ma Deſtinée Ne ſongez plus à rompre, ou partager la loy:	Vivez, Princes, vivez, et de ma Destinée Ne songez plus à rompre, ou partager la loi:
Jecroy vous l’avoir dit, le Ciel ne veut que moy, Le Ciel m’a ſeulecondamnée.	Jecrois vous l'avoir dit, le Ciel ne veut que moi, Le Ciel m'a seulecondamnée.
Je penſe oüir déja les mortels ſifflemens De ſon Miniſtre qui s’approche, Ma frayeur me le peint, me l’offre à tous momens, Et mantrene qu'enceit de touo meoiiſenhens, Elle me le figute au haut de cette Roche, J’en tombe de foibleſſe, & mon cœur abatu Ne ſoûtient plus qu’à peine un reſte de vertu.	Je pense ouïr déjà les mortels sifflements De son Ministre qui s'approche, Ma frayeur me le peint, me l'offre à tous moments, Et mantrène qu'enceit de touo meoiisenhens, Elle me le figute au haut de cette Roche, J'en tombe de faiblesse, et mon cœur abattu Ne soutient plus qu'à peine un reste de vertu.
Adieu, Princes, fuyez, qu’il ne vous empoiſonne.	Adieu, Princes, fuyez, qu'il ne vous empoisonne.
AGENOR.	AGENOR.
Rien ne s’offre à nos yeux encor qui les étonne, Et quand vous vous peignez un ſi prochetrépas, Si la force vous abandonne, Nous avons des cœurs & des bras Que l’eſpoir n’abandonne pas.	Rien ne s'offre à nos yeux encor qui les étonne, Et quand vous vous pelez un si prochetrépas, Si la force vous abandonne, Nous avons des cœurs et des bras Que l'espoir n'abandonne pas.
Peut-eſtre qu’un Rival a dicté cet Oracle, Que l’or a fait parler celuy qui l’a rendu:	Peut-être qu'un Rival a dicté cet Oracle, Que l'or a fait parler celui qui l'a rendu:
Ce ne ſeroit pas un miracle, Que pour un Dieu muet un Homme euſt répondu;	Ce ne serait pas un miracle, Que pour un Dieu muet un Homme eût répondu;
Et dans tous les Chmats on n’a que trop d’exemples Qu’il eſt ainſi qu’ailleurs des meſchãs dãs les Temples.	Et dans tous les Chmats on n'a que trop d'exemples Qu'il est ainsi qu'ailleurs des méchants dans les Temples.
CLEOMENE.	CLÉOMENE.
Laiſſez-nous oppoſer au lâche Raviſſeur, A qui le Sacrilege indignement vous livre, Un amour qu’a le Ciel choiſi pour defenſeur De la ſeule Beauté pour qui nous voulons vivre.	Laissez-nous opposer au lâche Ravisseur, À qui le Sacrilège indignement vous livre, Un amour qu'a le Ciel choisi pour défenseur De la seule Beauté pour qui nous voulons vivre.
di nous n’oſons prétendre à la poneſion, Du moins en ſon péril permettez-nous de ſuivre L’ardeur & les devoirs de noſtre paſſion.	di nous n'osons prétendre à la ponesion, Du moins en son péril permettez-nous de suivre L'ardeur et les devoirs de notre passion.
PSICHE’.	PSICHÉE.
Portez-les à d’autres moy-meſmes, Princes, portez-les à mes Sœurs Ces devoirs, ces ardeurs extrémes Dont pour moy ſont remplis vos cœurs, Vivez pour elles quand je meurs, Plaignez de mon Deſtin les funeſtes rigueurs, Sans leur donner en vous de nouvelles matieres.	Portez-les à d'autres moi-mêmes, Princes, portez-les à mes Sœurs Ces devoirs, ces ardeurs extrêmes Dont pour moi sont remplis vos cœurs, Vivez pour elles quand je meurs, Plaignez de mon Destin les funestes rigueurs, Sans leur donner en vous de nouvelles matières.
Ce ſont mes volontez dernieres, Et l’on a reçeu de tout temps Pour ſouveraines loix les ordres des Mourans.	Ce sont mes volontés dernières, Et l'on a reçu de tout temps Pour souveraines lois les ordres des Mourants.
Princeſſe.	Princesse.
CLEOMENE.	CLÉOMENE.
PSICHE'.	PSICHÉE.
Encor un coup, Princes, vivez pour elles, Tant que vous m’aimerez vous devez m’obeïr;	Encore un coup, Princes, vivez pour elles, Tant que vous m'aimerez -vous devez m'obéir;
Ne me reduiſez pas à vouloir vous haïr, Et vous regarder en rebelles, A force de m’eſtre fidelles.	Ne me réduisez pas à vouloir vous haïr, Et vous regarder en rebelles, À force de m'être fidèles.
Allez, laiſſez-moy ſeule expirer en ce lieu, Oû je n’ay plus de voix que pour vous dire Adieu.	Allez, laissez-moi seule expirer en ce lieu, Ou je n'ai plus de voix que pour vous dire Adieu.
Mais je ſens qu’on m’enleve, &l’air m’ouvre une route D’où vous n’entendrez plus cette mourante voix.	Mais je sens qu'on m'enlève, etl'air m'ouvre une route D'où vous n'entendrez plus cette mourante voix.
Adieu, Princes, Adieu pour la derniere fois, voyez n’demon lort vous pouvez eſtre en doute.	Adieu, Princes, Adieu pour la dernière fois, voyez n'démon lort vous pouvez être en doute.
Elle eſt enlevée en l’air par deux Zephires.	Elle est enlevée en l'air par deux Zéphires.
AGENOR.	AGENOR.
Nous la perdons de veuë, allons tous deux chercher Sur le faiſte de ce Rocher, Prince, les moyens de la ſuivre.	Nous la perdons de vue, allons tous deux chercher Sur le faîte de ce Rocher, Prince, les moyens de la suivre.
CLEOMENE.	CLÉOMENE.
Allons-y chercher ceux de neluy point ſurvivre.	Allons-y chercher ceux de nelui point survivre.
SCENE V L’AMOUR en l’air.	SCÈNE V 'AMOUR en l'air.
ALlez mourir, Rivaux d’un Dieu jaloux, Dont vous meritez le couroux, Pour avoir eu le cœur ſenſible aux meſmes charmes, Et toy, forge, Vulcain, mille brillans attraits Pour orner un Palais, Où l’Amour de Pſiché veut eſſuyer les larmes, Et luy rendre les armes.	ALlez mourir, Rivaux d'un Dieu jaloux, Dont vous méritez le courroux, Pour avoir eu le cœur sensible aux mêmes charmes, Et toi, forge, Vulcain, mille brillants attraits Pour orner un Palais, Où l'Amour de Pie veut essuyer les larmes, Et lui rendre les armes.
SLCCMS MYERMEDL.	SLCCMS MYERMEDL.
A Scene ſe change en une Cour magnifique, ornée L de Colomnes de Lapys enricbies de Figures d’orqui forment un Palais pompeux & brillant, que l’amour deſtene pour Pſiché.	À Scène se change en une Cour magnifique, ornée L de Colomnes de Lapis enricbies de Figures d'orqui forment un Palais pompeux et brillant, que l'amour destène pour Psiché.
Six Cyclopes avec quatre Fées y font une Entrée de Ballet, où ils achevent en cadence quatre gros Vaſes d’argent que les Fées leur ont apportez.	Six Cyclopes avec quatre Fées y font une Entrée de Ballet, où ils achèvent en cadence quatre gros Vases d'argent que les Fées leur ont apportez.
Cette Entrée eſt entrecoupée par ce Recit de Vulcain, qu’il fait à deux repriſes.	Cette Entrée est entrecoupée par ce Recit de Vulcain, qu'il fait à deux reprises.
Quand l’Amour preſſe, On n’a jamais fait aſlez toſt.	Quand l'Amour se, On n'a jamais fait aslez tôt.
L’Amour ne veut point qu’on differe, Ila valllez, naſtez-vous, Frappez, redoublez vos coups, Que l’ardeur de luy plaire Faſſe vos ſoins les plus doux.	L'Amour ne veut point qu'on diffère, Ila valllez, nastez-vous, Frappez, redoublez vos coups, Que l'ardeur de lui plaire Fasse vos soins les plus doux.
SECOND COUPLET.	SECOND COUPLET.
Ervez bien un Dieu ſi charmant, e nie plant dans rempaenenient.	Ervez bien un Dieu si charmant, eu nie plant dans rempaenenient.
Que chacun pour luy s’intereſſe, N’oubliez rien des ſoins qu’il faut;	Que chacun pour lui s'intéresse, N'oubliez rien des soins qu'il faut;
Quand l’Amour preſſe, On n’a jamais fait aſſez toſt.	Quand l'Amour se, On n'a jamais fait assez tôt.
L’Amour re veut point qu’on differe, Travaillez, &c.	L'Amour re veut point qu'on diffère, Travaillez, etc.
ACTE III.	ACTE III.
SCENE PREMIERE.	SCÈNE PREMIÈRE.
L’AMOUR, ZEPHIRE.	L'AMOUR, ZÉPHIRE.
ZEPHIRE.	ZÉPHIRE.
Ux, je me ſuis galamment acquité De la commiſſion que vous m’avez donnée, Et du haut du Rocher je l’ay, cette Beauté, Par le milieu des airs doucement amenée Dans ce beau Palais enchanté, Où vous pouvez en liberté Diſpoſer de ſa Deſtinée:	Oùx, je me suis galamment acquité De la commission que vous m'avez donnée, Et du haut du Rocher je l'ai, cette Beauté, Par le milieu des airs doucement amenée Dans ce beau Palais enchanté, Où vous pouvez en liberté Disposer de sa Destinée:
Mais vous me ſurprenez par ce grand changement Qu’en voſtre perſonne vous faites;	Mais vous me surprenez par ce grand changement Qu'en votre personne vous faites;
Cette taille, ces traits, & cet ajuſtement, Cachent tout-à-fait qui vous eſtes, Et je donne aux plus fins à pouvoir en ce jour Vous reconnoiſtre pour l’Amo ur.	Cette taille, ces traits, et cet ajustement, Cachent tout-à-fait qui vous êtes, Et je donne aux plus fins à pouvoir en ce jour Vous reconnaître pour l'Amo ur.
D.	D.
L’AMOUR.	L'AMOUR.
Auſſi ne veux-je pas qu’on puiſſe me connoiſtre, Je ne veux à Pſiché que découvrir mon cœur, Rien que les beaux tranſports de cette vive ardeur Que ſes doux charmes y font naiſtre;	Aussi ne veux-je pas qu'on puisse me connaître, Je ne veux à Psiché que découvrir mon cœur, Rien que les beaux transports de cette vive ardeur Que ses doux charmes y font naître;
Et pour en exprimer l’amoureuſe langueur, Et cacher ce que je puis eſtre Aux yeux quim’impoient des loix, J’ay pris la forme que tu vois.	Et pour en exprimer l'amoureuse langueur, Et cacher ce que je puis être Aux yeux quim'impaient des lois, J'ai pris la forme que tu vois.
ZEPHIRE.	ZÉPHIRE.
En tout vous eſtes un grand Maiſtre, C’eſt icy que je le connois.	En tout vous êtes un grand Maître, C'est ici que je le connais.
Sous des déguiſemens de diverſe nature On a veu les Dieux amoureux Chercher à ſoulager cette douce bleſſure Que reçoivent les cœurs de vos traits pleins de feux:	Sous des déguisements de diverse nature On a vu les Dieux amoureux Chercher à soulager cette douce blessure Que reçoivent les cœurs de vos traits pleins de feux:
Mais en bon ſens vous l’emportez ſur eux, Et voila la bonne figure Pour avoir un ſuccés heureux, Pres de l’aimable Sexe où l’on porte ſes vœux.	Mais en bon sens vous l'emportez sur eux, Et voilà la bonne figure Pour avoir un succès heureux, Pres de l'aimable Sexe où l'on porte ses vœux.
Ouy, de ces loinſes la r’amtanee ent oien forte, Et ſans parler ny de rang, n’y d’eſprit, Qui peut trouver moyen d’eſtre fait de la ſor te, Ne ſoûpire guere à credit.	Oui, de ces loinses la ramtane ent oien forte, Et sans parler ni de rang, n'y d'esprit, Qui peut trouver moyen d'être fait de la sot te, Ne soupire guère à crédit.
L’AMOUR.	L'AMOUR.
J’ay reſolu, mon cher Zephire, De demeurer ainſi toûjours, Et l’oi ne peut le trouver à le fite A l’aiſné de tous les Amours.	J'ai résolu, mon cher Zéphire, De demeurer ainsi toujours, Et l'oi ne peut le trouver à le site A l'aîné de tous les Amours.
Il eſt temps de ſortir de cette longue enfance Qui fatigue ma patience, Il eſt temps deſormais que je devienne grand.	Il est temps de sortir de cette longue enfance Qui fatigue ma patience, Il est temps désormais que je devienne grand.
ZEPHIRE.	ZÉPHIRE.
Fort-bien, vous ne pouvez mieux faire, Et vous entrez dans un miſtere Qui ne demande rien d’enfant.	Fort-bien, vous ne pouvez mieux faire, Et vous entrez dans un mystère Qui ne demande rien d'enfant.
L’AMOUR.	L'AMOUR.
Ce changement ſans doute irritera ma Mere.	Ce changement sans doute irritera ma Mère.
ZEPHIRE Je prévoy là-deſſus quelque peu de colere.	ZEPHIRE Je prévoi là-dessus quelque peu de colère.
Bien que les diſputes des ans Ne doivent point regner parmy des Immortelles, Voſtre Mere Vénus eſt de l’humeur des Belles Qui n’aiment point de grands enfans.	Bien que les disputes des ans Ne doivent point régner parmi des Immortelles, Votre Mère Vénus est de l'humeur des Belles Qui n'aiment point de grands enfants.
Mais où je la trouve outragée, C’eſt dans le procedé que l’on vous voit tenir, Et c’eſt l’avoir étrangement vangée, Que d’amieria neaute quene vouion punir.	Mais où je la trouve outragée, C'est dans le procédé que l'on vous voit tenir, Et c'est l'avoir étrangement vengée, Que d'amiera neaute quène vouion punir.
Cette haine où ſes vœux pretendent que réponde La puiſſance d’un Fils que redoutent les Dieux.	Cette haine où ses vœux prétendent que réponde La puissance d'un Fils que redoutent les Dieux.
L’AMOUR.	L'AMOUR.
Laiſſons cela, Zephire, & me dy ſi tes yeux Netrouvent pas Pſiché la plus belle du Monde?	Laissons cela, Zéphire, et me dis si tes yeux Nettrouvent pas Psiché la plus belle du Monde?
Eſt-il rien ſur la Terre, eſt-il rien dans les Cieux, & paine lay tavn le ntiegionleux De beauté ſans ſeconde?	Est-il rien sur la Terre, est-il rien dans les Cieux, et paine la taun le niegionleux De beauté sans seconde?
Mais je la voy, mon cher Zephire, Qui demeure ſurpriſe à l’éclat de ces lieux.	Mais je la vois, mon cher Zéphire, Qui demeure surprise à l'éclat de ces lieux.
ZEPHIRE.	ZÉPHIRE.
Vous pouvez vous montrer pour finir ſon martyre, Luy découvrir ſon deſtin glorieux, Et vous dire entre vous tout ce que peuvent dire Les ſoûpirs, la bouche, & les yeux.	Vous pouvez vous montrer pour finir son martyre, Lui découvrir son destin glorieux, Et vous dire entre vous tout ce que peuvent dire Les soupirs, la bouche, et les yeux.
En Confident diſcret je ſçay ce qu’il faut faire Pour ne pas interrompre un amoureux myſtere.	En Confident discret je sais ce qu'il faut faire Pour ne pas interrompre un amoureux mystère.
D ij	D ij
SOERAI	SORAI
Que mon eſpoir eſt ridicule, s’il croit par là ſoulager mes douleurs:	Que mon espoir est ridicule, s'il croit par là soulager mes douleurs:
PSICHE' ſeule.	PSICHÉE seule.
J ſuis-je?	J suis-je?
& dans un lieu que je croyois barbare, OQuelle ſçavante main a baſty ce Palais, Que l’Art, que la Narure pare De l’aſſemblage le plus rare Que l’œil puiſſe admirer jamais?	et dans un lieu que je croyais barbare, OQuelle savante main a bâti ce Palais, Que l'Art, que la Narure pare De l'assemblage le plus rare Que l'œil puisse admirer jamais?
Dans ces Jardins, dans ces Apartemens, Dont les pompeux ameublemens Nv ont rien qui n’enchante & ne flate;	Dans ces Jardins, dans ces Appartements, Dont les pompeux ameublements Név ont rien qui n'enchante et ne flatte;
Et de quelque coſté que tournent mes frayeurs, Je ne voy ſous mes pas que de l’or, ou des fleurs.	Et de quelque côté que tournent mes frayeurs, Je ne vois sous mes pas que de l'or, ou des fleurs.
Le Ciel auroit-il fait cet amas de mer veilles Pour la demeure d’un Serpent?	Le Ciel aurait-il fait cet amas de mer veilles Pour la demeure d'un Serpent?
Et lors que par leur veuë il amuſe & ſuſpend De mon Deſtin jaloux les rigueurs ſans pareilles, Veut-il montrer qu’il s’en repent?	Et lors que par leur vue il amuse et suspend De mon Destin jaloux les rigueurs sans pareilles, Veut-il montrer quil 'en repent?
Non, non, c’eſt de ſa haine en cruautez féconde Le plus noir, le plus rudc erdit, Qui par une rigueur nouvelle & ſans ſeconde N’étale ce choix qu’elle a fait De ce qu’a de plus beau le Monde, Qu'afin que je le quitte avec plus de regret.	Non, non, c'est de sa haine en cruautés féconde Le plus noir, le plus rudc erdit, Qui par une rigueur nouvelle et sans seconde N'étale ce choix qu'elle a fait De ce qu'a de plus beau le Monde, Qu'afin que je le quitte avec plus de regret.
Tout autant de momens que ma mort ſe recule, Sont autant de nouveaux malheurs, Plus elle tarde, & plus de fois je meurs.	Tout autant de moments que ma mort se recule, Sont autant de nouveaux malheurs, Plus elle tarde, et plus de fois je meurs.
Ne me fay plus languir, vien prendre ta victime, Monſtre qui dois me déchirer;	Ne me fais plus languir, viens prendre ta victime, Montre qui dois me déchirer;
Veux-tu que je te cherche, & faut-il que j’anime!	Veux-tu que je te cherche, et faut-il que j'anime!
Tes fureurs à me devorer?	Tes fureurs à me dévorer?
Si le Ciel veut ma mort, ſi ma vie eſt un crime, De ce peu qui m’en reſte oſe enfin t’emparer, Je ſuis laſſe de murmurer Contre un chaſtiment legitime, Je luis lane deloupnel, Vien, que j’acheve d’expirer.	Si le Ciel veut ma mort, si ma vie est un crime, De ce peu qui m'en reste ose enfin t'emparer, Je suis lasse de murmurer Contre un châtiment légitime, Je luis luis deloupnel, Vien, que j'achève d'expirer.
SCENE III L’AMOUR, PSICHE’, ZEPHIRE.	SCÈNE III L'AMOUR, PSICHÉE' ZÉPHIRÉE.
L'AMOUR.	L'AMOUR.
E voila ce Serpent, ce Monſtre impitoyable, LQu’un Oracle étonnant pour vous a préparé, Et qui n’eſt pas peut-eſtre à tel point effroyable Que vous vous l’eſtes figuré.	E voilà ce Serpent, ce Monstre impitoyable, LUQu'un Oracle étonnant pour vous a préparé, Et qui n'est pas peut-être à tel point effroyable Que vous vous l'êtes figuré.
FSICIB.	FSICIB.
Vous, Seigneur, vous ſeriez ce Monſtre dont l’Oracle A menacé mes triſtes jours, Vous qui ſemblez plutoſt un Dieu qui par miracle Daigne venir luy-meſme à mon ſecours!	Vous, Seigneur, vous seriez ce Montre dont l'Oracle A menacé mes tristes jours, Vous qui semblez plutôt un Dieu qui par miracle Daigne venir lui-même à mon secours!
L’AMOUR.	L'AMOUR.
Quel beſoin de ſecours au milieu d’un Empire, Où tout ce qui reſpire N’attends que vos regards pour en prendre la Loy, Où vous n’avez à craindre autre Monſtre que moy?	Quel besoin de secours au milieu d'un Empire, Où tout ce qui respire N'attends que vos regards pour en prendre la Loi, Où vous n'avez à craindre autre Montre que moi?
PSICHE'.	PSICHÉE.
Qu’un Monſtre tel que vous inſpire peu de crainte!	Qu'un Monstre tel que vous inspire peu de crainte!
Et que s’il a quelque poiſon, Une ame auroit peu de raiſon De hazarder la moindre plainte, Contre une favorable atteinte Dont tout le cœur craindroit la gueriſon?	Et que s'il a quelque poison, Une âme aurait peu de raison De hasarder la moindre plainte, Contre une favorable atteinte Dont tout le cœur craindrait la guérison?
A peine je vous voy, que mes frayeurs ceſſées Laiſſent évanoüir l’image du trépas, Et que je ſens couler dans mes veines glaſſées Un je ne ſçay quel feu que je neconnoy pas.	À peine je vous vois, que mes frayeurs cessées Laissent évanouir l'image du trépas, Et que je sens couler dans mes veines glassées Un je ne sais quel feu que je neconnais pas.
J’ay ſenty de l’eſtime, & de la complaiſance, De l’amitié, de la reconnoiſſance, De la compaſſion les chagrins innocens.	J'ai senti de l'estime, et de la complaisance, De l'amitié, de la reconnaissance, De la compassion les chagrins innocents.
M’en ont fait ſentir la puiſſance, Mais je n’ay point encor ſenty ce que je ſens.	M'en ont fait sentir la puissance, Mais je n'ai point encor senti ce que je sens.
Je ne ſçay ce que c’eſt, mais je ſçay qu’il me charme, Que je n’en conçoy point d’alarme;	Je ne sais ce que c'est, mais je sais qu'il me charme, Que je n'en conçois point d'alarme;
Plus j’ay les yeux ſur vous, plus je m’en ſens charmer:	Plus j'ai les yeux sur vous, plus je m'en sens charmer:
Tout ce que j’ay ſenty n’agiſſoit point de meſme, Et je dirois que je vous aime, Seigneur, ſi je ſçavois ce que c’eſt que d’aimer.	Tout ce que j'ai senti n'agissait point de même, Et je dirais que je vous aime, Seigneur, si je savais ce que c'est que d'aimer.
Ne les détournez point, ces yeux qui m’empoiſõnent, Ces yeux tendres, ces yeux perçans, mais amoureux, Qui ſemblent partager le trouble qu’ils me donnent.	Ne les détournez point, ces yeux qui m'empoisõnent, Ces yeux tendres, ces yeux perçants, mais amoureux, Qui semblent partager le trouble qu'ils me donnent.
Helas!	Hélas!
plus ils ſont dangereux, Plus je me plais à m’attacher ſur eux.	plus ils sont dangereux, Plus je me plais à m'attacher sur eux.
Par quel ordre du Ciel que je ne puis comprendre Vous dy-je plus que je ne doy, Moy de qui la pudeur devroit du moins attendre Que vous m’expliquaſſiez le trouble où je vous voy?	Par quel ordre du Ciel que je ne puis comprendre Vous dis-je plus que je ne dois, Moi de qui la pudeur devrait du moins attendre Que vous m'expliquassiez le trouble où je vous vois?
Vous ſoûpirez, Seigneur, ainſi que je ſoûpire, Vos ſens comme les miens paroiſſent interdits, C’eſt à moy de m’en taire, à vous de me le dire, Et cependant c’eſt moy qui vous le dis.	Vous soupirez, Seigneur, ainsi que je soupire, Vos sens comme les miens paraissent interdits, C'est à moi de m'en taire, à vous de me le dire, Et cependant c'est moi qui vous le dis.
L’AMOUR.	L'AMOUR.
Vous avez eu, Pſiché, l'ame toûjours ſi dure, Qu’il ne faut pas vous étonner, Si pour en reparer l’injure L’Amour en ce moment ſe paye avec uſure De ceux qu’elle a deu luy donner.	Vous avez eu, Psiché, l'âme toujours si dure, Qu'il ne faut pas vous étonner, Si pour en réparer l'injure L'Amour en ce moment se paye avec usure De ceux qu'elle a deval donner.
Ce moment eſt venu qn’il faut que voſtre bouche Exhale des ſoûpirs ſi longtemps retenus, Et qu’en vous arrachant à cette humeur farouche, Un amas de tranſports auſſi doux qu’inconnus Auſſi ſennblemient tout à la fois vous touene, Qu’ils ont dû vous toucher durant tant de beaux jours Dont cette ame inſenſible a profané le cours.	Ce moment est venu qn'il faut que votre bouche Exhale des soupirs si longtemps retenus, Et qu'en vous arrachant à cette humeur farouche, Un amas de transports aussi doux qu'inconnus Aussi sennblemient tout à la fois vous touène, Qu'ils ont dû vous toucher durant tant de beaux jours Dont cette âme insensible à profané le cours.
PSICHE'.	PSICHÉE.
N’aimer point, c’eſt donc un grand crime!	N'aimer point, c'est donc un grand crime!
EMMCoRs.	EMCoRs.
En ſouffrez-vous un rude châtiment?	En souffrez-vous un rude châtiment?
PSICHE'.	PSICHÉE.
C’eſt punir aſſez doucement.	C'est punir assez doucement.
L’AMOUR.	L'AMOUR.
C’eſt luy choiſir ſa peine légitime, nt.	C'est lui choisir sa peine légitime, naît.
Et ſe faire juſtice en ce glorieux jour D’un manquement d’amour, par un excés d’amour.	Et se faire justice en ce glorieux jour D'un manquement d'amour, par un excès d'amour.
PSICHE'.	PSICHÉE.
Que n’ay-je eſté plûtoſt punie!	Que n'ai-je été plutôt punie!
J’y mets le bonheur de ma vie, Je devrois en rougir, ou le dire plus bas, Mais le ſupplice a trop d’appas?	J'y mets le bonheur de ma vie, Je devrais en rougir, ou le dire plus bas, Mais le supplice a trop d'appas?
Permettez que tout haut je le die & redie, Je le dirois cent fois & n’en rougirois pas.	Permettez que tout haut je le die et rédie, Je le dirais cent fois et n'en rougirais pas.
Ce n’eſt point moy qui parle, & de voſtre preſence L’empire ſurprenant, l’aimable violence, Dés que je veux parler, s’empare de ma voix.	Ce n'est point moi qui parle, et de votre présence L'empire surprenant, l'aimable violence, Dès que je veux parler, s'empare de ma voix.
C’eſt en vain qu’en ſecret ma pudeur s’en offenſe, Que le Sexe & la bienſeance Oſent me faire d’autre loix;	C'est en vain qu'en secret ma pudeur s'en offense, Que le Sexe et la bienséance Osent me faire d'autre lois;
Vos yeux de ma réponſe eux-meſmes font le choix, et ma bouche aſſervie à leul toute-pumanice Ne me conſulte plus ſur ce que je me dois.	Vos yeux de ma réponse eux-mêmes font le choix, et ma bouche asservie à leute toute-pumanice Ne me consulte plus sur ce que je me dois.
L’AMOUR.	L'AMOUR.
Croyez, belle Pſiché, croyez ce qu’ils vous diſent, Ces yeux, qui ne ſont point jaloux, Qu’à l’envy les voſtres m’inſtruiſent De tout ce qui ſe paſſe en vous.	Croyez, belle Psiché, croyez ce qu'ils vous disent, Ces yeux, qui ne sont point jaloux, Qu'à l'envi les vôtres m'instruisent De tout ce qui se passe en vous.
Croyez en ce cœur quiſoûpire, Et qui, tant que le voſtre y voudra repartir, Vous dira bien plus d’un ſoûpir Que cent regards ne peuvent dire.	Croyez -en ce cœur quisoûpire, Et qui, tant que le vôtre y voudra répartir, Vous dira bien plus d'un soupir Que cent regards ne peuvent dire.
C’eſt le langage le plus doux, C’eſt le plus fort, c’eſt le plus ſeur de tous.	C'est le langage le plus doux, C'est le plus fort, c'est le plus sûr de tous.
PSICHE'.	PSICHÉE.
L’intelligence en étoit deuë A nos cœurs, pour les rendre également contens:	L'intelligence en était due A nos cœurs, pour les rendre également contens:
J’ay ſoûpiré, vous m’avez entenduë;	J'ai soupiré, vous m'avez entendue;
Vous ſoûpirez, je vous entens.	Vous soupirez, je vous entends.
Mais ne me laiſſez plus en doute, Seigneur, & dites-moy n'par la memme route Aprés moy le Zephire icy vous a rendu Pout me dire ce que j’écoute.	Mais ne me laissez plus en doute, Seigneur, et dites-moi n'épar la même route Après moi le Zéphire ici vous a rendu Pout me dire ce que j'écoute.
Quand j’y ſuis arrivée, étiez-vous attendu?	Quand j'y suis arrivée, étiez-vous attendu?
Et quand vous luy parlez, étes-vous entendu?	Et quand vous lui parlez, êtes-vous entendu?
L’AMOUR.	L'AMOUR.
J'ay dans ce doux climat un ſouverain empire, Comme vous l’avez ſur mon cœur:	J'ai dans ce doux climat un souverain empire, Comme vous l'avez sur mon cœur:
L’Amour m’eſt favorable, & c’eſt en ſa faveur Qu’à mes ordres Æole a ſoûmis le Zéphire.	L'Amour m'est favorable, et c'est en sa faveur Qu'à mes ordres Æole a soumis le Zéphire.
C’eſt l’Amour qui pour voir mes feux récompenſez Luy-meſme a dicté cet Oracle, Par qui vos beaux jours menacez D’une foule d’Amans ſe ſont débaraſſez, Et qui m’a delivré de béternel obſtacle De tant de ſoûpirs empreſſez, Qui ne méritoient pas de vous eſtre adreſſez.	C'est l'Amour qui pour voir mes feux récompensez Lui-même à dicté cet Oracle, Par qui vos beaux jours menacés D'une foule d'Amand se sont débarassez, Et qui m'a délivré de béternel obstacle De tant de soupirs empressez, Qui ne méritaient pas de vous être adressez.
Ne me demandez point quelle eſt cette Province, Ny le nom de ſon Prince, Vous le ſçaurez quand il en ſera temps:	Ne me demandez point quelle est cette Province, Ni le nom de son Prince, Vous le saurez quand il en sera temps:
Je veux vous acquerir, mais c’eſt par mes ſervices, Par des ſoins aſſidus, & par des vœux conſtans, Par les amoureux ſacrifices De tout ce que je ſuis, De tout ce que je puis, Sans que l’éclat du rang pour moy vous ſollicite, Sans que de mon pouvoir je me faſſe un mérite;	Je veux vous acquérir, mais c'est par mes services, Par des soins assidus, et par des vœux constants, Par les amoureux sacrifices De tout ce que je suis, De tout ce que je puis, Sans que l'éclat du rang pour moi vous sollicite, Sans que de mon pouvoir je me fasse un mérite;
Et bien que Souverain dans cet heureux ſejour, Je ne vous veux, Pſiché, devoir qu’à mon amour.	Et bien que Souverain dans cet heureux séjour, Je ne vous veux, Psiché, devoir qu'à mon amour.
Venez-en admirer avec moy les merveilles, Princeſſe, & préparez vos yeux & vos oreilles A ce qu’il a d’enchantemens.	Venez-en admirer avec moi les merveilles, Princesse, et préparés vos yeux et vos oreilles À ce qu'il a d'enchantements.
Vous y verrez des Bois & des Prairies Conteſter ſur leurs agrémens Avec l’Or & les Pierreries;	Vous y verrez des Bois et des Prairies Conter sur leurs agrémens Avec l'Or et les Pierreries;
Vous n’entendrez que des concerts charmans, De cent Beautez vous y ſerez ſervie, Qui vous adoreront ſans vous porter envie, Et brigueront à tous momens D’une ame ſoûmiſe & ravie L’honneur de vos commandemens.	Vous n'entendrez que des concerts charmans, De cent Beautés vous y serez servie, Qui vous adoreront sans vous porter envie, Et brigueront à tous moments D'une âme soumise et ravie L'honneur de vos commandements.
PSICHE'.	PSICHÉE.
Mes volontez ſuivent les voſtres, Je n’en ſçaurois plus avoir d’autres;	Mes volontés suivent les vôtres, Je n'en saurais plus avoir d'autres;
Mais voſtre Oracle enfin vient de me ſéparer De deux Sœurs, & du Roy mon Pere, Que mon trépas imaginaire Réduit tous trois à me pleurer.	Mais votre Oracle enfin vient de me séparer De deux Sœurs, et du Roi mon Père, Que mon trépas imaginaire Réduit tous trois à me pleurer.
Pour diſſiper l’erreur dont leur ame accablée De mortels déplaiſirs ſe voit pour moy comblée, Souffrez que mes Sœurs ſoient témoins Et de ma gloire & de vos ſoins.	Pour dissiper l'erreur dont leur âme accablée De mortels déplaisirs se voit pour moi comblée, Souffrez que mes Sœurs soient témoins Et de ma gloire et de vos soins.
Prétez-leur comme à moy les aiſles du Zéphire, Qui leur puiſſent de voſtre Empire Aiin qu amoy laciter Pacces;	Prêtez-leur comme à moi les ailes du Zéphire, Qui leur puissent de votre Empire Ajin qu' amoi laciter Pacces;
Faites-leur voir en quels lieux je reſpire, Faites-leur de ma perte admirer le ſuccés.	Faites-leur voir en quels lieux je respire, Faites-leur de ma perte admirer le succès.
L’AMOUR.	L'AMOUR.
Vous ne me donnez pas, Pſiché, toute voſtre ame:	Vous ne me donnez pas, Psiché, toute votre âme:
Ce tendre ſouvenir d’un Pere & de deux Sœurs Me vole une part des douceurs Que je veux toutes pour nid flame.	Ce tendre souvenir d'un Père et de deux Sœurs Me vole une part des douceurs Que je veux toutes pour nid flamme.
[vous, N’ayez d’yeux que pour moy, qui n’en ay que pour Ne ſongez qu’à m’aimer, ne ſongez qu'a me plaire;	[vous, N'ayez d'yeux que pour moi, qui n'en ai que pour Ne songez qu'à m'aimer, ne songez qu'à me plaire;
Et quand de tels ſoucis oſent vous en diſtraire.	Et quand de tels soucis osent vous en distraire.
PSICHE'.	PSICHÉE.
Des tendreſſes du ſang peut-on eſtre jaloux?	Des tendresses du sang peut-on être jaloux?
L'AMOUR.	L'AMOUR.
Je le ſuis, ma Pſiché, de toute la Nature.	Je le suis, ma Psiché, de toute la Nature.
Les rayons du Soleil vous baiſent trop ſouvent, Vos cheveux ſouffrent trop les careſſes du Vent;	Les rayons du Soleil vous baisent trop souvent, Vos cheveux souffrent trop les caresses du Vent;
Dés qu’il les flate, j’en murmure:	Dès qu'il les flatte, j'en murmure:
L’air meſme que vous reſpirez, Avec trop de plaiſir paſſe par voſtre bouche;	L'air même que vous respirez, Avec trop de plaisir passe par votre bouche;
Voſtre habit de trop pres vous touche;	Votre habit de trop pres vous touche;
Le Zéphire s’envole.	Le Zéphire s'envole.
Quand vous leur ferez voir ce bienheureux ſejour, De ſes tréſors faites-leur cent largeſſes, Prodiguez.	Quand vous leur ferez voir ce bienheureux séjour, De ses trésors faites-leur cent largesses, Prodiguez.
leur careſſes ſur careſſes, Et du ſang, s’il ſe peut, épuiſez les tendreſſes, Pour vous rendre toute à l'Amour.	leur caresses sur caresses, Rendre du sang, s'il se peut, épuisez les tendresses, Pour vous rendre toute à l'Amour.
Je n’y meſleray point d’importune préſence, Mais neieul fuites puo de n'iongs entretiens, Vous ne ſçauriez pour eux avoir de complaiſance, Que vous ne dérobiez aux miens.	Je n'y mêlerai point d'importune présence, Mais neieul fuites puo de n'iongs entretiens, Vous ne sauriez pour eux avoir de complaisance, Que vous ne dérobiez aux miens.
Et ſi-toſt que vous ſoûpirez, Je ne ſçay quoy qui m’effarouche Craint parmy vos ſoûpirs des ſoûpirs égarez.	Et sitôt que vous soupirez, Je ne sais quoi qui m'effarouche Craint parmi vos soupirs des soûpirs égarés.
Mais vous voulez vos Sœurs, allez, partez Zéphire, Pſiché le veut, je ne l’en puis dédire.	Mais vous voulez vos Sœurs, allez, partez Zéphire, Psiché le veut, je ne l'en puis dédire.
PSICHE.	PSYCHÉ.
Voſtre amour me fait une grace Dont je n’abuſeray jamais.	Votre amour me fait une grâce Dont je n'abuserai jamais.
L’AMOUR.	L'AMOUR.
Allons voir cependant ces Jardins, ce Palais, Où vous ne verrez rien que voſtre éclat n’efface.	Allons voir cependant ces Jardins, ce Palais, Où vous ne verrez rien que votre éclat n'efface.
Et vous petits Amours, & vous jeunes Zéphirs, Qui pour ames n’avez que de tendres ſoûpirs, Montrez tous à l’envy ce qu’à voir ma Princeſſe Vous avez ſenty d’allégreſſe.	Et vous petits Amours, et vous jeunes Zéphyrs, Qui pour âmes n'avez que de tendres soupirs, Montrez tous à l'envi ce qu'à voir ma Princesse Vous avez senti d'allégresse.
E ij	E ij
TROISTESME INTLRMEDE.	TROISTESME INTLRMEDE.
L ſe fait une Entrée de Ballet de quatre Amours & Iquatre Zéphirs, interrompuë deux fois par un Dialogue chanté par un Amour & un Zéphir.	L se fait une Entrée de Ballet de quatre Amours et Iquatre Zéphirs, interrompue deux fois par un Dialogue chanté par un Amour et un Zéphir.
LE ZEPHIR.	LE ZEPHYR.
Imable Jeuneſſe, A Suivez la tendreſſe.	Imable Jeunesse, A Suivez la tendresse.
Joignez aux beaux jours La douceur des Amours.	Joignez aux beaux jours La douceur des Amours.
C’eſt pour vous ſurprendre, Qu’on vous fait entendre Qu’il faut éviter leurs ſoûpirs, Et cramdie ieurs dens:	C'est pour vous surprendre, Qu'on vous fait entendre Qu'il faut éviter leurs soupirs, Et cramdie jus dens:
Laiſſez-vous apprendre Quels ſont leurs plaiſirs.	Laissez-vous apprendre Quels sont leurs plaisirs.
Ils chantent enſemble.	Ils chantent ensemble.
Hacun eſt obligé d’aimer A ſon tour, Et plus on a dequoy charmer, Plus on doit à l’Amour.	Hacun est obligé d'aimer A son tour, Et plus on a déquoi charmer, Plus on doit à l'Amour.
LE ZEPHIR ſeul.	LE ZEPHYR seul.
Un cœur jeune & tendre Eſt fait pour ſe rendre, Il n’a point à prendre De fâcheux détour.	Un cœur jeune et tendre Est fait pour se rendre, Il n'a point à prendre De fâcheux détour.
Las deux enſemble.	Las deux ensemble.
Chacun eſt obligé d’aimer A ſon tour, Et plus on a dequoy charmer, Plus on uoit à l’Ahfour.	Chacun est obligé d'aimer A son tour, Et plus on a déquoi charmer, Plus on uoit Ahfour.
L’AMOUR ſeul.	L'AMOUR seul.
Pourquoy ſe défendre?	Pourquoi se défendre?
Que ſert-il d’attendre?	Que sert-il d'attendre?
Quand on perd un jour, On le perd ſans retour.	Quand on perd un jour, On le perd sans retour.
Les deux enſemble.	Les deux ensemble.
Chacun eſt obligé d’aimer aalen de dey Et plus on a dequoy chalier, Plus on doit à l’Amour.	Chacun est obligé d'aimer alen de y Et plus on a dequoy chalier, Plus on doit à l'Amour.
SECOND COVPLET.	SECOND COUPLET.
Ils chantent enſemble.	Ils chantent ensemble.
S’il faut des ſoins & des travaux En aimant, On eſt payé de mille maux Par un heureux moment.	S'il faut des soins et des travaux En aimant, On est payé de mille maux Par un heureux moment.
LE ZEPHIR.	LE ZEPHYR.
L’Amour a des charmes, Rendons-luy les armes, Ses ſoins & ſes pleurs Ne ſont pas ſans douceurs.	L'Amour a des charmes, Rendons-lui les armes, Ses soins et ses pleurs Ne sont pas sans douceurs.
Un cœur pour le ſuivre A cent maux ſe livre, Il faut pour gouiter ies appas Languir juſqu’au trépas, Mais ce n’eſt pas vivre Que de n’aimer pas.	Un cœur pour le suivre A cent maux se livre, Il faut pour gouiter jes appas Languir jusqu'au trépas, Mais ce n'est pas vivre Que de n'aimer pas.
E iij	 Ejà
LE ZEPHIR ſeul.	LE ZEPHYR seul.
On craint, on eſpere, Il faut du miſtere, Mais on n’obtient guere De bien ſans tourment.	On craint, on espère, Il faut du mystère, Mais on n'obtient guère De bien sans tourment.
Les deux enſemble.	Les deux ensemble.
S’il faut des ſoins & des travaux En aimant, On eſt paye de mille maux Par un heureux moment.	S'il faut des soins et des travaux En aimant, On est paie de mille maux Par un heureux moment.
L’AMOUR ſeul.	L'AMOUR seul.
Que peut-on mieux faire, Cnena que plne.	Que peut-on mieux faire, Cnena que plaine.
C’eſt un ſoin charmant, Que l’employ d’un Amant.	C'est un soin charmant, Que l'emploi d'un Amant.
Les deux enſemble.	Les deux ensemble.
S’il faut des ſoins & des travaux En aimant, On eſt payé de mille maux Par un heureux moment.	S'il faut des soins et des travaux En aimant, On est payé de mille maux Par un heureux moment.
Le Théatre devient un autre Palais magnifique, cupé dans le fond par un Veſtibule, au travers duquel on voit un Iardin ſuperbe & charmant, décoré de pluſieurs Vaſes d’Orangers, & d’Arbres chargez de toutes ſortes de Fruits.	Le Théâtre devient un autre Palais magnifique, cupé dans le fond par un Vestibule, au travers duquel on voit un Jardin superbe et charmant, décoré de plusieurs Vases d'Orangers, et d'Arbres chargez de toutes sortes de Fruits.
ACTE IV SCENE PREMIERE.	ACTE IV SCÈNE PREMIÈRE.
AGLAURE, CIDIPPE.	AGLAURE, CIDIPPE.
V7 AGLAIURE.	V7 AGLAIURE.
E n’en puis plus, ma Sœur, j’aylveu trop de merveilles, L’avenir aura peine à les bien cõcevoir;	ELLE n'en puis plus, ma Sœur, j'aylveu trop de merveilles, L'avenir aura peine à les bien concevoir;
Le Soleil qui voit tout, & qui nous fait tout voir, N’en a veu jamais de pareilles.	Le Soleil qui voit tout, et qui nous fait tout voir, N'en a vu jamais de pareilles.
Elles me chagrinent l’eſprit, Et ce brillant Palais, ce pompeux équipage, Font un odieux étalage Qui m’accable de honte autant que de dépit.	Elles me chagrinent l'esprit, Et ce brillant Palais, ce pompeux équipage, Font un odieux étalage Qui m'accable de honte autant que de dépit.
Que la Fortune indignement nous traite, Et que ſa largeſſe indiſcrete Prodigue aveuglement, épuiſe, unit d’efforts, Pour faire de tant de tréſors Le partage d’une Cadette!	Que la Fortune indignement nous traite, Et que sa largesse indiscrète Prodigue aveuglement, épuise, unit d'efforts, Pour faire de tant de trésors Le partage d'une Cadette!
E iiij	 iiij
CIDIPPE.	CIDIPE.
J'entre dans tous vos ſentimens, J’ay les meſmes chagrins, & dans ces lieux charmans Tout ce qui vous déplaiſt me bleſſe;	J'entre dans tous vos sentiments, J'ai les mêmes chagrins, et dans ces lieux charmants Tout ce qui vous déplaît me blesse;
Tout ce que vous prenez pour un mortel affront, Comme vous m’accable, & me laiſſe L’amertume dans l’ame, & la rougeur au front.	Tout ce que vous prenez pour un mortel affront, Comme vous m'accable, et me laisse L'amertume dans l'âme, et la rougeur au front.
AGLAURE.	AGLAURE.
Non, ma Sœur, il n’eſt point de Reynes, Qui dans leur propre Etat parlent en Souveraines, Comme Pſiché parle en ces lieux.	Non, ma Sœur, il n'est point de Reines, Qui dans leur propre État parlent en Souveraines, Comme Psiché parle en ces lieux.
On l’y voit obeïe avec exactitude, Et de ſes volontez une amoureuſe étude Les cherche juſques dans ſes yeux.	On l'y voit obéie avec exactitude, Et de ses volontés une amoureuse étude Les cherche jusque dans ses yeux.
Mille beautez s’empreſſent autour d’elle, Et ſemblent dire à nos regards jaloux, Quels que ſoient nos attraits, elle eſt encor plus bellos Et nous qui la ſervons, le ſommes plus que vous.	Mille beautés s'empressent autour d'elle, Et semblent dire à nos regards jaloux, Quels que soient nos attraits, elle est encor plus bellos Et nous qui la servons, le sommes plus que vous.
Elle prononce, on execute, Aucun ne s’en defend, aucun ne s’en rebute:	Elle prononce, on execute, Aucun ne s'en défend, aucun ne s'en rebute:
Flore qui s’attache à ſes pas, Répand à pleines mains autour de ſa perſonne Ce qu’elle a de plus doux appas, Zéphire vole aux ordres qu’elle donne, Et ſon Amante & luy s’en laiſſant trop charmer, Quittent pour la ſervir les ſoins de s’entr’aimer.	Flore qui s'attache à ses pas, Répand à pleines mains autour de sa personne Ce qu'elle a de plus doux appas, Zéphire vole aux ordres qu'elle donne, Et son Amante et lu en laissant trop charmer, Quittent pour la servir les soins de s'entre autour.
CIDIPPE.	CIDIPE.
Elle a des Dieux à ſon ſervice, Elle aura bientoſt des Autels;	Elle a des Dieux à son service, Elle aura bientôt des Autels;
Et nous ne commandons qu’à de chétifs Mortels, De qui l’audace & le caprice Contre nous à toute heure en ſecret revoltez, Oppoſent à nos volontez Ou le murmure, ou l’artifice.	Et nous ne commandons qu'à de chétifs Mortels, De qui l'audace et le caprice Contre nous à toute heure en secret révoltez, Opposent à nos volontés Ou le murmure, ou l'artifice.
AGLAURE.	AGLAURE.
C’eſtoit peu que dans noſtre Cour Tant de cœurs à l’envy nous l’euſſent preferée;	C'était peu que dans notre Cour Tant de cœurs à l'envi nous l'eussent préférée;
Ce n’eſtoit pas aſſez que de nuit & de jour D’une foule d’Amans elle y fuſt adorée:	Ce n'était pas assez que de nuit et de jour D'une foule d'Amand elle y fût adorée:
Quand nous nous conſolions de la voir au tombeau Par l’ordre impréveu d’un Oracle, Elle a voulu de ſon deſtin nouveau Faire en noſtre préſence éclater le miracle, Et choiſy nos yeux pour témoins De ce qu’au fond du cœur nous ſouhaitions le moins,	Quand nous nous consolions de la voir au tombeau Par l'ordre imprévu d'un Oracle, Elle a voulu de son destin nouveau Faire en notre présence éclater le miracle, Et choisi nos yeux pour témoins De ce qu'au fond du cœur nous souhaitions le moins,
CIDIPPE.	CIDIPE.
Ce qui le plus me deſeſpere, C’eſt cet Amant parfait & ſi digne de plaire, Qui ſe captive ſous ſes loix.	Ce qui le plus me désespère, C'est cet Amant parfait et si digne de plaire, Qui se captive sous ses lois.
Quand nous pourrions choiſir entre tous les MonarEn eſt-il un de tant de Rois Qui porte de ſi nobles marques?	Quand nous pourrions choisir entre tous les MonarEn est-il un de tant de Rois Qui porte de si nobles marques?
Se voir du bien par dela ſes ſouhaits, [ques, N’eſt ſouvent qu’un bonheur qui fait des miſérables?	Se voir du bien par déla ses souhaits, [ques, N'est souvent qu'un bonheur qui fait des misérables?
Il n’eſt ny train pompeux, ny ſuperbes Palais, Qui n’ouvrent quelque porte à des maux incurables;	Il n'est assez train pompeux, ni superbes Palais, Qui n'ouvrent quelque porte à des maux incurables;
Mais avoir un Amant d’un mérite acheve, Et s’en voir cherement aimée, C’eſt un bonheur ſi haut, ſi relevé, Que ſa grandeur ne peut eſtre exprimée.	Mais avoir un Amant d'un mérite achève, Et s'en voir chèrement aimée, C'est un bonheur si haut, si relevé, Que sa grandeur ne peut être exprimée.
AGLAURE.	AGLAURE.
N’en parlõs plus, ma Sœur, nous en mourrions d’enSongeons plutoſt à la vangeance, (nuy, Et trouvons le moyen de rompre entre elle & luy Cette adorable intelligence.	N'en parlons plus, ma Sœur, nous en mourrions d'enSongeons plutôt à la vengeance, (nui, Et trouvons le moyen de rompre entre elle et lui Cette adorable intelligence.
La voicy.	La voici.
J’ay des coups tous preſts à luy porter, Qu'elle aura peine d’éviter.	J'ai des coups tous prêts à lui porter, Qu'elle aura peine d'éviter.
SCENE II.	SCÈNE II.
PSICHE, AGLAORE, CIDIPPE.	PSYCHÉ, AGLARE, CIDIPE.
PSICHE'.	PSICHÉE.
IE viens vous dire adieu, mon Amant vous renvoye, T EEt ne ſçauroit plus endurer Que vous luy retranchiez un moment de la joye Qu’il prend de ſe voir ſeul à me conſiderer.	JE viens vous dire adieu, mon Amant vous renvoie, T OIt ne saurait plus endurer Que vous lui retranchiez un moment de la joie Qu'il prend de se voir seul à me considérer.
Dans un ſimple regard, dans la moindre parole, Son amour trouve des douceurs, Qu’en faveur du ſang je luy vole, Quand je les partage à des Sœurs.	Dans un simple regard, dans la moindre parole, Son amour trouve des douceurs, Qu'en faveur du sang je lui vole, Quand je les partage à des Sœurs.
AGLAURE.	AGLAURE.
La jalouſie eſt aſſez fine, Et ces délicats ſentimens Méritent bien qu’on s’imagine Que celuy qui pour vous a ces empreſſemens, Paſſe le commun des Amans.	La jalousie est assez fine, Et ces délicats sentiments Méritent bien qu'on s'imagine Que celui qui pour vous a ces empressements, Passe le commun des Amants.
Je vous en parle ainſi faute de le connoiſtre.	Je vous en parle ainsi faute de le connaître.
Vous ignorez ſon nom, & ceux dont il tient l’eſtre, Nos eſprits en ſont alarmez:	Vous ignorez son nom, et ceux dont il tient l'être, Nos esprits en sont alarmés:
Je le tiens un grand Prince, & d’un pouvoir ſupréme Bien au dela du Diadéme, Ses tréſors ſous vos pas confuſément ſemez Ont dequoy faire honte à l’abondance meſme;	Je le tiens un grand Prince, et d'un pouvoir suprême Bien au déla du Diadème, Ses trésors sous vos pas confusément semés Ont dequoy faire honte à l'abondance même;
Vous l’aimez autant qu’il vous aime, Il vous charme, & vous le charmez;	Vous l'aimez autant qu'il vous aime, Il vous charme, et vous le charmez;
Voſtre felicité, ma Sœur, ſeroit extréme, Si vous ſçaviez qui vous aimez.	Votre félicité, ma Sœur, ferait extrême, Si vous saviez qui vous aimez.
PSICHE'.	PSICHÉE.
Que m’importe?	Que m'importe?
j’en ſuis aimée;	j'en suis aimée;
Plus il me voit, plus je luy plais;	Plus il me voit, plus je Seigneur plais;
Il n’eſt point de plaiſirs dont l’ame ſoit charmée, Qui ne préviennent mes ſouhaits, Et je voy mar dequoy la voltle cicalammee, Quand tout me ſert dans ce Palais.	Il n'est point de plaisirs dont l'âme soit charmée, Qui ne préviennent mes souhaits, Et je vois mar dequoy la voltèle cicalamène, Quand tout me sert dans ce Palais.
AGLAURE.	AGLAURE.
Qu’importe qu’icy tout vous ſerve, Si toûjours cet Amant vous cache ce qu’il eſt?	Qu'importe qu'ici tout vous serve, Si toujours cet Amant vous cache ce qu'il est?
Nous ne nous alarmons que pour voſtre intereſt.	Nous ne nous alarmons que pour votre intérêt.
En vain tout vous y rit, en vain tout vous y plaiſt,l Le veritable amour ne fait point de reſerve, Et qui s’obſtine à ſe cacher, Sent quelque choſe en ſoy qu’on luy peut reprochet, Si cet Amant devient volage, Car ſouvent en amour le change eſt aſſez doux, Et j'oſe le dire entre nous, Pour grand que ſoit l’éclat dont brille ce viſage, Il en peut eſtre ailleurs d’auſſi belles que vous.	En vain tout vous y rit, en vain tout vous y plaît, Le véritable amour ne fait point de réserve, Et qui s'obstine à se cacher, Sent quelque chose en soi qu'on lui ont reprochet, Si cet Amant devient volage, Car souvent en amour le change est assez doux, Et j'ose le dire entre nous, Pour grand que soit l'éclat dont brille ce visage, Il en peut être ailleurs d'aussi belles que vous.
Si, dis-je, un autre objet ſous d’autres loix l’engage, Si dans l’état où je vous voy, Seule en ſes mains, & ſans defenſe, Il va juſqu’à la violence, Surquevous vangerue le Roy, Ou de ce changement, ou de cette inſolence?	Si, dis-je, un autre objet sous d'autres lois l'engage, Si dans l'état où je vous vois, Seule en ses mains, et sans défense, Il va jusqu'à la violence, Surquevous vengerve le Roi, Ou de ce changement, ou de cette insolence?
PSICHE.	PSYCHÉ.
Ma Sœur, vous me faites trembler.	Ma Sœur, vous me faites trembler.
Juſte Ciel!	Juste Ciel!
pourois-je eſtre aſſez infortunée.	pourrais-je être assez infortunée.
CIDIPPE.	CIDIPE.
Que ſçait-on ſi déja les nœuds de l’Hymenée.	Que sait-on si déjà les nœuds de l'Hyménée.
PSICHE'.	PSICHÉE.
N’achevez pas, ce ſeroit m’accabler.	N'achevez pas, ce serait m'accabler.
AGLAURE.	AGLAURE.
Je n’ay plus qu’un mot à vous dire.	Je n'ai plus qu'un mot à vous dire.
Ce Prince qui vous aime, & qui cõmande aux Vents, Qui nous donne pour Char les aiſles du Zéphire, Et de nouveaux plaiſirs vous comble à tous momens, Quand il rompt à vos yeux l’ordre de la Nature, Peut-eſtre à tant d’amour meſle un peu d’impoſture Peut-eſtre ce Palais n’eſt qu’un enchantement;	Ce Prince qui vous aime, et qui commande aux Vents, Qui nous donne pour Char les aime du Zéphire, Et de nouveaux plaisirs vous comble à tous moments, Quand il rompt à vos yeux l'ordre de la Nature, Peut-être à tant d'amour mêle un peu d'imposture Peut-être ce Palais n'est qu'un enchantement;
Et ces lambris dorez, ces amas de richeſſes Dont il achete vos tendreſſes, Dés qu’il ſera laſſé de ſouffrir vos careſſes, Diſparoiſtront en un moment.	Et ces lambris dorés, ces amas de richesses Dont il achète vos tendresses, Dès qu'il sera lassé de souffrir vos caresses, Disparaîtront en un moment.
Vous ſçavez cõme nous ce que peuvent les charmes	Vous savez comme nous ce que peuvent les charmes
PSICHE'.	PSICHÉE.
Que je ſens à mon tour de cruelles alarmes!	Que je sens à mon tour de cruelles alarmes!
AGLAURE.	AGLAURE.
Noſtre amitié ne veut que voſtre bien.	Notre amitié ne veut que votre bien.
PSICHE'.	PSICHÉE.
Adieu, mes Sœurs, finiſſons l’entretien, J’aime, & je crains qu’on ne s’impatiente.	Adieu, mes Sœurs, finissons l'entretien, J'aime, et je crains qu'on ne s'impatiente.
Partez, & demain ſi je puis Vous me verrez, ou plus contente, Ou dans l’accablement des plus mortels ennuis.	Partez, et demain si je puis Vous me verrez, ou plus contente, Ou dans l'accablement des plus mortels ennuis.
AGLAURE.	AGLAURE.
Nous aitoisuit au Roy quene mouven gione, Quel excés de bonheur le Ciel répand ſur vous.	Nous aitaisuit au Roi quène mouven gione, Quel excès de bonheur le Ciel répand sur vous.
CIDIPPE.	CIDIPE.
Nous allons luy conter d’un changement ſi doux La ſurprenante & mer veilleuſe hiſtoire.	Nous allons Seigneur conter d'un changement si doux La surprenante et mer veilleuse histoire.
PSICHE'.	PSICHÉE.
Ne l’inquiétez point, ma Sœur, de vos ſoupçons;	Ne l'inquiétez point, ma Sœur, de vos soupçons;
Et quand vous luy peindrez un ſi charmant Empire.	Et quand vous lui peindrez un si charmant Empire.
AGLAURE.	AGLAURE.
Nous ſçavons toutes deux ce qu’il faut taire, ou dire, Et n’avons pas beſoin ſur ce point de leçons.	Nous Savons toutes deux ce qu'il faut taire, ou dire, Et n'avons pas besoin sur ce point de leçons.
Le Zéphire enleve les deux Sœurs de Pſiché dans un nüage qui deſcend juſqu’à terre, & dans lequel il les emporie avet rapiane.	Le Zéphire enlève les deux Sœurs de Psiché dans un nuage qui descend jusqu'à terre, et dans lequel il les emporie avet rapiane.
SCENE III.	SCÈNE III.
L’AMOUR, PSICHE'.	L'AMOUR, PSICHE'.
L’AMOUR.	L'AMOUR.
Nfin vous eſtes ſeule, & je puis vous redire, ESans avoir pour témoins vos importunes Sœurs, Ce que des yeux ſi beaux ont pris ſur moy d’empire, Et quel excés ont les douceurs Qu’une ſincere ardeur inſpire Si-toſt qu’elle aſſemble deux cœurs.	Nfin vous êtes seule, et je puis vous redire, EStans avoir pour témoins vos importunes Sœurs, Ce que des yeux si beaux ont pris sur moi d'empire, Et quel excès ont les douceurs Qu'une sincère ardeur inspire Si-tôt qu'elle assemble deux cœurs.
Je puis vous expliquer de mon ame ravie Les amoureux empreſſemens, Et vous jurer qu’à vous ſeule aſſervie Elle n’a pour objet de ſes raviſſemens, Que de voir cette ardeur de meſme ardeur ſuivie Ne concevoir plus d’autre envie Que de regler mes vœux ſur vos deſirs, Et de ce qui vous plait faire tous mes plaiſirs.	Je puis vous expliquer de mon âme ravie Les amoureux empressements, Et vous jurer qu'à vous seule asservie Elle n'a pour objet de ses ravissements, Que de voir cette ardeur de même ardeur suivie Ne concevoir plus d'autre envie Que de régler mes vœux sur vos désirs, Et de ce qui vous plaît faire tous mes plaisirs.
Mais d’où vient qu’un triſte nuage Semble offuſquer l’éclat de ces beaux yeux?	Mais d'où vient qu'un triste nuage Semble offusquer l'éclat de ces beaux yeux?
Vous manque-t-il quelque choſe en ces lieux?	Vous manque-t-il quelque chose en ces lieux?
Des vœux qu’on vous y rend dédaignez-vous l’homPSICHE'.	Des vœux qu'on vous y rend dédaignez-vous l'homPSICHÉE.
mage?	mage?
Non, Seigneur.	Non, Seigneur.
L’AMOUR.	L'AMOUR.
Qu’eſt-ce donc, & d’où vient mon malheurt J’entens moins de ſoûpirs d’amour que de douleur, Je voy de voſtre teint les roſes amorties Marquer un déplaiſir ſecret;	Qu'est-ce donc, et d'où vient mon malheurt J'entends moins de soupirs d'amour que de douleur, Je vois de votre teint les roses amorties Marquer un déplaisir secret;
Vos Sœurs à peine ſont parties, Que vous ſoûpirez de regret!	Vos Sœurs à peine sont parties, Que vous soupirez de regret!
Ah, Pſiché, de deux cœurs quãd l’ardeur eſt la meſme, Ont-ils des ſoûpirs différens?	Ah, Psiché, de deux cœurs quand l'ardeur est la même, Ont-ils des soupirs différents?
Et quand on aime bien, & qu’on voit ce qu’on aime, Peut-on ſonger à des Parens?	Et quand on aime bien, et qu'on voit ce qu'on aime, Peut-on songer à des Parents?
PSICHE'.	PSICHÉE.
Ce n’eſt point là ce qui m’afflige.	Ce n'est point là ce qui m'afflige.
LAMOUR.	LAMOUR.
Eſt-ce l’abſence d’un Rival, Et d’un Rival aimé qui fait qu’on me neglige?	Est-ce l'absence d'un Rival, Et d'un Rival aimé qui fait qu'on me néglige?
PSICHE'.	PSICHÉE.
Dans un cœur tout à vous que vous penétrez mal!	Dans un cœur tout à vous que vous pénétrez mal!
Je vous aime, Seigneur, & mon amour s’irrite De l’indigne ſoupçon que vous avez formé:	Je vous aime, Seigneur, et mon amour s'irrite De l'indigne soupçon que vous avez formé:
Vous ne connoiſſez pas quel eſt voſtre mérite, Si vous craignez de n’eſtre pas aimé.	Vous ne connaissez pas quel est votre mérite, Si vous craignez de n'être pas aimé.
Je vous aime, & depuis que j’ay veu la lumiere, Je me ſuis montrée aſſez fiere, Pour dédaigner les vœux de plus d’un Roy:	Je vous aime, et depuis que j'ai vu la lumière, Je me suis montrée assez fière, Pour dédaigner les vœux de plus d'un Roi:
Et s’il vous faut ouvrir mon ame toute entiere, Je n’ay trouvé que vous qui fuſt digne de moy.	Et s'il vous faut ouvrir mon âme toute entière, Je n'ai trouvé que vous qui fût digne de moi.
Cependant j’ay quelque triſteſſe Qu’en vain je voudrois vous cacher, Un noir chagrin ſe meſle à toute ma tendreſſe, Dont je ne la puis détacher.	Cependant j'ai quelque tristesse Qu'en vain je voudrais vous cacher, Un noir chagrin se mêle à toute ma tendresse, Dont je ne la puis détacher.
Ne m’en demandez point la cauſe, Peut-eſtre la ſçachant, voudrez-vous m’en punir;	Ne m'en demandez point la cause, Peut-être la secachant, voudrez-vous m'en punir;
Et ſi j’oſe aſpirer encor à quelque choſe, Je iuis leure du moins de ne point robtenir.	Et si j'ose aspirer encor à quelque chose, Je juis lèvre du moins de ne point robtenir.
L’AMOUR.	L'AMOUR.
Et ne craignez-vous point qu’à mon tour je m’irrite, Que vous connoifſiez mal quel eſt voſtre mérite, Ou feigniez de ne pas ſçavoir Quel eſt ſur moy voſtre abſolu pouvoir?	Et ne craignez-vous point qu'à mon tour je m'irrite, Que vous connaissez mal quel est votre mérite, Ou feigniez de ne pas savoir Quel est sur moi votre absolu pouvoir?
Ah ſi vous en doutez, loyez deraburee, Parlez.	Ah si vous en doutez, loyez deraburée, Parlez.
PSICHE'.	PSICHÉE.
J’auray l’affront de me voir refuſée.	J'aurai l'affront de me voir refusée.
L’AMOUR.	L'AMOUR.
Prenez en ma faveur demeilleurs ſentimens, L’expérience en eſt aiſée;	Prenez en ma faveur deilleurs sentiments, L'expérience en est aisée;
Parlez, tout ſe tient preſt à vos commandemens.	Parlez, tout se tient prêt à vos commandements.
Si pour m’en croire il vous faut des ſermens, J’en jure vos beaux yeux, ces maiſtres de mon ame, Ces divins autheurs de ma flame;	Si pour m'en croire il vous faut des serments, J'en jure vos beaux yeux, ces maîtres de mon âme, Ces divins auteurs de ma flamme;
Et ſi ce n’eſt aſſez d’en jurer vos beaux yeux, J’en jure par le Styx, comme jurent les Dieux.	Et si ce n'est assez d'en jurer vos beaux yeux, J'en jure par le Styx, comme jurent les Dieux.
PSICHE'.	PSICHÉE.
J’oſe craindre un peu moins apres cette aſſurance.	J'ose craindre un peu moins après cette assurance.
Seigneur, je vois icy la pompe & l’abondance, Je vous adore, & vous m’aimez, Mon cœur en eſt ravy, mes ſens en ſont charmez;	Seigneur, je vois ici la pompe et l'abondance, Je vous adore, et vous m'aimez, Mon cœur en est ravi, mes sens en sont charmez;
Mais parmy ce bonheur ſupréme J’ay le mameur de ne lȩavoir qui j’aime.	Mais parmi ce bonheur suprême J'ai le mameur de ne lumavoir qui j'aime.
Diſſipez cet aveuglement, Et faites-moy connoiſtre un ſi parfait Amant.	Dissipez cet aveuglement, Et faites-moi connaître un si parfait Amant.
L’AMOUR.	L'AMOUR.
Pſiché, que venez-vous de dire?	Psiché, que venez-vous de dire?
PSICHE'.	PSICHÉE.
Que c'eſt le bonheur où j’aſpire;	Que c'est le bonheur où j'aspire;
Et ſi vous ne me l’accordez.	Et si vous ne me l'accordez.
L’AMOUR.	L'AMOUR.
Je l’ay juré, je n’en ſuis plus le maiſtre, Mais vous ne ſçavez pas ce que vous demandez.	Je l'ai juré, je n'en suis plus le maître, Mais vous ne savez pas ce que vous demandez.
Laiſſez-moy mon ſecret;	Laissez-moi mon secret;
ſi je me fais connoiſtre, ye vous perds, & vous me perdez.	si je me fais connaître, ie vous perds, et vous me perdez.
Le ſeul remede eſt de vous en dédire.	Le seul remède est de vous en dédire.
PorenL.	PorenL.
C’eſt là ſur vous mon ſouverain empire?	C'est là sur vous mon souverain empire?
L'AMOUR.	L'AMOUR.
Vous pouvez tout, & je ſuis tout à vous;	Vous pouvez tout, et je suis tout à vous;
Mais ſi nos feux vous ſemblent doux, Ne mettez point d’obſtacle à leur charmante ſuite, Nve me lolece pomca mrulte.	Mais si nos feux vous semblent doux, Ne mettez point d'obstacle à leur charmante suite, Nè me ce pomca Nrulte.
C’eſt le moindre malheur qui nous puiſſe arriver D’un ſouhait qui vous a ſéduite.	C'est le moindre malheur qui nous puisse arriver D'un souhait qui vous a séduite.
PSICHE'.	PSICHÉE.
Seigneur, vous voulez m'éprouver, Mais jeſçay ce que j’en doy croire.	Seigneur, vou lez m'éprouver, Mais jesçai ce que j'en dois croire.
De grace, apprenez-moy tout l’excés de ma gloire, Et ne me cachez plus pour querihurtie choix J’ay rejetté les vœux de tant de Rois,	De grâce, apprenez-moi tout l'excès de ma gloire, Et ne me cachez plus pour quérihurtie choix J'ai rejetté les vœux de tant de Rois,
Le voulez-vous?	Le voulez-vous?
LAMOOR.	LAMOR.
PSICHE'.	PSICHÉE.
Souffrez que je vous en conjure.	Souffrez que je vous en conjure.
du luro n Si vous ſçaviez, Pſiché, la cruelle avanture Que par la vous vous atthct.	du luro n Si vous saviez, Psiché, la cruelle aventure Que par la vous vous atthct.
PSICHE'.	PSICHÉE.
Seigneur, vous me deſeſperez.	Seigneur, vous me désespérez.
L’AMOUR.	L'AMOUR.
Penſez-y bien, je puis encor me taire.	Pensez-y bien, je puis encor me taire.
PSICHE’.	PSICHÉE.
Faites-vous des ſermens pour n’y point ſatisfaite?	Faites-vous des serments pour n'y point satisfaite?
L’AMOUR.	L'AMOUR.
Hé bien, je ſuis le Dieu le plus puiſſant des Dieux, Abſolu ſur la Terre, abſolu dans les Cieux, Dans les eaux, dans les airs mon pouvoir eſt ſupréme, En un mot je ſuis l’Amour meſme, Qui de mes propres traits m’eſtois bleſſé pour vous;	Hé bien, je suis le Dieu le plus puissant des Dieux, Absolu sur la Terre, absolu dans les Cieux, Dans les eaux, dans les airs mon pouvoir est suprême, En un mot je suis l'Amour même, Qui de mes propres traits m'étais blessé pour vous;
Et ſans la violence, helas!	Et sans la violence, hélas!
que vous me faites, Et qui vient de changer mon amour en couroux, Vous m’alliez avoir pour Epoux.	que vous me faites, Et qui vient de changer mon amour en courroux, Vous m'alliez avoir pour Époux.
Vos volontez ſont ſatisfaites, Vous avez ſçeu qui vous aimiez, Vous connoiſſez l’Amant que vous charmiez, Pſiché, voyez où vous en eſtes.	Vos volontés sont satisfaites, Vous avez su qui vous aimiez, Vous connaissez l'Amant que vous charmiez, Psiché, voyez où vous en êtes.
Vous me forcez vous-meſme à vous quitter, Vous me forcez vous-meſme à vous oſter Tout l’effet de voſtre victoire:	Vous me forcez vous-même à vous quitter, Vous me forcez vous-même à vous ôter Tout l'effet de votre victoire:
Peut-eſtre vos beaux yeux ne me reverront plus, Ce Palais, ces Jardins avec moy diſparus Vont faire évanoüir voſtre naiſſante gloire;	Peut-être vos beaux yeux ne me reverront plus, Ce Palais, ces Jardins avec moi disparus Vont faire évanouir votre naissante gloire;
Vous n’avez pas voulu m’en croire, Et pour tout fruit de ce doute éclaircy, Le Deſtin ſous qui le Ciel tremble, Plus fort que mon amour, que tous les Dieux ensẽble, Vous va montrer ſa haine, & me chaſſe d’icy.	Vous n'avez pas voulu m'en croire, Et pour tout fruit de ce doute éclairci, Le Destin sous qui le Ciel tremble, Plus fort que mon amour, que tous les Dieux ensemble, Vous va montrer sa haine, et me chasse d'ici.
L'Amour diſparoiſt, & dans l'inſtant qu’il s’envole, le ſuperbe Iardin s’évanoüit.	L'Amour disparaît, et dans l'instant qu'il s'envole, le superbe Jardin s'évanoüit.
Pſiché demeure ſeule au milieu d’une vaſte Campagne, & ſur le bord ſauvage d’un grand Fleuve où elle ſe veut précipiter.	Psiché demeure seule au milieu d'une vaste Campagne, et sur le bord sauvage d'un grand Fleuve où elle se veut précipiter.
Le Dieu du Fleuve paroiſt aßis ſur un amas de Ioncs & de Roſeaux, & appuyé ſur une grande Vrne, d’où ſort une groſſe ſource d’eau.	Le Dieu du Fleuve paraît aussi sur un amas de Ioncs et de Roseaux, et appuyé sur une grande Vrne, d'où sort une grosse source d'eau.
DOLIMMV	DOLIMU
PSICHE'.	PSICHÉE.
Ruel Deſtin!	Ruel Destin!
funeſte inquiétude!	funeste inquiétude!
C Fatale curioſité!	Ç Fatale curiosité!
Qu’avez-vous fait, affreuſe Solitude, De toute ma felicité?	Qu'avez-vous fait, affreuse Solitude, De toute ma félicité?
J’aimois un Dieu, j’en eſtois adorée, Mon bonheur redoubloit de moment en moment, Et je me voy ſeule, éplorée, Au milieu d’un Deſert, où pour accablement, Et confuſe, & deſeſperée, Je ſens croiſtre l’amour, quand j’ay perdu l’Amant.	J'aimais un Dieu, j'en étais adorée, Mon bonheur redoublait de moment en moment, Et je me vois seule, éplorée, Au milieu d'un Désert, où pour accablement, Et confuse, et désespérée, Je sens croître l'amour, quand j'ai perdu l'Amant.
Le ſouvenir m’en charme & m’empoiſonne, Sa douceur tyranniſe un cœur infortuné Qu’aux plus cuiſans chagrins ma flame a condamné.	Le souvenir m'en charme et m'empoisonne, Sa douceur tyrannise un cœur infortuné Qu'aux plus cuisants chagrins ma flamme a condamné.
O Ciel!	Ô Ciel!
quand l’Amour m’abandonne, Pourquoy melaiſſe-t-il l’amour qu’il m’a donné?	quand l'Amour m'abandonne, Pourquoi melaisse-t-il l'amour qu'il m'a donné?
Source de tous les biens inépuiſable & pure, Maiſtre des Hommes & des Dieux, Cher Autheur des maux que j’endure, Eſtes-vous pour jamais diſparu de mes yeux?	Source de tous les biens inépuisable et pure, Maître des Hommes et des Dieux, Cher Auteur des maux que j'endure, Estes-vous pour jamais disparu de mes yeux?
Je vous en ay banny moy-meſme;	Je vous en ai banni moi-même;
Dans un excés d’amour, dans un bonheur extréme, D’un indigne ſoupçon mon cœur s’eſt alarmé;	Dans un excès d'amour, dans un bonheur extrême, D'un indigne soupçon mon cœur s'est alarmé;
Cœur ingrat, tu n’avois qu’un feu mal allumé, Et l’on ne peut vouloir du moment que l’on aime, Que ce que veut l’Objet aimé.	Cœur ingrat, tu n'avais qu'un feu mal allumai, Et l'on ne peut vouloir du moment que l'on aime, Que ce que veut l'Objet aimé.
Mourons, c’eſt le party qui ſeul me reſte à ſuivre, Apres la perte que je fais.	Mourons, c'est le parti qui seul me reste à suivre, Après la perte que je fais.
Pour qui, grands Dieux, voudrois-je vivre, Et pour qui former des ſouhaits?	Pour qui, grands Dieux, voudrais-je vivre, Et pour qui former des souhaits?
Jleuve, de qui les eaux baignent ces triſtes ſables, Enſevely mon crime dans tes flots, Espoml Millrdeo Maaauu artiaciea, Laiſſe-moy dans ton lit aſſurer mon repos.	Ileuve, de qui les eaux baignent ces tristes sables, Ensevely mon crime dans tes flots, EspomleuVeilla Maaauu artiaciea, Laisse-moi dans ton lit assurer mon repos.
LE DIEU DU FLEUVE.	LE DIE DU FLEUVE.
Ton trépas ſoüilleroit mes ondes, Pſiché, le Ciel te le défend, Et peut-eſtre qu’apres des douleurs ſi profondes Un autre ſort t’attend.	Ton trépas soüilleroit mes ondes, Psiché, le Ciel te le défend, Et peut-être qu'après des douleurs si profondes Un autre sort t'attend.
Fuy plutoſt de Vénus l’implacable colere:	Fui plutôt de Vénus l'implacable colère:
quia vay quitcenciene a qura teut pains, L’amour du Fils a fait la haine de la Mere, Fuy, je ſçauray la retenir.	quia vais quitcenciene a qura tut pains, L'amour du Fils a fait la haine de la Mère, Fui, je saurai la retenir.
PSICHE’.	PSICHÉE.
J’attens ſes Fureurs vangereſſes.	J'attends ses Fureurs vengeresses.
Qu’auront-elles pour moy qui ne me ſoit trop doux?	Qu'auront-elles pour moi qui ne me soit trop doux?
Qui cherche le trépas, ne craint Dieux, ny Déeſſes, Et peut braver tout leur couroux.	Qui cherche le trépas, ne craint Dieux, ni Déesses, Et peut braver tout leur courroux.
SCENE V.	SCÈNE V.
VENUS, PSICHE'.	VENUS, PSICHÉE'.
VENUS.	VENUS.
Rgueilleuſe Pſiché.	Rgueilleuse Psiché.
vous m’oſez donc attendre, O Apres m’avoir ſur Terre enlevé mes honneurs, Apres que vos traits ſuborneurs ent reçeu les encẽs qu’aux miens ſeuls on doit rendre?	vous m'osez donc attendre, Ô Près m'avoir sur Terre enlevé mes honneurs, Apres que vos traits suborneurs ent reçeu les encs qu'aux miens seuls on doit rendre?
J'ay veu mes Temples deſertez, J’ay veu tous les Mortels ſéduits par vos beautez Idolâtrer en vous la beauté ſouveraine, Vous offrir des reſpects juſqu’alors inconnus, Et ne ſe mettre pas en peine S’il eſtoit une autre Vénus:	J'ai vu mes Temples désertez, PAS en peine tous les Mortels séduits par vos beautés Idolâtrer en vous la beauté souveraine, Vous offrir des respects jusqu'alors inconnus, Et ne se mettre pas en peine S'il était une autre Vénus:
Et je vous vois encor l’audace De n’en pas redouter les juſtes chaſtimens, Et de me regarder en face, Comme ſi c’eſtoit peu que mes reſſentimens.	Et je vous vois encor l'audace De n'en pas redouter les justes châtiments, Et de me regarder en face, Comme si c'était peu que mes ressentiments.
PSICHE’.	PSICHÉE.
Si de quelques Mortels on m’a veuë adorée, Eſt-ce un crime pour moy d’avoir eu des appas, Dont leur ame inconſiderée Laiſſoit charmer des yeux qui ne vous voyoient pas?	Si de quelques Mortels on m'a vue adorée, Est-ce un crime pour moi d'avoir eu des appas, Dont leur âme inconsidérée Laissait charmer des yeux qui ne vous voyaient pas?
Je ſuis ce que le Ciel m’a faite, Je n’ay que les beautez qu’il m’a voulu preſter:	Je suis ce que le Ciel m'a faite, Je n'ai que les beautés qu'il m'a voulu prêter:
Si les vœux qu’on m'offroit vous ont mul ſatisfaite, Pour forcer tous les cœurs à vous les reporter, vous naviel quavous prelenter, Qu’à ne leur cacher plus cette beauté parfaite, Qui pour les rendre à leur devoir, Pour ſe faire adorer, n’a qu’à ſe faire voir.	Si les vœux qu'on m'offrait vous ont mul satisfaite, Pour forcer tous les cœurs à vous les reporter, vous naviel quavou prelenter, Qu'à ne leur cacher plus cette beauté parfaite, Qui pour les rendre à leur devoir, Pour se faire adorer, n'a qu'à se faire voir.
VENUS.	VENUS.
Il falloit vous en mieux défendre, Ces reſpects, ces encens ſe devoient refuſer, Et pour les mieux deſabuſer, Il falloit à leurs yeux vous-meſme me les rendre:	Il fallait vous en mieux défendre, Ces respects, ces encens se devaient refuser, Et pour les mieux désabuser, Il fallait à leurs yeux vous-même me les rendre:
Vous avez aimé cette erreur Pour qui vous ne deviez avoir que de l’horreut;	Vous avez aimé cette erreur Pour qui vous ne deviez avoir que de l'horreut;
Vous avez bien fait plus, voſtre humeur arrogante Sur le mépris de mille Rois Juſques aux Cieux a porté de ſon choix L’ambition extravagante.	Vous avez bien fait plus, votre humeur arrogante Sur le mépris de mille Rois Jusques aux Cieux a porté de son choix L'ambition extravagante.
PSICHE'.	PSICHÉE.
J’aurois porté mon choix, Déeſſe, juſqu’aux Cieux?	J'aurais porté mon choix, Déesse, jusqu'aux Cieux?
VENUS.	VENUS.
Voſtre innocence eſt ſans ſeconde;	Votre innocence est sans seconde;
meuuig mer tous leu rebis du Mronde;	meug mer tous le rebis du Mronde;
N’eſt-ce pas aſpirer aux Dieux?	N'est-ce pas aspirer aux Dieux?
PSICHE'.	PSICHÉE.
Si l’amour pour eux tous m’avoit endurcy l’ame, Et me reſervoit toute à luy, En puis-je eſtre coupable, & faut-il qu’aujourd’huy Pour prix d’une ſi belle flame, Vous vouliez m’accabler d’un éternel ennuy?	Si l'amour pour eux tous m'avait endurci l'âme, Et me réservait toute à lui, En puis-je être coupable, et faut-il qu'aujourd'hui Pour prix d'une si belle flamme, Vous vouliez m'accabler d'un éternel ennui?
YENOO.	YENO.
Pſiché, vous deviez mieux connoiſtre Qui vous eſtiez, & quel eſtoit ce Dieu.	Psiché, vous deviez mieux connaître Qui vous étiez, et quel était ce Dieu.
PSICHE.	PSYCHÉ.
Et m’en a-t-il donné ny le temps, ny le lieu, Luy qui de tout mõ courduoorus dieiendu maiſtre?	Et m'en a-t-il donné ainsi le temps, ni le lieu, Lui qui de tout mon courduoorus dieiendu maître?
VENUS.	VENUS.
Tout voſtre cœur s’en eſt laiſſé charmer, Et vous l’avez aimé dés qu’il vous a dit, j’aime.	Tout votre cœur s'en est laissé charmer, Et vous l'avez aimé dès qu'il vous a dit, j'aime.
PSICHE’.	PSICHÉE.
Pouvois-je n’aimer pas le Dieu qui fait aimer, Et qui me parloit pour luy-meſme?	Pouvais-je n'aimer pas le Dieu qui fait aimer, Et qui me parlait pour moi-même?
C’eſt voſtre Fils, vous ſçavez ſon pouvoir, Vous en connoiſſez le mérite.	C'est votre Fils, vous savez son pouvoir, Vous en connaissez le mérite.
VENUS.	VENUS.
Oüy, c’eſt mon Fils, mais un Fils qui m’irrite, Un Fils qui me rend mal ce qu’il ſçait me devoir, Un Fils qui fait qu’on m’abandonne, Et qui pour mieux flater ſes indignes amours, Depuis que vous l’aimez, ne bleſſe pus perſonne Qui vienne à mes Autels implorer mon ſecours.	Oui, c'est mon Fils, mais un Fils qui m'irrite, Un Fils qui me rend mal ce qu'il avait me devoir, Un Fils qui fait qu'on m'abandonne, Et qui pour mieux flatter ses indignes amours, Depuis que vous l'aimez, ne blesse pus personne Qui vienne à mes Autels implorer mon secours.
Vous m’en avez fait un rebelle, On m’en verra vangée, & hautement, ſur vous, Et je vous apprendray s’il faut qu’une Mortelle Souffre qu’un Dieu ſoûpire à ſes genoux.	Vous m'en avez fait un rebelle, On m'en verra vengée, et hautement, sur vous, Et je vous apprendrai s'il faut qu'une Mortelle Souffre qu'un Dieu soupire à ses genoux.
Suivez-moy, vous verrez par voſtre expérience A quelle folle confiance Vous portoit cette ambition;	Suivez-moi, vous verrez par votre expérience À quelle folle confiance Vous portait cette ambition;
Venez, & préparez autant de patience, Qu'on vous voit de préſomption.	Venez, et préparez autant de patience, Qu'on vous voit de présomption.
QUATRIESME INTERMEDE.	QUATRIÈME INTERMÈDE.
A Scene repreſente les Enfers.	À Scène représente les Enfers.
On y voit une Mer L toute de feu, dont les flots ſont dans une perpetuelle agitation.	On y voit une Mer L toute de feu, dont les flots sont dans une perpétuelle agitation.
Cette Mer effroyable eſt bornée par des Ruines enflâmées;	Cette Mer effroyable est bornée par des Ruines enflammées;
& au milieu de ſes flots agitez.	et au milieu de ses flots agités.
au travers d’une Gueulle affreuſe, paroiſt le Palais Inſernal de pluton.	au travers d'une Gueulle affreuse, paraît le Palais Insernal de pluton.
Huit Furies en ſortent, & forment une Entrée de Ballet, où elles ſe réjoüiſſent de la rage qu’elles ont ællumée dans l’ame de la plus douce des Divinitez.	Huit Furies en sortent, et forment une Entrée de Ballet, où elles se réjouissent de la rage qu'elles ont ællumée dans l'âme de la plus douce des Divinités.
Vn Lutin meſle quantité de ſauts périlleux à leurs Dances, cependaat que Pſiché qui a paßé aux Enfers par le commandement de Vénus, repaſſe dans la Barque ut Charon, avec la Boëte qu’elle a reçeuë de Proſerpine pour cette Déeſſe.	Un Lutin mêle quantité de sauts périlleux à leurs Dances, cependaat que Psiché qui a passé aux Enfers par le commandement de Vénus, repasse dans la Barque ut Charon, avec la Boète qu'elle a reçue de Proserpine pour cette Déesse.
ACTE V SCENE LREMIERE.	ACTE V CÈNE LREMIERE.
PSICHE'.	PSICHÉE.
FFROYABLES replis des ondes infernales, Noirs Palais où Megére & ſes Sœurs font leur Cour, Eternels ennemis du Jour, Parmy vos Ixions, & parmy vos Tantales, Parmy tant de tourmens qui n’ont point d’intervales, Eſt-il dans voſtre affreux ſejour Quelques peines qui ſoient égales Aux travaux où Vénus condamne mon amour?	FROYABLES replis des ondes infernales, Noirs Palais où Megére et ses Sœurs font leur Cour, Éternels ennemis du Jour, Parmi vos Ixions, et parmi vos Tantales, Parmi tant de tourments qui n'ont point d'intervales, Est-il dans votre affreux séjour Quelques peines qui soient égales Aux travaux où Vénus condamne mon amour?
Elle n’en peut eſtre aſſouvie;	Elle n'en peut être assouvie;
Et depuis qu’à ſes loix je me trouve aſſervie, Depuis qu’elle me livre à ſes reſſentimens, Il m’a fallu dans ces cruels momens Plus d’une ame, & plus d’une vie, Pour remplir ſes commandemens.	Et depuis qu'à ses lois je me trouve asservie, Depuis qu'elle me livre à ses ressentiments, Il m'a fallu dans ces cruels momens Plus d'une âme, et plus d'une vie, Pour remplir ses commandements.
Je ſouffrirois tout avec joye, Siparmy les rigueurs que ſa haine déploye,	Je souffrirais tout avec joie, Siparmi les rigueurs que sa haine déploie,
Mes yeux pouvoiẽt revoir, ne fuſt-ce qu’un moment, Ce cher, cet adorable Amant:	Mes yeux pouvaient revoir, ne fût-ce qu'un moment, Ce cher, cet adorable Amant:
Je n’oſe le nommer;	Je n'ose le nommer;
ma bouche criminelle D’avoir trop exigé de luy, S’en eſt renduë indigne, & dans ce dur ennuy La ſouffrance la plus mortelle Dont m’accable à toute heure un renaiſſant trépas, Eſt celle de ne le voir pas.	ma bouche criminelle D'avoir trop exigé de lui, S'en est rendue indigne, et dans ce dur ennui La souffrance la plus mortelle Dont m'accable à toute heure un renaissant trépas, Est celle de ne le voir pas.
Si ſon couroux duroit encore, Jamais aucun malheur n’aprocheroit du mien:	Si son courroux durait encore, Jamais aucun malheur n'approcherait du mien:
Mais s’il avoit pitié d’une ame qui l’adore, Quoy qu’il falluſt ſouffrir, je ne ſouffrirois rien.	Mais s'il avait pitié d'une âme qui l'adore, Quoi qu'il fallût souffrir, je ne souffrirais rien.
Oüy, Deſtins, s’il calmoit cette juſte colere, Tous mes malheurs ſeroient finis:	Oui, Destins, s'il calmait cette juste colère, Tous mes malheurs seraient finis:
Pour me rendre inſenſible aux fureurs de la Mere, Il ne faut qu’un regard d’un Fils.	Pour me rendre insensible aux fureurs de la Mère, Il ne faut qu'un regard d'un Fils.
Je n’en veux plus douter, il partage ma peine, Il voit ce que je ſouffre, & ſouffre comme moy, Tout ce que j’endure le geſne, Luy-meſme il s’en impoſe une amoureuſe loy:	Je n'en veux plus douter, il partage ma peine, Il voit ce que je souffre, et souffre comme moi, Tout ce que j'endure le gêne, Lui-même il s'en impose une amoureuse loi:
En dépit de Vénus, en dépit de mon crime, 1 C’eſt luy qui me ſoûtient, c’eſt luy qui me ranime, Au milieu des périls où l’on me fait courir:	En dépit de Vénus, en dépit de mon crime, 1 C'est rien qui me soutient, c'est venir qui me ranime, Au milieu des périls où l'on me fait courir:
Il garde la tendreſſe où ſon feu le convie, Et prend ſoin de me rendre une nouvelle vie, Chaque fois qu’il me faut mourir.	Il garde la tendresse où son feu le convie, Et prend soin de me rendre une nouvelle vie, Chaque fois qu'il me faut mourir.
Mais que me veulent ces deux Ombres Qu’à travers le faux jour de ces Demeures ſombres J’entrevoy s’avancer vers moy?	Mais que me veulent ces deux Ombres Qu'à travers le faux jour de ces Demeures sombres J'entrevoi s'avancer vers moi?
2	2
SCENE II.	SCÈNE II.
PSICHE, CLLOMENE, AGENOR.	PSYCHE, CLLOMENE, AGENOR.
PSICHE'.	PSICHÉE.
Leomene, Agenor, eſt-ce vous que je voy?	Lomène, Agénor, est-ce vous que je vois?
C Qui vous a ravy la lumiere?	Ç Qui vous a ravi la lumière?
CLEOMENNE.	CLÉOMENE.
La plus juſte douleur, qui d’un beau deſeſpoir Nous euſt pû fournir la matiere, Cette pompe funebre, ou du ſort le plus noir Vous attendiez la rigueur la plus fiere, L’injuſtice la plus entiere.	La plus juste douleur, qui d'un beau désespoir Nous eût pu fournir la matière, Cette pompe funèbre, ou du sort le plus noir Vous attendiez la rigueur la plus fière, L'injustice la plus entière.
AGENOR.	AGENOR.
Sur ce meſme Rocher, où le Ciel en couroux Vous promettoit au lieu d’Epoux Un Serpent dont ſoudain vous ſeriez devorée, Nous tenions la main preparée A repouſſer ſa rage, ou mourir avec vous.	Sur ce même Rocher, où le Ciel en courroux Vous promettait au lieu d'Époux Un Serpent dont soudain vous seriez dévorée, Nous tenions la main préparée A repousser sa rage, ou mourir avec vous.
Vous le ſçavez, Princeſſe, & lors qu’à noſtre veuë Par le milieu des airs vous eſtes diſparuë, Du naue de ce Roener pour funvre voynedutez, Ou plutoſt pour gouſter cette amoureuſe joye D’offrir pour vous au Monſtre une premiere proye, D’amour & de douleur l’un & l’autre emportez, Nous nous ſommes précipitez.	Vous le savez, Princesse, et lors qu'à notre vue Par le milieu des airs vous êtes disparue, Du nave de ce Roener pour funvre voisnedutez, Ou plutôt pour goûter cette amoureuse joie D'offrir pour vous au Monstre une première proie, D'amour et de douleur l'un et l'autre emportez, Nous nous sommes précipitez.
CLEOMENE.	CLÉOMENE.
Heureuſement déçeus au ſens de voſtre Oracle, Nous en avons icy reconnu le miracle, Et ſçeu que le Serpent preſt à vous devorer Eſtoit le Dieu qui fait qu’on aime, Et qui tout Dieu qu’il eſt, vous adorant luy-meſme, Ne pouvoit endurer Quun Morter comme nous olait vous adorer.	Heureusement déçus au sens de votre Oracle, Nous en avons ici reconnu le miracle, Et su que le Serpent prêt à vous dévorer Était le Dieu qui fait qu'on aime, Et qui tout Dieu qu'il est, vous adorant lui-même, Ne pouvait endurer Quun Morter comme nous olait vous adorer.
AGENOR.	AGENOR.
Pour prix de vous a voir ſuivie, Nous joüiſſons icy d’un trépas aſſez doux:	Pour prix de vous a voir suivie, Nous jouissons ici d'un trépas assez doux:
Qu’avions-nous affaire de vie, Si nous ne pouvions eſtre à vous?	Qu'avions-nous affaire de vie, Si nous ne pouvions être à vous?
Nous revoyons icy vos charmes, Qaueuideo deun la mauoiauroit re veus jamais, Heureux ſi nous voyons la moindre de vos larmes Honorer des malheurs que vous nous avez faits.	Nous revoyons ici vos charmes, Qaveuideo deun la mavoiaurait re çus jamais, Heureux si nous voyons la moindre de vos larmes Honorer des malheurs que vous nous avez faits.
PSICHE'.	PSICHÉE.
Puis-je avoir des larmes de reſte Apres qu’on a porté les miens au dernier point?	Puis-je avoir des larmes de reste Après qu'on a porté les miens au dernier point?
Uniſſons nos ſoûpirs dans un ſort ſi funeſte, Les ſoûpirs ne s’épuiſent point.	Unissons nos soupirs dans un sort si funeste, Les soupirs ne s'épuisent point.
Mais vous ioupireriez, Prinées, pour dhe Ingrate, Vous n’avez point voulu ſurvivre à mes malheurs, Et quelque douleur qui m’abate, Ce n’eſt point pour vous que je meurs.	Mais vous joupireriez, Prinées, pour dhe Ingrate, Vous n'avez point voulu survivre à mes malheurs, Et quelque douleur qui m'abate, Ce n'est point pour vous que je meurs.
CLEOMENE.	CLÉOMENE.
L’avons nous merité, nous dont toute la flâme N’a fait que vous laſſer du recit de nos maux?	L'avons nous mérité, nous dont toute la flamme N'a fait que vous lasser du récit de nos maux?
PSICHE'.	PSICHÉE.
Vous pouviez meriter, Princes, toute mon ame, Si vous n'euſſiez eſté Rivaux.	Vous pouviez mériter, Princes, toute mon âme, Si vous n'eussiez été Rivaux.
Ces qualitez incomparables Qui de l'un & de l’autre accompagnoient les vœux, 4 Vous rendoient tous deux trop aimables, Pour mépriſer auc un des deux.	Ces qualités incomparables Qui de l'un et de l'autre accompagnaient les vœux, 4 Vous rendaient tous deux trop aimables, Pour mépriser auc un des deux.
AGENOR.	AGENOR.
Vous avez pû ſans eſtre injuſte, ny cruelle, Nous reſufer un cœur reſervé pour un Dieu.	Vous avez pu sans être injuste, Seigneur cruelle, Nous rêver un cœur réservé pour un Dieu.
muit levoyez Vénus:	muit levoyez Vénus:
Le Deſtin nous rapelle;	Le Destin nous rappelle;
Et nous force à vous dire Adieu.	Et nous force à vous dire Adieu.
CIDIPPE.	CIDIPE.
Ne vous dome-t-i point ie iom deme dhle Quel eſt icy voſtre ſéjour?	Ne vous dôme-t-y point ici jom dème dhle Quel est ici votre séjour?
CLEOMENE.	CLÉOMENE.
Dans des Bois toûjours verds, où d’amour on reſpire, Auſſi-toſt qu’on eſt mort d’amour.	Dans des Bois toujours verds, où d'amour on respire, Aussitôt qu'on est mort d'amour.
D’amour on y revit, d’amour on y ſoûpire, Sous les plus douces loix de ſon heureux Empire, Et l’éternelle nuit n’oſe en chaſſer le jour, Que luy-meſme il attire Sur nos fantoſmes qu’il inſpire, Et dont aux Enfers meſme il ſe fait une Cour.	D'amour on y revit, d'amour on y soupire, Sous les plus douces lois de son heureux Empire, Et l'éternelle nuit n'ose en chasser le jour, Que lui-même il attire Sur nos fantômes qu'il inspire, Et dont aux Enfers même il se fait une Cour.
AGENOR.	AGENOR.
Vos envieuſes Sœurs apres nous deſcenduës, Pour vous perdre ſe ſont perduës, Et l’une & l’autre tour à tour, Pourdle prix d’un conſeil qui leur couſte la vie, A coſté d’Ixion, à coſté de Titye, Souffre tantoſt la rouë, & tantoſt le Vautour.	Vos envieuses Sœurs après nous descendues, Pour vous perdre se sont perdues, Et l'une et l'autre tour à tour, Pourdle prix d'un conseil qui leur coûte la vie, A côté d'Ixion, à côté de Titye, Souffre tantôt la roue, et tantôt le Vautour.
L’Amour par les Zephirs s’eſt fait prompte juſtice De leur envenimée & jalouſe malice:	L'Amour par les Zéphirs s'est fait prompte justice De leur envenimée et jalouse malice:
Ces Miniſtres aiſlez de ſon juſte couroux, Sous couleur de les rendre encor aupres de vous, Ont plongé l’une & l’autre au fond d’un précipice, Où le ſpectacle affreux de leurs corps déchirez, N’étale que le moindre, & le premier ſuplice De ces conſeils dont l’artifice Fait les maux dont vous ſoûpirez.	Ces Ministres aislez de son juste courroux, Sous couleur de les rendre encor auprès de vous, Ont plongé l'une et l'autre au fond d'un précipice, Où le spectacle affreux de leurs corps déchirez, N'étale que le moindre, et le premier suplice De ces conseils dont l'artifice Fait les maux dont vous soupirez.
i.	y.
Que je les plains.	Que je les plains.
PSICHE’.	PSICHÉE.
CLEOMENE.	CLÉOMENE.
Vous eſtes ſeule à plaindre.	Vous êtes seule à plaindre.
Mais nous demeurons trop à vous entretenir, Adieu, puiſſions nous vivre en voſtre ſouvenir, Puiſſiez-vous, & bientoſt, n’avoir plus rien à craindre.	Mais nous demeurons trop à vous entretenir, Adieu, puissions nous vivre en votre souvenir, Puissiez-vous, et bientôt, n'avoir plus rien à craindre.
Puiſſe, & bientoſt, l’Amour vous enlever aux Cieux, Vous y mettre à coſté des Dieux, Et rallumant un feu qui ne ſe puiſſe éteindre, Affranchir a jamais Peciat de vos beaux yeda, D’augmenter le jour en ces lieux.	Puisse, et bientôt, l'Amour vous enlever aux Cieux, Vous y mettre à côté des Dieux, Et rallumant un feu qui ne se puisse éteindre, Affranchir a jamais Peciat de vos beaux yéda, D'augmenter le jour en ces lieux.
SCENE III.	SCÈNE III.
PSICHE'.	PSICHÉE.
Auvres Amans!	Auvres Amants!
leur amour dure encore, I Tous morts qu’ils ſont l’un & l’autre m’adore, Moy dont la dureté reçeut ſi malleurs vœux:	leur amour dure encore, I Tous morts qu'ils sont l'un et l'autre m'adore, Moi dont la dureté reçut si malleurs vœux:
Tu n’en fais pas ainſi, toy qui ſeul m’as ravie, Amant, que j’aime encor cent fois plus que ma vie, Et qui briſes de ſi beaux nœuds.	Tu n'en fais pas ainsi, toi qui seul m'as ravie, Amant, que j'aime encor cent fois plus que ma vie, Et qui brises de si beaux nœuds.
Ne me fuy plus, & ſouffre que j’eſpere Que tu pourras un jour rabaiſſer l’œil ſur moy, Qu’à force de ſouffrir j’auray dequoy te plaire, Dequoy me rengager ta foy.	Ne me fuis plus, et souffre que j'espère Que tu pourras un jour rabaisser l'œil sur moi, Qu'à force de souffrir j'aurai dequoy te plaire, Dequoy me rengager ta foi.
Mais ce que j’ay ſouffert m’a trop défigurée, Pour rapeller un tel eſpoir, L’œil abbatu, triſte, deſeſperée, Languiſſante & décolorée, Dequoy puis-je me prévaloir, El par quelque miracle impoſſible à prévoit Ma beauté qui t'a plû ne ſe voit reparée?	Mais ce que j'ai souffert m'a trop défigurée, Pour rapeller un tel espoir, L'œil abattu, triste, désespérée, Languissante et décolorée, Dequoi puis-je me prévaloir, El par quelque miracle impossible à prévoit Ma beauté qui t'a plu ne se voit réparée?
Je porre icy dequoy la reparer, Ce treſor de beauté divine, Qu’en mes mains pour Vénus a remis Proſerpine, Enferme des appas dont je puis m’emparer, Et l’éclat en doit eſtre extréme, Puis que Vénus la Beauté meſme Les demande pour ſe parer.	Je porre ici dequoy la réparer, Ce trésor de beauté divine, Qu'en mes mains pour Venus a remis Proserpine, Enferme des appas dont je puis m'emparer, Et l'éclat en doit être extrême, Puis que Vénus la Beauté même Les demande pour se parer.
En dérober un peu ſeroit-ce un ſi grand crime?	En dérober un peu serait-ce un si grand crime?
Pour plaire aux yeux d’un Dieu qui s’eſt fait mõAmãt, Pour regagner ſon cœur, & finir mon tourment, Tout n’eſt-il pas trop legitime?	Pour plaire aux yeux d'un Dieu qui s'est fait mõAmãt, Pour regagner son cœur, et finir mon tourment, Tout n'est-il pas trop légitime?
Ouvrons.	Ouvrons.
Quelles vapeurs m’offuſquent le cerveau, Et que vois-je ſortir de cette Boëte ouverte?	Quelles vapeurs m'offusquent le cerveau, Et que vois-je sortir de cette Boète ouverte?
Amour, ſi ta pitié ne s’oppoſe à ma perte, Pour ne revivre plus, je deſcens au tombeau.	Amour, si ta pitié ne s'oppose à ma perte, Pour ne revivre plus, je descends au tombeau.
Elle s’évanoüit, & l’Amour deſcend anpres ucut en ovinf.	Elle s'évanoüit, et l'Amour descend anpres ucut en ovins.
SCENE IV.	SCÈNE IV.
L’AMOUR, PSICHE' évanoüie.	L'AMOUR, PSYCHE évanouie.
L’AMOUR.	L'AMOUR.
jOſtre péril, Pſiché, diſſipe ma colere, V Ou plutoſt de mes feux l’ardeur n’a point ceſſé, Et bien qu’au dernier point vous m’ayez ſçeu déplaire, Je ne me ſuis intereſſé Que contre celle de ma Mere.	jOstre péril, Psiché, dissipe ma colère, V Ou plutôt de mes feux l'ardeur n'a point cessé, Et bien qu'au dernier point vous m'ayez su déplaire, Je ne me suis intéressé Que contre celle de ma Mère.
J'ay veu tous vos travaux, j’ay ſuivy vos malheurs, Mes ſoûpirs ont par tout accompagné vos pleurs;	J'ai vu tous vos travaux, j'ai suivi vos malheurs, Mes soupirs ont par tout accompagné vos pleurs;
Tournez les yeux vers moy, je ſuis encor le meſme.	Tournez les yeux vers moi, je suis encor le même.
G iij.	G jij.
Quoy!	Quoi!
je dis & redis tout haut que je vous aime, Et vous ne dites point, Pſiché, que vous m’aimez!	je dis et redis tout haut que je vous aime, Et vous ne dites point, Psiché, que vous m'aimez!
Eſt-ce que pour jamais vos beaux yeux ſont fermez?	Est-ce que pour jamais vos beaux yeux sont fermés?
Qu’à jamais la clarté leur vient d’eſtre ravie?	Qu'à jamais la clarté leur vient d'être ravie?
O mort, devois-tu prendre un dard ſi criminel, Et ſans aucun reſpect pour mon Eſtre éternel Attenter à ma propre vie?	Ô mort, devais-tu prendre un dard si criminel, Et sans aucun respect pour mon Être éternel Attenter à ma propre vie?
Combien de fois, ingrate Deïté, Ay-je groſſy ton noir Empire, Par les mépris & par la cruauté D’une orgueilleuſe ou farouche Beauté?	Combien de fois, ingrate Deïté, Ay-je grossi ton noir Empire, Par les mépris et par la cruauté D'une orgueilleuse ou farouche Beauté?
Combien meſme, s’il le faut dire, T’ay-je immolé de fidelles Amans A force de raviſſemens?	Combien même, s'il le faut dire, T'ai-je immolé de fidèles Amants À force de ravissements?
Va, je ne bleſſeray plus d’ames, Je ne perceray plus de cœurs, Qu’avec des dards trempez aux divines liqueurs Qui nourriſſent du Cielles immortelles flâmes, Et n’en lanceray plus que pour faire à tes yeux Autant d’Amans, autant de Dieux.	Va, je ne blesserai plus d'ames, Je ne percerai plus de cœurs, Qu'avec des dards trempez aux divines liqueurs Qui nourrissent du Cielles immortelles flammes, Et n'en lancerai plus que pour faire à tes yeux Autant d'Amands, autant de Dieux.
Et vous, impitoyable Mere, Qui la forcez à m’arracher Tout ce que j’avois de plus cher, Craignez à voſtre tour l’effet de ma colere.	Et vous, impitoyable Mère, Qui la forcez à m'arracher Tout ce que j'avais de plus cher, Craignez à votre tour l'effet de ma colère.
Vous me voulez faire la loy, Vous qu’on voit ſi ſouvent la recevoit de moy!	Vous me voulez faire la loi, Vous qu'on voit si souvent la recevait de moi!
Vous qui portez un cœur ſenſible comme un autre, Vous enviez au mien les delices du voſtre!	Vous qui portez un cœur sensible comme un autre, Vous enviez au mien les délices du vôtre!
Mais dans ce meſme cœur j’enfonceray des coups, Qui ne ſeront ſuivis que de chagrins jaloux;	Mais dans ce même cœur j'enfoncerai des coups, Qui ne seront suivis que de chagrins jaloux;
Je vous accableray de honteuſes ſurpriſes, Et choiſiray par tout à vos vœux les plus doux Des Adonis & des Anchiſes, Qui n’auront que haine pour vous.	Je vous accablerai de honteuses surprises, Et choisirai par tout à vos vœux les plus doux Des Adonis et des Anchises, Qui n'auront que haine pour vous.
SCENE V VENUS, L’AMOUR, PSICHE' évanoüie.	SCÈNE V VENUS, L'AMOUR, PSYCHE évanouie.
ENUS.	ENUS.
LA menace eſt reſpectueuſe, Et d’un Enfant qui fait le revolté La colere préſomptueuſe.	LA menace est respectueuse, Et d'un Enfant qui fait le révolté La colère présomptueuse.
LAMOOR Je ne ſuis plus Enfant, & je l’ay trop eſté, Et ma colere eſt juſte autant qu’impétueuſe.	LAMOR Je ne suis plus Enfant, et je l'ai trop été, Et ma colère est juste autant qu'impétueuse.
YENUS.	YENUS.
L’impétuoſité s’en devroit retenir, Et vous pourriez vous ſouvenir Que vous me devez la naiſſance.	L'impétuosité s'en devrait retenir, Et vous pourriez vous souvenir Que vous me devez la naissance.
L’AMOUR.	L'AMOUR.
Et vous pourriez n’oublier pas Que vous avez un cœur & des appas Qui relevent de ma puiſſance:	Et vous pourriez n'oublier pas Que vous avez un cœur et des appas Qui relèvent de ma puissance:
Que mon Arc de la voſtre eſt l’unique ſoûtien, Que ſans mes traits elle n’eſt rien, Et que ſi les cœurs les plus braves, En triomphe par vous ſe ſont laiſſez traiſner, Vous n’avez jamais fait d’Eſclaves Que ceux qu’il m'a plû d’enchaiſner.	Que mon Arc de la vôtre est l'unique soutien, Que sans mes traits elle n'est rien, Et que si les cœurs les plus braves, En triomphe par vous se sont laissez traîner, Vous n'avez jamais fait d'Esclaves Que ceux qu'il m'a plu d'enchaîner.
Ne me vantez donc plus ces droits de la naiſſanct Qui tyranniſent mes deſirs;	Ne me vantez donc plus ces droits de la naissanct Qui tyrannisent mes désirs;
Et ſi vous ne voulez perdre mille ſoûpirs, songez enme voyant à la reconnoiſſance,	Et si vous ne voulez perdre mille soupirs, songez enme voyant à la reconnaissance,
G iiij Vous qui tenez de ma puifſance	G Gij Vous qui tenez de ma puissance
Et voſſte gloire, & vos plaiſirs.	Et vosste gloire, et vos plaisirs.
TENUS.	TENUS.
Comment l’avez-vous défenduë, Cette gloire dont vous parlez?	Comment l'avez-vous défendue, Cette gloire dont vous parlez?
Comment me l’a vez-vous renduë?	Comment me l'a vez-vous rendue?
Et quand vous avez veu mes Autels deſolez, Mes Temples violez, Mes honneurs ravalez, Si vous avez pris part à tant d’ignominie, Comment en a-t-on veu punie Pſiché qui me les a volez?	Et quand vous avez vu mes Autels désolés, Mes Temples violez, Mes honneurs ravalez, Si vous avez pris part à tant d'ignominie, Comment en a-t-on vu punie Psiché qui me les a volés?
Je vous ay commandé de la rendre charmée Du plus vil de tous les Mortels, Qui ne daignaſt répondre à ſon ame enflâmée Que par des rebuts éternels, Par les mépris les plus cruels, Et vous-meſme l’avez aimée!	Je vous ai commandé de la rendre charmée Du plus vil de tous les Mortels, Qui ne daignât répondre à son âme enflammée Que par des rebuts éternels, Par les mépris les plus cruels, Et vous-même l'avez aimée!
Vous avez contre moy ſéduit des Immortels, C’eſt pour vous qu’à mes yeux les Zephirs l’ont caQu’Apollon meſme ſubornéé Par un Oracle adroitement tourn Me l’avoit ſi bien arrachée, Que ſi ſa curioſité Par une a veugle défiance Ne l’euſt renduë à ma vangeance, Elle échapoit à mon cœur irrité.	Vous avez contre moi séduit des Immortels, C'est pour vous qu'à mes yeux les Zéphirs l'ont caQu'Apollon même suborné Par un Oracle adroitement tourn Me l'avait si bien arrachée, Que si sa curiosité Par une a veugle défiance Ne l'eût rendue à ma venge, Elle échappait à mon cœur irrité.
Voyez l’état où voſtre amour l’a miſe, Voſtre Pſiché, ſon ame va partir, Voyez, & ſi la voſtre en eſt encor épriſe, Recevez ſon dernier ſoûpir, (chée, Menacez, bravez moy, cependant qu'elle expire?	Voyez l'état où votre amour l'a mise, Votre Psiché, son âme va partir, Voyez, et si la vôtre en est encor éprise, Recevez son dernier soupir, (chée, Menacés, bravez -moi, cependant qu'elle expire?
Tant d’inſolence vous ſied bien, Et je dois endurer, quoy qu’il vous plaiſe dire, Moy qui ians vos traits ne puis rreiss	Tant d'insolence vous sied bien, Et je dois endurer, quoi qu'il vous plaise dire, Moi qui jans vos traits ne puis réiss
L’AMOUR.	L'AMOUR.
Vous ne pouvez que trop, Déeſſe impitoyable, Le Deſtin l’abandonne à tout voſtre couroux:	Vous ne pouvez que trop, Déesse impitoyable, Le Destin l'abandonne à tout votre courroux:
Mais ſoyez moins inéxorable Aux prieres, aux pleurs d’un Fils à vos genoux.	Mais soyez moins inéxorable Aux prières, aux pleurs d'un Fils à vos genoux.
Ce doit vous eſtre un ſpectacle aſſez doux De voir d’un œil Pſiché moutante, Et de l’autre ce Fils d’une voix ſupliante Ne vouloir plus tenir ſon bonheur que de vous.	Ce doit vous être un spectacle assez doux De voir d'un œil Psiché moutante, Et de l'autre ce Fils d'une voix suppliante Ne vouloir plus tenir son bonheur que de vous.
Rendez-moy ma Pſiché, rendez-luy tous ſes charmes, itenuen la, Déeſſe, à mes larmes, Rendez à mon amour, rendez à ma douleur Le charme de mes yeux, & le choix de mon cœur.	Rendez-moi ma Psiché, rendez-lui tous ses charmes, ituen la, Déesse, à mes larmes, Rendez à mon amour, rendez à ma douleur Le charme de mes yeux, et le choix de mon cœur.
VENUS.	VENUS.
Quelque amour que Pſiché vous donne, De ſes malheurs par moy n’attendez pas la fin:	Quelque amour que Psiché vous donne, De ses malheurs par moi n'attendez pas la fin:
Orie Deſtin me l’abandonne, Je l’abandonne à ſon Deſtin.	Orie Destin me l'abandonne, Je l'abandonne à son Destin.
Ne m’importunez plus, & dans cette infortune Eaiſſez-la ſans venus triompuer ou perir.	Ne m'importunez plus, et dans cette infortune Eaissez-la sans venus triompuer ou périr.
L’AMOUR.	L'AMOUR.
Helas!	Hélas!
fi je vous importune, Je ne le fetois pas, ſi je pouvois mourir.	fi je vous importune, Je ne le fétais pas, si je pouvais mourir.
VENUS.	VENUS.
cetu doueur ſrent puu onmeiune, Qui force un Immortel à ſouhaiter la mort.	cet doueur srent puv onmeiune, Qui force un Immortel à souhaiter la mort.
L’AMOUR.	L'AMOUR.
Voyez par ſon excez ſi mon amour eſt fort.	Voyez par son excès si mon amour est fort.
Ne luy ferez-vous grace aucune?	Ne notre ferez-vous grâce aucune?
JENUS.	JENUS.
Je vous l’avouë, il me touche le cœur, Voſtre amour, il deſarme, il fléchit ma rigueure, Voſtre Pſiché reverra la lumiere.	Je vous l'avoue, il me touche le cœur, Votre amour, il désarme, il fléchit ma riguure, Votre Psiché reverra la lumière.
L’AMOUR.	L'AMOUR.
Que je vous vay par tout faire donner d’encens	Que je vous vais par tout faire donner d'encens
ENUS.	ENUS.
Oüy, vous la reverrez dans ſa beauté premiere:	Oui, vous la reverrez dans sa beauté première:
Mais de vos vœux reconnoiſſans Je veux la déference entiere.	Mais de vos vœux reconnaissants Je veux la déférence entière.
Je teul qu'ui vay ſcipcet lame a mon ailtie Vous choiſir une autre Moitié.	Je teul qu'ui vay scipet lame a mon ailtie Vous choisir une autre Moitié.
L’AMOUR.	L'AMOUR.
Et moy, je ne veux plus de grace, Je reprens toute mon audace, Je veux Pſiché, je veux ſa foy, Je veux qu'elle revive & revive pour moy, Et tiens indifferent que voſtre haine laſſe, En faveur d'une autre ſe paſſe.	Et moi, je ne veux plus de grâce, Je reprends toute mon audace, Je veux Péché, je veux sa foi, Je veux qu'elle revive et revive pour moi, Et tiens indifférent que votre haine lasse, En faveur d'une autre se passe.
Jupiter qui paroiſt va juger entre nous De mes emportemens & de voſtre couroux.	Jupiter qui parait va juger entre nous De mes emportements et de votre courroux.
Apres quelques éclairs & roulemens de Tonnentt, anprter puresſe eniun jui jon Aigle.	Après quelques éclairs et roulements de Tonnent, anprîter puresse eniun jui jon Aigle.
SCENE DERNTERE.	SCÈNE DERNTERE.
PITER, VENUS, L’AMOUR, PSICHE'.	PITER, VENUS, L'AMOUR, PSICHÉE'.
L’AMOUR.	L'AMOUR.
VOus à qui ſeul tout eſt poſſible, Pere des Dieux, Souverain des Mortels, Fléchiſſez la rigueur d’une Mere infléxible Qui ſans moy n’auroit point d’Autels, J’aylpleuré, j’ay prié, je ſoûpire, menace, Et perds menaces & ſoûpirs, Elle ne veut pas voir que de mes déplaiſirs Dépend du Monde entier l’heureuſe, ou triſte face, Et que ſi Pſiché perd le jour, Si Pſiché n’eſt à moy, je ne ſuis plus l’Amour.	VOus à qui seul tout est possible, Père des Dieux, Souverain des Mortels, Fléchissez la rigueur d'une Mère infléxible Qui sans moi n'aurait point d'Autels, J'aylpleuré, j'ai prié, je soupire, menace, Et perds menaces et soupirs, Elle ne veut pas voir que de mes déplaisirs Dépend du Monde entier l'heureuse, ou triste face, Et que si Paiché perd le jour, Si Psiché n'est à moi, je ne suis plus l'Amour.
Oüy, je rompray mon Arc, je briſeray mes fléches, J’éteindray juſqu’à mon flambeau, Je laiſſeray languir la Nature au tombeau;	Oui, je romprai mon Arc, je briserai mes flèches, J'éteindrai jusqu'à mon flambeau, Je laisserai languir la Nature au tombeau;
ches, Ou ſi je daigne aux cœurs faire encor quelques bréAvec ces pointes d’or qui me font obeïr Je vous bleſſeray tous la haut pour des Mortelles, Et ne décocheray ſur elles!	chez, Ou si je daigne aux cœurs faire encor quelques bréAvec ces pointes d'or qui me font obéir Je vous blesserai tous la haut pour des Mortelles, Et ne décocherai sur elles!
Que des traits émouſſez qui forcent à haïr, Et qui ne font que des rebelles, Des ingrates, & des cruelles.	Que des traits émoussez qui forcent à haïr, Et qui ne font que des rebelles, Des ingrates, et des cruelles.
Par quelle tyrannique loy Tiendray-je a vous ſervir mies atfil-stoujours preſtes, Et vous feray-je à tous conqueſtes ſur conqueſtes, Si vous me defendez d’en faire une pour moy?	Par quelle tyrannique loi Tiendrai-je à vous servir mies atfil-toujours prêtes, Et vous ferai-je à tous conquêtes sur conquêtes, Si vous me défendez d'en faire une pour moi?
JUPITER.	JUPITER.
Ma Fille, ſois luy moins ſevere.	Ma Fille, sois lui Seigneur sévère.
Tu tiens de ſa Pſiché le Deſtin en tes mains, La Parque au moindre mot va ſuivre ta colere, Parle, & laiſſe-toy vaincre aux tendreſſes de Mere, Ou redoute un couroux que moy-meſme je crains.	Tu tiens de sa Psiché le Destin en tes mains, La Parque au moindre mot va suivre ta colère, Parle, et laisse-toi vaincre aux tendresses de Mère, Ou redoute un courroux que moi-même je crains.
Veux-tu donner le monde en proye A la haine, au deſordre, à la confuſion, Et d’un Dieu d’union, D’un Dieu de douceurs & de joye, Faire un Dieu d’amertume & de diviſion?	Veux-tu donner le monde en proie A la haine, au désordre, à la confusion, Et d'un Dieu d'union, D'un Dieu de douceurs et de joie, Faire un Dieu d'amertume et de division?
Conſidere ce que nous ſommes, Et ſi les paſſions doivent nous dominer, Plus la vangeance a dequoy plaire aux Hommes, Plus il fied bien aux Dieux de pardonner.	Considère ce que nous sommes, Et si les passions doivent nous dominer, Plus la vengeance a dequoy plaire aux Hommes, Plus il sied bien aux Dieux de pardonner.
VENUS.	VENUS.
Je pardonne à ce Fils rebelle;	Je pardonne à ce Fils rebelle;
Mais voulez-vous qu’il me ſoit reproché Qu’une miſerable Mortelle, L’objet de mon couroux, l’orgueilleuſe Pſiché, Sous ombre qu’elle eſt un peu belle, Parui Tiyiſendont je rougis, Soüille mon alliance, & le lit de mon Fils?	Mais voulez-vous qu'il me soit reproché Qu'une misérable Mortelle, L'objet de mon courroux, l'orgueilleuse Psiché, Sous ombre qu'elle est un peu belle, Parui Tiyisendont je rougis, Sourille mon alliance, et le lit de mon Fils?
JUPITER.	JUPITER.
Hé bien, je la fais immortelle, Afin d’y rendre tout égal.	Hé bien, je la fais immortelle, Afin d'y rendre tout égal.
VENUS.	VENUS.
Je n'ay plus de mépris, ny de haine pour elle, Et l’admets à l’honneur de ce nœud conjugal.	Je n'ai plus de mépris, Seigneur de haine pour elle, Et l'admets à l'honneur de ce nœud conjugal.
Pſiché, reprenez la lumiere, Pour ne la reperdre jamais, Jupiter a fait voſtre paix, Et je quitte cette humeur fiere Qui s’opporoleu rosfoanaits,	Psiché, reprenez la lumière, Pour ne la reperdre jamais, Jupiter a fait votre paix, Et je quitte cette humeur fière Qui s'opporoleu rosfoanaits,
PSICHE’.	PSICHÉE.
C’eſt donc vous, ô grande Déeſſe, Qui redonnez la vie a ce cœur innocent!	C'est donc vous, ô grande Déesse, Qui redonnés la vie à ce cœur innocent!
VENUS.	VENUS.
ſupiter vous fait grace, & ma colere ceſſe.	supiter vous fait grâce, et ma colère cesse.
Vivez, Vénus l’ordonne, aimez elle y conſent.	Vivez, Vénus l'ordonne, aimez elle y consent.
Je vous revois enfin, cher objet de ma flâme!	Je vous revois enfin, cher objet de ma flamme!
L'AMOUR à Pſiché.	L'AMOUR à Psiché.
Je vous poſſede enfin, delices de mon ame!	Je vous possède enfin, délices de mon âme!
UPITER.	OÙPITER.
Venez Amans, venez aux Cieux Achever un ſi grand & ſi digne Hymenée;	Venez Amants, venez aux Cieux Achever un si grand et si digne Hyménée;
Viens-y, belle Pſiché, changer de Deſtinée, Viens prendre place au rang des Dieux,	Viens-y, belle Psiché, changer de Destinée, Viens prendre place au rang des Dieux,
Les Divinitez qui avoient eſté partagées entre Vénus & ſon Fils, ſe réuniſſent en les voyant d’accord;	Les Divinités qui avaient été partagées entre Vénus et son Fils, se réunissent en les voyant d'accord;
& toutes enſemble par des Concerts, des Chants, & des Dances, celebrent la Feſte des Nopces de l’Amour.	et toutes ensemble par des Concerts, des Chants, et des Dances, célèbrent la Fête des Noces de l'Amour.
Apollon paroiſt le premier, & comme Dieu de l'Harmonte commence a inanter pour imviter les autres Dieux à ſe rejoüir.	Apollon paraît le premier, et comme Dieu de l'Harmonte commence a inanter pour imiter les autres Dieux à se réjouir.
Eux grandes Machines deſcendent aux deux U coſtez de Iupiter, cependant qu’il dit ces derniers Vers.	Eux grandes Machines descendent aux deux V côtés de Jupiter, cependant qu'il dit ces derniers Vers.
Vénus avec ſa Suite monte dans l’une.	Venus avec sa Suite monte dans l'une.
L’Amour voberpent uans l’autre, & tous enſemble remontent au Ciel.	L'Amour voberpent ans l'autre, et tous ensemble remontent au Ciel.
RECIT D’APPOLLON.	RÉCIT D'APOLLON.
y Niſſons-nous, Troupe immortelle;	y Nissons-nous, Troupe immortelle;
V Le Dieu d’Amour devient heureux Amant, Et venus à repris ia uoueeur haturelle En faveur d’un Fils ſi charmant:	V Le Dieu d'Amour devient heureux Amant, Et venus à repris ja ueeur haturelle En faveur d'un Fils si charmant:
Il va gouſter en paix, apres un long tourment, Une felicité qui doit eſtre éternelle.	Il va goûter en paix, après un long tourment, Une félicité qui doit être éternelle.
Toutes les Divinitez chantent enſemble ce Couplet à la gloire de l’Amour.	Toutes les Divinités chantent ensemble ce Couplet à la gloire de l'Amour.
Elebrons ce grand Jour;	Élébrons ce grand Jour;
CCelebrons tous une Feſte ſi belle:	CCélébrons tous une Fête si belle:
Que nos Chants en tous lieux en portent la nouvelle;	Que nos Chants en tous lieux en portent la nouvelle;
Qu’ils faſſent retentir le celeſte ſéjour:	Qu'ils fassent retentir le celeste jour:
Chantons, repetons tour à tour, Qu’il n’eſt point d’Ame ſi cruelle, Qui toſt ou tard ne ſe rende à l’Amour.	Chantons, répétons tour à tour, Qu'il n'est point d'Âme si cruelle, Qui tôt ou tard ne se rende à l'Amour.
APOLLON contiauë.	APOLLON contiave.
E Dieu qui nous engage LAluy faire la Cour, Defend qu’on ſoit trop ſage.	E Dieu qui nous engage LAlui faire la Cour, Défend qu'on soit trop sage.
Les plaiſirs ont leur tour, C’eſt leur plus doux uſage, Que de finir les ſoins du Jour, La Nuit eit is partage Des Jeux & de l’Amour.	Les plaisirs ont leur tour, C'est leur plus doux usage, Que de finir les soins du Jour, La Nuit éit is partage Des Jeux et de l'Amour.
Ce ſeroit grand!	Ce serait grand!
dommage Qu’en ce charmant Séjour On euſt un cœur ſauvage.	dommage Qu'en ce charmant Séjour On eût un cœur sauvage.
Les Plaiſirs ont leur tour, C’eſt leur plus doux uſage, de de Mille loisdajota La Nuit eſt le partage Des Jeux & de l’Amour.	Les Plaisirs ont leur tour, C'est leur plus doux usage, de de Mille loisdajota La Nuit est le partage Des Jeux et de l'Amour.
Deux Muſes qui ont toûjours évité de s’engager ſous les Loix de ll’amour, conſeillent aux Belles, qui n'ont point encore aimé, de s’en defendre avec ſoin à leur exemple.	Deux Muses qui ont toujours évité de s'engager sous les Lois de l'amour, conseillent aux Belles, qui n'ont point encore aimé, de s'en défendre avec soin à leur exemple.
CHANSON DES MUSES.	CHANSON DES MUSES.
Ardez-vous, Beautez ſeveres, OLes Amours font trop d’affaires, Craignez toûjours de vous laiſſer charmer:	Ardez-vous, Beautés sévères, OLes Amours font trop d'affaires, Craignez toujours de vous laisser charmer:
Quand il faut que l'on ſoûpire, Tout le mal n’eſt pas de s’enflâmer, Le martire De le dire Coulte pius cent lois que d’aimer.	Quand il faut que l'on soupire, Tout le mal n'est pas de s'enflammer, Le martyre De le dire Coulte pius cent lois que d'aimer.
SECOND COUPLET DES MUSES.	SECOND COUPLET DES MUSES.
On ne peut aimer ſans peines, Il eſt peu de douces chaînes, A tout moment on ſe ſent alarmer, Quand il faut que l’on ſoûpire, Tout le mal n’eſt pas de s’enflâmer;	On ne peut aimer sans peines, Il est peu de douces chaînes, À tout moment on se sent alarmer, Quand il faut que l'on soupire, Tout le mal n'est pas de s'enflammer;
Le martire De le dire, Couſte plus cent fois que d’aimer.	Le martyre De le dire, Coûte plus cent fois que d'aimer.
Bacchus fait entendre qu’il n’eſt pas ſi dangereux que l’amour.	Bacchus fait entendre qu'il n'est pas si dangereux que l'amour.
RECIT DE BACCHUS.	RÉCIT DE BACCHUS.
quelquefois, O Suivant nos douces Loix, La raiſon ſe perd & s’oublie, Ce que le Vin nous cauſe de folie Commence & finit en un jour;	quelquefois, Ô Suivant nos douces Lois, La raison se perd et s'oublie, Ce que le Vin nous cause de folie Commence et finit en un jour;
Mais quand un cœur eſt enyvré d’Amour, Souvent c’eſt pour toute la vie.	Mais quand un cœur est enivré d'Amour, Souvent c'est pour toute la vie.
Mome declare qu’il n’a point de plus doux employ que de médire, & que ce n’eſt qu’à l’Ameur ſeul qu’il n’oſe ſe joüer.	Mome déclare qu'il n'a point de plus doux emploi que de médire, et que ce n'est qu'à l'Ameur seul qu'il n'ose se jouer.
RECIT DE MOMJE.	RÉCIT DE MÔME.
’Echerche à médire, ISur la Terre & dans les Cieux;	Ç'Écherche à médire, ISur la Terre et dans les Cieux;
Je ſoûmets à ma Satyre Les plus grands des Dieux.	Je soumets à ma Satire Les plus grands des Dieux.
Il n’eſt dans l’Univers que l’Amout qui m’étonne;	Il n'est dans l'Univers que l'Amout qui m'étonne;
Il eſt le ſeul que j’épargne aujourd’huy, Il n’appartient qu’à luy De n'epargner perionne.	Il est le seul que j'épargne aujourd'hui, Il n'appartient qu'à avait De n'épargner perionne.
ENTRE’E DE BALLET, Compoſée de deux Mœnades & de deux Agipans qui ſuivent Bacchus.	ENTRE DE BALLET, Composée de deux Mœnades et de deux Agipans qui suivent Bacchus.
ENTRE'E DE BALLET, Compoſée de quatre Polichinelles & de deux Mataſsins qui ſuivent Mome, & viennent joindre leur plaiſanterie & leur badinage aux divertiſſemens de cette grande Feſte.	ENTRE DE BALLET, Composée de quatre Polichinelles et de deux Matassins qui suivent Mome, et viennent joindre leur plaisanterie et leur badinage aux divertissements de cette grande Fête.
Bacchus & Mome qui les conduiſent, chantent au milieu d’eux chacun une Chanſon, Bachus à la loüange du Vin, & Mome une Chanſon enjoüée ſur le ſujet & les avantages de la raillerie.	Bacchus et Mome qui les conduisent, chantent au milieu d'eux chacun une Chanson, Bachus à la louange du Vin, et Mome une Chanson enjouée sur le sujet et les avantages de la raillerie.
RECIT DE BACCHUS.	RÉCIT DE BACCHUS.
Dmirons le jus de la Treille:	Démirons le jus de la Treille:
A Qu’il eſt puiſſant!	A Qu'il est puissant!
qu’il a d’attraits!	qu'il a d'attraits!
Il ſert aux douceurs de la Paix, Et dans la Guerre il fait merveille:	Il sert aux douceurs de la Paix, Et dans la Guerre il fait merveille:
Mais ſur tout pour les Amours, Le Vin eſt d’un grand ſecours.	Mais sur tout pour les Amours, Le Vin est d'un grand secours.
RECIT DE MOME.	RÉCIT DE MÔME.
Olaſtrons, divertiſſons-nous, L'Raillons, nous ne ſçaurions mieux faire, La raillerie eſt neceſſaire Dans les Jeux les plus doux.	Olâtrons, divertissons-nous, L'Raillons, nous ne saurions mieux faire, La raillerie est nécessaire Dans les Jeux les plus doux.
Sans la douceur que l’on gouſte à médire, On trouve peu de plaiſirs ſans ennuy, Rien n’eſt ſi plaiſant que de rire, Quand on rit aux deſpens d’autruy.	Sans la douceur que l'on goûte à médire, On trouve peu de plaisirs sans ennui, Rien n'est si plaisant que de rire, Quand on rit aux dépens d'autrui.
Plaiſantons, ne pardonnons rien, Rions, rien n'eſt plus à la mode.	Plaisantons, ne pardonnons rien, Rions, rien n'est plus à la mode.
On court péril d’eſtre incommode, En diſant trop de bien.	On court péril d'être incommode, En disant trop de bien.
Sans la douceur que l’on gouſte à médire, On trouve peu de plaiſirs ſans ennuy, Rien n’eſt ſi plaiſant que de rire, Quand on rit aux deſpens d’autruy.	Sans la douceur que l'on goûte à médire, On trouve peu de plaisirs sans ennui, Rien n'est si plaisant que de rire, Quand on rit aux dépens d'autrui.
Mars arrive au milieu du Théatre, ſuivy de ſaTroupe guerriere, qu’il excite à profiter de leur loiſir, en prenant part aux Divertiſſemens.	Mars arrive au milieu du Théâtre, suivi de saTroupe guerrière, qu'il excite à profiter de leur loisir, en prenant part aux Divertissements.
RECIT DE MARS.	RÉCIT DE MARS.
Aiſſons en paix toute la Terre, L Cherchons de doux amuſemens;	Aissons en paix toute la Terre, L Cherchons de doux amusements;
Parmy les Jeux les plus charmans, Meſlons l’image de la Guerre.	Parmi les Jeux les plus charmants, Mêlons l'image de la Guerre.
ENTAEE DE DALLET.	ENTAEE DE DALLET.
Suivans de Mars, qui font en dançant avec des Eusſeignes une maniere d’Exercice.	Suivants de Mars, qui font en dançant avec des Eusseignes une manière d'Exercice.
DERNIERE ENTRE’E DE BALLET.	DERNIÈRE ENTRE DE DE BALLET.
Les Troupes diferentes de la Suite d'Apollon, de Bacchus, de Mome, & de Mars, apres avoir achevé leurs Entrées particulieres, s’uniſſent enſemble, *3 forment la derniere Entrée qui renferme toutes les autres.	Les Troupes dièrentes de la Suite d'Apollon, de Bacchus, de Mome, et de Mars, après avoir achevé leurs Entrées particulières, s'unissent ensemble, *3 forment la dernière Entrée qui renferme toutes les autres.
Vn Chœur de toutes les Voix & de tous les Inſtrumens, qui ſont au nombre de quarante, ſe joint à la Dance geverale, & termine la Feſte des Nopces de l'Amoûr & de l'fiche.	Un Chœur de toutes les Voix et de tous les Instruments, qui sont au nombre de quarante, se joint à la Dance gévérale, et termine la Fête des Nopces de l'Amour et de l'fiche.
DERNIER CHOEUR.	DERNIER CHOEUR.
Mantons les plaiſirs charmans  Des heureux Amans, Que tout le Ciel s’empreſſe A leur faire ſa Cour, Celebrons ce beau Jour Pal Mine dourenanes daneorens, Celebrons ce beau Jour Parmille doux chants pleins d’amour.	Mantons les plaisirs charmants Des heureux Amants, Que tout le Ciel s'empresse À leur faire sa Cour, Clébrons ce beau Jour Pal Mine dourenanes daneorens, Célébrons ce beau Jour Parmille doux chants pleins d'amour.
Dans le grand Sallon du Palais des Tuilleries, où Pſiché a eſté repreſentée devant Leurs Majeſtez, il y avoit des Tymbales, des Trompettes & des Tambours, meſlez dans ces derniers Concerts;	Dans le grand Sallon du Palais des Tuilleries, où Psiché a été représentée devant Leurs Majectés, il y avait des Tymbales, des Trompettes et des Tambours, mêlés dans ces derniers Concerts;
& ce dernier Couplet ſe chantoit ainſi.	et ce dernier Couplet se chantait ainsi.
Hantons les plaiſirs charmans O Des heureux Amans.	Hantons les plaisirs charmants Ô Des heureux Amants.
Répondez-nous Trompettes, Tymbales & Tambours:	Répondez-nous Trompettes, Tymbales et Tambours:
Accordez-vous toûjours Avec le doux ſon des Muſettes, Accordez-vous toûjours Avec le doux chant des Amours.	Accordez-vous toujours Avec le doux chus son Musettes, Accordez-vous toujours Avec le doux chant des Amours.
FIN.	FIN.
Eeairais an l dsalless an aeeſ.	Étairais an l dsalless an aces.
QAR Grace & Privilege du Roy, Donné à Paris le T31.	QAR Grâce et Privilège du Roi, Donné à Paris le T31.
jour de Decembre, l’an de grace 1670.	jour de Décembre, l'an de grâce 1670.
Signé, Par le Roy en ſon Conſeil, GUITONNEAU.	Signé, Par le Roi en son Conseil, GUITONNEAU.
Il eſt permis à Jean-Baptiſte Pocquelin de Moliere, l’un des Comediens de Sa Majeſté, de faire imprimer, vendre & debiter une Piece de Theatre, intitulée.	Il est permis à Jean-Baptiste Pocquelin de Molière, l'un des Comédiens de Sa Majesté, de faire imprimer, vendre et débiter une Pièce de Théâtre, intitulée.
LES AMOURS DE PSICHE’, par tel Imprimeur ou Libraire qu’il voudra choiſir, pendant le temps de dix années entieres & accomplies, à compter du jour que ladite Piece ſera achevée d’imprimer pour la premiere fois:	LES AMOURS DE PSICHÉE, par tel Imprimeur ou Libraire qu'il voudra choisir, pendant le temps de dix années entières et accomplies, à compter du jour que ladite Pièce sera achevée d'imprimer pour la première fois:
Et defenſes ſont faites à toutes Perſonnes, de quelque qualité & condition qu’elles ſoient, d’imprimer, faire imprimer, vendre, ny debiter ladite Piece, ſans le conſentement de l'Expoſant, ou de ceux qui auront droict de luy, à peine de ſix mille livres d'aniende, connteution den Exemplanes contrefaits, & de tous dépens, dommages & intereſts, ainſi que plus au long il eſt porté audit Privilege.	Et défenses sont faites à toutes Personnes, de quelque qualité et condition qu'elles soient, d'imprimer, faire imprimer, vendre, ni débiter ladite Pièce, sans le consentement de l'Exposant, ou de ceux qui auront droit de Seigneur, à peine de six mille livres d'aniende, connution den Exemplanes contrefaits, et de tous dépens, dommages et intérêts, ainsi que plus au long il est porté audit Privilège.
Ledit Sieur Moliere a cedé ſon droit de Privilege à Anne David, Femme de Jean Ribou, ainſi qu’il apert par ſa Ceſſion;	Ledit Sieur Molière a cédé son droit de Privilège à Anne David, Femme de Jean Ribou, ainsi qu'il apert par sa Cession;
& ladite David a cedé du droit de Privilege des Oeuvres dudit Sieur Moliere à Claude Barbin, ſuivant l’accord fait entr’eux.	et ladite David a cédé du droit de Privilège des Oeuvres dudit Sieur Molière à Claude Barbin, suivant l'accord fait entr'eux.
Regiſtré lur le Livre de la Communauté des Imprimeurs & Marchands Libraires de Paris, ſuivant l’Arreſt de la Cour de Parlement du 8.	Registré lur le Livre de la Communauté des Imprimeurs et Marchands Libraires de Paris, suivant l'Arrêt de la Cour de Parlement du 8.
Avril 1653.	Avril 1653.
aux charges & conditions portées és preſentes Lettres.	aux charges et conditions portées ès présentes Lettres.
Fait ce 13 Maars mil ſix cens ſoixante & onze.	Fait ce 13 Maars mil six cens soixante et onze.
Acheué d’imprimer le 12.	Achevé d'imprimer le 12.
Avril 1675.	Avril 1675.
