L.	L.
Muie	Muie
M.	M.
DC.	DC.
LXX.	LXX.
Avec Privilege du Roy.	Avec Privilège du Roi.
Lairater an mihumigu du Roy.	Lairater an mihumigu du Roi.
AR grace & Privilege du Roy, Donné à Paris, le 20.	AR grâce et Privilège du Roi, Donné à Paris, le 20.
T jour de Fevrier, l’an de grace 1670.	T jour de Février, l'an de grâce 1670.
Signé, Par le Roy en ſon Conſeil, Bouchet.	Signé, Par le Roi en son Conseil, Bouchet.
Il eſt permis à Iean Baptiſte Pocquelin de Moliere, l’un de nos Comediens, de faire imprimer, vendre & debiter une Piece de Theatre, intitulée MONSIEUR DE POURCEAUGNAC;	Il est permis à Jean Baptiste Pocquelin de Molière, l'un de nos Comédiens, de faire imprimer, vendre et débiter une Pièce de Théâtre, intitulée MONSIEUR DE POURCEAUGNAC;
& ce par tel Imprimeur, ou Libraire qu’il voudra choiſir, pendant le temps & eſpace de cinq années entieres & accomplies, à compter du jour que ladite piece ſera achevée d’imprimer pour la premiere fois:	et ce par tel Imprimeur, ou Libraire qu'il voudra choisir, pendant le temps et espace de cinq années entières et accomplies, à compter du jour que ladite pièce sera achevée d'imprimer pour la première fois:
Et défences ſont faites à toutes perſonnes, de quelque qualité & condition qu’ils ſoient, d’imprimer, faire imprimer, vendre ny debiter ladite riece, ſans le conſentement de l’Expoſant, ou de ceux qui auront droit de luy, à peine de ſix mil li vres d’amende, confilcation des Exemplaires contrefaits, & de tous dépens, dommages & intereſts, ainſi que plus au long il eſt porté audit privilege.	Et défences sont faites à toutes personnes, de quelque qualité et condition qu'ils soient, d'imprimer, faire imprimer, vendre ni débiter ladite rièce, sans le consentement de l'Exposant, ou de ceux qui auront droit de soins, à peine de six mil li âtres d'amende, confilcation des Exemplaires contrefaits, et de tous dépens, dommages et intérêts, ainsi que plus au long il est porté au Ciel.
Regiſtré ſur le Livre de la Communauté, ſuivant l’Arreſt de la Cour du 8.	Registré sur le Livre de la Communauté, suivant l'Arrêt de la Cour du 8.
Avril 1653.	Avril 1653.
le 28.	le 28.
Fevrier 1670.	Février 1670.
Signé, SOUBRON.	Signé, SOUBRON.
Ledit I.	Ledit I.
B.	B.
P.	P.
de Moliere a cedé le preſent Privilege, à Iean Ribou, Marchand Libraire à Paris, pour en joüit, ſaivant l’accord fait entr’eux.	de Molière a cédé le présent Privilège, à Jean Ribou, Marchand Libraire à Paris, pour en jouit, saisant l'accord fait entr'eux.
Achevé d’imprimer pour la premiere fois, le 3.	Achevé d'imprimer pour la première fois, le 3.
jour de Mars 167e.	jour de Mars 167e.
ACTE RS.	ACTE RS.
MONS.	MONS.
DE POURCEAUGNAC.	DE POURCEAUGNAC.
DRONTE.	DRONTE.
ULIE, Fille d’Oronte.	ULIE, Fille d'Oronte.
NERINE, Femme d’intrigue.	NERINE, Femme d'intrigue.
LIICETTE, feinte Gaſconne.	LICETTE, feinte Gasconne.
FRASTE, Amant de Julie.	FRASTE, Amant de Julie.
[trigue.	[trigue.
SBRIGANI, Napolitain, Homme d’in	SBRIGANI, Napolitain, Homme d'in
’Ouverture ſe fait par Eraſte, qui conduit Lun grand Concert de Voix & d’Inſtrumens;	Ouverture se fait par Éraste, qui conduit Lun grand Concert de Voix et d'Instruments;
pour une Serenade, dont les Paroles chantées par trois voix en maniere de Dialogue, ſont faites ſur le Sujet de la Comedie, & expriment les ſentimens des deux Amaus, qui eſtans bien enſemble, ſont traverſez par le caprice des Parens.	pour une Serenade, dont les Paroles chantées par trois voix en manière de Dialogue, sont faites sur le Sujet de la Comédie, et expriment les sentiments des deux Amaus, qui étant bien ensemble, sont traversez par le caprice des Parents.
Premiere Voix.	Première Voix.
Répans charmante nuit, répans ſur tous les yeux, Et ne laiſſe veiller en ces aimables lieux Que les cœurs que l’Amour ſoûmet à ſa puiſſance.	Répans charmante nuit, répans sur tous les yeux, Et ne laisse veiller en ces aimables lieux Que les cœurs que l'Amour soumet à sa puissance.
Tes ombres & ron ſitente Plus beau que le plus beau jour, Offre de doux momens à ſoûpirer d’amour.	Tes ombres et ron sitente Plus beau que le plus beau jour, Offre de doux moments à soupirer d'amour.
Deuxiéme Voix.	Deuxième Voix.
Que ſoûpirer d’amour Eſt une douce choſe, Quand rien à nos vœux ne s’oppoſe!	Que soupirer d'amour Est une douce chose, Quand rien à nos vœux ne s'oppose!
A d’aimables penchans nôtre cœur nous diſpoſe, Mais on a des Tyrans à qui on doit le jour:	À d'aimables penchants notre cœur nous dispose, Mais on a des Tyrans à qui on doit le jour:
Que ſoûpirer d’amour Eſt u ne douce choſe, Quand rien à nos vœux ne s’oppoſe.	Que soupirer d'amour Est u ne douce chose, Quand rien à nos vœux ne s'oppose.
Tout ce qu’à nos vœux on oppoſe, Contre un parfait amour ne gagne jamais rien;	Tout ce qu'à nos vœux on oppose, Contre un parfait amour ne gagne jamais rien;
Et pour vaincre toute choſe, A ne jaai que suimer olens	Et pour vaincre toute chose, À ne jaï que sumer olents
Les trois Voixenſemble.	Les trois Voixensemble.
Aimons-nous donc d’une amour éternelle, Les rigueurs des Parens la contrainte cruelle, L’abſence, les travaux, la foriune rebelle, Ne font que redoubler une amitié fidelle:	Aimons-nous donc d'une amour éternelle, Les rigueurs des Parents la contrainte cruelle, L'absence, les travaux, la foriune rebelle, Ne font que redoubler une amitié fidèle:
Aimonuuon, uont unnoumour éternelle, Quand deux cœurs s’aiment bien, Tout le reſte n’eſt rien.	Aimonuon, ouvont unnoumour éternelle, Quand deux cœurs s'aiment bien, Tout le reste n'est rien.
La Serenade eſt ſuivie d’une Danſe de deux Pages, pendant laquelle quatre curieux de Spectacles ayans pris querelle enſemble, mettent l’épée à la main.	La Serenade est suivie d'une Danse de deux Pages, pendant laquelle quatre curieux de Spectacles ayant pris querelle ensemble, mettent l'épée à la main.
Aprés un aſſez agreable Com.	Après un assez agréable Com.
bat, ils ſont ſeparez par deux Suiſſes, qui les ayant mis d’accord danſent avec eux au ſon de tous les Inſtrumens.	bat, ils sont séparés par deux Suisses, qui les ayant mis d'accord dansent avec eux au son de tous les Instruments.
MONSIEUR DE POVRCEAVGNAC, COMEDIE.	MONSIEUR DE POURCEAUGNAC, COMÉDIE.
ACTE I.	ACTE I.
SCLNVE IXBMTENL.	SCLNVE IXBMTENL.
JULIE, ERASTE, NERINE.	JULIE, ERASTE, NERINE.
OLIE.	OLIE.
2 ON Dieu, Eraſte, gardons d’eſtre ſurpris;	2 ON Dieu, Eraste, gardons d'être surpris;
ie tremble que l’on ne nous voye enſemble;	Il tremble que l'on ne nous voit ensemble;
& tout ſeroit perdu, aprés la défenſe que l'on m’a faite.	et tout serait perdu, après la défense que l'on m'a faite.
ERASTE.	ERASTE.
Je regarde de tous coſtez, & ie n’apperçoy rien	Je regarde de tous côtés, et Seigneur n'aperçois rien
ULIE.	ULIE.
Aye auſſi l’œil au guet, Nerine, & prens bien garde qu’il ne vienne perſonne.	Aye aussi l'œil au guet, Nerine, et prends bien garde qu'il ne vienne personne.
NERINE.	NERINE.
Repoſez-vous ſur moy, & dites fardiment ce que vous avez à vous dire.	Reposez-vous sur moi, et dites fardiment ce que vous avez à vous dire.
ULIE.	ULIE.
Avez vous imaginé pour noſtre affaire quelque cnort de favorable;	Avez -vous imaginé pour notre affaire quelque cnort de favorable;
& croyez-vous, Eraſte, pouvoir venir à jbout de détourner ce fâcheux Mariage que mon Pere s’eſt mis en teſte?	et croyez-vous, Erâte, pouvoir venir à jbout de détourner ce fâcheux Mariage que mon Père s'est mis en tête?
ERASTE.	ERASTE.
Au moins y travaillons-nous fortement, & déja nous avons preparé un bon nombre de Batteries pour renverſer ce deſſein ridicule.	Au moins y travaillons-nous fortement, et déjà nous avons préparé un bon nombre de Batteries pour renverser ce dessein ridicule.
Av da la Mn EPar ma foy, voila voſtre Pere!	Ave da la Mn EPar ma foi, voilà votre Père!
IULIE.	ILLIE.
Ah ſeparons-nous viſte.	Ah séparons-nous vite.
NERINE.	NERINE.
Non, non, non, ne bougez, ie m’eſtois trompée.	Non, non, non, ne bougez, on m'étais trompée.
410	410
ULIE.	ULIE.
Mon Dieu, Nerine, que tu es ſotte, de nous donner de ces fra eurs!	Mon Dieu, Nerine, que tu es sotte, de nous donner de ces fra eurs!
ERASTE.	ERASTE.
Ouiy, belle Julie, nous avons dreſſé pour cela quantité de Machines, & nous ne feignons point de mettre tout en uſage ſur la permiſſion que vous m’avez donnée.	Oui, belle Julie, nous avons dressé pour cela quantité de Machines, et nous ne feignons point de mettre tout en usage sur la permission que vous m'avez donnée.
Ne nous demandez point tous les reſſorts que nous ferons joüer, vous en aurez le divertiſſement;	Ne nous demandez point tous les ressorts que nous ferons jouer, vous en aurez le divertissement;
& comme aux Comedies, il eſt bon de vous laiſſer le plaiſir de la ſurpriſe, & de ne vous avertir point de tout ce qu’on vous fera voir, c’eſt aſſez de vous dire que nous avons en main divers ſtratagêmes tous preſts à produire dans l’occaſion, & que l'ingenieuſe Nerine & l’adroit Sbrigani’entreprennent l’affaire.	et comme aux Comédies, il est bon de vous laisser le plaisir de la surprise, et de ne vous avertir point de tout ce qu'on vous fera voir, c'est assez de vous dire que nous avons en main divers stratagêmes tous prêts à produire dans l'occasion, et que l'ingénieuse Nerine et l'adroit Sbrigani’entreprennent l'affaire.
NERINE.	NERINE.
Aſſurément.	Assurément.
Voſtre Pere ſe moque-t-il, de vouloir vous enger de ſon Advocat de Limoges Monſieur de Pourceaugnac, qu’il n’a veu de ſa vie, & qui vient par le Coche vous enlever à noſtre barbe;	Votre Père se montre-t-il, de vouloir vous enger de son Advocat de Limoges Monsieur de Pourceaugnac, qu'il n'a vu de sa vie, et qui vient par le Coche vous enlever à notre barbe;
faut-il que trois ou quatre mil écus de plus, ſur la parole de voſtre Oncle, luy faſſent rejetter un Amant qui vous agrée?	faut-il que trois ou quatre mil écus de plus, sur la parole de votre Oncle, te fassent rejeter un Amant qui vous agrée?
& une Perſonne comme vous, eſt-elle faite pour un Limoſin?	et une Personne comme vous, est-elle faite pour un Limosin?
S’il a envie de ſe marier que ne prend-il une Limoſine, & ne laiſſe-t-il en repos les Chrétiens?	S'il a envie de se marier que ne prend-il une Limosine, et ne laisse-t-il en repos les Chrétiens?
Le ſeul nom de Monſieur de Pourceaugnac m’a mis dans une colere effroyable.	Le seul nom de Monsieur de Pourceaugnac m'a mis dans une colère effroyable.
J’enrage de Monſieur de Pourceaugnac.	J'enrage de Monsieur de Pourceaugnac.
Quand il n’y auroit que ce nomlà;	Quand il n'y aurait que ce nomlà;
Monſieur de Pourceaugnac, j’y brûleray mes Livres, ou ie rompray ce Mariage, & vous ne ſerez point Madame de Pourceaugnac, Pourceaugnac!	Monsieur de Pourceaugnac, j'y brûlerai mes Livres, ou ma romprai ce Mariage, et vous ne serez point Madame de Pourceaugnac, Pourceaugnac!
cela ſe peut-il ſouffrir, Non, Pourceaugnac eſt une choſe que ie ne ſçaurois ſupporter, & nous luy joüerons tant de pieces, nous luy ferons tant de niches ſur niches, que nous renvoyerons à Limoges Monſieur de Pourceaugnac.	cela se peut-il souffrir, Non, Pourceaugnac est une chose que je ne saurais supporter, et nous y jouerons tant de pièces, nous lui ferons tant de niches sur niches, que nous renvoyerons à Limoges Monsieur de Pourceaugnac.
ERASTE.	ERASTE.
Voicy noſtre ſubtil Napolitain, qui nous dira des nouvenles.	Voici notre subtil Napolitain, qui nous dira des nouvenles.
CCENE II.	CCENE II.
SBRIGANI, JULIE, ERASTE, NERINE.	SBRIGANI, JULIE, ERASTE, NERINE.
SBRIGANI.	SBRIGANI.
Onſieur, voſtre homme arrive, ie l’ay vû Mà trois lieües d’icy, où a couché le Coche;	Onsieur, votre homme arrive, on l'ai vu Mà trois lieües d'ici, où a couché le Coche;
& dans la Cuiſine où il eſt deſcendu pour déjeſiner, ie l’ay étudié une groſſe demie heure, & ie le ſçay déja par cœur.	et dans la Cuisine où il est descendu pour déjesiner, Elle l'ai étudié une grosse demie heure, et et un sais déjà par cœur.
Pour ſa figure, ie ne veux point vous en parler, vous verrez de quel air la Nature l’a deſſinée, & ſi l’ajuſtement qui l’accompagne y répond comme il faut:	Pour sa figure, je ne veux point vous en parler, vous verrez de quel air la Nature l'a dessinée, et si l'ajustement qui l'accompagne y répond comme il faut:
mais pour ſon Eſprit, ie vous avertis par avance qu’il eſt des plus épais qui ſe faſſent;	mais pour son Esprit, je vous avertis par avance qu'il est des plus épais qui se fassent;
que nous trouvons en luy une matiere tout à fait diſpoſée pour ce que nous vouions, & qu’il eſt Homme enfin à donner dans tous les paneaux qu’on luy preſentera.	que nous trouvons en même une matière tout à fait disposée pour ce que nous vouions, et qu'il est Homme enfin à donner dans tous les paneaux qu'on lui présentera.
ERASTE.	ERASTE.
Nous dis-tu vray?	Nous dis-tu vrai?
SBRIGANI.	SBRIGANI.
Oüy, fi ie me connois en Gens.	Oui, fi ie me connais en Gens.
NERINE.	NERINE.
Madame, voila un Illuſtre, voſtre affaire ne pouvoit eſtre miſe en de meilleures mains, & c’eſt le Heros de noſtre Siecle pour les exemples dont il s’agit:	Madame, voilà un Illustre, votre affaire ne pouvait être mise en de meilleures mains, et c'est le Héros de notre Siècle pour les exemples dont il s'agit:
Un homme qui vingt fois en ſa vie pour ſervir ſes Amis, a genereuſement affronté les Galeres;	Un homme qui vingt fois en sa vie pour servir ses Amis, a généreusement affronté les Galères;
qui au peril de ſes bras & de ſes épaules, ſçait mettre noblement à fin les avantures les plus difficiles;	qui au péril de ses bras et de ses épaules, sçait mettre noblement à fin les aventures les plus difficiles;
& qui tel que le voyez, eſt exilé de ſon Païs pour je ne ſçay combien d’actions honorables qu’il a genereuſement entrepriſes.	et qui tel que le voyez, est exilé de son Pays pour je ne sais combien d'actions honorables qu'il a généreusement entreprises.
BRIGANI.	BRIGANI.
Je ſuis confus des loüanges dont vous m’honorez, ie pourrois vous en donner avec plus de juſtice ſur les merveilles de voſtre vie, & principalement ſur la gloire que vous acquiſtes, lors qu’avec tant d’honneſteté vous pipâtes au jeu pour douze mille écus, ce jeune Seigneur étranger que l’on mena chez vous;	Je suis confus des louanges dont vous m'honorez, tu pourrais vous en donner avec plus de justice sur les merveilles de votre vie, et principalement sur la gloire que vous acquîtes, lors qu'avec tant d'honnesteté vous pipâtes au jeu pour douze mille écus, ce jeune Seigneur étranger que l'on mena chez vous;
lors que vous fiſtes galamment ce faux Contract qui ruïna toute une Famille;	lors que vous fîtes galamment ce faux Contrat qui ruina toute une Famille;
lors qu’avec tant de grandeur d’ame vous ſçeûtes nier le dépoſt qu’on vous avoit confié, & que ſi genereuſement on vous vit preſter voſtre témoignage à faire pendre ces ucum lenenes quede levennt pas merité.	lors qu'avec tant de grandeur d'âme vous sûtes nier le dépôt qu'on vous avait confié, et que si généreusement on vous vit prêter votre témoignage à faire pendre ces ucum lenes que levennt pas mérité.
NERINE.	NERINE.
Ce ſont petites bagatelles qui ne valent pas qu’on en parle, & vos éloges me font rougir.	Ce sont petites bagatelles qui ne valent pas qu'on en parle, et vos éloges me font rougir.
SBRIGANI.	SBRIGANI.
Je veux bien épargner voſtre modeſtie;	Je veux bien épargner votre modestie;
laifſons cela;	laissons cela;
& pour commencer noſtre affaire, allons viſte joindre noſtre Provincial, tandis que de vôtre coſté vous nous tiendrez preſts au beſoin les autres Acteurs de la Comedie.	et pour commencer notre affaire, allons vite joindre notre Provincial, tandis que de votre côté vous nous tiendrez prêts au besoin les autres Acteurs de la Comédie.
ERASTE.	ERASTE.
Au moins, Madame, ſouvenez-vous de vôtre Rolle;	Au moins, Madame, souvenez-vous de votre Rolle;
& pour mieux couvrir noſtre jeu, feignez, comme on vous a dit, d’eſtre la plus contente du monde des reſolutions de vôtre Pere.	et pour mieux couvrir notre jeu, feignez, comme on vous a dit, d'être la plus contente du monde des résolutions de votre Père.
141 CIE.	141 CIE.
S’il ne tient qu’à cela les choſes iront à merveilles.	S'il ne tient qu'à cela les choses iront à merveilles.
60	60
ERASIE.	ERASIE.
Mais belle Julic, ſi toutes nos Machines venoient à ne pas reüſſir?	Mais belle Julic, si toutes nos Machines venaient à ne pas réussir?
11 ULIE 11 Je declareray à mon Pere mes veritables ſenHilitiis?	11 ULIE 11 Je déclarerai à mon Père mes véritables senHilitiis?
ERASTE.	ERASTE.
Et ſi contre vos ſentimens il s’obſtinoit à ſon deſſein?	Et si contre vos sentiments il s'obstinait à son dessein?
ſo H IICi h.	so H IICi h.
di JLIE.	di ILIE.
2 10 Je le menaceroïs de me jetter dans un Conyent.	2 10 Je le menaceroïs de me jeter dans un Conyent.
H171 2	H171 2
e mnoin  l la na lE.	Je moin loin la na lE.
Mais ſi malgré tout cela il vouloit vous forcer à ce Mariage.	Mais si malgré tout cela il voulait vous forcer à ce Mariage.
8 110110	8 110110
aNqin LIE.	aNqin LIE.
Que voulez-vous que je vous diſe?	Que voulez-vous que je vous dise?
ERASTE.	ERASTE.
Ce que je veux que vous me diſiez?	Ce que je veux que vous me disiez?
217 JULIE.	217 JULIE.
Oüy.	Oui.
ULIE.	ULIE.
ERASTE.	ERASTE.
Ce qu’on dit quand on aime bien.	Ce qu'on dit quand on aime bien.
Mais quoy?	Mais quoi?
ULIE.	ULIE.
ERASTE.	ERASTE.
Que rien ne pourra vous contraindre, & que malgré tous les efforts d’un Pere, vous me promettez d’eſtre à moy.	Que rien ne pourra vous contraindre, et que malgré tous les efforts d'un Père, vous me promettez d'être à moi.
ULIE.	ULIE.
Mon Dieu, Eraſte, contentez.	Mon Dieu, Éraste, contentez.
vous de ce que ie fais maintenant, & n’allez point tenter ſur l’avenir les reſolutions de mon cœur:	vous de ce que vertu fais maintenant, et n'allez point tenter sur l'avenir les résolutions de mon cœur:
ne fatiguez point mon devoir par les propoſitions d’une fâcheuſe extrémité dont peut-eſtre n’aurons-nous pas beſoin;	ne fatiguez point mon devoir par les propositions d'une fâcheuse extrémité dont peut-être n'aurons-nous pas besoin;
& s’il y faut venir, ſouffren au moins que j’y ſois entraînée par la ſuite des choſes.	et s'il y faut venir, souffren au moins que j'y sois entraînée par la suite des choses.
ERASTE:	ERASTE:
Eh bien.	Eh bien.
BRIGANI.	BRIGANI.
Ma foy, voicy noſtre Homme, ſongeons à nous.	Ma foi, voici notre Homme, songeons à nous.
ERINE.	ÉRINE.
Ah comme il eſt baſty !	Ah comme il est bâti !
SCENE II.	SCÈNE II.
M.	M.
DE POURCEAUGNAC ſe tourne du coſté d’où il vient, comme parlant à des Gens qui le ſuivent.	DE POURCEAUGNAC se tourne du côté d'où il vient, comme parlant à des Gens qui le suivent.
SBRIGANI.	SBRIGANI.
M.	M.
POURCEAUGNAC.	POURCEAUGNAC.
E' bien, quoy?	E' bien, quoi?
qu’eſt-ce?	qu'est-ce?
qui a-t’il?	qui a-t-il?
Au HIdiantre ſoit la ſotte Ville & les ſottes Gens qui y ſont;	Au HIdiantre soit la sotte Ville et les sottes Gens qui y sont;
ne pouvoir faire un pas ſans trouver des Nigauds qui vous regardent?	ne pouvoir faire un pas sans trouver des Nigauds qui vous regardent?
& ſe mettent à rire!	et se mettent à rire!
Eh, Meſſieurs les Badauts, faites vos alfaires, & faiſſez paner res Perſonnes ſans leur rire au nez.	Eh, Messieurs les Badauts, faites vos alfaires, et faissez paner rés Personnes sans leur rire au nez.
Je me donne au Diable, ſi je ne baille un coup de poing au premier que je verray rire.	Je me donne au Diable, si je ne baille un coup de poing au premier que je verrai rire.
BRIGANI.	BRIGANI.
Queiues que c’eſt, Meſſieurs?	Queives que c'est, Messieurs?
que veut dire cela?	que veut dire cela?
à qui en avez-vous?	à qui en avez-vous?
faut-il ſe mocquer ainſi des honneſtes Etrangers qui arrivent icy?	faut-il se moquer ainsi des honnêtes Étrangers qui arrivent ici?
M.	M.
POURCEAUGNAC.	POURCEAUGNAC.
Voila un homme raiſonnable celuy-là.	Voilà un homme raisonnable celui-là.
SBRIGANI.	SBRIGANI.
Quel procedé eſt le voſtre?	Quel procédé est le vôtre?
& qu’avez-vous à rire?	et qu'avez-vous à rire?
M.	M.
POURCEAUGNAC.	POURCEAUGNAC.
Fort bien.	Fort bien.
BRIGANI.	BRIGANI.
Monſieur a-t-il quelque choſe de ridicule en	Monsieur a-t-il quelque chose de ridicule en
M.	M.
TOORCEHOGNAC.	TOORCEHOGNAC.
Oüy.	Oui.
SBRIGANI.	SBRIGANI.
Eſt-il autrement que les autres?	Est-il autrement que les autres?
M.	M.
POURCEAUGNAC.	POURCEAUGNAC.
quis je tortuy ou pond;	quis je tortui ou pond;
BRIGANI.	BRIGANI.
Apprenez à connonde les dens.	Apprenez à connonde les dens.
M.	M.
POURCEAUGNAC.	POURCEAUGNAC.
C’eſt bien dit.	C'est bien dit.
SBRIGANI.	SBRIGANI.
Monſieur eſt d’une mine à reſpecter.	Monsieur est d'une mine à respecter.
A TC GRCEAUGNAC.	À TC GRCEAUGNAC.
Cela eſt vray.	Cela est vrai.
SBRIGINI.	SBRIGINI.
Perſonne de condition.	Personne de condition.
M.	M.
POURCEAUGNAC.	POURCEAUGNAC.
Oüy, Gentilhomme Limoſin.	Oui, Gentilhomme Limosin.
BRIGANI.	BRIGANI.
Homme d’eſprit.	Homme d'esprit.
M.	M.
POURCEAOGNAC.	POURCEAOGNAC.
Qui a étudié en Droict.	Qui a étudié en Droit.
BRIGANI.	BRIGANI.
Il vous fait trop d’honneur, de venir dans võtre Ville.	Il vous fait trop d'honneur, de venir dans votre Ville.
M.	M.
POURCEAUGNAC.	POURCEAUGNAC.
Sans doute.	Sans doute.
SBRIGANI.	SBRIGANI.
Monſieur n’eſt point une perlonne à faire rire.	Monsieur n'est point une perlonne à faire rire.
M.	M.
POURCEAUGNAC.	POURCEAUGNAC.
Aſſurément.	Assurément.
qua aun dMI.	qua aun dMI.
Et quiconque rira de luy, aura affaire à moy.	Et quiconque rira de jours, aura affaire à moi.
M.	M.
POONCEACONRO.	PONCEACONRO.
Monſieur je vous ſuis infiniment obligé.	Monsieur je vous suis infiniment obligé.
SBRIGANI.	SBRIGANI.
Je ſuis fâché, Monſieur, de voir recevoir de la ſorte une Perſonne comme vous, & je vous demande pardon pour la Ville.	Je suis fâché, Monsieur, de voir recevoir de la sorte une Personne comme vous, et je vous demande pardon pour la Ville.
M.	M.
POURCEAUGNAG.	POURCEAUGNAG.
Je ſuis voſtre ſerviteur.	Je suis votre serviteur.
SBRIGANI.	SBRIGANI.
Je vous ay veu ce matin, Monſieur, avec le Coche, lors que vous avez déjeuné;	Je vous ai vu ce matin, Monsieur, avec le Coche, lors que vous avez déjeuné;
& la grace avec laquelle vous mangiez voſtre pain, m’a fait naiſtre d’abord de l’amitié pour vous:	et la grâce avec laquelle vous mangiez votre pain, m'a fait naître d'abord de l'amitié pour vous:
Et comme ie ſçay que vous n’eſtes jamais venu en ce Païs, & que vous y eſtes tout neuf, je ſuis bien aiſe de vous avoir trouvé pour vous offrir mon ſervice à cette arrivée, & vous aider à vous conduire parmy ce Peuple, qui n’a pas par fois pour les honneſtes Gens toute la conſideration qu’il faudroit.	Et comme ie sais que vous n'êtes jamais venu en ce Pays, et que vous y êtes tout neuf, je suis bien aise de vous avoir trouvé pour vous offrir mon service à cette arrivée, et vous aider à vous conduire parmi ce Peuple, qui n'a pas par fois pour les honnêtes Gens toute la considération qu'il faudrait.
M.	M.
POURCEAUGNAC.	POURCEAUGNAC.
C’eſt trop de grace que vous me faites.	C'est trop de grâce que vous me faites.
BRIGANI.	BRIGANI.
Je vous l’ay déja dit;	Je vous l'ai déjà dit;
du moment que je vous ay veu;	du moment que je vous ai vu;
je me ſuis ſenty pour vous de l’inclination.	je me suis senti pour vous de l'inclination.
M.	M.
POURCEAUGNAC.	POURCEAUGNAC.
Je vous ſuis obligé.	Je vous suis obligé.
SBRIGANI.	SBRIGANI.
Voſtre phiſionomie m’a plû	Votre physionomie m'a plu
M POURCEAUGNAC.	M MOURCEAUGNAC.
Ce m’eſt beaucoup d’honneur.	Ce m'est beaucoup d'honneur.
BIGANT.	BIGANT.
y ay veu quelque choſe d’honneſte.	y ai vu quelque chose d'honnête.
M.	M.
POURCEAUGNAC.	POURCEAUGNAC.
Je ſuis voſtre ſerviteur.	Je suis votre serviteur.
SBRIGANI.	SBRIGANI.
Quenque cnel dhnanic.	Quenque cénel dhannanic.
M.	M.
POURCEAUGNAC.	POURCEAUGNAC.
Ah, an.	Ah, an.
SBRIGANI.	SBRIGANI.
He glacieuk	He glacieuk
M.	M.
POURCEAUGNAC.	POURCEAUGNAC.
Ah, ah.	Ah, ah.
De doux.	De doux.
BETIINI.	BETIINI.
M.	M.
POURCEACUNAC.	POURCEACUNAC.
Ah, ah.	Ah, ah.
SBRTGANI.	SBRTGANI.
De majeſtueux.	De majestueux.
M.	M.
POURCEAUGNAC.	POURCEAUGNAC.
Aib, ail	Aib, ail
De franc.	De franc.
SBRIGANI.	SBRIGANI.
M.	M.
POURCEAUGNAC.	POURCEAUGNAC.
Ah, ah.	Ah, ah.
Et de cordial.	Et de cordial.
BRIGANI.	BRIGANI.
B iij	 Bijà
M.	M.
POURCEAUGNAC.	POURCEAUGNAC.
Ah, ah.	Ah, ah.
BRIGANI.	BRIGANI.
Je vous aſſure que je ſuis tout à vous.	Je vous assure que je suis tout à vous.
M1CCRCDIOGNAC, Je vous ay beaucoup d’obligation.	M1CRCDIOGNAC, Je vous ai beaucoup d'obligation.
BRIGANI.	BRIGANI.
C’eſt du fonds du cœur que je parle.	C'est du fond du cœur que je parle.
M.	M.
POURCEAUGNAC.	POURCEAUGNAC.
Je le croy.	Je le crois.
SBRIGANI.	SBRIGANI.
S1 J'avois fhomeur a chit connu de vous, vous ſçauriez que je ſuis un Homme tout à fait fincere.	S1 J'avais fhomeur a chit connu de vous, vous sauriez que je suis un Homme tout à fait sincère.
M.	M.
POURCEAUGNAC.	POURCEAUGNAC.
Je n’en doute point.	Je n'en doute point.
BRIGANI.	BRIGANI.
Ennemy de la fourberie.	Ennemi de la fourberie.
M.	M.
POURCEAUGNAC.	POURCEAUGNAC.
J’en ſuis perſuade.	J'en suis persuade.
BRIGANI.	BRIGANI.
Et qui n’eſt pas capable de deguiler les ſentimens.	Et qui n'est pas capable dé guiler les sentiments.
M.	M.
POURCEAUGNAC.	POURCEAUGNAC.
C’eſt ma penſée.	C'est ma pensée.
S-BRIGANI.	S-BRIGANI.
Vous regardez mon habit qui n’eſt pas fait comme les autres;	Vous regardez mon habit qui n'est pas fait comme les autres;
mais je ſuis originaire de Naples, à voſtre ſervice, & j’ay voulu conſerver un peu & la maniere de s’habiller, & la ſincerité de mon Païs.	mais je suis originaire de Naples, à votre service, et j'ai voulu conserver un peu et la manière de s'habiller, et la sincérité de mon Pays.
M.	M.
POURCEAUGNAC.	POURCEAUGNAC.
C’eſt fort bien fait:	C'est fort bien fait:
l'our moy j’ay voulu me mettre à la mode de la Cour pour la Campagne.	l'our moi j'ai voulu me mettre à la mode de la Cour pour la Campagne.
BRIGANI.	BRIGANI.
Ma foy, cela tous ra umux qu’à tous nos Courtiſans.	Ma foi, cela tous ra umux qu'à tous nos Courtisans.
M.	M.
POURCEAUGNAC.	POURCEAUGNAC.
C’eſt ce que m’a dit mon I’ailieur;	C'est ce que m'a dit mon J'ailieur;
l’habit eſt propre & riche, & il fera du bruil icy.	l'habit est propre et riche, et il fera du bruil ici.
SBRIGANI.	SBRIGANI.
Salis doute;	Salis doute;
n’irez,vous pas au Louvre?	n'irez,vous pas au Louvre?
M.	M.
POURCEAUGNAC.	POURCEAUGNAC.
Il laudia bien aifer fane ma Cour.	Il laudia bien aiffer fane ma Cour.
SBRIGANI.	SBRIGANI.
Le Roy ſera ravy de vous voir.	Le Roi sera ravi de vous voir.
M.	M.
POURCEAUGNAC.	POURCEAUGNAC.
Je le croy.	Je le crois.
RIGANI.	RIGANI.
Avez-vous arreſté un Logis?	Avez-vous arrêté un Logis?
M.	M.
POURCEAUGNAC.	POURCEAUGNAC.
Non, j’allois en chercher un.	Non, j'allais en chercher un.
BRIGANI.	BRIGANI.
Je ſeray bien aiſe d’eſtre avec vous pourcela, & je connois tout ce Païs-cy.	Je serai bien aise d'être avec vous pourcela, et je connais tout ce Pays-cy.
SCENE IV ERTIE, SBRIGANI, M.	SCÈNE IV ERTIE, SBRIGANI, M.
DE POURCEAUGNAC.	DE POURCEAUGNAC.
ERASTE.	ERASTE.
H!	H!
qu’eſt ce-cy?	qu'est ce-cy?
que voy-ie?	que vois-je?
quelle Aheureuſe rencontre!	quelle Aheureuse rencontre!
Monſieur de Pourceaugnat;	Monsieur de Pourceaugnat;
que je luis l'avy de vous voir?	que je luis l'avi de vous voir?
Comment?	Comment?
Il ſemble que vous ayez peine à ine reconnoiſtre?	Il semble que vous ayez peine à iné connaître?
M.	M.
POURCEAUGNAC.	POURCEAUGNAC.
Monſieur, je ſuis voſtre ſerviteur.	Monsieur, je suis votre serviteur.
ERASTE.	ERASTE.
mue ſr pomole que emq’ou na annees m’ayent oſte de voſtre memoire?	mue sr pomole que emq'ou na années m'aient ôte de votre mémoire?
& que vous ne reconnoiſſiez pas le meilleur Amy de toute la Famille des Pourceaugnacs?	et que vous ne reconnaissiez pas le meilleur Ami de toute la Famille des Pourceaugnacs?
M POURCEAUGNAC.	M MOURCEAUGNAC.
Pardonnez-moy, à Sbrig.	Pardonnez-moi, à Sbrig.
Ma foy, ie ne ſçay qui il eſt.	Ma foi, Seigneur ne sais qui il est.
ERASTE.	ERASTE.
Il n’y a pas un Pourceaugnac à Limoges que ie ne connoiſſe, depuis le plus grand juſques au plus petit, ie ne frequentois qu’eux dans le temps que j’y eſtois, & j’avois l’honneur de vous voir preſque tous les jours.	Il n'y a pas un Pourceaugnac à Limoges que je ne connaisse, depuis le plus grand jusques au plus petit, je ne fréquentais qu'eux dans le temps que j'y étais, et j'avais l'honneur de vous voir presque tous les jours.
M.	M.
POURCEAUGNAC.	POURCEAUGNAC.
C’eſt moy qui l’ay receu, Monſleur.	C'est moi qui l'ai reçu, Monsieur.
ERASTE.	ERASTE.
Vous ne vous remettez point mon viſage;	Vous ne vous remettez point mon visage;
ORCEAUGNAC.	ORCEAUGNAC.
Si-fait, à Sbrig.	Si-fait, à Sbrig.
Je ne le connois point.	Je ne le connais point.
ERASTE.	ERASTE.
Vous ne vous reſſouvenez pas que j’ay eu le bon-heur de boire avec vous ie ne Içay combien de fois?	Vous ne vous ressouvenez pas que j'ai eu le bonheur de boire avec vous manière ne Içai combien de fois?
M.	M.
POURCEAUGNAC.	POURCEAUGNAC.
Excuſez-moy.	Excusez-moi.
à Sbrig.	à Sbrig.
Je ne ſçay ce que c’eſt.	Je ne sais ce que c'est.
ERASIE.	ERASIE.
Comment appellez-vous ce Traitteur de Limoges qui fait ſi bonne chere?	Comment appelez-vous ce Traiteur de Limoges qui fait si bonne chère?
M.	M.
POURCEAUGNAC.	POURCEAUGNAC.
Petit Iean!	Petit -Jean!
ERASTE.	ERASTE.
Le voiſa.	Le voisa.
Nous aiions ie pius ſouvent enſemble chez luy nous réjoüir.	Nous aiions ici pius souvent ensemble chez ton nous réjouir.
Comment eſt-ce que vous nommez à Limoges ce Lieu où l’on ſe promene?	Comment est-ce que vous nommez à Limoges ce Lieu où l'on se promène?
M.	M.
POURCEAUGNAC.	POURCEAUGNAC.
Le clmeciere des Mrentas	Le clêmecière des Mrentas
ERASTE.	ERASTE.
Iuſtement;	Justement;
c’eſt où ie paſſois de ſi douces heures à jouyr de voſtre agreable Converſation.	c'est où tu passais de si douces heures à jouir de votre agréable Conversation.
Vous ne vous remettez pas tout cela?	Vous ne vous remettez pas tout cela?
M.	M.
POURCEAUGNAC.	POURCEAUGNAC.
Excuſez moy, ie me le remets.	Excusez -moi, Seigneur me le remets.
à Sbrig.	à Sbrig.
Diable emporte, ſi ie m’en ſouviens.	Diable emporte, si ici m'en souviens.
BRIGANI.	BRIGANI.
Il y a cent choſes comme cela qui paſſent de la teſte.	Il y a cent choses comme cela qui passent de la tête.
ERASTE.	ERASTE.
Einbranon mnoj uone, iotous prie, & reſſerrons les nœuds de noſtre ancienne amitié.	Einbranon mennoj one, jotous prie, et resserrons les nœuds de notre ancienne amitié.
BRIGANI.	BRIGANI.
Voila un Homme qui vous aime fort.	Voilà un Homme qui vous aime fort.
ERASTE.	ERASTE.
Dites-moy un peu des nouvelles de toute la Parenté:	Dites-moi un peu des nouvelles de toute la Parenté:
Comment ſe porte Monſieur vonreni lan qui ere i nomieſte Homme?	Comment se porte Monsieur vonreni lan qui ère y nomieste Homme?
M.	M.
POURCEAUGNAC.	POURCEAUGNAC.
MoR Frere le conlule	MoR Frère le conlule
Oüy.	Oui.
ERASTE.	ERASTE.
M.	M.
POURCEAUGNAC.	POURCEAUGNAC.
Il ſe porte le mieux du monde.	Il se porte le mieux du monde.
ERASTE.	ERASTE.
Certes jen luis ravy.	Certes jen luis ravi.
Et celuy qui eſt de ſi bonne humeur?	Et celui qui est de si bonne humeur?
la.	la.
Monſieur vôtre.	Monsieur votre.
Mon Couſin l’Aſſeſſeur?	Mon Cousin l'Assesseur?
Juſtement.	Justement.
ERASTE.	ERASTE.
M.	M.
PGORCEACUNAC.	PGORCEACUNAC.
Toûjours gay & gaillard.	Toujours gai et gaillard.
ERASTE.	ERASTE.
Ma foy, i'en ay beaucoup de joye.	Ma foi, j'en ai beaucoup de joie.
Monſieur voſtre Oncle?	Monsieur votre Oncle?
Le.	Le.
M.	M.
POURCEAUGNAC.	POURCEAUGNAC.
Ie n’ay point d’Oncle.	Je n'ai point d'Oncle.
ERASTE.	ERASTE.
Vous aviez pourtant en ce temps là.	Vous aviez pourtant en ce temps là.
M.	M.
POURCEAUGNAC.	POURCEAUGNAC.
Non, rien qu’vne Tante.	Non, rien qu'une Tante.
ERASTE.	ERASTE.
C’eit ce que ie voutois dire;	C'it ce que ici voûtais dire;
madame voſtre Tante;	madame votre Tante;
comment ſe porte-t-elle?	comment se porte-t-elle?
M.	M.
POORCEACONAE.	PORCEACONAE.
Elle eſt morte depuis ſix mois.	Elle est morte depuis six mois.
ERASTE.	ERASTE.
Helas la pauvre Femme!	Hélas la pauvre Femme!
elle eſtoit ſi bonne perſonne.	elle était si bonne personne.
A POURELHUGNAC.	À POURELHUGNAC.
Nous avons auſſi mon Neveu le Chanoine, qui a penſé mourir de la petite verole.	Nous avons aussi mon Neveu le Chanoine, qui a pensé mourir de la petite vérole.
ERASTE.	ERASTE.
Quel dommage ç’auroit eſté!	Quel dommage ç'aurait été!
M.	M.
POURCEAUGNAC.	POURCEAUGNAC.
De comonel vous aui.	De comonel vous auj.
ERASTE.	ERASTE.
Vrayement n’ie le coidis !	Vraiment n'ie le coidis !
vn grand Garçon bien fait.	Elle grand Garçon bien fait.
M.	M.
POURCEAUGNAC.	POURCEAUGNAC.
Pas des plus grands.	Pas des plus grands.
ERASTE.	ERASTE.
Non;	Non;
hlais de tanle bien pric.	hlais de tanle bien pric.
M.	M.
POURCEAUGNAC.	POURCEAUGNAC.
Eh oüy.	Eh oui.
ERASTE.	ERASTE.
Qui eſt voſtre Neveu.	Qui est votre Neveu.
oüy.	oui.
M.	M.
POVRCEAVGNAC.	POURCEAUGNAC.
ERASTE.	ERASTE.
Fils de vôtre Frere & de vôtre Sœur.	Fils de votre Frère et de votre Sœur.
M.	M.
POURCEAUGNAC.	POURCEAUGNAC.
Iuſtement.	Justement.
ERASTE.	ERASTE.
Chanoine de l'Eguie demcomment l’appellez-vous?	Chanoine de l'Éguie demcomment l'appelez-vous?
M.	M.
POURCEAUGNAC.	POURCEAUGNAC.
De Saint Eſtienne.	De Saint Étienne.
ERASTE.	ERASTE.
De toira y le lle connois autre.	De toira y le lèle connais autre.
M.	M.
POURCEAUGNAC.	POURCEAUGNAC.
Il dit toute la Parente.	Il dit toute la Parente.
SBRIGANI.	SBRIGANI.
Il vous connoiſt plus que vous ne croyez.	Il vous connaît plus que vous ne croyez.
M.	M.
POURCEAUGNAC.	POURCEAUGNAC.
Ice que je vois, vous avez demeuré long temps dans noſtre Ville.	Ice que je vois, vous avez demeuré long temps dans notre Ville.
ERASTE.	ERASTE.
Deux ans entiers.	Deux ans entiers.
M.	M.
POURCEAUGNAC.	POURCEAUGNAC.
Vous eſtiez donc là quand mon Couſin l’Eleu fit tenir ſon Enfant à Mr noſtre Gouverneur.	Vous étiez donc là quand mon Cousin l'Elev fit tenir son Enfant à Mr nôtre Gouverneur.
ERASTE.	ERASTE.
rrajomiont ouyy prus convié des premiers.	rajomiont oui prus convié des premiers.
M.	M.
POURCEAUGNAC.	POURCEAUGNAC.
Cela fut galant.	Cela fut galant.
Tres-galant.	Trèségalant.
ERASTE.	ERASTE.
M.	M.
POURCEAUGNAC.	POURCEAUGNAC.
C’eſtoit un Repas bien trouſſé.	C'était un Repas bien troussé.
HRASTE.	HRASTE.
Sans doute.	Sans doute.
ERASTE.	ERASTE.
M.	M.
POURCEAUGNAC.	POURCEAUGNAC.
Vous viſtes donc auſſi la querelle que j’eus avec ce Gentilhomme Perigordin?	Vous vîtes donc aussi la querelle que j'eus avec ce Gentilhomme Perigordin?
Oüy.	Oui.
EEISIE.	EEISIE.
M.	M.
POURCEAUGNAC.	POURCEAUGNAC.
Parbleu il trouva à qui parler.	Parbleu il trouva à qui parler.
Ah, ah.	Ah, ah.
ERASTE.	ERASTE.
MPOORUHHOGIAC.	MOPORUHHOGIAC.
Il me donna un ſoufflet, mais je luy dis bien ſon fait.	Il me donna un soufflet, mais je lui dis bien son fait.
ERASIE.	ERASIE.
Aſſurément.	Assurément.
Au reſte, je ne pretens pas que vous preniez d’autre Logis que le mien.	Au reste, je ne prétends pas que vous preniez d'autre Logis que le mien.
M.	M.
POURCEAUGNAC.	POURCEAUGNAC.
Je n’ay garde de.	Je n'ai garde de.
MRASTE.	MRASTE.
Vous mocquez-vous?	Vous moquez-vous?
Je ne ſouffriray point du tout que mon meilleur Amy ſoit autre part que dans ma maiſon.	Je ne souffrirai point du tout que mon meilleur Ami soit autre part que dans ma maison.
4	4
M.	M.
POURCEAUGNAC.	POURCEAUGNAC.
Ce ſeroit vous.	Ce serait vous.
ERASTE.	ERASTE.
Non, le Diable m’emporte vous logerez chez moy.	Non, le Diable m'emporte vous logerez chez moi.
RIGANI.	RIGANI.
Puis qu’il le veut obſtinément, je vous conſeille d’accepter l’offre.	Puis qu'il le veut obstinément, je vous conseille d'accepter l'offre.
ERASTE.	ERASTE.
Où ſont vos hardes ?	Où sont vos hardes ?
M.	M.
POURCEAUGNAC.	POURCEAUGNAC.
Je les ay laiſſées avec mon Valetoù je ſuis deſcendu.	Je les ai laissées avec mon Valetoù je suis descendu.
MMMAAL.	MMAL.
Envoyons les querir par quelqu’un.	Envoyons les quérir par quelqu'un.
M.	M.
POURCEAUGNAC.	POURCEAUGNAC.
Non, je luy ay deffendu de bouger, à moins que j’y fuſſe moy-meſme, de peur de quelque lemiberle	Non, je lui ai défendu de bouger, à moins que j'y fusse moi-même, de peur de quelque lémiberle
SBRIGANI.	SBRIGANI.
C'eit prudemencavie.	C'éit prudemencavie.
M.	M.
POURCEAUGNAC.	POURCEAUGNAC.
Ce Pais-cy eſt un peu ſujet à caution.	Ce Pais-cy est un peu sujet à caution.
ERASTE.	ERASTE.
On voit les Gens d’eſprit en tout.	On voit les Gens d'esprit en tout.
BRIGANI.	BRIGANI.
Je vais accompagner Monſieur, & le rameneray où vous voudrez.	Je vais accompagner Monsieur, et le ramènerai où vous voudrez.
ENASIE.	ENASIE.
Oüy, je ſeray bien aiſe de donner quelques ordres, & vous n’avez qu’à révenir à cette Maifen Me	Oui, je serai bien aise de donner quelques ordres, et vous n'avez qu'à révenir à cette Maifen Me
SBRIGANI.	SBRIGANI.
Nous lommes a vous tont uriſcure.	Nous lommes a vous tont uriscure.
ERASTE.	ERASTE.
Je vous attens avec impatience.	Je vous attends avec impatience.
M.	M.
POURCEAUGNAC.	POURCEAUGNAC.
Voila une connoiſſance où ie ne m’attendois	Voilà une connaissance où tu ne m'attendais
point.	point.
SBRIGANI.	SBRIGANI.
Il a la mine d’eſtre honneſte Homme.	Il a la mine d'être honnête Homme.
ERASTE ſeul.	ERASTE seul.
Ma foy, Monſieur de Pourceaugnac nous vous en donnerons de toutes les façons;	Ma foi, Monsieur de Pourceaugnac nous vous en donnerons de toutes les façons;
les choies lont preparces;	les choies lont préparées;
ce roinuj u’à fraper.	ce roinuj ujà frapper.
SCENE V.	SCÈNE V.
L’APOTIQUAIRE, ERASTE.	L'APOTIQUAIRE, ERASTE.
ERASIE.	ERASIE.
E croy, Monſieur, que vous eſtes le Medecin Là qui l’on eſt venu parler de ma part.	E crois, Monsieur, que vous êtes le Médecin Là qui l'on est venu parler de ma part.
L’APOTIQUAIRE.	L'APOTIQUAIRE.
Non, Monſieur, ce n’eſt pas moy qui ſuis le Medecin, à moy n’appartient pas cét honneur, & je ne iuis qu’Apotiquanle, mpoeiquaire indigne, pour vous ſervir.	Non, Monsieur, ce n'est pas moi qui suis le Médecin, à moi n'appartient pas cet honneur, et je ne juis qu'Apotiquanle, mépoeiquaire indigne, pour vous servir.
ERASTE.	ERASTE.
Et Monſieur le Medecin eſt-il à la Maiſon?	Et Monsieur le Médecin est-il à la Maison?
L’APOTIQUAIRE.	L'APOTIQUAIRE.
Oüy, il eſt là embarraſſé à expedier quelques Malades, & je vais luy dire que vous eſtes icy.	Oui, il est là embarrassé à expédier quelques Malades, et je vais toujours dire que vous êtes ici.
ERASTE.	ERASTE.
Non, ne bougez, j’attendray qu’il ait fait;	Non, ne bougez, j'attendrai qu'il ait fait;
c’eſt pour luy mettre entre les mains certain Parent que nous avons, dont on luy a parlé, & qui ſe trouve attaqué de quelque folie que nous ſerions bien aiſes qu’il pût guerir avant que de le marier.	c'est pour lui mettre entre les mains certain Parent que nous avons, dont on lui a parlé, et qui se trouve attaqué de quelque folie que nous serions bien aises qu'il pût guérir avant que de le marier.
L’APOTIQUAIRE.	L'APOTIQUAIRE.
Je ſçay ce que c’eſt, je ſçay ce que c’eſt, & j’eſtois avec luy quand on luy a parlé de cét affaire.	Je sais ce que c'est, je sais ce que c'est, et j'étais avec lui quand on lui a parlé de cet affaire.
Ma foy, ma foy, vous ne pouviez pas vous adreſſer à un Medecin plus habile;	Ma foi, ma foi, vous ne pouviez pas vous adresser à un Médecin plus habile;
c’eſt un Homme qui ſçait la Medecine à fond, comme je ſçay ma Croix-de-Pardieu;	c'est un Homme qui sait la Médecine à fond, comme je sais ma Croix-de-Pardieu;
& qui, quand on devroit crever, ne démordroit pas d’un iota des regles des Anciens.	et qui, quand on devrait crever, ne démordrait pas d'un jota des règles des Anciens.
Oüy, il ſuit toûjours le grand chemin, le grand chemin, & ne va point chercher midy à quatorze heures;	Oui, il suit toujours le grand chemin, le grand chemin, et ne va point chercher midi à quatorze heures;
& pour tout ror du monde, il ne voudroit pas avoir guery une perſonne avec d’autres remedes que ceux que la Faculté permet.	et pour tout ror du monde, il ne voudrait pas avoir guéri une personne avec d'autres remèdes que ceux que la Faculté permet.
ENASIE.	ENASIE.
Il fait fort bien, un Malade ne doit point vouloir guerir, que la Faculté n’y conſente.	Il fait fort bien, un Malade ne doit point vouloir guérir, que la Faculté n'y consente.
L’APOTIQUAIRE.	L'APOTIQUAIRE.
Ce n’eſt pas parce que nous ſommes grands Amis, que j’en parle;	Ce n'est pas parce que nous sommes grands Amis, que j'en parle;
mais il y a plaiſir, il y a plaiſir d’eſtre ſon Malade:	mais il y a plaisir, il y a plaisir d'être son Malade:
& j’aimerois mieux mourir de ſes remedes, que de guerir de ceux d’un autre:	et j'aimerais mieux mourir de ses remèdes, que de guérir de ceux d'un autre:
car quoy qui puiſſe arriver, on eſt aſſuré que les choſes ſont toûjours dans l’ordre:	car quoi qui puisse arriver, on est assuré que les choses sont toujours dans l'ordre:
& quand on meurt ſous ſa conduite, vos Heritiers n’ont rien à vous reprocher.	et quand on meurt sous sa conduite, vos Héritiers n'ont rien à vous reprocher.
ERASTE.	ERASTE.
C’eſt une grande conſolation pour un Défunt.	C'est une grande consolation pour un Défunt.
L’APOTIQUAIRE.	L'APOTIQUAIRE.
Aſſurément, on eſt bien-aiſe au moins d’eſtre mort methodiquement.	Assurément, on est bienaise au moins d'être mort méthodiquement.
Au reſte, il n’eſt pas de ces Medecins qui marchandent les mala	Au reste, il n'est pas de ces Médecins qui marchandent les mala
dies;	dies;
c’eſt un Homme expeditif, expeditif, qui aime à dépeſcher ſes Malades;	c'est un Homme expéditif, expéditif, qui aime à dépêcher ses Malades;
& quand on a à mourir, cela ſe fait avec luy le plus viſte du monde.	et quand on a à mourir, cela se fait avec lui le plus vite du monde.
ERASTE.	ERASTE.
En enet, i n’eit rien ter que de lorin promptement d’affaires.	En enet, y j'eit rien ter que de lorin promptement d'affaires.
L’APOTI QUAIRE.	L'APOTI QUAIRE.
Cela eſt vray, à quoy boũ tant barguigner & tant tourner autour du pot:	Cela est vrai, à quoi boum tant barguigner et tant tourner autour du pot:
il faut ſçavoir viſtement lo court ou le long d’une maladie.	il faut savoir vite lo court ou le long d'une maladie.
E RASTE.	E RASTE.
Vous avez raiſon.	Vous avez raison.
L’APOTIQUAIRE.	L'APOTIQUAIRE.
Voila déja trois de mes Enfans dont il m’a fait l’honneur de conduire la maladie, qui ſont morts en moins de quatre jours, & qui entre les mains d’un autre, auroient languy plus de trois mois.	Voilà déjà trois de mes Enfants dont il m'a fait l'honneur de conduire la maladie, qui sont morts en moins de quatre jours, et qui entre les mains d'un autre, auraient langui plus de trois mois.
ERASTE.	ERASTE.
Il eſt bon d’avoir des amis comme cela	Il est bon d'avoir des amis comme cela
L’APOTIQUAIRE.	L'APOTIQUAIRE.
Sans doute.	Sans doute.
Il ne me reſte plus que deux Enfans dont il prend ſoin comme des ſiens;	Il ne me reste plus que deux Enfants dont il prend soin comme des siens;
il les traite & gouverne à ſa fantaiſie, ſans que ie me niene derien;	il les traite et gouverne à sa fantaisie, sans que je me niene derien;
a re plus louvent, quand ie reviens de la Ville, je ſuis tout étonné que ie les trouve ſaignez ou purgez par ſon ordre.	a re plus louvent, quand on reviens de la Ville, je suis tout étonné que personne les trouve saignez ou purgez par son ordre.
ERASTA.	ERASTA.
Voila des ſoins fort obligeans.	Voilà des soins fort obligeants.
L'APOTIQUAIRE.	L'APOTIQUAIRE.
Le voicy, le voicy, le voicy qui vient.	Le voici, le voici, le voici qui vient.
C iij	Ç Cijà
SCENE VI.	SCÈNE VI.
PREMIER MEDECIN, UN PAYSAN, UNE PAYSANE, ERASTE, L’APOTIQUAIRE.	PREMIER MÉDECIN, UN PAYSAN, UNE PAYSANE, ERASTE, L'APOTIQUAIRE.
LE PAYSAN.	LE PAYSAN.
Onſieur, il n’en peut plus, & il dit qu’il Mſent dans la teſte les plus grandes douleurs du monde.	Onsieur, il n'en peut plus, et il dit qu'il Msent dans la tête les plus grandes douleurs du monde.
1.	1.
MEDECIN, Le Malade eſt un ſot, d’autant plus que dans la maladie dont il eſt attaqué, ce n’eſt pas la reſte, ſelon Galien, mais la rate qui luy doit faile mal	MÉDECIN, Le Malade est un sot, d'autant plus que dans la maladie dont il est attaqué, ce n'est pas la reste, selon Galien, mais la rate qui lui doit faile mal
LE PAYSAN.	LE PAYSAN.
Quoy que ç’en ſoit, Monſieur, il a toûjours avec cela ſon cours de ventre depuis ſix mois.	Quoi que ç'en soit, Monsieur, il a toujours avec cela son cours de ventre depuis six mois.
2 1.	2 1.
MEDECIN.	MÉDECIN.
Bon, c’eſt ſigne que le dedans ſe dégage.	Bon, c'est signe que le dedans se dégage.
Je l’iray viſiter dans deux ou trois jours, mais s’il mouroit avant ce tempslà, ne manquez pas de m’en donner avis, car il n’eſt pas de la civilité, qu’un Medecin viſtte un Mort.	Je l'irai visiter dans deux ou trois jours, mais s'il mourait avant ce tempslà, ne manquez pas de m'en donner avis, car il n'est pas de la civilité, qu'un Médecin vite un Mort.
LA PAYSANE.	LA PAYSANE.
Mon Pere, Monſieur, ert totjours malade de plus en plus.	Mon Père, Monsieur, ert totjours malade de plus en plus.
1.	1.
MEDECIN.	MÉDECIN.
Ce n’eſt pas ma faute, ie luy donne des remedes, que ne guerit-il?	Ce n'est pas ma faute, Seigneur Seigneur donne des remèdes, que ne guérit-il?
Combien a-t-il eſté ſaigné de fois?	Combien a-t-il été saigné de fois?
LA PAYSANE.	LA PAYSANE.
Quinze, Monſieur, depuis vingt jours.	Quinze, Monsieur, depuis vingt jours.
le MEDECIN.	le MÉDECIN.
Quinze fois ſaigné!	Quinze fois saisgné!
Oüy.	Oui.
LA PAYSANE.	LA PAYSANE.
1.	1.
MEDECIN.	MÉDECIN.
den na guens poie	den na guments poie
LA PAYSANE.	LA PAYSANE.
Non, Monſieur.	Non, Monsieur.
1.	1.
MEDECIN.	MÉDECIN.
C’eſt ſigne que la maladie n’eſt pas dans le ſang Nous le ferons purger autant de fois, pour voir ſi elle n’eſt pas dans les humeurs;	C'est signe que la maladie n'est pas dans le sang Nous le ferons purger autant de fois, pour voir si elle n'est pas dans les humeurs;
& ſi rien ne nous reüſſit, nous l’envoyerons aux Bains.	et si rien ne nous réussit, nous l'envoyerons aux Bains.
L’APOTIQUAIRE.	L'APOTIQUAIRE.
Voila le fin cela, voila le fin de la Medecine.	Voilà le fin cela, voilà le fin de la Médecine.
ERASTE.	ERASTE.
C’eſt moy, Monſieur, qui vous ay envoyé parler ces jours paſſez pour un Parent un peu troublé d’eſprit, que je veux vous donner chez vous, afin de le guerir avec plus de commodité, & qu’il ſoit veu de moins de monde.	C'est moi, Monsieur, qui vous ai envoyé parler ces jours passés pour un Parent un peu troublé d'esprit, que je veux vous donner chez vous, afin de le guérir avec plus de commodité, et qu'il soit vu de moins de monde.
1.	1.
MEDECIN.	MÉDECIN.
Oüv, Monſieur, j’ay déja diſpoſé tout, & promets d’en avoir tous les ſoins imaginables.	Oui, Monsieur, j'ai déjà disposé tout, et promets d'en avoir tous les soins imaginables.
Le voicy.	Le voici.
ERASTE.	ERASTE.
1.	1.
MEDECIN.	MÉDECIN.
La conjoncture eſt tout-à-fait heureuſe, & j’ay icy un Ancien de mes amis avec lequel je ſeray bien-aiſe de conſulter ſa maladie.	La conjoncture est tout-à-fait heureuse, et j'ai ici un Ancien de mes amis avec lequel je serai bienaise de consulter sa maladie.
SCENE VII.	SCÈNE VII.
M.	M.
DE POURCEAUGNAC, mrcitofup MnDLCiN.	DE POURCEAUGNAC, mrcitofup MnDLCiN.
L’APOTIQUAIRE.	L'APOTIQUAIRE.
ERASTE.	ERASTE.
y Ne petite affaire m’eſt ſurvenuë, qui m’o oi ga vous quiteen;	y y petite affaire m'est survenue, qui m'ô oi ga vous quiteen;
mais oraune Perſonne ntre les mains de qui je vous laiſſe, qui aura ſoin pour moy de vous traitter du mieux qu’il luy ſera poſſioie.	mais oraune Personne naître les mains de qui je vous laisse, qui aura soin pour moi de vous traiter du mieux qu'il lui sera possioie.
I MEDECIN.	I MÉDECIN.
Le devoir de ma Profeſſion m’y oblige, & c’eſt aſſez que vous me chargiez de ce ſoin.	Le devoir de ma Profession m'y oblige, et c'est assez que vous me chargiez de ce soin.
M.	M.
POURCEAUGNAC.	POURCEAUGNAC.
C’eſt ſon Maiſtre d'Hoſtel, & il faut que ce ſoit un Homme de qualité.	C'est son Maître d'Hôtel, et il faut que ce soit un Homme de qualité.
1.	1.
M EDECIN.	M MDECIN.
Oüy, je vous aſſure que je traitteray Monſieur methodiquement, & dans toutes les regularitez de noſtre Art.	Oui, je vous assure que je traiterai Monsieur méthodiquement, et dans toutes les régularités de notre Art.
M.	M.
POURCEAUGNAC.	POURCEAUGNAC.
Mon Dieu, il ne faut point tant de ceremonies, & je ne viens pas ict pour incommoder.	Mon Dieu, il ne faut point tant de cérémonies, et je ne viens pas jet pour incommoder.
1.	1.
MEDECIN.	MÉDECIN.
Un tel employ ne me donne que la joye.	Un tel emploi ne me donne que la joie.
RASTE.	RASTE.
voila toujours nx Pittoles d’avance, en attendant ce que j’ay promis.	voilà toujours nx Pittoles d'avance, en attendant ce que j'ai promis.
M.	M.
POURCEAUGNAC.	POURCEAUGNAC.
faſſiez de dépenſe, & que vous envoyez rien acheter pour moy.	fassiez de dépense, et que vous envoyez rien acheter pour moi.
LRRSIE.	LRRSIE.
Mon Dieu, laiſſez faire, ce n’eſt pas pour ce que vous penſez.	Mon Dieu, laissez faire, ce n'est pas pour ce que vous pensez.
M.	M.
POURCEAUGNAC.	POURCEAUGNAC.
Je vous demande de ne me traitter qu’en Amy.	Je vous demande de ne me traiter qu'en Ami.
ERASTE.	ERASTE.
C’eſt ce que je veux faire.	C'est ce que je veux faire.
bas au Medecin.	bas au Médecin.
Je vous recommande ſur tout de ne le point laiſſer ſortir de vos mains, car par fois il veut s’échaper.	Je vous recommande sur tout de ne le point laisser sortir de vos mains, car par fois il veut s'échapper.
1MEDECIN.	1MEDECIN.
Ne vous mettez pas en peine.	Ne vous mettez pas en peine.
ERASTE à M.	ERASTE à M.
P.	P.
Je vous prie de m’excuſer de l’incivilité que je commets.	Je vous prie de m'excuser de l'incivilité que je commets.
M.	M.
POURCEAUGNAC.	POURCEAUGNAC.
Vous vous mocquez, & c’eſt trop de grace que vous me faites.	Vous vous moquez, et c'est trop de grâce que vous me faites.
SCENE VIII.	SCÈNE VIII.
PREMIER MEDECIN, 2.	PREMIER MÉDECIN, 2.
MEDECIN, M.	MÉDECIN, M.
POURCEAUGNAC, L’APOTIQUAIRE.	POURCEAUGNAC, L'APOTIQUAIRE.
L MEDECIIV.	 LÉDECIIV.
E m’eſt beaucoup d’honneur, Monſieur, Od’eſtre choiſi pour vous rendre ſervice.	E m'est beaucoup d'honneur, Monsieur, Od'être choisi pour vous rendre service.
M.	M.
POURCEAUGNAC.	POURCEAUGNAC.
Je ſuis voſtre ſerviteur.	Je suis votre serviteur.
1.	1.
MEDECIN.	MÉDECIN.
Voicy un habile Homme, mon Confrere, avec lequel ie vais conſulter la maniere dont nous vous traſttérons.	Voici un habile Homme, mon Confrère, avec lequel tu vais consulter la manière dont nous vous trasttérons.
M.	M.
POURCEAUGNAC.	POURCEAUGNAC.
Il ne faut point tant de façons, vous dis-je, & je ſuis Homme à me contenter de l’ordinaire.	Il ne faut point tant de façons, vous dis-je, et je suis Homme à me contenter de l'ordinaire.
A MHDECIN.	À MHDECIN.
Allons, des ſieges.	Allons, des sièges.
M.	M.
POURCEAUGNAC.	POURCEAUGNAC.
Voila, pour un jeune Homme, des Domeſtiques bien lugubres!	Voilà, pour un jeune Homme, des Domestiques bien lugubres!
2.	2.
MEDECIN.	MÉDECIN.
Allons, Monſieur, prenez voſtre place, Monſieur.	Allons, Monsieur, prenez votre place, Monsieur.
Lors Lors qu’ils ſont aßtis, let deux Medecins luy prennent chacun vne main, pour luy taſter le poulx.	Lors Lors qu'ils sont assis, let deux Médecins y prennent chacun une main, pour lui tâter le poulx.
M.	M.
POURCEAUGNAC Preſentant ſes mains.	POURCEAUGNAC Prentant ses mains.
oide mes fuiore caret.	oide mes fuiore caret.
Voyant qu’ils luy taſtent le poulx.	Voyant qu'ils avait tâtent le poulx.
Que veut dire cela?	Que veut dire cela?
I.	I.
MEDECIN.	MÉDECIN.
Mangez.	Mangez.
vous bien, Monſieur?	vous bien, Monsieur?
M.	M.
POURCEAUGNAC.	POURCEAUGNAC.
Oüy, & boy encore mieux.	Oui, et boy encore mieux.
1.	1.
MEDECIN.	MÉDECIN.
Tant pis, cette grande appetition du froid & de l’humide, eit vne iuication de la chaleur & ſechereſſe qui eſt au dedans.	Tant pis, cette grande appétition du froid et de l'humide, eit toujours juication de la chaleur et sécheresse qui est au dedans.
Dormez-vous fort?	Dormez-vous fort?
M.	M.
POURCEAUGNAC.	POURCEAUGNAC.
Oüy quand i’ay bien ſoupé,	Oui quand j'ai bien soupé,
l MEDHCIN.	 MEDHCIN.
Faites-vous des ſonges?	Faites-vous des songes?
M.	M.
POURCBAOONAC.	POURCBAONAC.
Quelquefois.	Quelquefois.
1.	1.
MEDECIN.	MÉDECIN.
De quelle nature ſont-ils;	De quelle nature sont-ils;
MI.	MI.
POURCEAUGNAC.	POURCEAUGNAC.
De la nature des ſonges.	De la nature des songes.
Quelle diable de converſation eſt-ce là?	Quelle diable de conversation est-ce là?
1.	1.
MEDECIN.	MÉDECIN.
Vos dejections, comment ſont-elles?	Vos déjections, comment sont-elles?
M.	M.
POURCEAUGNAC.	POURCEAUGNAC.
Ma foy, ie ne comprens rien à toutes ces queſtions, & ie veux plûtoſt boire vn coup	Ma foi, Seigneur ne comprends rien à toutes ces questions, et personne veux plutôt bête un coup
1.	1.
MEDECIN.	MÉDECIN.
Un peu de patience nous allons raiſonner ſur voſtre affaire devant vous, & nous le ferons en François, pour eſtre plus intelligibles.	Un peu de patience nous allons raisonner sur votre affaire devant vous, et nous le ferons en Français, pour être plus intelligibles.
M.	M.
POURCEAUGNAC.	POURCEAUGNAC.
Quer grund lamomimiimodaue n pour manger vn morceau?	Quer grund lamomimiimodave n pour manger un morceau?
1.	1.
MEDECIN.	MÉDECIN.
Comme ainſi ſoit qu’on ne puiſſe guerir une maladie, qu’on ne la connoiſſe parfaitement, & qu’on ne la puiſſe parfaitement connoiſtre, ſans en bien établir l’idée en particulier & la veritable eſpece, par ſes ſignes diagnoſtiques & prognoſtiques;	Comme ainsi soit qu'on ne puisse guérir une maladie, qu'on ne la connaisse parfaitement, et qu'on ne la puisse parfaitement connaître, sans en bien établir l'idée en particulier et la véritable espèce, par ses signes dives et diagnostiques;
vous me permettrez, Monſieur noſtre Ancien, d’entrer en conſideration de la maladie dont il s’agit, avant que de toucher à la therapeutique, & aux remedes qu’il nous conviendra faire pour la parfaite curation d’icelle.	vous me permettrez, Monsieur notre Ancien, d'entrer en considération de la maladie dont il s'agit, avant que de toucher à la thérapeutique, et aux remèdes qu'il nous conviendra faire pour la parfaite curation d'icelle.
Je dis donc, Monſieur, avec voſtre permiſſion, que nôtre malade icy preſent, eſt mal-heureuſement attaqué, affecté, poſſedé, travaillé de cette ſorte de folie, que nous nommons fort bien, mélancolie hypocondriaque, eſpece de folie tres-fâcheuſe, & qui ne demande pas moins qu’un Eſculape comme vous, conſommé dans noſtre Art;	Je dis donc, Monsieur, avec votre permission, que notre malade ici présent, est malheureusement attaqué, affecté, possédé, travaillé de cette sorte de folie, que nous nommons fort bien, mélancolie hypocondriaque, espèce de folie très-fâcheuse, et qui ne demande pas moins qu'un Esculape comme vous, consommé dans notre Art;
vous, dis-je, qui avez blanchy, comme on dit, ſous le harnois, & auquel il en a tant paſſé par les mains de toutes façons.	vous, dis-je, qui avez blanchi, comme on dit, sous le harnais, et auquel il en a tant passé par les mains de toutes façons.
Je l’appelle mélancolie hypocondriaque, pour la diſtinguer des deux autres;	Je l'appelle mêlancolie hypocondriaque, pour la distinguer des deux autres;
car le celebre Galien établit doctement à ſon ordinaire troïs eſpeces de cette maladie que nous nommons mélancolie, ainſi appellée, non ſeulement par les Latins, mais encore par les Grecs;	car le célèbre Galien établit doctement à son ordinaire troïs espèces de cette maladie que nous nommons mélancolie, ainsi appelée, non seulement par les Latins, mais encore par les Grecs;
ce qui eſt bien à remarquer pour nôtre affaire:	ce qui est bien à remarquer pour notre affaire:
La premiere, qui vient du propre vice du cerveau;	La première, qui vient du propre vice du cerveau;
la ſeconde, qui vient de tout le ſang, fait & rendu atrabilaire;	la seconde, qui vient de tout le sang, fait et rendu atrabilaire;
la troiſiéme appellée hy pocondriaque, qui eſt la noſtfe, laquelle procede du vice de quelque partie du bas ventre, & de la region inferieure;	la troisième appelée hy pondriaque, qui est la noûtée, laquelle procède du vice de quelque partie du bas ventre, et de la région inférieure;
mais particulierement de la rate, dont la chaleur & l’inflamation porte au cerveau de noſtre Malade beaucoup de fuligines épaiſſes & craſſes, dont la vapeur noire & maligne, cauſe dépravation aux fonctions de la faculté princeſſe, & fait la maladie, dont par noſtre raiſonnement il eſt manifeſtement atteint & convaincu.	mais particulièrement de la rate, dont la chaleur et l'inflamation porte au cerveau de notre Malade beaucoup de fuligines épaisses et crasses, dont la vapeur noire et maligne, cause dépravation aux fonctions de la faculté princesse, et fait la maladie, dont par notre raisonnement il est manifestement atteint et convaincu.
Qu’ainſi ne ſoit, pour diagnoſtique inconteſtable de ce que ie dis, vous n’avez qu’à conſiderer ce grand ſerieux que vous voyez;	Qu'ainsi ne soit, pour diagnostique incontestable de ce que je dis, vous n'avez qu'à considérer ce grand sérieux que vous voyez;
cette triſteſſe accompagnée de crainte & de défiance, ſignes pathognomoniques & individuels de cette maladie, ſi bien marquée chez le Divin vieillard Hipocrate;	cette tristesse accompagnée de crainte et de défiance, signes pathognomoniques et individuels de cette maladie, si bien marquée chez le Divin vieillard Hipocrate;
cette phiſionomie, ces yeux rouges & hagards, cette grande barbe, cette habitude du corps, menuë greſle, noire & veluë, leſquels ſignes le dénotent tres affecté de cette maladie par laps de temps naturaliſée.	cette physionomie, ces yeux rouges et hagards, cette grande barbe, cette habitude du corps, menue grêle, noire et velue, lesquels signes le dénotent très affecté de cette maladie par laps de temps naturalisée.
envieillie, habituée, & ayant droit de bourgeoiſie chez luy, pourroit bien dégenerer, ou en manie, ou en phtiſie, ou en apoplexie, ou même en fine phreneſie & fureur.	envieillie, habituée, et ayant droit de bourgeoisie chez lui, pourrait bien dégénérer, ou en manie, ou en phtisie, ou en apoplexie, ou même en fine phrénésie et fureur.
Tout cecy ſuppoſé, puis qu’une maladie bien connuë eſt à demy guerie, car ignoti nulla eſt curatio morbi, il ne vous ſera pas difficile de convenir des remedes que nous devons faire à Monſieur.	Tout ceci supposé, puis qu'une maladie bien connue est à demi guérie, car ignoti nulla est curatio morbi, il ne vous sera pas difficile de convenir des remèdes que nous devons faire à Monsieur.
Premierement, pour remedier à certe pletore obturante, & à cette cacochimie luxuriante par tout le corps, ie ſuis d’avis qu’il ſoit phlebotomiſé liberalement, c’eſt à dire que les ſaignées ſoient frequentes & plantureuſes:	Premièrement, pour remédier à certe pletore obturante, et à cette cacochimie luxuriante par tout le corps, je suis d'avis qu'il soit phlébotomisé libéralement, c'est à dire que les saignées soient fréquentes et plantureuses:
En premier lieu de la baſilique, puis de la cephalique;	En premier lieu de la basilique, puis de la céphalique;
& meſme ſi le mal eſt opiniaſtre, de luy ouvrir la veine du front, & que l’ouverture ſoit large, afin que le gros ſang puiſſe ſortir;	et même si le mal est opiniâtre, de lui ouvrir la veine du front, et que l'ouverture soit large, afin que le gros sang puisse sortir;
& en meſme temps, de le purger, deſopiler, & euacuer par purgatifs propres & convenables;	et en même temps, de le purger, désopiler, et évacuer par purgatifs propres et convenables;
c’eſt à dire par cholagogues, melanogogues, & catera;	c'est -à -dire par cholagogues, melanogogues, et catera;
& comme la veritable ſource de tout Ie mal, eſt ou une humeur craſſe & feculente, ou une vapeur noire & groſſiere qui obſcurcit, infecte & ſalit les eſprits animaux, il eſt à propos en ſuite qu’il prenne un bain d’eau pure & nette, avec force petir lait clair, pour purifier par l’eau la feculence de l’humeur craſſe, & éclaircir par le lait clair la noirceur de cette vapeur;	et comme la véritable source de tout Je mal, est ou une humeur crasse et féculente, ou une vapeur noire et grossière qui obscurcit, infecte et salit les esprits animaux, il est à propos en suite qu'il prenne un bain d'eau pure et nette, avec force petir lait clair, pour purifier par l'eau la féculence de l'humeur crasse, et éclaircir par le lait clair la noirceur de cette vapeur;
mais avant toute choſe, ie trouve qu’il eſt bon de le réjoüir par agreables Converſations, Chants, & Inſtrumens de Muſique, à quoy il n’y a pas d’inconvenientde joindre des Danſeurs, afin que leurs mouvemens, diſpoſition & agilité puiſſent exciter & ré veiller la pareſſe de ſes eſprits engourdis, qui occaſionne l’épaiſſeur de ſon ſang, d’où procede la maladie.	mais avant toute chose, je trouve qu'il est bon de le réjouir par agréables Conversations, Chants, et Instruments de Musique, à quoi il n'y a pas d'inconvenientde joindre des Danseurs, afin que leurs mouvements, disposition et agilité puissent exciter et ré veiller la paresse de ses esprits engourdis, qui occasionne l'épaisseur de son sang, d'où procède la maladie.
Voila les remedes que j’imagine, auſquels pour	Voilà les remèdes que j'imagine, auxquels pour
ront eſtre adjoûtez beaucoup d’autres meilleurs par nôſtre Maiſtre & Ancien, ſuivant l’experience, jugement, lumiere & ſuffiſance qu’il s’eſt acquiſe dans noſtre Art.	ront être ajoutez beaucoup d'autres meilleurs par nôtre Maître et Ancien, suivant l'expérience, jugement, lumière et suffisance qu'il s'est acquise dans notre Art.
Dixi.	Dixi.
2.	2.
MEDECIN.	MÉDECIN.
A Dieu ne plaiſe, Monſieur, qu’il me tombe en penſée d’ajoûter rien à ce que vous venez de dire:	À Dieu ne plaise, Monsieur, qu'il me tombe en pensée d'ajouter rien à ce que vous venez de dire:
vous avez ſi bien diſcouru ſur tous les ſignes, les ſimptoſmes & les cauſes de la maladie de Monſieur;	vous avez si bien discouru sur tous les signes, les symptômes et les causes de la maladie de Monsieur;
le raiſonnement que vous en avez fait eſt ſi docte & ſi beau, qu’il eſt impoſſible qu’il ne ſoit pas fou, & mélancolique hypocondriaque;	le raisonnement que vous en avez fait est si docte et si beau, qu'il est impossible qu'il ne soit pas fou, et mélancolique hypocondriaque;
& quand il ne le ſeroit pas, il faudroit qu’il le devint, pour la beauté des choſes que vous avez dites, & la juſteſſe du raiſonnement que vous avez fait.	et quand il ne le serait pas, il faudrait qu'il le devint, pour la beauté des choses que vous avez dites, et la justesse du raisonnement que vous avez fait.
Oüy, Monſieur, vous avez dépeint fort graphiquément, graphice depinxiſti;	Oui, Monsieur, vous avez dépeint fort graphiquément, graphice dépinxisti;
tout ce qui appartient à cette maladie;	tout ce qui appartient à cette maladie;
il ne ſe peut rien de plus doctement, ſagement, ingenieuſement conçeu, penſé, imaginé, que ce que vous avez prononcé au ſujet de ce mal, ſoit pour la diagnoſe, ou la prognoſe, ou la therapie;	il ne se peut rien de plus doctement, sagement, ingénieusement conçu, pensé, imaginé, que ce que vous avez prononcé au sujet de ce mal, soit pour la diagnose, ou la prognose, ou la thérapie;
& il ne me reſte rien icy, que de feliciter Monſieur, d’eſtre tombé entre vos mains, & de luy dire qu’il eſt trop heureux d’eſtre fou, pour éprouver l’efficace & la douceur des remedes que vous avez ſi judicieuſement propoſez:	et il ne me reste rien ici, que de féliciter Monsieur, d'être tombé entre vos mains, et de lui dire qu'il est trop heureux d'être fou, pour éprouver l'efficace et la douceur des remèdes que vous avez si judicieusement proposez:
Je les approuve tous, manibus & pedibus deſcendo in tuam ſententiam.	Je les approuve tous, manibus et pédibus descendo in tuam sententiam.
Tout ce que j’y voudrois, c’eſt de faire les ſaignées & les purgations en nombre impair, Numero Deus impari gaudet:	Tout ce que j'y voudrais, c'est de faire les saignées et les purgations en nombre impair, Numero Deus impari gaudet:
de prendre le lait clair avant le bain;	de prendre le lait clair avant le bain;
de luy compoſer un fronteau où il entre du ſel;	de grands composer un fronteau où il entre du sel;
le ſel eſt ſimbole de la ſageſſe:	le sel est symbole de la sagesse:
de faire blanchir les murailles de ſa chambre, pour diſſiper les tenebres de ſes eſprits, Album eſt diſgregativum viſus, & de luy donner tout à l’heure un petit Lavement, pour ſervir de prélude & d’introduction à ces judicieux remedes, dont s’il a à guerir il doit recevoir du ſoulagement.	de faire blanchir les murailles de sa chambre, pour dissiper les ténèbres de ses esprits, Album est disgrégativum visus, et de lui donner tout à l'heure un petit Lavement, pour servir de prude et d'introduction à ces judicieux remèdes, dont s'il a à guérir il doit recevoir du soulagement.
Faſſe le Ciel, que ces remedes, Monſieur, qui ſont les voſtres, reüſ.	Fasse le Ciel, que ces remèdes, Monsieur, qui sont les vôtres, réus.
fiſſent au Malade ſelon noſtre intention.	fissent au Malade selon notre intention.
M TCORCEAUGNAC.	M TCORCEAUGNAC.
Meſſieurs, il y a une heure que ie vous écoute.	Messieurs, il y a une heure que je vous écoute.
Eſt-ce que nous jouons icy dne comedle.	Est-ce que nous jouons ici dne comédèle.
1.	1.
MEDECIN.	MÉDECIN.
Non, Monſieur, nous ne joüons point.	Non, Monsieur, nous ne jouons point.
M.	M.
POURCEAUGNAC.	POURCEAUGNAC.
Qu’eſt-ce que tout cecy?	Qu'est-ce que tout ceci?
& que voulez.	et que voulez.
vous dire avec voſtre galimatias & vos ſottiſes?	vous dire avec votre galimatias et vos sottises?
L MEDECIN.	 MÉDECIN.
Bon, dire des injures.	Bon, dire des injures.
Voila un diagnoſtique qui nous manquoit pour la confirmation de ſon mal, & cecy pourroit bien tourner en manie.	Voilà un diagnostique qui nous manquait pour la confirmation de son mal, et ceci pourrait bien tourner en manie.
M.	M.
POURCEAUGNAC.	POURCEAUGNAC.
Avec qui m’a-t-on mis icy?	Avec qui m'a-t-on mis ici?
Il cratne ueux on drors jorst.	Il cratne ouveux on drors jorst.
1.	1.
MEDECIN.	MÉDECIN.
Autre diagnoſtique:	Autre diagnostique:
La ſputation frequente.	La sputation fréquente.
M.	M.
POURCE AUGNAC.	POURCE AUGNAC.
Laiſſons cela, & ſortons d’icy.	Laissons cela, et sortons d'ici.
1.	1.
MEDECIN.	MÉDECIN.
Autre encor:	Autre encor:
L’inquietude de changer de place.	L'inquiétude de changer de place.
M.	M.
POURCEAUGNAC Qu’eſt-ce donc que toute cette affaire, & que me voulez-vous?	POURCEAUGNAC Qu'est-ce donc que toute cette affaire, et que me voulez-vous?
1.	1.
MEDECIN.	MÉDECIN.
vous guerir , iciompolure qui nous a eſté donné.	vous guérir , iciompolure qui nous a été donné.
M.	M.
POVROLATONAC.	POUROLATONAC.
Me guerir?	Me guérir?
P.	P.
MEDECIN.	MÉDECIN.
Oüy.	Oui.
M.	M.
POURCEAUGNAC.	POURCEAUGNAC.
Parbleu ie ne ſuis pas malade.	Parbleu Peu ne suis pas malade.
1LICIN.	1LICIN.
Mauvais ſigne, lors qu’un Malade ne ſent pas ſon mal.	Mauvais signe, lors qu'un Malade ne sent pas son mal.
Je vous dis que ie me porte bien	Je vous dis que personne me porte bien
1.	1.
MEDECIN.	MÉDECIN.
Nous ſçavons mieux que vous comment vous vous portez, & nous ſommes Medecins, qui voyons clan daſls voltre conntieution.	Nous sçavons mieux que vous comment vous vous portez, et nous sommes Médecins, qui voyons clan dasls voltre ion.
M.	M.
POURCEAUGNAC.	POURCEAUGNAC.
Si vous eſtes Medecins, ie n’ay que faire dé vous;	Si vous êtes Médecins, Seigneur n'ai que faire de vous;
& ie me mocque de la Medecine.	et Elle me moque de la Médecine.
1.	1.
MEDECIN.	MÉDECIN.
Hon, hon?	Hon, hon?
voicy un Homme plus fou que nous ne pemons.	voici un Homme plus fou que nous ne pemons.
M.	M.
POURCEAUGNAC.	POURCEAUGNAC.
Mon Pere & ma Mere n’ont jamais voulu de remedes, & ils ſont morts tous deux ſans l’aſſiſtance des Medecins.	Mon Père et ma Mère n'ont jamais voulu de remèdes, et ils sont morts tous deux sans l'assistance des Médecins.
I.	I.
MEDECIN.	MÉDECIN.
Ie ne m’étonne pas s’ils ont engendré un 2 17 Fils qui eſt inſenſé.	Je ne m'étonne pas s'ils ont engendré un 2 17 Fils qui est insensé.
Allons, procedons à la cucuration, & par Ia douceur exhilarante de l’harmonie, adouciſſons, lenifions & accoiſons l’aigreur de ſes eſprits, que je voy preſts à s’enflaH-T.	Allons, procédons à la cucuration, et par Ia douceur exhilarante de l'harmonie, adoucissons, lénifions et accoisons l'aigreur de ses esprits, que je vois prêts à s'enflaH-T.
SCENE IX.	SCÈNE IX.
M.	M.
POURCEAUGNAC.	POURCEAUGNAC.
Ue Diable eſt-ce là?	Que Diable est-ce là?
Les Gens de ce Païs- Ocy ſont-ils inſenſez?	Les Gens de ce Pays- Je sont-ils insensés?
Je n’ay jamais rien deu de tel, a jen j comprens nen uu tout.	Je n'ai jamais rien dev de tel, a jen j comprends nen u tout.
SCENE X.	SCÈNE X.
DEUX MUSICIENS Italiens, mhetuieins croteſques, ſuivis de TUIT MATASSINS, chantent ces Paroles, ſoûtenuës de la Symphonie d’un mélange d’Inſtruments.	DEUX MUSICIENS Italiens, mhétuieins crotesques, suivis de TUIT MATASSINS, chantent ces Paroles, soutenues de la Symphonie d'un mélange d'Instruments.
Les deux Muſiciens.	Les deux Musiciens.
On di, bon di, bon di, DNon vi laſciate uccidere D'ol dolor malinconico, Noi vi faremo ridere Col noſtro canto harmonico.	On di, bon di, bon di, DNon vi lasciate uccière D'ol dolor malinconico, Noi vi faremo ridere Col nostro canto harmonico,
Sol'per guarirui Saume benuil qui Bon di, bon di, bon di.	Sol'per guérirui Saume bénuil qui Bon di, bon di, bon di.
1.	1.
Muſicien.	Musicien.
Altro non è la pazzia Che malinconia.	Altro non la pazzia Che malinconia.
Il malato Nou è diſperate.	Il malato Nou ète disperate.
ut ebir Bllai an peucamaasna, Altro non è la paZia Che malinconia.	ut ébir Bllai an peucamazna, Altro non aient la passia Che malinconia.
2.	2.
Muſicien.	Musicien.
Sû, cancate, ballate, ridete Et ſe far meglio volete, Quando ſentite il deliro vicino.	Su, cancate, ballate, ridète Et se far meglio vole, Quando sentite il déliro vicino.
Pigliate del vino, Et qualche volta un pe pe di tabat Alegramente Monſu de Pourceaugnac.	Pigliate dél vino, Et qualche volta un pe di tabat Alégramente Monsieur de Pourceaugnac.
SCENE XI.	SCÈNE XI.
L’APOTIQUAIRE, M.	L'APOTIQUAIRE, M.
POUR.	POUR.
CEAUCNAC.	CEAUCNAC.
L’APOTIQUAIRE.	L'APOTIQUAIRE.
Onſieur, voicy un petit remede, un petit IIremede, qu’il vous faut prendre, s’il vous plaiſt, s’il vous plaiſt.	Onsieur, voici un petit remède, un petit JIremède, qu'il vous faut prendre, s'il vous plaît, il vous plaît.
MI.	MI.
POURCEAUGNAC.	POURCEAUGNAC.
Comment?	Comment?
je n’ay que faire de cela.	je n'ai que faire de cela.
BhROoiaM Il a eſté ordonné.	BhROoiaM Il a été ordonné.
Monſieur il a eſté oldonné	Monsieur il a été oldonné
M.	M.
POURCEAUGNAC.	POURCEAUGNAC.
Ah, que de bruit.	Ah, que de bruit.
L’APOTIQUAIRE.	L'APOTIQUAIRE.
Prenez le, Monſieut, prenez-le, il ne vous fera point de mal.	Prenez le, Monsieut, prenez-le, il ne vous fera point de mal.
il ne vous fera point de mal.	il ne vous fera point de mal.
Ah !	Ah !
M.	M.
POURCEAUGNAC.	POURCEAUGNAC.
L’APOTIQUAIRE.	L'APOTIQUAIRE.
C’eſt un petit Cliſtere, un petit Cliſtere, benin, benin, prenez, prenez, Monſieur, c’eſt pour déterger, pour déterger, déterger.	C'est un petit Cliste, un petit Clistère, bénin, bénin, prenez, prenez, Monsieur, c'est pour déterger, pour déterger, déterger.
Les deux Muſiciens accompagnez des Mataſſins & des Inſtrumens, dancent à l’entour de M.	Les deux Musiciens accompagnés des Matassins et des Instruments, dancent à l'entour de M.
de rourceaugnac, & s’arreſtans devant luy, chantent, Piglia lo ſú Signor Monſu, Piglia-lo piglia-lo piglia lo ſû, Che von ti fara male.	de rourceaugnac, et s'arrêts devant ici, chantent, Piglia lo somme Signor Monsu, Piglia-lo piglia-l piglia lo sû, Che von ty fara male.
Piglia-lo ſu, queſto ſervitiale, Piglia lo ſû Signor Monſu, Piglia-lo, piclia-lo, piglia lo ſu.	Piglia-lo su, questo servitiale, Piglia lo sû Signor Monsu, Piglia-lo, piclia-lo, piglia lo su.
M.	M.
POURC.	POURC.
fuyant.	fuyant.
Allez-vous-en au Diable.	Allez-vous-en au Diable.
L'Apotiquaire, les deux Muſiciens, & les Mataſſins le ſuivent, tous une Seringue à la main.	L'Apotiquaire, les deux Musiciens, et les Matassins le suivent, tous une Seringue à la main.
Fin du premier Acte.	Fin du premier Acte.
SCENE PREMIERE.	SCÈNE PREMIÈRE.
SBRIGANI, 1.	SBRIGANI, 1.
MEDECIN.	MÉDECIN.
1.	1.
MEDECIN.	MÉDECIN.
L a forcé tous les obſtacles que ’avois mis;	L a forcé tous les obstacles que 'avais mis;
& s’eſt dérobé aux remedes que je commençois de luy faire.	et s'est dérobé aux remèdes que je commençais de jours faire.
DRTGNNI.	DRTGNNI.
C’eſt eſtre bien ennemy de ſoy-meſme, que de fuir des remedes auſſi ſalutaires que les jôtres.	C'est être bien ennemi de soi-même, que de fuir des remèdes aussi salutaires que les jôtres.
1.	1.
MEDECIN.	MÉDECIN.
Marque d’un cerveau démonté, & d’une raiſon dépravée, que de ne vouloir pas guerir.	Marque d'un cerveau démonté, et d'une raison dépravée, que de ne vouloir pas guérir.
BRIGANI.	BRIGANI.
Vous l’auriez guery haut la main.	Vous l'auriez guéri haut la main.
1.	1.
MEDECIN.	MÉDECIN.
Moy, je n’entens point les perdre, & pretens le guerir en dépit qu’il en ait.	Moi, je n'entends point les perdre, et prétends le guérir en dépit qu'il en ait.
Il eſt lié, & engagé à mes remedes, & je veux le faire ſaiſir où je le trouveray, comme Deſerteur de la Medecine, & Iufracteur de mes Ordonnances.	Il est lié, et engagé à mes remèdes, et je veux le faire saisir où je le trouverai, comme Déserteur de la Médecine, et Jufracteur de mes Ordonnances.
SBRIGANI.	SBRIGANI.
Vous avez raiſon, vos remedes eſtoient un coup ſeur, & c’eſt de l’argent qu’il vous vole.	Vous avez raison, vos remèdes étaient un coup sûr, et c'est de l'argent qu'il vous vole.
L.	L.
MEDECIIV.	MÉDECIV.
Où puis-je en avoir des nouvelles?	Où puis-je en avoir des nouvelles?
BRIGANI.	BRIGANI.
Chez le bon Homme Oronte, aſſurément, dont il vient épouſer la Fille, & qui ne ſçachant rien de l’infirmité de ſon Gendre futur, voudra peut eſtre lonuiten do conelure le Mariage.	Chez le bon Homme Oronte, assurément, dont il vient épouser la Fille, et qui ne sachant rien de l'infirmité de son Gendre futur, voudra peut -être lonuiten do conelure le Mariage.
1.	1.
MEDECIN.	MÉDECIN.
Je vais luy parler tout à iſſeure.	Je vais lui parler tout à issure.
BRIGANI.	BRIGANI.
Vous ne ferez point mal.	Vous ne ferez point mal.
1.	1.
MEDECIN.	MÉDECIN.
Il eſt hypothequé à mes Conſultations;	Il est hypothéqué à mes Consultations;
& un Malade ne ſe mocquera pas d’un Medecin.	et un Malade ne se moquera pas d'un Médecin.
SBRIGANI.	SBRIGANI.
C’eſt fort bien dit à vous;	C'est fort bien dit à vous;
& ſi vous m’en croyez, vous ne ſouffrirez point qu’il ſe marie, que vous ne l’ayez penſé tout voſtre ſoû.	et si vous m'en croyez, vous ne souffrirez point qu'il se marie, que vous ne l'ayez pensé tout votre souffrirez.
1.	1.
MEDECIN.	MÉDECIN.
Laiſſez-moy faire.	Laissez-moi faire.
SBRIGANI.	SBRIGANI.
Je vais de mon coſté dreſſer une autre Battetie, & le Beau-pere eſt auſſi dupe que legiendre.	Je vais de mon côté dresser une autre Battétie, et le Beau-père est aussi dupe que légiendre.
SCENE II.	SCÈNE II.
ORONTE , I.	ORONTE , I.
MEDECIN	MÉDECIN
1.	1.
MEDECIN.	MÉDECIN.
Ous arer, monueur, un certain MonV ſieur de Pourceaugnac, qui doit épouſer voſtre Fille.	Ous arer, monueur, un certain MonV sieur de Pourceaugnac, qui doit épouser votre Fille.
ORONIE.	ORONIE.
Oüy, je l’attens de Limoges, & il devroit eſtre arrivé.	Oui, je l'attends de Limoges, et il devrait être arrivé.
1.	1.
MEDECIN.	MÉDECIN.
Auſſi l’eſt-il, & il s’en eſt fuy de chez moy, aprés y avoir eſté mis;	Aussi l'est-il, et il s'en est fui de chez moi, après y avoir été mis;
mais je vous défens de la part de la Medecine, de proceder au mariage que vous avez conclu, que je ne l’aye deuëment preparé pour cela, & mis en eſtat de procréer des Enfans bien conditionnés & de corps & d’eſprit.	mais je vous défends de la part de la Médecine, de procéder au mariage que vous avez conclu, que je ne l'aie deuëment préparé pour cela, et mis en état de procréer des Enfants bien conditionnés et de corps et d'esprit.
ORONTE.	ORONTE.
Comment donc?	Comment donc?
1.	1.
MEDECIN Voſtre pretendu Gendre a eſté conſtitué mon Malade:	MÉDECIN Votre prétendu Gendre a été constitué mon Malade:
Sa Maladie qu’on m’a donnée à guerir, eſt un meuble qui m’appartient, & que je compte entre mes effets;	Sa Maladie qu'on m'a donnée à guérir, est un meuble qui m'appartient, et que je compte entre mes effets;
& je vous declare que je ne preteus pomt quir ſe marie, qu’au qu’au prealable il n’ait ſatisfait à la Medecine, & ſuby les remedes que je luy ay ordonnez.	et je vous déclare que je ne préteus pompt qui se marie, qu'au qu'au préalable il n'ait satisfait à la Médecine, et subi les remèdes que je lui ay ordonnez.
ORONTE.	ORONTE.
Il a quelque mal?	Il a quelque mal?
ORONVEE.	ORONVE.
Et quel mal, s’il vous plaiſt?	Et quel mal, s'il vous plaît?
I.	I.
MEDECIN, Ne vous en mettezpas en peine,	MÉDECIN, Ne vous en mettezpas en peine,
ORONTE.	ORONTE.
Eſt-ce quelque mal.	Est-ce quelque mal.
1.	1.
MEDECIN.	MÉDECIN.
Les Medecins ſont obligez au ſecret:	Les Médecins sont obligés au secret:
Il ſuffit que je vous ordonne, à vous & à voſtre Fille, de ne point celebrer, ſans mon conſentement, vos Nopces avec luy, ſur peine d’encourir la diſgrace de la Faculté, & d’eſtre accablez de toutes les Maladies qu’il nous plaira.	Il suffit que je vous ordonne, à vous et à votre Fille, de ne point célébrer, sans mon consentement, vos Noces avec mieux, sur peine d'encourir la disgrâce de la Faculté, et d'être accablez de toutes les Maladies qu'il nous plaira.
ORONTE.	ORONTE.
je n'ay garue, n cela eit;	je n'ai garue, n cela eit;
de faire le Mariage.	de faire le Mariage.
1.	1.
MEDECIN.	MÉDECIN.
On me l’a mis entre les mains, & il eſt obligé d’eſtre mon Malade.	On me l'a mis entre les mains, et il est obligé d'être mon Malade.
ORONTE.	ORONTE.
A la bonne heure.	À la bonne heure.
la MEDESTIV Il a beau fuïr, je le feray condamner par Arreſt à ſe faire guerir par moy.	la MÉDESTIV Il a beau fuir, je le ferai condamner par Arrêt à se faire guérir par moi.
J'y conſens.	J'y consens.
ORONTE.	ORONTE.
1.	1.
MEDECIN.	MÉDECIN.
Oüy, il faut qu’il creve, ou que je le gueriſſe E	Oui, il faut qu'il crève, ou que je le guérisse E
ORONTE.	ORONTE.
Je le veux bien.	Je le veux bien.
1.	1.
MEDECIN.	MÉDECIN.
Et ſi je ne le trouve, je m’en prendray à vous, & je vous gueriray au lieu de luy	Et si je ne le trouve, je m'en prendrai à vous, et je vous guérirai au lieu de .
Cleedu do Je me porte bien.	Clédu do Je me porte bien.
1.	1.
MEDECIN.	MÉDECIN.
Il ne m’importe, il me faut un Malade, & ie prendray qui je pourray.	Il ne m'importe, il me faut un Malade, et tu prendrai qui je pourrai.
ORONTE.	ORONTE.
Prenez qui vous voudrez, mais ce ne ſera pas moy.	Prenez qui vous voudrez, mais ce ne sera pas moi.
Voyer un peu la Benrcrunon.	Voyer un peu la Benrunon.
SCENE III.	SCÈNE III.
S BRIGANI en Marchand Fldmand, ORONTE.	 SRIGANI en Marchand Fldmand, ORONTE.
SBRIGANI.	SBRIGANI.
ontiir, aree le voſtre permiſſione, je AVT ſuiſſe un Trancher Marchant Flamane, qui voudroye bienne vous temandair un petit nouvel.	ontiir, aree le vôtre permissione, je AVT suisse un Trancher Marchant Flamane, qui voudraie bien vous témandair un petit nouvel.
ORONTE.	ORONTE.
Quoy, Mlomenr.	Quoi, Mlomenr.
SBRIGANI.	SBRIGANI.
Mettez le voſtre chapiau ſur le teſte, Montſir, ſi ve plaiſt.	Mettez le vôtre chapiau sur le tête, Montsir, si ve plaît.
ORONTE.	ORONTE.
Dites-moy!	Dites-moi!
, Monſieur, ce que vous voulez.	, Monsieur, ce que vous voulez.
SBRIGANI.	SBRIGANI.
Moy le dire rien, Montſir, ſi vous le mettre pas le chapiau ſur le teſte.	Moi le dire rien, Montsir, si vous le mettre pas le chapiau sur le tête.
ORONTE.	ORONTE.
Soit.	Soit.
Qu’y a-t’il Monſieur?	Qu'y a-t-il Monsieur?
BRIGANI.	BRIGANI.
Fous connoiſtre point en ſti File un certe Aronemt Grontas Oüy, je le connoy.	Fous connaître point en sti File un certe Aronemt Gront Oui, je le connais.
ORONTE.	ORONTE.
BRIGANI.	BRIGANI.
Et quel Homme eſt-ile Montſir, ſi ve plaiſt?	Et quel Homme est-île Montsir, si ve plaît?
ORONTE.	ORONTE.
C’eſt un Homme comme les autres.	C'est un Homme comme les autres.
SBRIGANI.	SBRIGANI.
je touo temando, montiir, gil eſt un Homme riche qui a du bienne.	je touo témando, montiche, gil est un Homme riche qui a du bienne.
ORONTE.	ORONTE.
Oüy.	Oui.
BRIGANI.	BRIGANI.
Mais riche beaucoup grandement, Montſir?	Mais riche beaucoup grandement, Montsir?
ORONTE.	ORONTE.
oüy.	oui.
SBRIGANI.	SBRIGANI.
J'en ſuis aiſe beaucoup, Montſir.	J'en suis aise beaucoup, Montsir.
ORONTE.	ORONTE.
Mais pourquoy cela?	Mais pourquoi cela?
SBRIGANI.	SBRIGANI.
L’eſt, Montſir, pour un petit raiſonne de conſequence pour nous.	L'est, Montsir, pour un petit raisonne de conséquence pour nous.
ORONTE.	ORONTE.
Mais encore, pourquoy?	Mais encore, pourquoi?
SDRTOANI.	SDRTONI.
L’eſt, Montſir, que ſti Montſir Oronte donne ſon Fille en mariatge à un certe Montſir de Pourcegnac.	L'est, Montsir, que sti Montsir Oronte donne son Fille en mariatge à un certe Montsir de Pourcegnac.
ORONTE.	ORONTE.
Hé bien.	Hé bien.
BRIGANI.	BRIGANI.
Et ſti Montſir de Pourcegnac, Montſir, l’eſt E ij un Homme que doivre biaucoup grandement à dix ou douze Marchanne Flamnane qui eſtre venu icy.	Et sti Montsir de Pourcegnac, Montsir, l'est E jour Homme que doivre biavcoup grandement à dix ou douze Marchanne Flamnane qui être venu ici.
ORONTE.	ORONTE.
Ce Monſieur de Pourceaugnac doit beaucoup à dix ou douze Marchands?	Ce Monsieur de Pourceaugnac doit beaucoup à dix ou douze Marchands?
SBRIGANI.	SBRIGANI.
Ovy, Montſir, & depuis huite moys nous avoir obtenir un petit Sentence contre luy, & luy à remettre à payer tou ce Creanciers de ſti Mariatge que ſti Montſir Oronte donne pour ſon Fille.	Oui, Montsir, et depuis huite mois nous avoir obtenir un petit Sentence contre lui, et Seigneur à remettre à payer tou ce Creanciers de sti Mariatge que sti Montsir Oronte donne pour son Fille.
ORONTE.	ORONTE.
Hon, hon!	Hon, hon!
il a remis à payer à ſes Creanciers?	il a remis à payer à ses Creanciers?
D Biere ii l.	 Dière ji l.
l.	l.
Ovy, Montſir, & avec un grand devotion nous tous attendre ſti Mariatge.	Oui, Montsir, et avec un grand dévotion nous tous attendre sti Mariatge.
ORONTE.	ORONTE.
L’avis n’eſt pas mauvais.	L'avis n'est pas mauvais.
Je vous donne le bon	Je vous donne le bon
jour.	jour.
SERIGANI.	SERIGANI.
Je remercie, Montſir, de la faveur grande?	Je remercie, Montsir, de la faveur grande?
ORONTE.	ORONTE.
voitre tres-humble valet.	voitre très-humble valet.
SBRIGANI.	SBRIGANI.
Je le ſuis, Montſir, obliger plus que beaucoup du bon nouvel que Montſir m’avoir donné.	Je le suis, Montsir, obliger plus que beaucoup du bon nouvel que Montsir m'avoir donné.
ORONTE.	ORONTE.
Cela ne va pas mal;	Cela ne va pas mal;
quittons noſtre ajuſtemẽt de Flamand pour ſonger à d’autres machines;	quittons notre ajustement de Flamand pour songer à d'autres machines;
& tâchons de ſemer tant de ſoupçons & de diviſion entre le Beaupere & le Gendre, que cela rompe le Mariage pretendu.	et tâchons de semer tant de soupçons et de division entre le Beaupère et le Gendre, que cela rompe le Mariage prétendu.
Tous deux également ſont propres à gober les hameçons qu’on leur veut tendre;	Tous deux également sont propres à gober les hameçons qu'on leur veut tendre;
& entre nous autres Tourbes de la premiere Claſſe, nous ne faiſons que nous joüer, lors que nous trouvons un Gibler aun fache que celug la	et entre nous autres Tourbes de la première Classe, nous ne faisons que nous jouer, lors que nous trouvons un Gibler aun fâche que celug la
SCENE IV.	SCÈNE IV.
M.	M.
POURCEAUGNAC, SBRIGANI.	POURCEAUGNAC, SBRIGANI.
M.	M.
POORCDHUGNAC.	PORCDHUGNAC.
Iglia-lo ſû, piglia lo ſû, Signor Monſu.	Iglia-lo su, piglia lo sû, Signor Monsu.
Y Que diable eſt-ce la?	Y Que diable est-ce la?
An ?	An ?
BRIGANI.	BRIGANI.
Qu’eſt-ce, Monſieur, qu’avez-vous;	Qu'est-ce, Monsieur, qu'avez-vous;
M.	M.
POURCEAUGNAC.	POURCEAUGNAC.
Tout ce que je voy me ſemble Lavement.	Tout ce que je vois me semble Lavement.
SBRIGANI.	SBRIGANI.
Comment ?	Comment ?
M.	M.
POURCEAUGNAC.	POURCEAUGNAC.
Vous ne ſçavez pas ce qui m’eſt arrivé dans ce Logis à la porte duquel vous m’avez con	Vous ne savez pas ce qui m'est arrivé dans ce Logis à la porte duquel vous m'avez con
duit?	duit?
SBRIGANI.	SBRIGANI.
Non vrayement, qu'ent ce quec ent.	Non vraiment, qu'ent ce quec ent.
M.	M.
POURCEAUGNAC.	POURCEAUGNAC.
Je penſois y eſtre regalé comme il faut.	Je pensais y être régalé comme il faut.
Hé bien?	Hé bien?
SBRIGANI.	SBRIGANI.
M.	M.
POURCEAUGNAC.	POURCEAUGNAC.
Je vous laiſſe entre les mains de Monſieur.	Je vous laisse entre les mains de Monsieur.
E iij Des Medecins habillez de noir.	E ijà Des Médecins habillez de noir.
Dans une chaiſe.	Dans une chaise.
Tâter le poulx.	Tâter le poulx.
Comme ainſi foit.	Comme ainsi soit.
Il eſt fou.	Il est fou.
Deux gros jouflus.	Deux gros jouflus.
Grands chapeaux.	Grands chapeaux.
Bon di, bon di.	Bon di, bon di.
Six Pantalons.	Six Pantalons.
Ta, ra, ta, ta:	Ta, ra, ta, ta:
Ta, ra, ta, ta.	Ta, ra, ta, ta.
Alegramente Monſu Pourceaugnac.	Alégramente Monsu Pourceaugnac.
Apoticaire.	Apoticaire.
Lavement.	Lavement.
Prenez Monſieur, prenez, prenez.	Prenez Monsieur, prenez, prenez.
Il eſt benin, benin.	Il est bénin, bénin.
C’eſt pour déterger, pour déterger, déterger.	C'est pour déterger, pour déterger, déterger.
Piglialo ſu, Signor Monſu, piglia lo, piglia lo, piglia-lo ſu.	Piglial su, Signor Monsu, piglia lo, piglia lo, piglia-lo su.
Jamais ie n’ay eſté ſi ſaoul de ſottiſes.	Jamais ici n'ai été si saoul de sottises.
BRIGANI.	BRIGANI.
Qu’eſt-ce que tout cela veut dire?	Qu'est-ce que tout cela veut dire?
M.	M.
POURCEAUGNAC.	POURCEAUGNAC.
Cela veut dire que cét Homme-là, avec ſes grandes embraſſades, eſt un Fourbe qui m’a mis dans une Maiſon pour ſe mocquer de moy, & me faire une piece.	Cela veut dire que cet Homme-là, avec ses grandes embrassades, est un Fourbe qui m'a mis dans une Maison pour se moquer de moi, et me faire une pièce.
BRIGANI.	BRIGANI.
Cela eſt-il poſſible?	Cela est-il possible?
M.	M.
POURCEAUGNAC.	POURCEAUGNAC.
Sans doute, ils eſtoient une douzaine de Poſſedez apres mes chauſſes;	Sans doute, ils étaient une douzaine de Possédés après mes chausses;
& j’ay eu toutes les peines du monde à m’échaper de leurs pates.	et j'ai eu toutes les peines du monde à m'échapper de leurs pates.
SBRIGANI.	SBRIGANI.
voyez un peu, les milles iont bien trompeuſes !	voyez un peu, les milles jont bien trompeuses !
Je l’aurois crû le plus affectionné de vos Amis.	Je l'aurais cru le plus affectionné de vos Amis.
Voila un de mes étonnemens, comme il eſt poſſible qu’il y ait des Fourbes comme cela dans le Monde.	Voilà un de mes étonnements, comme il est possible qu'il y ait des Fourbes comme cela dans le Monde.
M.	M.
POURCE AUGNAC.	POURCE AUGNAC.
Ne ſens-je point le Lavement?	Ne sens-je point le Lavement?
voyez, ie rous puie	voyez, Seigneur rous puie
BRIGANI.	BRIGANI.
Eh, il y a quelque petite choſe qui approche de cela.	Eh, il y a quelque petite chose qui approche de cela.
M.	M.
POURCEAUGNAC.	POURCEAUGNAC.
J’ay l’odorat & l’imagination tout remply de cela, & il me ſemble toûjours que je voy une douzaine de Laveinens qui me coueiſent en jouë.	J'ai l'odorat et l'imagination tout rempli de cela, et il me semble toujours que je vois une douzaine de Laveinents qui me coueisent en joue.
SBRIGANI.	SBRIGANI.
Voila une méchanceté bien grande!	Voilà une méchanceté bien grande!
& les Hommes ſont bien traiſtres & ſcelerats.	et les Hommes sont bien traîtres et scélérats.
M.	M.
POURCEAUGNAC.	POURCEAUGNAC.
Enſeignez moy, de grace, le xogis de Monſieur Oronte;	Enseignez -moi, de grâce, le xogis de Monsieur Oronte;
je ſuis bien aiſe d’y aller tout à l’heure.	je suis bien aise d'y aller tout à l'heure.
SBRIGANI.	SBRIGANI.
Ah, ah, vous eſtes donc de complexion amoureuſe, & vous avez oüy parler que ce Monſieur Oronte a une Fille.	Ah, ah, vous êtes donc de complexion amoureuse, et vous avez oui parler que ce Monsieur Oronte à une Fille.
M.	M.
POURCEAOONAC.	POURCEAONAC.
Oüy, je viens l’épouſer.	Oui, je viens l'épouser.
SBRIGANT.	SBRIGANT.
L’é.	L'é.
l’épouſer?	l'épouser?
M.	M.
POURCEAUGNAC.	POURCEAUGNAC.
Otij.	Otij.
SBRIGANI.	SBRIGANI.
En mariage?	En mariage?
M.	M.
POURCEAUGNAC.	POURCEAUGNAC.
De quelle façon donc?	De quelle façon donc?
SBRIGANI.	SBRIGANI.
Ah c’eſt une autre choſe, & je vous demande pardon.	Ah c'est une autre chose, et je vous demande pardon.
M.	M.
POURCEAUGNAC.	POURCEAUGNAC.
Qu’eſt-ce que cela veut diré?	Qu'est-ce que cela veut diré?
Rien.	Rien.
SBRIGANI.	SBRIGANI.
M TCORT TAUGNAC.	M TCORT TAUGNAC.
Mais encore ?	Mais encore ?
DRIONNE Rien, vous dis je, j’ay un peu parlé trop viſte.	DRIONNE Rien, vous dis -je, j'ai un peu parlé trop vite.
M.	M.
POURCEAUGNAC.	POURCEAUGNAC.
Je vous prie de me dire ce qu’il y a là-deſſous.	Je vous prie de me dire ce qu'il y a là-dessous.
SBRIGANI.	SBRIGANI.
dtoll, cela lreut pasnechane:	dtoll, cela lut pasnechane:
M.	M.
POURCEAUGNAC.	POURCEAUGNAC.
De grace.	De grâce.
SBRIGANI.	SBRIGANI.
Point, je vous prie de m'en diſpenſer.	Point, je vous prie de m'en dispenser.
M POURCEAUGNAC.	M MOURCEAUGNAC.
Eſt-ce que vous n’eſtes pas de mes amis?	Est-ce que vous n'êtes pas de mes amis?
B Di la nn I2 Si-fait, on ne le peut pas eſtre davantage.	 Bi la nour I2 Si-fait, on ne le peut pas être davantage.
M.	M.
POURCEAUGNAC.	POURCEAUGNAC.
Vous devez donc ne me rien cacher.	Vous devez donc ne me rien cacher.
SBRIGANI.	SBRIGANI.
C’eſt une choſe où il y va de l’intereſt du proenalin	C'est une chose où il y va de l'intérêt du proénalin
M.	M.
POURCEAUGNAC.	POURCEAUGNAC.
Afin de vous obliger à m’ouvrir vôtre cœur, voila une petite Bague que je vous prie de garder pour l’amour de moy.	Afin de vous obliger à m'ouvrir votre cœur, voilà une petite Bague que je vous prie de garder pour l'amour de moi.
SBRIGANI.	SBRIGANI.
Laiſſez-moy conſulter un peu ſi je le puis faire en conſcience.	Laissez-moi consulter un peu si je le puis faire en conscience.
C’eſt un Homme qui cherche ſon bien, qui tâ he de pourvoir ſa fille le plus avantageuſement qu’il eſt poſſible;	C'est un Homme qui cherche son bien, qui tâge hé de pourvoir sa fille le plus avantageusement qu'il est possible;
& il ne faut nuire à perſonne.	et il ne faut nuire à personne.
Ce ſont des choſes qui ſont connuës a la verité, mais j’iray les découvrir à un Homme qui les ignore, & il eſt deffendu de ſcandaliſer ſon prochain:	Ce sont des choses qui sont connues à la vérité, mais j'irai les découvrir à un Homme qui les ignore, et il est défendu de scandaliser son prochain:
Cela eſt vray;	Cela est vrai;
mais d’autre part voila un Eſtranger qu’on veut ſurprendre, & qui de bonne foy vient ſe marier avec une Fille qu’il ne connoiſt pas, & qu’il n’a jamais veuë, un Gentilhomme plein de franchiſe, pour qui je me ſens de l’inclination, qui me fait l’honneur de me tenir pour ſon Amy?	mais d'autre part voilà un Étranger qu'on veut surprendre, et qui de bonne foi vient se marier avec une Fille qu'il ne connaît pas, et qu'il n'a jamais vue, un Gentilhomme plein de franchise, pour qui je me sens de l'inclination, qui me fait l'honneur de me tenir pour son Ami?
prend confiance en moy, & me donne une Bague à garder pour l’amour de luy.	prend confiance en moi, et me donne une Bague à garder pour l'amour de même.
Oüy, je trouve que je puis vous dire les choſes ſans bleſſer ma conſcience;	Oui, je trouve que je puis vous dire les choses sans blesser ma conscience;
mais tâchons de vous les dire le plus doucement qu’il nous ſera poſſible, & d’epargner les Gens le plus que nous pourrons.	mais tâchons de vous les dire le plus doucement qu'il nous sera possible, et d'épargner les Gens le plus que nous pourrons.
De vous dire que cette Fille-la mene une vie deſhonneſte, cela ſeroit un peu trop fort;	De vous dire que cette Fille-la mène une vie déshonnête, cela serait un peu trop fort;
cherchons pour nous expliquer, quelques termes plus doux.	cherchons pour nous expliquer, quelques termes plus doux.
Le mot de Galante auſſi n’eſt pas aſſez;	Le mot de Galante aussi n'est pas assez;
celuy de Coquette achevée me ſemble propre à ce que nous voulons, & je m’en puis ſervir, pour vous dîre honneſtement ce qu’elle eſt.	celui de Coquette achevée me semble propre à ce que nous voulons, et je m'en puis servir, pour vous dîre honnêtement ce qu'elle est.
M.	M.
POURCEAUGNAC.	POURCEAUGNAC.
L’on me veut donc prendre pour dupe?	L'on me veut donc prendre pour dupe?
SBRIGANI.	SBRIGANI.
Peut-eſtre dans le fonds n’y a-t-il pas tant de mal que tout le monde croit;	Peut-être dans le fonds n'y a-t-il pas tant de mal que tout le monde croit;
& puis il y a des Gens, aprés tout, qui ſe mettent au deſſus de ces ſortes de choſes, & qui ne croyent pas que leur honneur dépende.	et puis il y a des Gens, après tout, qui se mettent au dessus de ces sortes de choses, et qui ne croient pas que leur honneur dépende.
M.	M.
POURCEAUGNAC.	POURCEAUGNAC.
Je ſuis voſtre ſerviteur, je ne me veux point mettre ſur la teſte un chapeau comme celuy-là, & l’on aime à aller le front levé dans la Famille des Pourceaugnacs.	Je suis votre serviteur, je ne me veux point mettre sur la tête un chapeau comme celui-là, et l'on aime à aller le front levé dans la Famille des Pourceaugnacs.
SERIGANI.	SERIGANI.
Oüy, je me retire.	Oui, je me retire.
SCENE V.	SCÈNE V.
ORONTE, M.	ORONTE, M.
POURCEAUG.	POURCEAUG.
M.	M.
POORCEAOGNAC.	PORCEAOGNAC.
D On-jour, Monſieur, bon-jour.	D On ajour, Monsieur, bonjour.
ORONTE.	ORONTE.
oorvitour;	oorvitour;
uronfleur, ſerviteur.	uronfleur, serviteur.
M.	M.
POURCEAUGNAC.	POURCEAUGNAC.
vous eites Mviomeur Oronte, n’eſt-ce pas?	vous eites Viomeur Oronte, n'est-ce pas?
Oüy.	Oui.
ORONTE.	ORONTE.
M.	M.
POURCEAUGNAC.	POURCEAUGNAC.
Et moy, Monſieur de Pourceaugnac.	Et moi, Monsieur de Pourceaugnac.
ORONTE.	ORONTE.
A la bonne heure.	À la bonne heure.
M.	M.
POURCEAUGNAC.	POURCEAUGNAC.
Croyez-vous, Monſieur Oronte, que les Limoſins ſoient des ſots?	Croyez-vous, Monsieur Oronte, que les Limosins soient des sots?
ORONTE.	ORONTE.
Sroyen rons, Monſieur de Pourceaugnac, que les Pariſiens ſoient des beſtes?	Sroyen rons, Monsieur de Pourceaugnac, que les Parisiens soient des bêtes?
M.	M.
POURCEAUGNAC.	POURCEAUGNAC.
Vous Imaginez-vous, Monneur Orunte, qu’un Hommé comme moy ſoit ſi affamé de Femme?	Vous Imaginez-vous, Monneur Orunte, qu'un Hommé comme moi soit si affamé de Femme?
ORONTE.	ORONTE.
Vous imaginez-vous, Monſieur de Pourceaugnac, qu’une rille coinmſe la fienſie foſt ſi affamée de Mary?	Vous imaginez-vous, Monsieur de Pourceaugnac, qu'une rille coinmse la fiensie sost si affamée de Mari?
SCENE VI.	SCÈNE VI.
ULIE, ORONTE, M.	OÙLIE, ORONTE, M.
POURCEAUGNAC.	POURCEAUGNAC.
ULIE.	ULIE.
N vient de me dire, mon Pere, que Mon neur de Pourceaugnac eſt arrivé.	N vient de me dire, mon Père, que Mon neur de Pourceaugnac est arrivé.
Ah le voila ſans doute, & mon cœur me le dit.	Ah le voilà sans doute, et mon cœur me le dit.
qu’il eſt bien fait!	qu'il est bien fait!
qu’il a bon air!	qu'il a bon air!
& que je ſuis contente d’avoir un tel Epoux!	et que je suis contente d'avoir un tel Époux!
Souffrez que je l’embraſſe, & que je luy témoigne.	Souffrez que je l'embrasse, et que je lui témoigne.
ORONTE.	ORONTE.
Doucement, ma Fille, doucemenk	Doucement, ma Fille, doucemenk
M.	M.
POURCEAUGNAC.	POURCEAUGNAC.
Tu-dieu, quelle Galante!	Tudieu, quelle Galante!
comme elle prend feu d’abord !	comme elle prend feu d'abord !
ORONTE.	ORONTE.
je vouarois brenrgaror, Monſieur dePourceaugnac, par quelle raiſon vous venez.	je vouarais brenrgar, Monsieur déPourceaugnac, par quelle raison vous venez.
ULIE.	ULIE.
Que je ſuis aile de vous voir!	Que je suis aile de vous voir!
& que je brûle d’impatience.	et que je brûle d'impatience.
ORONTE.	ORONTE.
niui, ma Fille, oſtez vous de là, vous dis-je.	niui, ma Fille, ôtez -vous de là, vous dis-je.
M.	M.
POURCEAUGNAC.	POURCEAUGNAC.
proche de Ho, ho, quelle égrillarde !	proche de Ho, ho, quelle égrillarde !
ORONTE.	ORONTE.
Je voud ois bien, dis-je, ſçavoir par quelle raiſon, s’il vous plaiſt, vous avez la hardieſſe de.	Je voud ois bien, dis-je, savoir par quelle raison, s'il vous plaît, vous avez la hardiesse de.
TOURCEAUGNAC.	TOURCEAUGNAC.
Vertu de ma vie !	Vertu de ma vie !
ORONTE.	ORONTE.
Encore, qu’eſt ce a dire cela?	Encore, qu'est ce a dire cela?
ULIE.	ULIE.
Ne voulez-vous pas que je careſſe l’Epoux que Vous m’avez choiſi?	Ne voulez-vous pas que je caresse l'Epoux que Vous m'avez choisi?
ORONTE.	ORONTE.
nion ,iemties la dyains .	nion ,iemties la dizains .
ULIE.	ULIE.
Laiſſez-moy le regarder.	Laissez-moi le regarder.
ORONTE.	ORONTE.
Rentrez, vous dis-je.	Rentrez, vous dis-je.
ULIE.	ULIE.
Je veux demeurer là, s’il vous plaiſt.	Je veux demeurer là, s'il vous plaît.
ORONTE	ORONTE
ORONTE.	ORONTE.
Je ne veux pas moy, & ſi tu n’entre tout à l’heure, je.	Je ne veux pas moi, et si tu n'entre tout à l'heure, je.
ULIE.	ULIE.
Hé bien, je rentre.	Hé bien, je rentre.
ORONTE.	ORONTE.
Ma Fille eſt une fotte, ene ne ſçait pas les choſes.	Ma Fille est une sotte, ene ne sait pas les choses.
M.	M.
POURCEAOGNAC.	POURCEAOGNAC.
Comme nous luy plaiſons!	Comme nous nous plaisons!
ORONTE à Iulie.	ORONTE à Julie.
Tu ne veux pas te retirer ?	Tu ne veux pas te retirer ?
ULIEQuand eſt-ce donc que vous me marierez avec Monſieur?	ULIEQuand est-ce donc que vous me marieriez avec Monsieur?
ORONTE.	ORONTE.
Jamais, & tu n’es pas pour luy.	Jamais, et tu n'es pas pour lui.
ULIE.	ULIE.
vle veux avoil juioy ;	vle veux avoi juioi ;
puis que vous me l’avez promis.	puis que vous me l'avez promis.
URONTL.	URONTL.
Si je te l’ay promis, je te le dépromets.	Si je te l'ai promis, je te le dépromets.
M.	M.
POURCEAUGNAC.	POURCEAUGNAC.
Elle voudroit bien me tenir?	Elle voudrait bien me tenir?
ULIE.	ULIE.
Vous avez beau faire, nous ſerons mariez enlemole en depit de tout le mondes	Vous avez beau faire, nous serons mariés enlémole en dépit de tout le mondes
ORONTE.	ORONTE.
Je vous en empeſcheray bien tous deux, je vous aſſure.	Je vous en empêcherai bien tous deux, je vous assure.
Voyez un peu quel vertigo luy prend.	Voyez un peu quel grand grand prend.
M.	M.
POURCEAUGNAC.	POURCEAUGNAC.
Mon Dieu, noſtre Beaupere pretendu, ne vous fatiguez pas tant;	Mon Dieu, notre Beaupère prétendu, ne vous fatiguez pas tant;
on n’a pas envie de vous enlever voſtre Fille, & vos grimaces n’atrapperont rien.	on n'a pas envie de vous enlever votre Fille, et vos grimaces n'atraperont rien.
ORONTE.	ORONTE.
Toutes les voſtres n’auront pas grand effet.	Toutes les vôtres n'auront pas grand effet.
M.	M.
POURCEAUGNAC.	POURCEAUGNAC.
Vous eſtes-vous mis dans la teſte que Leonard de Pourceaugnac ſoit un Homme à acheter Chat en poche?	Vous êtes-vous mis dans la tête que Léonard de Pourceaugnac soit un Homme à acheter Chat en poche?
& qu’il n’ait pas là-dedans quelque morceau de judiciaire pour ſe conduire, pour ſe faire informer de l’hiſtoire du monde, & voir en ſe mariant ſi ſon honneut a bien toutes ſes ſeuretez?	et qu'il n'ait pas là-dedans quelque morceau de judiciaire pour se conduire, pour se faire informer de l'histoire du monde, et voir en se mariant si son honnut a bien toutes ses sûretés?
ORONTE.	ORONTE.
Je ne ſçay pas ce que cela veut dire:	Je ne sais pas ce que cela veut dire:
mais vous eſtes-vous mis dans la teſte, qu’un Homme de ſoixante & trois ans ait ſi peu de cervelle, & conſidere ſi peu ſa Fille, que de la marier avec un Homme qui' a ce que vous ſçavez, & qui a eſte mis chen dil Meucem pour eſtre penſé.	mais vous êtes-vous mis dans la tête, qu'un Homme de soixante et trois ans ait si peu de cervelle, et considère si peu sa Fille, que de la marier avec un Homme qui a ce que vous savez, et qui a este mis chen dil Meucem pour être pensé.
M.	M.
POURCEAUGNAC.	POURCEAUGNAC.
C’eſt une pièce que l’on mn a faîte, & je n’ay aucun mal.	C'est une pièce que l'on mn a faîte, et je n'ai aucun mal.
ORONTE.	ORONTE.
Le Medecin me l’a dit luy-meſme.	Le Médecin me l'a dit lui-même.
M.	M.
POURCEAUGNAC.	POURCEAUGNAC.
Le Medecin en a menty;	Le Médecin en a menti;
je ſuis Gentihomme, & je le veux voir l’épée à la main.	je suis Gentihomme, et je le veux voir l'épée à la main.
ORONTE.	ORONTE.
Je ſçay ce que j’en dois croire, & vous ne m’abuſerez pas là-deſſus, non plus que ſur les debtes que vous en avez aſſignées ſur le Mariage de ma Fille.	Je sais ce que j'en dois croire, et vous ne m'abuserez pas là-dessus, non plus que sur les débtes que vous en avez assignées sur le Mariage de ma Fille.
M.	M.
POURCEAUGNAC.	POURCEAUGNAC.
Quelles debtes ?	Quelles débtes ?
ORONTE.	ORONTE.
La feinte icy eſt inutile, & j’ay veu le Marchand Flamand, qui avec les autres Creanciers, a obtenu uepuis muit mois Sentence contre vous.	La feinte ici est inutile, et j'ai vu le Marchand Flamand, qui avec les autres Créanciers, a obtenu uepuis muit mois Sentence contre vous.
M.	M.
POURCEAUGNAC.	POURCEAUGNAC.
Quel Marchand Flamand?	Quel Marchand Flamand?
quels Cre anciers?	quels Cre anciers?
quelle Sentence obtenuë contre moy?	quelle Sentence obtenue contre moi?
ONONTL.	ONONTL.
Vous ſçavez bien ce que je veux dire.	Vous savez bien ce que je veux dire.
SGENE VII.	SGENE VII.
LUCETTE, ORONTE, M.	LÙCETTE, ORONTE, M.
POURCEAUGNAC.	POURCEAUGNAC.
LOCELIE.	LOCELIE.
H tu es aiſſy, & à fy you te trobi aprés TY abé fayt tant de paſſés.	H tu es aissi, et à fi y te trobi après TY abé fais tant de passés.
Podes, tu, ſcelerat, podes-tu ſouſteni ma biſto?	Podes, tu, scélérat, podes-tu souteni ma bisto?
M.	M.
POURCEAUGNAC.	POURCEAUGNAC.
LUCETTE.	LUCETTE.
Que te boli, infame!	Que te boli, infâme!
tu fas ſemblan de nou me pas connoüyſſe, & nou rougiſſes pas impudent que tu ſias, tu ne rougiſſes pas de me beyre?	tu sas semblan de nouv me pas connoüysse, et nou rougisses pas impudent que tu sias si tu ne rougisses pas de me béire?
Nou ſaby pas, Mouſſur, ſaquos bous dont m’an dit que boüillo eſpouſa la Fillou;	Nou sabi pas, Moussur, saquos bous dont m'an dit que boüillo épousa la Fillou;
may you bous declari que you ſoun ſa Fenno, & que ya ſet ans, Mouſſur, qu’en paſſan à Pezenas el auguet l’adreſſe d’ambé ſas mignardiſos, commo ſat tapla layre;	mais you bous déclari que you soun sa Fenno, et que ya set ans, Moussur, qu'en passan à Pezenas elle auguet l'adresse d'ambé sas mignardisos, commo sat tappla laire;
de gaigna lou cor, & m’oubligel pra quel moüyen à l’y dõna la ma per l’eſpouſa.	de gagna lou cor, et m'oubligel pra quel mouien à l'y donna la ma per l'épousa.
ORONTE.	ORONTE.
Oh, oh.	Oh, oh.
M.	M.
POORCEAOGNAC.	PORCEAOGNAC.
Que Diable eſt-ce cecy?	Que Diable est-ce ceci?
LUCETTE.	LUCETTE.
Lou traitré me quitel trés ans apres, ſul preteſte de qualques affayrés que l’apelabon dins ſoun Païs, & deſpey nou ly reſçauput quaſo de noubelo, may dins lou temps qui ſougeabi lou mens, m’an donnat abiſt, que begnio dins aqueſto Bilo, per ſe remarida danbé un autro joüene Fillo, que ſous Parens ly an procurado, ſenſſe ſaupré res de ſon premié mariatge.	Lou traitré me quitel très ans après, sul près de qualques affairés que l'appelabon dins soun Pays, et dépei nou li resçauput quaso de nouvela -moi dins lou temps qui sougeabi lou mens, m'an donnât abît, que begnio dins aquêto Bilo, per se remarida danbé un autro joue Fillo, que sous Parents li an procurado, sensse sauprè rés de son premié mariège.
You ay tout quittat en diligenſſo, & me ſüy rendu dedins a queſte Loc lou pu leau qu’ay pouſcut, per m’oupouſa en aquel criminel mariatge, & confondre as elys de tout le mounde lou plus méchant des Hommes.	You ai tout quittât en diligenso, et me zvi rendu dedins a quête Des lou pu leau qu'ai pouscut, per m'oupousa en aquel criminel mariatge, et confondre as élis de tout le mounde lou plus nant des Hommes.
M.	M.
POURCEAUGNAC.	POURCEAUGNAC.
voila due etranst dlontee.	voilà due étrant dlontee.
LUCETTE.	LUCETTE.
Impudent, n’as pas honte de m’injuria, alloc d’eſtre confus day reproches ſecrets que ta conſſienſo te deou fayre?	Impudent, n'as pas honte de m'injuria, alloc d'être confus dai reproches secrets que ta conssiens te de faire?
M.	M.
POURCEAUGNAC.	POURCEAUGNAC.
Moy, je ſuis voſtre Mary?	Moi, je suis votre Mari?
LUCETTE.	LUCETTE.
Infamo, gauſos-tu dire lou contrairi?	Infamo, gaus-tu dire lou contrairi?
He tu ſabes be, per ma penno, que n’es que trop bertat, & plagueſſo al Cel qu’aco nou fougueſſo pas, & que m’augueſſos layſſado dins l’eſtat d’innocenço, & dins la tranquilitat oun moun amo bibio daban que tous charmes & tas trounpariés nou m’en bengueſſon malhurouſomen fayre ſourty;	He tu sabes be, per ma penno, que n'es que trop bordât, et plaguesso al Cel qu'aco nou fouguesso pas, et que m'auguessos layssado dins l'état d'innocenço, et dins la tranquillitat oun oco amo bibio daban que tous charmes et tas trounpariés nouveau m'en bénéguesson malhurousomen faire sourty;
you nou ſerio pas reduito à fayré lou triſté perſounatgé quyou fay preſentomen;	y nouv serio pas réduito à fayré lou tristé persounatgé quiou fay présentomen;
à beyre un Marit cruel meſpreſa touto l’ardou que jou ay panen,de me lay na ſenſſo cap de pietat, abandounado à las mortellos doulous que you reſſenty de ſas perfidos accious.	à beire un Marit cruel mespresa touto l'ardou que jou ai panen,de me la na sensso cap de piétât, abandounado à las mortellll doulous que you ressenti de sas perfidos accious.
ORONTE.	ORONTE.
Je ne ſçaurois m’empêcher de pleurer.	Je ne saurais m'empêcher de pleurer.
Allez, vous eltes un incenant Tieimes	Allez, vous éltes un incenant Times
M.	M.
POURCEAUGNAC.	POURCEAUGNAC.
Je ne connois rien à tout cecy?	Je ne connais rien à tout ceci?
SCRAAIMIR.	SCRAIMIR.
NERINE en Picarde, LUCETTE ORONTE, M.	NERINE en Picarde, LUCETTTE ORONTE, M.
POURC.	POURC.
NERINE.	NERINE.
H ie n’en pis plus, ie ſis toute eſſoflée.	H ie n'en pis plus, Seigneur sis toute essoufflée.
A Ah finfaron, tu m’as bien fait courir, tu ne m’écaperas mie.	A Ah finfaron, tu m'as bien fait courir, tu ne m'écaperas mie.
Iuſtite, iuitice, le cunts uj empéchement au Mariage.	Justite, juitice, le cunts uj empéchement au Mariage.
Ches mon Mery, Monſieur, & ie veux faire pindre che bon pindar là	Ches mon Mery, Monsieur, et Seigneur veux faire pindre che bon pindar là
Encor!	Encor!
M.	M.
POURCEAUGNAC.	POURCEAUGNAC.
SRaRTE.	SRaRTE.
Quel diable d’Homme eſt-ce-cy?	Quel diable d'Homme est-ce-cy?
LUCETTE.	LUCETTE.
Et que boulés bous dire, ambe boſtre empachomen, & boſtro pendarié?	Et que boulés bous dire, ambe botre empachomen, et bostro pendarié?
Quaquel Homo es boſtro Marit?	Quaquel Homo es bostro Marit?
NERINE.	NERINE.
Oüy Medeme, & ie ſis ſa Femme.	Oui Mème, et ainsi sis sa Femme.
LUCETTE.	LUCETTE.
A quo es faus, aquos you que ſoun ſaFenno;	À quo es faus, aquos you que soun saFenno;
& ſe deû eſtre pendut, aquo ſera you que lou feray penja.	et se dévu être pendut, aquo sera you que lou ferai penjà.
N ERINE.	 ÉRINE.
Je n’entains mie che baragoin là.	Je n'entains mie che baragoin là.
LCCEAIMI Yoù bous diſy que you ſoun la remo.	LCCEIMI Yoù bous dizy que you soun la remo.
Sa Femme ?	Sa Femme ?
NERINE.	NERINE.
Obe.	Obe.
LUCETTE.	LUCETTE.
NERINE.	NERINE.
je vous dis que eneie injgendor in coup,	je vous dis que eneie injendor in coup,
qui le ſis.	qui le sis.
LUCETTE.	LUCETTE.
Et you bous ſouſteni-you, qu’és you.	Et you bous souteni-you, qu'ez you.
NERINE.	NERINE.
Il y a quetre ans qu’il m’a époſée.	Il y a quetre ans qu'il m'a éposée.
LUCETTE.	LUCETTE.
Et you ſet ans que m’a preſo per Fenno.	Et you set ans que m'a pres per Fenno.
I ERINE.	I ÉRINE.
J’ay des gairents de tout ce que ie dy	J'ai des gairents de tout ce que ieomi
LUCETTE.	LUCETTE.
Tout mon Païs lou ſap.	Tout mon Pays lou sap.
Aum iua la nt No Ville en eſt témoin.	Aum jua la nô Nô Ville en est témoin.
LCCLIIE.	LCCLIIE.
Tout Pezenas a biſt noſtre mariatge.	Tout Pezenas a bît notre mariatge.
ERINE.	ÉRINE.
Tout ChinQuentin a aſſiſté à no Noce.	Tout ChinQuentin a assisté à nô Ce.
LUCETTE.	LUCETTE.
Nou y a res de tan beritable.	Nou y a rés de tan béritable.
ERINE.	ÉRINE.
n an yarlen de plus cnersain.	 nan yarlen de plus cnersain.
LVCETTE.	LUCETTE.
Gauſos-tu dire lou contrari, valiſquos?	Gauss-tu dire lou contrari, valisquos?
ERINE.	ÉRINE.
Eſt che que tu me démaintiras méchaint Homme.	Est che que tu me démaintiras méchaint Homme.
M.	M.
POURCEAUGNAC.	POURCEAUGNAC.
Il eſt auſſi vray l’un que l’autre.	Il est aussi vrai l'un que l'autre.
LUCETTE.	LUCETTE.
Qualle inpudenſſo?	Qualle inpudentso?
Et couſſy, miferablo, nou te ſoubenes plus de la Pauro Françon, & del Pauro Jeanet, que ſoun lous fruits de noſtre marlatse:	Et coussi, miférablo, nouv te soubenes plus de la Pauro Françon, et dél ô Jeanet, que soun ous fruits de notre marlatse:
NERINE.	NERINE.
Bayez un peu l’inſolenche.	Bayez un peu l'insolenche.
Quay, tu ne te ſouviens mie de chette pauvre ainfrain, no petite Madelaine, que tu m’as laichée pour gaige de ta foy?	Quais, tu ne te souviens mie de chette pauvre ainfainr, nô petite Madelaine, que tu m'as laichée pour gag de na foi?
M.	M.
POURCEAUGNAC.	POURCEAUGNAC.
Voila deux impudentes carognes!	Voilà deux impudentes carognes!
LUCETTE.	LUCETTE.
Beny Françon, beny Jeanet, beny touſtou, beny touſtoune, beny fayre beyre à un Payre, dénaturat, la duretat quel a per nautres.	Béni Françon, béni Jeanet, béni toustou, béni toustoune, beny fais beire à un Payre, dénaturat, la duretat quel a per nautres.
NERINE.	NERINE.
venez Mauelaine, mon n’ainfrain, venezveſen ichi faire honte à vo Pere de l’inpudainche qu’il a.	venez Maulaine, mon n'ainfrain, venezvesen ichy faire honte à vo Père de l'inpudainche qu'il a.
LES ENFANS.	LES ENFANS.
Ah mon Papa, mon Papa, mon Papa.	Ah mon Papa, mon Papa, mon Papa.
M.	M.
POURCEAUGNAC.	POURCEAUGNAC.
Diantre ſoit des petits fils de Putains.	Diantre soit des petits fils de Putains.
LUCETTE.	LUCETTE.
Couſſy, traytre, tu nou ſios pas dins la darniere confuſiu, de reſſaupre à tai tous Efans, & de ferma l’oreillo à la tendreſſo paternello?	Coussi, traître, tu nou sios pas dins la darnière confusiv, de ressaupre à tai tous Efants, et de ferma l'oreillo à la tendresso paternelo?
Tu nou m’eſcaperas pas, infamo, you te boly ſeguy per tout, & te reproucha toun crime juſquos à tant que me ſio benjado, & que t’ayo fayt penja, couqui, te boly fayré penja.	Tu nou m'écaperas pas, infamo, you te boli ségui per tout, et te reproucha toun crime jusqu' à tant que me sio benjado, et que t'ayo fait penja, couqui, te bol fayré penja.
NERINE.	NERINE.
Ne rougis-tu mie de dire ches mots là, & d’eſtre inſainſible aux caireſſes de chette pauvre ainfrain?	Ne rougis-tu mie de dire chez mots là, et d'être insainsible aux cairesses de chette pauvre ainfrain?
Tu ne te ſauveras mie de mes pates;	Tu ne te sauveras mie de mes pates;
& en dépit de tes dains, ie feray bien voir que de les ta reine, a le le leray palidre.	et en dépit de tes dains, je ferai bien voir que de les ta reine, a le le rai palidre.
Les Enfans tous enſemble.	Les Enfants tous ensemble.
Mon Papa, mon Papa, mon Papa.	Mon Papa, mon Papa, mon Papa.
M.	M.
POURCEAUGAC.	POURCEAUGAC.
Au ſecours, au ſecours, ou fuyray-je?	Au secours, au secours, ou fuirai-je?
ien’en puis	ien’en puis
plus.	plus.
ORONTE.	ORONTE.
Allez, vous ferez bien de le faire punir, & il merite d’eſtre pendu,	Allez, vous ferez bien de le faire punir, et il mérite d'être pendu,
SCE NE IX.	SCE NE IX.
BRIGANI.	BRIGANI.
E conduis de l’œil toutes choſes, & tout cecy T ne va pas mal.	E conduis de l'œil toutes choses, et tout ceci T ne va pas mal.
Nous fatiguerons tant noſtre Provincial, qu’il faudra ma foy, qu’il déguerIit.	Nous fatiguerons tant notre Provincial, qu'il faudra ma foi, qu'il déguerIit.
coſtez!	côtés!
SBRIGANI.	SBRIGANI.
Qu’eſt-ce, Monſieur, ert-il encor arrivé quelque choſe?	Qu'est-ce, Monsieur, ert-il encor arrivé quelque chose?
M.	M.
POURCEAUGNAC.	POURCEAUGNAC.
Oüy.	Oui.
Il pleut en ce païs des Femmes & des Lavemens.	Il pleut en ce pays des Femmes et des Lavements.
SBRIGANI.	SBRIGANI.
Confiſienc done *	Confisien donce *
M.	M.
POURCEAUGNAC.	POURCEAUGNAC.
Deux Carognes de baragoüineuſes me ſont venu accuſer de les avoir épouſe toutes deux, & me menacent de la Juſtice.	Deux Caronnes de baragouineuses me sont venu accuser de les avoir épouse toutes deux, et me menacent de la Justice.
BRIGANI.	BRIGANI.
Voila une méchante affaire, & la Juſtice en ce païs-cy eſt rigoureuſe en diable contre cette ſorte de crime.	Voilà une méchante affaire, et la Justice en ce pays-cy est rigoureuse en diable contre cette sorte de crime.
M.	M.
POURCRAUGNAC.	POURCRAUGNAC.
Oüy.	Oui.
Mais quand il y auroit Information, Ajournement, Decret, & Iugement obtenu par ſurpriſe, Deffaut & contumace, i’ay la voye de Conflit de Juriſdiction, pour temporiſer & vemi aux moyens de nuite qui ieront dans les Procedures.	Mais quand il y aurait Information, Ajournement, Décret, et Jugement obtenu par surprise, Défaut et contumace, j'ai la voie de Conflit de Juridiction, pour temporiser et vémi aux moyens de nuite qui jeront dans les Procedures.
BRIGANI.	BRIGANI.
Voila en parler dans tous les termes;	Voilà en parler dans tous les termes;
& l’on voit bien, Monſieur, que vous eſtes du meſtier.	et l'on voit bien, Monsieur, que vous êtes du métier.
M.	M.
POURCEAUGNAC.	POURCEAUGNAC.
Point, ce n’eſt que le ſens commun qui me fait juger que ie ſeray toûjours receu à mes Faits juitilſcatns, & qu’on he me ſçauroit condamner ſur une ſimple accuſation, ſans un recollement & conf ontation avec mes Parties.	Point, ce n'est que le sens commun qui me fait juger que je serai toujours reçu à mes Faits juitilscatns, et qu'on hé me saurait condamner sur une simple accusation, sans un recollement et cons ontation avec mes Parties.
BRIGANI.	BRIGANI.
En voila du plus fin encore.	En voilà du plus fin encore.
M.	M.
POURCEAUGNAC.	POURCEAUGNAC.
Ces mots-là me viennent ſans que ie les	Ces mots-là me viennent sans que deux les
ſçache.	sache.
SBRIGANI.	SBRIGANI.
Il me ſemble que le ſens commun d’un Gentilhomme peut bien aller à concevoir ce qui eſt du droict & de l’ordre de la Juſtice;	Il me semble que le sens commun d'un Gentilhomme peut bien aller à concevoir ce qui est du droit et de l'ordre de la Justice;
mais non pas à ſçavoir les vrais termes de la Chicane.	mais non pas à savoir les vrais termes de la Chicane.
M.	M.
TOONCEAOGIIO.	TOONCEAOGIIO.
Ce ſont quelques mots que i’ay retenus en liſant les Romans.	Ce sont quelques mots que j'ai retenus en lisant les Romans.
SBRIGANI.	SBRIGANI.
Ah fort bien.	Ah fort bien.
M.	M.
POURCEAUGNAC.	POURCEAUGNAC.
Pour vous montrer que ie n’entens rien du tout à laChicane, ie vous prie de me mener chez quelque Advocat pour conſulter mon Affaire.	Pour vous montrer que Dieu n'entends rien du tout à laChicane, je vous prie de me mener chez quelque Advocat pour consulter mon Affaire.
SBRIGANI.	SBRIGANI.
Je le veux, & vais vous conduire chez deux Hommes fort habiles;	Je le veux, et vais vous conduire chez deux Hommes fort habiles;
mais j’ay auparavant à vous avertir de ne point eſtre ſurpris de leur maniere de parler;	mais j'ai auparavant à vous avertir de ne point être surpris de leur manière de parler;
ils ont contracté dujBarreau certaine habitude de Declamation, qui fait que l’on diroit qu’ils chantent, & vous prendrez pour Muſique tout ce qu’ils vous diront.	ils ont contracté dujarreau certaine habitude de Declamation, qui fait que l'on dirait qu'ils chantent, et vous prendrez pour Musique tout ce qu'ils vous diront.
M.	M.
POURCEAUGNAC.	POURCEAUGNAC.
Qu’importe comme lis parſene 5 pourveu qu’ils me diſent ce que je veux ſçavoir.	Qu'importe comme lis parsène 5 pourvu qu'ils me disent ce que je veux savoir.
SCENE XISBRIGANI, M.	SCÈNE XISBRIGANI, M.
POURCEAUGN.	POURCEAUGN.
L’Advocat traînant ſes paroles.	L'Advocat traînant ses paroles.
A Poligamie eſt un cas, L Eſtun cas pendable.	À Poligamie est un cas, L Stun cas pendable.
L’Advocat bredoüilleur.	L'Advocat bredouilleur.
Voſtre fait Eſt clair & net, Et tout de droit Sur cét endroit Conclut tout droit.	Votre fait Est clair et net, Et tout de droit Sur cet endroit Conclut tout droit.
Si vous conſultez nos Auteurs, Legiſlateurs & Gloſſateurs, Iu ſtinian, Papinian, Vlpian & Tribonian, Fernand, Rebuffe, Iean Imole, Paulde Caſtre, Iulian, Barthole, Iaſon, Alciat & Cujas, Ce grand Homme eſt ſi capable;	Si vous consultez nos Auteurs, Législateurs et Glossateurs, Ju stinian, Papinian, Vlépian et Tribonian, Fernand, Rebuffe, Jean Imole, Paulde Castre, Julian, Barthole, Jason, Alciat et Cujas, Ce grand Homme est si capable;
La Poliganie eſt un cas Eſt un cas pendable.	La Poliganie est un cas Est un cas pendable.
Tous les Peuples policez.	Tous les Peuples policez.
Et bien cenſeZ;	Et bien censés;
Les François, Anglois, Hollandois, Danois, Suedois, Polonois, Portugais, Eſpagnols, Flamans, Italiens, Allemans, sul le juti liennenetey joudalore, Et l’affaire eſt ſans embarras;	Les Français, Anglais, Hollandais, Danois, Suedais, Polonais, Portugais, Espagnols, Flamants, Italiens, Allemands, sul le juti liennenetey joudalore, Et l'affaire est sans embarras;
La Poligamie eſt un cas, Eſt un cas penuavte.	La Poligamie est un cas, Est un cas penuaute.
Monſieur Pourceaugnac les bat.	Monsieur Pourceaugnac les bat.
Deux Procureurs & deux Sergens danſent une Entrée qui ſinit l’Acte.	Deux Procureurs et deux Sergents dansent une Entrée qui sinit l'Acte.
Fin du Second Aue.	Fin du Second Aue.
ACTE	ACTE
ACTE III.	ACTE III.
SCENE PREMIERE.	SCÈNE PREMIÈRE.
ERASTE, SBRIGANI,	ERASTE, SBRIGANI,
{ SBRIGANI.	 SBRIGANI.
UY, les choſes s’acheminent oû nous voulons:	UY, les choses s'acheminent ouû nous voulons:
Et comme ſes lumieres ſont fort petites, & ſon ſeus le plus borné du monde, je luy ay fait prendre une frayeur ſi grande de la ſeverité de la Juſtice de ce Païs, & des appreſts qu’on faiſoit déja pour ſa mort, qu’il veut prendre la fuite, & pour ſe dérober avec plus de facilité aux Gens que je luy ay dit qu’on avoit mis pour l’arreſter aux Portes de la Ville, il s’eſt reſolu à ſe déguiſer, & le déguiſement qu’il a pris eſt l’habit d’une Femme.	Et comme ses lumières sont fort petites, et son zeus le plus borné du monde, je lui ai fait prendre une frayeur si grande de la sévérité de la Justice de ce Pays, et des apprêts qu'on faisait déjà pour sa mort, qu'il veut prendre la fuite, et pour se dérober avec plus de facilité aux Gens que je luitaît dit qu'on avait mis pour l'arrêter aux Portes de la Ville, il s'est résolu à se déguiser, et le déguisement qu'il a pris est l'habit d'une Femme.
ERASTE.	ERASTE.
Je voudrois bien le voir en cét équipage.	Je voudrais bien le voir en cet équipage.
SBRIGANI.	SBRIGANI.
Songez de voſtre part à achever la Comedie;	Songez de votre part à achever la Comédie;
& tandis que je joüeray mes Scenes avec luy.	et tandis que je jouerai mes Scènes avec lui.
allez-vous en.	allez-vous en.
vous entendez bien.	vous entendez bien.
Oüy.	Oui.
ERASTE.	ERASTE.
SBRIGANI.	SBRIGANI.
Et lors que je l’auray mis où je veux.	Et lors que je l'aurai mis où je veux.
Fort bien.	Fort bien.
Ele no ln.	Elle nô l.
SBRIGANI.	SBRIGANI.
Et quand le Pere aura eſté averty par moy.	Et quand le Père aura été averti par moi.
ERASTE.	ERASTE.
Cela va le mieux du monde.	Cela va le mieux du monde.
SBRIGANI.	SBRIGANI.
voicy iimtre Demonene s arten vinte, qu’il ne nous voye enſemble.	voici iimtre Démonène s arten vinte, qu'il ne nous voie ensemble.
SCENE II.	SCÈNE II.
M.	M.
POURCEAUGNAC, en Femme, SBRIGANI.	POURCEAUGNAC, en Femme, SBRIGANI.
Snlale lrler.	Snlale lrler.
Our moy je ne croy pas qu’en cét eſtat ou T puiſſe jamais vous connoiſtre, & vous avez la mine comme cela, d’une Femme de condition.	Our moi je ne crois pas qu'en cet état où T puisse jamais vous connaître, et vous avez la mine comme cela, d'une Femme de condition.
M.	M.
POURCEAUGNAC.	POURCEAUGNAC.
Voilà qui m’étonne qu’en ce Païs-cy les formes de la Juſtice ne ſoient point obſervées.	Voilà qui m'étonne qu'en ce Pays-cy les formes de la Justice ne soient point observées.
SBRIGANI.	SBRIGANI.
Oüy, je vous l’ay déja dit, ils commencent icy par faire pendre un Homme, & puis ils luy font ſon Procez.	Oui, je vous l'ai déjà dit, ils commencent ici par faire pendre un Homme, et puis ils nous font son Procès.
M.	M.
POURC'EAUGNAC.	POURC'EAUGNAC.
Voila une Juſtice bien injaſte.	Voilà une Justice bien injaste.
SBRIGANI.	SBRIGANI.
Elle eſt ſevere comme tous les Diables, particulierement ſur ces ſortes de crimes.	Elle est sévère comme tous les Diables, particulièrement sur ces sortes de crimes.
M.	M.
POURCEAUGNAC.	POURCEAUGNAC.
Mais quand on eſt innnocent?	Mais quand on est innocent?
SBRIGANI.	SBRIGANI.
N’importe, ils ne s’enqueſtent point de cela;	N'importe, ils ne s'enquêtent point de cela;
& puis ils ont en cette Ville une haine effroyable pour les Gens de voſtre Pais, & ils ne ſont point plus ravis que de voir pendre un Limoſin.	et puis ils ont en cette Ville une haine effroyable pour les Gens de votre Pais, et ils ne sont point plus ravis que de voir pendre un Limin.
M.	M.
POURCEAUGNAC.	POURCEAUGNAC.
Qu’eſt-ce que ces Limoſins leur ont fait?	Qu'est-ce que ces Limosins leur ont fait?
SBRIGANICe ſont des brutaux, ennemis de la gentilleſſe & du merite des autres Villes.	SBRIGANICe sont des brutaux, ennemis de la gentillesse et du mérite des autres Villes.
Pour moy je vous avoüe que je ſuis pour vous dans une peur épouventable;	Pour moi je vous avoue que je suis pour vous dans une peur épouventable;
& je ne me conſolerois de ma vie, ſi vous veniez à emte pendu.	et je ne me consolerais de ma vie, si vous veniez à emte pendu.
M.	M.
POURCEAUGNAC.	POURCEAUGNAC.
Ce n’eſt pas tant la peur de la mort qui me fait füir, que de ce qu’il eſt fâcheux à un Gentilhomme d’eſtre pendu;	Ce n'est pas tant la peur de la mort qui me fait fuir, que de ce qu'il est fâcheux à un Gentilhomme d'être pendu;
& qu’une preuve comme celle-là feroit tort à nos Titres de Nobleſſe.	et qu'une preuve comme celle-là ferait tort à nos Titres de Noblesse.
SBRIGANI.	SBRIGANI.
cela le Titre d’Eſcuyer.	cela le Titre d'Écuyer.
Au reſte, étudiez-vous quand je vous meneray par la main, à bien marcher comme une Femme, & prendre le langage de toutes les manieres d’une Perſonne de qualité.	Au reste, étudiez-vous quand je vous mènerai par la main, à bien marcher comme une Femme, et prendre le langage de toutes les manières d'une Personne de qualité.
M.	M.
POURCEAUGNAC.	POURCEAUGNAC.
Laiſſez-moy faire, j’ay veu les Perſonnes du bel air, tout ce qu’il y a, c’eſt que j’ay un peu de barbe.	Laissez-moi faire, j'ai vu les Personnes du bel air, tout ce qu'il y a, c'est que j'ai un peu de barbe.
SBRIGANI.	SBRIGANI.
omit Sarbe n’eſt rien, & il y a des Femmes qui en ont autant que vous.	omit Sarbe n'est rien, et il y a des Femmes qui en ont autant que vous.
C.	Ç.
a voyons un peu comme vous ferez.	à voyons un peu comme vous ferez.
Bon.	Bon.
M.	M.
POURCEAUGNAC.	POURCEAUGNAC.
Allons donc, mon Carroſſe, où eſt-ce qu’eſt mon Carroſſe?	Allons donc, mon Carrosse, où est-ce qu'est mon Carrosse?
Mon Dieu, qu’on eſt miſerable d’avoir des Gens comme cela!	Mon Dieu, qu'on est misérable d'avoir des Gens comme cela!
Eſt ce qu’on me ſein heschure toute la journée ſur le pavé, & qu’on ne me fera point venir mon Carroſſe?	Est -ce qu'on me sein héchure toute la journée sur le pavé, et qu'on ne me fera point venir mon Carrosse?
Fort bien.	Fort bien.
SBRIGANI.	SBRIGANI.
M.	M.
POURCEAUGNAC.	POURCEAUGNAC.
Hola ho.	Hola ho.
Cocher, petit Laquais.	Cocher, petit Laquais.
Ah petit fripon, que de coupe n foüet je vous feray donner tantoſt!	Ah petit fripon, que de coupe n foüet je vous ferai donner tantôt!
Petit Laquais, petit Laquais, où eſt-ce donc qu’eſt-ce petit Laquais?	Petit Laquais, petit Laquais, où est-ce donc qu'est-ce petit Laquais?
ce petit Laquais ne ſe trouvera-il point?	ce petit Laquais ne se trouvera-il point?
ne me ferat-on point venar ce petit Laquais?	ne me ferat-on point venar ce petit Laquais?
Eſt-ce que je n’ay point un petit Laquais dans le monde?	Est-ce que je n'ai point un petit Laquais dans le monde?
SBRIGANI.	SBRIGANI.
Voila qui va à merveilles:	Voilà qui va à merveilles:
mais je remarque une choſe, cette Coiffe eſt un peu trop déliée, j’en vais querir une un peu plus épaiſſe, pour vous mieux cacher le viſage, en cas de quelque rencontre.	mais je remarque une chose, cette Coiffe est un peu trop déliée, j'en vais quérir une un peu plus épaisse, pour vous mieux cacher le visage, en cas de quelque rencontre.
M.	M.
POURCEAUGNAC.	POURCEAUGNAC.
Que deviendray-je cependant?	Que deviendrai-je cependant?
RIGANI.	RIGANI.
Attendez-moy là, je ſuis à vous dans un meMnent,vous n'avez qu’a vous promenere	Attendez-moi là, je suis à vous dans un meMnent,vous n'avez qu'a vous promenère
SCENE III.	SCÈNE III.
DEUX JUISSES, MONSIEUR POURCEAUGNAC.	DEUX JUISSES, MONSIEUR POURCEAUGNAC.
1.	1.
SUISSE.	SUISSE.
Llons ,dépéſchons, Camerade, ly faut A Y allair tous deux nous à la Creve pour regarter chouſticier ſti Monſiu de Pourcegnac qui muaſté contanné par Or tonnance à l’eſtre pendu par ſon cou.	Llons ,dépéschons, Camerade, li faut A Y allair tous deux nous à la Crève pour regarter chouticier sti Monsieur de Pourcegnac qui muasté contanné par Or tonnance à l'être pendu par son cou.
2.	2.
SUISSE.	SUISSE.
Ey faut nous loër un feneſtre pour foir ſti Chouſtice.	Ei faut nous loètr un fenêtre pour soir s Choustice.
I.	I.
SUISSE.	SUISSE.
Ly diſent que l’on fait reja planter un grand potence tout neuve pour l’y accrocher ſti Porcegnac.	Ly disent que l'on fait rejà planter un grand potence tout neuve pour l'y accrocher sti Porcegnac.
G iij	G jijà
2.	2.
SUISTE.	SUISTE.
Ly ſira, ma foy un grand plaiſir, d’y regarter pendre ſti Limoſin.	Li sira, ma foi un grand plaisir, d'y régarter pendre sti Limosin.
I.	I.
SUISSE.	SUISSE.
Ovy de tj lon gamomter ieo preds enhaut tevant tout le monde.	Oui de tj on gamomter ieo préds enhaut tevant tout le monde.
2.	2.
SUISSE.	SUISSE.
Ly eſt un plaiſſant drole, ly dilent que c’eſtre marié troy foye.	Ly est un plaissant drôle, li dilent que c'être marié troy ie.
I.	I.
SUISSE.	SUISSE.
Sti diafle ly vouloir troy Femmes à ly tout leun ij eit blenamhedne.	Sti diafle li vouloir trois Femmes à li tout lun ij eit blenamhedne.
2.	2.
SUISSE.	SUISSE.
Ah pon chour, Mamelelle.	Ah pon chour, Mamèlelle.
I.	I.
SUISSE.	SUISSE.
Que faire fous la tout ſeul?	Que faire fous la tout seul?
M POURCEAUGNAC.	M MOURCEAUGNAC.
J’attens mes Gens, Meſſieurs.	J'attends mes Gens, Messieurs.
A JOJJI.	À JOJJI.
Ly eſt belle, par mon foy.	Li est belle, par mon foi.
M.	M.
POURCEAUGNAC.	POURCEAUGNAC.
Doucement, Meſſieurs.	Doucement, Messieurs.
I.	I.
SUISSE.	SUISSE.
Fous, Mameſelle, fouloir fenir réchoüir fous à la Creve?	Fous, Mameselle, fouloir fenir réchoüir fous à la Creve?
nous faire foir a fous un petit pendement pien choly.	nous faire soir a fous un petit pendement pien choli.
M.	M.
POURCEAUGNAC.	POURCEAUGNAC.
Je vous rends grace.	Je vous rends grâce.
2.	2.
SUISSE.	SUISSE.
L’eſt un Gentilhomme Limoſſin qui ſera pendu chantiment à un grand potence.	L'est un Gentilhomme Limossin qui sera pendu chantiment à un grand potence.
M.	M.
POURCEAUGNAC.	POURCEAUGNAC.
Je n’ay pas de curioſité.	Je n'ai pas de curiosité.
1.	1.
SUISSE.	SUISSE.
Ly eſt là un petit teton qui l’eſt drole.	Ly est là un petit téton qui l'est drôle.
Mi HOGROHHOGNAC.	Mi HOGROHHOGNAC.
S Tout beau.	S Tout beau.
F.	F.
JUISSE.	JUISSE.
Mon foy, moy couchair pien avec fous.	Mon foi, moi couchair pien avec fous.
M.	M.
POURCEAUGNAC.	POURCEAUGNAC.
Ah c’en eſt trop, &ces ſortes d’ordures-là ne ſe diſent point à une Femmme de ma condition.	Ah c'en est trop, etces sortes d'ordures-là ne se disent point à une Femme de ma condition.
2SOISSE.	2SOISE.
Laiſſe-toy, l’eſt moy qui le veut couchair afec elle.	Laisse-toi, l'est moi qui le veut couchair afec elle.
I.	I.
SUISSE.	SUISSE.
Moy ne vouloir pas laiſſer.	Moi ne vouloir pas laisser.
T SUISSE.	 SUISSE.
Moy ly vouloir, moy.	Moi li vouloir, moi.
1BOY33L.	1BOY3L.
Moy, ne faire rien.	Moi, ne faire rien.
2.	2.
SUISSE.	SUISSE.
Toy l’avoir menty	Toi l'avoir menti
1.	1.
SUISSE.	SUISSE.
Toy l’aront felcy toy-meſme.	Toi l'aront felci toi-même.
M.	M.
POURCEAUGNAC.	POURCEAUGNAC.
Au ſecours, à la force.	Au secours, à la force.
SCENE IV.	SCÈNE IV.
UN EXEMPT, DEUX ARCHERS, Premier & deuxiéme SVISSE, MONSIEUR POVRCEAUGNAC.	UN EXEMPT, DEUX ARCHERS, Premier et deuxième SVISE, MONSIEUR POURCEAUGNAC.
L’EXEMPT.	L'EXEMPT.
v'eſt ce?	v'est ce?
quelle violence eſt ce-là?	quelle violence est ce-là?
& & que voulez-vous faire a Madame?	et et que voulez-vous faire a Madame?
Allons, que l’on ſorte de là, ſi vous ne voulez.	Allons, que l'on sorte de là, si vous ne voulez.
que ie vous mette en priſon.	que je vous mette en prison.
I.	I.
SVISSE.	SVISSE.
Party pon, toy ne l’avoir point.	Parti pon, toi ne l'avoir point.
2.	2.
SVISSE.	SVISSE.
Party pon auſ, toy ne l'avoir point encor.	Parti pon aus, toi ne l'avoir point encor.
M.	M.
POURCEAUGNAC.	POURCEAUGNAC.
Je vous ſuis bien obligé, Monſieur, de m’avoir delivrée de ces inſolens.	Je vous suis bien obligé, Monsieur, de m'avoir délivrée de ces insolents.
L’EXEMPT Oüay voila un viſage qui reſſemble à celuy que l’on m’a depeint.	L'EXEMPT Ouiai voilà un visage qui ressemble à celui que l'on m'a dépeint.
M.	M.
POURCEAUGNAC.	POURCEAUGNAC.
Ce n’eſt pas moy ie vous aſſeure.	Ce n'est pas moi à vous assure.
L’EXEMPT.	L'EXEMPT.
Ah, ab, qu’eſt ce que ie veux dire?	Ah, ab, qu'est ce que tu veux dire?
M.	M.
POURCEAUGNAC.	POURCEAUGNAC.
Je ne ſçay pas.	Je ne sais pas.
L’EXEMPT.	L'EXEMPT.
Pourquoy donc dites-vous cela?	Pourquoi donc dites-vous cela?
M.	M.
POURCEAUGNAC.	POURCEAUGNAC.
Pour rien.	Pour rien.
L’EXEMPT.	L'EXEMPT.
voita un difcours qui prarque quelque choſẽ, & ie vous arreſte priſonnier.	voita un discours qui prarque quelque chosien, et Seigneur vous arrête prisonnier.
M.	M.
POURCEAUGNAC.	POURCEAUGNAC.
Eh, Monſieur, de grace.	Eh, Monsieur, de grâce.
L’EXEMPT.	L'EXEMPT.
Non, non, à voſtre mine, & à vos diſcours, il faut que vous ſoyez ce Monſieur de Pourceaugnac que nous cnercions, qui le foit déguiſe de la ſorte;	Non, non, à votre mine, et à vos discours, il faut que vous soyez ce Monsieur de Pourceaugnac que nous cnercions, qui le soit déguise de la sorte;
& vous viendrez en priſon coue a Pheure.	et vous viendrez en prison coue a Pheure.
M.	M.
POURCEAUGNAC.	POURCEAUGNAC.
Paeids .	Paéids .
SCENE V.	SCÈNE V.
L’EXEMPT,ARCHERS, SBRIGANI, M.	L'EXEMPT,ARCHÉRS, SBRIGANI, M.
POURCEAUGNAC.	POURCEAUGNAC.
L’EXEMPT.	L'EXEMPT.
Oüy, oüy, c’eſt dequoy ie ſuis ravy.	Oui, oui, c'est dequoy je suis ravi.
BRIGANI.	BRIGANI.
Eh, Monſieur, pour l’amour de moy;	Eh, Monsieur, pour l'amour de moi;
vous ſçavez que nous ſommes Amis il y a longtemps;	Vous savez que nous sommes Amis il y a longtemps;
ie vous conjure de ne le point mener en priſon.	Hé vous conjure de ne le point mener en prison.
MMMIRII Non, il m’eſt impoſſible.	MMIRII Non, il m'est impossible.
BRIGANI.	BRIGANI.
Vous eſtes Homme d’accommodement;	Vous êtes Homme d'accommodement;
n’y a-t-il pas moyen d’ajuſter cela avec quelques ſeres ?	n'y a-t-il pas moyen d'ajuster cela avec quelques serez ?
L’EXEMPT à ſes Archers.	L'EXEMPT à ses Archers.
Retirez-vous un peu.	Retirez-vous un peu.
RRIGANI.	RRIGANI.
Il faut luy donner de l’argent pour vous laiſſer aller;	Il faut venir donner de l'argent pour vous laisser aller;
Faites viſte.	Faites vite.
M.	M.
POURCEAUGNAC.	POURCEAUGNAC.
Ah maudite Ville !	Ah maudite Ville !
Bulainne li Tenez, Monſieur.	Bulainne li Tenez, Monsieur.
L'EXEMPT.	L'EXEMPT.
Combien y a-il :	Combien y a-il :
BRIGANI.	BRIGANI.
Un, deux, trois, quatre, cinq, ſix, ſept, huit, neuf, dix.	Un, deux, trois, quatre, cinq, six, sept, huit, neuf, dix.
LLAEMIA.	LLAMIA.
Non, mon ordre eſt trop exprés.	Non, mon ordre est trop exprès.
BRIGANI.	BRIGANI.
Mon Dieu attendez.	Mon Dieu attendez.
Dépeſchez, donnez luy en encore autant.	Dépêchez, donnez luy en encore autant.
M.	M.
POURCEAUGNAC.	POURCEAUGNAC.
Mais.	Mais.
BRIGANI.	BRIGANI.
Dépeſchez-vous, vous dis-je, & ne perdez point de temps:	Dépêchez-vous, vous dis-je, et ne perdez point de temps:
Vous auriez un grand plaiſir quand vous ſeriez pendu.	Vous auriez un grand plaisir quand vous seriez pendu.
M.	M.
POURCEAUGNAC, Ah !	POURCEAUGNAC, Ah !
DRIOAINI.	DRIOAINI.
Tenez, Monſieur.	Tenez, Monsieur.
L’EXEMPT.	L'EXEMPT.
Il faut donc que ie m’enfuye avec luy, car il n’y auroit point icy de ſeureté pour moy.	Il faut donc que personne m'enfuie avec lui, car il n'y aurait point ici de sûreté pour moi.
Laiſſez-le moy conduire, & ne bougez d’icy.	Laissez-le moi conduire, et ne bougez d'ici.
BRIGANI.	BRIGANI.
Je vous prie donc d’en avoir un grand ſoin.	Je vous prie donc d'en avoir un grand soin.
LEXEMPI.	LEXEMPI.
Je vous promets de le point quitter, que ie ne l’aye mis en lieu de ſeureté.	Je vous promets de le point quitter, que sans ne l'aie mis en lieu de sûreté.
M.	M.
POURCEAUGNAC.	POURCEAUGNAC.
Adieu.	Adieu.
Voilà le ſeul honneſte-Homme que j’ay trouvé en cette Ville.	Voilà le seul honnête-Homme que j'ai trouvé en cette Ville.
BRIGANI.	BRIGANI.
Ne perdez point de temps, ie vous aime tant, que ie voudrois que vous fuſſiez déja bien loinQue le Ciel te conduiſe!	Ne perdez point de temps, je vous aime tant, que sans voudrais que vous fussiez déjà bien loinQue le Ciel te conduise!
Par ma foy, voila une grande dupe.	Par ma foi, voilà une grande dupe,
Mais voicy.	Mais voici.
SCENE VI.	SCÈNE VI.
ORONTE, SBRICANI.	ORONTE, SBRICANI.
BRIGANI.	BRIGANI.
H quelle étrange avanture!	H quelle étrange aventure!
quelle fâAcheuſe nouvelle pour un Pere!	quelle fâcheuse nouvelle pour un Père!
Pauvre Oronte que ie te plains !	Pauvre Oronte que ie te plains !
Que diras-tu?	Que diras-tu?
& de quelle façon pourras-tu ſupporter cette douleur mortefle 2	et de quelle façon pourras-tu supporter cette douleur mortefle 2
ORONTE.	ORONTE.
Qu’eſt-ce?	Qu'est-ce?
quel malheur me preſages-tu?	quel malheur me présages-tu?
BRIGANI.	BRIGANI.
Ah, Monſieur, ce perfide de Limoſin, ce traître de Momſent de Pourceaugnue yvous enleve voſtre Fille.	Ah, Monsieur, ce perfide de Limosin, ce traître de Momsent de Pourceaugnue y enlève votre Fille.
ORONTE.	ORONTE.
Il m’enleve ma Fille;	Il m'enlève ma Fille;
SBRTGANI.	SBRTGANI.
Oüy, elle en eſt devenuë ſi fole, qu’elle vous quicte pour le faitre;	Oui, elle en est devenue si sole, qu'elle vous quicte pour le fait;
& l’on dit qu’il a vn Caractere pour ſe faire aimer de toutes les Femmes.	et l'on dit qu'il a un Caractère pour se faire aimer de toutes les Femmes.
ORONTE.	ORONTE.
Allons viſte à la Juſtice.	Allons vite à la Justice.
Des Archers ’apres eux.	Des Archers 'après eux.
SOBEM	SOBEM
SCENE VII.	SCÈNE VII.
ERASTE, IULIE, SBRIGANI, ONONTE.	ERASTE, JULIE, SBRIGANI, ONONTE.
ERASTE.	ERASTE.
Llons, vous viendrez malgré vous, & ie A veux vous remettre entre les mains de voſtre Pere.	Llons, vous viendrez malgré vous, et ton A veux vous remettre entre les mains de votre Père.
Tenez, Monſieur, voîla voſtre Fille que i’ay tirée de force d’entre les mains de l’Homme avec qui elle s’enfuyoit;	Tenez, Monsieur, voîla votre Fille que j'ai tirée de force d'entre les mains de l'Homme avec qui elle s'enfuyait;
non pas pour l’amour d’elle, mais pour voſtre ſeule conſideration:	non pas pour l'amour d'elle, mais pour votre seule considération:
car aprés l’action qu’elle a faite, fuuis la Mepanans ue mne guerit avloluinent de l’amour que j’avois pour elle.	car après l'action qu'elle a faite, fuis la Mepanans ue mé rit avloluinent de l'amour que j'avais pour elle.
ORONTE.	ORONTE.
Ah infame que tu es !	Ah infâme que tu es !
ERASTE.	ERASTE.
Comment!	Comment!
me traitter de la ſorte aprés toutes les marques d’amitié que ie vous ay données!	me traiter de la sorte après toutes les marques d'amitié que je vous ai données!
Ie ne vous blâme point de vous eſtre ſoûmiſe aux volontez de Monſieur voſtre Pere, il eſt ſage & judicieux dans les choſes qu’il fait, & ie ne me plains point de luy de m’avoir rejetté pour un autre.	Je ne vous blâme point de vous être soumise aux volontés de Monsieur votre Père, il est sage et judicieux dans les choses qu'il fait, un autre ne me plains point de même de m'avoir rejeté pour un autre.
S’il a manqué à la parole qu’il m’avoit donnée, il a ſes raiſons pour cela.	S'il a manqué à la parole qu'il m'avait donnée, il a ses raisons pour cela.
On luy a fait croire que cét autre eſt plus riche que moy de quatre ou cinq mil écus;	On a a fait croire que cet autre est plus riche que moi de quatre ou cinq mil écus;
& quatre ou cinq mil écus eſt un denier conſiderable, & qui vaut bien la peine qu’un homme manque à ſa parole:	et quatre ou cinq mil écus est un denier considérable, et qui vaut bien la peine qu'un homme manque à sa parole:
Mais oublier en un moment toute l’ardeur que je vous ay montrée, vous laiſſer d’abord enflamer d’amour pour un nouveau venu, & le ſuivre honteuſement ſans le conſentement de Monſieur voſtre Pere, aprés les crimes qu’on luy impute, c’eſt une choſe condamnée de tout le monde, & dont mon cœur ne peut vous faire d’aſſez ſanglants reproches.	Mais oublier en un moment toute l'ardeur que je vous ai montrée, vous laisser d'abord enflammer d'amour pour un nouveau venu, et le suivre honteusement sans le consentement de Monsieur votre Père, après les crimes qu'on lui impute, c'est une chose condamnée de tout le monde, et dont mon cœur ne peut vous faire d'assez sanglants reproches.
JULIE.	JULIE.
Hé bien oüy, j’ay conceu de l’amour pour luy, & je l’ay voulu ſuivre, puis que mon Pere me l’avoit choiſi pour Eſpoux.	Hé bien oui, j'ai conçu de l'amour pour lui, et je l'ai voulu suivre, puis que mon Père me l'avait choisi pour Époux.
Quoy que vous me diſiez, c’eſt un fort honneſte Homme, & tous les crimes dont on l’accuſe, ſont fauſſetez realinmare,	Quoi que vous me disiez, c'est un fort honnête Homme, et tous les crimes dont on l'accuse, sont fausseté realinmare,
ORONTE.	ORONTE.
Taiſez-vous, vous eſtes une impertinente, & je ſçay mieux que vous ce qui en eſt.	Taisez-vous, vous êtes une impertinente, et je sais mieux que vous ce qui en est.
JOLIE.	JOLIE.
Ce ſont ſans doute des pieces qu’on luy fait, & c’eſt peut eſtre luy qui a trouvé cét artifice pour vous en dégoûter.	Ce sont sans doute des pièces qu'on rien fait, et c'est peut être lui qui a trouvé cet artifice pour vous en dégoûter.
E lIJII.	E lIJII.
Moy, je ſerois capable de cela?	Moi, je serais capable de cela?
ULIE Oüy, vous.	OÙLIE Oui, vous.
ORONTE.	ORONTE.
Taiſez-vous, vous dis-je, vous eſtes une ſotte	Taisez-vous, vous dis-je, vous êtes une sotte
ERASTE.	ERASTE.
Non, non, ue vous ihiagmvo pas ue j’aye en	Non, non, ue vous ihiagmvo pas ue ôaye en
vie de détourner ce Mariage, & que ce ſoit ma paſſion qui m’ait forcé à courir aprés vous.	vie de détourner ce Mariage, et que ce soit ma passion qui m'ait forcé à courir après vous.
Je vous l’ay déja dit, ce n’eſt que la ſeule conſideration que j’ay pour Monſieur voſtre Pere, & ie n’ay pû ſouffrir qu’un honnêté Homme comme luj feit cApore a la fonte de tous les bruits qui pourroient ſuivre une action comme la voſtre.	Je vous l'ai déjà dit, ce n'est que la seule considération que j'ai pour Monsieur votre Père, et ie n'ai pu souffrir qu'un honnêté Homme comme luj à cApore a la fonte de tous les bruits qui pourraient suivre une action comme la vôtre.
ORONIE.	ORONIE.
Je vous ſuis, Seigneur Eraſte, infiniment obli	Je vous suis, Seigneur Eraste, infiniment obli
ERASTE.	ERASTE.
Adieu, Monſieur, j’avois toutes les ardeurs du monde d’entrer dans voſtre Alliance, j’ay fait tout ce que j’ay pû pour obtenir un tel honneur, mais j’ay eſté malheureux, & vous ne m’avez pas jugé digne de cette grace.	Adieu, Monsieur, j'avais toutes les ardeurs du monde d'entrer dans votre Alliance, j'ai fait tout ce que j'ai pu pour obtenir un tel honneur, mais j'ai été malheureux, et vous ne m'avez pas jugé de de cette grâce.
Cela n’empeſchera pas que je ne conſerve pour vous les Ientimens d’eſtime & de veneration où voſtre Perſonne m’oblige;	Cela n'empêchera pas que je ne conserve pour vous les Jentiments d'estime et de vénération où votre Personne m'oblige;
& ſi je n’ay pû eſtre voſtre Gendre, au moins ſeray je éternellement voſtre Serviteur.	et si je n'ai pu être votre Gendre, au moins serai je éternellement votre Serviteur.
ORONIE.	ORONIE.
Arreſtez, Seigneur Eraſte, voſtre procedé me touche l’ame, & je vous donne ma Fille en mariage.	Arrêtez, Seigneur Eraste, votre procédé me touche l'âme, et je vous donne ma Fille en mariage.
JULIE.	JULIE.
Je ne veux point d’autre mary que Monſieur de Pourceaugnac.	Je ne veux point d'autre mari que Monsieur de Pourceaugnac.
ORONTE.	ORONTE.
Et je veux, tout à l’heure, que tu prennes le Seigneur Eraſte.	Et je veux, tout à l'heure, que tu prennes le Seigneur Eraste.
Ca, la main.	Ça, la main.
ULIE.	ULIE.
Non, je n’en feray rien.	Non, je n'en ferai rien.
ORONTE.	ORONTE.
Je te donneray ſur les oreiſſes.	Je te donnerai sur les oreisses.
ERASTE.	ERASTE.
Non, non, Monſieur, ne luy faites point de violence, je vous en prie.	Non, non, Monsieur, ne lui faites point de violence, je vous en prie.
ORONTE.	ORONTE.
Ceſt a ciſe amopen, a je ijaj me montret le Maiſtre.	Cest à cize amopen, a je ijà me montret le Maître.
ERASTE.	ERASTE.
Ne voyez-vous pas l’amour qu’elle a pour cét Homme-la?	Ne voyez-vous pas l'amour qu'elle a pour cet Homme-la?
& voulez-vous que je poſſede un Corps dont un autre poſſedera le cœur?	et voulez-vous que je possède un Corps dont un autre possédera le cœur?
ORONTE.	ORONTE.
Ceſt un fortilege qu’il luy a donné, & vous verrez qu’elle chãgera de ſentiment avant qu’il ſoit peu.	Cest un sortilège qu'il a a donné, et vous verrez qu'elle chergera de sentiment avant qu'il soit peu.
Donnez moy voſtre main.	Donnez -moi votre main.
Allons.	Allons.
benleste.	benleste.
JULIE.	JULIE.
ORONTE.	ORONTE.
Ah que de bruit, C.	Ah que de bruit, Ç.
a, voſtre main, vous dis-je Ah, ah, ah.	a, votre main, vous dis-je Ah, ah, ah.
ERASTE.	ERASTE.
Ne croyez-pas que ce ſoit pour l’amour de vous que je vous donne la main;	Ne croyez-pas que ce soit pour l'amour de vous que je vous donne la main;
ce n’eſt que Monſieur voſtre Pere dont je ſuis amoureux, & c’eſt luy que j’épouſe.	ce n'est que Monsieur votre Père dont je suis amoureux, et c'est lui que j'épouse.
ORONTE.	ORONTE.
Je vous ſuis beaucoup obligé, & j’augmente de dix mil écus le mariage de ma Fille.	Je vous suis beaucoup obligé, et j'augmente de dix mil écus le mariage de ma Fille.
Allons, qu’on faſſe venir le Notaire pour dreſſer le Contract.	Allons, qu'on fasse venir le Notaire pour dresser le Contrat.
ERASTE.	ERASTE.
En attendant qu’il vienne, nous pouvons joüir du divertiſſement de la Saiſon, & faire entrer les Maſques que le bruit des Nopces de Aromtnt a Pourceaugnac a attiré icy de tous les endroits de la Ville.	En attendant qu'il vienne, nous pouvons jouir du divertissement de la Saison, et faire entrer les Masques que le bruit des Noces de Aromt a Pourceaugnac a attiré ici de tous les endroits de la Ville.
SCENE VIII.	SCÈNE VIII.
PPLUSIEURS MASQUES DI toutes les manieres, dont les uns occupent pluſieurs Balcons, & les autres ſont dans la Place, qui par pluſieurs Chanſons & diverſes danſes & Jeux, cherchent à ſe donner des plaiſirs innocens.	PPLUSIEURS MASQUES DI toutes les manières, dont les uns occupent plusieurs Balcons, et les autres sont dans la Place, qui par plusieurs Chansons et diverses danses et Jeux, cherchent à se donner des plaisirs innocents.
UNE EGYPTIENNE.	UN ÉGYPTIENNE.
OrteZ, ſorteZ de ces lieux, mcunuu namgius CuifJes Venez, venez, ris & jeux, Plaiſirs, amour & tendreſſe.	Ortez, sortez de ces lieux, mcunu namgius Cuifes Venez, venez, ris et jeux, Plaisirs, amour et tendresse.
Ne ſongeons qu’à nous réjoüir, La grande affaire eſt le plaiſir.	Ne songeons qu'à nous réjouir, La grande affaire est le plaisir.
Chœur des Muſiciens.	Chœur des Musiciens.
Ne ſongeons qu’à nous réjoüir, La grande affaire eſt le plaiſir.	Ne songeons qu'à nous réjouir, La grande affaire est le plaisir.
L’EGYPTIENNE.	L'ÉGYPTIENNE.
A me ſuivre tous icy, Voſtre ardeur eſt non commune, Et vous eſtes en ſoucy De voſtre bonne fortune:	À me suivre tous ici, Votre ardeur est non commune, Et vous êtes en souci De votre bonne fortune:
SoyeZ touiours amoureux, C’eſt le moyen d’eſtre heureux.	SoyeZ toujours amoureux, C'est le moyen d'être heureux.
EGYPTIEN Aimons juſques au trépas, La raiſon nous y convie:	ÉGYPTIEN Aimons jusques au trépas, La raison nous y convie:
Helas?	Hélas?
ſi l’on æ’aimoit pas, Que ſeroit ce de la vie?	si l'on æ'aimait pas, Que serait ce de la vie?
Ah!	Ah!
perdons plûteſt le jour, Que de perdre noſtre amour, Tous deux en Dialogue.	perdons plûtest le jour, Que de perdre notre amour, Tous deux en Dialogue.
L’EGYPTIEN.	L'ÉGYPTIEN.
BEGIDTIBANVE.	BÉGIDTIBANVE.
La Gloire.	La Gloire.
LEGYPIIEN.	LÉGYPIEN.
Les Grandeurs.	Les Grandeurs.
L’EGYPTIENNE.	L'ÉGYPTIENNE.
Les Sceptres qui ont tant d’envie.	Les Sceptres qui ont tant d'envie.
EGY I IF Tout n’eſt rien ſi l’amour n’y meſle ſes ardeurs.	ÉGY I IF Tout n'est rien si l'amour n'y mêle ses ardeurs.
L’EGYPTIENNE.	L'ÉGYPTIENNE.
Il n’eſt point, ſans l’amour, de plaiſir dans la vie.	Il n'est point, sans l'amour, de plaisir dans la vie.
Tous deux enſemble.	Tous deux ensemble.
Soyons toûjours ameureux, C'et le moyen d’eſtre heureux.	Soyons toujours ameureux, C'est le moyen d'être heureux.
Le petit Chœur chante aprés ces deux derniers Sus, ſus, chantons tous en ſemble, Danſons, ſautons, joüons nous.	Le petit Chœur chante après ces deux derniers Sus, sus, chantons tous en semble, Dansons, sautons, jouons nous.
Un Muſicien ſeul.	Un Musicien seul.
Lors que pour rire on s’aſſemble, Les plus jages, te me jembie, Sont ceux qui ſont les plus fous.	Lors que pour rire on s'assemble, Les plus jages, te me jembie, Sont ceux qui sont les plus fous.
Tous enſemble.	Tous ensemble.
Ne ſongeons qu’à nous réjoöir.	Ne songeons qu'à nous réjoöir.
La grande affaire eſt le ptaiſit	La grande affaire est le ptaisit
IN.	IN.
fance	fance
