MADEMOISELLE.	MADEMOISELLE.
A PARIS, Chez ANTOINE DE SOMMAVILLE, au Palais, en la Gallerie des Merciers, à l’Eſcu de France.	À PARIS, Chez ANTOINE DE SOMAUILLE, au Palais, en la Gallerie des Merciers, à l'Écu de France.
de dedier unr Comedie à hiad.	de dédier un Comédie à hiad.
Reme rendit hardy comme vn Lyon, & ie.	Reme rendit hardi comme un Lyon, et notre.
crûs que trauaillant pourſon diuerriſſemient, ie poauoïs meſurer miaPlume, meſine auec telledó lquelque Poëte Heroique, fut-il du premier ordre, & de ceux qui chauffent le Cothurne à tous les iours.	crus que travaillant pourson diverrissement, votre poauoïs murer mivaPlume, mes auec telledó lquelque Poète Héroïque, fut-il du premier ordre, et de ceux qui chauffent le Cothurne à tous les jours.
Ie doute ſi Apollon bien inuoqué, & mia Nuſe bien ſollicitée, m’euſſent eſté des DiuiniteZ plus fauorables, que me l’a eſté vôtre Alteſſe, & ſi pluſieurs priſes à pleïne taſſe d’eau dis ſacré Kallon, m’euſſent faït mõter plus de vapeurs Poëtiques à la teste, qu’afait l'ams bition de vous plaire.	Je doute si Apollon bien invoqué, et mia Nuse bien sollicitée, m'eussent été des Divinitez plus favorables, que me l'a été votre Altesse, et si plusieurs prises à pleine tasse d'eau dis sacré Kallon, eussent faït mõter plus de vapeurs Poëtiques la teste, afait l' bition de vous plaire.
Elle a eu des Obſtacles à ſurmonter, comme les grands deſſeins en ont touſiours.	Elle a eu des Obstacles à surmonter, comme les grands desseins en ont toujours.
On a hay ma Comedie deuant que de la connoiſtre.	On a hais ma Comédie devant que de la connaître.
De belles Dames qui ſont en poſſeßion de faire la destinée des Pauures humains, ont voulu rendre mal-heureuſe celle de ma pauure Comedie.	De belles Dames qui sont en possession de faire la destinée des Pauvres humains, ont voulu rendre malheureuse celle de ma pauvre Comédie.
Elles ont tenu' Ruelle pour l’étouffer dés ſa naiffance.	Elles ont tenu' Ruelle pour l'étouffer dès sa naissance.
Quelques vnes des plus partiates ont porté contre elle des Eactumis par les Maiſons comme on fait en ſollicitant vn Procés, & l’ont comparée d'vne grace, ſans feconde, à deda Moutarde mélee aues de la Creſme:	Quelques unes des plus partiates ont porté contre elle des Eactumis par les Maisons comme on fait en sollicitant un Procès, et l'ont comparée d'une grâce, sans féconde, à dédà Moutarde mêlée êtes de la Crême:
Mais les comparaiſons nobles & riches ne ſont, point deffenduë, & quãd par pufieurs autres de meſme force, vn auroit perdu de reputation ma Comedie, l’applaudiſſement qu’elle a eu de la Coûr & de la Ville, luz en auroit plus rendu, que ne luy en auroit pû oſter vne conjaration de precieuſes.	Mais les comparaisons nobles et riches ne sont, point défendue, et quand par pufieurs autres de même force, un aurait perdu de réputation ma Comédie, l'applaudissement qu'elle a eu de la Cour et de la Ville, luz en aurait plus rendu, que ne lu en aurait pu ôter une conjaration de précieuses.
Que ſi ie fuis aſſez heureux, pour auoir außi l’approbation de V.	Que si ici fuis assez heureux, pour avoir aussi l'approbation de V.
A.	A.
ie me croiray glorieuſement vengé des Dames ſans pitié, qui ont tant voulu faire de mal à qui ne leur aauoit iamais rien fait.	Les me croirai glorieusement vengé des Dames sans pitié, qui ont tant voulu faire de mal à qui ne leur aauoit jamais rien fait.
VOSTRE ALLESSE, clairuoyante, camme elle eſt, aura nemarqué ſans doute, que mou;	VÔTRE ALLESSE, clairvoyante, camme elle est, aura nemarqué sans doute, que mou;
Epistre, qui ne doit eſtre pleine quæ de ſes loüanges, ne l’eſt iuſqu’icy que des auantures de ma Cumedie;	Épître, qui ne doit être pleine quæ de ses langes, ne l'est jusqu'ici que des aventures de ma Cumedie;
que i’en parle trop auuntageuſement;	que j'en parle trop avuntageusement;
& enfin, qu’il ſemble, que la plunte à ha main ie ne connois plus perſoune, & ne me counoy, pas moy meſnie.	et enfin, qu'il semble, que la plunte à ha main ils ne connais plus persoune, et ne me counoi, pas moi ménie.
Il eſt vray que les Epiſtres Liminaires doiuent eſtre des Panegyriques en Petit.	Il est vrai que les Épîtres Liminaires doivent être des Panégyriques en Petit.
Mais V.	Mais V.
A.	A.
eſt trop juſte pœur ne conſiderer pas, qu’ilest impoßible de la loüer autant qu’elle merite d’eStre loüée, & que c’est tout ce que pourroient faire les Donneurs de loüanges qui durent eternellement.	est trop juste pœur ne considérer pas, qu'ilest impossible de la louer autant qu'elle mérite d'eStre louée, et que c'est tout ce que pourraient faire les Donneurs de langes qui durent éternellement.
Les façons de parler ſont deffectueuſes où la matiere eſt trop abondante, & tout ce qu’on peut s’imaginer à la loüange d’vne Princeſſe d’vn merite extraordinaire, ne peut quaſi estre que des redites.	Les façons de parler sont défectueuses où la matière est trop abondante, et tout ce qu'on peut s'imaginer à la louange d'une Princesse d'être mérite extraordinaire, ne peut quasi être que des rédites.
Diray-je que V.	Dirai-je que V.
A.	A.
est du plus Illuſtre Sang du Monde?	est du plus Illustre Sang du Monde?
Il n’y a que quelques Indiens des plus éloignez du commerce des hommes qui le puißẽt ignorer.	Il n'y a que quelques Indiens des plus éloignez du commerce des hommes qui le puissẽt ignorer.
Parlerayie de ſon Courage?	Parleraiie de son Courage?
qui eſt, ſi ie l’oſe dire, encore plus grand que ſa condition.	qui est, si ici l'ose dire, encore plus grand que sa condition.
Parleray-ie de ſon Eſprit, que les Hyperboles meſmie ne peuuẽt aſſez exagerer?	Parlerai-je de son Esprit, que les Hyperboles mémie ne peuuẽt assez exagérer?
De ſa Beauté, de ſa Taille & de ſa Mine?	De sa Beauté, de sa Taille et de sa Mine?
qui peuuent ſeruir d’vn riche patron aux meilleurs Poëtes, pour repreſenter non ſeulement vne Heroine bien verifiée;	qui peuvent servir d'vn riche patron aux meilleurs Poètes, pour représenter non seulement une Héroine bien vérifiée;
mais auſi vne Diuinité telle que la Mere d’Aenée eſt admirablement bien décrite dans l’inimitable	mais ausi une Divinité telle que la Mère d'Aenée est admirablement bien décrite dans l'inimitable
Virgile.	Virgile.
Ou ie ne dirois pus tout ce qu’il faut dire, ou ie le dirois mal.	Ou ici ne dirais pus tout ce qu'il faut dire, ou apprendre le dirais mal.
Ie feray donc mieux de finir, en proteſtant que ie ſuis plus que perſonne du monde,	Je ferai donc mieux de finir, en protestant que tu suis plus que personne du monde,
De F.	De F.
A.	A.
E.	E.
Ltres-humble & tres, abeiſant fernite *04R	Ltres-humble et très, abéisant fernite *04R
Extraict du Priuilege du Roy.	Extrait du Privilège du Roi.
Ar grace & Priuilege du Roy, I donné à Paris le 4.	Ar grâce et Privilège du Roi, I donné à Paris le 4.
Decẽbre 1654.	Décembre 1654.
ſigné BERAVD, & ſeellé, il eſt permis à ANTOINE DE SOMMAVILLE Marchand Libraire à Paris, d’imprimer ou faire imprimer vne piece de Theatre intirulée L’Eſcolier de Salamanque, oules Genereux Ennemis, de la compoſition du Sieur SCARRON, pendant le temps & eſpace de 5.	signé BERAUD, et seelé, il est permis à ANTOINE DE SOMAVILLE Marchand Libraire à Paris, d'imprimer ou faire imprimer une pièce de Théâtre intirulée L'Escolier de Salamanque, oules Généreux Ennemis, de la composition du Sieur SCARON, pendant le temps et espace de 5.
ans, à compter du iour qu’il ſera acheué d’imprimer pour la premiere fois, & deffenſes à tous Imprimeurs, Libraires & autres, de l’imprimer ou faire imprimer, vendre & debiter sãs ſon conſentement à peine de confiſcation des exemplaires, cinq cens liures d’amande, & de tous deſpens dommages & intereſts, comme il eſt plus au long porté par leſdites Lettres de Priuilege.	ans, à compter du jour qu'il sera achevé d'imprimer pour la première fois, et défenses à tous Imprimeurs, Libraires et autres, de l'imprimer ou faire imprimer, vendre et débiter sans son consentement à peine de confiscation des exemplaires, cinq cens livres d'amende, et de tous dépens dommages et intérêts, comme il est plus au long porté par lesdites Lettres de Privilège.
AGTEVRS.	AGTEURS.
CASSANDRE, Sœurjdu Comtt.	CASSANDRE, Sœurjudu Compt.
LA TATLLADE - Brae M Brauëss i o iip nu ui do fele nos	LA TATLLADE - Ès BRAVE Brauëss y ô jip nu ui do flèle nos
L’ESCOLIER I SALAMANQVE, LES GENEREVX ENNEMIS.	L'ÉCOLIER I ALAMANQUE, LES GÉNÉREUX ENNEMIS.
TRAGI-COMEDIE.	TRAGI-COMÉDIE.
ACTE I.	ACTE I.
CENE I.	CÈNE I.
COMTE;	COMTE;
LEONORE, BEATRIS:	LENORE, BEATRIZ:
LE COMTE.	LE COMTE.
Ovs ne voulez donc pas, Madame, que ie ſorte?	Ous ne voulez donc pas, Madame, que sans sorte?
LEONORE.	LEONORE.
Non, ie ne le veux pas.	Non, Seigneur ne le veux pas.
Ferme, ferme la porte;	Ferme, ferme la porte;
Ouure moy, Beatris.	Ouvre moi, Béatris.
LE COMTE.	LE COMTE.
BEATRIS.	BEATRIZ.
Ie ne puis, ny ne dois.	Je ne puis, Seigneur ne dois.
Maudit ſoit le verrouïl qui m’a pincé les doigs.	Maudit soit le verrouil qui m'a pincé les doigs.
Beatris, LE COMTE.	Béatris, LE COMTE.
LEONORE.	LEONORE.
Ferme-là, quoy qu’il te puiſſe dire.	Ferme-là, quoi qu’il te puisse dire.
BEATRIS.	BEATRIZ.
Elle l'eſt autant vaut.	Elle l'est autant vaut.
LE COMTE.	LE COMTE.
Madame, eſt-ce pour rire Que vous voulez ainſi m’enfermer mal-gré moy?	Madame, est-ce pour rire Que vous voulez ainsi m'enfermer mal-gré moi?
PPONORE.	PPONORE.
Non, c’eſt pour t'eſprouuer.	Non, c'est pour t'éprouver.
LE COMTE.	LE COMTE.
M’eſprouuer!	M'éprouver!
& pourquoy a	et pourquoi a
LEONORE.	LEONORE.
Tune t’en nas pas ſans i anon eſcoutée.	Tune t'en nas pas sans y ânon écoutée.
LE COMTE.	LE COMTE.
S'il ne tient qu’à cela, vous ſerez contentée:	S'il ne tient qu'à cela, vous serez contentée:
LEONORE.	LEONORE.
Mais ie veux qu'on m’eſcoute auec attention.	Mais ici veux qu'on m'écoute avec attention.
BEATRIS.	BEATRIZ.
Mais vous;	Mais vous;
parlez plus bas de peur d’inuaſion, Noſtre vieillard qui dort, eſt d’vn ſommeil fort tenSi vous parlez trop haut, il pourra vous entendre,	parlez plus bas de peur d'invasion, Notre vieillard qui dort, est d'un sommeil fort tenS vous parlez trop haut, il pourra vous entendre,
LE COMTE.	LE COMTE.
He bien, Madame,	He bien, Madame,
LEONORE.	LEONORE.
Hé bien, pour me faire eſcouter, Deurois-je eſtre reduite à te faire arreſter?	Hé bien, pour me faire écouter, Deurais-je être réduite à te faire arrêter?
Eſt-ce là l’action d’vn amant ſi fidelle?	Est-ce là l'action d'un amant si fidèle?
LE COMTE.	LE COMTE.
Madame, ie me tais:	Madame, Seigneur me tais:
Mais vous cherchez querelle.	Mais vous cherchez querelle.
LEONORE.	LEONORE.
Ie ne la cherche point :	Je ne la cherche point :
mais toy m'en accuſer C’eſt m’en vouloir faire vne, & c’eſt en mal-vſer.	mais toi m'en accuser C'est m'en vouloir faire une, et c'est en mal-vser.
Depuis que tes reſpects, tes ſouſpirs, & tes plaintes, Ont ſçeu gagner mon cœur & diſſiper mes craintes, Enfin depuis le temps que la premiere fois, Tu me iuras de viure & mourir ſous mes Loix.	Depuis que tes respects, tes soupirs, et tes plaintes, Ont sçeu gagner mon cœur et dissiper mes craintes, Enfin depuis le temps que la première fois, Tu me juras de vivre et mourir sous mes Lois.
Deux hyuers à la terre ont ſes beautez vollées, Eb deux eſtez deux fois les ont renouuellées.	Deux hivers à la terre ont ses beautés volées, Éb deux estez deux fois les ont renouvelées.
Mon eſprit, cependant par le tien enchanté, N a iamais eu ſoupçon de ta ſincerité, Et ſur moins de ſermens, de lettres, de promeſſes Ne t'en auroit pas moins teſmoigné de tendreſſes.	Mon esprit, cependant par le tien enchanté, N a jamais eu soupçon de ta sincérité, Et sur moins de serments, de lettres, de promesses Ne t'en aurait pas moins témoigné de tendresses.
Pendant cét heureux temps que Tolede & l’Amour Te faiſoient oublier & Madrit & la Cour;	Pendant cet heureux temps que Tolède et l'Amour Te faisaient oublier et Madrit et la Cour;
Tu ſçais bien que mes yeux des Galans de Tolede, Eſtoient en meſme temps le mal & le remede.	Tu sais bien que mes yeux des Galants de Tolède, Étaient en même temps le mal et le remède.
T’ayant donné mon cœur, les autres vainement Cherchoient dans mes faueurs le moindre allegementi Quoy que de ton amour trop toſt perſuadée, Ma vertu toutesfois m’auoit touſiours guidée.	T'ayant donné mon cœur, les autres vainement Cherchaient dans mes faveurs le moindre allégementi Quoi que de ton amour trop tôt persuadée, Ma vertu toutefois m'avait toujours guidée.
Ie reglois mes faueurs aux loix de mon honneur;	Je règlais mes faveurs aux lois de mon honneur;
Alors que trop ſenſible aux ſouſpirs de ton cœur, Ou pour dire le vray, trop inconſiderée, Dans mon appartement ie te donne vne entrée.	Alors que trop sensible aux soupirs de ton cœur, Ou pour dire le vrai, trop inconsidérée, Dans mon appartement ie te donne une entrée.
Là ſans preſter l'oreille à ma foible raiſon, Et ſans m’aſſeurer mieux contre vne trahiſon;	Là sans prêter l'oreille à ma faible raison, Et sans m'assurer mieux contre une trahison;
Sur vh ſimple papier tu vois que ie m’expoſe, Aux tranſports indiſcrets d’vn amant qui tout oſeiPeut eſtre que ton feu deuient deſia plus lent, Parce qu’il a trouué le mien trop violent.	Sur vh simple papier tu vois que ie m'expose, Aux transports indiscrets d'un amant qui tout oseiPeut être que ton feu dé desya plus lent, Parce qu'il a trouvé le mien trop violent.
A ij La crainte d'vn meſpris m’a deſia l’ame atteinte, Deſia le repentir accompagne ma crainte:	A Ajà La crainte d'Hommes mépris m'a déjà l'âme atteinte, Désia le repentir accompagne ma crainte:
Mais à ce repentir, cher Comte) ſi tu veux Tu feras ſucceder la ioye, & tu le peux.	Mais à ce repentir, cher Comte) si tu veux Tu feras succéder la joie, et tu le peux.
Tu ſçais que noſtre Race eſt égale à la rienne, Et que pour eſtre pauure, elle eſt fort ancienne.	Tu sais que notre Race est égale à la rienne, Et que pour être pauvre, elle est fort ancienne.
Ta promeſſe t’oblige à me donner la main;	Ta promesse -t'oblige à me donner la main;
Ta toy de l'accomplir ſans attendre à demain.	Ta toi de l'accomplir sans attendre à demain.
Tu deſpens de toy mefme, & contre ta parole, Tu ne peus m’alleguer qu'vne excuſe friuolle;	Tu dépens de toi même, et contre ta parole, Tu ne pus m'alléguer qu'une excuse frivole;
Et puis que mon amour faĩt vn excés pour toy, Il faut que ton amour faſſe vn excés pour moy:	Et puis que mon amour faĩt un excès pour toi, Il faut que ton amour fasse un excès pour moi:
Mais que dis-je vn excés?	Mais que dis-je un excès?
Tout ce que tu peux faire, Et meſme cét Hymen ne me peut ſatisfaire, S’il faut que cét Hymen que ta main m’a promis, Par ton cœur reffroidy ſoit tant ſoit peu remis.	Tout ce que tu peux faire, Et même cet Hymen ne me peut satisfaire, S'il faut que cet Hymen que ta main m'a promis, Par ton cœur reffroidi soit tant soit pu remis.
L’honneur que i'en reçois, qui d’autãt plus me touche, Qu'il n’aura rien d’indigne exigé de ma bouche, Ne ſe verra iamais hors de mon ſouuenir, Et iamais.	L'honneur que j'en reçois, qui d'autant plus me touche, Qu'il n'aura rien d'indigne exigé de ma bouche, Ne se verra jamais hors de mon souvenir, Et jamais.
LE COMTE.	LE COMTE.
Ie voy bien où vous voulez venir, Madame:	Je vois bien où vous voulez venir, Madame:
ie voy bien où tend voſtre harangue, Sans tant vous fatiguer & l’eſprit & la langue Sachez en peu de mots ce que i’ay ſur le cœur, Il n’eſt rien de plus vray, que voſtre œil mon vainqueur, Eſt & ſera touſiours ma Deïté viſible:	Ce vois bien où tend votre harangue, Sans tant vous fatiguer et l'esprit et la langue Sachez en peu de mots ce que j'ai sur le cœur, Il n'est rien de plus vrai, que votre œil mon vainqueur, Est et sera toujours ma Deïté visible:
Mais, Madame, il eſt vray, qu’il m’eſt autant poſſible De ne vous aimer plus, moy qui vous aime tant?	Mais, Madame, il est vrai, qu'il m'est autant possible De ne vous aimer plus, moi qui vous aime tant?
Que d’eſtre voſtre eſpoux, & demeurer conſtant.	Que d'être votre époux, et demeurer constant.
I'adore vne Maiſtreſſe & i’abhorre vne Femme, Ie n’ay plus rien à dire apres cela, Madame,	J'adore une Maîtresse et j'abhorre une Femme, Je n'ai plus rien à dire après cela, Madame,
LEONORE.	LEONORE.
Tu n'as plus rien à dire!	Tu n'as plus rien à dire!
à moy!	à moi!
cruel, à moy!	cruel, à moi!
Tu n’as plus rien à dire à qui fait tout pour toy?	Tu n'as plus rien à dire à qui fait tout pour toi?
Perſide!	Perside!
Il n’eſt plus temps de deguiſer ton crime.	Il n'est plus temps de déguiser ton crime.
A mon amour au moins tu deuois de l’eſtime, Et loin de m'eſtimer eſprit méconnoiſſant, Tu payes mon amour d’vn meſpris offençant.	À mon amour au moins tu devais de l'estime, Et loin de m'estimer esprit méconnaissant, Tu payes mon amour d'un mépris offensant.
I'adore vne Maiſtreſſe, & i’abhorre vne femme!	J'adore une Maîtresse, et j'abhorre une femme!
Sont-ce là les diſcours d’vn honneſte homme?	Sont-ce là les discours d'un honnête homme?
inſame!	insame!
Et i’abhorre vne femme!	Et j'abhorre une femme!
à moy, de tels diſcours?	à moi, de tels discours?
Moy, Reine de ton cœur, l’arbitre de tes iours:	Moi, Reine de ton cœur, l'arbitre de tes jours:
Moy, ta felicité, ta Deeſle adorable, Sans qui tout autre object t’eſtoit inſupportable.	Moi, ta félicité, ta Deesle adorable, Sans qui tout autre object t'était insupportable.
Ce ſont là les diſcours ſi ſouuent repetez, Et crus trop ayſément comme trop eſcoutez.	Ce sont là les discours si souvent répétés, Et crus trop aisément comme trop écoutez.
Tu ne les faiſois donc d’vne voix languiſſante Que pour te ioüer mięux d’vne fille innocente.	Tu ne les faisais donc d'une voix languissante Que pour te jouer miux d'une fille innocente.
Tu me trahiſſois donc?	Tu me trahissais donc?
& de cette action, Ta vanité ſe rit à ma confuſion.	et de cette action, Ta vanité se rit à ma confusion.
Mais tu n'es pas encor;	Mais tu n'es pas encor;
ſcelerat, où tu penſes, Vn cœur noble offencé ſçait venger ſes offences.	scélérat, où tu penses, Un cœur noble offensé Sait venger ses offenses.
Ie vengeray la mienne, & ſi ie ne le puis, Ie ne veux plus ſuruiure à l'eſtat où ie ſuis.	Je vengerai la mienne, et si ici ne le puis, Je ne veux plus survivre à l'état où tu suis.
La reputation n’eſt plus conſiderée, Quand on eſt trop épriſe, ou trop deſeſperée.	La réputation n'est plus considérée, Quand on est trop éprise, ou trop désespérée.
Tu me verras par tout ſans ceſſe ſur tes pas, Tant que ſous ma douleur ie ne periray pas:	Tu me verras par tout sans cesse sur tes pas, Tant que sous ma douleur Dieux ne périrai pas:
Et quand de ma douleur ie ſeray la victime, Mon ombre iour & nuict le bourreau de ton crime, Te pourſuiuant par tout, meſchant, tu ſeruiras, D'eſpouuentable exemple aux Traiſtres, aux Ingrats.	Et quand de ma douleur se serai la victime, Mon ombre jour et nuit le bourreau de ton crime, Tué poursuiuant par tout, méchant, tu serviras, D'espouventable exemple aux Traîtres, aux Ingrats.
Mais à quoy differer mon treſpas dauantage, Il faut que ton fer meſme acheue ton ouurage.	Mais à quoi différer mon trépas davantage, Il faut que ton fer même achève ton ouvrage.
im.	im.
hadame.	hadame.
LE COMTE.	LE COMTE.
LEONORE.	LEONORE.
Ha!	Ha!
cruel.	cruel.
LE COMTE.	LE COMTE.
Et que me voulez-vous?	Et que me voulez-vous?
LEONORE.	LEONORE.
Ie veux perdre la vie.	Je veux perdre la vie.
BEATRIS.	BEATRIZ.
Ha!	Ha!
mon Dieu, filez doux.	mon Dieu, filez doux.
Le vieillard réueillé touſſe depuis vne heure, Et crache ſon poulmon depuis deux, où ie meure.	Le vieillard réueillé tousse depuis une heure, Et crache son poulémon depuis deux, où on meure.
DBONORE.	DONORE.
Onprape à la porte.	Onprappe à la porte.
Pieux!	Pieux!
l’on frappe à la porte.	l'on frappe à la porte.
BEATRIS.	BEATRIZ.
Et meſme rudement,	Et même rudement,
DOM FELIX, derriere le Theatre.	DOM FELIX, derrière le Théâtre.
Ouurez.	Ouvrez.
LEONORE.	LEONORE.
Cache toy donc de grace, & promptement.	Cache toi donc de grâce, et promptement.
O quel mal-heur!	Ô quel malheur!
LE COMTE.	LE COMTE.
Qui moy?	Qui moi?
me cacher?	me cacher?
Diod m’en garde.	Diod m'en garde.
LEONORE.	LEONORE.
la Sionge a mnon homcor qui pour toy ſe hazardr.	la Sionge a mennon homcor qui pour toi se hasardr.
LE COMTE.	LE COMTE.
Ie pourray bien ſauter de la feneſtre en bas,	Je pourrai bien sauter de la fenêtre en bas,
Elle eſt grillée.	Elle est grillée.
LEONORE.	LEONORE.
DOM FELIX, touſiours derriere le Theatre, Ouurez.	DOM FELIX, toujours derrière le Théâtre, Ouvrez.
BEATRIS.	BEATRIZ.
La ſerrure eſt meſlée.	La serrure est mêlée.
La clef ne tourne pas,	La clef ne tourne pas,
DOM FELIX.	DOM FELIX.
Ouurez, disije.	Ouvrez, disije.
A l fin ie me faſche,	À l fin Seigneur me fâche,
LE COMTE.	LE COMTE.
Madame, où faut-il qu’on ſe cache?	Madame, où faut-il qu'on se cache?
LEONORE.	LEONORE.
saute ſur la feneſtre, & la ferme apres toy,	saute sur la fenêtre, et la ferme après toi,
Ouuriray-ie?	Ouvrirai-je?
BEATRIS.	BEATRIZ.
LEONORE.	LEONORE.
Atten;	Atten;
ouure.	ouvre.
DOM FELIX.	DOM FELIX.
Et fon ſe rit de moy:	Et son se rit de moi:
Chienne de Beatris, ſi tantoſt.	Chienne de Bétris, si tôt.
BEATRIS.	BEATRIZ.
Ie me briſois les doigs.	Je me brisais les doigs.
Patience,	Patience.
SCENE II.	SCÈNE II.
SUNI FELIX.	SUNI FELIX.
BEATRIS.	BEATRIZ.
LEONORE.	LEONORE.
LE COMTE.	LE COMTE.
DOM FELIX en entrant.	DOM FELIX en entrant.
A tourner vne clef.	À tourner une clef.
La belle diligence	La belle diligence
BBATRIS.	BBATRIS.
On ne s’en peut ayder, Il faut vn ſerrurier pour la racommoder.	On ne s'en peut aider, Il faut un serrurier pour la racommoder.
DOM FELIX.	DOM FELIX.
Toufiours des ſrruriers, & de l’argent deſpendre.	Toufiours des srruriers, et de l'argent dépendre.
A iinj Les bourreaux de valets ne valent pas le pendre.	À jinj Les bourreaux de valets ne valent pas le pendre.
Quoy, ma nſie veſtue au leu d’eſtre en ſon lit!	Quoi, ma nsie vue au lu d'être en son lit!
LEONORE.	LEONORE.
l'auois pris mes habits, parce qu’elle m’a dit Que vous eſtiez malade.	l'avais pris mes habits, parce qu'elle m'a dit Que vous étiez malade.
D'OM FELIX.	D'OM FELIX.
Il eſt vray que mon rhume Ma tourmenté la nuict & plus que de couſtumeMais mon rhume n’eſt pas ce qui m’amene icy:	Il est vrai que mon rhume Ma tourmenté la nuit et plus que de coutumeMais mon rhume n'est pas ce qui m'amène ici:
Quand on a des enfans on n’eſt pas ſans ſoucy.	Quand on a des enfants on n'est pas sans souci.
LEONORE.	LEONORE.
Helas!	Hélas!
il ſçait ma faute.	il sait ma faute.
DOM FELIX.	DOM FELIX.
Et par trop d’indulgence On ſerend mal-heureux.	Et par trop d'indulgence On serend malheureux.
LEONORE.	LEONORE.
Se pourra reparer.	Se pourra réparer.
Mon pere cette offence	Mon père cette offense
DOM FELIX.	DOM FELIX.
Oüy, i'en auray raiſon:	Oui, j'en aurai raison:
Car enfin, c’eſt ioüer à perdre ma maiſon.	Car enfin, c'est jouer à perdre ma maison.
LEONORE.	LEONORE.
Il m'acent fois promis.	Il m'acent fois promis.
DOM FELIX.	DOM FELIX.
Et folle, à la promeſſe D'vne inconſidlerée & peu ſage jeuneſſe Veux-tu bien te fier?	Et folle, à la promesse D'une inconsidérée et peu sage jeunesse Veux-tu bien te fier?
LEONORE.	LEONORE.
Mon pere, à vos genoux Ie vous promets pour luy qu’il fera.	Mon père, à vos genoux Je vous promets pour lui qu'il fera.
DOM FELIX.	DOM FELIX.
Moncouroux* L’emporte ſur mon ſang, Quand on eſt trop bon per On gaſte ſes enfans:	Moncourroux L'emporte sur mon sang, Quand on est trop bon per On gâte ses enfants:
Voſtre fripon de frere A perdu ſon argent.	Votre fripon de frère A perdu son argent.
LEONORE.	LEONORE.
Ie repren mes eſprits.	Je repren mes esprits.
Ie croy qu'à Salamanque il emporte le prix Des fripons ſignalez.	Je crois qu'à Salamanque il emporte le prix Des fripons signalés.
Venez oüir ſa lettre, Ie ne m’y fieray plus, il aura beau promettre.	Venez ouïr sa lettre, Je ne m'y fierai plus, il aura beau promettre.
LETTRE, La paix du Seigneur vous ſoit donnée, &c.	LETTRE, La paix du Seigneur vous soit donnée, etc.
Le beau commencement de lettre que voicy:	Le beau commencement de lettre que voici:
Croit-il mo tromper mieux en m’écriuant ainſi.	Croit-il mo tromper mieux en m'écrivant ainsi.
La paix du Seigneur vous ſoit donnée:	La paix du Seigneur vous soit donnée:
Vous apprendrez par la preſente, que i’ay ioüé & pordu à la Prime l’argent áe m’a penſion:	Vous apprendrez par la présente, que j'ay joué et pordu à la Prime l'argent a pension:
mais au moins i’ay la ſatisfaction d’auoir perdu mon argent à cinquante cinq, & qu’il n’a pas moins fallu qu’vn Flux pour me faire perdre.	mais au moins j'ai la satisfaction d'avoir perdu mon argent à cinquante cinq, et qu'il n'a pas moins fallu qu'un Flux pour me faire perdre.
Ie vous prie de ne vous en allarmer point;	Je vous prie de ne vous en alarmer point;
car i’ay fait ſerment dene renuier iamais ſans les auœr en la main.	car j'ai fait serment dene renvier jamais sans les avœr en la main.
Vous ſçauez mieux que moy, que qui n’a pas de quoy manger court riſque de mourir de faim, & que vous eſtes tenu de m’en fournir, ne vous ayant point prié de me mettre au monde.	Vous savez mieux que moi, que qui n'a pas de quoi manger court risque de mourir de faim, et que vous êtes tenu de m'en fournir, ne vous ayant point prié de me mettre au monde.
Au reſte, ie ſuis d’vne humeur ſi pacifique que ie ne puis dormir quand i’ay vne querelle ſi is ne la vuide auſſi toſt.	Au reste, je suis d'une humeur si pacifique que je ne puis dormir quand j'ai une querelle si is ne la vide aussi tôt.
L’autre iour vn eſcolier Arragonnois m’importuud nant pour ſe battre auec moy, qu’il luy on couſta vu œil.	L'autre jour un écolier Arragonnais m'importuud nant pour se battre avec moi, qu'il lui on coûta vu œil.
Vous voyez par là que ie né ſuis pas ſi perdu que vous penſez.	Vous voyez par là que ici né suis pas si perdu que vous pensez.
Ie vous enuoye Criſpin, que vous me renuoyerez s’il vous plaiſt auec de l’argent.	Je vous envoie Crispin, que vous me renvoyerez s'il vous plaît auec de l'argent.
Ie me recommande à vos bonnes graces, cher Pere de mon ame, lumiere de mes yeux.	Je me recommande à vos bonnes grâces, cher Père de mon âme, lumière de mes yeux.
Ie prie Diau qu’il vous conſerue, & ma petite ſœur auſſi, de qui quoy qu’indigne ie me ſouuien touſjour, dans mes oraiſons.	Je prie Diau qu'il vous conserve, et ma petite sœur aussi, de qui quoi qu’indigne ) me souvien toujours, dans mes oraisons.
Voſtre humble Fili	Votre humble Fili
Dom PEDRE DE LESPEDE, De Salamanque ce demnier Octobra,	Dom PEDRE DE LÉPEDE, De Salamanque ce démnier Octobra,
LEONORE.	LEONORE.
La Lettre eſt fort deuote.	La Lettre est fort dévote.
DOM FELIX.	DOM FELIX.
Et voyez, ie vous prlei.	Et voyez, Seigneur vous prlei.
Et ſon hipocriſie & ſa veillaquerie.	Et son hypocrisie et sa veillaquerie.
Vn More Grenadin eſt plus que luy deuot, Encure que d’origine il ſoit Cheuallier Got.	Un More Grenadin est plus que lui dévot, Encure que d'origine il soit Chevallier Got.
Ie luy veux retrancher ſes vertus eſcolieres, Et vous veux faire voir ſon Deputé badin, Vn tres-rare animal, moitié cuiſtre & gredin, uola, Ceiſpin.	Je te veux retrancher ses vertus écolières, Et vous veux faire voir son Député badin, Un très-rare animal, moitié cuistre et gredin, uola, Ceispin.
SCENE III.	SCÈNE III.
CRISPIN.	CRISPIN.
DOM FELIX.	DOM FELIX.
LEONORE.	LEONORE.
BEATRIS.	BEATRIZ.
CRISPIN.	CRISPIN.
Adſum.	Adsum.
DOM FELIX.	DOM FELIX.
Parle Chreſtien, ſot homme,	Parle Chrétien, sot homme,
Non poſſum.	Non possum.
CRISPIN.	CRISPIN.
DOM FELIX.	DOM FELIX.
Si ie pren vn baſton, ie t’aſſomme.	Si ici pren un bâton, Seigneur t'assomme.
Four trois mots de Latin que le maroufle ſçait, Il en eſt importun.	Four trois mots de Latin que le maroufle sait, Il en est importun.
Hé bien donc, comment fait Mon bon vaurien de fils	Hé bien donc, comment fait Mon bon vaurien de fils
GRISPIN.	GRISPIN.
Male facit.	Male facit.
DOM FELIX.	DOM FELIX.
Encore!	Encore!
Ha tie t'eſtrangleray, Pedanteſque pecore.	Ha tye t'étranglerai, Pédantesque pécore.
CRISPIN.	CRISPIN.
Tout beau, Monſieur, tout beau, ie n’en crachãay plus.	Tout beau, Monsieur, tout beau, ie n'en crachamai plus.
DOM FELIX.	DOM FELIX.
Ton Maiſtre donc?	Ton Maître donc?
CRISPIN.	CRISPIN.
Il loge auecque ſept goulus Desbauchez comme luy, dans vne chambre ſeule, Où touſiours quelqu’vn iure, où dit des mots de gurulle.	Il loge auecque sept goulus Desbauchez comme lui, dans une chambre seule, Où toujours quelqu'un jure, où dit des mots de gurulle.
L'hyutr, le vent y donne autant que dans les champs.	L'hyutr, le vent y donne autant que dans les champs.
Ils couchent quâtre à quâtre en deux lits fort meſchans.	Ils couchent quâtre à quâtre en deux lits fort méchants.
Les murs y ſont parez de Rondeiles, d'eſpées, De portraicts de charbon, de toilles d’araignées.	Les murs y sont parés de Rondeiles, d'épées, De portraits de charbon, de toilles d'araignées.
Ces huict bons eſcoliers, ou pluſtoſt huict bandits, Chomment les Samedis comme les Vendredis.	Ces huit bons écoliers, ou plutôt huit bandits, Chomment les Samedis comme les Vendredis.
Haïſſent les leçons comme les Parenoſtres, Et ne font chaque iour que debaucher les autres.	Haïssent les leçons comme les Parenôtres, Et ne font chaque jour que débaucher les autres.
La nuict venuë, ils vont enleuer des manteaux, Plier quelque toillette, & loüer des couſteaux, Ils ſe couchent fort tard, & ſe leuent de meſme.	La nuit venue, ils vont enlever des manteaux, Plier quelque toillette, et louer des couteaux, Ils se couchent fort tard, et se lèvent de même.
Vne ſeruante maigre, acariaſtre, bleſme, Seiche, ferrant la mule, & qui compte trente ans Depuis qu’elle renonce à l’vſage des dens, Leur appreſte à manger.	Une servante maigre, acariâtre, blême, Seiche, ferrant la mule, et qui compte trente ans Depuis qu'elle renonce à l'usage des dens, Leur apprête à manger.
Chacun y mange en Diablej Ou ſi l'on veut en chien.	Chacun y mange en Diablej Ou si l'on veut en chien.
Vn coffre y ſert de table, Du vin à quantité, peu de mets delicats, Des Liures pleins de graiſſes y tiennent lieu de plats:	Un coffre y sert de table, Du vin à quantité, peu de mets délicats, Des Livres pleins de graisses y tiennent lieu de près:
Quand l’vn mange trop fort, les ſept autres enleuent Ce qu’il a deuant luy, ſe pillent, & s’en creuent, S’entend, alors qn'ils ont prou de quoy fe creuer;	Quand l'un mange trop fort, les sept autres enlèvent Ce qu'il a devant lui, se pillent, et s'en crèvent, S'entend, alors qn'ils ont prou de quoi ie cruer;
Car ſouuent ce n’eſt pas coup ſeur que d’en trouuer?	Car souvent ce n'est pas coup sûr que d'en trouver?
En peu de mots, voila de voſtre fiſs la vie.	En peu de mots, voilà de votre fiss la vie.
LEONORE.	LEONORE.
De ſa Relatton, pour moy ie ſuis rauie.	De sa Relatton, pour moi -même suis ravie.
DOM FELIX.	DOM FELIX.
Pour vn ſot de College, il parle plaiſamment:	Pour un sot de Collège, il parle plaisamment:
Mais n’a-t-il rien de bon, ce mauuais garniment!	Mais n'a-t-il rien de bon, ce mauvais garniment!
CRISPIN.	CRISPIN.
De bon!	De bon!
Il a tout bon, quoy que i'aye pu dire.	Il a tout bon, quoi que j'aie pu dire.
Il eſt de bonne humeur, il a le mot pour rire.	Il est de bonne humeur, il a le mot pour rire.
Quand il eſt queſtion d’vn diſcours ſerieux, Vn Caton le Cenſeur ne le feroit pas mieux.	Quand il est question d'une discours sérieux, Un Caton le Censeur ne le ferait pas mieux.
Il eſt officieux, ne refuſe perſonne, Il preſte ſans regret, ſans faire attendre donne, It eſt fort ponctuel alors qu’il à promis, Ciuil quoy que vaillant, & fait beaucoup d'amis, Au reſte liberal autant qu'vn Alexandre.	Il est officieux, ne refuse personne, Il prête sans regret, sans faire attendre donne, It est fort ponctuel alors qu'il à promis, Civil quoi que vaillant, et fait beaucoup d'amis, Au reste libéral autant qu'un Alexandre.
Euis cclegrand mhameur qu’il n’a dequoy dependre Ayuat bon appetit & de meilleures dens.	Euis cèglegrand mhameur qu'il n'a dequoy dépendre Aivat bon appétit et de meilleures dens.
DOM FELIX.	DOM FELIX.
Voila comme i'eſtois durant mes ieunes ans.	Voilà comme j'étais durant mes jeunes ans.
Il faut que de mon fils la ieuneſſe ſe paſſe, Tien von de lagent:	Il faut que de mon fils la jeunesse se passe, Tien von de lagent:
mais dy luy bien qu’il faſſe Beaucoup mieux qu’il n’a fait, & qu’il ſoit menager.	mais dis quelque bien qu'il fasse Beaucoup mieux qu'il n'a fait, et qu'il soit ménager.
Quoy!	Quoi!
des bottes, faquin, comme vn cheuau-leger, Commn de d ven.	des bottes, faquin, comme un cheau-léger, Commn de d ven.
CRISPIN.	CRISPIN.
Par la poſte, en charette.	Par la poste, en charette.
D.	D.
OM ECLIX.	OM ECLIX.
L'inuention m'en plaiſt:	L'invention m'en plaît:
va, ta dépeſche eſt faitet	va, ta dépêche est faitet
CRISPIN.	CRISPIN.
Vous n'eſcriuez donc point?	Vous n'écrivez donc point?
DOM FELIX.	DOM FELIX.
Non, de largent ſuffit.	Non, de largent suffit.
CRISPIN.	CRISPIN.
Il s'en va C’eſt agir à mon ſens comme vn bomme d’eſprit;	Il s'en va C'est agir à mon sens comme un bomme d'esprit;
Que Dieu garde de mal tout pere de la ſorte.	Que Dieu garde de mal tout père de la sorte.
La deſſus ie prendray le chemin de la porte.	La dessus Prince prendrai le chemin de la porte.
DOM FELEX.	DOM FÉLEX.
Ie ne ſçaurois dormir alors qu'on m'a faſché:	Je ne saurais dormir alors qu'on m'a fâché:
Et ma toux me reprent quand ie veille couché.	Et ma toux me reprend quand ici veille couché.
Vous autres couchez vous, il eſt tantoſt vne heure?	Vous autres couchez -vous, il est tantôt une heure?
Mais appellez Criſpin:	Mais appelez Crispin:
I’oubliois où ie meure De luy dire vne choſe importante à mon fils, Il faut le rappeller:	J'oubliais où ainsi meure De lui dire un chose importante à mon fils, Il faut le rappeler:
va viſte, Beatris.	va vite, Béatris.
BEATRIS.	BEATRIZ.
Vrayment il eſt bien loin d'icy, le vilain homme, Ia tiré de lonque ayant touché la ſonme, I’aurois beau lappeller, il ne m’entendroit pas.	Vraiment il est bien loin d'ici, le vilain homme, Ia tiré de lonque ayant touché la sonme, J'aurais beau lapeler, il ne m'entendrait pas.
DOM FELIX.	DOM FELIX.
La double pareſſeuſe;	La double paresseuse;
à peine eſt-il en bas, Il peut eſtre en la ruë, appelle à la feneſtre.	à peine est-il en bas, Il peut être en la rue, appelle à la fenêtre.
BEA TRIS.	BEA TRIS.
De la façon qu’il court, Monſieur, il n’y peut eſtra.	De la façon qu'il court, Monsieur, il n'y peut estra.
DOM FELIX.	DOM FELIX.
Peur eſtre eſt-il encor aupres de la maiſon,	Peur être est-il encor auprès de la maison,
LEONORE.	LEONORE.
Et que luy voalez-vous?	Et que mille voalez-vous?
DON FELIX.	DON FELIX.
ouy, ie reudray saldoa De ce que ie commande?	oui, Seigneur revdrai saldoa De ce que ici commande?
LEONORE.	LEONORE.
Ha!	Ha!
Beatris, ie tremble, Noſtre Comte eſt trouué:	Bétris, Seigneur tremble, Notre Comte est trouvé:
Bon Dieix?	Bon Dieix?
BEATRIS.	BEATRIZ.
H me leſimble.	H me lesimble.
DOM FELIX.	DOM FELIX.
Vener pu l vοe il faut appeller vn valet.	Vener pu l ène il faut appeler un valet.
On a dellé, ſant doux, ou cloüé ce vollet, Dol, foron qu'iluient.	On a dellé, sant doux, ou cloüé ce vollet, Dol, foron qu'ilvient.
LEONORE.	LEONORE.
& Faeur eſt exuínd	et Faeur est exund
BOM FELIX.	BOM FELIX.
Comment, Diable?	Comment, Diable?
Ie croy qu’il s'ouure de luymeſme.	Je crois qu'il s'ouvre de Seigneur.
Alu, Muateſuen toy,	Alu, Muatesuen toi,
SCENE IV.	SCÈNE IV.
2 LE COMTE.	2 LE COMTE.
DOM FELIX.	DOM FELIX.
LEONORE.	LEONORE.
BEATRIS.	BEATRIZ.
LE COMTE.	LE COMTE.
C'eſt vn homme enfermé, Qui n’eſt pas ſans courage, & n’eſt pas mal-armé.	C'est un homme enfermé, Qui n'est pas sans courage, et n'est pas mal-armé.
DOM FELIX.	DOM FELIX.
O toy, qui que tu ſols, de qui ie pren ombrage, Tant pour lheure, le lieu, que pour ton equipage, Et de qui la ſurpriſe eſt la conuiction, Qui t’a mis en ces lieux?	Ô toi, qui que tu sols, de qui as pren ombrage, Tant pour lheure, le lieu, que pour ton équipage, Et de qui la surprise est la conviction, Qui t'a mis en ces lieux?
LE COMTE.	LE COMTE.
A eelle queſtion, le ne de reipouuron qu auce vn coup d’eſpée, Si tu pouuois venger ta vieilleſſe frappée:	À celle question, le ne de reipouuron qu' ce un coup d'épée, Si tu pouvais venger ta vieillesse frappée:
Mais ta main eſt ſans arme, & pour des cheueux grit Ie n’ay point de colere, & n’ay que du meſpris.	Mais ta main est sans arme, et pour des cheveux grit -Je n'ai point de colère, et n'ai que du mépris.
DOM FELIX.	DOM FELIX.
Permets moy de ſortir, promets-moy de m’attendre Et tu ſeras bien-toſt reduit à te deffendre.	Permets moi de sortir, promets-moi de m'attendre Et tu seras bientôt réduit à te défendre.
LE COMTE.	LE COMTE.
le t’atten, va t'armer, & puis reuien mourir.	le t'atten, va t'-armer, et puis revien mourir.
B.	B.
ij	ij
Ha, mon pere!	Ha, mon père!
LEONORE.	LEONORE.
DOM FELIX.	DOM FELIX.
Ha, ma fille!	Ha, ma fille!
LEONORE.	LEONORE.
où voulez-vous courrir?	où voulez-vous courrir?
DOM FELIX.	DOM FELIX.
Ayde à mon ennemy, ſers à ton propre outrage, Ie voy mon deshonneur écrit ſur ton viſage.	Ayde à mon ennemi, sers à ton propre outrage, Je vois mon déshonneur écrit sur ton visage.
LEONORE.	LEONORE.
Mon pere, où vous conduit vne aueugle fureur?	Mon père, où vous conduit une aveugle fureur?
Vous ne la pouuez ſuiure, & ſauuer mon honneur.	Vous ne la pouvez suivre, et sauver mon honneur.
Puis qu’on veut m’eſpouſer, puis qu’on m’ayme & que i’ayme:	Puis qu'on veut m'épouser, puis qu'on m'aime et que j'aime:
Perdrez-vous mon eſpoux?	Perdrez-vous mon époux?
vous perdrez-vous vous.	vous perdrez-vous vous.
meſme?	même?
COMTE.	COMTE.
oſtez ce nom d'eſpoux de voſtre ſouuenir.	ôtez ce nom d'époux de votre souvenir.
I’ay promis, il eſt vray;	J'ai promis, il est vrai;
mais ſans vouloir tenint	mais sans vouloir tenint
DOM FELIX.	DOM FELIX.
Puis que tu las promis, il faut que tu le tlennes, Et l'inégalité de mes forces aux tiennes, Ne diminuera rien de mon reſſentiment, Satisfait Leonore, & ſans retardement, Où rauie à la ſois mon honneur & ma viea Ta rage ainſi ſera pleinement aſſouuie.	Puis que tu las promis, il faut que tu le tlennes, Et l'inégalité de mes forces aux tiennes, Ne diminuera rien de mon ressentiment, Satisfait Leonore, et sans retardement, Où ravie à la sois mon honneur et ma viea Ta rage ainsi sera pleinement assouvie.
Tu pretens moy viuant refuſer, inhumain.	Tu prétends moi vivant refuser, inhumain.
LE COMTE.	LE COMTE.
A toy, de te combatre, à ta fille, ma main.	A toi, de te combattre, à ta fille, ma main.
On joint mal-aiſement ſous les loix coniugales Ceux dont les qualitez ſe trouuent inégales.	On joint malaisément sous les lois conjugales Ceux dont les qualités se trouvent inégales.
Tes injures, toscris, ne peuuent m’irriter,	Tes injures, toscris, ne peuvent m'irriter,
Ie veux vn ennemy qui puiſſe reſiſter.	Je veux un ennemi qui puisse résister.
Ie ne veux point de femme, & quand l’en voudrois vne, I'en choiſirois vne autre, & d'vnè autre fortune.	Je ne veux point de femme, et quand l'en voudrais une, J'en choisirais une autre, et d'unè me fortune.
Pour me la faire prendre, il falloit me prier, Non pas me quereller, non pas m’injurier.	Pour me la faire prendre, il fallait me prier, Non pas mère quereller, non pas m'injurier.
Ie ne fay rien par force, & fay tout par priere;	Je ne fais rien par force, et fais tout par prière;
Aux humbles, ie ſuis doux;	Aux humbles, Madame suis doux;
aux fiers, i’ay lame fier, Et puis vos déplaiſirs me ſeront imputez:	aux fiers, j'ai lame fier, Et puis vos déplaisirs me seront imputez:
Prenez, prenez vous en à vos temeritez.	Prenez, prenez vous en à vos témérité.
I'ay dit ſur le ſujet tout ce que ie veux dire;	J'ai dit sur le sujet tout ce que je veux dire;
Penſez y meurement, & que ie me retire.	Pensez y meurement, et que tu me retire.
DOM FELIX.	DOM FELIX.
Tu ne t’en iras pas ſans me faire raiſon.	Tu ne t'en iras pas sans me faire raison.
LE COMTE.	LE COMTE.
La brauoure ſied mal à tout homme griſon.	La bravoure sied mal à tout homme grison.
DOM FELIX.	DOM FELIX.
D'autres bras que les miens vengeront mon offense.	D'autres bras que les miens vengeront mon offense.
LE COMTE.	LE COMTE.
Ie m'e n vay de ce pas ſonger à ma deffence.	Je m'e n' ai de ce pas songer à ma défense.
LEONORE.	LEONORE.
Ha ʳe perfide, ſans foy.	Ha re perfide, sans foi.
LE COMTE.	LE COMTE.
Ne vous faſchez pas tant, Pour remede à vos maux, i’ay de l'argent comptant.	Ne vous fâchez pas tant, Pour remède à vos maux, j'ai de l'argent comptant.
Adieu bel Ange en pleurs.	Adieu bel Ange en pleurs.
Et vous vieillard colere, Ne vous preſſez pas tant de deuenir beaupere.	Et vous vieillard colère, Ne vous pressez pas tant de devenir beaupère.
DOM FELIX.	DOM FELIX.
Ha, ſi ton bras m'eſpargne, inſolent rauiſſeux Ie prefere ſes coups à ta fauſſe douceur.	Ha, si ton bras m'épargne, insolent ravisseux Je préfère ses coups à ta fausse douceur.
M'ayaut oſté l'honneur en ma fille rauie, Pour allonger mes maux me laiſſes-tu la vie?	M'aiaut ôté l'honneur en ma fille ravie, Pour allonger mes maux me laisses-tu la vie?
Vien, vien, finir mes iours, ils n’ont que trop duré.	Viens, viens, finir mes jours, ils n'ont que trop duré.
Si i'auois moins vécu i’aurois moins enduré.	Si j'avais moins vécu j'aurais moins enduré.
B iij.	 Bij.
Mais differons encor cét extréme remede, Rappellons cependant Dom Pedre dans Tolede.	Mais différons encor cet extrême remède, Rappelons cependant Dom Pédre dans Tolède.
Ce fils que Dieu me laiſſe, eſt ieune, & courageux, Il ſçaura bien venger vn meſpris outrageux.	Ce fils que Dieu me laisse, est jeune, et courageux, Il saura bien venger un mépris outrageux.
Et li dans ce deſſein ſa vaillance ſuccombe, Nous chercherons alors le repos dans la Tombe.	Et li dans ce dessein sa vaillance succombe, Nous chercherons alors le repos dans la Tombe.
Et toy faſcheuxobjet de mes yeux deſolez, Va t'en verſer plus loin tes pleurs diſſimulez, Euite ma fureur, crain ton genereux Frere, Et plus que toutcela, crain le Ciel en colere;	Et toi fâcheuxobjet de mes yeux désolés, Va t'en verser plus loin tes pleurs dissimulez, Euite ma fureur, crain ton généreux Frère, Et plus que toutcela, crain le Ciel en colère;
Al n'eit ponit lauorabie aur Aiſans aueuglez, Et fait payer bien cher les plaiſirs déreiglez.	Al n'éit ponit lavorabie aur Aisans aveuglés, Et fait payer bien cher les plaisirs déreiglez.
beauis, donne-moy l’eſpée & la lanterne Qui ſont pres de mon lit.	beau, donne-moi l'épée et la lanterne Qui sont près de mon lit.
s’il ne fera le fouBEATRIS.	s'il ne fera le fouBEATRIS.
Ie veux que l'onme berne	Je veux que l'onme berne
DOM FELIX.	DOM FELIX.
Vas y donc promptement.	Vas y donc promptement.
D'icy pres chaque iour partent lournellement ta pluſpart des Coches qui vont à Salamanque:	D'ici pres chaque jour partent lournellement ta plupart des Coches qui vont à Salamanque:
Si j’atten à demain, i’ay peur que ie ne manque D'vn commode moyen, de faire reuenir Dom Pedre:	Si j'atten à demain, j'ai peur que je ne manque D'un commode moyen, de faire revenir Dom Pèdre:
Ie vai donc ſa place retenir, Son coquin de vallet s’eſt amuſé peut eſtre, Et n’aura pas encor retourné vers ſon Maiſtre.	Je vais donc sa place retenir, Son coquin de vallet s'est amusé peut -être, Et n'aura pas encor retourné vers son Maître.
ACTE II.	ACTE II.
SCENE I.	SCÈNE I.
DOM LOVIS.	DOM LOUIS.
ZAMORIN brauel4.	ZAMORIN bravel4.
Braues.	Bravez.
DOM LOVIS.	DOM LOUIS.
P’Ovs ſçauez mon deſſein.	P'Ous savez mon dessein.
ZAMORIN.	ZAMORIN.
Repoſez vous ſur nous:	Reposez -vous sur nous:
En matiere d'honneur nous nous connoiſſons tous.	En matière d'honneur nous nous connaissons tous.
L’Eſcolier eſt-il braue?	L'Écolier est-il brave?
DOM LOVIS.	DOM LOUIS.
Autant qu’on le peut eſtre.	Autant qu'on le peut être.
Tant mieux.	Tant mieux.
ZAMORIN.	ZAMORIN.
DOM LOVIS.	DOM LOUIS.
On dit qu’il fait des armes comme vn Maiſtre.	On dit qu'il fait des armes comme un Maître.
Tant mieux.	Tant mieux.
ZAMORIN.	ZAMORIN.
DOM LOVIS.	DOM LOUIS.
Paiſons main baſſe.	Paisons main basse.
ZAMORIN.	ZAMORIN.
Il eſt expedié, Ie le garantis tel, s’il n’appelle à ſon pié.	Il est expédié, Je le garantis tel, s'il n'appelle à son pie.
Or &, mes compagnons, choiſiſſons vn bon poſte, Et va d’eſtrammaçon, de pointe, & de riſpoſte.	Or et, mes compagnons, choisissons un bon poste, Et va d'estrammaçon, de pointe, et de risposte.
D’OM LOVIS.	D'OM LOUIS.
Ghaque nuict ſans manquer il paſſe par icy, iiij Ie voy de la lumiere, & croy que le voicy.	Ghaque nuit sans manquer il passe par ici, jij Ie à de la lumière, et crois que le voici.
Attendon le au paſſage.	Attendon le au passage.
CENE IL DOM PEDRE.	CÈNE IL DOM PEDRE.
CRISPIN.	CRISPIN.
DOM PEDRE.	DOM PÉDRE.
Et tu dis que mon Pere T'a donné ſeulement?	Et tu dis que mon Père T'a donné seulement?
CRISTIN.	CRYSTIN.
Deux cens francs.	Deux cens francs.
DOM PEDRE.	DOM PÉDRE.
Et ma tres-chere ſœur?	Et ma très-chère sœur?
La miſere!	La misère!
CRISPIN.	CRISPIN.
Non pas meſme vn ſalut.	Non pas même un salut.
DOM PEDRE.	DOM PÉDRE.
La peque!	La pèque!
Que dit-il lors que ma lettre il lut?	Que dit-il lors que ma lettre il lut?
CRISPIN.	CRISPIN.
Ie ne luy vy pas lire.	Je ne te vis pas lire.
DOM TEDRE.	DOM TÉDRE.
Que ie ſuis à Tolede.	Que ie suis à Tolède.
Il ne faut pas qu’il ſçache	Il ne faut pas qu'il sache
CRISPIN.	CRISPIN.
Il faut donc qu’on ſe cache, Où n’aller que la nuict.	Il faut donc qu'on se cache, Où n'aller que la nuit.
DOM PEDRE.	DOM PÉDRE.
Et ne le fay-je pas?	Et ne le fais-je pas?
CRIS Vous faites iuſtement l'amour comme les chats.	CRIS Vous faites justement l'amour comme les chats.
Il ne vous manque plus que courrir les goutieres Vous ſeriez chat complet.	Il ne vous manque plus que courrir les goutières Vous seriez chat complet.
DOM.	DOM.
PEDRE.	PÉDRE.
Mille coups d’eſtriuieres	Mille coups d'étrivières
CRISPIN.	CRISPIN.
Mille boſſes & trous, A tous coureurs de nuict, Chat-huans comme vous.	Mille bosses et trous, A tous coureurs de nuit, Chathuant comme vous.
Si vous vouliez au moins parfois tirer la laine, ene yroullonmadel.	Si vous vouliez au moins parfois tirer la laine, ene yroullonmadel.
DOM PEDRE.	DOM PÉDRE.
Tay toy, teſte mal-ſaine.	Tais -toi, tête malhaine.
CRISPIN.	CRISPIN.
Mal-ſaine où non, l'eſprit en eſt pourtant bien ſain.	Mal-ne où non, l'esprit en est pourtant bien sain.
Ie ne voy pas bien clair en voſtre noir deſſein.	Je ne vois pas bien clair en votre noir dessein.
Où me conduiſez-vous?	Où me conduisez-vous?
DOM PEDRE.	DOM PÉDRE.
Où mon amour me meine.	Où mon amour me mène.
CRISPIN.	CRISPIN.
Nous ſommes mal conduits.	Nous sommes mal conduits.
DOM PEDRE.	DOM PÉDRE.
I'adore vne Chimene, Sœur d’vn Comte eſtranger, éloigné de la Cour Pour vn ſoufflet donné.	J'adore une Chimène, Sœur d' Hôte étranger, éloigné de la Cour Pour un soufflet donné.
CRISPIN.	CRISPIN.
I'ay peur que voſtre amour N'attire deſſur nous quelques coups d’eſpouſſette.	J'ai peur que votre amour N'attire dessur nous quelques coups d'époussette.
Se conte louffrira que ſa ſœur la coqueſte Vous eſpouſe;	Se conte louffrira que sa sœur la coquête Vous épouse;
il ra le Diable.	il ra le Diable.
Encore bon Sf vous eſtiez vn Comte, ou du moins vn Baron:	Encore bon Sf vous étiez un Comte, ou du moins Un Baron:
Mais on n’en trouue plus, à ce que j’enten dire, Cela ſent le vieux temps:	Mais on n'en trouve plus, à ce que j'enten dire, Cela sent le vieux temps:
Pour des Comtes pour rire, Ou bien faits à plaiſir, de Marquis, Ducs & Pairs, L'année en eſt fertile, & les chemins couuers.	Pour des Comtes pour rire, Ou bien faits à plaisir, de Marquis, Ducs et Pairs, L'année en est fertile, et les chemins couuers.
De Mareſchaux de Camp l'année eſt auſſi bonne.	De Maréchaux de Camp l'année est aussi bonne.
DOM PEDRE.	DOM PÉDRE.
RISPIN.	RISPIN.
La race des Criſpins eut du Ciel ce talent, Comme vous poſſedez celuy d’eſtre Galent.	La race des Crispins eut du Ciel ce talent, Comme vous possédez celui d'être Galent.
Tantoſt parlant de vous, noſtre auare bon-homme, Diſoit ce que l'on dit de qui reuient de Rome, Vous ſçauez le Prouerbe, & lors que l'on va là, Que cheual on reuient, ſi cheual on alla.	Tantôt parlant de vous, notre avare bonhomme, Disait ce que l'on dit de qui revient de Rome, Vous savez le Proverbe, et lors que l'on va là, Que cheval on revient, si cheval on alla.
DOM PEDRE.	DOM PÉDRE.
Criſpin, encore vn coup tréve de raillerie.	Crispin, encore un coup trêve de raillerie.
CRISPIN.	CRISPIN.
Puis que ie ne dors point, trouuez bon que ie rie.	Puis que ici ne dors point, trouvez bon que sans rie.
DOM PEDRE.	DOM PÉDRE.
Comment ſe porte donc mon Pere?	Comment se porte donc mon Père?
Il dit que.	Il dit que.
CRISPIN.	CRISPIN.
Ha le penart!	Ha le pénart!
DOM PEDRE.	DOM PÉDRE.
Tu luy pers le reſpect, franc pondart, endeplen cnomton.	Tu lui perds le respect, franc pondart, endeplen comton.
CRISPIN.	CRISPIN.
Monſieur, ie voy des hommes,	Monsieur, Seigneur vois des hommes,
DOM PEDRE.	DOM PÉDRE.
Ethouquiiselontie :	Étouquiiselontie :
Que deux.	Que deux.
CRISPIN.	CRISPIN.
Ils ſont ſix;	Ils sont six;
Nous ne ſommes	Nous ne sommes
DOM PEDRE.	DOM PÉDRE.
Et pour combien me comptes-tu, faquin?	Et pour combien me comptes-tu, faquin?
CRISPIN, Pour dix :	CRISPIN, Pour dix :
Mais auec vous ayant le cher Criſpin, Qui n’eſt pas autrement homme propre à combattre.	Mais avec vous ayant le cher Crispin, Qui n'est pas autrement homme propre à combattre.
Il faut que de vos dix vous en rabattiez quatre:	Il faut que de vos dix vous en rabattiez quatre:
Qui de dix oſte quatre, il en reſtera ſix, Vous voila tant à tant, faites bien l'Amadis.	Qui de dix ôte quatre, il en restera six, Vous voilà tant à tant, faites bien l'Amadis.
Marche auant.	Marche avant.
DOM PEDRE.	DOM PÉDRE.
CRISPIN.	CRISPIN.
Ils ſont tous de taille Gigarie Vilains hommes à voir, & de mauuaiſe mine.	Ils sont tous de taille Gigarie Vilains hommes à voir, et de mauvaise mine.
Helas, ſi i’auois fait vn mot de teſtamont.	Hélas, si j'avais fait un mot de têtamont.
SCENEIII.	SCENEII.
DOM LOVIS.	DOM LOUIS.
DOM PEDRE.	DOM PÉDRE.
ZAMORIN braue.	ZAMORIN brave.
4.	4.
Bruues.	Bruves.
CRISPIN.	CRISPIN.
DOM LOVIS.	DOM LOUIS.
* Aualier, cedez-moy la ruë, & promptement, Cie le veux.	* Avalier, cédez-moi la rue, et promptement, Cie le veux.
DOM TEDRE.	DOM TÉDRE.
Et combien eſtes-vous, noſtre Maiſtrei Tour commander ainſi?	Et combien êtes-vous, notre Maître Tour commander ainsi?
DOM LOVIS.	DOM LOUIS.
Nous ſommes ſix.	Nous sommes six.
DOM PEDRE.	DOM PÉDRE.
Pour eſtre En nembre ſi petit, vous parlez vn peu haut, Cherchez en autres lix, Ie croy qu’il vous les faut:	Pour être En nembre si petit, vous parlez un peu haut, Cherchez en autres lix, Je crois qu'il vous les faut:
Et quand vous les aurez, il n’eſt rien que ne faſſe Voſtre humble ſeruiteur,, iuſqu’à quitter la place;	Et quand vous les aurez, il n'est rien que ne fasse Votre humble serviteur, jusqu'à quitter la place;
Cependant, ie l garde.	Cependant, Seigneur l garde.
DOM LOVIS.	DOM LOUIS.
Ha!	Ha!
c’eſt trop diſcourir.	c'est trop discourir.
Tu mourras, Fanfaron.	Tu mourras, Fanfaron.
DOM PEDRE.	DOM PÉDRE.
Ils ſebattent.	Ils sébattent.
Ie ne ſçay pas mourrir.	Je ne sais pas mourrir.
CRISPIN.	CRISPIN.
Anaη coindu Theatrο.	Ana coindu Theatrο.
Or ça, Maiſtre Criſpin, menageons la brauoures Nulle temerité.	Or ça, Maître Crispin, ménageons la bravoures Nulle témérité.
Peſte, ceme il les.	Peste, cème il les.
bourre:	bourre:
Que mon Maiſtre eſt vaſtent!	Que mon Maître est vâtent!
I OM VOVIS.	I OM VOUIS.
Donne à luy, zamorim.	Donne à Seigneur, zamorim.
ZAMORIN.	ZAMORIN.
Il faut perdre la vie ou perdre le terrein.	Il faut perdre la vie ou perdre le terrein.
DOM TEDRE.	DOM TÉDRE.
Ny Ivn ny l'autre.	Ni Imé ici l'autre.
A toy ieune cadet.	A toi jeune cadet.
D'OM LOVIS.	D'OM LOUIS.
ne tiautie m a viene, len'en puis plus.	ne tiautie m a vue, l'en puis plus.
I'enrage!	J'enrage!
ZAMORIN.	ZAMORIN.
Courage.	Courage.
DOM PEDRE vous en auez ociom.	DOM PEDRE vous en avez ociom.
Cc icune nomme bleſſé Se baſtoit en Ceſar, & j’en eſtois preſſé.	Cc une nomme blessé Se bâtait en César, et j'en étais pressé.
Il tombe.	Il tombe.
Dieux!	Dieux!
le pied m’a manqué:	le pied m'a manqué:
mais le bras me demeure.	mais le bras me demeure.
ZAMORIN.	ZAMORIN.
Il eſt pris pour le coup, point de quartier, qu’il meure.	Il est pris pour le coup, point de quartier, qu'il meure.
DOM PEDRE.	DOM PÉDRE.
Vous reculiez tantoſt, poltrons.	Vous reculiez tantôt, poltrons.
ZAMORIN.	ZAMORIN.
Pour mieux ſauter.	Pour mieux sauter.
Ha, traiſtres!	Ha, traîtres!
DOM PEDRE.	DOM PÉDRE.
LE COMTE.	LE COMTE.
Arriue.	Arrive.
Cinq contre vn!	Cinq contre un!
qui pourroit reſiſter!	qui pourrait résister!
Leuez-vous, Cauallier.	Levez-vous, Cavallier.
DOM PEDRE.	DOM PÉDRE.
Puis que voſtre bras m’ayde, Ie ferois teſte à tous les braues de Tolede.	Puis que votre bras m'aide, Je ferais tête à tous les braves de Tolède.
Allons apres, Criſpin.	Allons après, Crispin.
CRISPIN.	CRISPIN.
Allons, quoy que bien las:	Allons, quoi que bien las:
Car ie n’auois iamais tant remué les bras.	Car ici n'avais jamais tant remué les bras.
SCENE	SCÈNE
SCENE IV.	SCÈNE IV.
CASSANDRE.	CASSANDRE.
LISETTE.	LISETTE.
CRISTIN,	CRYSTIN,
CASSANDRE.	CASSANDRE.
du li amnes, Chela, auauut daus la qi OEt voy ce qui s’y fait,	du li amnes, Chela, auavut daus la qi OEt vois ce qui s'y fait,
LISETTE.	LISETTE.
Ie croy que i'en s’y tuë,	Je crois que j'en s'y tue,
GASSANORE.	GASSANORE.
Sans doute Dom Louys auec ſon poinct d’honruui aunuouut d um Polre, & cauſe la rumeur.	Sans doute Dom Louis était son point d'honruvi aunuouut d um Polre, et cause la rumeur.
LISETTE.	LISETTE.
Il tranche auecque vous del Eſpoux & du Pere, Et vous auez, Madame, vn faſcheux perit frere;	Il tranche auecque vous del Espoux et du Père, Et vous avez, Madame, un fâcheux périt frère;
Mais apres tout, Madame, il faudroit oublier Dom Pedre;	Mais après tout, Madame, il faudrait oublier Dom Pèdre;
car enſin, ce n’eſt qu'vn eſcolier.	car ensin, ce n'est qu'un écolier.
CASSANDRE.	CASSANDRE.
Ce n'eſt qu'vn eſcolier, il eſt bien vray Liſeuue?	Ce n'est qu'un écolier, il est bien vrai Liseuve?
Mais il a de l'eſprit, ſa porſonne eſt bien faite, Et pourueu que ſon fou ne cede point au mien Ie luy rendray commun & mon rang & mon biea?	Mais il a de l'esprit, sa porsonne est bien faite, Et pourvu que son fou ne cède point au mien Je vou rendray commun et mon rang et mon bieda?
Mais quelqu’vn viont à nous.	Mais quelqu'autre viont à nous.
CRISPIN.	CRISPIN.
Mallame, vne cohorte De Sergens ãffamez me ſint d'eſttanje ſorte, Il y va de la morc ſi j’eſtois atrrapé:	Mallme, une cohorte De Sergents ãffamez me sint d'esttanje sorte, Il y va de la morc si j'étais atrapé:
Car vn bomme eſt dit-on mortellement frappé.	Car un bomme est dit-on mortellement frappé.
Mon Maiſtre en eſtourdy s'eſt meſlé dans l’affaire, Et i'ay fait comme luy ſeulement pour luy plaire.	Mon Maître en étourdi s'est mêlé dans l'affaire, Et j'ai fait comme lui seulement pour quelque plaire.
Ie vous laiſſe à iuger ſi i'ay bien ou mal fait, Si vous ſçauiez vn trou, ce ſeroit bien mon fait.	Je vous laisse à juger si j'ai bien ou mal fait, Si vous saviez un trou, ce serait bien mon fait.
l n’eſtuo, quel qu’il ſott.	 l'estuo, quel qu'il sott.
& fur il meſme immonſt Où ie ne vueille entrer le plus content du monde, Rourueu qu’inacceſſible à tous vilains Sergens, On n’y viole point le ſacré droict des gens.	et fur il même immonst Où je ne veuille entrer le plus content du monde, Rourvu qu'inaccessible à tous vilains Sergents, On n'y viole point le sacré droit des gens.
Là deſſus ie me tais, chere Dame, & pour cauſe:	Là -dessus Seigneur me tais, chère Dame, et pour cause:
Car de n’eſtre pas veu, s’il importe à la choſe, Il n’importe pas moins de n’eſtre pas oüy.	Car de n'être pas vu, s'il importe à la chose, Il n'importe pas moins de n'être pas oui.
Et bien voulez vous donc me receuoir?	Et bien voulez -vous donc me recevoir?
CASSANDRE.	CASSANDRE.
Liſette, va le mettre au deſſus de ma chambre Où tu ſçais.	Lisette, va le mettre au -dessus de ma chambre Où tu sais.
CRISPIN.	CRISPIN.
Euthie, eur m'attaque en chaque membre:	Eûthie, eur m'attaque en chaque membre:
Que puiſſiez-vous iamais n’auoir beſoin de trous, Et que iamais Sergents ne courent apres vous.	Que puissiez-vous jamais n'avoir besoin de trous, Et que jamais Sergents ne courent après vous.
CASSANDRE.	CASSANDRE.
Mon frere, qu’auez-vous?	Mon frère, qu'avez-vous?
quelqne choſe vous preſſe.	quelquene chose vous presse.
SCENE Y.	SCÈNE Y.
LE COMTE.	LE COMTE.
DOM PEDRE.	DOM PÉDRE.
CASSANDRE.	CASSANDRE.
LE COMTE.	LE COMTE.
Ftirez vous, ma ſœur, & que ſeul on me laiſſe, NCaualier, approchez, on ne vous fera rien Tant que j’auray de vie.	Ftirez -vous, ma sœur, et que seul on me laisse, NAvalier, approchez, on ne vous fera rien Tant que j'aurai de vie.
DOM PEDRE.	DOM PÉDRE.
Ha, ie le ſçay fort bien, Et que par voſtre bras la mienne deffenduë, Quand pour vous mille fois elle ſeroit perduë, Ie ne me verrois pas encor bien acquitté, De tout ce que de moy vous auez merité.	Ha, Seigneur le sais fort bien, Et que par votre bras la mienne défendue, Quand pour vous mille fois elle serait perdue, Je ne me verrais pas encor bien acquitté, De tout ce que de moi vous avez mérité.
LE COMTE.	LE COMTE.
Ne me louez pas tant de ce que i'ay deû faire, Songeons à vous ſauuer, comme au plus neceſſaire.	Ne me louez pas tant de ce que j'ai déun faire, Songeons à vous sauver, comme au plus nécessaire.
Entrez dedans ma chambre, & vous fiez en moy, Que ie vous garderay ma parole & ma foy.	Entrez dedans ma chambre, et vous fiez en moi, Que je vous garderai ma parole et ma foi.
DOM PEDRE.	DOM PÉDRE.
Vous me promettez donc?	Vous me promettez donc?
LMGOMTE.	LMGOMTE.
De vous ſeruir d’azile.	De vous servir d'asile.
SCENE VI.	SCÈNE VI.
LE BREVOST.	LE BREUOST.
LE COMTE.	LE COMTE.
DES ARCHERS:	DES ARCHERS:
DOM PEDRE.	DOM PÉDRE.
REVOST.	REUOST.
Onſieur, vous trouuerez ma viſite inciuile;	Onsieur, vous trouverez ma visite incivile;
Mais le triſte accident qui m'ameine ſi tard Veut que ſans differer l'on vous en faſſe part.	Mais le triste accident qui m'amène si tard Veut que sans différer l'on vous en fasse part.
On vient d’aſſaſſiner Dom Louys voſtre frere Deuant voſtre logis.	On vient d'assassiner Dom Louis votre frère Devant votre logis.
1e.	1e.
LE COMTE.	LE COMTE.
Et l’aſſaſſin?	Et l'assassin?
LE PREVOST.	LE PRÉVÔT.
I'eſpere Que nous l’aurons bien toſt;	J'espère Que nous l'aurons bien tôt;
car i’ay ſçeu d’vn voiſin Que l'on a veu ceans entrer cét aſſaſſin.	car j'ai su d'une voisin Que l'on a vu ce entrer cet assassin.
LE COMTE.	LE COMTE.
L'advis eſt temeraire, & meſme peu croyable.	L'avis est téméraire, et même peu croyable.
Apres la mort d’vn homme, il n'eſt pas vray-séblable Que celuy qui le tuë, aille ſe perdre au port, Et chercher vn azile eǹ la maiſon du mort.	Après la mort d' Homme, il n'est pas vrai-séblable Que celui qui le tue, aille se perdre au port, Et chercher int asile eûr la maison du mort.
Au fort de la Ruſneur, j'ay fait fermer ma Porte, Et ie n’ay pas permis qu’aucun de mes gens ſorte.	Au fort de la Rusneur, j'ai fait fermer ma Porte, Et tu n'ai pas permis qu'aucun de mes gens sorte.
Ie ne ſuis pas ſorti moy-meſme, & l'on n’a peu Cacher quelqu’vn chez moy, que ie no l’aye ſçeu	Je ne suis pas sorti moi-même, et l'on n'a peu Cacher quelqu'un chez moi, que ie no l'aie su
LE REVOST vous auez rinteien tout entier dans l’affaire, Le noſtre eſt ſeulement le deſſein de vous plaire.	LE REUOST vous avez rinteien tout entier dans l'affaire, Le nôtre est seulement le dessein de vous plaire.
LE COMTE.	LE COMTE.
Imtes coqu'maue iue en vn pareil mal-heur, Et pardonnez, Meſſleurs, à ma iuſte douleur, Si ie ne me tiens pas auet vous dauantage.	Imtes coqu'mave jue en un pareil malheur, Et pardonnez, Messleurs, à ma juste douleur, Si personne ne me tiens pas auet vous davantage.
LE PREVOST.	LE PRÉVÔT.
Il s’en va.	Il s'en va.
Nous ferons noſtre charge,	Nous ferons notre charge,
LE COMTE.	LE COMTE.
O deſeſpoir!	Ô désespoir!
o rage!	ô rage!
Quel parcy dois-je prendre en l’eſtat où ie ſuis?	Quel parci dois-je prendre en l'état où tu suis?
Ie ne mo puis venger, lors que plus je le puis.	Je ne mo puis venger, lors que plus je le puis.
Ie dois a ma parole, & ie dois à mon frere, le dois venger ſa mort,ſi j'en crois ma colere, Ie dois paruomer, ſi ie parde ma foy.	Je dois a ma parole, et ainsi dois à mon frère, le dois venger sa mort,si j'en crois ma colère, Je dois parvomer, si personne parde ma foi.
Helas, qui fut iamais plus empeſché que moy?	Hélas, qui fut jamais plus empêché que moi?
caualier, ſçauet-vous qui ie ſuis?	cavalier, sçauet-vous qui ie suis?
DOM PEDRE Ouy, me vie sans voſtre prompt ſecours m’auroit eſté raui,.	DOM PEDRE Oui, me vie sans votre prompt secours m'aurait été ravi,.
E COMTE.	E COMTE.
Ne vous eſtois-je point connu?	Ne vous étais-je point connu?
DON PEDRE.	DON PÉDRE.
lo	lo
LE COMTE.	LE COMTE.
Sçauiez-vous Le mom du mal beureux accablé ſous vos coups?	Saviez-vous Le moment du mal heureux accablé sous vos coups?
DOM PEDRE.	DOM PÉDRE.
Autant que ie l’ay pſl par vne nuit obſcure I’ay couns per ſa voix pliu que par ſa figure, Q il eſtoit eſtranger, le frere ou le parent D'vn Comce, & qel qu’il ſoit il m'eſt indifferent.	Autant que cela l'ai psl par une nuit obscure J'ai couns per sa voix pli que par sa figure, Q il était étranger, le frère ou le parent D'un Comce, et qel qu'il soit il m'est indifférent.
OMTE.	OMTE.
Vounavoustromræ pule mox eſtot mon fese Etmor le Cerant	Vounavoutromræ pule mox étot mon fée Etmor le Cerant
DOM PEDRE, O Dieux!	DOM PÉDRE, Ô Dieux!
& que penſez-vous faire?	et que pensez-vous faire?
Vous tuer:	Vous tuer:
ER COMTE.	ER COMTE.
DOM PEDRE.	DOM PÉDRE.
Me tuer!	Me tuer!
ce n’eſt pas vn coup ſeur, Et peut-eſtre auriez-vous la moitié de la peur.	ce n'est pas un coup sûr, Et peut-être auriez-vous la moitié de la peur.
Puiſque nous ſommes ſeuls faiſons l’experience, De celuy qui de nous ſe trompe en ſa croyance, Dauion, dous.	Puisque nous sommes seuls faisons l'expérience, De celui qui de nous se trompe en sa croyance, Davion, dous.
LE COMTE.	LE COMTE.
Ie ſçauray choilir vn autre temps Pour me venger de vous comme ie le pretens.	Je saurai choilir un autre temps Pour me venger de vous comme tu le prétends.
DOM PEDRE.	DOM PÉDRE.
Vous auez ce me ſemble, & le temps, & la place,	Vous avez ce me semble, et le temps, et la place,
LE COMTE.	LE COMTE.
Ouy;	Oui;
mais il faut deuant que ie vous ſatisfaſſe, Et vous ayant promis de vous ſauuer chez moy, Contre moy-melme il faut que ie garde ma foy, Ie ſçauray bien ailleurs venger la mort d’vn frere, Et vous ſacrifier à ma iuſte colere.	mais il faut devant que je vous satisfasse, Et vous ayant promis de vous sauver chez moi, Contre moi-melme il faut que ici garde ma foi, Je saurai bien ailleurs venger la mort d'un frère, Et vous sacrifier à ma juste colère.
DOM TEDRE.	DOM TÉDRE.
Vous auez deux deſſeins qui ne ſont par d’accort, Vous me ſauuez la vie, & conſpirez ma mort;	Vous avez deux desseins qui ne sont par d'accort, Vous me sauvez la vie, et conspirez ma mort;
LE COMTE.	LE COMTE.
Comme vn homme d'honneur, ie vous fauue la vie;	Comme un homme d'honneur, je vous fauve la vie;
Mais puiſque vous l’auez à mon frere rauie, Ie vous feray perir comme vn homme offencé.	Mais puisque vous l'avez à mon frère ravie, Je vous ferai périr comme un homme offensé.
14	14
DOM PEDRE.	DOM PÉDRE.
Ie ſun au deſeſpoir de ce qui s'eſt paſſé:	Je sun au désespoir de ce qui s'est passé:
Mais puis que le paſſé n'eſt plus en ma puiſſance, Que voſtre bien-fait meſm.	Mais puis que le passé n'est plus en ma puissance, Que votre bienfait mém.
e augmente mon offence?	é augmente mon offense?
Que cruel ou forcé mon bras vient d’abreger Des lours qui vous ſont chers que vous deuez venger.	Que cruel ou forcé mon bras vient d'abréger Des lours qui vous sont chers que vous devez venger.
Contre mon naturel de ne fuir perſonne, Et ſuiuant mon humeur de rendre à qui me donneIe vous veux éuiter par tout où vous ſerez,M Auec le meſme ſoin que vous me chercherez.	Contre mon naturel de ne fuir personne, Et suivant mon humeur de rendre à qui me donneIe vous veux éviter par tout où vous serez,M Avec le même soin que vous me chercherez.
iij Vous ſçauez par vos yeux iuſqu’o va ma vaillance Er iugerez par-là de ma reconnoiſſanee.	ij Vous savez par vos yeux jusqu'ô va ma vaillance Er jugerez par-là de ma reconnaissane.
Ie veux eſtre poltron, pour n’vine pas ingrat, Et pour rendre vn bien-fait, refuſer vn combus:	Je veux être poltron, pour n'une pas ingrat, Et pour rendre un bienfait, refuser un combus:
LA COMTE.	LA COMTE.
Ie vous y forceray,	Je vous y forcerai,
DON PEDRE.	DON PÉDRE.
Ie fuiray vos approcher.	Je fuirai vos approcher.
LE COMTE.	LE COMTE.
ndel-vous peu demoy ?	nédel-vous peu demoi ?
DOM PEDRE.	DOM PÉDRE.
I'ay peur de vos reproches.	J'ai peur de vos reproches.
LE COMTE.	LE COMTE.
On n'en ſçauroit trop faire à qui manque de cœurs,	On n'en saurait trop faire à qui manque de cœurs,
DOM PEDRE.	DOM PÉDRE.
Quand pour vous ie renonce à ma propre valeur, Et lors que contre moy vous irritez la voſtre, Nous ſuiuons du deuoir les loix & l’vn & P'autre.	Quand pour vous sem renonce à ma propre valeur, Et lors que contre moi vous irritez la vôtre, Nous suivons du devoir les lois et l'un et P'autre.
sibienque.	sibienque.
LE COMTE.	LE COMTE.
DOM PEDRE.	DOM PÉDRE.
Si les Cicux, ne mie ſont ennemit Nous no nous batrons point,z deuiendtons amis.	Si les Cigux, ne mie sont ennemit Nous nô nous batrons point,s deviendtons amis.
LE COMTE.	LE COMTE.
C'eſt urop s'entreparler n'eſtant pas bien enſemble Le iardin eſt ouuest, ſortez ſi bon vous ſemble:	C'est urop s'entreparler n'étant pas bien ensemble Le jardin est ouvet, sortez si bon vous semble:
Mais qui fiape a ma porte à la pointe du iour;	Mais qui fiape a ma porte à la pointe du jour;
Hac'et toy.	Hac'et toi.
Beuxit:	Beuxit:
SCENE VII.	SCÈNE VII.
LE COMTE.	LE COMTE.
BEATRIS.	BEATRIZ.
Q BEATRIS.	Q BEATRIZ.
De la par de l'amour;	De la par de l'amour;
comme vous ſçaue ſur la raiſon l’emporte, Ie viens an point du iour heurter à voſtre porte Nous changcons de loris, Madame vous veur voir.	comme vous savez sur la raison l'emporte, Je viens an point du jour heurter à votre porte Nous changcons de loris, Madame vous veu voir.
, Et ce billet, Mouſieur, vous fera tout ſçauoir, Faites ce qu’il contient, & donnez-moy licence, D'aller mettre ordre au mal que feroit mon abſence.	, Et ce billet, Mousieur, vous fera tout savoir, Faites ce qu'il contient, et donnez-moi licence, D'aller mettre ordre au mal que ferait mon absence.
Si mon vorage icy du vielllard ſoupçonné, Irritoit ſon eſprit de Demon incaroe.	Si mon vorage ici du vielllard soupçonné, Iritait son esprit de Démon incaroe.
:	:
LE COMTE.	LE COMTE.
Beatririe ſery œe que veut ta maiſtieſſe.	Béatririe sery œe que veut ta maistiesse.
BEATRIS.	BEATRIZ.
Iemoy ie gagne au pied:	Iémoi ici gagne au pied:
ENCOMTE.	ENCOMTE.
Si-toſt?	Si-tôt?
REATRIS.	REATRIS.
Elle s'en va.	Elle s'en va.
L'heure me preſſe :	L'heure me presse :
LE COMTE.	LE COMTE.
Vous n'eſtes pas cxt-æaulit, machere ſœur?	Vous n'êtes pas cxt-æaulit, machère sœur?
LE' COMTE.	LE COMTE.
CASSANDRE.	CASSANDRE.
CASSANDRE.	CASSANDRE.
.	.
E moyen de dormir apres vn tel mal-heur	E moyen de dormir après un tel malheur
LE GOMTE.	LE GOMTE.
Non plus que vous ma ſœur ie n'en ay point d'enuie.	Non plus que vous ma sœur ici n'en ai point d'envie.
Ie dois venger vn frere au peril de ma vie.	Je dois venger un frère au péril de ma vie.
Vn amy depuis peu, m’a de la Cour eſcrit, à Que celuy que j’auois offencé dans Madrid Afin de ſe venger eſt party pour Tolede:	Un ami depuis peu, m'a de la Cour écrit, à Que celui que j'avais offensé dans Madrid Afin de se venger est parti pour Tolède:
Vne Dame que j’ayme, & de qui ie poſſede.	Une Dame que j'aime, et de qui notre possède.
Les inclinations, & dont pour vn meſpris, Le cœur peut contre moy de colere eſtre eſpris.	Les inclinations, et dont pour un mépris, Le cœur peut contre moi de colère être épris.
5 M'eſcrit, qu’accompagné de quelque amy fidelle, I’aille, ſans y manquer, paner la nuit chez elle.	5 M'écrit, qu'accompagné de quelque ami fidèle, J'aille, sans y manquer, paner la nuit chez elle.
Ma paſſion m’y porte, & d’vn autre coſté, I'ay depuis quelques iours ſon eſprit irrité.	Ma passion m'y porte, et d'un autre côté, J'ai depuis quelques jours son esprit irrité.
12 2	12 2
CASSANDRE.	CASSANDRE.
Eſt-ce par va oubly?	Est-ce par va oubli?
LE COMTE.	LE COMTE.
Non, c’eſt par vne offence.	Non, c'est par une offense.
CASSANDRE.	CASSANDRE.
Prenęz vos ſeuretez, & craignez ſa vangeance.	Prencz vos sûretés, et craignez sa vengeance.
Si la femme oubliée eſt capable de tout, Alors que l’on l’offence, & qu’on la pouſſe à bout, Elle fait ſucceder la fureur aux tendreſſes, On en doit craindre tout, & meſme ſes careſſes.	Si la femme oubliée est capable de tout, Alors que l'on l'offense, et qu'on la pousse à bout, Elle fait succéder la fureur aux tendresses, On en doit craindre tout, et même ses caresses.
L’homme le plus meſchant ne la peut eſgaler, Tant à faire le mal, qu'à le diſſimuler:	L'homme le plus méchant ne la peut égaler, Tant à faire le mal, qu'à le dissimuler:
Enfin, c’eſt vne femme, & de plus, offencée, le ne vous ſçauroi mueux dapnquer ma pensée.	Enfin, c'est une femme, et de plus, offensée, le ne vous saurais mueux dapnquer ma pensée.
LE COMTE.	LE COMTE.
Ie ne vous ſçaurois mieux expliquer mon erreur, Qu'en vous diſant que j’ayme, & meſme auec fureur.	Je ne vous saurais mieux expliquer mon erreur, Qu'en vous disant que j'aime, et même auec fureur!
Sur vos conſeils, ma ſœur, ma paſſion l’emporte:	Sur vos conseils, ma sœur, ma passion l'emporte:
Mais encore vne fois on refrape à la porte.	Mais encore une fois on refrape à la porte.
Hola, qu on ouule:	Holà, qu on ouvle:
o Dicun le toy mon ennemy, Ie vous croyois bien loin.	ô Dicun le toi mon ennemi, Je vous croyais bien loin.
SCENEIX.	SCENEIX.
DOM PEDRE, LE COMTE.	DOM PEDRE, LE COMTE.
DOM FEDRE.	DOM FÉDRE.
Et moy vous endormy:	Et moi vous endormi:
LE COMTE.	LE COMTE.
De vous reuoir encore mon ame eſt eſtonnée, Et vous tenez fort mal la parole donnée, De me venir brauer, au lieu de me fuir.	De vous revoir encore mon âme est estonnée, Et vous tenez fort mal la parole donnée, De me venir braver, au lieu de me fuir.
DOM PEDRE.	DOM PÉDRE.
Ne me condaiez pas deuant que de m’oüir.	Ne me condaiez pas devant que de m'ouïr.
Alors que ie promeis il n’eſt rien de plus ferme, Soyons ſeuls	Alors que ie proméis il n'est rien de plus ferme, Soyons seuls
LE COMTE.	LE COMTE.
Oſtez-vous Caſſandre,	Ostez-vous Cassandre,
DOM PEDRE.	DOM PÉDRE.
La porce deſſus nous.	La porce dessus nous.
Et que ie ferme	Et que ici ferme
LE COMTE.	LE COMTE.
Fermez ſi vous voulez.	Fermez si vous voulez.
Que voulez-vous encor?	Que voulez-vous encor?
DOM PEDRE.	DOM PÉDRE.
Queie parle,	Queie parle,
LE COMTE.	LE COMTE.
Mais parlez viſte, Parlez:	Mais parlez vite, Parlez:
DOM PEDRE.	DOM PÉDRE.
Il faut, que deuant toute choſe Vous liſiez en ces mots, de mon retour la cauſe.	Il faut, que devant toute chose Vous lisiez en ces mots, de mon retour la cause.
LETTRF.	LETTRF.
Le Comte lit.	Le Comte lit.
Dom Pedre on m’offence en l’honneur, L’ennemy puiſſant qui m’outrage, Se fie en ſa puiſſance, & meſpriſe mon aage, Vien luy monſtrer que mon fils a du cœur.	Dom Pèdre on m'offense en l'honneur, L'ennemi puissant qui m'outrage, Se fie en sa puissance, et méprise mon âge, Viens Seigneur montrer que mon fils a du cœur.
DOM PEDRE.	DOM PÉDRE.
Vous voyez bien pourquoy ie manque à ma promeſſe, Mais puis qu’à la tenir mon honneur s’intereſſe, Vn homme à qui ie dois & la vie & l’honneur, Ne me traitera pas de toute ſa rigueur.	Vous voyez bien pourquoi Vous manque à ma promesse, Mais puis qu'à la tenir mon honneur s'intéresse, Un homme à qui ie dois et la vie et l'honneur, Ne me traitera pas de toute sa rigueur.
Vn pere qu’on outrage, à qui la force manque, Et qui croit que ie ſuis encore à Salamanque, Luy qui peut tout ſur moy, me conjure inſtamment De le venir trouuer, & ſans retardement.	Un père qu'on outrage, à qui la force manque, Et qui croit que je suis encore à Salamanque, Lui qui peut tout sur moi, me conjure instamment De le venir trouver, et sans retardement.
Logeant au meſme lieu que la Poſte demeure, Mon Hoſte m’a rendu ſa lettre toute à l’heure:	Logeant au même lieu que la Poste demeure, Mon Hôte m'a rendu sa lettre toute à l'heure:
Ie vous coniure donc, ennomy genereux, Puiſque auſſi bien me vaincre eſt vn exploit honteux, Que ie n’ay point d’hõneur puis qu’õ l’oſte à mõ pere, Qu vn homme ſans honneur ne peut vous ſatisfaire;	Je vous conjure donc, ennomi généreux, Puisque aussi bien me vaincre est un exploit honteux, Que femme n'ai point d'honneur puis qu'ô ôte à mont père, Qu ' ôte à honneur ne peut vous satisfaire;
De me donner le temps, de me mettre en eſtat, Ou de tenir parole en fuyant le combat, Ou bien d’y ſuccomber plein d’honneur & de gloire, Smns que vous rougiſſiez d'vne telle victoire.	De me donner le temps, de me mettre en état, Ou de tenir parole en fuyant le combat, Ou bien d'y succomber plein d'honneur et de gloire, Smns que vous rougissiez d'une telle victoire.
LE COMTE.	LE COMTE.
Ouy, ie ne ſeray pas genereux à demy, Ie vous veux obliger ennemy comme amy.	Oui, Seigneur ne serai pas généreux à demi, Je vous veux obliger ennemi comme ami.
Allez, allez venger vn pere qu’on offence:	Allez, allez venger un père qu'on offense:
DOM PEDRE.	DOM PÉDRE.
Vous verrez des effets de ma reconnoiſſance,	Vous verrez des effets de ma reconnaissance,
LE COMTE.	LE COMTE.
Si ie les acceptois, ce ſeroit vous trahir:	Si ici les acceptais, ce serait vous trahir:
Conſtant à vous ſeruir, conſtant à vous hair, Vous n’aurez pas pluſtoſt vengé l’affront d’vn pere Que ie pretens ſur vous venger la mort d’vn freres Mais parce qu'eſtant pris vous eſtes en danger, Et qu'ainſi deſſus vous ie ne me puis venger, Remettez à mon bras ce qu’on demande au voſtre, Vous ſçauez que le mien vaut bien celuy d’vu autre.	Constant à vous servir, constant à vous haïr, Vous n'aurez pas plutôt vengé l'affront d'un père Que ainsi prétends sur vous venger la mort d'un frères Mais parce qu'étant pris vous êtes en danger, Et qu'ainsi dessus vous été ne me puis venger, Remettez à mon bras ce qu'on demande au vôtre, Vous savez que le mien vaut bien celui d' une.
Où loge voſtre pere?	Où loge votre père?
aprenez-moy ſon nom, Et ie vais de ce pas reſtablir ſon renom, Et quand j’auray pour vous ſatisfait voſtre pere, Ie reuiendray ſur vous aſſouuir ma colere.	apprenez-moi son nom, Et ainsi vais de ce pas rétablir son renom, Et quand j'aurai pour vous satisfait votre père, Je reviendrai sur vous assouvir ma colère.
DOM PEDRE.	DOM PÉDRE.
Ces deux deſſeins ſont beaux, & tres dignes de voux Mais le ſecond dépend aucunement de nous, Ma valeur vous en rend l’iſſuë aſſez douteuſe.	Ces deux desseins sont beaux, et très dignes de voux Mais le second dépend aucunement de nous, Ma valeur vous en rend l'issue assez douteuse.
La propoſition du premier m’eſt honteuſe.	La proposition du premier m'est honteuse.
Le nom d’vn offencé ne ſe reuelle point, L’honneur mele deffend, & le meſme m’enjoint De ne remettre pas à la valeur d’vn autre, Ce que peut acheuer vn bras comme le noſtre.	Le nom d'un offensé ne se revelle point, L'honneur me défend, et le même m'enjoint De ne remettre pas à la valeur d'un autre, Ce que peut achever un bras comme le nôtre.
LE COMTE.	LE COMTE.
Que voulez-vous donc faire?	Que voulez-vous donc faire?
DOM PEDRE.	DOM PÉDRE.
Euiter le danger D'eſtre pris, ſans laiſſer pourtant de me venger.	Éviter le danger D'être pris, sans laisser pourtant de me venger.
E COMTE.	E COMTE.
C'eſt bien ſait iuſqu'à tant que j’en puiſſe autãt faire, Ma maiſon vous fournit d azile ſalutaire:	C'est bien sait jusqu'à tant que j'en puisse autant faire, Ma maison vous fournit d azile salutaire:
Entrez donc dans ma chambre, & ie vais cependant M’aſſurer d'vn amy fidelle & confident:	Entrez donc dans ma chambre, et a pais cependant M'assurer d'Un ami fidèle et confident:
Vne aſſignation qu’à la nuit on me donne, Et que non ſans ſujet de fraude ie ſoupçonne, M.	Une assignation qu'à la nuit on me donne, Et que non sans sujet de fraude autre soupçonne, M.
oblige à me ſeruir de ces precautions.	oblige à me servir de ces précautions.
DOM PEDRE.	DOM PÉDRE.
le veux rompre auec vous toutes conuentiont, Ie reprea ma paroſe.	le veux rompre avec vous toutes conventiont, Je reprea ma parose.
LE COMTE.	LE COMTE.
Et pourquoy?	Et pourquoi?
DOM PEDRE.	DOM PÉDRE.
Ie vous ſie, Mon ſecret, mon honneur, & ie vous dois la vie, Vous ne me croyez pas aſſez homme d'honneur;	Je vous sièie, Mon secret, mon honneur, et je vous dois la vie, Vous ne me croyez pas assez homme d'honneur;
Aſſez reconnoiſſant, aſſez homme de cœur, rour vous pouuon iaun d'vne ndelle eſcorte, Auec moy vous deuiez agir d’vn autre ſorte, Et ie ne comprens pas,pour qui vous m’auez promis, Et comment au bien-fait vous joignez le meſpris?	Assez reconnaissant, assez homme de cœur, rour vous pouvon jaun d'une nédelle escorte, Avec moi vous deviez agir d'un autre sorte, Et ie ne comprends pas,pour qui vous m'avez promis, Et comment au bienfait vous joignez le mépris?
LE COMTE.	LE COMTE.
Ie vous croy plein d'honneur, & de peur incapable, Et c’eſt par vn motif purement pitoyable, Que ie vous viens d’offrir de vous tenir caché Dans ma chambre, où iamais vous ne ſeriez cherché.	Je vous crois plein d'honneur, et de peur incapable, Et c'est par un motif purement pitoyable, Que ie vous viens d'offrir de vous tenir caché Dans ma chambre, où jamais vous ne seriez cherché.
Ainli ie tiens par-ſa voſtre vie aſſurée, Et ma vengeance ainſi n’eſt qu’vn peu diferée.	Ainli Princes tiens par-sa votre vie assurée, Et ma vengeance ainsi n'est qu'un peu diferée.
DOM Oubien vous vous battrez tout à l'heure auec moy, Ou vous vous y fierez, aſſuré de ma foy Que ie vous garderois contre mon pere meſme,	DOM Oubien vous vous battrez tout à l'heure avec moi, Ou vous vous y fierez, assuré de ma foi Que ie vous garderais contre mon père même,
LE COMTE.	LE COMTE.
Voſtre valeur me charme, ouy venez, ie vous ayme Quoy qu’ennemy mortel, & nous ſerons amis, Si par les loix d’honneur il nous eſtoit permis.	Votre valeur me charme, ouï venez, je vous aime Quoi qu'ennemi mortel, et nous serons amis, Si par les lois d'honneur il nous était permis.
ACTE	ACTE
ACTE III.	ACTE III.
SCENE I.	SCÈNE I.
BEATRIS.	BEATRIZ.
LEONORE.	LEONORE.
BEATRIS.	BEATRIZ.
OSTRE ame vainement ſe vantoit d’eſtre fortes Voſtre colere cede à l’arnour qui l’emporte Vous rappellez le Comte & ie gagerois bien, Que la paix entre vous ne tient plus preſqu’à rien.	OSTRE âme vainement se vantait d'être fortes Votre colère cede à l'arnour qui l'emporte Vous rappelez le Comte et avec gagerais bien, Que la paix entre vous ne tient plus presqu'à rien.
LEONORE.	LEONORE.
C’eſt pour me mieux venger de luy:	C'est pour me mieux venger de belle:
BEATRIS.	BEATRIZ.
Madame, à d'autres:	Madame, à d'autres:
Ie ſçay comment ſont faits les cœurs cõme les voſtres.	Je sais comment sont faits les cœurs cõme les vôtres.
Comme vous ie ſuis femme, & ie ſçay ce que c’eſts.	Comme vous me suis femme, et ie sçay ce que c'ests.
Que le deſir de voir vn Amant qui deſplaiſt.	Que le désir de voir un Amant qui déplaît.
Le Comte eſt vn ingrat, ſi vous voulez vn traiſtre, Son melpris eſt ſenſible autant qu’il le peut eſtre, Son oubly toutesfois pluſtoſt que ſon nieſpris, Eſt tout ce qui vous rend le cœur de rage eſpris, Et vous aimeriez mieux qu’il vous euſt offencée, Que ſon oubly vous euſt de ſon ame effacée.	Le Comte est un ingrat, si vous voulez un traître, Son melpris est sensible autant qu'il le peut être, Son oubli toutefois plutôt que son niêpris, Est tout ce qui vous rend le cœur de rage épris, Et vous aimeriez mieux qu'il vous eût offensée, Que son oubli vous eût de son âme effacée.
LEQNORE.	LEQNORE.
Helas:	Hélas:
que tu vois clair dans le fonds de mon cœur, Et que de ſon oubly mon amour a de peur:	que tu vois clair dans le fond de mon cœur, Et que de son oubli mon amour a de peur:
BEATRIS.	BEATRIZ.
Madame, croyez-moy, les hommes ſont des drofles, Et le temps eſt paſſé des Amadis de Gaules:	Madame, croyez-moi, les hommes sont des drôles, Et le temps est passé des Amadis de Gaules:
Quand l'ay tantoſt rendu voſtre obligeant billet, Qu’en langage d’amour on apelle poulet.	Quand l'ai tantôt rendu votre obligeant billet, Qu'en langage d'amour on apelle poulet.
I’ay bien veu que le Comte, auec ſa fauſſe mine A pour vous plein ſon cœur de l'amour la plus fino, Et qu’il nous fait ſemblant, cét artificieux, Que ſon cœur en a moins que n’en prennent ſes yeux.	J'ai bien vu que le Comte, avec sa fausse mine A pour vous plein son cœur de l'amour la plus fino, Et qu'il nous fait semblant, cet artificieux, Que son cœur en a moins que n'en prennent ses yeux.
Madame, tenez bon;	Madame, tenez bon;
quoy qu’il diſe, ou qu’il faſſe, Quand vous ſerez tantoſt auec luy, face à face, Quoy que voſtre billet l’ait chez vous amené, Faites bien la meſchante, & qu’il ſoit mal mené.	quoi qu’il dise, ou qu'il fasse, Quand vous serez tantôt auec femme, face à face, Quoi que votre billet l'ait chez vous amené, Faites bien la chante, et qu'il soit mal mené.
LEONORE, s’il s’en va, Beatris?	LENORE, s'il s'en va, Beatris?
BEATRIS.	BEATRIZ.
Il faudra qu’il reuienne.	Il faudra qu'il revienne.
LEONORE.	LEONORE.
Bien loin que ma rigneur le charme, & le retienne, Elle le doit chaſſer,	Bien loin que ma rigneur le charme, et le retienne, Elle le doit chasser,
f EATRIS.	 FATRIS.
Il faudra courre apres!	Il faudra courre après!
Mais ſur luy vos beaux yeux ont fait trop de progrez.	Mais sur lui vos beaux yeux ont fait trop de progrès.
Arreuiendiu contioujen qon oi reuſent vne, Que s’il fait le cruel, faites lors l’importune.	Arreviendiv contioujen q oi reusent une, Que s'il fait le cruel, faites lors l'importune.
l'iray, ie reulendray luy parler;	l'irai, Seigneur reulendrai était parler;
Il faudra, il teulenne, ou qu’il creue:	Il faudra, il teulenne, ou qu'il crève:
EPONORE.	EPONORE.
Di-moy grand folle?	Dis-moi grand folle?
Et qui l'y forcera,	Et qui l'y forcera,
HEATRIS.	HEATRIS.
Moy, ſon amour, vous Madame, Qu'il aime, quoy qu’il faſſe, & du meilleur de l’ame.	Moi, son amour, vous Madame, Qu'il aime, quoi qu'il fasse, et du meilleur de l'âme.
L'EONORE:	L'ENORE:
Il le toſmoigne mal.	Il le tosmoigne mal.
2i*:	2i*:
BEATRIS.	BEATRIZ.
S'il reuient auiourd huy, Il n'eſt pas ſous le Ciel vn plas feru que luy:	S'il revient aujourd' hui, Il n'est pas sous le Ciel un plas fer va luy:
LEONORE.	LEONORE.
C’eſt ce qu'll ent le moins.	C'est ce qu'll ent le moins.
BEATRIS.	BEATRIZ.
Il vous aime, ſans doute, Ou bien, en eas d'amour Beatris ne voit goute.	Il vous aime, sans doute, Ou bien, en eas d'amour Béatris ne voit goute.
Mais, Madame, il me ſemble, & ſous-correction, Que voſtre bel eſprit manque d’inuention.	Mais, Madame, il me semble, et sous-correction, Que votre bel esprit manque d'invention.
Dites-moy donc, Madame, vn peu de jalouſie N’a-t’il iamais vn peu troublé ſa fantaiſie?	Dites-moi donc, Madame, un peu de jalousie N'a-t-il jamais un peu troublé sa fantaisie?
LEONORE.	LEONORE.
Tu crois que ie voudrois luy donner vn riual.	Tu crois que ici voudrais était donner un rival.
Ne l’auez-vous pas fait?	Ne l'avez-vous pas fait?
15.	15.
LEONORE.	LEONORE.
Iamais.	Jamais.
BEATRIS.	BEATRIZ.
Voila le mal.	Voilà le mal.
Ie l'aimerois luy ſeal;	Je l'aimerais Seigneur seal;
mais en ligne indirecte I’aurois d’autres galands pour me rendre ſiſpecte.	mais en ligne indirecte J'aurais d'autres galants pour me rendre sispte.
Et quand le beau Nareiſſe en feroit le cruel, Il ne manqueroit pas de matiere à duël.	Et quand le beau Nareisse en ferait le cruel, Il ne manquerait pas de matière à duël.
Ie ferois les doux yeux;	Je ferais les doux yeux;
& deſſus ſa mouſtache A quelque fanfaron:	et dessus sa moustache A quelque fanfaron:
c’eſt-là trouuer la cache, C’eſt le meilleur ſecret de meitre à Ia raiſon, Vn amant, qui d’amour ſe croit le vray tiſon.	c'est-là trouver la cache, C'est le meilleur secret de mitre à Ia raison, Vén amant, qui d'amour se croit le vrai tison.
Ma foy, de fermete la totte qui ſe pique, Fait vn ſauuage amant, d'vn amant domeſtique.	Ma foi, de fermeté la totte qui se pique, Fait un sauvage amant, d'un amant domestique.
il ne faut point laouſer vn amait affamé, Qui touſiours aime peu, quand il eſt trop aimé.	il ne faut point laouser un amait affamé, Qui toujours aime peu, quand il est trop aimé.
c'eſt de cette façon que Beatris en vze, Auſſi ſuis-je en amour vn Aigle.	c'est de cette façon que Béatris en zé, Aussi suis-je en amour un Aigle.
LEONORE.	LEONORE.
Et moy donc?	Et moi donc?
BEATRIS.	BEATRIZ.
Buze,	Buze,
L'EONORE.	L'ENORE.
Que tes diſcours auroient mon eſprit diuerty, Si par ma paſſion il n’eſtoit peruerty.	Que tes discours auraient mon esprit diverti, Si par ma passion il n'était perverti.
Il ne viendra iamais:	Il ne viendra jamais:
BEATRIS.	BEATRIZ.
Il viendra ſur mon ame:	Il viendra sur mon âme:
Qu'ainſi ne ſoit j’enten du bruit, allez Madame, Allez vous retirer dans voſtre appartement;	Qu'ainsi ne soit j'enten du bruit, allez Madame, Allez -vous retirer dans votre appartement;
le m’en vais au deuant du ſugitif amant.	le m'en vais au devant du sugitif amant.
CENE II.	CÈNE II.
CRISPIN.	CRISPIN.
BEATRES.	BEATRES.
CRISPIN.	CRISPIN.
En chantant.	En chant.
Y mez autant que vous eſtes aimable, A9i vous voulez aimer autant que moy, &c.	Y mez autant que vous êtes aimable, A9i vous voulez aimer autant que moi, etc.
iil Pero3 C'eſt le chien de Criſpin.	iil Péro3 C'est le chien de Crispin.
CRISPIN.	CRISPIN.
Dieu te gard la Soubrette.	Dieu te gard la Soubrette.
BEATRIS.	BEATRIZ.
Que viens-tn faire icy?	Que viens-n faire ici?
CRISPIN.	CRISPIN.
Ie vien faire Diette.	Je viens faire Diette.
Le fantaſque vieillard a rapellé ſon fils.	Le fantasque vieillard a rappelé son fils.
Nous venons d'arriuer tous deux au iour prefir, Moy de mon pied gaillard, ſur ſa mule mon Maiſtre.	Nous venons d'arriver tous deux au jour préfir, Moi de mon pied gaillard, sur sa mule mon Maître.
Ie ne puis deuiner, où le Seigneur peut eſtre, Ny comment ſur ſa mule, & party le premier, Il ne ſera pourtant icy que le dernier.	Je ne puis deviner, où le Seigneur peut être, Ni comment sur sa mule, et parti le premier, Il ne sera pourtant ici que le dernier.
Que dis-tu, Beatris,de choſe tant eſtrange?	Que dis-tu, Béatris,de chose tant étrange?
BEATRIS.	BEATRIZ.
Que u t’ailles coucher:	Que a t'ailles coucher:
CRISPIN.	CRISPIN.
Me coucher?	Me coucher?
mon bel ange.	mon bel ange.
Ie pourrois t'obeyr ſi ie me ſentois las:	Je pourrais t'obéir si ici me sentais las:
Mais ie ne le ſuis point n’eſtant veni qu’au pas.	Mais ici ne le suis point n'étant veni qu'au pas.
BEATRIS.	BEATRIZ.
Ton Maiſtre donc?	Ton Maître donc?
CRISPIN.	CRISPIN.
Mon Maiſtre;	Mon Maître;
eſt vn fou ſans remede.	est un fou sans remède.
Il bat preſentement le paué dans Tolede, Et ſans conſiderer que ſon Pere griſon A changé bruſquement depuis peu de maiſon, Et que moy ſeul j'en ſçay le quartier, & la ruë, Ayant ſa Lettre ſeul, receuë, ouuerte & leuë;	Il bat présentement le pavé dans Tolède, Et sans considérer que son Père grison A changé brusquement depuis peu de maison, Et que moi seul j'en sais le quartier, et la rue, Ayant sa Lettre seul, reçue, ouuerte et leuë;
Ce ſaineux eſtourn, aauo me une pourquoy, En arriuant icy s’eſt ſeparé de moy.	Ce saineux estourn, aavo me une pourquoi, En arrivant ici s'est séparé de moi.
BEATRIS.	BEATRIZ.
Va l'attendre en ton lit.	Va l'attendre en ton lit.
CRISPIN.	CRISPIN.
Encor faut-il qu'on vine;	Encor faut-il qu'on vine;
Et conuerſer vn peu quand des champs on arriue.	Et converser un peu quand des champs on arrive.
Lit,ny draps d’aujourd’huy ne verront mon corps nuz Que ie n’aye causé comme vn nouueau venu.	Lit,ni draps d'aujourd'hui ne verront mon corps nuz Que quelque n'aie causé comme un nouveau venu.
Mon Dieu!	Mon Dieu!
BEATRIS:	BEATRIZ:
CRISPIN.	CRISPIN.
Mon Dieu:	Mon Dieu:
qu'as-tu fille la moins traitable Des filles de Tolede, & la moins conuerſable?	qu'as-tu fille la moins traitable Des filles de Tolède, et la moins conversable?
BRATRIS.	BRATRIS.
Va-t'en chercher ton Maiſtre.	Va-t'-en chercher ton Maître.
CRISPIN.	CRISPIN.
Ouy;	Oui;
mais ie fuis bien las:	mais ici fuis bien las:
EATRIS.	EATRIS.
Et tu diſois tantoſt que tu ne l’éſtois pas.	Et tu disais tantôt que tu ne l'étais pas.
CRISPIN.	CRISPIN.
Ie ne diſois pas bien, Beatris ma mignonne, Mediſons vn moment ſans reſpecter perſonne:	Je ne disais pas bien, Béatris ma mignonne, Médisons un moment sans respecter personne:
Médy de ta Maiſtreſſe, & moy ie te diray, Du Maiſtre que ie ſers tout ce que ie ſçauray.	Médi de ta Maîtresse, et moi -même te dirai, Du Maître que personne sers tout ce que ie éclaurai.
Farlons de nos profits:	Farlons de nos profits:
contons-nous des hiſtoires, Exerçons à l'eouy nos heureuſes memoires:	contons-nous des histoires, Exerçons à l'éoui nos heureuses mémoires:
Ie t'en veux conter vne.	Je t'en veux conter une.
Il eſtoit vne fois, Vn Roy.	Il était une fois, Un Roi.
Ce Roy faiſoit ſa demeure en vn bois.	Ce Roi faisait sa demeure en un bois.
D iii Au milieu de ce bois paſſoit vne riuiere.	 Dis Au milieu de ce bois passait une rivière.
Sur la riuiere vn pont de beauté ſinguliere, Ioignoit au Pont-leuis d'vn ſuperbe Chaſteau, knuironné de tours, & de foſſez plein d’eau.	Sur la rivière un pont de beauté singulière, Joignait au Pont-lèvis d'un superbe Château, knuironné de tours, et de fossé plein d'eau.
Dans ces foſſez pleins d’eau nageoit vne Sirene.	Dans ces fossé pleins d'eau nageait une Sirène.
Cette Sirene eſtoit,	Cette Sirène était,
On ſiffte.	On siffte.
REATRIS.	REATRIS.
Double fiéure quartaine.	Double fière quartaine.
A ce maudit Pedant.	À ce maudit Pédant.
S'il void le Comte icy, Bon Dieu!	S'il voit le Comte ici, Bon Dieu!
j’enten ſiffler, & croy que le voicy.	j'ent siffler, et crois que le voici.
Tout eſt perdu.	Tout est perdu.
CRISPINMa chere;	CRISPINMa chère;
on ſiffle, & ce ſifflage, Eſt-ce pour bon deſſein, ou pour concubinage?	on siffle, et ce sifflage, Est-ce pour bon dessein, ou pour concubinage?
Va va lais ton meſtier, loin de t'en empeſcher, Pour te ſaire plaiſir ie m’en vais me coucher,	Va va lais ton métier, loin de t'en empêcher, Pour te zaïre plaisir ainsi m'en vais me coucher,
BEATRIS.	BEATRIZ.
Par ma foy, j'ay bien eu beſoin de patience, Voyez vn peu ſon flegme, & ſon impertinence, Ii a fait emager;	Par ma foi, j'ai bien eu besoin de patience, Voyez un peu son flegme, et son impertinence, Ji a fait emager;
mais ie le luy rendray, Itn’en vſe pourtant pas trop mal à mon gré, Et j’en attendois pis d’vne ame ſi mal faite.	mais était le mal rendrai, Itn'en us tant pas trop mal à mon gré, Et j'en attendais pis d'une âme si mal faite.
Or ça ſuiuant les pas de feu Dariolette, Faiſons entrer le Comte.	Or ça suivant les pas de feu Dariolette, Faisons entrer le Comte.
Il ſiffle en Eſtourneau.	Il siffle en Étourneau.
Eint voleur de nuit.	Ént voleur de nuit.
CENE FII.	CÈNE FII.
E COMTE.	E COMTE.
DOM PEDRE.	DOM PÉDRE.
REATRIS.	REATRIS.
LE COMTE.	LE COMTE.
Eſteignez le flambeau:	Éteignez le flambeau:
vnaror quimaſuitne veur pas, qu’ou le vore,	Aharor quimasuitne veur pas, qu'ou le vore,
BEATRIS.	BEATRIZ.
Madame en vous voyant aura beaucoup de joye.	Madame en vous voyant aura beaucoup de joie.
LE COMTE.	LE COMTE.
Ie n’en auray pas moins.	Je n'en aurai pas moins.
BEATRIS.	BEATRIZ.
Ne faiſons point de bruit,	Ne faisons point de bruit,
LE COMTE.	LE COMTE.
le vous feray paiſer vne mauuaiſe nuit.	le vous ferai paiser une mauvaise nuit.
DOM PEDRE.	DOM PÉDRE.
Ne ſongez point en moy, ſongez à voſtre affaire,	Ne songez point en moi, songez à votre affaire,
LE COMTE.	LE COMTE.
Vous auez de Ihonneur.	Vous avez de Ihonneur.
DOM PEDRE.	DOM PÉDRE.
Contre mon propre Pere;	Contre mon propre Père;
Contre le monde entier contre moy conjuré Ie perirois pour vous, puiſque ie lay iuré;	Contre le monde entier contre moi conjuré Je périrais pour vous, puisque ici la juré;
Ie vous l'ay defia dit, & ie vous le repete.	Je vous l'ai défia dit, et votre vous le répète.
LE COMTE.	LE COMTE.
Ie n’attendois pas mois a'vne aine ſi bien-faite.	Je n'attendais pas mois a'une aine si bienfaite.
BEATRIS.	BEATRIZ.
Tréue de compliment;	Trêve de compliment;
noſtre ennemy commun Eſt tendre à s’eſueiller autant qu’vn homme à jeun.	notre ennemi commun Est tendre à s'éveiller autant qu'un homme à jeun.
Doucement Elle introduit le Comte.	Doucement Elle introduit le Comte.
DOM PEDRE:	DOM PÉDRE:
demeure ſeul dans vne chaize Ie deuois differer dauantage Au mandement exprés d'vn Pere qu’on outrage, Et le ſuiure pluſtoſt qu'vn mortel ennemy.	demeure seul dans une chaiseaUtz devais différer davantage Au mandement exprès d'un Père qu'on outrage, Et le suivre plutôt qu'un mortel ennemi.
Demain au point du iour ſans meſme auoir dormy I'iray trouuer mon Pere, & ſçauoir quelle offence Inſpiré à ſes vieux ans vn deſir de vengeance.	Demain au point du jour sans même avoir dormi J'irai trouver mon Père, et savoir quelle offense Inspiré à ses vieux ans un désir de vengeance.
Sa Lettre eſtoit preſſante, & j'ay bien reconnu Que quelque grand mal-heur luy doit eſtre venu.	Sa Lettre était pressante, et j'ai bien reconnu Que quelque grand malheur lui doit été venu.
Manquer à ſon deuoir;	Manquer à son devoir;
hazarder ſon eſtime;	hasarder son estime;
C’eſt en quelque façon commettre vn double crime, I’en ſuis au deſeſpoir.	C'est en quelque façon commettre un double crime, J'en suis au désespoir.
D iiij	 Dijà
SCEID IV.	SCEID IV.
D'OM FBLIX.	D'OM FBLIX.
D'OM PIEDRE.	D'OM PIEDRE.
DOM FELIX, Entre ſans lumiere.	DOM FELIX, Entre sans lumière.
Ie ne me trompe pas:	Je ne me trompe pas:
le Vieit d'ouir du oiuit, des paroles, des pas, Ie veux m’en échircir.	le Vieit d'ouïr du oivit, des paroles, des pas, Je veux m'en échircir.
DOM PEDRE.	DOM PÉDRE.
Frapant ſur ſon fiege.	Frappant sur son siège.
Que peut auoir mon Pere?	Que peut avoir mon Père?
DOM FELIX.	DOM FELIX.
A ce bruit que j'entens, ſi ie croy ma colere, si le fer à la main ie cours où j’oy du bruic.	À ce bruit que j'entends, si tu crois ma colère, si le fer à la main homme cours où j'ois du bruic.
On ſe ſauue aisément à Iaide de la nuit Ayons de la lumiere.	On se sauve aisément à Jaide de la nuit Ayons de la lumière.
DOM PEDRE.	DOM PÉDRE.
En toute cette ruë, Que j’ay cent & cent fois viſitée & couruë;	En toute cette rue, Que j'ai cent et cent fois visitée et courue;
Ar ne lopea lamais Dume de qualité Ny fille de merite, ou de rare beauté, Qui meritaſt d’vn Comte eſtre galantisée.	Ar ne lopea lamais Dume de qualité Ni fille de mérite, ou de rare beauté, Qui méritât d'un Comte était galantisée.
L'auenture eſt pourtant ſuſpecte & mal-aisée;	L'aventure est pourtant suspecte et malaisée;
Puis qu’vn homme de cœur y trouue du danger, Et ſe munit ainſi d'vn ſecours eſtranger.	Puis qu'un homme de cœur y trouve du danger, Et se munit ainsi d'un secours étranger.
Vn homme vient à moy l'eſpée toute nuë, Deffendons noſtre poſte:	Un homme vient à moi l'épée toute nue, Défendons notre poste:
Arreſte, où ie te tuë.	Arrête, où belle te tue.
DOM FELIX.	DOM FELIX.
Tu mourras le premier	Tu mourras le premier
DOM PEDRE.	DOM PÉDRE.
C’eſt mon Pere!	C'est mon Père!
DOM FELIX.	DOM FELIX.
Et c'eſt toy:	Et c'est toi:
ENNEMIS.	ENNEMIS.
Pom Pedre, mon cheruls:	Pom Pèdre, mon chéruls:
Mon Pere icy!	Mon Père ici!
DOM PEDRE.	DOM PÉDRE.
Ha qu’eſt-ce que ie voy!	Ha qu'est-ce que ici vois!
DOM FELIX.	DOM FELIX.
Mon fils, qui t’a dit ma demeure?	Mon fils, qui t'a dit ma demeure?
Et comnent astu puu tiouuer A telle heure?	Et comnent astu pu tiouuer A telle heure?
DOM PEDRE.	DOM PÉDRE.
O que non ſans ſujet ce diſcours me fait peur.	Ô que non sans sujet ce discours me fait peur.
DOM FELIX.	DOM FELIX.
Il faut mourir Dom Pedre, ou venger mon honneur, Mais mon fils, ie te voy l’ame toute interdite, Et tur me parois froid alors que ie t’excite.	Il faut mourir Dom Pedre, ou venger mon honneur, Mais mon fils, Il te vois l'âme toute interdite, Et tur me parais froid alors que je t'excite.
Sçais-tu deſia par où noſtre honneur eſt taché;	Sais-tu déjà par où notre honneur est taché;
Car vn pareirimi-neur n eſe pa long-temps caché:	Car un pareirimi-neur n' eze pa longtemps caché:
Ou ton bras puniſſant vne vie ennemie, Auroit-il pû deſia venger noſtre infamie?	Ou ton bras punissant une vie ennemie, Aurait-il pu déjà venger notre infamie?
DOM.	DOM.
PEDRE.	PÉDRE.
Venger noſtre infamie!	Venger notre infamie!
DOM FELIX.	DOM FELIX.
Ouy, mon fils, la venger, Au prix de noſtre mal, c’eſt vn fardeau leger.	Oui, mon fils, la venger, Au prix de notre mal, c'est un fardeau léger.
Venge moy, venge toy,	Venge -moi, venge toi,
DOM PEDRE.	DOM PÉDRE.
Ne ſçachant pas l’offence.	Ne sçachant pas l'offense.
DOM FELIX.	DOM FELIX.
Tu la ſçauras trop toſt, courons à la vengeance:	Tu la Sauras trop tôt, courons à la vengeance:
C'eſt par ce ſeul moyen, que noſtre honneur perdu Où le ſera ſans honte, où nous ſera rendu.	C'est par ce seul moyen, que notre honneur perdu Où le sera sans honte, où nous sera rendu.
Mais mon fils, ſans rougir, te puis-je rendre compte;	Mais mon fils, sans rougir, te puis-je rendre compte;
Du commun déplaiſir qui nous couure de honte.	Du commun déplaisir qui nous couvre de honte.
Eſpargne moy, mon fils, la honte & le regret De reueler moy-meſme vn ſi faſcheux ſecret.	Épargne moi, mon fils, la honte et le regret De révéler moi-même si fâcheux secret.
Diſpenſe moy, mon ſils, d'vn recit ſi funeſte, Va-t'en trouuer ta ſœur, apren d’elle le reſte:	Dispense moi, mon sils, d'un récit si funeste, Va-t'en trouver ta sœur, appren d'elle le reste:
Mais ſi tu m'aimes bien, parle luy doucement, Parle luy de pardon, plus que de chaſtiment:	Mais si tu m'aimes bien, parle amour doucement, Parle Seigneur de pardon, plus que de châtiment:
En aprenant ſon mal apren luy ſon remede:	En apprenant son mal appren cy son remède:
Car enfin dans mon cœur, mon ſang pour elle plaide, Et louuien-toy, qu'ene eit, & ma fille, & ta ſœur.	Car enfin dans mon cœur, mon sang pour elle plaide, Et louvien-toi, qu'ène eit, et ma fille, et ta sœur.
DOM PEDRE.	DOM PÉDRE.
Ie ſers mon ennemy contre mon propre honneur.	Je sers mon ennemi contre mon propre honneur.
O Dieu:	Ô Dieu:
que de mal-heurs ſur moy le Ciel aſſemble.	que de malheurs sur moi le Ciel assemble.
DOM FELIX.	DOM FELIX.
Dom Pedre, faiſons mieux allons la voir enſemble, Lt flatant ſa douleur, taſchons de luy monſtrer.	Dom Pèdre, faisons mieux allons la voir ensemble, Lt flattant sa douleur, tâchons de Seigneur montrer.
DOM PEDRE.	DOM PÉDRE.
Non mon Pere attendez, vous n’y pouuez entrer.	Non mon Père attendez, vous n'y pouvez entrer.
DOM Moy ie n’y puis entrer!	DOM Moi Madame n'y puis entrer!
FELIX.	FELIX.
DOM PEDRE.	DOM PÉDRE.
Ie vous di vray, mon Pere, vouan y pouuer encrer moy viuant.	Je vous di vrai, mon Père, vouan y pouver encrer moi vivant.
DOM FELIX.	DOM FELIX.
Quel miſtere?	Quel mystère?
Ou quelle extrauagance?	Ou quelle extravagance?
es-tu dans ton bon ſens?	es-tu dans ton bon sens?
Et pourquoy ces ſouſpirs, & ces yeux languiſſans?	Et pourquoi ces soupirs, et ces yeux languissants?
Oſte-toy.	Ost-toi.
DOM PEDRE.	DOM PÉDRE.
N’entrez pas;	N'entrez pas;
ie garde cette porte.	Il garde cette porte.
D'OM FELIX.	D'OM FELIX.
Reſiſter à ſon P'ere?	Résister à son P'ère?
& parler de la ſorte!	et parler de la sorte!
H ne me manquoit donc pour combler mon mallieur, Que ta raiſon bleſſée, autant que mon honneur?	H ne me manquait donc pour combler mon mallieur, Que ta raison blessée, autant que mon honneur?
DOMPEDRE.	DOMPEDRE.
Mon Pere, ma raiſon ne fut iamais plus ſaine;	Mon Père, ma raison ne fut jamais plus saine;
Mais vn iuſte ſujet.	Mais un juste sujet.
Fils ingrat.	Fils ingrat.
DOM FELEX.	DOM FÉLEX.
Ne crains-tu point ma haine?	Ne crains-tu point ma haine?
CENE V.	CÈNE V.
LEONORE.	LEONORE.
LE COMTE.	LE COMTE.
DOM PEDRE.	DOM PÉDRE.
LE COMTE.	LE COMTE.
Derrtere le Theatre.	Derrtère le Théâtre.
Madame ouurez la porte, ou ie la mets à bas.	Madame ouvrez la porte, ou ainsi la mets à bas.
DOM FELIX Vn homme chez ma fille, ô Dieu!	DOM FELIX Un homme chez ma fille, ô Dieu!
LE COMTE.	LE COMTE.
Don Pedre à vos contez le viens vaincre, ou mourir.	Don Pèdre à vos comptez le viens vaincre, ou mourir.
LEONORE.	LEONORE.
Cher Comte, à tes coſtez ie ſuis preſte à perir.	Cher Comte, à tes côtés te suis prête à périr.
DOM TELIX.	DOM TELIX.
Mon fils, c’eſt l'ennemy qui nous pert, & nous braue,	Mon fils, c'est l'ennemi qui nous pert, et nous brave,
LE COMTE.	LE COMTE.
il le nomme ſon fils!	il le nomme son fils!
DOM FELIX.	DOM FELIX.
Il faut que ſon ſang laue Noſtre commune offence, il faut que noſtre honneur Reuiue dans la mort d’vn laſche ſuborneur.	Il faut que son sang la Notre commune offense, il faut que notre honneur Reuiue dans la mort d'un lâche suborneur.
DOM PEDRE.	DOM PÉDRE.
Ie n’ay point à choiſir,il faut ſauuer le Comte, Manquer à ſa parole eſt la derniere honte.	Je n'ai point à choisir,il faut sauver le Comte, Manquer à sa parole est la dernière honte.
DOM FELIX.	DOM FELIX.
Tu pact-basman fils?	Tu pat-basman fils?
DOM PEDRE.	DOM PÉDRE.
Mon Pere il faudroit voir.	Mon Père il faudrait voir.
DOM FELIX.	DOM FELIX.
Ha ie n’ay veu que trop.	Ha ici n'ai vu que trop.
Appren-moy mon deuoir.	Appren-moi mon devoir.
LE COMTE, De te trahir Dom Pedre, il m'euſt eſté facile:	LE COMTE, De te trahir Dom Pedre, il m'eût été facile:
uine chon me, voiie moy ie te ſeruis d’azile:	uine chon me, voiie moy ie te seruis d’azile:
Et chez toy cependant, entre ton Pere & moy, Ie te voy hezitter comme vn homme ſans foy?	Et chez toi cependant, entre ton Père et moi, Je te vois hezter comme un homme sans foi?
DOM FELIX.	DOM FELIX.
Quoy!	Quoi!
mon fils, aux raiſons que ſa peur luy ſuggere, Ton cœur preite Ioremie & la ferme à ton Pere;	mon fils, aux raisons que sa peur Seigneur sugère, Ton cœur préite Ioremie et la ferme à ton Père;
Il t’a ſauué la vie, il s'en eſt fait honneur:	Il t'a sauvé la vie, il s'en est fait honneur:
Mais il rauit le tien,l'inſolent ſuborneur.	Mais il ravit le tien,l'insolent suborneur.
Vengeons, vengeõs.	Vengeons, vengeuse.
mon fils, vengeons noſtre infamie.	mon fils, vengeons notre infamie.
DOM PEDRE.	DOM PÉDRE.
Mon Pere, ie luy dois ma parole, & ma vie.	Mon Père, ie luy dois ma parole, et ma vie.
Vous me rauez domee :	Vous me ravez domée :
iine la pû rauir.	jine la pu ravir.
Chez luy contre moy ſeul, il a pû ſe ſeruir De ſa rare valeur à ma perte animée, Par le ſang reſpandu d'vne perſonne aiméez Il a pû ſe ſeruir de valets contre moy, Et vous eitiez ſans nis,s feuit eſté ſans foy.	Chez notre contre moi seul, il a pu se servir De sa rare valeur à ma perte animée, Par le sang répandu d'une personne aiméez Il a pu se servir de valets contre moi, Et vous eitiez sans nis,s feuit été sans foi.
DOM FELIX.	DOM FELIX.
Prefere vne parole à la haſte donnée, A ta gloire fleſtrie, à ta ſœur ſubornée.	Préfère était parole à la hâte donnée, A ta gloire flétrie, à ta sœur subornée.
Va, va, ſauue la vie à ton conſeruateur?	Va, va, sauve la vie à ton conservateur?
Mais ne me nomme plus de la tienne l'autheur.	Mais ne me nomme plus de la tienne l'auteur.
Ouy, que ie ſois ſans fils, qu’il nous tuë, ou qu’il meure.	Oui, que je sois sans fils, qu'il nous tue, ou qu'il meure.
LE COMTE.	LE COMTE.
Eſcoute-moy Dom Pedre;	Écoute-moi Dom Pèdre;
& toy vieillard, demeure.	et toi vieillard, demeure.
Ie ſçay donner la vie, & la deffendre auſſi, Et mon bras ſeul encor peut me tirer d’icy:	Je sais donner la vie, et la défendre aussi, Et mon bras seul encor peut me tirer d'ici:
Mais du Pere & du fils, quand la fureur vnie Auroit versé mon ſang, & ma trame finie;	Mais du Père et du fils, quand la fureur un Purait versé mon sang, et ma trame finie;
Indignes ennemis, pouuez-vous empeſcher, Qu'on ne vous puiſſe vn iour iuſtement reprocher, Qu'vn fils peu genereux, ſans moy ſeroit ſans vie, 2 vn	Indignes ennemis, pouvez-vous empêcher, Qu'on ne vous puisse un jour justement reprocher, Qu'un fils peu généreux, sans moi serait sans vie, 2 un
Du'va Pere, dont ma perté eſt lajoye, & l'enuie, Sans moy ſe trouueroit ſans fils, & fans ſuport, Et que ſeul contr’eux dęux, j’ay diſguré ma mont.	Du'vaUne, dont ma perté est lajoie, et l'envie, Sans moi se trouverait sans fils, et fans suport, Et que seul contr'eux dęux, d'ai disguré ma mont.
l'ouuez-vous eſfacer vne ſi noire rache?	l'avez-vous éfacer une si noire rache?
Pouuez-vous empeſcher que l’Eſpagne ne ſçache, Que j’ay fait pour le fils, bion plus que ie n’ay dû:	Pouvez-vous empêcher que l'Espagne ne sache, Que j'ai fait pour le fils, bion plus que je n'ai dû:
Eiin, qu'irm poit touc,cenoihe tien rondu.	Eiin, qu'irm poit toucenoihe tien rondu.
Venęz apres cell, venez, & Fils, & Pare, Venez d'vn bien-aiteur, elprouuer la colere.	Vensez après cel, venez, et Fils, et Pare, Venez d'un bien-aiteur, elprouuer la colère.
DOA FELIX.	DOA FELIX.
Ouy ſeuil, &c ſans mon fus, ie m'expoſeà ous enurs.	Oui seuil, etc sans mon fus, Seigneur m'exposeà ous enurs.
DOM PEDRE.	DOM PÉDRE.
Mon Pere u vousganſpute vx auxrelr oumouxi	Mon Père u vousganspute vx auxrel oumouxi
DOM FELIX.	DOM FELIX.
A me perdre, à te perdrt, à poignacdæ maſlle, O peſte dereſtable à poure ma cariille;	À me perdre, à te perdrt, à poignacdæ maslle, Ô peste derétable à pôvre ma carjille;
Il faut que ſur le champ va poiguard daus auſcin.	Il faut que sur -le -champ va poiguard daus auxcin.
DON PEDRE:	DON PÉDRE:
Arreſteut ſos Peu.	Arrêteut sos Peu.
Ah que ſur moy gluſtaſtre tragi que deſlain Se commenoe, & c’acheue.	Ah que sur moi glustastre tragi que délain Se commenoe, et c'achève.
DOTELIE.	DOTELIE.
Oſtra	Ostra
LE COMITE.	LE COMITÉ.
Ταυλαςὲ Lvm.	Ταυλαςὲ Lvm.
Tout à libeure bagnez viſte laruë, & delàma demeure.	Tout à libeure bagnez vite larve, et delàma demeure.
OM FELIX.	OM FELIX.
Enſin donc, ſils ſans cœur, à quoy ce reſoustut	Ensin donc, sils sans cœur, à quoi ce resoustut
DOM PEDRE.	DOM PÉDRE.
A croire mon honpeur, à croire ma vertu, A garder ma parole, à verger mon ollence.	À croire mon honpeur, à croire ma vertu, A garder ma parole, à verger mon ollence.
DOM FELIX.	DOM FELIX.
Tu mets donc l'vne & l'auere enépale balance?	Tu mets donc l'une et l'avère enépale balance?
Tu luy fais perdre vn frere, il ſiiborne ta ſœur, L’vn, eſt vn déplaiſir, lautie, eſt vn deshonneur:	Tu autre fais perdre un frère, il siiborne ta sœur, L'un, est un déplaisir, lautie, est un déshonneur:
L'vn ne vout qu’vn combat, Iautre veut vne vie;	L'un ne vout qu'vn combat, Jautre veut une vie;
L'vn fait porter le deuil, & l'autre l'infamie.	L'un fait porter le deuil, et l'autre l'infamie.
Voy, voy, comme ie ſçay me venger, Acſant tor.	Vois, vois, comme ici sais me venger, Acsant tor.
DOM PEDRE.	DOM PÉDRE.
Voulant arreſter ſon Pere.	Voulant arrêter son Père.
Mon Pere, ſi iamais.	Mon Père, si jamais.
DOM FELIA Ne parle point à moy.	DOM FELIA Ne parle point à moi.
A part.	À part.
Ie m'en vais emermer cedte nuprudente fille Dans ſa chambre, & demain dans vne auſtere grille.	Je m'en vais emermer cédte nuprudente fille Dans sa chambre, et demain dans une austère grille.
Dom Felix ſort.	Dom Félix sort.
DOM PEDRE.	DOM PÉDRE.
Comte, tu te vois ſeul, & connois ayzément, Que pluſieurs nous pouuons te perdre en vn moment, Puiſque ie le pourrois ſeul, & ſans auantage:	Comte, tu te vois seul, et connais aisément, Que plusieurs nous pouvons te perdre en un moment, Puisque enfin le pourrais seul, et sans avantage:
Mais ie dois pour le moins t’eſgaler en courage.	Mais ici dois pour le moins t'égaler en courage.
Tu ſçais que perdre vn frere, & perdre ſon honneur, N’eſt pas perte pareille entre les gens de cœur.	Tu sais que perdre un frère, et perdre son honneur, N'est pas perte pareille entre les gens de cœur.
Ma generoſité ſurpaſſe donc la tienne, D’autant que ton offence eſt moindre que la mienne Ie paye auec vſure, vn bien que tu m'as fait:	Ma générosité surpasse donc la tienne, D'autant que ton offense est moindre que la mienne Je paye avec usure, un bien que tu m'as fait:
Mais ce n'eſt pas aſſez que tu ſois ſatisfait;	Mais ce n'est pas assez que tu sois satisfait;
Il faut que ie le ſois.	Il faut que personne le sois.
Ta mort ſeule eſt capable, Si ton crime enuers nous peut eſtre reparable, De mettre mon honneur en ſon premier eſclat.	Ta mort seule est capable, Si ton crime envers nous peut être réparable, De mettre mon honneur en son premier éclat.
Sors donc :	Sors donc :
Mais pour entrer toſt apres au combat.	Mais pour entrer tôt après au combat.
Vn combat ſatisfait les manes de ton frere;	Un combat satisfait les mânes de ton frère;
Ta mort, ſatisfera moy, ma ſœur, & mon Pere.	Ta mort, satisfera moi, ma sœur, et mon Père.
Eſtant homme de cœur, tu la diſputeras:	Étant homme de cœur, tu la disputeras:
Mais le Ciel eſt injuſte, ou bien tu periras.	Mais le Ciel est injuste, ou bien tu périras.
E COMTE.	E COMTE.
La choſe giſt en Fait.	La chose gît en Fait.
Où te faut-il attendre?	Où te faut-il attendre?
DOM PEDRE.	DOM PÉDRE.
Dans la place, où ie vais toute à Iheure me rendre.	Dans la place, où belle vais toute à Iheure me rendre.
LE COMTE.	LE COMTE.
Ie n’attens pas long-temps.	Je n'attends pas longtemps.
DOM PEDRE.	DOM PÉDRE.
I'ay haſte plus que toy, De re voir ſeul à ſeul aux mains auecque moy.	J'ai hâte plus que toi, De re voir seul à seul aux mains avec moi.
Va-t’en donc.	Va-t-en donc.
DOM FELIX.	DOM FELIX.
Reuient.	Revient.
Quoy mon fils!	Quoi mon fils!
il ſort auec la vie?	il sort avec la vie?
A qui te perd d'honneur tu ne l'as point rauie?	À qui te perd d'honneur tu ne l'as point ravie?
M PEDRE.	M MEDRE.
Ie le trouueray bien.	Je le trouverai bien.
DOM FELIX.	DOM FELIX.
Trouue pluſtoſt ta ſœur, Infame comdent d'vn cruel radiſſeur.	Trouve plutôt ta sœur, Infâme comdent d'un cruel radisseur.
OM PEDRE Quoy mon Pere!	OM PEDRE Quoi mon Père!
ma Sœur.	ma Sœur.
OM FELIX, Dom Pedre ſort.	OM FELIX, Dom Pèdre sort.
Eſt en fuite, eſt ſauuée:	Est en fuite, est sauvée:
Mais ne te montre point qu’elle ne ſoit trouuée, Ou pluſtoſt, laſche fils, ne te montre iamais.	Mais ne te montre point qu'elle ne soit trouvée, Ou plutôt, lâche fils, ne te montre jamais.
Ie ne veux plus de fils, de fiile, ny de paix.	Je ne veux plus de fils, de fiile, ni de paix.
La laſcheté d'vn fils, la honte d'vne fille, Perdent également I'honneur de ma famille:	La lâcheté d'Hommes fils, la honte d'une fille, Perdent également J'honneur de ma famille:
Perdons-en la memoire, & ſanr plus differer, Allons du Souuerain la Iuſtice implorer;	Perdons-en la mémoire, et sanr plus différer, Allons du Souverain la Justice implorer;
Et s’il n’eſt point pour nous de Iuſtice à Tolede.	Et s'il n'est point pour nous de Justice à Tolède.
La violence alors, ſera noſtre remede.	La violence alors, sera notre remède.
ACTE IV.	ACTE IV.
SOENE I.	ZONE I.
CRISPIN.	CRISPIN.
BEATRIS.	BEATRIZ.
RISPIN.	RISPIN.
OVE te dire le vray;	OVE te dire le vrai;
j'adoptois la vſſite, I Car tu la deuois bien à mon rare morite.	j'adoptais la ussite, I Car tu la devais bien à mon rare morite.
BEATRIS.	BEATRIZ.
Ie venois ſeulement voir ton Maiſtre, d pour tor Ie ne te croyois pas en la Maiſon du Roy;	Je venais seulement voir ton Maître, d pour tor Je ne te croyais pas en la Maison du Roi;
Mais comment t’a ton pris	Mais comment t'a ton pris
CRISFIN.	CRISFIN.
A ce bruit effroyable Que lon a ſait la fuit, à la nuneur de Diable Qu'ont fait le fils, le Pere, & le Comte acharnez A trouuer maux nouueaux, & ſe les dire au nez;	À ce bruit effroyable Que lon a sait la fuit, à la nuneur de Diable Qu'ont fait le fils, le Père, et le Comte acharnez A trouver maux nouveaux, et se les dire au nez;
I'ay quitté le grabat, & j’ay ſuiuy mon Maiſtre, Qui ſortoit furieux, & pâle comme vn traiſtre, Iurant entre ſes dents, nommant ſouuent ſa ſœur, Et la donnant au Diable, elle & ſon rauiſſeur.	J'ai quitté le grabat, et j'ai suivi mon Maître, Qui sortait furieux, et pâle comme un traître, Jurant entre ses dents, nommant souvent sa sœur, Et la donnant au Diable, elle et son ravisseur.
De quartier en quartier il a cherché le Comte:	De quartier en quartier il a cherché le Comte:
Nous ne lauons trouué, ny luy, ny noſtrecompte.	Nous ne lavons trouvé, encoux, ni otrecompte.
Vn Preuoſt nous a pris, & nous a mis leans;	Un Prévôt nous a pris, et nous a mis leants;
Leans, c’eſt vn manoir qui reſlemble à ceans;	Leans, c'est un manoir qui réslemble à céans;
Ceans, c’eſt la priſon;	Ceans, c'est la prison;
Priſon;	Prison;
c’eſt où ie peſte;	c'est où tu peste;
Peſter, c’eſdilin, mort, teſte, ſang, ie deteſte, Dereſter.	Pester, c'édilin, mort, tête, sang, Elle déteste, Derester.
BEATRIS.	BEATRIZ.
Ha tay toy, tu ris hors de ſaiſon.	Ha ta y, tu ris hors de saison.
CRISPIN.	CRISPIN.
Si bien que vous auez deſgarny la Maiſon?	Si bien que vous avez dégarni la Maison?
BEATRIS.	BEATRIZ.
Ie t’ay conté comment la choſe eſt arriuée.	Je t'ai conté comment la chose est arrivée.
CRISPIN.	CRISPIN.
Si bien que Econore auec toy s’eſt ſauuée?	Si bien que Éconore avec toi s'est sauvée?
Chez le Comte.	Chez le Comte.
BEATRIS.	BEATRIZ.
CRISPIN.	CRISPIN.
Et ſa ſœur Caſſandre?	Et sa sœur Cassandre?
BEATRIS.	BEATRIZ.
Elle nous fit Vn merueilleux accueil ſa bonté nous rauit;	Elle nous fit Un merveilleux accueil sa bonté nous ravit;
Entin, ce n'eſt plus qu'vn de ma Maiſtreſſe & d’elle.	Entin, ce n'est plus qu'un de ma Maîtresse et d'elle.
CRISPIN.	CRISPIN.
Ie t’apren que mon Maiſtre eſt ſon amant fidelle, Et e’eſt pour ſon ſujet qu’à ſon frere germain, Ilhit comme tu ſçais perdre le gouſt du pain.	Je t'appren que mon Maître est son amant fidèle, Et e'est pour son sujet qu'à son frère germain, Ilhit comme tu sais perdre le goût du pain.
BEATRIS.	BEATRIZ.
I'appris hier cette mort pendant tout Ieur grabuge.	J'appris hier cette mort pendant tout Jeur grabuge.
CRISPIN.	CRISPIN.
Cependant, ie verray tantoſt face de Iuge, Cela ne me plaiſt point;	Cependant, Seigneur verrai tantôt face de Juge, Cela ne me plaît point;
mais pourquoy ſortiez-vous?	mais pourquoi sortiez-vous?
BEATRIS.	BEATRIZ.
Parce qu’on ne parloit que de donner cent coups, Et ſçauez-vous dequoy!	Parce qu'on ne parlait que de donner cent coups, Et savez-vous dequoy!
de poignard, & le Pere Nous paroiſſoit alors auſſi fou que le frere, Nous ſommes chez le Comte, & ma maiſtreſſe & luy, Ne s’aymerent iamais tant qu’ils font aujourd’huy.	de poignard, et le Père Nous paraissait alors aussi fou que le frère, Nous sommes chez le Comte, et ma maîtresse et lui, Ne s'aimèrent jamais tant qu'ils font aujourd'hui.
CRISPIN.	CRISPIN.
Nous ſommes en Priſon, oà Criſpin & ſon Maiſtre Sont, me ſemble, auſſi mal qu’ils puiſſent iamais eſtre, Pour moy ie me conſole, & ie rencontre icy, Des gens qui comme moy ſe conſolent auſſi.	Nous sommes en Prison, oà Crispin et son Maître Sont, me semble, aussi mal qu'ils puissent jamais être, Pour moi je me console, et Seigneur rencontre ici, Des gens qui comme moi se consolent aussi.
le vien de leur payer à tous ma bien-venuë,	le viens de leur payer à tous ma bienvenue,
BEATRIE.	BEATRIE.
Et moy, je m’elrc-y comme ie ſuis venut.	Et moi, je m'elrc-y comme je suis venut.
En te remerciant.	En te remerciant.
ONTOTIN.	ONTOTIN.
BEATRIE.	BEATRIE.
Il n'y a pas dequoy, Alors qu’on te pendra le priray Dieu pour toy.	Il n'y a pas dequoy, Alors qu'on te pendra le prirai Dieu pour toi.
RISPIN.	RISPIN.
I'eſpere à mes ſouhaits ſi Hitu preſtt l'oreille, En mehe ocuinon te renoit la pareille:	J'espère à mes souhaits si Hitu prêt l'oreille, En mehe ocuinon te renaît la pareille:
Adieu cauſeuſe.	Adieu causeuse.
BEATRIS.	BEATRIZ.
Adis.	Adis.
CRIMTTAVI Me viendrar tui reuoir?	CRIMTTAVI Me viendrar tui revoir?
BEATRIS.	BEATRIZ.
Si j'y vien, ce ſera peut-eſtrè vots le ſoir.	Si j'y viens, ce sera peut-être vots le soir.
SCENE II.	SCÈNE II.
SAMORIN.	SAMORIN.
CRISPIN.	CRISPIN.
ZAMORIN.	ZAMORIN.
Lle a parbleu bon ail!	Lle a parbleu bon ail!
quellerſt cutte Prinoeſſe?	quellet cute Prinoesse?
CRISPIN.	CRISPIN.
Vpe fille de bien, qui pour moy ?	Ve fille de bien, qui pour moi ?
iatereſſe.	jateresse.
2.	2.
A MORIN.	À MORIN.
Elle n’eſt pas pourrie!	Elle n'est pas pourrie!
& porte bien les piez.	et porte bien les pieds.
CRISPIN.	CRISPIN.
Sont-ils allez dermir nos braues conciez.	Sont-ils allés dermir nos braves conciés.
ZAMORIN.	ZAMORIN.
It ſe ſentent vn peu de voſtx bonne chere.	It se sentent un peu de vostx bonne chère.
CRISPIN.	CRISPIN.
l'ay fait ſelon le lieu, le pomps, &da miſere.	l'ai fait selon le lieu, le pomps, etda misère.
ZAMGRIN:	ZAMGRIN:
Il faut ſe reſiouys, car nous ſenoas demaln Peut-eſtte en l'autre monde, uù du moins en chemin.	Il faut se réjouis, car nous senoas demaln Peut-estte en l'autre monde, du moins en chemin.
Pour moy deſia trois ſoit en cette meline place, I'ay veu comme lon dit le treſpas face à ſace, Ie n’en ay pas moins bâ, ie n’en cy pas moins ry, Car s’en trouues s’on mieux, pour faire le marry, Vous ay-je pas fait voir des hommes d’importance?	Pour moi déjà trois soit en cette meline place, J'ai vu comme lon dit le trépas face à sace, Je n'en ai pas moins bât, elle n'en cy pas moins ry, Car s'en trouves s'on mieux, pour faire le marri, Vous ai-je pas fait voir des hommes d'importance?
Viue Dic, ſi iamais, & l'Eſpagne, & la Prance, A veu pareille troupe, & de plus brauesgens, En vi neu lamanenu par les mains des Sergons, Nous y tuons le comps à conter quelque Hiſtoires.	Vive Dic, si jamais, et l'Espagne, et la Préance, A veu pareille troupe, et de plus brauesgens, En vi ve lamanenu par les mains des Sergons, Nous y tuons le comps à conter quelque Histoires.
A joüer, à dormir, à ne rien faire, à boire, Et profeſſons en tout d’agit en gens de bien.	À jouer, à dormir, à ne rien faire, à boire, Et professons en tout d'agit en gens de bien.
ORESPIN.	ORÉPIN.
Le Seipmar semotina dit bien, &c tresbien.	Le Sypmar semotina dit bien, etc tresbien.
ZAMORIN.	ZAMORIN.
lout vou vontit periome en ces lieux efcroüée, Ie ne vous en voy pas l’hemeur moins enjoüée.	lout vou vontit périome en ces lieux efcroüée, Je ne vous en vois pas l'hémeur moins enjouée.
GRISPIN.	GRISPIN.
Auſfi, n’y ſiuis-je pas pounta prtmiere fois.	Ausfi, n'y siuis-je pas pounta prtmiere fois.
ZA MORIN.	ZA MORIN.
En auez-vous depu ?	En avez-vous dépu ?
CRISPIN.	CRISPIN.
Pius de doux mois.	Pius de doux mois.
Et pour n'auo cien fait.	Et pour n'avo cien fait.
LAMORIN.	LAMORIN.
Enfin qui vœy mit?	Enfin qui vœi mit?
Chacuu en dit de meſme.	Chacu en dit de même.
GRISPIN.	GRISPIN.
La paiſion exgéme, Que j’eus pour vn ohje dirmant.	La paision exgrême, Que j'eus pour un ohje dirmant.
ZAMORIN.	ZAMORIN.
Dires vous rout?	Dires -vous rout?
CRISPIN.	CRISPIN.
Ie vous vay reconrer l’aſſaire iuſqu l bout.	Je vous vais réonrer l'assaire iusqu l' out.
Vn Auocat Coquet à teſte perruquée, Cardoit bien cherrment vne bourfe meſquée,	Un Anvocat Coquet à tête perruquée, Cardait bien cherrment une bourse mesquée,
E iiij Ie ne hay pas cela:	E jij à ne hais pas cela:
j'en deuins amoureux.	j'en devins amoureux.
La Donzelle n’eut pas le cœur fort rigoureux, Dens ma poche auſſi-toſt l'amitié nous aſſemble:	La Donzelle n'eut pas le cœur fort rigoureux, Dents ma poche aussitôt l'amitié nous assemble:
L’Auocat enragé de nous voir bien enſemble, (A vous dire le vray j'auois rauy ſa fleur,) Informa contre moy, me traira de voleur;	L'Avocat enragé de nous voir bien ensemble, (A vous dire le vrai j'avais ra sa fleur,) Informa contre moi, me traira de voleur;
On m'arreſta pour rapt, me trouuant auec elle, Ie fus mis en priſon ſeparé de la belle;	On m'arrêta pour rapt, me trouvant avec elle, Je fus mis en prison séparé de la belle;
I alleguay mes raiſons, dis qu’elle eſtoit à moy, Et ſoutins qu'elle auoit ma parole & ma foy:	I alléguai mes raisons, dis qu'elle était à moi, Et soutins qu'elle avait ma parole et ma foi:
L’Auocat ſit pourtant, rompre le mariage, Et ſans mes bons amis j’eſtois long temps en cage.	L'Avocat sit pourtant, rompre le mariage, Et sans mes bons amis j'étais long temps en cage.
ZAMORIN.	ZAMORIN.
Tous les hommes d'honneur ſont mal-heureux ainſi:	Tous les hommes d'honneur sont malheureux ainsi:
Mais aujourd’huy pourquoy vous a-t’on mis icy?	Mais aujourd'hui pourquoi vous a-t-on mis ici?
CRISPIN.	CRISPIN.
Pour aymer par excez.	Pour aimer par excès.
BAMORIN.	BAMORIN.
Eſt-ce vne bourſe encore;	Est-ce vne bourse encore;
No;	No;
Mais vn chien de Maiſtre, vn vaurien que j'adoro Allans ce Maiſtre & moy, la niit galantizer, Et vous ne deuez pas vous en ſcandalizer.	Mais un chien de Maître, un vaurien que j'adoro Allants ce Maître et moi, la néant galantiser, Et vous ne devez pas vous en scandaliser.
Car enfin l'homme eſt homme, & ſujet à foibleſſe, Comme chacun de nous cajoloit ſa Maiſtreſſe, La luſtice eſt venuë, & nous le fer au poing Nous l'auons repouſſée, & pouſſée aſſez loin.	Car enfin l'homme est homme, et sujet à faiblesse, Comme chacun de nous cajolait sa Maîtresse, La lustice est venue, et nous le fer au point Nous l'avons repoussée, et poussée assez loin.
Noſtre Maiſtre d'abord a fait de ſa main blanche Vne playe au Preuoſt au deſſus de la hanche, A de ſon Lieutenant offencé le ſternum, Et j’ay ſait au Greffier viſage de Guenon.	Notre Maître d'abord a fait de sa main blanche Vne plaie au Prévôt au dessus de la hanche, À de son Lieutenant offensé le sternum, Et j'ai sait au Greffier visage de Guenon.
Luy faiſant choir du nez la meilteure partie;	Lui faisant choir du nez la meilteure partie;
L’eſtafillade eſt rare, & faite en ſimetrie;	L'étafillade est rare, et faite en symétrie;
Elle luy ſied fort bien, & par tout paſſeroit Pour eſtre naturelle à qui ne le ſçauroit, La pluſpart des Archers ſont bleſſez par mon Maiſtre,,	Elle homme sied fort bien, et par tout passerait Pour être naturelle à qui ne le saurait, La plupart des Archers sont blessés par mon Maître,
ZAMORIN.	ZAMORIN.
En eſt-il mort quelqu’vn?	En est-il mort quelqu'un?
CRISPIN.	CRISPIN.
Cela pourroit bien eſtre.	Cela pourrait bien être.
Les cloches ont ſonné, dit-on, auprés delà.	Les cloches ont sonné, dit-on, auprès delà.
ZAMORIN.	ZAMORIN.
gi cette affairè eſt vraye, & va comme cela, Il y pouxroit entrer vn tant ſoit peu d’Echelle:	gy cette affairène est vraie, et va comme cela, Il y pouxroit entrer un tant soit peu d'Échelle:
Mais a l'nomne de cuur es n’eſt que bagatelle.	Mais a l'nomne de cuur es n'est que bagatelle.
CRISPIN.	CRISPIN.
affaire, s’il vous plaiſt, ſoit ſecrette Intet nes.	affaire, s'il vous plaît, soit secrète Intet nés.
ZAMORIN.	ZAMORIN.
Con liſenza Patron, Ie vay dire deux mots, A I’homme que is voy.	Con lisenza Patron, Je vais dire deux mots, A J'homme que .
CRISPIN.	CRISPIN.
Et moy Mosy somir.	Et moi Mosi somir.
Volontiers camarade,	Volontiers camarade,
ZAMORIN.	ZAMORIN.
Et qui t’amoine icy!	Et qui t'amoine ici!
Mon amy la Taillade	Mon ami la Taillade
SCENE III.	SCÈNE III.
LA TAILLADE.	LA TAILLADE.
ZAMORIN.	ZAMORIN.
LA TAILLADE.	LA TAILLADE.
Le deſſein de te voir.	Le dessein de te voir.
ZAMORIN.	ZAMORIN.
Tu me vois en priſon.	Tu me vois en prison.
LA TAILLADE.	LA TAILLADE.
le vien de le ſçauoir.	le viens de le savoir.
Ayant à te parler, d'vnt courſe inutlle l'ay fait en vn moment tous les coint de la ville, I'ay couru tous les litix d’aſſemblée, & d'etat, où nois deliberous des afraires d’Eſtat.	Ayant à te parler, d'unt course inutlle l'ai fait en un moment tous les coint de la ville, J'ai couru tous les litix d'assemblée, et d'état, où nois délibérous des afraires d'État.
Enfin, n’eſperans plus d’auoir de tes nounelles, Par bon-heur, j'ay trouué lane des Eſcroijelles, La veufue du Boiteux qu’on pendit à Burgos.	Enfin, n'espérants plus d'avoir de tes nouvelles, Par bonheur, j'ai trouvé lane des Écroijelles, La veuve du Boiteux qu'on pendit à Burgos.
ZAMORIN.	ZAMORIN.
Celuy qui t’accuſa du vol de deux cheuaux?	Celui qui t'accusa du vol de deux chevaux?
LA TAILLADE.	LA TAILLADE.
Le meſme.	Le même.
Tu ſçais bien comme la vieille eauſe, Elle m'a dit ta priſe, & m’en a dit la cauſe;	Tu sais bien comme la vieille eauze, Elle m'a dit ta prise, et m'en a dit la cause;
Et moy, ſans peruie temps, ie te ſuis venu voir.	Et moi, sans pervie temps, Seigneur te suis venu voir.
Enragé que ce ſoit en ce hydeux manoir;	Enragé que ce soit en ce hideux manoir;
Auius nen faut ſortir.	Avius nen faut sortir.
Comme elle eſt?	Comme elle est?
ZAMORIN.	ZAMORIN.
T’a-t'elle dit l’affaire	T'a-t'-elle dit l'affaire
LA TAILLADE.	LA TAILLADE.
Ie ne ſçay.	Je ne sais.
Ie la trouue peu claire Comme elle la raconte.	Je la trouve peu claire Comme elle la raconte.
ZAMORIN.	ZAMORIN.
Vn certain Eſcolier, Galantizoit la ſœur de certain Caualier.	Un certain Escolier, Galantizait la sœur de certain Avalier.
Ce certain Caualier, nous ayant bien ait boire Et bien payez auſſi, pendant vne nuit noire, Nous poſta cinq Bretteurs, pour reduire à neant, En pur aſſaſſinat ce braue ſtudiant.	Ce certain Cavalier, nous ayant bien ait boire Et bien payés aussi, pendant une nuit noire, Nous posta cinq Bretteurs, pour réduire à néant, En pur assassinat ce brave studiant.
Ce braue ſtudiant n’eſtoit pas vne poulle.	Ce brave studiant n'était pas une poulle.
Cinq nous l’attaquons ſeul;	Cinq nous l'attaquons seul;
ſeul, il nous bat en foule Et donne au Caualier d’abord entre œil & bat, De ces coups qu’entre nous on nomme échec & mat.	seul, il nous bat en foule Et donne au Cavalier d'abord entre œil et bat, De ces coups qu'entre nous on nomme échec et mat.
Le Bourgeois s'accumule, & la Iuſfice arriue, On m’atrappe, on m’arreſte, on demande qui viue, Ie ne dis pas le mot, on me met en prifon, Où j'ay touliours dit non, ainſi que de raiſon.	Le Bourgeois s'accumule, et la Jusfice arrive, On m'atrape, on m'arrête, on demande qui vive, Je ne dis pas le mot, on me met en prison, Où j'ai toulivours dit non, ainsi que de raison.
On fait courir de nous vn bruit ſourd de Galere:	On fait courir de nous un bruit sourd de Galère:
Grace à Dieu, ie ne ſuis ny traiſtre ny fauſſaire.	Grâce à Dieu, ie ne suis ni traître ni faussaire.
Si l'on veut que ie rame, & bien ie rameray, I'y ſuis Maiſtre paſſé:	Si l'on veut que ici rame, et bien ie rameray, J'y suis Maître passé:
Mais ie me vangeray, Et certains happechairs en auront dans leurs pances.	Mais ie me vengerai, Et certains hapechairs en auront dans leurs panées.
CA TAILLADE.	CA TAILLADE.
Cher zamorin il faut pardonner ſes offences,	Cher zamorin il faut pardonner ses offensés,
ZAMORIN.	ZAMORIN.
Et quand tu m'as cherché, Que voulois-tu de moy!	Et quand tu m'as cherché, Que voulais-tu de moi!
LA TAILLADE.	LA TAILLADE.
Te mettre d’vn marché Pour ſequer, j'ay touciie iiune eſcus à bon compte.	Te mettre d'un marché Pour sequer, j'ai touciie jiune écus à bon compte.
ZAMORIN.	ZAMORIN.
Eſt-ce affaire de ſang	Est-ce affaire de sang
LA TAILLADE.	LA TAILLADE.
C’eſt pour urer vn Comte, Le meſme qui te tient ſi bien empriſonné, Et l’on luy fait le tour pour vn ſoufflet donné.	C'est pour urer un Comte, Le même qui te tient si bien emprisonné, Et l'on était fait le tour pour un soufflet donné.
Vn cartel de deffy vers le ſoir nous l’amene Au bout du Pout, ou l'eau nous tirera de peine D’enſeuelir le corps.	Un cartel de défi vers le soir nous l'amène Au bout du Pout, ou l'eau nous tirera de peine D'ensévelir le corps.
ZAMORIN.	ZAMORIN.
Vous faites bon marché, Supprimer vn Seigneur pour ſi peu c’eſt peché.	Vous faites bon marché, Supprimer un Seigneur pour si peu c'est péché.
LA TAILLADE.	LA TAILLADE.
Il n'y faut plus ſonger, c’eſt vne affaire faite.	Il n'y faut plus songer, c'est une affaire faite.
LAMORIN.	LAMORIN.
Qui ſeront les Acteurs.	Qui seront les Acteurs.
LA TAILLADE.	LA TAILLADE.
Le Seuillan, & moy.	Le Seuillan, et moi.
Le Gaucher, la Cliquette,	Le Gaucher, la Cliquette,
LAMORIN.	LAMORIN.
Vos armes?	Vos armes?
LA TAILLADE.	LA TAILLADE.
Sont à feu.	Sont à feu.
ZAMORIN.	ZAMORIN.
L'eſpée & le poignard aſieurent mieux vn jeu.	L'épée et le poignard asieurent mieux un jeu.
A TAILLADE.	À TAILLADE.
Nous auroús l'vn & l’autre.	Nous auroùs l'une et l'autre.
ZAMORIN.	ZAMORIN.
Ha par ma foy j’enrage De n’en pouuoir pas eſtre, & de me voir en cage.	Ha par ma foi j'enrage De n'en pouvoir pas être, et de me voir en cage.
LA TAILLADE.	LA TAILLADE.
Tu n’y vieilliras pas.	Tu n'y vieilliras pas.
ZAMORIN.	ZAMORIN.
Qui m'en empeſchera?	Qui m'en empêchera?
LA TAILLADE.	LA TAILLADE.
De ber aigeue de Dicu que n raillade auraSeul ie touche deux pars, eſcoure.	De ber aigève de Dicu que n' aillade auraSeul apprendre touche deux pars, écoure.
SCANE IV.	SACNE IV.
VN PREVOST.	UN PRÉVÔT.
DOM PIDRE.	DOM PIDRE.
ZAMORIN.	ZAMORIN.
LE PREVOST.	LE PRÉVÔT.
Que l'on ſorte.	Que l'on sorte.
Demeurez Zamorin;	Demeurez Zamorin;
& pouſiez cette porte.	et pousiez cette porte.
DOM PEDRE.	DOM PÉDRE.
On m'impute la mort d'vn certain Dom Louis, Dont le luis deiciaige par les ceſmoins ouis.	On m'impute la mort d'un certain Dom Louis, Dont le luis deiciaige par les cesmoins ouïs.
Vn Seigneur Zamorin, vn braue à toute outrance;	Un Seigneur Zamorin, un brave à toute outrance;
Ne m’ira pas charger contre ſa conſcience, Et ne voudra iamais à mes deſpens mentir, Quand meſme pour cela l'on le feroit ſortir.	Ne contre sa pas charger contre sa conscience, Et ne voudra iamais à mes dépends mentira Quand mes dépens cela l' mentira pas feroit sortir.
LE PREVOST.	LE PRÉVÔT.
Dires la verité, Zamorin.	Dires la vérité, Zamorin.
2.	2.
ZAMORIN.	ZAMORIN.
Dieu me garde De la cacher iamais:	Dieu me garde De la cacher jamais:
Tant plus ie le regarde;	Tant plus grands le regarde;
C’eſt pourtant l'eſcolier ie le reconnois bien) Le coupable, & Monſieur ne reſſemblent en rien, Celuy dont vous parlez, eſtoit rouge en vifage, Plus petit que Monſieur, & plus gros de corſage:	C'est pourtant l'écolier Seigneur le reconnais bien) Le coupable, et Monsieur ne ressemblent en rien, Celui dont vous parlez, était rouge en visage, Plus petit que Monsieur, et plus gros de corsage:
Il eſtoit gras à lard, dans ſa taille engoncé, Des jamibes, il faiſoit vn Igrec renuersé:	Il était gras à lard, dans sa taille engoncé, Des jamibes, il faisait un Igrec renversé:
Car Il eſtoit cagneux aſin que ie m’explique;	Car Il était cagneux asin que Ne m'explique;
Et Monſieur eſt bien fait, & droit comme vne pique, Ma depoſition ſeulé en vaut plus d’vn cent.	Et Monsieur est bien fait, et droit comme une pique, Ma déposition seulé en vaut plus d'un cent.
DOM PEDRE.	DOM PÉDRE.
Ie vous laiſſe à iuger ſi ie ſuis innocent.	Je vous laisse à juger si ici suis innocent.
ZAMORIN.	ZAMORIN.
Ie vous le maintien tel, au peril de ma vie.	Je vous le maintien tel, au péril de ma vie.
LE PRÉVOST, Sa depoſition ayde fort à l'enuie Que j’ay de vous ſeruir.	LE PRVOST, Sa déposition aide fort à l'envie Que j'ai de vous servir.
DOM PEDRE.	DOM PÉDRE.
Ie me reuancheray.	Je me revancherai.
De l’obligation.	De l'obligation.
LE PREVOST.	LE PRÉVÔT.
Meſme ſans caution On vous peut eſlargir dés auſſi-toſt qu’au Comte Des informations on aura rendu compte.	Même sans caution On vous peut élargir dès aussitôt qu'au Comte Des informations on aura rendu compte.
Vous n’eſtes ny connu, ny chargé des teſmoins:	Vous n'êtes ici connu, ni chargé des témoins:
Saus Vnl pius ioit muice, eu ne peut faire moins Que de vous laiſſer libre :	Saus Un pius joit muice, eu ne peut faire moins Que de vous laisser libre :
en tout cas cette affaire Iroit à quelques frais, qu’il faudroit encor faire.	en tout cas cette affaire Jroit à quelques frais, qu'il faudrait encor faire.
Ie ne dis pas pour moy, qui n’aime pas le bien:	Je ne dis pas pour moi, qui n'aime pas le bien:
Mais vous ſçauez, Mõſieur, qu’õ ne fait rien pour rien, Le Preuoſt s’en va.	Mais vous savez, Monsieur, qu'on ne fait rien pour rien, Le Prévôt s'en va.
DOM PEDRE.	DOM PÉDRE.
Mon braue, ie vous ſuis tout à fait redeuable.	Mon brave, Seigneur vous suis tout à fait redevable.
ZAMORIN, Des hommes ie ſerois le plus abominable, ut plre qu’vn poltron enté ſur vn voleur, Si ie n’auois ſeruy voſtre rare valeur.	ZAMORIN, Des hommes ie serois le plus abominable, ut plre qu'un poltron enté sur un voleur, Si jus n'avais servi votre rare valeur.
.	.
Ie vous ay veu de prés, & n'ay veu de ma vie Homme, dont la valeur m’ait donné plus d’enuie.	Je vous ai vu de près, et n'ai vu de ma vie Homme, dont la valeur m'ait donné plus d'envie.
Et meſme ait donné plus à la mſenne à ſonger.	Et même ait donné plus à la msenne à songer.
Au reſte vous ſçaurez que le Comte eſtranger Qui vous retient icy, vous payera la dette.	Au reste vous saurez que le Comte étranger Qui vous retient ici, vous payera la dette.
DOM PEDRE.	DOM PÉDRE.
Qu'entendez-vous par-la?	Qu'entendez-vous par-la?
ZAMORIN Que ſon affaire eſt faite.	ZAMORIN Que son affaire est faite.
Quelques braues,tous gens de parole & d’effet, Tantoſt auprés du Pont luy donneront ſon fait.	Quelques braves,tous gens de parole et d'effet, Tantôt auprès du Pont était donneront son fait.
Vn Seigneur de la Cour, pourueu que l’on l’aſſomme, Leur doit payer content vne notable ſomme.	Un Seigneur de la Cour, pourvu que l'on l'assomme, Leur doit payer content une notable somme.
Vn cartel ſuposé ſaniene au rendez-vous, Où leurs bras agiront & pour eux, & pour vous.	Un cartel suposé sanène au rendez-vous, Où leurs bras agiront et pour eux, et pour vous.
DON PEDRE.	DON PÉDRE.
Ie vous ſuis oblige d'vne tene nouuelle.	Je vous suis oblige d'une tene nouvelle.
At ſalete ZAMORIN.	At saleté ZAMORIN.
DOM PEDRE.	DOM PÉDRE.
Vous verrez, comme ie ſuis fidelle.	Vous verrez, comme personne suis fidèle.
CENE V.	CÈNE V.
CRISPIN, DOM PEDRE.	CRISPIN, DOM PEDRE.
CRISPIN.	CRISPIN.
E Soleil eclipsé ſous vn ſombre broüillas, Ou bien ſi vous voulez, ſous vn noir taffetas, Demande à vous parler.	E Soleil eclipsé sous un sombre brouillas, Ou bien si vous voulez, sous un noir taffetas, Demande à vous parler.
DOM TEDRE.	DOM TÉDRE.
A Que dis-tu?	A Que dis-tu?
CRISPIN Qu'vne femme Dont la mite à mon ſens eſt plus d’vne grand Dame Que d’vn moulin à vent, demande à vous parler.	CRISPIN Qu'une femme Dont la mite à mon sens est plus d'une grand Dame Que d' moulin à vent, demande à vous parler.
DOM PEDRE, Elle prend mal ſon temps, & peut bien s’en aller	DOM PEDRE, Elle prend mal son temps, et peut bien s'en aller
CRISPIN.	CRISPIN.
flle n'en fera rien:	flle n'en fera rien:
car elle eſt reſoluë De vous voir, ex deuſt elle eſtre icy retenuë.	car elle est résolue De vous voir, ex dût -elle être ici retenue.
DOM PEDRE.	DOM PÉDRE.
R ſuis bien eſloigné de fonger à l’amour.	R suis bien éloigné de songer à l'amour.
Mais la voicy qui vient.	Mais la voici qui vient.
Mon braue au premier iour?	Mon brave au premier jour?
Nous nous reuancherons.	Nous nous revancherons.
ZAMORII Briſons-lâ, ſe vous prie;	ZAMORII Brisons-lât, se vous prie;
Ie voudrois faire plus pour voſtre Seigneurie.	Je voudrais faire plus pour votre Seigneurie.
DOM PEDRE.	DOM PÉDRE.
Madame, l’on m’a dibque vous me demandiez.	Madame, l'on m'a dibque vous me demandiez.
CENDVI.	CENDVI.
, CASSANDRE.	, CASANDRE.
DOM PEDRE.	DOM PÉDRE.
CRISPIN.	CRISPIN.
CASSANDRE.	CASSANDRE.
y braue Caualier, ſçachant qui vous eſtiez, Sçachant voſtre priſon, & que voſtre nobleſſe Eſt riche de merite, At raanque de richeſſe, Ie vous en vien offrir:	y brave Cavalier, sachant qui vous étiez, Sachant votre prison, et que votre noblesse Est riche de mérite, At raque de richesse, Je vous en vien offrir:
Mais à conditign Que ſans vous infumner de ma çondition, -La 513 Sans touloir per mon nom connoiſtre ma perſonne, Vousmoſpauier oungir dece que ie vous donne.	Mais à conditign Que sans vous infumner de ma çondition, -La 513 Sans touloir per mon nom connoistre ma personne, Vousmospauier oungir dece que ie vous donne.
Quand le Ciel m'auroit fait d'humeur à receuoir, Ie ne puis acœpor voſtre offre ſans vous voir, Ny vous en ſçauoir gré deuant que vous conneſtre.	Quand le Ciel m'aurait fait d'humeur à recevoir, Je ne puis acpor votre offre sans vous voir, Ni vous en savoir gré devant que vous connaître.
Ie crains le nom d’ingoit, ie croirois dofia l'ęſtre:	Je crains le nom d'ingait, je croirais dosia l'HÊtre:
Acceptant vn bitn fat nont j’ignore l'autheur.	Acceptant un bitn fat nont j'ignore l'auteur.
M’iray-je faire ingrar de gayeté de cœur?	M'irai-je faire ingrar de gaieté de cœur?
CASSANDRE.	CASSANDRE.
Voſtre raiſonnement mes bons deſſeins élude.	Votre raisonnement mes bons desseins élude.
Et I'eſprit y paroiſt plus que la gratituds.	Et J'esprit y paraît plus que la grattituds.
Ie ſors d’auprés de vous le viſage confus:	Je sors d'auprès de vous le visage confus:
Car ie ne penſois pas y trouuer vn refus.	Car ie ne pensais pas y trouver un refus.
& que ie vous offrois, & qui n’a pd̀ vous plaire Me couſtoit mille fois plus à dire qu'à faire:	et que ici vous offrais, et qui n'a pd̀ vous plaire Me coûtait mille fois plus à dire qu'à faire:
Peut-eſtre en l'acceptant, euſſiez-vous obtenu;	Peut-être en l'acceptant, eussiez-vous obtenu;
De ſçauoir, vn ſecret qui vous eſt inconnu.	De sçauoir, un secret qui vous est inconnu.
Et qui vous preparoit vne bonne fortune:	Et qui vous préparait une bonne fortune:
Mais ie ne ſonge pas que ie vous importune.	Mais ici ne songe pas que ici vous importune.
DOM PEDRE.	DOM PÉDRE.
Madaine, le voy bien qu'il vous faut obeyr:	Madaine, le vois bien qu'il vous faut obéir:
Mais ſouhaiter vous voir, eſt-ce ſe faire hayr?	Mais souhaiter vous voir, est-ce se faire haïr?
Et ſans vous offencer.	Et sans vous offenser.
CASSANDRE.	CASSANDRE.
Vous tentez l’impoſſible.	Vous tentez l'impossible.
Ie ne ſçaurois vous voir, Fans lous eſtte inuiſible.	Je ne saurais vous voir, Fans lou te invisible.
Ou bien vous vous tiendrez à mes conditions, Oune.	Ou bien vous vous tiendrez à mes conditions, Oune.
Eut pant bal.	Eût pant bal.
.	.
CRISPIN.	CRISPIN.
Vous venez donc, comme des viſions Tenter les priſonniers?	Vous venez donc, comme des visions Tenter les prisonniers?
montre moy ton viſage anee detaneu.	montre moi ton visage ane détanu.
LIZET TE.	LIZET TE.
M Tu cherches ton dommage, Etſt tu m’auois veuë.	M Mu cherches ton dommage, Etst -tu m'avais vue.
CRISPIN.	CRISPIN.
En perdrois-je les yeux?	En perdrais-je les yeux?
E IZETTE.	 EZETTE.
Tu perdrois ta franchiſe.	Tu perdrais ta franchise.
CRISPIN.	CRISPIN.
Et bien voyons, tant mieux.	Et bien voyons, tant mieux.
Mais j’aperçois venir le Diantre qui m’emporte.	Mais j'aperçois venir le Diantre qui m'emporte.
Ha mon cher Maiſtre!	Ha mon cher Maître!
2.	2.
DOM PEDRE.	DOM PÉDRE.
Et bien qu’as-tu?	Et bien qu'as-tu?
CRISPIN.	CRISPIN.
Ie viens de voir le Comte.	Je viens de voir le Comte.
Prés de la porte	Près de la porte
CASSANDRE.	CASSANDRE.
C’eit mon frere.	C'éit mon frère.
Ah mon Dieu!	Ah mon Dieu!
cachez-mof	cachez-mof
D'ÒM PEDRE.	D'ÒM PEDRE.
Et c’eſt vous Madame?	Et c'est vous Madame?
Lizette?	Lisette?
CRISPIN.	CRISPIN.
Et c'eſt donc toy	Et c'est donc toi
DOM PEDRE.	DOM PÉDRE.
Les faiſant cacher.	Les faisant cacher.
Entrez, entrez viſtement,	Entrez, entrez vitement,
TRISPIN.	TRISPIN.
Nous allons voir beau jeu.	Nous allons voir beau jeu.
s'il la veuë	s'il la vue
CENE VII.	CÈNE VII.
LE CONTE.	LE CONTE.
DOM PEDRE.	DOM PÉDRE.
Vous ſurprend.	Vous surprend.
LE CEMTE.	LE CEMTE.
Ma viſite impreueuë	Ma visite impreueuë
DOM PEDRE.	DOM PÉDRE.
Il eſt vray que vous me ſurprenez, vous me ienden vmte;	Il est vrai que vous me surprenez, vous me ienden vite;
e vous m’empriſonnez.	Je vous m'emprisonnez.
Venez-vous emplrer le ſort d’vn miſerable?	Venez-vous emplrer le sort d'un misérable?
Vous repaiſtre les yeux du mal heur qui m’accable?	Vous repaître les yeux du mal heur qui m'accable?
Imtuiter au captif, ſans deffence & ſans mains?	Imtuiter au captif, sans défense et sans mains?
Comte, ces ſentimens ſont bas, ſont inhumains.	Comte, ces sentiments sont bas, sont inhumains.
Et ie vous aurols crû d’ame trop genereuſe Pour vous venger de moy par vne voye honteuſe, De moy;	Et ici vous aurols crus d'âme trop généreux Pour vous venger de moi par une voie honteuse, De moi;
qui me voy pris pour vous auoir cherché.	qui me vois pris pour vous avoir cherché.
LE COMTE.	LE COMTE.
Ceſſez d'expliquer mal ce qui vous eſt caché.	Cessez d'expliquer mal ce qui vous est caché.
Vous ſortirez demain n’ayant point de partie, Et nous nous chercherons apres voſtre ſortie.	Vous sortirez demain n'ayant point de partie, Et nous nous chercherons après votre sortie.
DOM PEDRE.	DOM PÉDRE.
Et qui me fait ſortir?	Et qui me fait sortir?
F iij	 Fij
LE COMTE.	LE COMTE.
Moy, que vous blaſmez tant.	Moi, que vous blâmez tant.
DOM.	DOM.
PEDRE.	PÉDRE.
C’eſt vous qui merendez ce ſeruice important!	C'est vous qui mérendez ce service important!
L E COMTE.	L E COMTE.
C’eſt moymeſme, & qui vien afin que rien n’y mãque, D'affermer qu’vn des miens vous vit à Salamanque, Le iour que Dom Louis fut tué par vos mains.	C'est moymesme, et qui viens afin que rien n'y manque, D'affermer qu'un des miens vous vit à Salamanque, Le jour que Dom Louis fut tué par vos mains.
Ces ſentimens ſont-ils fort bas?	Ces sentiments sont-ils fort bas?
fort inhumains?	fort inhumains?
Et ſçauons-nous auſſi porcet loin la brauoure?	Et sçauons-nous aussi porcet loin la bravoure?
DOM PEDRE.	DOM PÉDRE.
O Dieu!	Ô Dieu!
ſera-ce à moy d'auoir touſiours à coure:	sera-ce à moi d'avoir toujours à coure:
Illo fi Mesennemy que j’ayme, & qu’il faudra pourtant Que ie perde, ou perinmoy-meſme en combatant, Si vous me deliurez;	Illo fi Mesennemi que j'aime, et qu'il faudra pourtant Que été perde, ou permoi-même en combattant, Si vous me délivrez;
eſt-ce qu'il vous importe Que ce ſoit toute à l’heure, ou demain que ie ſorte?	est-ce qu'il vous importe Que ce soit toute à l'heure, ou demain que personne sorte?
LE COMTE.	LE COMTE.
Il m'importeroit peu que ce fuſt à l'inſtant, Si ce n'eſt qu'à mà gloire, il eſt fort important Quand vous ſerez ſorti, de vous chercher moy meſme.	Il m'importerait peu que ce fût à l'instant, Si ce n'est qu'à mà gloire, il est fort important Quand vous serez sorti, de vous chercher moi -même.
Et cependant il faut par vn mal-heur extréme, Que le reſte du iour, quand vous me chercheriez Ie me cache, où iamais vous ne me trouueriez.	Et cependant il faut par un malheur extrême, Que le reste du jour, quand vous me chercheriez Je me cache, où jamais vous ne me trouveriez.
Quelle haſte auez-vous de ſortir toute à l'heure?	Quelle hâte avez-vous de sortir toute à l'heure?
Attendes à demain.	Attendes à demain.
DOM PEDRE.	DOM PÉDRE.
Il m’importe, ou ie meure.	Il m'importe, ou ainsi meure.
LE COMTE.	LE COMTE.
Paiſons donc quelque tréue?	Paisons donc quelque trêve?
U.	V.
.	.
?	?
DOM.	DOM.
PEDRE.	PÉDRE.
Ouy, donnez-noy la maint Mais à condition qu’elle finit demain.	Oui, donnez-noi la maint Mais à condition qu'elle finit demain.
L.	L.
E COMLE.	E COMLE.
Nfaut, querelle à part, que de mes bras j’embraſſ.	Naut, querelle à part, que de mes bras j'embrass.
Mon plus grand ennemy.	Mon plus grand ennemi.
DOM PEDRE.	DOM PÉDRE.
Quelle eſtrange diſgrate!	Quelle étrange disgrâte!
Faut-il en meſme temps, vous aimer, vous hayrt mais idonfees	Faut-il en même temps, vous aimer, vous haïrt mais idonfées
CCENE VIII.	CCENE VIII.
DOM FELIX.	DOM FELIX.
DOM PEDRE.	DOM PÉDRE.
LE COMTE.	LE COMTE.
DOM- EELIX.	DOM- ÉÉLIX.
Ouy mon fils, c’eſt fort bien m’obeyr, C’eſt oroire les conſeils d'vn Pere, c’eſt les ſuiure;	Oui mon fils, c'est fort bien m'obéir, C'est oroire les conseils d'un Père, c'est les suivre;
Fils ingrat, fils poltron, fils indigne de viure.	Fils ingrat, fils poltron, fils indigne de vivre.
Tu venges donc ainſi ton honneur offencé?	Tu venges donc ainsi ton honneur offensé?
Et ſatisfais ainſi ton Pere couroucé?	Et satisfais ainsi ton Père couroucé?
Tu te ſouuiens ainſi de ta ſœur ſubornée?	Tu te souviens ainsi de ta sœur subornée?
Et tu gardes ainſi ta parole donnée!	Et tu gardes ainsi ta parole donnée!
Toy qui la ſçais garder ſi rigoureuſement, Que tu fais moins d’eſtat de moy que d’vn ſerment.	Toi qui la sais garder si rigoureusement, Que tu fais moins d'état de moi que d'un serment.
Et ne m’auois-tu pas engagé ta parole, De venger mon lonneur ſur celuy qui le volé?	Et ne m'avais-tu pas engagé ta parole, De venger mon lonneur sur celui qui le volé?
Et par ces meſmes bras dont tu l’as embraſſé Que ie verrois ſon corps de mille coups percé?	Et par ces mêmes bras dont tu l'as embrassé Que tu verrais son corps de mille coups percé?
S’il auoit eu des miens vne pareille eſtreinte, Encor que leur vigueur ſoit deſia preſque eſteinte, Ils auroient deſchiré ſon cœur en vn inſtant, Et frie t'embraſſois, ils t'en ſeroient aurant.	S'il avait eu des miens avoir pareille étreinte, Encor que leur vigueur soit déjà presque éteinte, Ils auraient déchiré son cœur en un instant, Et frie t'embrassais, ils t'en seraient aurant.
Peus-tu bien ſans pleurer, me voir pleurer infame.	Peus-tu bien sans pleurer, me voir pleurer infâme.
Voy, voy couler mes pleurs, c’eſt le ſang de mõ ame.	Vois, vois couler mes pleurs, c'est le sang de mon âme.
Au peril d’eſpuiſer mon corps de tout le ſien, Ie reſpandray celuy qui fait glacer le tien.	Au péril d'épuiser mon corps de tout le sien, Je répandrai celui qui fait glacer le tien.
Mais laiſſons-là ce fils, qui faiſoit tant le braue, Qui fait aux yeux d'vn Pere vne action d’eſclaue.	Mais laissons-là ce fils, qui faisait tant le brave, Qui fait aux yeux d'un Père une action d'esclaue.
Ce mal-heureux verra ſon vieil Pere aujourd'huy Vaincre, ou mourir pluſtoſt, que viure comme luy.	Ce malheureux verra son vieil Père aujourd'hui Vaincre, ou mourir plutôt, que vivre comme lui.
Tu te ris inſolent de ma vaine menace;	Tu te ris insolent de ma vaine menace;
Mais mes ans ont encor du feu parmy leur glace:	Mais mes ans ont encor du feu parmi leur glace:
L'inſolence eſt ſouuent reduite à ſuplier.	L'insolence est souvent réduite à supplier.
Le bras quiluie ies gadioe peut les humilier.	Le bras quiluie jes gadioe peut les humilier.
Tien-toy bien.	Tient-toi bien.
LE COMTE.	LE COMTE.
Vous auez vn Pere fort colere:	Vous avez un Père fort colère:
DOM TPEDRE.	DOM TPEDRE.
Comte, n’en parlons polnt;	Comte, n'en parlons polnt;
car enfin, c’eſt mon Pere.	car enfin, c'est mon Père.
A bien conſiderer combien vous l’offencez.	À bien considérer combien vous l'offensez.
Et qu’il nous a trouuez toute à lheure embiaſſez, Mettez-vous dans ſa place;	Et qu'il nous a trouvez toute à lheure embiassez, Mettez-vous dans sa place;
eſt-il homme ſi ſage, Oſfencé comme il eſt par vn dernier outrage, Qui ne ſuiue d’abord ſon premier mouuement, Et qui ne m’euſt traité comme luy rudement?	est-il homme si sage, Osfencé comme il est par un dernier outrage, Qui ne suive d'abord son premier mouvement, Et qui ne m'eût traité comme tu rudement?
LE COMTE.	LE COMTE.
E euraoucjauieumous nous verrons peut-eſtre Demain;	 euraoucjauieumous nous verrons peut-être Demain;
Mais d’aujourd’huy, ie ne ſçaurois pareſtre Ayant à m’occuper iuſqu’au ſoir.	Mais d'aujourd'hui, je ne saurais paraître Ayant à m'occuper jusqu'au soir.
DOMTEDRE.	DOMTEDRE.
Bien-toſt où vous ſerez.	Bientôt où vous serez.
Ie ſçauray	Je saurai
LE COMTE.	LE COMTE.
Du ſoin de me chercher.	Du soin de me chercher.
Ie vous exempteray	Je vous exempterai
SCENE IX.	SCÈNE IX.
LE PREVOST.	LE PRÉVÔT.
LE COMTE.	LE COMTE.
DOM PEDRE.	DOM PÉDRE.
LE PREVO Monſieur, à la Requeſte Da Seigneur Dom Felix, auec regret j’arraſte Vn homme comme vous.	LE PREUO Monsieur, à la Requête Da Seigneur Dom Félix, avec regret j'arraste Un homme comme vous.
Et pourquoy?	Et pourquoi?
LE COMTE.	LE COMTE.
Moy!	Moi!
m’arreſter!	m'arrêter!
comment?	comment?
CE PREVOST.	CE PRÉVÔT.
C’eſt, Monſieur, pour vn enleuement.	C'est, Monsieur, pour un enlèvement.
DOM PEDRE.	DOM PÉDRE.
I'en ay de deſplaiſir plus que vous l’ame atteinte:	J'en ai dé plaisir plus que vous l'âme atteinte:
Mais comment a-t’il pû faire ſi-toſt ſa plainte?	Mais comment a-t-il pu faire sitôt sa plainte?
LE PREVOST.	LE PRÉVÔT.
Deuant que de venir il auoit obtenu Le decret.	Devant que de venir il avait obtenu Le décret.
Vous icauez, a quoy ie ſuis tenu :	Vous icavez, a quoi Je suis tenu :
Si d’ailleurs ie pouuois par quelque bon office Qui dependiſt de moy, vous rendre du ſeruice, Denus inoy vous auez vn abſolu pouuoir.	Si d'ailleurs ie pouvais par quelque bon office Qui dépendît de moi, vous rendre du service, Denus inoi vous avez un absolu pouvoir.
LE COMTE.	LE COMTE.
Monſieur, vous auez fait en tout voſtre deuoir, Laiſſez-nous icy ſeuls, & qu’on ſçache à la porte Quy io n'empeiche poniit que Dom Pedre ne ſorte.	Monsieur, vous avez fait en tout votre devoir, Laissez-nous ici seuls, et qu'on sache à la porte Qui jo n'empeiche poniit que Dom Pedre ne sorte.
REVOST.	REUOST.
L'ordre eſt deſia donné.	L'ordre est déjà donné.
LE COMTE.	LE COMTE.
Le Preuoſt s'en va.	Le Prévôt s'en va.
Laiſſez-nous donc icy.	Laissez-nous donc ici.
DOM PEDRE.	DOM PÉDRE.
Ie ſuis faſché de voir que l'on vous braite ainſi:	Je suis fâché de voir que l'on vous braite ainsi:
Mais fiez-vous en moy;	Mais fiez-vous en moi;
ie vous donne parole, De vous faire paſſer au trauers de là geole Sans que d’aucun Geolier vous ſoyez arreſté.	On vous donne parole, De vous faire passer au travers de là geôle Sans que d'aucun Geolier vous soyez arrêté.
LE COMTE.	LE COMTE.
Ie me croirois par vous comme reſſuſcité:	Je me croirais par vous comme ressuscité:
Car enfin, ie me meurs de regret & de honte;	Car enfin, Seigneur me meurs de regret et de honte;
De ce qu’on peut penſer que ie fais peu de compte De garder ma parole, alors que j’ay promis, Moy, qui la ſtay garder meſme à mes ennemis.	De ce qu'on peut penser que je fais peu de compte De garder ma parole, alors que j'ai promis, Moi, qui la stai garder même à mes ennemis.
Ie me bats aujourd'huy, puis qu'il vous faut tout dire, Et dans vne heure ou deux, tout au plus tard expire Le temps que ie me dois trouuer au rendez-vous:	Je me bats aujourd'hui, puis qu'il vous faut tout dire, Et dans une heure ou deux, tout au plus tard expire Le temps que je me dois trouver au rendez-vous:
I'y manque, on m’empriſonne, & tout cela pour vous.	J'y manque, on m'emprisonne, et tout cela pour vous.
Mais quel pouuon, Domr eure, auez-vous ſur la porte.	Mais quel pouuon, Domr eure, avez-vous sur la porte.
DOM PEDRE.	DOM PÉDRE.
Pourueu que vous ſortiez, Comte, que vous importe Comment vous ſortirez.	Pourvu que vous sortiez, Comte, que vous importe Comment vous sortirez.
Ie vous feray ſortir;	Je vous ferai sortir;
Mais à condition, de ne ſe départir D vn ordre tres expre¬, qu’il faut que ie vous donne.	Mais à condition, de ne se départir D un ordre très expreche, qu'il faut que je vous donne.
LE COMTÉ.	LE COMTE.
Ie ne manquay iamais de parole à perſonne.	Je ne manquai jamais de parole à personne.
DOM PEDRE.	DOM PÉDRE.
Ie ſçauray bien d’ailleurs prendre mes ſeuretez.	Je saurai bien d'ailleurs prendre mes sûretés.
venes.	venes.
LE COMTE.	LE COMTE.
Iuſques icy, nos generoſitez Ont fait tous nos combats.	Jusqu' ici, nos générosités Ont fait tous nos combats.
DOM PEDRE.	DOM PÉDRE.
Bien-toſt par vn duël.	Bientôt par un duel.
Il faut qu’elles finiſſent	Il faut qu'elles finissent
LE COMTE.	LE COMTE.
Ce ſera par la paix Si mes vœux s’accompliſſent	Ce sera par la paix Si mes vœux s'accomplissent
DOM PEDRE.	DOM PÉDRE.
Nous le ſçaurons demainSi nous nous voyons ſeuls, & le fer à la main.	Nous le saurons demainS nous nous voyons seuls, et le fer à la main.
SCENE I.	SCÈNE I.
CRISPIN.	CRISPIN.
DOM PEDRE.	DOM PÉDRE.
CRISPIN.	CRISPIN.
A peſte, mon Patron, & que vous en ſçauez.	À peste, mon Patron, et que vous en Savez.
Et quel homme eltes-vous,qui ſi bien les ſauuez?	Et quel homme elletes-vous,qui si bien les sauvez?
Qui ſi bien les priſons fourbez à la ſourdine.	Qui si bien les prisons fourbez à la sourdine.
Voſtre eſprit en Içait plus, que n’en dit voſtre mine.	Votre esprit en Içait plus, que n'en dit votre mine.
D’OM PEDRE.	D'OM PÉDRE.
N’ay-je pas fait ſortir le Comte adroitement.	N'ai-je pas fait sortir le Comte adroitement.
CRISPIN.	CRISPIN.
Sa ſœur n’a-t'elle pas tremblé cruellement, Voyant à ſes talons ſor:	Sa sœur n'a-t'-elle pas tremblé cruellement, Voyant à ses talons sot:
frere & non Lizette?	frère et non Lizette?
Elle aura bien peſté contre vous, la coquette.	Elle aura bien pesté contre vous, la coquette.
Tay toy fat.	Tais -toi fat.
DOM PEDRE.	DOM PÉDRE.
CRISPIR.	CRISPIR.
Cegrand Comte en femme traueſty, Auoit plus peur que vous, alors qu’il eſt ſorty.	Cegrand Comte en femme trauesty, Avait plus peur que vous, alors qu'il est sorti.
Deſguisé d'vne robe, & couuert d'vne mante, il ſentoit ſon fantoſme, & non pas ſa ſeruante.	Déguisé d'une robe, et couvert d'une mante, il sent son fantôme, et non pas sa servante.
Au reſte il cheminoit ſi maſculinement, Que ie me diuertis d'y ſonger ſeulement.	Au reste il cheminait si masculinement, Que je me divertis d'y songer seulement.
Mais hazarder ainſi ſa ſœur ſur ſa parole C'eſt, ne vous en déplaiſe, vne action tres folle;	Mais hasarder ainsi sa sœur sur sa parole C'est, ne vous en déplaise, une action très folle;
Car enfin, par harard, par curioſité, Oucomme vous voudrez, ce miſtere eſuenté, C’eſtoit à vous à courre, & cette pauure fille Tomboit de mal en pis, alloit de cage en grille, Eſtoit au moins razée, & par prouiſion, Son beau teint receuoit quelque contuſion.	Car enfin, par harard, par curiosité, Oucomme vous voudrez, ce mystère éventé, C'était à vous à courre, et cette pauvre fille Tombait de mal en pis, allait de cage en grille, Était au moins rasée, et par provision, Son beau te recevait quelque contusion.
DOM PEDRE.	DOM PÉDRE.
Auſſi ne m'y ſiant que de la bonne ſorte, N’as-tu pas remarqué qu’au ſortir de la porte Ie fay touſiours ſuiuy, iuſqu’à tant que ſa ſœur Se ſeparant de luy, ſe ſoit miſe en lieu ſeur.	Aussi ne m'y siant que de la bonne sorte, N'as-tu pas remarqué qu'au sortir de la porte Je fais toujours suivi, jusqu'à tant que sa sœur Se séparant de lui, se soit mise en lieu sûr.
CRISPIN.	CRISPIN.
La pauurette pour vous de la ſorte engagée De ce bon tour d’amy vous eſt fort obligée:	La pauvrette pour vous de la sorte engagée De ce bon tour d'ami vous est fort obligée:
Mais auoüez, Monſieur, que vous ne l’auez fait, Que pour paſſer par tout pour Caualier parfait, Que pour paſſer par tout pour Oreſte, ou Pilade:	Mais auoüez, Monsieur, que vous ne l'avez fait, Que pour passer par tout pour Cavalier parfait, Que pour passer par tout pour Oreste, ou Pilade:
Et tout cela Monſieur, qu’eſt-ce?	Et tout cela Monsieur, qu'est-ce?
fanfaronade.	fanfaronade.
Et Lizette en priſon?	Et Lisette en prison?
DOM PEDRE.	DOM PÉDRE.
On l'a deliurera, Auecque de l’argent le pluſtoſt qu’on pourra.	On l'a délivrera, Avecque de l'argent le plustost qu'on pourra.
CRISPIN.	CRISPIN.
Et ſi l'on la demande?	Et si l'on la demande?
DOM PEDRE.	DOM PÉDRE.
Elle eſt à la campagne	Elle est à la campagne
CRISPIN.	CRISPIN.
Ma foy, vous eſtes fourbe,& le plus grand d'Eſpagne.	Ma foi, vous êtes fourbe,et le plus grand d'Espagne.
Mais jay bien d'aedes ionis que vos folles amours, Et qui me touchent plus;	Mais jay bien d'aèdes ionis que vos folles amours, Et qui me touchent plus;
changeons donc de diſcours.	changeons donc de discours.
A quoy bon, cher Monſieur, ce mortel équipage?	À quoi bon, cher Monsieur, ce mortel équipage?
A quoy ce piſtolet inſtrument de carnage?	À quoi ce pistolet instrument de carnage?
A quoy bon ce poignard;	À quoi bon ce poignard;
cette eſpée?	cette épée?
& pourquoy, Tant de fer, & vouloir que j’en prenne auſſi, moy.	et pourquoi, Tant de fer, et vouloir que j'en prenne aussi, moi.
DOM PEDRE.	DOM PÉDRE.
Ie te mene à la gloire:	Je te mène à la gloire:
CRISPIN.	CRISPIN.
Ah, ie m'apellegloire, Ie ne tachay iamais d'auoir place en l'hiſtoire.	Ah, Seigneur m'appellegloire, Je ne tachai jamais d'avoir place en l'histoire.
Vous n'eſtes pas pluſtoſt deliuré de priſon, Que comme vn furieux, vn homme ſans raiſon.	Vous n'êtes pas plustost délivré de prison, Que comme un furieux, un homme sans raison.
Au ſortir d'vn mal-heur vous entrez dans vn autre.	Au sortir d'un malheur vous entrez dans un autre.
Ie ne voy point d’eſprit baſty comme le voſtre.	Je ne vois point d'esprit bâti comme le vôtre.
DOM PEDRE.	DOM PÉDRE.
Ignorant mon deſſein.	Ignorant mon dessein.
CRISPIN.	CRISPIN.
Ie croy qu’il eſt fort beauVous allez vous baigner?	Je crois qu'il est fort beauUous allez -vous baigner?
ou bien laiſſer dans l’eau Mille ſalles acqueſts que voſtre Seigneurie Aura peut-eſtre faits dans la Conciergerie?	ou bien laisser dans l'eau Mille salles acquêts que votre Seigneurie Aura peut-être faits dans la Conciergerie?
muilez-vous prés du Pont dérober les paſſans?	muilez-vous près du Pont dérober les passants?
Enfin qu'allez-vous faire, homme de peu de ſens?	Enfin qu'allez-vous faire, homme de peu de sens?
DOM PEDRE.	DOM PÉDRE.
Ie me vay battre.	Je me vais battre.
CRISPIN.	CRISPIN.
Et quoy, vous en taltez encore!	Et quoi, vous en taltez encore!
Au nom de Dieu, Monſieur, que vos deſſeins j ignore, Et de grace, eſcoutez quatre mots ſeulement.	Au nom de Dieu, Monsieur, que vos desseins j ignore, Et de grâce, écoutez quatre mots seulement.
On ne nagea iamais plus pitoyablement Que moy, ſi pour cela vous cherchez la riuiere;	On ne nagea jamais plus pitoyablement Que moi, si pour cela vous cherchez la rivière;
Si c’eſt pour le combat, ie recule en arriere, Veus m’auez veu cent fois de vos yeux reculer;	Si c'est pour le combat, ie encule en arrière, Veus m'avez vu cent fois de vos yeux reculer;
Ie pourrois vous ſeruir ſi vous alliez voler;	Je pourrais vous servir si vous alliez voler;
Mais ie ne le croy pas.	Mais ici ne le crois pas.
Permettez-moy, beau Sire, Puiſque vous me ſçauez tres habile homme à nuire, Que ie ſuis trop prudent, & vous trop hazardeux Que ie m'aille ébaudir pour vn quart d’heure ou deux.	Permettez-moi, beau Sire, Puisque vous me savez très habile homme à nuire, Que Que suis trop prudent, et vous trop hasardeux Que tu m'aille ébaudir pour un quart d'heure ou deux.
DOM PEDRE.	DOM PÉDRE.
Ouy iete le permets:	Oui jette le permets:
Mais tantoſt, ie proteſte Si tu dis ou ie ſuis.	Mais tantôt, Seigneur proteste Si tu dis ou je suis.
CRISPIN.	CRISPIN.
Ie me doute du reſte.	Je me doute du reste.
Adieu, Monſieur, adiei.	Adieu, Monsieur, adiei.
DOM PEDRE.	DOM PÉDRE.
Voicy le lieu fatal, Ou j'eſpere acquerir vn honneur ſans égal.	Voici le lieu fatal, Ou j'espère acquérir un honneur sans égal.
Mais quelqu’vn vient icy:	Mais quelqu'amour vient ici:
ce ſont mes hõmes meſmo.	ce sont mes hommes mémo.
Cachons-nous.	Cachons-nous.
E NE II LA TAILLADE.	E NE II LA TAILLADE.
4.	4.
BRAVES.	BRAVES.
LA TAILLADE.	LA TAILLADE.
Grace à Dieu, peu de viſages bleſmes Entre quatre Bretteurs que nous ſommes icy;	Grâce à Dieu, peu de visages blesmes Entre quatre Bretteurs que nous sommes ici;
Mais ils ſont tous choiſis par la Taillade auſſi.	Mais ils sont tous choisis par la Taillade aussi.
Mes braues compagnons, nous deuons rendre compte De cinq cens eſcus d’or, ou de la mort d’vn Comte;	Mes braves compagnons, nous devons rendre compte De cinq cents écus d'or, ou de la mort d'un Comte;
Nous ſommes bien payez ſoyons loyaux Marchans, Ie hay plus que la mort tous les hommes meſchans.	Nous sommes bien payés soyons loyaux Marchants, Je hais plus que la mort tous les hommes méchants.
Si j’eſtois bien payé pour mettre à mort mon frere Ie le ferois mourit ſans faire de miſtere.	Si j'étais bien payé pour mettre à mort mon frère Je le ferais mourit sans faire de mystère.
Amorçons nos fuzils, viſitons nos couſteaux, Et n’allons pas icy, Meſſieurs, faire les veaux:	Amorçons nos fumils, visitons nos coûteaux, Et n'allons pas ici, Messieurs, faire les veaux:
Si nous operons mal, nulle miſericorde;	Si nous opérons mal, nulle miséricorde;
Iy vaue nioue, ou du moms de la corde.	Ii vave nioue, ou du moments de la corde.
Noſtre homme vient à nous, ie m’en vay l’amuzer, Aais uu toue;	Notre homme vient à nous, ie m'en vais l'amuzer, Aais toue;
piener garde a bien harquebuzer;	piener garde a bien harquebuzer;
Ajuſtez bien vos coups ſans faire d’equiuoque;	Ajustez bien vos coups sans faire d'équivoque;
Paroiſſez à propos, quand il faudra qu’on choque.	Paraissez à propos, quand il faudra qu'on choque.
Cachez-vous cependant dans ce vieil baſtiment.	Cachez-vous cependant dans ce vieil bâtiment.
CENE III.	CÈNE III.
LE COMTE.	LE COMTE.
DOM PEDRE.	DOM PÉDRE.
LA TAILLADE.	LA TAILLADE.
3.	3.
Braues.	Bravez.
LE COMTE.	LE COMTE.
Aualier.	Avalier.
ie n'ay pû venir plus promptement;	Elle n'ai pu venir plus promptement;
C Mais ſçachons li c’eſt vous que ie doy ſatisfair	Ç Mais sachons li c'est vous que ie dois satisfair
LA TAILLADE.	LA TAILLADE.
ouy c’eſt moy.	oui c'est moi.
LE COMTE.	LE COMTE.
Ie ne ſçay ce que j’ay pû vous faire;	Je ne sais ce que j'ai pu vous faire;
Car ie ne penſe pas vous auoir iamais veu.	Car ie ne pense pas vous avoir jamais vu.
Ha traiſtres:	Ha traîtres:
tant de gens ine prendre à l’impourueus.	tant de gens ine prendre à l'impourueus.
Mais quand bien vous ſeriez encore dauantage, Ie vous ferois perir.	Mais quand bien vous seriez encore davantage, Je vous ferais périr.
DOM PEDRE.	DOM PÉDRE.
Tuant vn des Brauer d vn tonp ue piſtolet.	Tuant un des Braver d vn tonp ue pistolet.
LA TAILLADE.	LA TAILLADE.
Mon arme a pris vn rat.	Mon arme a pris un rat.
DOM PEDRE.	DOM PÉDRE.
Ils fuyent les poltrons.	Ils fuient les poltrons.
PE COMTE.	PE COMTE.
Suiuons les.	Suivons -les.
LA TAILLADE.	LA TAILLADE.
En fuyant.	En fuyant.
Se feroit auonuner.	Se ferait avonuner.
Quelque fat	Quelque fat
DOM PEDRE.	DOM PÉDRE.
Laiſſez, laiſſez-les viure.	Laissez, laissez-les vivre.
songon drousuchendie, au neu de les pourſuiure.	songon drousuchendie, au neu de les poursuivre.
COMTE.	COMTE.
Me deffendre I& de qui?	Me défendre IB de qui?
DOM PEDRE.	DOM PÉDRE.
De moy.	De moi.
LE COMTE.	LE COMTE.
De vous!	De vous!
DOM PEDRE.	DOM PÉDRE.
De mer.	De mer.
LE COMTE.	LE COMTE.
Pourquoy me voulez-vous tant de mal?	Pourquoi me voulez-vous tant de mal?
DOM PEDRE.	DOM PÉDRE.
Ie le dor.	Je le dor.
LE COMTE.	LE COMTE.
Vous m'auiez obligé de me venir deffendre, Et mes biens-faits pouuoient ſans doute vous le rẽdre:	Vous m'aviez obligé de me venir défendre, Et mes biens-faits pouvaient sans doute vous le rendre:
Mais ſi me deffendans vous m’auiez obligé, 1 M'arellant au combat vous m’auez outragé:	Mais si me défends vous m'aviez obligé, 1 M'arellant au combat vous m'avez outragé:
Sans vouloir penetrer dans cette extrauagance, Ie veux bien contre vous me battre à toure outranee:	Sans vouloir pénétrer dans cette extravagance, Je veux bien contre vous me battre à toure outrance:
Mais deuant, contentez ina curioſité, Et ne vous couurez plus d’vn viſage emprunté.	Mais devant, contentez ina curiosité, Et ne vous couvrez plus d'un visage empruné.
DOM PEDRE.	DOM PÉDRE.
Vous n’y trouuerez pas vn grand ſujet de joye.	Vous n'y trouverez pas un grand sujet de joie.
LE COMTE.	LE COMTE.
Il ne m’importe, oſtez le maſque, & qu’on vous voye.	Il ne m'importe, ôtez le masque, et qu'on vous voie.
le l’oſte.	le l'ôte.
DOM PEDRE.	DOM PÉDRE.
LE COMTE.	LE COMTE.
O Dicu!	Ô Dicu!
c’eſt vous Dom Pedre, & qui l’euſt cru?	c'est vous Dom Pèdre, et qui l'eût cru?
DOM PEDRE.	DOM PÉDRE.
Ie peuſe auoir payé ce que ie vous ay du:	Je pusse avoir payé ce que je vous ai du:
De voſtre part auſſi vous en ferez de meſme:	De votre part aussi vous en ferez de même:
Et me ſatisferez.	Et me satisferez.
LE COMTE.	LE COMTE.
Mon regret eſt extréme, D'auoir à me ſeruir de mon bras contre vous.	Mon regret est extrême, D'avoir à me servir de mon bras contre vous.
DOM PEDRE.	DOM PÉDRE.
Ie le croy:	Je le crois:
Mais enfin que diroit-on de nous.	Mais enfin que dirait-on de nous.
Ne differons donc plus, baiiſſons la tendreſſe, Ne faiſons plus agir que la force & l’adreſſe.	Ne différons donc plus, baiissons la tendresse, Ne faisons plus agir que la force et l'adresse.
LE COMTE.	LE COMTE.
Deffens toy, nous faiſons trop languir noſtre hõneur.	Défens toi, nous faisons trop languir notre honneur.
DOM PEDRE.	DOM PÉDRE.
L’eſpée ſe rompt.	L'épée se rompt.
Du premier coup ie ſuis ſans eſpée?	Du premier coup Rom suis sans épée?
ô mal-heur!	ô malheur!
LE COMTE.	LE COMTE.
Il faut mourir, Dom Pedre, ou demander la vie.	Il faut mourir, Dom Pedre, ou demander la vie.
DOM PEDRE.	DOM PÉDRE.
I'aime mieux mille fois qu'elle me ſoit rauie Que de la demander, fay ce que tu pourras.	J'aime mieux mille fois qu'elle me soit ravie Que de la demander, fais ce que tu pourras.
LE COMTE, Ta mort eſt ea mes muins.	LE COMTE, Ta mort est ea mes muins.
DOM PEDRE.	DOM PÉDRE.
Et ma vie en mes bras.	Et ma vie en mes bras.
LE COMTE.	LE COMTE.
Non non, de ta valeur la mienne eſt trop épriſe.	Non non, de ta valeur la mienne est trop éprise.
Ie t’attendray, cours viſte, & reuien ſans remiſe Lors que tu te ſeras d’vn autre fer pourueu.	Je t'attendrai, cours vite, et revien sans remise Lors que tu te seras d'un autre fer pourvu.
DOM PEDRE.	DOM PÉDRE.
O Dieu!	Ô Dieu!
faut-il encor qu'vn mal-heur impreueu Me ſurprenne, & me rende enuers vous redeuable, Ie reuiens à l’inſtant.	faut-il encore qu'un malheur imprévue Me surprenne, et me rende envers vous rédevable, Je reviens à l'instant.
LE COMTE.	LE COMTE.
Du corps d’vn miſerable, Ie ne me trouue pas fort bien accompagné, Et le pouriois de meurde en eicie toupçonné.	Du corps d'Hommes misérable, Je ne me trouve pas fort bien accompagné, Et le pourriais de meurde en eicie toupçonné.
Taſchons donc de ietter au fonds de la riuiere Ce corps, dont les corbeaux deuoient eſtre la biere.	Tâchons donc de jeter au fond de la rivière Ce corps, dont les corbeaux devaient être la bonne.
Ie voy du monde;	Je vois du monde;
Il faut l’aller ietter plus bas.	Il faut l'aller jeter plus bas.
SCENDIV.	SCENDIV.
CRISPIN.	CRISPIN.
BEATRIS.	BEATRIZ.
LEONORE.	LEONORE.
CASSANDRE.	CASSANDRE.
CAISFIN, Es porteurs ſont forbus.	CAISFIN, Es porteurs sont forbus.
BEATRIS.	BEATRIZ.
Ou pour le moins bien las.	Ou pour le moins bien las.
CRISPIN.	CRISPIN.
Madame, c’eſt icy que j’ay laiſſé mon Maiſtre Ie ne ſçay pas pouruoy, pour ſe battre peut-eſtre.	Madame, c'est ici que j'ai laissé mon Maître Je ne sais pas pourvoi, pour se battre peut-être.
L’EONORE.	L'ENORE.
Il n’y paroiſt perſonne.	Il n'y paraît personne.
Ha ie n’en doute plus, S'en eſt fait:	Ha ie n'en doute plus, S'en est fait:
& nos pas ſont icy ſuperflus Si l'vn d'eux, ou pous deux ont acheué de viure, Ils m'auront enſeigné par où ie les doy ſuiure N’en doutez point Caſſandre, en vn mal-heur parei De mon ſeul deſeſpoir ie ſuiuray le conſeil.	et nos pas sont ici superflus Si l'Un d'eux, ou pous deux ont achevé de vivre, Ils m'auront enseigné par où tu les dois suivre N'en doutez point Cassandre, en un malheur pare De mon seul désespoir ie suivrai le conseil.
Alors aymab le ſœur d’vn peu fincere frere.	Alors aimab le sœur d'un peu sincère frère.
Peut-eſtre ferez-vous ce qu'il àuroit dû faire, Vous aurer de mes maux quoiquè compaſſion.	Peut-être ferez-vous ce qu'il ouvrait dû faire, Vous aurer de mes maux quoiqué compassion.
CASSANDRE.	CASSANDRE.
I'uy beſoin comme vous de conſolation.	J'hui besoin comme vous de consolation.
Nous craignõs vous & moy pour deux aimables freres, Nous ne craignons pas moins pour leurs chers aduerfaires, Ie ne vous trouue pas plus à plaindre que moy.	Nous craignons -vous et moi pour deux aimables frères, Nous ne craignons pas moins pour leurs chers adversaires, Je ne vous trouve pas plus à plaindre que moi.
LEONORE.	LEONORE.
O Dieu!	Ô Dieu!
n'eſt-ce pas là le Comte que ie voy, Sans chapeau, ſans caſaque, au bord de la rluiere?	n'est-ce pas là le Comte que je vois, Sans chapeau, sans caque, au bord de la ruière?
D'vn funeſte accident j’ay la peur toute entiere, Ie le voy dans l’eſtat qu’on eſt quand on ſe bat, Ie n'en doy plus douter ils ont fait leur combat, Il eſt ſeul, & mon frere aura perdu la vie, Et le barbare Comte à ſa rage aſſouuie, Et mon mal-heur eſt tel, que ſi j’oze ſonger A me venger lur luy jè cie lur moy ſe venger Allons, Caſſandre,allons trouuer ce ſanguinaire, Allons luy demander voſtre amant, & mon frere:	D'un este accident j'ai la peur toute entière, Je le vois dans l'estat Yon est quand on se bat, Je n'en dois plus douter ils ont fait leur combat, Il est seul, et mon frère aura perdu la vie, Et le barbare Comte à sa rage assouvie, Et mon malheur est tel, que si j'ose songer À me venger lur lui jè cie venger moi se venger Allons, Cassandre, trouuer elle sanguinaire, Allons toujours demander votre amant, et mon frère:
O meſchant, que mes yeux ont peine à regarder Qu'as-tu fait de mon frere?	Ô méchant, que mes yeux ont peine à regarder Qu'as-tu fait de mon frère?
CENE' V.	CÈNE V.
LE COMTE.	LE COMTE.
LEONORE.	LEONORE.
CASSANDRE.	CASSANDRE.
CRISPIN.	CRISPIN.
BEATRIS.	BEATRIZ.
LE COMTE.	LE COMTE.
Sortant dubord de l'eau.	Sortant dubord de l'eau.
Auois-je à le garder.	Avais-je à le garder.
LEONORE.	LEONORE.
Ouy, traiſtre tu l'auois ſi ton ame cruelle, M’auoit aimée autant, que ie te ſuis fidelle.	Oui, traître tu l'avais si ton âme cruelle, M'avait aimée autant, que ie te suis fidelle.
Que tu te ſçais bon gré, dy-moy la verité,	Que tu te sais bon gré, dis-moi la vérité,
De m'auoir fait ouir vne brutalité?	De m'avoir fait ouïr une brutalité?
Auois-je à le garder!	Avais-je à le garder!
o reſponce barbare!	ô réponse barbare!
LE GOMTE.	LE GOMTE.
Madame, il n’eſt pas mort:	Madame, il n'est pas mort:
Mais voſtre eſprit s’égare.	Mais votre esprit s'égare.
EONORE.	EONORE.
Perſide!	Perside!
moneſprit, n’a point à s’égarer:	monesprit, n'a point à s'égarer:
Il s’égara deſlors qu’il t’oüit ſoûpirer, Que ſur de faux ſoûpirs, & ſur de fauſſes plaintes, Il crut trop ayzément à tes promeſſes feintes:	Il s'égara délors qu'il t'oüit soupirer, Que sur de faux soupirs, et sur de fausses plaintes, Il crut trop aisément à tes promesses feintes:
Mais tu ſçais bien mõ foible, & que j’ay trop d’amoum.	Mais tu sais bien mon faible, et que j'ai trop d'amoum.
Tu peur impunément m’offencer chaque iour.	Tu peur impunément m'offenser chaque jour.
Si du bien que ie pers le penſer m'eſt funeſte, Il ne me I'eſt pas moins pour celuy qui me reſte, Tout ingrat que tu m’es, ie ne te puis hair, Et ma bouche ne peut long-temps mon cœur trahir.	Si du bien que je pers le penser m'est funeste, Il ne me J'est pas moins pour celui qui me reste, Tout ingrat que tu m'es, Seigneur ne te puis haïr, Et ma bouche ne peut longtemps mon cœur trahir.
LE Conſolez-H, ma ſœur.	LE Consolez-H, ma sœur.
OMTE.	OMTE.
CASSANDRE.	CASSANDRE.
Conſole-moy toy-meſme,.	Console-moi toi-même,.
Tu m'es plus odieux, cent fois qu’elle ne t’ayme.	Tu m'es plus odieux, cent fois qu'elle ne t'aime.
LE COMTE.	LE COMTE.
le cio, qu vn meme mar vous fait parler ainſi.	le cio, qu' int -même mar vous fait parler ainsi.
CASSANI Ouy, Dom Pedre m’aimoit, & ié l’aymois auſſi.	CASSANI Oui, Dom Pedre m'aimait, et et j'aimais aussi.
CONTE, Ie vous trouue en ſa mort toutes deux bien à plaindre.	CONTE, Je vous trouve en sa mort toutes deux bien à plaindre.
CASSANDRE.	CASSANDRE.
Peut-eſtre verras-tu que ie ſuis bien à craindre.	Peut-être verras-tu que ici suis bien à craindre.
COMTE.	COMTE.
Cependant que ma ſour pleutera le treſpas De cét aymable mort, qui pourtant ne l’eſt pas.	Cependant que ma sour pleutera le trépas De cet aimable mort, qui pourtant ne l'est pas.
Madame vous plaiſt-il.	Madame vous plaît-il.
Mais ie voy voſtre Pert:	Mais ici vois votre Pert:
Qui me vient demander encore voſtre frere.	Qui me vient demander encore votre frère.
si ce mort reuenoit, il m’épargneroit bien Des conteſtations qui ne ſeruent de rien.	si ce mort revenait, il m'épargnerait bien Des contestations qui ne servent de rien.
G iiij.	G jij.
CENE IVI.	CÈNE IVI.
DOMFELIX.	DOMFELIX.
va PREVOST & ſa ſuitte.	va PRÉVÔT et sa suitte.
DOM.	DOM.
FELIX.	FELIX.
rappeiry, le pama déloyalle fille?	rappeiri, le pâma déloyalle fille?
NCét opprobre honteux d'vne illuſtre famille, Mais le Ciel auſte entin me Ia fait retrouuer, Et ſon amant icy ne la ſçauroit ſauuor.	NCét opprobre honteux d'une illustre famille, Mais le Ciel auxte entin me fait retrouver, Et son amant ici ne la sçauroit sauvor.
LE COMTE, A part.	LE COMTE, À part.
Ce yiemard & ces gens me donnert de la peine.	Ce yiemard et ces gens me donnert de la peine.
LI PREVOST Monſieur, vous eſtes pris, la reſiſtance eſt vaine.	LI PRÉVÔT Monsieur, vous êtes pris, la résistance est vaine.
EC COMTE.	EC COMTE.
Et qu’ay-je fait, Meſſieurs?	Et qu'ai-je fait, Messieurs?
DOM FELIX.	DOM FELIX.
Tu me viens de tuer Vn fils, & tu me dois auſſi reſtituer L’honneur que mo rauit vne fille enleuée.	Tu me viens de tuer Un fils, et tu me dois aussi restituer L'honneur que mo rauit L' il enlevée.
ECOMTESi Domr euic en manne, n la ſœur eſt trouuée Qu'auray-je fait encor?	ECOMTESi Domr euic en manne, n la sœur est trouvée Qu'aurai-je fait encor?
DOM FELIX.	DOM FELIX.
Tu t'en ris inhumain.	Tu t'en ris inhumain.
Ft ton habit ſanglant, & ta ſanglante main Ne conuainquent que trop ton ame meurtriere.	Ft ton habit sanglant, et ta sanglante main Ne convainquent que trop ton âme meurtrière.
Le COMTE.	Le COMTE.
Qu'aurois-je fait du corps?	Qu'aurais-je fait du corps?
DOM FELIX.	DOM FELIX.
Il eſt dans la riuiere.	Il est dans la rivière.
LE PREVOST.	LE PRÉVÔT.
Onvous l’a veu ietter.	Onvous l'a vu jeter.
DOM FELIX.	DOM FELIX.
Le voila bien confus.	Le voilà bien confus.
LE COMTE.	LE COMTE.
Et bien vous me tenez, ne conteltons donc plus.	Et bien vous me tenez, ne compteltons donc plus.
LE PREVOST, S’il vit, vous n’aurez pas grand ſujet de vous plaindre.	LE PRÉVÔT, S'il vit, vous n'aurez pas grand sujet de vous plaindre.
DÔM FELIX.	DÔM FELIX.
Tant que ie l’aye veu viuant j’ay tout à craindre.	Tant que ici l'aie vu vivant j'ai tout à craindre.
Qu'as-tu fait de ton Maiſtre?	Qu'as-tu fait de ton Maître?
CRISPIN.	CRISPIN.
Armé comme vn voleus Il eſt tantoſt venu iuſqu’icy.	Armé comme un voleus Il est tantôt venu jusqu'ici.
DOM FELIX.	DOM FELIX.
N'eſt que trop aueré!	N'est que trop averé!
Mon mal-heur	Mon malheur
CRISPIN.	CRISPIN.
Le regard fort funeſte, Et l'eſprit fort hargneux.	Le regard fort funeste, Et l'esprit fort hargneux.
I'ignore tout le reſte:	J'ignore tout le reste:
I’ay couru vous chercher, & ne vous trouuant pas l'ay trouué voſtre fille, elle a doublé le pas En Baſque, & cette Dame eſt venuë auec elle:	J'ai couru vous chercher, et ne vous trouvant pas l'ai trouvé votre fille, elle a doublé le pas En Basque, et cette Dame est venue avec elle:
De tout de qui lçay c’eſt le recit fidelle.	De tout de qui lçai c'est le récit fidèle.
DOM FELIX.	DOM FELIX.
Helas mon fils eſt mort!	Hélas mon fils est mort!
ERISPIN.	ERISPIN.
Il eſtoit fort mortel, er peu queiere, veu pie lay lecounu tel.	Il était fort mortel, er peu queière, vu pie lay lecounu tel.
OM FELIX.	OM FELIX.
Oſte-toy, mal plaiſant & froid bouffon.	Ost-toi, mal plaisant et froid bouffon.
LEONORE.	LEONORE.
Mon Pere.	Mon Père.
DOM FELIX.	DOM FELIX.
Ozes-ui me parler ſans craindre ma colere ?	Ozes-mui me parler sans craindre ma colère ?
Ozes-ui ſans rougir paroiſtre au iour ainſi?	Ozes-vi sans rougir paraître au jour ainsi?
CRISPIN.	CRISPIN.
Défachezvous mortels, ie voy venir icy, De tant de gens faſchez l'infaillible remede, C’eſt comme qui diroit, Dom Pedre de Ceſpede	Défachezvous mortels, on vois venir ici, De tant de gens fâchez l'infaillible remède, C'est comme qui dirait, Dom Pèdre de Cespède
SCENE VII.	SCÈNE VII.
DOM PEDRE.	DOM PÉDRE.
LE COMTE.	LE COMTE.
DOM FELIX.	DOM FELIX.
LEONORE.	LEONORE.
CASSANDRE.	CASSANDRE.
BEATRIS.	BEATRIZ.
CRISPIN, &c.	CRISPIN, etc.
OM PEDRE.	OM PEDRE.
On Pere & des Archers:	On Père et des Archers:
LE COMTE.	LE COMTE.
Et bien ton fils tué, Impetueux vieillard, t’eſt-il reſtitué?	Et bien ton fils tué, Impétueux vieillard, t'est-il restitué?
DOM FELIX.	DOM FELIX.
Ele te ſeuois cucereegradu lapriſel ;	Elle te seuais cuceregradu laprisel ;
CRISPIN, Où ie me trompe fort, Iaffaire eſt en ſa crize.	CRISPIN, Où ie me trompe fort, Iaffaire est en sa crize.
DOM PEDRE.	DOM PÉDRE.
Il entre du Criſpin icy:	Il entre du Crispin ici:
Mais ſi tantoſt led douue tlecat.	Mais si tantôt led doue tlecat.
CRISPIN.	CRISPIN.
an a paidnen.	an a paiden.
Ha foüillez-moy pluſtoſt.	Ha foüillez-moi plutôt.
LE COMTE.	LE COMTE.
Pour vous auoir tué.	Pour vous avoir tué.
Dom Pedre, ſon m’arreſte,	Dom Pèdre, son m'arrête,
DOM FELIX.	DOM FELIX.
Non, c’eſt à ma Requeſte, Pour auoir enleué ma fille;	Non, c'est à ma Requête, Pour avoir enlevé ma fille;
& ie precens, 14 Qu'vn mariage ſeul peut nous rendre contons.	et Les précends, 14 Qu'un mariage seul peut nous rendre contons.
E COMTE.	E COMTE.
Dom Felix ce n’eſt pas par tant de violence, Que tu deuois taſcher d’auoir mon alliance.	Dom Félix ce n'est pas par tant de violence, Que tu devais tâcher d'avoir mon alliance.
Quand tout le monde entier prendroit party pour toy, La choſe dépendroit encor toute de moy.	Quand tout le monde entier prendrait parti pour toi, La chose dépendrait encor toute de moi.
Mais de puiſſans motifs en ta faueur combattent, Et les fiers ſentimens de mon ame s’abattent.	Mais de puissants motifs en ta faveur combattent, Et les fiers sentiments de mon âme s'abattent.
Ie connois ton merite, & ſçay ta qualité, Et ta ſçauras auſſi ma generoſité.	Je connais ton mérite, et sais ta qualité, Et ta sçauras aussi ma générosité.
Ie ne refuſe plus d’eſpouſer Leonore:	Je ne refuse plus d'épouser Leonore:
Mais d'vn frere perdu la douleur dure encore.	Mais d'un frère perdu la douleur dure encore.
Triſte & couuert de deüil ſous l’hymen m’engager, Eſpouſer vne ſœur?	Triste et couvert de deuil sous l'hymen m'engager, Épouser une sœur?
d'vn frere ſe venger!	d'un frère se venger!
Sont-ce des actions qui s’accordent enſemble!	Sont-ce des actions qui s'accordent ensemble!
Il les faut accorder ,Erhymen nous aſſemble, Il faut hayr le frere, il faut aymer la ſœur, Il faut croire l'amour, il faut croire l'honneur, La raiſon veut auſſi que ie vous ſatisface.	Il les faut accorder ,Erhymen nous assemble, Il faut haïr le frère, il faut aimer la sœur, Il faut croire l'amour, il faut croire l'honneur, La raison veut aussi que je vous satisface.
DOM PEDRE.	DOM PÉDRE.
A cét honneur inſigne adjouſtez vne grace, Peut-eſtre ignorez-vous, que j'ayme voſtre ſœur Auec tous les reſpects, auecque tout l’honneur, Qu'elle peut exiger d'vn eſclaue fidelle:	À cet honneur insigne ajoutés une grâce, Peut-être ignorez-vous, que j'aime votre sœur Avec tous les respects, avec tout l'honneur, Qu'elle peut exiger d'un esclaue fidèle:
Elle ſçait les tourmens que j'ay ſouffers pour elle, Et que pour ſon ſujet le deſtin a permis, Le funeſte accident qui nous rend ennemis:	Elle devait les tourments que j'ai soufferts pour elle, Et que pour son sujet le destin a permis, Le funeste accident qui nous rend ennemis:
Ie Ciel me ſoit teſmoin, que deffendant ma vie, Qnand ſans voſtre ſecours elle m’eſtoit rauie, Si j’euſſe reconnu l’autheur d'vn tel deſſein, I’euſſe à ſon fer cent fois laiſſé percer mon ſein, Ou peut-eſtre cherché mon ſalut en ma fuite, Pluſtoſt que repouſſer ſon ardente pourſuite.	Je Ciel me soit témoin, que défendant ma vie, Qnand sans votre secours elle m'était ravie, Si j'eusse reconnu l'auteur d'un tel dessein, J'eusse à son fer cent fois laissé percer mon sein, Ou peut-être cherché mon salut en ma fuite, Plutôt que repousser son ardente poursuite.
Ie me vis attaqué d’vn ieune homme en fureur, Et comme il me preſſoit, auec plus de vigueur Que les laſches poltrons, que nous miſmes en fuite, Iugez où ma valeur ſe trouua lors reduite.	Je me vis attaqué d'une jeune homme en fureur, Et comme il me pressait, avec plus de vigueur Que les lâches poltrons, que nous mîmes en fuite, Jugez où ma valeur se trouva lors réduite.
I auois à me deffendre, ou j’auois à mourir:	I auois à me défendre, ou j'avais à mourir:
Preſt de perir moy-meſme, ou de faire perir, Il eſt plus naturel de choiſir l'vn que l’autre, Et c’eſt comme arriua mon mal-heur & le voſtre.	Prêt de périr moi-même, ou de faire périr, Il est plus naturel de choisir l'un que l'autre, Et c'est comme arriva mon malheur et le vôtre.
Mais Monſieur me donnant Caſſandre, cét honneur D’vn ennemy vous fait vn frere, vn ſeruiteur.	Mais Monsieur me donnant Cassandre, cet honneur D'un ennemi vous fait un frère, un serviteur.
LES GENEREVX	LES GÉNÉREUX
E COMTE.	E COMTE.
Vous aymez donc ma ſœur, Dom Pedre?	Vous aimez donc ma sœur, Dom Pèdre?
DOM PEDRE.	DOM PÉDRE.
Ie l'adore.	Je l'adore.
E COMTE.	E COMTE.
Elle eſt à vous, & moy ie ſuis à Leonore.	Elle est à vous, et moi je suis à Leonore.
LEONORE.	LEONORE.
Mon Pere, pardonnez.	Mon Père, pardonnez.
DOM FELIX.	DOM FELIX.
Tout n'a que bien eſté, Hazardant voſtre honneur vous l auez augmenté.	Tout n'a que bien été, Hasardant votre honneur vous avez augmenté.
LE COMTE.	LE COMTE.
A Dom Felix.	À Dom Félix.
Allons chez vous, Monſieur, car vn logis funebre N'admet point d’action ſi gaye & ſi celebre, Que celle dont vn iour nos ilfuſtres neueux, Si la bonté du Ciel en accorde à nos vœurs Auront à ſe vanter chez les races ſutures, Tant de nos procedez, & de nos auantures, Que uer eiuit negaur, ou l’amour nous a mis, Nous faiſant appeller;	Allons chez vous, Monsieur, car un logis funèbre N'admet point d'action si gaie et si célèbre, Que celle dont un jour nos ilfustres neueux, Si la bonté du Ciel en accorde à nos vœurs Auront à se vanter chez les races sutures, Tant de nos procédez, et de nos aventures, Que uer éjuit negaur, ou l'amour nous a mis, Nous faisant appeler;
Genereux Ennemis.	Généreux Ennemis.
CRISPIN.	CRISPIN.
Beatris de moa oœeur	Béatris de moa oœeur
MATRIS 25:	MATRIS 25:
Gher Criſpin de mon ame,	Gher Crispin de mon âme,
CRISPIN.	CRISPIN.
De cez haiceux Amans faiſons l’épiralame.	De cez haiceux Amants faisons l'épiralame.
SEATRIS.	SEIGNEUR.
I'en ſuis:	J'en suis:
ſouhaitons leur des filles & des ſils De l'humeur de Criſpin.	souhaitons leur des filles et des sils De l'humeur de Crispin.
LES GENEREVX	LES GÉNÉREUX
E COMTE.	E COMTE.
Vous aymez donc ma ſœur, Dom Pedre?	Vous aimez donc ma sœur, Dom Pèdre?
DOM PEDRE.	DOM PÉDRE.
Ie l'adore.	Je l'adore.
E COMTE.	E COMTE.
Elle eſt à vous, & moy ie ſuis à Leonore.	Elle est à vous, et moi je suis à Leonore.
LEONORE.	LEONORE.
Mon Pere, pardonnez.	Mon Père, pardonnez.
DOM FELIX.	DOM FELIX.
Tout n'a que bien eſté, Hazardant voſtre honneur vous l auez augmenté.	Tout n'a que bien été, Hasardant votre honneur vous avez augmenté.
LE COMTE.	LE COMTE.
A Dom Felix.	À Dom Félix.
Allons chez vous, Monſieur, car vn logis funebre N'admet point d’action ſi gaye & ſi celebre, Que celle dont vn iour nos ilfuſtres neueux, Si la bonté du Ciel en accorde à nos vœurs Auront à ſe vanter chez les races ſutures, Tant de nos procedez, & de nos auantures, Que uer eiuit negaur, ou l’amour nous a mis, Nous faiſant appeller;	Allons chez vous, Monsieur, car un logis funèbre N'admet point d'action si gaie et si célèbre, Que celle dont un jour nos ilfustres neueux, Si la bonté du Ciel en accorde à nos vœurs Auront à se vanter chez les races sutures, Tant de nos procédez, et de nos aventures, Que uer éjuit negaur, ou l'amour nous a mis, Nous faisant appeler;
Genereux Ennemis.	Généreux Ennemis.
CRISPIN.	CRISPIN.
Beatris de moa oœeur	Béatris de moa oœeur
MATRIS 25:	MATRIS 25:
Gher Criſpin de mon ame,	Gher Crispin de mon âme,
CRISPIN.	CRISPIN.
De cez haiceux Amans faiſons l’épiralame.	De cez haiceux Amants faisons l'épiralame.
SEATRIS.	SEIGNEUR.
I'en ſuis:	J'en suis:
ſouhaitons leur des filles & des ſils De l'humeur de Criſpin.	souhaitons leur des filles et des sils De l'humeur de Crispin.
