M.	M.
DC.	DC.
muri.	mûri.
dOMJIINDYI VOEI ΑMATMOi ATIUA1 MJAMZIVIOA MU THAMM MMAMO 8M ohon uh bo Mut 150[ 2b 2 SUSSSH θcοb uidmobhamendià ob 2041 Cusnibio	dOMIINDYI VOEI UMATMOi ATIUA1 MAMZIVIOA MU THAM MMAMO 8M ohon uh bo Mut 150[ 2b 2 SUSSSH θcοb uidmobhamendià 2041 Cusnibio
A SON EXCELLENCE MONSEIGNEVR LE COMTE DE KONISMARK, GRAND CHAMBELLAN du Roy de Suede, Capitaine des Cheuaux-Legers de ſa Garde, & ſon fiinbunadeur Extrdordinaire en France.	À SON EXCELLENCE MONSEIGNEUR LE COMTE DE ONISMAR, GRAND CHAMBELLAN du Roi de Suède, Capitaine des Chevaux-Légers de sa Garde, et son fiinbunadeur Extrédordinaire en France.
ONSEIGNEVR, C’eſt Vous que j’ay choiſi a ij 13 pour eſtre le Protecteur illuſtr d’vn Prince qui fut autan recommandable dans ſon ſie cle que Vous l’eſtes dans noſtre.	ONSEIGNEUR, C'êtes -vous que j'ai choisi a ij 13 pour être le Protecteur illustr d'un Prince qui fut autan recommandable dans son siè le que Vous l'êtes dans notre.
C’eſt de Voſtre Ex cellence, MONSE GNEVR, qu’il oſe atten dre le ſuffrage pour ſe mon ſtrer au Public, n'ayant ja Ormais eu la hardieſſe de paſſe dans ſes mains sil n'auot Nauant paßé dans les Uoſtre Ne.	C'est de Votre Ex celence, MONZE GNEUR, qu'il ose atten dre le suffrage pour se mon strer au Public, n'ayant ja Ormais eu la hardiesse de passe dans ses mains sil n'audot Navant passé dans les Uotre Ne.
Vous eſtonneZ pas ſon choix, ou pluſtoſt du mier apres que le grand Condé, don les lumieres égalent la Va leur, ſemons engugeitious François à Vous rendre leurs homages par l’eſtime qu’il fait de vos belles qualiteZ.	Vous étonnez pas son choix, ou plutôt du mier après que le grand Condé, donc les lumières égalent la Va leur, semons engugeitious Français à Vous rendre leurs hommages par l'estime qu'il fait de vos belles qualités.
Ie deurois apres luy au nom de toute la France, ſi mon Preſent en eſtoit digne, Vous donner par là quelques marques de ſes reconnoiſſances, d'eſtre venu confirmer l’amitié des deux plus grands Roys qui regnent aujourd’huy ſur la Terre, & dont les forces vnies par l’entremiſe de Voſtre Excellence, les rendront redoutables a tous les hutres.	Je devrais après avoir au nom de toute la France, si mon Présent en était digne, Vous donner par là quelques marques de ses reconnaissances, d'être venu confirmer l'amitié des deux plus grands Rois qui règnent aujourd'hui sur la Terre, et dont les forces Tries par l'entremise de Votre Excellence, les rendront redoutables à tous les hutres.
Ie remets à vne Plume plus delicate que la mienne à pu blier les loüanges qui Vous en ſont deuës, pour laiſſer vne exemple à la Poſterité de voſtre rare Conduite.	Je remets à notre Plume plus délicate que la mienne à pu blier les louanges qui Vous en sont dues, pour laisser une exemple à la Postérité de votre rare Conduite.
Ie n'entreprendray pas non plus, MONSEIGNEVR, d’eſtaler icy les grands Emplois que Vous auez eûs dans les Eſtats de la Suede, de l'Eſpagne & de l’Angleterre, qui Vous ont fait meriter celuy que Vous aueZ auprés de noſtre Auguſte Monarque.	Je n'entreprendrai pas non plus, MONSEIGNEUR, d'étaler ici les grands Emplois que Vous avez eus dans les États de la Suède, de l'Espagne et de l'Angleterre, qui Vous ont fait mériter celui que Vous avez auprès de notre Auguste Monarque.
Ie ne m'eſtendray piestujer fantes grands auantages que Vous tirez de l’eſclat de vos Anceſtres, dont l’Hiſtoire eſt remplie des hauts faits;	Je ne m'étendrai piestujer fantes grands avantages que Vous tirez de l'éclat de vos Ancêtres, dont l'Histoire est remplie des hauts faits;
Ie me contenteray ſeulement d'eſtre du nombre de ceux qui publient voſtre Gloire, afin que ſi leurs merites les rendent dignes de vos Bontez, mon Zele me rende außi digne d’eſtre auëc beaucoup de reſpect,	Je me contenterai seulement d'être du nombre de ceux qui publient votre Gloire, afin que si leurs mérites les rendent dignes de vos Bontés, mon Zèle me rende aussi digne d'être auec beaucoup de respect,
CONSEIGNEVR.	CONSEIGNEUR.
Tres-humble & tresobeïſſant Seruiteur, DE CHARENTON.	Très-humble et tresobeïssant Serviteur, DE CHARENTON.
ACTEVRS.	ACTEURS.
ELEVCVS, Roy d’Egypte, ſuéceſſeur d’Alexandre,	ELEVCVS, Roi d'Égypte, suécesseur d'Alexandre,
LEOPATRE, Reyne, femme de Seleucus.	LEOPATRE, Reine, femme de Seleucus.
ROLOMHE, PAMMee eſtraniger, Amoufeux de Berecinte.	ROLOMHÉ, PAMMe étraniger, Amouffeux de Bèrecinte.
DORIMAN, Fauory du Roy, & Riual de Ptolomée.	DORIMAN, Favori du Roi, et Rival de Ptolomée.
BERECINTE, Princeſſe captiue, fille de Liſimachus, ſucceſſeur d’Aſexandre.	BERECINTE, Princesse captive, fille de Lisimachus, successeur d'Asexandre.
LVCIAN, Confident de Doriman.	LUCIAN, Confident de Doriman.
STRATON, Capitaine des Gardes du Roy.	STRATON, Capitaine des Gardes du Roi.
CBIOIt, Capntuthe des Gardes de la Reyne.	CBIOIt, Capntuthe des Gardes de la Reine.
PAVLINE, Confidente de la Reyne.	PAULINE, Confidente de la Reine.
SABINE, Confidente de Berecinte.	SABINE, Confidente de Bérecinte.
LES GARDES.	LES GARDES.
PAGES.	PAGES.
4F L SIEEEZ TRAGI-COMEDIE.	4F L IEEEZ TRAGICOMÉDIE.
ACTE I.	ACTE I.
SCENE PREMIERE.	SCÈNE PREMIÈRE.
PTOLOMEE, BERECINTE.	PTOLOME, BÉRECINTE.
PTOLOMEE.	PTOLOMEE.
NFIN voicy le iour fauorable à nos vœux, Voicy l’aymable iour qui nous doit rendre heureux, Qui donne vn beau ſuccez à nos perſeuerances, Et qui fait triompher nos iuſtes eſperances:	NON voici le jour favorable à nos vœux, Voici l'aimable jour qui nous doit rendre heureux, Qui donne un beau succès à nos persévérances, Et qui fait triompher nos justes espérances:
Doriman dont la gloire explique le pouuoir, A ſceu l’adueu du Roy que ie viens de ſçauoir, – Nous deuons à ſes ſoins cette heureuſe iournée, Où nous ſerons vnis par vn doux Hymenée.	Doriman dont la gloire explique le pouvoir, A su l'aveu du Roi que ie viens de savoir, Nous deuons ses soins cette heureuse iournée, nous serons vnis par doux Hymenée.
Ah!	Ah!
que mon ame alors ſçaura bien reparer, Ce bon-heur languiſſant qui m’a fait ſoûpirer, Et que le ſouuenir des miſeres paſſées, Laiſſera dans mon cœur d’agreables penſées!	que mon âme alors saura bien réparer, Ce bonheur languissant qui m'a fait soupirer, Et que le souvenir des misères passées, Laissera dans mon cœur d'agréables pensées!
Berecinte aduoüons que les Dieux tous puiſſants Rendent le Roy ſenſible à nos vœux innocents;	Berecinte avouons que les Dieux tous puissants Rendent le Roy sensible à nos vœux innocents;
Et comblent mes deſirs de toute leur attente En vous tirant des fers pour vous rendre contente.	Et comblent mes désirs de toute leur attente En vous tirant des fers pour vous rendre contente.
BERECINTE.	BÉRECINTE.
Il eſt trop vray, Seigneur, que ma captiuité M’anime à ſoupirer apres la liberté;	Il est trop vrai, Seigneur, que ma captivité M'anime à soupirer après la liberté;
Il eſt vray que l’amour qui veut rompre mes chaînts Doit changer en plaiſirs la rigueur de mes peines;	Il est vrai que l'amour qui veut rompre mes chaînts Doit changer en plaisirs la rigueur de mes peines;
Le cruel ſouuenir qui me vient chaque iour De la mort de mon pere, & viure en cette Cour, Eſt vn digne ſujet d’animer mon courage A chercher les moyens de ſortir d’eſclauage:	Le cruel souvenir qui me vient chaque jour De la mort de mon père, et vivre en cette Cour, Est un digne sujet d'animer mon courage A chercher les moyens de sortir d'esclavage:
Mais ie ne puis celer par vn preſſentiment, Que ie crains la ſurpriſe en ce prompt changement Et que nous croyans eſtre au comble de la joye, D’vn mal-heur déguiſé nous deuenions la proye.	Mais ici ne puis celer par un pressentiment, Que je crains la surprise en ce prompt changement Et que nous croyant avoir au comble de la joie, D'un malheur déguisé nous devenions la proie.
Doriman eſt ſubtil, & l’intereſt du Roy Le portera ſans doute à vous manquer de foy;	Doriman est subtil, et l'intérêt du Roi Le portera sans doute à vous manquer de foi;
Le refus que ce Prince a toûjours fait paroiſtre, Eſt vn grand prejugé pour le faire connoiſtres Ne vous ſouuient-il plus de ces emportemens Où le Roy furieux vous dit ſes ſentimens?	Le refus que ce Prince a toujours fait paraître, Est un grand préjugé pour le faire connaîtrez Ne vous souvient-il plus de ces emportements Où le Roi furieux vous dit ses sentiments?
Lors que vous le prentez de ſinil voitre peine, Vous viſtes ſon refus qui declaroit ſa haine;	Lors que vous le prentez de sinil être peine, Vous vîtes son refus qui déclarait sa haine;
Ne vous flattez donc pas d’obtenir ſon adueu, Quand ils taſchent tous deux d’éteindre noſtre feu.	Ne vous flattez donc pas d'obtenir son aveu, Quand ils tâchent tous deux d'éteindre notre feu.
PTOLOME'E, C’eſt vn peu trop, Madame, auoir de defiance, Ie dois à Doriman toute mon eſperance, Et le Roy qui n’agit que par ſes ſeuls aduis, Voudra bien qu’vne fois pour nous ils ſoient ſuiuis.	PTOLOME'E, C'est un peu trop, Madame, avoir de défiance, Je dois à Doriman toute mon espérance, Et le Roi qui n'agit que par ses seuls avis, Voudra bien qu'une fois pour nous ils soient suivis.
Vn ſemblable ſoupçon, eſt pour eux vne injure;	Un semblable soupçon, est pour eux une injure;
Il faut eſperer mieux en cette conjoncture:	Il faut espérer mieux en cette conjoncture:
Mais Doriman paroiſt, finiſſons ce diſcours, Parlons de la faueur que nous rend ſon ſecours.	Mais Doriman paraît, finissons ce discours, Parlons de la faveur que nous rend son secours.
SCENE II.	SCÈNE II.
ais PTOLOMEE, BERECEINTE, DORIMAN, LVCIAN.	ais PTOLOME, BERECEINTE, DORIMAN, LUCIAN.
PTOLOMEE.	PTOLOMEE.
Vous par qui l’amour reçoit tant d’aduantages, O Qui releuant nos cœurs, animez nos courages, Que deuõs-nous vous rendre apres tant de bien-ſaits?	Vous par qui l'amour reçoit tant d'avantages, Ô Qui relevant nos cœurs, animez nos courages, Que devons-nous vous rendre après tant de bienfaits?
Peut-on ſouhaiter plus pour eſtre ſatisfaits?	Peut-on souhaiter plus pour être satisfaits?
Ie dois pour Doriman ſacrifier ma vie, Verſer pour luy mon ſang, ſa vertu m’y conuie:	Je dois pour Doriman sacrifier ma vie, Verser pour lui mon sang, sa vertu m'y convie:
Ouy genereux amy, l’amour pour mon bon-heur Doit à voſtre amitié la moitié de mon cœur.	Oui généreux ami, l'amour pour mon bonheur Doit à votre amitié la moitié de mon cœur.
DORIMAN.	DORIMAN.
Seignenr, parler ainſi, c’eſt vouloir me confondre, A vos ciuilitez ie ne ſçay que reſpondre, L’honneur de vous ſeruir eſt le prix que i’attens, Ie ſuis recompenſé ſi vous viuez contens:	Seignenr, parler ainsi, c'est vouloir me confondre, À vos civilités ie ne sais que répondre, L'honneur de vous servir est le prix que j'attends, Je suis récompensé si vous vivez contents:
Mais ceſſons ce diſcours pour épargner ma honte, Il faut pour vn grãd Prince vne action plus prompte.	Mais cessons ce discours pour épargner ma honte, Il faut pour un grand Prince action plus prompte.
Soyez pourtant certain qu’en toute occaſion Mon cœurn'aura point part à ma confuſion:	Soyez pourtant certain qu'en toute occasion Mon cœurn'aura point part à ma confusion:
Vous deuriez deſia jouyr de voſtre flame, Le temps que vous perdez le reproche à mon ame;	Vous devriez déjà jouir de votre flamme, Le temps que vous perdez le reproche à mon âme;
Mais le Roy que ie quitte a promis qu’en ce iour On voiroit l’amitié couronner voſtre amour.	Mais le Roi que je quitte a promis qu'en ce jour On voirait l'amitié couronner votre amour.
PTOLOMEE, ſe tournant vers Berecinte, Madame, nous peut-on monſtrer plus de franchiſe?	PTOLOME, se tournant vers Berecinte, Madame, nous peut-on montrer plus de franchise?
Peut-on pour nous plus faire apres cette entrepriſe?	Peut-on pour nous plus faire après cette entreprise?
Allons ſans perdre temps en rendre grace aux Dieux, Puis qu’aujourd’huy le Roy doit accomplir nos vœux.	Allons sans perdre temps en rendre grâce aux Dieux, Puis qu'aujourd'hui le Roi doit accomplir nos vœux.
Et vous de qui depend toute noſtre eſperance, Continuez de grace à nous rendre aſſiſtance.	Et vous de qui dépend toute notre espérance, Continuez de grâce à nous rendre assistance.
DORIMAN.	DORIMAN.
N’en doutez point, Seigneur, aſſeurez-vous en moy Et ie mourray plutoſt que vous manquer de foy.	N'en doutez point, Seigneur, assurés-vous en moi Et ici mourrai plutôt que vous manquer de foi.
SCENE III.	SCÈNE III.
DORIMAN, LVCIAN.	DORIMAN, LUCIAN.
LVCIAN.	LUCIAN.
jOus ne ſçauriez, Seigneur, témoigner dauãtage IV Les plus beaux ſentimens de voſtre grand courage.	jOus ne sauriez, Seigneur, témoigner davantage IV Les plus beaux sentiments de votre grand courage.
Ces deux Amants s’en vont de vous ſi ſatisfaits, Quil Iemble que leurs cœurs touchent a leurs ſouhaits;	Ces deux Amants s'en vont de vous si satisfaits, Quil Iemble que leurs cœurs touchent à leurs souhaits;
Il eſt vray que de vous dépend leur Hymenée, Ils vous deuront, Seigneur, cette grande iournée.	Il est vrai que de vous dépend leur Hyménée, Ils vous devront, Seigneur, cette grande journée.
DORIMAN.	DORIMAN.
Ah!	Ah!
que tu connois mal les projects de mon cœur, Quand l’amour de ſes traits s’eſt rendu mon Vainqueur;	que tu connais mal les projects de mon cœur, Quand l'amour de ses traits s'est rendu mon Vainqueur;
Sçais-tu que Bereceinte a captiué mon ame?	Sais-tu que Brèceinte a captivé mon âme?
Sçais-tu que ſes apas ont fait naiſtre ma flame?	Sais-tu que ses appas ont fait naître ma flamme?
Et que mon cœur charmé du prix de ſes beautez, Ne peut ſouffrir qu’vn autre ait ſes felicitez?	Et que mon cœur charmé du prix de ses beautés, Ne peut souffrir qu'un autre ait ses félicités?
Cette feinte amitié que i’ay pour Ptolomée, Eſt vn piege à ſes iours de ma haine enflamee;	Cette feinte amitié que j'ai pour Ptolomée, Est un piège à ses jours de ma haine enflamène;
Apprend qu’il doit perir.	Apprend qu'il doit périr.
LVCIAN.	LUCIAN.
Que dites-vous, Seigneur?	Que dites-vous, Seigneur?
DORIMAN, Vn ſecret iuſqu’icy que t’a caché mon cœur, Et ce iour pour l’Hymen qu’il croit qu’on luy deſtine, Pouſſe tout mon dépit de preſſer ſa ruine;	DORIMAN, Un secret jusqu'ici que t'a caché mon cœur, Et ce jour pour l'Hymen qu'il croit qu'on lui destine, Pousse tout mon dépit de presser sa ruine;
Mrais le te diray tout luiqu'au momdre ihcident, Et de tous mes ſecrets ie te fais confident.	Mrais le te dirai tout luiqu'au Princes ihcident, Et de tous mes secrets ie te fais confident.
LVCIAN.	LUCIAN.
De ces graces, Seigneur, ie me connois indigne;	De ces grâces, Seigneur, je me connais indigne;
Mais ma fidelité.	Mais ma fidélité.
DORIMAN.	DORIMAN.
Ie ſçay qu’elle eſt inſigne.	Je sais qu'elle est insigne.
Apprend donc Lucian que la haine & l’amour, Fauoriſent tous deux les erimes de ce iour;	Apprend donc Lucian que la haine et l'amour, Favorisent tous deux les erimes de ce jour;
Et pour mieux arriuer à ma haute entrepriſe, Qu’vne lettre en chemin qui doit eſtre ſurpriſe, Eſt le piege tendu pour perdre mon Riual, Qui deſſous de faux traicts luy rend ce iour fatal.	Et pour mieux arriver à ma haute entreprise, Qu'une lettre en chemin qui doit être surprise, Est le piège tendu pour perdre mon Rival, Qui dessous de faux traits lui rend ce jour fatal.
Ie l’ay faite addreſſer au Roy Syphax ſon frere:	Je l'ai faite adresser au Roi Syphax son frère:
Tu ſçais comme le Roy le croit ſon aduerſaire?	Tu sais comme le Roi le croit son adversaire?
Il reſte à dire encor ce que contient l’eſcrit, Pour iuger ſi ma haine en va faire vn proſcript.	Il reste à dire encor ce que contient l'écrit, Pour juger si ma haine en va faire un proscript.
Voicy donc à peu pres leo terines de lu Becere, », Mon Hymen accomply i’oſe tout me promettre, ,, De releuer l’Eſtat du Roy Ly ſimachus, en de gerdre emierement celuy de Seſeucus, p, Dont i’ay juré la mort.	Voici donc à peu près le terines de lu Bécère, ", Mon Hymen accompli j'ose tout me promettre, ,, De releuer Estat du Roy simachus, en de gerdre emierement celui de Seseucus, , Dont ay juré la mort.
LVCIAN.	LUCIAN.
O Dieux!	Ô Dieux!
quelle ſurpriſe Doit receuoir le Roy d’vne telle entrepriſe!	quelle surprise Doit recevoir le Roi d'une telle entreprise!
DORIMAN.	DORIMAN.
Ie ne t’ay pas tout dit, la Lettre porte plus;	Je ne t'ai pas tout dit, la Lettre porte plus;
Qu’il veut vanger la mort du Roy Lyſimachus, Affermir ſon amour des coups de la vengeance, A iij Du ſang de Seleucus ſigner ſon Alliance, Qu’il s’eſtoit aſſeuré des plus fermes guerriers, Que Mars auec l’Amour luy ſemoit des lauriers, Qu’auec qu’vn fort party dont il eſtoit le Maiſtre, Ma Ils vniſſent leurs bras pour écraſer le traiſtre, Et fit diligemment ſes troupes auancer Pour punir le tyran qui ſceut les offencer:	Qu'il veut venger la mort du Roi Lysimachus, Affermir son amour des coups de la vengeance, A jà Du sang de Seleucus signer son Alliance, Qu'il s'était assuré des plus fermes guerriers, Que Mars avec l'Amour lui semait des lauriers, Qu'avec fort parti dont il était le Maître, Ma Ils Ma Ils bras leurs braser le traître, Et fit diligemment ses troupes avancer Pour punir le tyran qui sut les offenser:
Iuge s’il doit perir apres ce ſtratageme, S’il ſe peut garantir de ce peril extreme;	Juge s'il doit périr après ce stratagème, S'il se peut garantir de ce péril extrême;
De la Lettre vn des ſiens doit eſtre le Porteur, Et i’ay ſceu Lucian.	De la Lettre un des siens doit être le Porteur, Et j'ai su Lucian.
LVCIAN.	LUCIAN.
nadiomudon tous point peur.	nadiomudon tous point peur.
Se	Se
DORIMAN.	DORIMAN.
Dequoy peur Lucian, luy meſme a fait la lettre?	Dequoy peur Lucian, lui mesme a fait la lettre?
LVCIAN.	LUCIAN.
Cela n’eſt pas aſſez, pouuez-vous vous promettre Qu’il vous ſera fidele à garder le ſecret?	Cela n'est pas assez, pouvez-vous vous promettre Qu'il vous sera fidèle à garder le secret?
DORIMAN.	DORIMAN.
Si i’oſois m’y fier ie ſerois indiſcret.	Si j'osais m'y fier ici serais indiscret.
Afin de mieux t’inſtruire & tout te faire entendre, C’eſt dedans vn paſſage où l’on le doit ſurprendre:	Afin de mieux t'instruire et tout te faire entendre, C'est dedans un passage où l'on le doit surprendre:
Tu ſçais que ſous ces murs Pon s’aſſemble demain;	Tu sais que sous ces murs Pon s'assemble demain;
Que l’armee eſt mandée exprés pour ce deſſein;	Que l'armée est mandée exprès pour ce dessein;
Ie ne te cele point que c’eſt par mon addreſſe Pour arriuer au poinct d’épouſer la Princeſſe Que i’ay fait deſirer vne reueuë au Roy Pour vn project de guerre & qu’il n’a dit qu’à moy.	Je ne te cèle point que c'est par mon adresse Pour arriver au point d'épouser la Princesse Que j'ai fait désirer une reueuë au Roi Pour un project de guerre et qu'il n'a dit qu'à moi.
T’en dire dauantage, il n’eſt pas neceſſaire, La ſuite t’inſtruira de ce qui ſe doit faire:	T'en dire davantage, il n'est pas nécessaire, La suite t'instruira de ce qui se doit faire:
Il ſuffit de ſçauoir que l’armee en ces lieux Eſt vn dernier moyen d’accomplir tous mes vœux, Et qu’vn party déja, dont i’ay la foy pour gage, Le porteur de la lettre attend à ce paſſage:	Il suffit de savoir que l'armée en ces lieux Est un dernier moyen d'accomplir tous mes vœux, Et qu'un parti déjà, dont j'ai la foi pour gage, Le porteur de la lettre attend à ce passage:
Par les meſmes Soldats conduit à Seleucus, Loin de luy rien nier, il doit eucor dire plus;	Par les mêmes Soldats conduit à Seleucus, Loin de Se rien nier, il doit eucor dire plus;
Tous gagneront le camp, ſa lettre apres rendue, C’eſt la qu’il doit peril, ou la ſlort attendue.	Tous gagneront le camp, sa lettre après rendue, CAMP est la qu'il doit péril, ou la slort attendue.
LVCIAN.	LUCIAN.
je, Mais ne craignez vous point qu’on le faſſe arreſter?	Je, Mais ne craignez -vous point qu'on le fasse arrêter?
DORIMAN.	DORIMAN.
I’ay ſçeu preuoir le coup qu’il falloit éuiter;	J'ai su prévoir le coup qu'il fallait éviter;
Voy donc ſi d’vn Riual ie dois croire la perte, Lors que loccanon d vi des nens Meiconerre;	Vois donc si d'un Rival te dois croire la perte, Lors que loccanon d ès des nens Méiconerre;
Qu'en penſe-tu?	Qu'en pense-tu?
LVCIAN.	LUCIAN.
Seigneur, c’eſt vn homme perdu, Pour aduancer ſa mort le piege eſt bien tendu, Seleucus dont l’eſprit eſt plein de defiunce Le va faire arreſter pour eſtre en aſſeurance, Et ne manquera pas apres vn tel rapport De l’enuoyer coupable, ou ſans crime à la mort:	Seigneur, c'est un homme perdu, Pour avancer sa mort le piège est bien tendu, Seleucus dont l'esprit est plein de défiunce Le va faire arrêter pour être en assurance, Et ne manquera pas après un tel rapport De l'envoyer coupable, ou sans crime à la mort:
Mais ne pouuiez-vous point ſans luy faire vne injure;	Mais ne pouviez-vous point sans avoir faire un injure;
Iouïr de voſtre amour que par cette impoſture?	Jouir de votre amour que par cette imposture?
Vous offre les moyens d’aſſeurer voſtre amour;	Vous offre les moyens d'assurer votre amour;
Voſtre Riual eſt foible auprés de vos puiſſances, Et tout Prince qu'Ireit, ou lont les elperences;	Votre Rival est faible auprès de vos puissances, Et tout Prince qu'Ireit, ou lont les elperences;
Que peut-il obtenir auec ſa grandeur Quand il n’a de ſouſtient que de voſtre faueur, Et qu’il attend de vous le fruict de ſa conqueſte?	Que peut-il obtenir avec sa grandeur Quand il n'a de soutient que de votre faveur, Et qu'il attend de vous le fruit de sa conquête?
DORIMAN.	DORIMAN.
Tu iuge mal du coup qui menaçoit ma teſte, L’amour a des reſſorts, & pour les preuenir, Il faut perdre vn Riual qui peut tout obtenir:	Tu juge mal du coup qui menaçait ma tête, L'amour a des ressorts, et pour les prévenir, Il faut perdre un Rival qui peut tout obtenir:
Berecinte & le Prince ont fait voir dans leurs ames Trop de force d’amour pour eſteindre leurs flames, Pour en venir à bout, il faut les ſeparer, Ie n’ay que cette voïe à pouuoir l’eſperer;	Berecinte et le Prince ont fait voir dans leurs âmes Trop de force d'amour pour éteindre leurs flammes, Pour en venir à bout, il faut les séparer, Je n'ai que cette voïe à pouvoir l'espérer;
Le feu qui les conſume a monſtré ſa puiſſance, Il faut pour l’arreſter courir à la vengeance, Mon amour m’y contraint, ma haine le pretend, Vn reſte de pitié ſeulement les deffend;	Le feu qui les consume a montré sa puissance, Il faut pour l'arrêter courir à la vengeance, Mon amour m'y contraint, ma haine le prétend, Un reste de pitié seulement les défend;
Mais les charmans plaiſirs qui flattent ma penſee.	Mais les charmants plaisirs qui flattent ma pensée.
Ont pour y paruenir mon ame trop preſſee, Qui pour mieux s’oppoſer à l’Hymen de ce iour, Veut chercher dans la haine à ſeruir mon amour.	Ont pour y parvenir mon âme trop presse, Qui pour mieux s'opposer à l'Hymen de ce jour, Veut chercher dans la haine à servir mon amour.
Le ſort en eſt jetté, rien ne m’en peut deffendre, Quand l'amour eſt le maiſtre, il peut tout entreprendre, Luy mort, elle eſt à moy, c’eſt là ſon intereſt.	Le sort en est jeté, rien ne m'en peut défendre, Quand l'amour est le maître, il peut tout entreprendre, Lui mort, elle est à moi, c'est là son intérêt.
LVCIAN.	LUCIAN.
Finiſſez ce diſcours, la Reine ici paraiſt, Ie dois me retirer, Seigneur que vous en ſemble?	Finissez ce discours, la Reine ici paraît, Je dois me retirer, Seigneur que vous en semble?
DORIMAN, bas.	DORIMAN, bas.
Cet abord me ſurptend.	Cet abord me surptend.
Va, laiſſc-nous enſemble, Quel ſujet donc l’ameine & l’oblige à venir.	Va, laissc-nous ensemble, Quel sujet donc l'amène et l'oblige à venir.
LA REYNE, DORIMAN, PAVLINE.	LA REINE, DORIMAN, PAULINE.
LA REYNE.	LA REINE.
IE cherche Doriman à vous entretenir.	JE cherche Doriman à vous entretenir.
ISans faire vn long diſcours, ie ſçay d’experience, Combien en cette Cour vous auez de puiſſance, Que le Roy pour agir prend & ſuit vos aduis;	JSans faire un long discours, je sais d'expérience, Combien en cette Cour vous avez de puissance, Que le Roi pour agir prend et suit vos avis;
Faites auprés de luy que les miens ſoient ſuiuis.	Faites auprès de mains que les miens soient suivis.
Ie veux de Berecinte accomplir l’Hymenée, Pour elle fa parole à ce iour m’eſt donnée, Il veut le differer, ce changement ſoudain Me fait croire aujourd’huy qu’il change de deſſein:	Je veux de Berecinte accomplir l'Hyménée, Pour elle fa parole à ce jour m'est donnée, Il veut le différer, ce changement soudain Me fait croire aujourd'hui qu'il change de dessein:
Ie dois à Ptolomée encor rendre vn office, C’eſt de voſtre credit qu'irtienura ce ferdiée;	Je dois à Ptolomée encor rendre un office, C'est de votre crédit qu'irtienvra ce ferdiée;
Auprés de Seleucus appuyez donc ſes vœux, D’vn Hymen qu’il attend, faites joindre les nœuds.	Auprès de Seleucus appuyez donc ses vœux, D'un Hymen qu'il attend, faites joindre les nœuds.
DORIMAN.	DORIMAN.
Quel ſentiment, Madame, a donc pû vous ſeduire?	Quel sentiment, Madame, a donc pu vous séduire?
A quel comble de maux voulez-vous nous reduire?	À quel comble de maux voulez-vous nous réduire?
Acheuant cét Hymen, c’eſt agir contre nous, Et de tous les mal-heurs, nous attirer les coups.	Achevant cet Hymen, c'est agir contre nous, Et de tous les malheurs, nous attirer les coups.
La Politique veut qu’à tout on prenne garde;	La Politique veut qu'à tout on prenne garde;
Qu'on ne riſque iamais dans ce qui nous regarde;	Qu'on ne risque jamais dans ce qui nous regarde;
On prend ſes ſeuretez, on voit dans l’aduenir, On braue les hazards que l’on ſçait preuenir:	On prend ses sûretés, on voit dans l'avenir, On brave les hasards que l'on Sait prévenir:
Ouy l’Hymen de ce Prince auec Berecinte Va donner d’vne guerre vne premiere atteinte, Expoſer cét Empire aux injures du ſort, Et nous donner en proye aux rigueurs de la mort.	Oui l'Hymen de ce Prince avec Berecinte Va donner d'une guerre une première atteinte, Exposer cet Empire aux injures du sort, Et nous donner en proie aux rigueurs de la mort.
Car ne preſumez pas que le treſpas d’vn pere, S’efface dvn grand cœur qui veut ſe ſatisfaire, Que la perte d’vn Troſne auec ſes Eſtats, Soient de foibles ſoupçons pour ne la garder pas;	Car ne présumez pas que le trépas d'un père, S'efface donc grand cœur qui veut se satisfaire, Que la perte d'une Trône avec ses États, Soient de faibles soupçons pour ne la garder pas;
Croyez-vous que ce Prince eſpouſant la Princeſſe, Ne vange pas ſon pere où l’amour l’intereſſe, Et qu’vn Sceptre perdu, dont ſon ſang eſt jaloux, Ne ſerue de motif pour armer contre nous?	Croyez-vous que ce Prince épousant la Princesse, Ne venge pas son père où l'amour l'intéresse, Et qu'un Sceptre perdu, dont son sang est jaloux, Ne serve de motif pour armer contre nous?
Ouy, ouy l’eſprit du Prince ayme trop la vengeance Pour ne pas ſe porter à la derniere offence;	Oui, oui l'esprit du Prince aime trop la vengeance Pour ne pas se porter à la dernière offense;
Peut-eſtre que déja dans ſes nouueaux projets, Il nous conte ſans nous au rang de ſes ſujets, Et peut-eſtre flaté de cette vaine gloire, Il attend cét Hymen pour ſuiure ſa victoire;	Peut-être que déjà dans ses nouveaux projets, Il nous conte sans nous au rang de ses sujets, Et peut-être flatté de cette vaine gloire, Il attend cet Hymen pour suivre sa victoire;
Pour mieux nous garantir, Madame oppoſons-nous, Empeſchons cét Hymen par vn juſte courroux, Employons noſtre force à garder la Princeſſe, N’eſcoutons plus tous deux contre nous la tendreſſe:	Pour mieux nous garantir, Madame opposons-nous, Empêchons cet Hymen par un juste courroux, Employons notre force à garder la Princesse, N'écoutons plus tous deux contre nous la tendresse:
C’eſt vn puiſſant ſupport pour nous que ſes appas, A l’abry de ces coups nous gardons vos Eſtats, Et l’amour de ce Prince auprés de tant de charmes, Doit par vn contre-coup nous ſeruir de ſes armes;	C'est un puissant support pour nous que ses appas, À l'abri de ces coups nous gardons vos États, Et l'amour de ce Prince auprès de tant de charmes, Doit par un contre-coup nous servir de ses armes;
Iugez ſur ces raiſons ſi l’on doit conſentir Au traité d’vn Hymen pour nous en repentir, S’il ne faut pas vous-meſme empeſcher la ſurpriſe, Qu'vne injuſte pitié contre nous authoriſe.	Jugez sur ces raisons si l'on doit consentir Au traité d'une Hymen pour nous en repentir, S'il ne faut pas vous-même empêcher la surprise, Qu'une injuste pitié contre nous autorise.
LA REYNE.	LA REINE.
Il ſuffit, vos raiſons me découurent aſſez Comme pour nous vos ſoins ſont fort intereſſez:	Il suffit, vos raisons me découvrent assez Comme pour nous vos soins sont fort intéressez:
Mais vos precautions n’ont point de vrai-ſemblance Et voſtre politique a trop de deffiance.	Mais vos précautions n'ont point de vraisemblance Et votre politique a trop dé fiance.
La puiſſance du Roy ne ſe limite point, Elle eſleue aujourd’huy ſa gloire au plus haut point, Et les fronts couronnez viennent par leur hommage Confeſſer ſa grandeur, ſa force & ſon courage;	La puissance du Roi ne se limite point, Elle élève aujourd'hui sa gloire au plus haut point, Et les fronts couronnés viennent par leur hommage Confesser sa grandeur, sa force et son courage;
C’eſt donc mal prejuger des maux que vous craignez Lors que contre ſon bras vous ſeul les ſouſtenez.	C'est donc mal préjuger des maux que vous craignez Lors que contre son bras vous seul les soutenez.
Oüy, oüy, c’eſt s’oppoſer aux forces de l’Empire, Quand vos foibles raiſons n’y veulent pas ſouſcrires Les projets de ce Prince ont leur but dans l'amour, Il borne ſes deſſeins dans l’Hymen de ce iour;	Oui, oui, c'est s'opposer aux forces de l'Empire, Quand vos faibles raisons n'y veulent pas souscrirez Les projets de ce Prince ont leur but dans l'amour, Il borne ses desseins dans l'Hymen de ce jour;
Ce n’eſt qu’à cebon-heur que tend ſon entrepriſe, Son cœur eſt ſatisfait ſi le Roy l'authoriſe;	Ce n'est qu'à cebonheur que tend son entreprise, Son cœur est satisfait si le Roi l'autorise;
Ne refuſez donc pas ſecours à ces Amans, Sous l'adueu d’vn ſoupçon contre mes ſentimens;	Ne refusez donc pas secours à ces Amants, Sous l'aveu d'un soupçon contre mes sentiments;
Accordez voſtré appuy ſans plus de reſiſtance;	Accordez vostré appui sans plus de résistance;
D'vn grand cœur rebuté craignons la violence;	D'un grand cœur rebuté craignons la violence;
Berecinte en ces lieux peut cauſer des mal-heurs Dont vn ſecret caché fait naiſtre mes douleurs;	Berecinte en ces lieux peut causer des malheurs Dont un secret caché fait naître mes douleurs;
Croyez-vous que ce Prince, apres tant de remiſes, Apres tant de deſtours, de refus, de ſurpriſes, Ne ſe portera point au dernier deſeſpoir, Et ne monſtrera pas ſon funeſte pouuoir?	Croyez-vous que ce Prince, après tant de remises, Apres tant de détours, de refus, de surprises, Ne se portera point au dernier désespoir, Et ne montrera pas son funeste pouvoir?
Et pouſſant ſa fureur iuſques au parricide Du ſang de Seleucus il ne deuienne auide?	Et poussant sa fureur jusques au parricide Du sang de Seleucus il ne devienne aujde?
C’eſt cela qu’il faut craindre, & non pas vos raiſons, Qui ne découurent point ces dangereun pollens;	C'est cela qu'il faut craindre, et non pas vos raisons, Qui ne découvrent point ces dangereun pollens;
Quand l'amour a tout fait, qu’il n’a plus que la rage, Il peut deſſus le Troſne acheuer ſon outragé, Et meſpriſant la vie, en donnant tout au ſort, riſe, Peut trouuer dans ſa perte à nous donner la mort.	Quand l'amour a tout fait, qu'il n'a plus que la rage, Il peut dessus le Trône achever son outragé, Et méprisant la vie, en donnant tout au sort, rise, Peut trouver dans sa perte à nous donner la mort.
Euitons ce danger, acheuons l’Hymenée, Enuoyons ces Amans apres leur deſtinée, peur demeure cle tuturey ce lulle eune bulncer;	Euitons ce danger, achevons l'Hyménée, Envoyons ces Amants après leur destinée, peur demeure clé turei ce lulle eune bulner;
Pour eſtre ſatisfaite il faut les deuancer.	Pour être satisfaite il faut les devancer.
DORIMAN.	DORIMAN.
Vous le voulez, Madame, il faut vous ſatisfaire, Ie vais trouuér le Roy de ce pas pour vous plaire, Taſcher que dans ce iour ces Amans ſoient heureux, Acheuant leur Hymen qui couronne leurs vœux:	Vous le voulez, Madame, il faut vous satisfaire, Je vais trouver le Roi de ce pas pour vous plaire, Tâcher que dans ce jour ces Amants soient heureux, Achevant leur Hymen qui couronne leurs vœux:
Mais plurtont le porter a fuil cette miymence, bas.	Mais plurtont le porter a fuil cette mimence, bas.
A perdre mon Riual qui fait ma deſtinée.	À perdre mon Rival qui fait ma destinée,
SCENE V.	SCÈNE V.
LA REYNE, PAVLIN	LA REINE, PAULIN
LA REYNE.	LA REINE.
Ve mon eſprit, Pauline, a d’eſtranges ennuis, Que ie le ſents troublé dans l’eſtat où ie ſuis, Berecinte en ces lieux eſt l'objet de ma haine, Sa preſence eſt icy la cauſe de ma peine, Elle porte mon cœur au dernier deſeſpoir, Ie voudrois m’en venger, & ie ſuis ſans pouuoir:	Ve mon esprit, Pauline, a d'étranges ennuis, Que était le sents troublé dans l'état où tu suis, Berecinte en ces lieux est l'objet de ma haine, Sa présence est ici la cause de ma peine, Elle porte mon cœur au dernier désespoir, Je voudrais m'en venger, et deux suis sans pouvoir:
Il faut pour me ſeruir vſer de ſtratageme, Il faut agir pour elle, & me trahir moy-même;	Il faut pour me servir user de stratagème, Il faut agir pour elle, et me trahir moi-même;
Dure loy de mon ame, à quoy me reduis-tu?	Dure loi de mon âme, à quoi me réduis-tu?
De combien de deſirs mon cœur eſt combatu:	De combien de désirs mon cœur est combattu:
Mais enfin acheuons de ſeruir ma Riuale, Par d’indignes moyens où mon ſort me rauale, 2 Vengeons-nous d’vn Eſpoux qui me manque de foy, Qui met toute ſa gloire à viure ſous ſa loy;	Mais enfin achevons de servir ma Rivale, Par d'indignes moyens où mon sort me ravale, 2 Vengeons-nous d'un Époux qui me manque de foi, Qui met toute sa gloire à vivre sous sa loi;
Qui n’a que des meſpris à preſent pour ſa femme, mais Pour eſtre preuenu de ſa nouuelle flame.	Qui n'a que des mépris à présent pour sa femme, mais Pour être prévenu de sa nouvelle flamme.
Qu’il eſt rude, Pauline, apres des feux ſacrez, De les voir preſque eſteints, & d’autres preferez!	Qu'il est rude, Pauline, après des feux sacrés, De les voir presque éteints, et d'autres préférez!
De voir que Seleucus n’ayme que Bereceinte!	De voir que Seçucus n'aime que Bereceinte!
Qu’elle a tout ſon amour, d’où naiſt ma juſte plainte auc eroyant aujourd nuy l’obitacie à ieurs deſirs, Et de haine & d’amour i’en pouſſe des ſoupirs.	Qu'elle a tout son amour, d'où naît ma juste plainte auc eroyant aujourd nui 'obitacie à jeurs désirs, Et de haine et d'amour j'en pousse des soupirs.
PAVLINE.	PAULINE.
Quel fondement, Madame, à voſtre defiance?	Quel fondement, Madame, à votre défiance?
Quel eſt voſtre raiſon pour y donner croyance?	Quel est notre raison pour y donner croyance?
I’ay touſiours veu le Roy vous porter tant d’amour Qu'on lle dort puo penrer qu'i le quicee en vn jour.	J'ai toujours vu le Roi vous porter tant d'amour Qu'on lèle dort puo penrer qu'y le quicée en un jour.
LA REYNE.	LA REINE.
Ce n’eſt pas d’aujourd’huy qu’il ayme la Princeſſe	Ce n'est pas d'aujourd'hui qu'il aime la Princesse
PAVLINE.	PAULINE.
Croyez-vous de l’amour où ce n’eſt que tendreſſe?	Croyez-vous de l'amour où ce n'est que tendresse?
Ce qu’il rend à ſon rang, c’eſt par ciuilité, Que i’impute au reſpect, non pas à ſa beauté.	Ce qu'il rend à son rang, c'est par civilité, Que j'impute au respect, non pas à sa beauté.
LA REYNE.	LA REINE.
Ah!	Ah!
que tu connois mal les projets de ſon ame!	que tu connais mal les projets de son âme!
Ah!	Ah!
que tu connois mal les ſecrets de ſa flame!	que tu connais mal les secrets de sa flamme!
I’ay crû que ton eſprit penetroit plus auant, Que tu ſçauois connoiſtre vn reſpect deceuant Que la ciuilité couure de bien-ſeance Pour oſter à ſes feux toute leur apparence.	J'ai cru que ton esprit pénétrait plus avant, Que tu savais connaître un respect décevant Que la civilité couvre de bienséance Pour ôter à ses feux toute leur apparence.
Que le mien ſçait bien mieux penetrer dans vn cœut Qu’vne flame maiſtriſe, où l’amour eſt vainqueur!	Que le mien sait bien mieux pénétrer dans un cœut Qu'une flamme maîtrise, où l'amour est vainqueur!
Quelque diſſimulé qu’il nous puiſſe paroiſtre, Quand il eſt épié, qui veut le peut connoiſtre.	Quelque dissimulé qu'il nous puisse paraître, Quand il est épié, qui veut le peut connaître.
L’artifice du Roy pour me cacher ſes feux, Eſt vne forte preuue à ne point douter d’eux;	L'artifice du Roi pour me cacher ses feux, Est une forte preuve à ne point douter d'eux;
Cette prompté retraite auſſi-toſt qu’il ma veuë, Qu’il quite Berecinte à ma feule venue, Aux eſprits les plus forts feroit croire ayſement Que l’entretien qu’il ceſſe eſt vn élolgnement;	Cette prompté retraite aussitôt qu'il ma vue, Qu'il quite Berecinte à ma feule venue, Aux esprits les plus forts ferait croire aisément Que l'entretien qu'il cesse est un élolgnement;
Mais de quelque couleur que ſe couure ſa flame, De quelques mouuemens qu’il déguiſe ſon ame, Apprend que de l’amour ſe ſont les vrays reſſorts, Qui cachent le dedans & monſtrent le dehors;	Mais de quelque couleur que se couvre sa flamme, De quelques mouvements qu'il déguise son âme, Apprend que de l'amour se sont les vrais ressorts, Qui cachent le dedans et montrent le dehors;
Tu croirois qu’vn depit qu’vne rigueur enflame, Seroit le deſaueu de l’amour de noſtre ame;	Tu croirais qu'un dépit qu'une rigueur enflamme, Serait le désaveu de l'amour de notre âme;
Que ſous cette apparence vn cœur ceſſe d’aymer, Quand contre ſa nature il ſert à l’enflamer;	Que sous cette apparence un cœur cesse d'aimer, Quand contre sa nature il sert à l'enflammer;
Ainſi que le braſier d’vne fournaiſe ardente, En y verſant de l’eau rend l’ardeur plus brûlante, Et dans l’antipatie où ſont ces elemens, Pour trop eſtre oppoſez, font des redoublemens.	Ainsi que le brasier d'une fournaise ardente, En y versant de l'eau rend l'ardeur plus brûlante, Et dans l'antipatie où sont ces éléments, Pour trop être opposez, font des redoublements.
PAVLINE.	PAULINE.
Ces raiſons n’ont pas lieu d’aſſeoir vne croyance, Ou tout leur rondement a bien peu d’apparence;	Ces raisons n'ont pas lieu d'asseoir une croyance, Ou tout leur rondement a bien peu d'apparence;
Ie vous le dis encor, Seleucus voſtre époux, N’a que pitié pour elle, & qu’amitié pour vous.	Je vous le dis encor, Seleucus votre époux, N'a que pitié pour elle, et qu'amitié pour vous.
LA REYNE.	LA REINE.
Pauline briſons-là, ie ſçay ce qu’il faut croire, Pour ſon propre intereſt autant que pour ma gloire, Et pour de ſon injure interrompre le cours, L’Hymen de Berecinte eſt l’vnique ſecours.	Pauline brisons-là, je sais ce qu'il faut croire, Pour son propre intérêt autant que pour ma gloire, Et pour de son injure interrompre le cours, L'Hymen de Berecinte est l'unique secours.
Allons y trauailler, chaſſons cette Princeſſe, Et rendons à mon cœur ſa premiere allegreſſe.	Allons y travailler, chassons cette Princesse, Et rendons à mon cœur sa première allégresse.
Fin du premier acte.	Fin du premier acte.
ACTE II.	ACTE II.
SCENE PREMIERE.	SCÈNE PREMIÈRE.
LE ROY, DORIMAN.	LE ROY, DORIMAN.
LE ROY.	LE ROY.
Vi l’eut dit, Doriman, apres tant de faueurs, Que iuſqu’à moy ce traiſtre eut pouſſé ſes fu reurs ?	Vi l'eut dit, Doriman, après tant de faveurs, Que jusqu'à moi ce traître eut poussé ses fu reurs ?
Qu’il euſt porté ſon cœur eſpouſant Berecinte, A vouloir de mon ſang que ſa main ſe viſt teinte?	Qu'il eût porté son cœur épousant Berecinte, À vouloir de mon sang que sa main se vît teinte?
Sans les Dieux qui touſiours conſeruent ma Maiſon I’aurois ſenty l’effect de cette trahiſon;	Sans les Dieux qui toujours conservent ma Maison J'aurais senti l'effet de cette trahison;
Il euſt mis mes Eſtats en deſordre au pillage, Et lans aucun coinbat fatisrait à la lage.	Il eût mis mes États en désordre au pillage, Et lans aucun coinbat fatisrait à la ge.
Tu vois pour m’aſſeurer que ce n’eſt qu’en ſa mort, Quę i’eſuite les coups & d’vn traiſtre & du ſort, Tu connois par ſa lettre où va ſa perfidie.	Tu vois pour m'assurer que ce n'est qu'en sa mort, Quę j'évite les coups et d'un traître et du sort, Tu connaître par sa lettre où va sa perfidie.
DORIMAN.	DORIMAN.
Feignons vn ſentiment de luy ſauuer la vie.	Feignons un sentiment de deux sauver la vie.
Pour donner plus de poids à la ſincerité;	Pour donner plus de poids à la sincérité;
Ie ſuis ſurpris, Seigneur, de ſa temerité, bas Mais c’eſt aux grands forfaits qu’eſclatte la clemẽce Et vous excuſerez cette premiere offenſe;	Je suis surpris, Seigneur, de sa témérité, bas Mais c'est aux grands forfaits qu'éclatte la clemẽce Et vous excuserez cette première offense;
Le pardon quelquefois fait plus que la rigueur, Le faiſant repentant, c’eſt regagner ſon cœur;	Le pardon quelquefois fait plus que la rigueur, Le faisant repentant, c'est regagner son cœur;
Encor qu’il euſt iuré de vous oſter la vie, Apres ſon crime abſoû loing d’en auoir enuie, Ses deſirs n’iront plus qu’à reſpandre ſon ſang, Pour reparer ſa faute & reprendre ſon rang.	Encor qu'il eût juré de vous ôter la vie, Après son crime absou loin d'en avoir envie, Ses désirs n'iront plus qu'à répandre son sang, Pour réparer sa faute et reprendre son rang.
LE ROY.	LE ROY.
Mais quoy ne ſçais-tu pas qu’en bonne politique, Les crimes pardonnez ſe tournent en pratique?	Mais quoi ne sais-tu pas qu'en bonne politique, Les crimes pardonnez se tournent en pratique?
Iamais pour la Couronne on ne doit haſarder, Et quiconque le fait ne veut pas la garder.	Jamais pour la Couronne on ne doit hasarder, Et quiconque le fait ne veut pas la garder.
Les termes de ſa lettre ont monſtré ſon audace, Et ie dois par ſa mort preuenir ſa menace.	Les termes de sa lettre ont montré son audace, Et tu dois par sa mort prévenir sa menace.
La Reine adroitement fait enqueſte ſous main, S’il eſt ſeul à tramer ſon perfide deſſein;	La Reine adroitement fait enquête sous main, S'il est seul à tramer son perfide dessein;
Ie veux auecque luy punir tous ſes complices, Qu’ancun pour me vanger n’eſchape des ſupplices, Et mon ordre eſt donné de l’amener icy;	Je veux avec deux punir tous ses complices, Qu'ancun pour me venger n'échappe des supplices, Et mon ordre est donné de l'amener ici;
La Reine que i’attends le doit.	La Reine que j'attends le doit.
mais le voicy-	mais le voici-
DORIMAN.	DORIMAN.
Teſmoignons prendre part aux mal-heurs qui le prelſent, bas.	Témoignons prendre part aux malheurs qui le prèslsent, bas.
Où pour le mieux trõper mes yeux ſeuls s’intereſſent.	Où pour le mieux tréper mes yeux seuls s'intéressent.
SCENE II.	SCÈNE II.
LE ROTJTTOEUMEE, DORIMAN.	LE ROTJTTOEUMEE, DORIMAN.
LE ROY.	LE ROY.
E bien Prince auez vous reſolu mon treſpas?	E bien Prince avez -vous résolu mon trépas?
I TAuez-vous reſolu de perdre mes Eſtats?	I TAvez-vous résolu de perdre mes États?
TOLOMEE.	TOLOME.
Que dites-vous, Seigneur?	Que dites-vous, Seigneur?
LE ROY.	LE ROY.
Ce diſcours vous eſtonne?	Ce discours vous étonne?
Et vous ne craignez pas d’attaquer ma perſonne?	Et vous ne craignez pas d'attaquer ma personne?
PTOLOMEE.	PTOLOMEE.
Moy, Seigneur, moy penſer.	Moi, Seigneur, moi penser.
LE ROY.	LE ROY.
Ie ſçay voſtre deſſein, B ij.	Je sais votre dessein, B ij.
Il donne vne Lettr Mais liſez & voyez, & l’eſcrit & la main.	Il donne une Lettr Mais lisez et voyez, et l'écrit et la main.
Il ti Parlant à Dorima Regarde ſon viſage, il change & deuient bleſme, Sans doute il eſt coupable, & s’accuſe luy-mefme Sa mort pour me deffendre eſt l’vnique ſecours.	Il ty Parlant à Dorima Regarde son visage, il change et devient blême, Sans doute il est coupable, et s'accuse lui-même Sa mort pour me défendre est l'unique secours.
DOREMRAIO.	DOREMRAIO.
Pourroit-il en vouloir, à l’Eſtat, à vos iours?	Pourrait-il en vouloir, à l'État, à vos jours?
LE ROY, parlant à Ptolomée.	LE ROY, parlant à Ptolomée.
Hé bien cette lecture eſt-elle conuainquante?	Hé bien cette lecture est-elle convainquante?
Accuſe-t’elle aſſez, vos ſouhaits, voſtre attente?	Accuse-t-elle assez, vos souhaits, votre attente?
Enfin de voſtre eſprit ie ſçay la paſſion, na cheute de mon Troſne eſt voſtre ambition;	Enfin de votre esprit ie sais la passion, na chute de mon Trône est vôtre ambition;
Et pour mieux aſſouuir & la haine & la rage, Vous voulez que mon ſang à l’amour faſſe hõmas Pour	Et pour mieux assouvir et la haine et la rage, Vous voulez que mon sang à l'amour fasse hommas Pour
PTOLOMEE.	PTOLOMEE.
Mon eſprit arreſté dans vn eſtonnement, Où cent penſers diuers troublent mon jugement;	Mon esprit arrêté dans un étonnement, Où cent pensers diuers troublent mon jugement;
Ie me trouue coupabie, innocent tout enſemble, Sans que mon cœur ſurpris, conſente que i’en tremble.	Je me trouve coupabie, innocent tout ensemble, Sans que mon cœur surpris, consente que j'en tremble.
D’vn crime conuaincu, cependant innocent, Ie demeure confus pour eſtre trop preſſant;	D'un crime convaincu, cependant innocent, Je demeure confus pour être trop pressant;
Ouy, Seigneur, ie l’aduouë apres voſtre colere.	Oui, Seigneur, je l'avoue après votre colère.
Ie demeure interdit, lors qu’il faut vous déplaire, Les jugemens des Roys, tiennent de ceux des Dieur Ce qu’ils ont aduancé ne peut eſtre douteux, Leur abus aujourd’huy ſemble ſi ſalutaire, Qu’à vous deſabuſer ma mout eſt neceſſaire.	Je demeure interdit, lors qu'il faut vous déplaire, Les jugements des Rois, tiennent de ceux des Dieur Ce qu'ils ont avancé ne peut être douteux, Leur abus aujourd'hui semble si salutaire, Qu'à vous désabuser ma moût est nécessaire.
I’y conſens donc, Seigneur, & n’y repugne pas, On demande mon ſang, auancez mon treſpas;	J'y consens donc, Seigneur, et n'y répugne pas, On demande mon sang, avancez mon trépas;
Mais du faict ſuppoſé touchant la lettre eſcrite, L’impoſture & l’injure où mon ame s’irrite, Luy donnent tant d’effroy que ſa rebellion S’augmente au ſouuemit d'vne telie action.	Mais du fait supposé touchant la lettre écrite, L'imposture et l'injure où mon âme s'irrite, Lui donnent tant d'effroi que sa rébellion S'augmente au souvemit d'une telie action.
De cét horrible ouime où mon mal-heur m’accuſe, lle Pour me iuſtifier ie ne faits point d’excuſe;	De cet horrible ouime où mon malheur m'accuse, lèle Pour me justifier ici ne faits point d'excuse;
Ie laiſſe à vos bontez d’en iuger beaucoup mieux, Si ie ſuis criminel, i’en atteſte les Dieux;	Je laisse à vos bontés d'en juger beaucoup mieux, Si tu suis criminel, j'en atteste les Dieux;
Leur colere m’eſcraſe & me reduiſe en poudre;	Leur colère m'écrase et me réduise en poudre;
Qu’elle me precipite aux Enfers de ſon foudre, Ie me ſoûmets moy-meſme aux rigueurs de ſes coûs, Si ie formay iamais de deſſein contre vous;	Qu'elle me précipite aux Enfers de son foudre, Je me soumets moi-même aux rigueurs de ses cous, Si ici formai jamais de dessein contre vous;
Hé!	Hé!
quoy quelle apparence arriuant à ma joye, Sur le point du bon-heur que la faueur m’enuoye, Dans le temps de jouyr du fruict de mon amour, Que i’attende à trahir cette Cour dans ce iour?	quoi quelle apparence arrivant à ma joie, Sur le point du bonheur que la faveur m'envoie, Dans le temps de jouir du fruit de mon amour, Que j'attende à trahir cette Cour dans ce jour?
Le temps s’accorde mal auec l’impoſture, Peut-on mieux faire voir l’innocence & l’infure?	Le temps s'accorde mal après l'imposture, Peut-on mieux faire voir l'innocence et l'infure?
L’embuſche eſt trop groſſiere auprés des eſclairez, Pour douter de la fourbe où vont mes conjurez.	L'embûche est trop grossière auprès des éclairez, Pour douter de la fourbe où vont mes conjurés.
LE ROY.	LE ROY.
I’ay voulu t’eſcouter auecque patience, Et voir iuſques au bout la derniere arrogance, Du porteur de la lettre, éuadé des priſons, Que me reſpondrasntu:	J'ai voulu t'écouter auecque patience, Et voir jusques au bout la dernière arrogance, Du porteur de la lettre, évadé des prisons, Que me répondrasntu:
quelles ront tes fanſons?	quelles ront tes fansons?
Tu te tais?	Tu te tais?
tu craignois qu’il te ſouſtint ton crime?	tu craignais qu'il te soutint ton crime?
Ah!	Ah!
c’eſt trop retenir vn courroux legitime.	c'est trop retenir un courroux légitime.
Holà, Gardes venez,	Holà, Gardes venez,
DORIMAN.	DORIMAN.
Ah?	Ah?
Seigneur moderez.	Seigneur modérez.
LE ROY, Les Gardes entrants.	LE ROY, Les Gardes entrants.
Qu’on enferme cetruritre, & vous m’en reſpondrez.	Qu'on enferme cetruritre, et vous m'en répondrez.
DORIMAN à Ptolomée.	DORIMAN à Ptolomée.
Ie vais prier ie Roy pour voſtre deliurance;	Je vais prier ie Rince pour vôtre délivrance;
Ne vous eſtonnez pas d’vn peu de violence, Attendez tout de moy, ie vais l’entretenir.	Ne vous étonnez pas d'int peu de violence, Attendez tout de moi, a pais l'entretenir.
PTOLOMEE.	PTOLOMEE.
Vous m’obligez beaucoup.	Vous m'obligez beaucoup.
DORIMAN.	DORIMAN.
Mais c’eſt pour te punir, cuſe Mon amour veur veut ta mort, il faut le ſatisfaire;	Mais c'est pour te punir, cuse Mon amour veu veut ta mort, il faut le satisfaire;
B iij Profitous à propos du temps de ſe colere.	 Bij Profitous à propos du temps de se colère.
SCENE III.	SCÈNE III.
LE ROY, DORIMAN, PTOLOMEE DERECINTES LES GANDES.	LE ROY, DORIMAN, PTOLOME DERECINTES LES GANDES.
BERECINTE, à vn bout du Theatre.	BÉRECINTE, à un bout du Théâtre.
E'!	E'!
que vois-ie grands Dieux!	que vois-je grands Dieux!
quel eſt donc ee EY mal-heur?	quel est donc ce EY malheur?
TTOLOMEE ſortant.	TTOLOME sortant.
Vous me voyez, Madame, accablé de douleur;	Vous me voyez, Madame, accablé de douleur;
Mais les Dieux protecteurs de la haute innocence, De ce noir attentat ſçauront tirer vengeance.	Mais les Dieux protecteurs de la haute innocence, De ce noir attentat sçauront tirer vengeance.
Retenez donc ces pleurs que verſent vos beaux yeux.	Retenez donc ces pleurs que versent vos beaux yeux.
Dans ce mal-heur preſſant, laiſſez agir les Dieux.	Dans ce malheur pressant, laissez agir les Dieux.
BERECINTE.	BÉRECINTE.
Helas!	Hélas!
Prince, ſouffrez que ie verſe des larmes, Pour vous deffendre icy ie n’ay point d’autres armes	Prince, souffrez que ici verse des larmes, Pour vous défendre ic ie j'ai point d'autres armes
PTOLOMEE.	PTOLOMEE.
Vous voir en cét eſtat vous m’arrachez le cœur:	Vous voir en cet état vous m'arrachez le cœur:
C’eſt encor à mes maux vn ſurcroiſt de douleur?	C'est encor à mes maux un surcroît de douleur?
Eſt-ce vous dire aſſez que c’eſt toute ma peine?	Est-ce vous dire assez que c'est toute ma peine?
LE ROY, le voyant arreſté S’il ne veut pas marcher, Gardes que l’on l’entraîne.	LE ROY, le voyant arrêté S'il ne veut pas marcher, Gardes que l'on l'entraîne.
SCENE IV.	SCÈNE IV.
LE ROY, BERECINTE, DORIMAN, SABINE.	LE ROY, BÉRECINTE, DORIMAN, SABINE.
BERECINTE.	BÉRECINTE.
Voy, Seigneur, quand ie viens à voſtre Majeſté?	Vois, Seigneur, quand ie viens à votre Majesté?
Luy teſmoigner mon zele & ma fidelité, De toutes vos faueurs quand ie viens rendre grace, Ie voy qu’à la rigueur ils ont cedé la place, Que voſtre eſprit s’irrite & s’arme contre nous;	Lui témoigner mon zèle et ma fidélité, De toutes vos faveurs quand apprendre viens rendre grâce, Je vois qu'à la rigueur ils ont cédé la place, Que vôtre esprit s'irrite et s'arme contre nous;
Quel ſujet donc, Seigneur, cauſe voſtre coufroux?	Quel sujet donc, Seigneur, cause votre coufroux?
Pour mal traiter ce Prince auec tant de haine;	Pour mal traiter ce Prince avec tant de haine;
Qu’en s’arreſtant icy, vous voulez qu’on l’entraîne?	Qu'en s'arrêtant ici, vous voulez qu'on l'entraîne?
LE ROY.	LE ROY.
Ne le ſçauez-vous pas, & ſon noir attentat, Qu’il en veut à mes iours, à mon Troſne, à l’Eſtat?	Ne le savez-vous pas, et son noir attentat, Qu'il en veut à mes jours, à mon Trône, à l'État?
De ſon party, peut-eſtre, eſtes-vous la premiere, Puis qu’il pretend pour vous vẽger la mort d’vn pere, Releuer par ſon bras voſtre Troſne abbatu;	De son parti, peut-être, êtes-vous la première, Puis qu'il prétend pour vous venger la mort d'un père, Relever par son bras votre Trône abattu;
Et de tous ſes forfaits en faire vne vertu, Vous rendre vos Eſtats aux deſpens de ma vie, Pour couronner l’amour, ſa haine & ſon enuie;	Et de tous ses forfaits en faire une vertu, Vous rendre vos États aux dépens de ma vie, Pour couronner l'amour, sa haine et son envie;
Eſt-ce aſſez de ſujet pour vn tel traitement?	Est-ce assez de sujet pour un tel traitement?
Ne merite-il pas vn autre chaſtiment?	Ne mérite-il pas un autre châtiment?
4	4
BERECINTE.	BÉRECINTE.
Nous croiriez-vous, Seigneur, coupable d’vn tel crime, Quand nous auons pour vous vne ſi haute eſtime;	Nous croiriez-vous, Seigneur, coupable d'un tel crime, Quand nous avons pour vous une si haute estime;
Croire que nous penſions à nous venger de vous, Alors que vos faueurs ſe reſpandent ſur nous.	Croire que nous pensions à nous venger de vous, Alors que vos faveurs se répandent sur nous.
Ah!	Ah!
ce n’eſt pas à vous à connoiſtre ma plainte;	ce n'est pas à vous à connaître ma plainte;
B.	B.
iiij	jijà
Mais c’eſt à la fortune apres ſa rude atteinte;	Mais c'est à la fortune après sa rude atteinte;
Ie ſçay que des debats entre mon pere & vous, AHlumans l’vn pour l’autre vn funeſte courrous, Vous porterent tous deux à vous faire la guerre, Que chacun fiſt armer, & ſur mer & ſur terre;	Je sais que des débats entre mon père et vous, AHumants l'vn pour l'autre un funeste courrous, Vous portèrent tous deux à vous faire la guerre, Que chacun fît mer, et sur mer et sur terre;
Vous le ſçauez, Seigneur, ſans vous le raconter, Qu’il fallut qu’vn des deux ſe vit precipiter;	Vous le savez, Seigneur, sans vous le raconter, Qu'il fallut qu'un des deux se vit précipiter;
Ayant tous deux iuré la perte l’vn de l’autre, Ou de gagner ſon Troſne, ou de perdre le voſtre, Vn combat general vuida vos differens, La force eſtoit eſgale entre les combattans, Là victoire entre vous fut long-temps chancelante, Chacun à triompher s’animoit dans l’attente;	Ayant tous deux juré la perte l'un de l'autre, Ou de gagner son Trône, ou de perdre le vôtre, Un combat général vida vos différents, La force était égale entre les combattants, Là victoire entre vous fut longtemps chancelante, Chacun à triompher s'animait dans l'attente;
Mais helas!	Mais hélas!
la fortune en voulut decider, La cruelle fit tant qu’il fallut vous ceder, Se declarant pour vous affoiblit tous les noſtres, Et de noſtre foibleſſe encouragea les voſtres;	la fortune en voulut décider, La cruelle fit tant qu'il fallut vous céder, Se déclarant pour vous affaiblit tous les nôtres, Et de notre faiblesse encouragea les vôtres;
Elle nous fuſt maraſtre auec tant de rigueur, Que ie n’y puis penſer ſans me percer le cœur;	Elle nous fût marâtre avec tant de rigueur, Que je n'y puis penser sans me percer le cœur;
Pardonnez ce tranſport, mon ennuy ſe redouble, Vn cœur comme le mien à la douleur ſe trouble:	Pardonnez ce transport, mon ennui se redouble, Un cœur comme le mien à la douleur se trouble:
Mon pere y fut tué, funeſte ſouuenir!	Mon père y fut tué, funeste souvenir!
Qui cherche dans mon ſang encor à le punir!	Qui cherche dans mon sang encor à le punir!
Vous fuſtes ſon Vainqueur, il fut voſtre victime, De ſon Troſne, il vous fit Conquerant legitime, Du hazard de la guerre, apres ſuiuant le ſort, Ie demeuray captiue en vengeance du mort;	Vous fûtes son Vainqueur, il fut été victime, De son Trône, il vous fit Conquérant légitime, Du hasard de la guerre, après suivant le sort, Je demeurai captive en vengeance du mort;
Mais quoy ie le confeſſe, on ne peut pas s’en plaindre, Comme luy vous auiez vn mefme ſort à craindre, Le hazard dominoit tout ſeul entre vous deux, Et vous fuſt fauorable en dépit de mes vœux.	Mais quoi était le confesse, on ne peut pas s'en plaindre, Comme tu vous aviez un même sort à craindre, Le hasard dominait tout seul entre vous deux, Et vous fût avorable en dépit de mes vœux.
I'ay veſcu du depuis parmy tant de delices, Que l’abſence des miens a fait tout mes ſupplices;	J'ai vécu du depuis parmi tant dé lices, Que l'absence des miens a fait tout mes supplices;
L’honneur de vos biens-faits, de vos ciuilitez, L’emporte par deſſus toutes les libertez, 10 Vous auez trop pour moy de bonté, trop d’eſtime, Pour me croire coupable enuers vous d’aucun crime;	L'honneur de vos biens-faits, de vos civilités, L'emporte par -dessus toutes les libertés, 10 Vous avez trop pour moi de bonté, trop d'estime, Pour me croire coupable envers vous d'aucun crime;
C’eſt me faire vne injure apres vos traitemens;	C'est me faire une injure après vos traitements;
Comme moy, Ptolomée a meſmes ſensimens.	Comme moi, Ptolomée à mêmes sensiments.
Doutez des impoſteurs qui deuant vous l’accuſent, Le rendant criminel, c’eſt vous ſeul qu’ils abuſent.	Doutez des imposteurs qui devant vous l'accusent, Le rendant criminel, c'est vous seul qu'ils abusent.
EE ROY.	CE ROY.
Sa lettre le condamne, & les traits & le ſein.	Sa lettre le condamne, et les traits et le sein.
BERLCNNTE, Et qui peut aſſeurer qu’ils ſoient faits de ſa main?	BERLCNTE, Et qui peut assurer qu'ils soient faits de sa main?
DORIMAN.	DORIMAN.
La Reine vient, Seigneur.	La Reine vient, Seigneur.
BERECINTE.	BÉRECINTE.
Helas!	Hélas!
cette inhumaine.	cette inhumaine.
Par ſa jalouſe humeur va redoubler ſa haine.	Par sa jalouse humeur va redoubler sa haine.
bas.	bas.
SABINE.	SABINE.
Sans ſon abord icy, ſoh cœurs artendrinioit;	Sans son abord ici, soh cœurs artendriniait;
I’ay veu qu’à vos raiſons ſon ame patiſſoit- Dieux!	J'ai vu qu'à vos raisons son âme pâtissait- Dieux!
quel mal-heur,	quel malheur,
BEREINTE.	BÉREINTE.
I'ay-toy, l'on te pourroit entendre.	J'ai-toi, l'on te pourrait entendre.
SCENE V.	SCÈNE V.
LE ROY, LA REIIES BERUCINTE, DORIMAN, SABINE, PAVLINE.	LE ROY, LA RÉIEZ BERUCINTE, DORIMAN, SABINE, PAULINE.
LE ROY.	LE ROY.
l bien les coujurez les venez vous d’apprendre?	Il bien les coujurés les venez -vous d'apprendre?
BERECINTE.	BÉRECINTE.
Moy?	Moi?
LA REYNE.	LA REINE.
Ouy vous, Madame, auſſi vous trahiſez le Roy, On eſt trop informé de tous vos artifices;	Oui vous, Madame, aussi vous trahisez le Roi, On est trop informé de tous vos artifices;
Ber oinle voit que trop tant de noires malices.	Ber île voit que trop tant de noires malices.
BERECINTE.	BÉRECINTE.
Madame, vous pouuez m’enuoyer à la mort, avſais ie puis ſouſtenir que l’on m’accuſe à tort.	Madame, vous pouvez m'envoyer à la mort, avais ie puis soutenir que l'on m'accuse à tort.
LE ROY.	LE ROY.
Comment auez vous ſçeu qu’elle eſt auſſi compliupour	Comment avez -vous su qu'elle est aussi compliupour
LA REYNE.	LA REINE.
L’on ne conſpire icy que pour ſon ſeul ſeruice.	L'on ne conspire ici que pour son seul service.
BERÉCINTE.	BERÉCINTE.
Mon innocence parle, & c’eſt aſſez pour moy, Ie ne me deffends plus, ie reſpecte le Roy;	Mon innocence parle, et c'est assez pour moi, Je ne me défends plus, ie respecte le Roi;
Il peut abſolument diſpoſer de ma vie, Me deffendre luy ſeul des fureurs de Penuie.	Il peut absolument disposer de ma vie, Me défendre lui seul des fureurs de Penvie.
peſc	pesc
ED ROT, partant à Doriman.	ED ROT, partant à Doriman.
Conduiſez la Princeſſe en ſon appartement.	Conduisez la Princesse en son appartement.
Ce P Ie ſçauray decider ce faict plus amplement.	Ce P Je saurai décider ce fait plus amplement.
Si ſo	Si so
l’oben, oeigneur.	l'oben, oeigneur.
SCENEVI.	SCENEVI.
ME LE ROY, LA REYNE, PAVLINE,	ME LE ROY, LA REINE, PAULINE,
14 EA RETNE.	14 EA RETNE.
Voy vous vous laiſſez ſurprendre A ſes foibles raiſons voſtre eſprit ſe va rendre?	 Vois -vous laissez surprendre À ses faibles raisons votre esprit se va rendre?
Son crime demandoit vne noire priſon, On ne ſçauroit aſſez punir la trahiſon.	Son crime demandait é noire prison, On ne saurait assez punir la trahison.
LE ROY.	LE ROY.
27 Vn Roy qui ſe croit juſte, & qui veut le paroiſtre Auant que de punir, c’eſt à luy de connoiſtre, Ne rien precipiter agir de jugement, Bien- peſer les raiſons pour juger prudemment;	27 Un Roi qui se croit juste, et qui veut le paraître Avant que de punir, c'est à lui de connaître, Ne rien précipiter agir de jugement, Bien- peser les raisons pour juger prudemment;
Le crime en apparence aſſez ſouuent abuſe, Deſſous vn faux pretexte, il peut gliſſer la ruſe.	Le crime en apparence assez souvent abuse, Dessous un faux prétexte, il peut glisser la ruse.
Accuſant l’innocent l’enuoyer au treſpas, Comme i’agis, Madame, on ne ſe meſprend pas;	Accusant l'innocent l'envoyer au trépas, Comme j'agis, Madame, on ne se méprend pas;
Berecinte a pour elle vn ſang ſi fauorable, Qu’on ne peut d’vn ſoupçon, la traicter en coupable, liepour la rendre complice, il en faut plus ſçauoir, le pourrois me tromper, & ie ſçay mon deuoir.	Berecinte a pour elle un sang si favorable, Qu'on ne peut d'être soupçon, la traiter en coupable, liepour la rendre complice, il en faut plus savoir, le pourrais me tromper, et ainsi sais mon devoir.
LA REYNE.	LA REINE.
Faut-il voir cét Empire au poinct de ſa ruine, Pour juger des mal-heurs que ſon cœur luy deſtine?	Faut-il voir cet Empire au point de sa ruine, Pour juger des malheurs que son cœur lui destine?
De ſon auerſion, ſentir auant les coûs, Pour croire qu’elle cherche à ſe vanger de nous.	De son aversion, sentir avant les cous, Pour croire qu'elle cherche à se venger de nous.
Ce Prince n’euſt iamais oſé rien entreprendre, Si ſous vn bel eſpoir on euſt ſceu le ſurprendre, S’il ne s’agiſt icy que de ſon intereſt, Vous deuez de ſa mort prononcer vn Arreſt, Elle merite mieux qu’on la traite en coupable, Que non pas ſon amant, qui peut eſtre excuſable;	Ce Prince n'eût jamais osé rien entreprendre, Si sous un bel espoir on eût su le surprendre, S'il ne s'agît ici que de son intérêt, Vous devez de sa mort prononcer un Arrêt, Elle mérite mieux qu'on la traite en coupable, Que non pas son amant, qui peut être excusable;
L’amour l’a pû, pouſſer contre ſa volonté, Qui le rend criminel c’eſt ſa temerité;	L'amour l'a pu, pousser contre sa volonté, Qui le rend criminel c'est sa témérité;
Peut-eſtre que long-temps il a fait reſiſtance, Et qu’il ne s’eſt rendu que par obeiſſance;	Peut-être que longtemps il a fait résistance, Et qu'il ne s'est rendu que par obéissance;
Que l’amour aueuglé de tous ſes faux appas, L’a contraint par ſurpriſe à luy preſter ſon bras;	Que l'amour aveuglé de tous ses faux appas, L'a contraint par surprise à M prêter son bras;
Ne diſtinguez donc pas le crime l’vn de l’autre, Qui les porte tous deux à ſe venger du voſtre;	Ne distinguez donc pas le crime l'Hum de l'autre, Qui les porte tous deux à se venger du vôtre;
Vengeant la mort d'vn pere, elle croit tout permis, Et vous n’euſtes iamais de plus grands ennemis.	Vengeant la mort d'un père, elle croit tout permis, Et vous n'eûtes jamais de plus grands ennemis.
Les delays que l’on prend pour punir vn tel crime, Nous font courir hazard d’en eſtre la victime;	Les délais que l'on prend pour punir un tel crime, Nous font courir hasard d'en être la victime;
Empeſchez-là, Seigneur, d’accomplir ſes deſſeins, Gardez-nous de tomber dans ſes cruelles mains;	Empêchez-là, Seigneur, d'accomplir ses desseins, Gardez-nous de tomber dans ses cruelles mains;
Puniſſez-là pluſtoſt, courez à la vengeance;	Punissez-là plutôt, courez à la vengeance;
Sa mort eſt le coup ſeur d’euiter ſon offenſe.	Sa mort est le coup sûr d'éviter son offense.
LE ROY.	LE ROY.
Vous concluez, Madame, anec trop de chaleur, Pour ſuiure voſtre auis qui feroit ſon mal-heur;	Vous concluez, Madame, anec trop de chaleur, Pour suivre votre avis qui ferait son malheur;
Vous vous monſtrez contre elle vn peu trop animt Et i’ay peine à ſouffrir cette humeur enflamée.	Vous vous montrez contre elle un peu trop animt Et j'ai peine à souffrir cette humeur enflamée.
Le Prince eſt ſeul coupable, il eſt ſeul à punir, Pour la croire complice, il faut l’entretenir;	Le Prince est seul coupable, il est seul à punir, Pour la croire complice, il faut l'entretenir;
Car tantoſt me parlant i’ay veu ſon innocence;	Car tantôt me parlant j'ai vu son innocence;
I’en ay veu ſur ſon front vne forte apparence;	J'en ai vu sur son front une forte apparence;
Mais ie vais luy parler, & ſelon ſon diſcours La laiſſer en repos, ou terminer ſes iours.	Mais ici vais lui parler, et selon son discours La laisser en repos, ou terminer ses jours.
SCENE VII LA REYNE, PAVLINE.	SCÈNE VII LA REINE, PAULINE.
LA REYNE.	LA REINE.
E' bien reconnois-tu la grandeur de ſa flame?	E bien reconnais-tu la grandeur de sa flamme?
s I ICrois-tu que Berecinte a captiué ſon ame?	 I ICrais-tu que Berecinte à captivé son âme?
Il n’auoit, diſois-tu, deffendant cét Eſpous, Que tendreſſe pour elle, & qu’amitié pour vous;	Il n'avait, disais-tu, défendant cet Espous, Que tendresse pour elle, et qu'amitié pour vous;
C’eſt à peu prés tes mots, il m’en ſouuient encor C’eſtoit ciuilité, connois-tu qui l’adore?	C'est à peu prés tes mots, il m'en souvient encor C'était civilité, connais-tu qui l'adore?
Comme à la condamner il s’eſt trop deffendu, Auant que nous quitter, as-tu bien entendu?	Comme à la condamner il s'est trop défendu, Avant que nous quitter, as-tu bien entendu?
Vous vous monſtrez contre elle vn peu trop anim Et i’ay peine à ſouffrir cette humeur enflamee:	Vous vous montrez contre elle un peu trop anim Et j'ai peine à souffrir cette humeur enflamène:
Le Prince eſt ſeul coupable, il eſt ſeul à punir, Pour la croire complice il faut l’entretenir:	Le Prince est seul coupable, il est seul à punir, Pour la croire complice il faut l'entretenir:
Helas!	Hélas!
pouuoit-il mieux trouuer à la deffendre?	pouvait-il mieux trouver à la défendre?
Pouuoit-il mieux chercher encor à me ſurprendre!	Pouvait-il mieux chercher encor à me surprendre!
l Me croit-il aſſez foibie apres tous fes deitours, De croire que j’ignore où va tout ſon diſcours?	 Me croit-il assez faibie après tous fes deitours, De croire que j'ignore où va tout son discours?
Que ie ne ſçache pas qu’il l’a veut iocente, Pour plaire à ſon amour & la rendre contente?	Que personne ne sache pas qu'il l'a veut jocente, Pour plaire à son amour et la rendre contente?
Non, non, eſpoux ingrat on ne m’abuſe pas, Ie ſçay que ton amour refuſe ſon treſpas, Que tu la cheris trop pour m’oſer le promettre, Que pour te ſatisfaire il faudroit m’en demettre;	Non, non, époux ingrat on ne m'abuse pas, Je sais que ton amour refuse son trépas, Que tu la chéris trop pour m'oser le promettre, Que pour te satisfaire il faudrait m'en démettre;
Ah!	Ah!
ne le pretends pas, ie conclûs à ſa mort, Pour fuimonter Ma fame & fuimontel inon Tort;	ne le prétends pas, ie conclus à sa mort, Pour fuimonter Ma famé et fuimontel inon Tort;
Ie ne le cele point, ie veux me ſatisfaire.	Je ne le cèle point, votre veux me satisfaire.
PAVLINE.	PAULINE.
12 Madame, à vos ſoupçons ie ne puis plus me taire.	12 Madame, à vos soupçons ici ne puis plus me taire.
Le Roy veut la Iuſtice, ou i’ay mal entendu, Son diſcours ne va pas au voſtre pretendu;	Le Roi veut la Justice, ou j'ai mal entendu, Son discours ne va pas au vôtre prétendu;
Qui doute que l’on doit pour punir tout connoiſtre?	Qui doute que l'on doit pour punir tout connaître?
Qu’vne conuiction ne ſçauroit trop paroiſtre?	Qu'une conviction ne saurait trop paraître?
vous n’aulez pas tantoſt vn pareil ſentiment, Vous la vouliez vnir auecque ſon Amant, Vous n’auiez pas pour elle vne ſi forte haine.	vous n'aulez pas tantôt un pareil sentiment, Vous la vouliez unir avec son Amant, Vous n'aviez pas pour elle une si forte haine.
LA REYNE.	LA REINE.
Ie ceſſerois encor de me rendre inhumaine Si ie ne predo jois que le Pimce eſtant mort, Ie ſuis plus expoſée aux rigueurs de mon ſort:	Je cesserais encor de me rendre inhumaine Si tu ne prédo jois que le Pimce étant mort, Je suis plus exposée aux rigueurs de mon sort:
Que e'eit à mon Eſpoux donner lieu de ma perte;	Que éteit à mon Époux donner lieu de ma perte;
Et ce qu’il fait ſous main le faire à guerre ouuerte	Et ce qu'il fait sous main le faire à guerre ouuerte
PAVLINE.	PAULINE.
Ah!	Ah!
ne le croyez pas, vous l’accuſez à tort.	ne le croyez pas, vous l'accusez à tort.
LA REYNE.	LA REINE.
Lors que pour la ſauuer il fait tout ſon effort?	Lors que pour la sauver il fait tout son effort?
Va, va, le Prince & luy vont pour toute aſſeurance, Par vn excez d’amour monſtrer ſon innocence.	Va, va, le Prince et lui vont pour toute assurance, Par cez d'amour montrer son innocence.
Et tous deux à l'enuy luy conſeruant le iour, L’vn s’immole à la mort, & l'autre à ſon amour.	Et tous deux à l'envi lui conservant le jour, L'un s'immole à la mort, et l'autre à son amour.
Ie ſçay que Ptolomée attend trop le ſuplice, Et le Roy qui ſe voit par ſon treſpas content, Ne veut pas ſe priuer du bon-heur qu’il attend.	Je sais que Ptolomée attend trop le supplice, Et le Roi qui se voit par son trépas content, Ne veut pas se priver du bonheur qu'il attend.
Mais allons pour apprendre où va ſa conference, 3 Si i’ay bien preſumé de ſon intelligence.	Mais allons pour apprendre où va sa conférence, 3 Si j'ai bien présumé de son intelligence.
Si Berecinte & luy par vn commun accord N’enuoyent point ce Prince & ſa femme à la mort	Si Berecinte et lui par un commun accord N'envoient point ce Prince et sa femme à la mort
Fin du ſecond Acte.	Fin du second Acte.
ACTE III.	ACTE III.
H 21192 114 SCENE PREMIERE.	H 21192 114 SCÈNE PREMIÈRE.
DORIMAN, LVCIAN.	DORIMAN, LUCIAN.
DORIMAN.	DORIMAN.
E ne puis le celer, c’eſt trop de hardieſſe;	ET ne puis le celer, c'est trop de hardiesse;
IMais c’eſt le ſeul moyen d’eſpouſer la Princeſſe.	JMais c'est le seul moyen d'épouser la Princesse.
Ie te l’ay deſia dit, il faut les ſeparer, Ie n’ay que cette voye à pouuoir l’eſperer;	Je te l'ai déjà dit, il faut les séparer, Je n'ai que cette voie à pouvoir l'espérer;
Il falloit exciter la reuolte en l'Armée, Phorbas mon Lieutenant l'a ſi fort allumée, Que pour ſe garantir d’vn ſi prochain danger, Il faut preſſer la mort de ce Prince eſtranger;	Il fallait exciter la révolte en l'Armée, Phorbas mon Lieutenant l'a si fort allumée, Que pour se garantir d'un si prochain danger, Il faut presser la mort de ce Prince étranger;
A moins que Seleucus ne ſouffre en ſa preſence, Que les Mutins pour luy ne brauent ſa puiſſance, Et qu’il ne ſoit contraint malgré tout ſon pouuoir De leur accorder tout, en manquant d’y preuoir.	À moins que Seleucus ne souffre en sa présence, Que les Mutins pour nous ne bravent sa puissance, Et qu'il ne soit contraint malgré tout son pouvoir De leur accorder tout, en manquant d'y prévoir.
Mais il n’aura iamais pour eux cette baſſeſſe, Iamais ne ſouffrira iuſques là qu’on le preſſe, Il aimera bien mieux en preſſer le treſpas, Que de ſe voir contraint de ceder à leurs bras.	Mais il n'aura jamais pour eux cette bassesse, Jamais ne souffrira jusques -là qu'on le presse, Il aimera bien mieux en presser le trépas, Que de se voir contraint de céder à leurs bras.
LVCIAN.	LUCIAN.
Voila le ſeur moyen d’abatre cette teſte;	Voilà le sûr moyen d'abattre cette tête;
Mais ce n’eſt pas celuy de calmer la tempeſte, Et loin des Mutinez d’arreſter le courroux, C’eſt enfler leur orgueil pour aller iuſques à vous.	Mais ce n'est pas celui de calmer la tempête, Et loin des Mutinez d'arrêter le courroux, C'est enfler leur orgueil pour aller jusques à vous.
Ie crains pour vous, Seigneur, vn reters de Tortune.	Je crains pour vous, Seigneur, un reters de Tortune.
DORIMAN, Tu crains mal à propos, ſans apparence aucune;	DORIMAN, Tu crains mal à propos, sans apparence aucune;
Quand l'amour nous conduit on peut tout acheuer;	Quand l'amour nous conduit on peut tout achever;
Dans le rang où ie ſuis i’ay droict de m’eſleuer;	Dans le rang où je suis j'ai droit de m'élever;
L’amour dans ſes deſirs ne trouue point d’obſtacle, Et s’il eſt ſans puiſſance, il n’eſt pas ſans miracle;	L'amour dans ses désirs ne trouve point d'obstacle, Et s'il est sans puissance, il n'est pas sans miracle;
Si dedans mes deſſeins ie manque de ſecours, La mort en ce beſoin ſera mon ſeul recours.	Si dedans mes desseins ie manque de secours, La mort en ce besoin sera mon seul recours.
Mais tu perds trop de temps;	Mais tu perds trop de temps;
va-t’en joindre l'Armée, rais que les luetleux demandent Ptolomée;	va-t-en joindre l'Armée, rais que les lueteux demandent Ptolomée;
Et pouſſe tous ſes gens à la ſedition, Pour mieux leur imputer toute la faction.	Et pousse tous ses gens à la sédition, Pour mieux leur imputer toute la faction.
LVCIAN.	LUCIAN.
Ie m’en vais de ce pas, Seigneur, vous ſatisfaire, Et ie ſçauray preuoir à tout ce qu’il faut faire.	Je m'en vais de ce pas, Seigneur, vous satisfaire, Et ici saurai prévoir à tout ce qu'il faut faire.
SCENE II.	SCÈNE II.
DORIMAN, ſeul.	DORIMAN, seul.
Où me vienr donc ce trouble où ie vois tous D mes ſens Se reuolter entre eux par des combats preſſens?	Où me vienr donc ce trouble où on vois tous mes sens Se volter entre eux par des combats pressens?
Mon ame eſt allarmée, & ma raiſon confuſe, Aux coups de mon amour ſon ſecours luy refuſe;	Mon âme est alarmée, et ma raison confuse, Aux coups de mon amour son secours lui refuse;
Et l’honneur ſuruenant entre tous ces tranſports, Luy fait dans vn moment ſentir mille remords.	Et l'honneur survenant entre tous ces transports, Lui fait dans un moment sentir mille remords.
Ma haine eſt ſans vigueur, qui le cede à ſa gloire, Et mon amour ſans force accorde ſa victoire.	Ma haine est sans vigueur, qui le cède à sa gloire, Et mon amour sans force accorde sa victoire.
Ah!	Ah!
ſentimens d’honneur pouuez-vous tant ſur moy Que par vn repentir vous me faiſiez la loy?	sentiments d'honneur pouvez-vous tant sur moi Que par un repentir vous me faisiez la loi?
C ij	Ç ij
Dure, dure à iamais cette noble puiſſance, Pour eſtouffer l’amour, la haine & la vengeance;	Dure, dure à jamais cette noble puissance, Pour étouffer l'amour, la haine et la vengeance;
Allons voir Ptolomée au milieu de ſes fers, Monſtrõs dans mes regrets les maux qu’il a ſoufferts Découurons-luy mon cœur qui deteſte ſon crime, Et qui rend à l’honneur ſa premiere victime;	Allons voir Ptolomée au milieu de ses fers, Monstrons dans mes regrets les maux qu'il a soufferts Découvrons-lui mon cœur qui déteste son crime, Et qui rend à l'honneur sa première victime;
Allons donc mon honneur precipite mes pas, Courons auecque ardeur le ſauuer du trépas:	Allons donc mon honneur précipite mes pas, Courons auecque ardeur le sauver du trépas:
Mais ie demeure encor, ie ne ſçay qui m’anime, L’honneur s’affoibliſſant autoriſe mon crime:	Mais quelque demeure encor, je ne sais qui m'anime, L'honneur s'affaiblissant autorise mon crime:
Mon cœur ſe reuoltant veut deffendre l’amour;	Mon cœur se révoltant veut défendre l'amour;
Ie ſents que l’honneur cede à l’amour à ſon tour.	Je sents que l'honneur cède à l'amour à son tour.
Ma haine ſe réueille aux penſers de ſes charmes, Et pour la ſatisfaire elle m’offre ſes armes:	Ma haine se réueille aux pensers de ses charmes, Et pour la satisfaire elle m'offre ses armes:
Elle veut la vengeance, & joignant à ſes feux Tous ceux de mon amour, ie me rends à tous deux.	Elle veut la vengeance, et joignant à ses feux Tous ceux de mon amour, je me rends à tous deux.
Il eſt vray mon amour c’eſtoit trop de baſſeſſe, Ie te quittois ma haine auec trop de foibleſſe;	Il est vrai mon amour c'était trop de bassesse, Je te quittais ma haine avec trop de faiblesse;
Ie reconnois ma faute, & ſuy vos mouuemens, Mon cœur ſe rend à vous dans tous vos ſen imens;	Je reconnais ma faute, et suis vos mouvements, Mon cœur se rend à vous dans tous vos sen imends;
Il faut perdre vn Riual, il faut vous ſatisfaire;	Il faut perdre un Rival, il faut vous satisfaire;
Ie ne conſulte plus où l’amour delibere.	Je ne consulte plus où l'amour délibère.
Fuyez donc de l’honneur les ſentimens trompeurs, Vos charmes ſont ſans force auprés de ſes faueurs:	Fuyez donc de l'honneur les sentiments trompeurs, Vos charmes sont sans force auprès de ses faveurs:
La ſeule vanité fait tout voſtre aduantage;	La seule vanité fait tout votre avantage;
Mais aux biens qu’il me rend tous les Dieux font homage.	Mais aux biens qu'il me rend tous les Dieux font hommage.
Fuyez donc dis-je encor chimeres de l’eſprit, Quand vous m’auez deçeu i’eſtois trop intefdit.	Fuyez donc dis-je encor chimères de l'esprit, Quand vous m'avez décev j'étais trop intedit.
Ce n’eſt qu’à mon amour à captiuer mon ame;	Ce n'est qu'à mon amour à captiver mon âme;
Ie ſuy ſes mouuemens pour couronner ma flâme.	Je suis ses mouvements pour couronner ma flamme.
Allons donc acheuer l’ouurage commencé;	Allons donc achever l'ouvrage commencé;
Il faut vne victime à l’amour offencé;	Il faut une victime à l'amour offensé;
Les plaiſirs que ie perds me ſont autant de peines;	Les plaisirs que personne perds me sont autant de peines;
De ma captiuité ie veux rompre mes chaînes;	De ma captivité ie veux rompre mes chaînes;
C’eſt aſſez ſoûpirer pour meriter vn bien;	C'est assez soupirer pour mériter un bien;
Il faut.	Il faut.
Mais le Roi vient, quel bonheur eſt le mien?	Mais le Roi vient, quel bonheur est le mien?
Pour perdre mon Riual l'occaſion cſt belle;	Pour perdre mon Rival l'occasion cst belle;
De la reuolte encor il n’a point de nouuelle;	De la révolte encor il n'a point de nouvelle;
Ses yeux ne marquent point ſon eſprit en courroux.	Ses yeux ne marquent point son esprit en courroux.
SCENE III.	SCÈNE III.
DORIMAN, LB ROY.	DORIMAN, LB ROY.
LE ROY.	LE ROY.
v lIince Ftolomee emnque rerons nous?	vite lIince Ftolome emnque rerons nous?
UIe te viens conſulter, dy moy que dois-je faire?	VIe te viens consulter, dis -moi que dois-je faire?
Sà mort te ſemble-t’elle à l’Eſtat neceſſaire?	Sà mort te semble-t-elle à l'État nécessaire?
DORIMAN.	DORIMAN.
A reſpondre, Seigneur, ie dois eſtre ſoûmis;	À répondre, Seigneur, ie dois être soumis;
Sà teſte abbat d’vn coup vos plus grands ennemis.	Sà tête abat d'une coup vos plus grands ennemis.
Ie ne puis le nier, c’eſt aſſeurer l’Empire, Et malgré ma pitié ie dois encor vous dire Que le pem ent grand en orant dillerer;	Je ne puis le nier, c'est assurer l'Empire, Et malgré ma pitié homme dois encor vous dire Que le pem ent grand en orant dillerer;
Les Roys ſont obligez touſiours de s’aſſeurer;	Les Rois sont obligez toujours de s'assurer;
Par ſa lettre l’on void iuſqu’où va ſon enuie, Qui tend à la Couronne, à vous oſter la vie.	Par sa lettre l'on voit jusqu'où va son envie, Qui tend à la Couronne, à vous ôter la vie.
LE ROY.	LE ROY.
Ie vois dans tes raiſons que par neceſſité, Il faur que ſon treſpas faſſe ma ſeureté.	Je vois dans tes raisons que par nécessité, Il saur que son trépas fasse ma sûreté.
Pour le bien de l’Eſtat, pour expier ſon crime, Qu’il faut ſelon nos Loix en faire vne victime;	Pour le bien de l'État, pour expier son crime, Qu'il faut selon nos Lois en faire une victime;
Qu’il ne peut eſchaper apres ſa trahiſon, Et ſon crime attend plus qu’vne noire priſon.	Qu'il ne peut échapper après sa trahison, Et son crime attend plus qu'une noire prison.
Mais ie dois obſeruer les formes de Iuſtice, Et laiſſer au Senat le ſoin de ſon ſuplice:	Mais était dois observer les formes de Justice, Et laisser au Sénat le soin de son suplice:
Ie n’abuſeray point de mon iuſte pouuoir;	Je n'abuserai point de mon juste pouvoir;
Il eſt- vray ie ſuis Roy, mais ie ſçay mon deuoir?	Il est- vrai ici suis Roi, mais ainsi sais mon devoir?
C iij On me reprocheroit d’vſer de violence, Si ie le condamnois de ma ſeule puiſſance:	Ç Cij On me reprocherait d'user de violence, Si grande le condamnais de ma seule puissance:
Des Iuges eſtablis decideront ſon ſort, Pour n’eſtre point blaſmé d’auoir preſſé ſa mort.	Des Juges établis décideront son sort, Pour n'être point blâmé d'avoir pressé sa mort.
DORIMAN.	DORIMAN.
Ce procedé, Seigneur, à condamner vn traiſtre, Sans doute vous exclud d’en eſtre apres le maiſtre;	Ce procédé, Seigneur, à condamner un traître, Sans doute vous exclud d'en être après le maître;
Songez-y;	Songez-y;
prenez garde à n’eltte point lurpris;	prenez garde à n'eltte point lurpris;
Pour le bien de l’Eſtat ſuiuez ſeul voſtre aduis.	Pour le bien de l'État suivez seul votre avis.
LE ROY.	LE ROY.
Auant i’y dois penſer.	Avant j'y dois penser.
Mais que nous veut la Reine?	Mais que nous veut la Reine?
Quel eſt donc le ſujet qui dans ce lieu l'ameine?	Quel est donc le sujet qui dans ce lieu l'amène?
Allons au deuant d’elle, & l’entendons parler.	Allons au devant d'elle, et l'entendons parler.
d Cdd lve LE ROY, LA REYNE, DORIMAN	d Cd ève LE ROY, LA REINE, DORIMAN
LA REYNE.	LA REINE.
Eigneur, il n’eſt plus temps de vous plus rien celet, OC’eſt celuy de ſonger à ſauuer la Prouince;	Eigneur, il n'est plus temps de vous plus rien clélet, OCest celui de songer à sauver la Province;
La mort de Berecinte & le treſpas du Prince N’offrent que les moyens d’éuiter ſon danger;	La mort de Berecinte et le trépas du Prince N'offrent que les moyens d'éviter son danger;
Dhllince ele reroicee, et vetteccc erranger;	Dhllince éle reroicée, et vettecc èranger;
Si tantoſt vous euſſiez arreſté cette fiere, Pour rompre les deſems la lanant prironniere, On l’euſt miſe hors d’eſtat de ſauuer ſon Amant, Et n’auroit pas cauſé tout ce grand remuëment.	Si tantôt vous eussiez arrêté cette fière, Pour rompre les désems la lanant prironniere, On l'eût mise hors d'état de sauver son Amant, Et n'aurait pas causé tout ce grand remument.
LE ROY.	LE ROY.
Mais pour l’en accuſer ie voudrois quelque indice.	Mais pour l'en accuser On voudrais quelque indice.
LA REYNE.	LA REINE.
En faut-il de plus grund que d’eſtre ſa complice?	En faut-il de plus grund que d'être sa complice?
LE ROY.	LE ROY.
Vous retombez, Madame, en la premiere erreur.	Vous retombez, Madame, en la première erreur.
LA REYNE.	LA REINE.
Et vous vous perſiſtez à luy faire faueur;	Et vous vous persistez à lui faire faveur;
Voicy venir Straton qui vient tout vous apprend̂re, Et puis vous connoiſtrez ſi ie veux vous ſurprendre.	Voici venir Straton qui vient tout vous apprend̂re, Et puis vous connaîtrez si ici veux vous surprendre.
SCENE V.	SCÈNE V.
LE ROY, LA REYNE, DORIMAN, STRATON.	LE ROY, LA REINE, DORIMAN, STRATON.
LE ROY.	LE ROY.
e nous rapportes-tu de l’Armée & du Fort?	Je nous rapportes-tu de l'Armée et du Fort?
STRATON.	STRATON.
Le Fort n’euſt iamais tant de beſoin d’vn renfort, Les Mutins aſſemblez, le tumulte s’augmente, D’enleuer Ptolomée on n’eſt plus qu’en attente;	Le Fort n'eût jamais tant de besoin d'Han renfort, Les Mutins assemblés, le tumulte s'augmente, D'enlever Ptolomée on n'est plus qu'en attente;
Deſia les plus hardis ſont beaucoup aduancez, Pour ſurprendre le Fort ont gagné les foſſez;	Déjà les plus hardis sont beaucoup avancés, Pour surprendre le Fort ont gagné les fossés;
L’on n’entend que les cris de, viue Ptolomée, Et ce bruit eſt pouſſé des plus forts de PArmée;	L'on n'entend que les cris de, vive Ptolomée, Et ce bruit est poussé des plus forts de PArmée;
Les plus zelez pour ſuy diſent que c’eſt à tort Que ſur vn faux ſoupçon on l’enuoye à la mort;	Les plus zélé pour suivi disent que c'est à tort Que sur un faux soupçon on l'envoie à la mort;
Qu’ils ſont bien reſolus au deſpens de leur vie, D'empeſcher qu’on immole vn grãd Prince à l'enuie.	Qu'ils sont bien résolus au dépens de leur vie, D'empêcher qu'on immole un grands Prince à l'envie.
LE ROY.	LE ROY.
Les chefs de ces Mutins ne les connois-tu point.	Les chefs de ces Mutins ne les connais-tu point.
STRATON.	STRATON.
Ie ne ſçaurois, Seigneur, vous eſclaircir ce point?	Je ne saurais, Seigneur, vous éclaircir ce point?
Vn bruit court ſeulement ſuiuy de deffiance, Qu’on a veu, qu’on a pris vn homme funle derrence;	Un bruit court seulement suivi de défiance, Qu'on a vu, qu'on a pris un homme funle derrence;
L’on parle de poignard, l'on parle de treſpas;	L'on parle de poignard, l'on parle de trépas;
Ny de qui, ny comment, l’on ne s’explique pas:	Ni de qui, ni comment, l'on ne s'explique pas:
Mais la reuolte eſt grande, & dans vn grand tumulte L’on peut aux plus grands Rois quelquefois faire inſulte.	Mais la révolte est grande, et dans un grand tumulte L'on peut aux plus grands Rois quelquefois faire insulte.
LA REYNE.	LA REINE.
A moins que d’arreſter ces premiers mouuemens, Peuit-eitre verrons-nous d’eſtranges changemens.	À moins que d'arrêter ces premiers mouvements, Peuit-eitre verrons-nous d'étranges changements.
LE ROY.	LE ROY.
Dans tels euenemens ie ſçay ce qu’il faut faire, Le Prince doit mourir, ſa mort eſt neceſſaire;	Dans tels événements ie sçay ce qu'il faut faire, Le Prince doit mourir, sa mort est nécessaire;
Qu’on le ſorte du Fort, Straton prend-en le ſoinDe mon iuſte courroux donnons ce grand teſmoin Pour le conduire icy prend vne ſeure eſcorte, Tu ſçais comme ſa mort à mon pouuoir importe, I’aſche d’apprendre auſſi les principaux autheurs, Ie les veux immoler à mes juſtes fureurs.	Qu'on le sorte du Fort, Straton prend-en le soinDe mon juste courroux donnons ce grand témoin Pour le conduire ici prend ton sûre escorte, Tu sais comme sa mort à mon pouvoir importe, J'âche d'apprendre aussi les principaux auteurs, Je les veux immoler à mes justes fureurs.
LA REYNE.	LA REINE.
Ie me enarge, oeigneur, deiçauonl les complices.	Je me enarge, oeigneur, deiçauonl les complices.
LE ROY.	LE ROY.
Moy de les enuoyer ſans reſerue aux ſuplices.	Moi de les envoyer sans réserve aux suplices.
LA REYNE.	LA REINE.
Seigneur, ie me retire apres ce ſentiment, Berecinte eſt coupable autant que ſon Amant, Ne perdons pome de temps de perdre l’vn & l’autre.	Seigneur, je me retire après ce sentiment, Berecinte est coupable autant que son Amant, Ne perdons pome de temps de perdre l'un et l'autre.
SCENE VI.	SCÈNE VI.
LE ROY, D'ORIMAN.	LE ROY, D'ORIMAN.
LE ROY.	LE ROY.
Vel mal-heur aujourd’huy peut égaler le noſtres 2 Mes ſubjets contre moy faire rebellion!	Vel malheur aujourd'hui peut égaler le nôtres 2 Mes sujets contre moi faire rébellion!
Eſſeuer leur audace à la ſedition !	Essèver leur audace à la sédition !
Hé!	Hé!
quoy dans mes Eſtats, au milieu de l’Empire, On eſt aſſez hardy pour m’oſer contredire;	quoi dans mes États, au milieu de l'Empire, On est assez hardi pour m'oser contredire;
On s’oppoſe à mes Loix, on quitte fon deuoir, Et ie demeure encore à monſtrer mon pouuoir:	On s'oppose à mes Lois, on quitte son devoir, Et ie demeure encore à montrer mon pouvoir:
Courons à la vengeance apres leurs perfidies;	Courons à la vengeance après leurs perfidies;
Venez à mon ſecours l’Enfer & ſes furies, NNe me preſentez plus dans mes reſſentimens Que l’horreur d’vn affront qui ſuit vos mouuemens.	Venez à mon secours l'Enfer et ses furies, N me présentez plus dans mes ressentiments Que l'horreur d'une affront qui suit vos mouvements.
A reſpandre du ſang animez mon courage, Si ma pitié l’empeſche, oppoſez voſtre rage, Et portez ma vengeance à telle extremité, Qu'elle ſerue d’exemple à la poſterité;	À répandre du sang animez mon courage, Si ma pitié l'empêche, opposez votre rage, Et portez ma vengeance à telle extrémité, Qu'elle serve d'exemple à la postérité;
quadeun pour me venger ſerenappz des fupplices;	quadeun pour me venger serenapps des supplices;
Aforce de tourmens trouuez tous les complices.	Aforce de tourments trouvez tous les complices.
DORIMAN.	DORIMAN.
Eſuitons pour les miens ces cruels ſentimens, bas.	Esuitons pour les miens ces cruels sentiments, bas.
Et diſſipons contre eux ces premiers mouuemens:	Et dissipons contre eux ces premiers mouvements:
Pardonnez-moy, Seigneur, ie ne puis pas-vous taire Qu’en cette occaſion l’adreſſe eſt neceſſaire,  le temps de vous venger n’eſt point encor venu, C’eſt de voſtre colere eſtre trop preuenu, De ſe precipiter alors qu’il faut attendre;	Pardonnez-moi, Seigneur, je ne puis pas-vous taire Qu'en cette occasion l'adresse est nécessaire, le temps de vous venger n'est point encor venu, C'est de votre colère était trop prévenu, De se précipiter alors qu'il faut attendre;
Appaiſez le tumulte auant que d’entreprendre, Des ſoldats mutinez deuiennent furieux, lls ne connoiſſent plus ny de Roy, ny de Dieux:	Apaisez le tumulte avant que d'entreprendre, Des soldats mutinez deviennent furieux, lls ne connaissent plus ni de Roi, ni Se Dieux:
Rien ne peut empeſcher leur premier coup d’offence, leur fureur ne ſe perd qu’au trop de violence:	Rien ne peut empêcher leur premier coup d'offense, leur fureur ne se perd qu'au trop de violence:
Il faut laiſſer paſſer ces premiers mouuemens, Encor qu’on vous ait dit qu’à ces commencemens Il falloit s’oppoſer, empeſcher leurs pourſuites, Qui n’auoient trop ſouuent que de facheuſes ſuites;	Il faut laisser passer ces premiers mouvements, Encor qu'on vous ait dit qu'à ces commencements Il fallait s'opposer, empêcher leurs poursuites, Qui n'avaient trop souvent que de fâcheuses suites;
Il eſt de leur fureur comme des grandes eaux, S’oppoſant à leur cours, on irrite leurs flots, Si pour leur eſcouler ils manquent d’eſtenduës, Leur force ſe redouble aux digues deffenduës, heurs pas precipitez venans à ſe preſſer, Forcent, entraiſnent tout, afin de mieux paſſer.	Il est de leur fureur comme des grandes eaux, S'opposant à leur cours, on irrite leurs flots, Si pour leur écouler ils manquent d'étendues, Leur force se redouble aux digues défendues, heurs pas précipités venants à se presser, Forcent, entraînent tout, afin de mieux passer.
I Vous iugez bien par là, Seigneur, qu’il eſt à craindre De ſe precipi ter de plus de ne pas feindre, ue pour trop vous preſſer vous haſardez beaucoup, Et manquant à frapper vous receuez le coup:	I Vous jugez bien par là, Seigneur, qu'il est à craindre De se précipi ter de plus de ne pas feindre, ue pour trop vous presser vous hasardez beaucoup, Et manquant à frapper vous recevez le coup:
Mais laiſſez pour vn temps agir voſtre prudence, Et laiſſez diſſiper toute leur violence;	Mais laissez pour un temps agir votre prudence, Et laissez dissiper toute leur violence;
Apres vous pourrez mieux les ranger au deuoir, Et par les chaſtimens monſtrer voſtre pouuoir.	Après vous pourrez mieux les ranger au devoir, Et par les châtiments montrer votre pouvoir.
» Voulez-vous vous venger des Mutins de l’Armée, Faites trancher la teſte au Prince Ptolomée;	" Voulez-vous vous venger des Mutins de l'Armée, Faites trancher la tête au Prince Ptolomée;
Ie vous l’ay deſia dit, ce coup fait tout pour vous, Et ſans rien hazarder vous les reduira tous:	Je vous l'ai déjà dit, ce coup fait tout pour vous, Et sans rien hasarder vous les réduira tous:
C eit la le feur moyen de vous bien ſatisfaire, Et les faire trembler d’auoir ſçeu vous deſplaire.	C' it la le seur moyen de vous bien satisfaire, Et les faire trembler d'avoir su vous déplaire.
LE ROY.	LE ROY.
Tes raiſons pour vn temps retiennent mon courroux Pour me bien ſatisfaire & pour les punir tous;	Tes raisons pour un temps retiennent mon courroux Pour me bien satisfaire et pour les punir tous;
Ie confeſſe auec toy qu’il faut vſer d’adreſſe, De peur de hazarder où l’Eſtat m’intereſſe.	Je confesse avec toi qu'il faut user d'adresse, De peur de hasarder où l'État m'intéresse.
Ie ſuiuray ton aduis:	Je suivrai ton avis:
mais dans ce ſentiment De n’eſpargner perſonne à mon reſſentiment.	mais dans ce sentiment De n'épargner personne à mon ressentiment.
Ie m’en vais cependant preuoir à ce tumulte, Apres toy ſur ce poinct aucun ie ne conſulte.	Je m'en vais cependant prévoir à ce tumulte, Après toi sur ce point aucun Je ne consulte.
I’auois deliberé d’aſſembler le Senat doueſiant la mort du’Prince apres lon attentat, Ton conſeil me ſuffit:	J'avais délibéré d'assembler le Sénat douéiant la mort duPrince après lon attentat, Ton conseil me suffit:
Mais ie voy qu’on l’ameine, Ie te laiſſe auec luy, ſa preſence me geſne, Prend garde à luy, ſa mort accomplit mes deſſeins.	Mais ici vois qu'on l'amène, Je te laisse imaires, sa présence me gêne, Prend garde à lui, sa mort accomplit mes desseins.
D e Renv Ne craignez pas, Seigneur, qu’il m’échape des mains, Son trépas doit ſeruir à iamais de memoire, On ne peut le Iauuer rans ternil voitre gloire, Et ſans trop hazarder.	D eu Renv Ne craignez pas, Seigneur, qu'il m'échappe des mains, Son trépas doit servir à jamais de mémoire, On ne peut le Jauver rans ternil voitre gloire, Et sans trop hasarder.
LE ROY.	LE ROY.
Quand vous vous parlerez, Deſcouure ſi tu peux qui ſont les conjurez.	Quand vous vous parlerez, Découvre si tu peux qui sont les conjurés.
DORIMAN.	DORIMAN.
L'y feray mes efforts, o que lay d'adantage:	L'y ferai mes efforts, ô que lai d'avantage:
De perdre mon Riual:	De perdre mon Rival:
mais changeons de langage Le voicy qui s’aproche.	mais changeons de langage Le voici qui s'approche.
SCENE VII.	SCÈNE VII.
ACIOMLE, DORIMAI, ELS GARDES,	ACIOMLE, DORIMAI, ELS GARDES,
PTOLOMEE.	PTOLOMEE.
HE' bien faut-il perir?	HÉ bien faut-il périr?
A-t’on iuré ma mort, dois-je viure ou mourir?	A-t-on juré ma mort, dois-je vivre ou mourir?
Ne me le celez point, le Roy veut ma deffaite?	Ne me le celez point, le Roi veut ma défaite?
le le connois aſſez par ſa prompre retraite.	le le connais assez par sa prompre retraite.
DORIMAN.	DORIMAN.
l'ay fait ce que i’ay pu ponr calmer ſon courroux, Comme vous entriez ie luy parlois de vous, lvous excuſeroit en nommant vos complices.	l'ai fait ce que j'ai pu ponr calmer son courroux, Comme vous entriez ie lui parlais de vous, lvous excuserait en nommant vos complices.
PTOLOMEE.	PTOLOMEE.
ll’inſulte-t’il encore auec ces artifices?	l'insulte-t-il encore avec ces artifices?
DORIMAN.	DORIMAN.
Ceſt là le ſeul moyen d’eſchaper à la mort.	Cest là le seul moyen d'échapper à la mort.
PTOLOMEE, Par ce ſeul moyen il faut changer mon ſort, le cede à mon mal-heur & ſouffre ſon injure, l'aime mieux le treſpas que d’vſer d’impoſtures le le dis, Doriman, i’aurois plus de regret De paroiſtre innocent que coupable en ſecret:	PTOLOME, Par ce seul moyen il faut changer mon sort, le cède à mon malheur et souffre son injure, l'aime mieux le trépas que d'user d'impostures le le dis, Doriman, j'aurais plus de regret De paraître innocent que coupable en secret:
Qu'on n’attende donc point de moy cette baſſeſſe, Que d’éuiter la mort par vne laſche addreſſe:	Qu'on n'attende donc point de moi cette bassesse, Que d'éviter la mort par une lâche adresse:
le conſents de mourir, & n’y recule pas, Ce qui combat mon cœur ce n’eſt plus le treſpas, Le crime qu’on m’impoſe eſt mon plus grand ſuplice, le ne deteſte plus que ſon laſche artifice, L’amour pour m’accabler ſe meſle auec luy, Par vn contraire effect tous deux font mon ennuy.	le consents de mourir, et n'y recule pas, Ce qui combat mon cœur ce n'est plus le trépas, Le crime qu'on m'impose est mon plus grand supplice, le ne déteste plus que son lâche artifice, L'amour pour m'accabler se mêle avec tu, Par un contraire effet tous deux font mon ennui.
Mais ne pourriez-vous point me rendre vn bon offiouſpie C'eſt de voir Berecinte à mes voux ſi propice, Que ie luy puiſſe encor parler de mon amour, I’auray moins je regret de perdre apres le iour:	Mais ne pourriez-vous point me rendre un bon offiousie C'est de voir Berecinte à mes voux si propice, Que iemmes puisse encor parler de mon amour, J'aurai moins je regret de perdre après le jour:
Pouuez-vous conſentir icy que ie la voye, Pour luy dire à la fois ma douleur & ma joye, nvertre amitie limplore aupres de vos faueurs, Accordez ce ſecours à mes grandes douleurs.	Pouvez-vous consentir ici que je la voie, Pour lui dire à la fois ma douleur et ma joie, nuer amitié limplore auprès de vos faveurs, Accordez ce secours à mes grandes douleurs.
DORIMAN.	DORIMAN.
Il eſt en mon pouuoir, Seigneur ie le confeſſe, De donner les moyens de reuoir la Princeſſe:	Il est en mon pouvoir, Seigneur Seigneur le confesse, De donner les moyens de revoir la Princesse:
Mais n’auez-vous point fait auant reflexion Sur tous les mouuemens de voſtre paſſion?	Mais n'avez-vous point fait avant réflexion Sur tous les mouvements de votre passion?
Auez-vous bien ſongé que dans cette entreueuë L’amour vous doit fraper du dernier coup qui tuë?	Avez-vous bien songé que dans cette entrevue L'amour vous doit frapper du dernier coup qui tue?
Qu’il vous faut appeller en ce funeſte eſtat Et la vie & la mort, & l’amour au combat?	Qu'il vous faut appeler en ce funeste état Et la vie et la mort, et l'amour au combat?
Ces tirans oppoſez plus craints que le tonnerte, Seront l’vn contre l’autre à vous faire la guerre;	Ces tyrans opposez plus craints que le tonnerte, Seront l'un contre l'autre à vous faire la guerre;
Chacun dans ſon party vous ayant engagé, Vous vous verrez cent fois en tous trois partagé:	Chacun dans son parti vous ayant engagé, Vous vous verrez cent fois en tous trois partagé:
Tous trois dedãs vous-meſme aux yeux de Berecint Decideront leur ſort pour donner plus d’atteinte, La vie en s’opoſant aux rigueurs de la mort, La mort qu’elle eſt pour vous le dernier reconfort, L’amour dans les regrets de quiter la Princeſſe Araiuua Pelort de moulin de cilteile.	Tous trois dedans vous-même aux yeux de Berecint Décidéront leur sort pour donner plus d'atteinte, La vie en s'opposant aux rigueurs de la mort, La mort qu'elle est pour vous le dernier réconfort, L'amour dans les regrets de quit la Princesse Araiva Pelort de moulin de cilteile.
Ainſi dans ces combats decidans voſtre ſort, L’amour cede à la vie, & la vie à la mort:	Ainsi dans ces combats décidans votre sort, L'amour cède à la vie, et la vie à la mort:
Croyez-m’en donc, Seigneur, éuitez ſa preſence, Ne vous commettez pas à cette violence.	Croyez-m'en donc, Seigneur, évitez sa présence, Ne vous commettez pas à cette violence.
PTOLOMEE.	PTOLOMEE.
Penſez-vous que cela puiſſe eſtre en mon pouuoir?	Pensez-vous que cela puisse être en mon pouvoir?
Et que mon cœur comenite à ne plus la reuorr?	Et que mon cœur contenite à ne plus la révorr?
Ah!	Ah!
que vous iugez mal des tranſports de mon ameſſe Quand ſa preſence icy doit couronner ma flame:	que vous jugez mal des transports de mon âmesse Quand sa présence ici doit couronner ma flamme:
pien loin de me cauſer de ces bas mouuemens, Elle m’inſpirera les plus hauts ſentimens, Elle fortifiera mon eſprit à la peine, 2 12 1 Et conſumé des feux des beaux yeux de ma Reyne, l'iray dans cét eſtat d’vn ſeur & ferme pas Affronter mon Tyran, & brauer mon treſpas:	pien loin de me causer de ces bas mouvements, Elle m'inspirera les plus hauts sentiments, Elle fortifiera mon esprit à la peine, 2 12 1 Et consumé des feux des beaux yeux de ma Reine, l'irai dans cet état d'être seur et ferme pas Affronter mon Tyran, et braver mon trépas:
ne pentter pome de cempo, rartes que ie la voye, Pour preuenir mon ſort i’en puis mourir de ioye.	ne penter pome de cempo, rartes que Elle la voie, Pour prévenir mon sort j'en puis mourir de joie.
DORIMAN.	DORIMAN.
dlia du auiauece puo concencer vecdeillos	dlia du auiauece pu concencer vecdeillos
PTOLOMEE	PTOLOME
Donnons en l’attendant relaſche à mes ſoupirs.	Donnons en l'attendant relâche à mes soupirs.
DORIMAN à vn bout du Theatre.	DORIMAN à un bout du Théâtre.
Que ie me croirois laſche apres toute ma haine, Si i’allois conſentir à ſoulager ta peine!	Que ie me croirais lâche après toute ma haine, Si j'allais consentir à soulager ta peine!
Moy ſouffrir qu’vn Riual vid encor à ſes yeux Cét adorable object qui fit naiſtre mes feux!	Moi souffrir qu'un Rival vit encor à ses yeux Cet adorable object qui fit naître mes feux!
le n’auray point pour toy de telle complaiſance, Quand meſme tu mourrois de ioye en ſa preſence;	le n'aurai point pour toi de telle complaisance, Quand même tu mourrais de joie en sa présence;
ma naille va plus ioin, l laut la contencel.	ma naille va plus join, l laut la contencel.
Il parle à l'oreille, „ ſſcoutez, & lur tout gardez de le quitter.	Il parle à l'oreille, „ scoutez, et lur tout gardez de le quitter.
SCENE VIII.	SCÈNE VIII.
PTOLOMEE éloigné des Gardes.	PTOLOME éloigné des Gardes.
STANCES.	STANCES.
Egret dont le penſer me tuë, N Tu reſponds mal à tes apas, Quand tu vois mon ame abatuë De l’implacable ſort qui preſſe mon trepas.	Egret dont le penser me tue, N Tu réponds mal à tes appas, Quand tu vois mon âme abattue De l'implacable sort qui presse mon trépas.
Tu me viens preſenter des charmes;	Tu me viens présenter des charmes;
Va, c’eſt me demander des larmes.	Va, c'est me demander des larmes.
Laiſſe au mal-heur finir mon ſort.	Laisse au malheur finir mon sort.
Ne m’importune plus par tes foibles amorces, Tu ne peux rien contre la mort, 2 L’amour qui ta fait naiſtre a beſoin d’autres forces.	Ne m'importune plus par tes faibles amorces, Tu ne peux rien contre la mort, 2 L'amour qui ta fait naître a besoin d'autres forces.
Au iour pompeux d'vn Hymenee, Par vn changement impreueu, Ie connois par ma deſtinee Qu'vn bien n’eſt pas vn bien ſans en eſtre pourueu.	Au jour pompeux d'un Hymène, Par un changement impreu, Je connais par ma destinée Qu' bien n'est pas un bien sans en avoir pourvu.
L’amour flatoit mon eſperence, Tout me rioit dans l’aparence:	L'amour flattait mon espérence, Tout me riait dans l'apparence:
Mais le mal-heur par vn reuers Fait de ce grand eſclat vne pompe funebre, Pour publier à l’Vniuers, Que l’amour & la mort faiſoient vn iour celebre.	Mais le malheur par un revers Fait de ce grand éclat une pompe funèbre, Pour publier à l'Univers, Que l'amour et la mort faisaient un jour célèbre.
A qui puis-je adreſſer ma plainte!	À qui puis-je adresser ma plainte!
Qui me ſoulage en mes ennuis?	Qui me soulage en mes ennuis?
Ce ne peut eſtre à Berecinte, Elle languit aſſez de l’eſtat où ie ſuis.	Ce ne peut être à Berecinte, Elle languit assez de l'état où je suis.
Loin d’affermir ma patience D'vn contre-coup de ma ſouffrance, Nos cœurs ſuiuent vn meſme ſort:	Loin d'affermir ma patience D'un contre-coup de ma souffrance, Nos cœurs suivent un même sort:
Et l'eſpoir de ce iour qui nous donnoit la vie, A tous les deux cauſe la mort, Laiſſant à noſtre amour d’en accuſer l’enuie.	Et l'espoir de ce jour qui nous donnait la vie, À tous les deux cause la mort, Laissant à notre amour d'en accuser l'envie.
Rudes ſentimens de mon ame!	Rudes sentiments de mon âme!
Si vous voulez me conſoler, Cherchez-vous l’objet de ma flame Peur aller à la mort ſans luy pouuoir parler?	Si vous voulez me consoler, Cherchez-vous l'objet de ma flamme Peur aller à la mort sans te pouuoir parler?
C’eſt donc vous ſoûpirs que i’implore, Deuant la beauté que i’adore, Parlez au deffaut de ma voix.	C'est donc vous soupirs que j'implore, Dévant la beauté que j'adore, Parlez au défaut de ma voix.
Pour mieux vous animer regretez tant de charmes, Faites luy voir à cette fois que pour mourir contant ie Ieroit de leurs armes.	Pour mieux vous animer règretez tant de charmes, Faites lui voir à cette fois que pour mourir contant ie Ieroit de leurs armes.
STRATON entrant Par vn ordre, Seigneur, il faut vous retirer.	STRATON entrant Par un ordre, Seigneur, il faut vous retirer.
PTOLOMEE.	PTOLOMEE.
l'attendois la Princeſſe.	l'attendais la Princesse.
4* l'ordre preſſe.	4* l'ordre presse.
STRATON.	STRATON.
On ne peur differer,	On ne peur différer,
PTOLOMEE.	PTOLOMEE.
Peut-on m’accabler dauantage?	Peut-on m'accabler davantage?
Allons, obeïſſons, mon cœur reprend courage.	Allons, obéissons, mon cœur reprend courage.
Fin du troifieſme Acte.	Fin du troifiesme Acte.
ACIEI 2 1 SCENE PREMIERE.	ACIEI 2 1 CÈNE PREMIÈRE.
LA REYNE, PAVLINE.	LA REINE, PAULINE.
110	110
44 PAVLINE.	44 PAULINE.
1.	1.
Aonisde enollt E l’aduoüray, Madame, à ma confuſion, Tous me viſtes ſenſible à la compaſſion:	Aonidède enollt E l'avouerai, Madame, à ma confusion, Tous me vîtes sensible à la compassion:
Ie ne preuoyois pas qu’elle euſt cette artifice, De rendre à voſtre Eſtat vn ſi mauuais office;	Je ne prévois pas qu'elle eût cette artifice, De rendre à votre État un si mauvais office;
On tient que tous ſes gens deuiennent furieux, Et ſont tous les premiers d’entre les factieux, Qu’ils ont fait le party pour ſauuer Ptolomee, Et qu’à force de brigue ils diſſipent l’Armee;	On tient que tous ses gens deviennent furieux, Et sont tous les premiers d'entre les factieux, Qu'ils ont fait le parti pour sauver Ptolomée, Et qu'à force de brigue ils dissipent l'Armée;
Ceux de ce riinee auiii le foiit fomts à leurs bras, Et ſont tous reſolus d’empeſcher ſon trépas;	Ceux de ce riine auiii le foiit fompts à leurs bras, Et sont tous résolus d'empêcher son trépas;
Ne cherchez plus ailleurs les autheurs du tumulte, Vous les venez d’apprendre.	Ne cherchez plus ailleurs les auteurs du tumulte, Vous les venez d'apprendre.
PAVLINE.	PAULINE.
Madame le voicy	Madame le voici
LA REYNE.	LA REINE.
A punir Berecinte il faut que ie l’engage.	À punir Berecinte il faut que ici l'engage.
LA REYNE.	LA REINE.
Il faut que ie confulte Sur ce poinct Doriman, il doit ſe rendre icy;	Il faut que ici confulte Sur ce point Doriman, il doit se rendre ici;
Exprés ie l’ay mandé.	Exprès Prince l'ai mandé.
2	2
SCENE II.	SCÈNE II.
la REINE, DORTMAN, PAVLINE.	la REINE, DORTMAN, PAULINE.
3011 LA REINE.	3011 LA REINE.
Es mutins ceſſent-ils contre nous leur outrage?	Es mutins cessent-ils contre nous leur outrage?
DORIMAN.	DORIMAN.
De plus en plus, Madame, on les voit l’augmenter, Al’enuy l’vn de l’autre on les voit s’irriter;	De plus en plus, Madame, on les voit l'augmenter, Al'envi l'un de l'autre on les voit s'irriter;
Et meſme ie craindrois que dans leur violence, onne vitt fuiqu au Tiome aller leur inſolence, Amoins que d’vn moyen qui peut ſeul l’empeſcher, nuit le feux à prendre, & le ſeul à chercher.	Et même ie craindrais que dans leur violence, onne vitt fuiqu au Tiome aller leur insolence, Amoins que d'un moyen qui peut seul l'empêcher, nuit le feux à prendre, et le seul à chercher.
LA REYNE.	LA REINE.
Quel eſt-il ce moyen?	Quel est-il ce moyen?
DORIMAN.	DORIMAN.
I'ay peine à vous le dire.	J'ai peine à vous le dire.
Reignõs pour en parler que mon cœur en ſoupire;	Reignons pour en parler que mon cœur en soupire;
bas.	bas.
Importune contrainte à quelle extremité lleduis-tu donc mon cœur & ma ſincerité?	Importune contrainte à quelle extrémité léléduis-tu donc mon cœur et ma sincérité?
luoy pour fauuer l’Eſtat dans vn peril extreme!	luéroi pour sauver l'État dans un péril extrême!
faut-il perdre vn amy plus chery que moy-meſme?	faut-il perdre un ami plus chéri que moi-même?
ah!	ah!
prenez part, Madame, à mon reſſentiment, it donnés du felarene à moircœn vn moment.	prenez part, Madame, à mon ressentiment, it donnés du félarène à moircœnt un moment.
Souffrez que mes regrets vous expliquent ma peine, mant de deſcouurir la cauſe qui me geſne.	Souffrez que mes regrets vous expliquent ma peine, mant de découvrir la cause qui me gêne.
LA REYNE.	LA REINE.
ſnfin que ſcauez-vous qui nous peut ſecourir?	snfin que savez-vous qui nous peut secourir?
DORIMAN.	DORIMAN.
l'eſt le treſpas du Prince où l’on doit recourir.	l'est le trépas du Prince où l'on doit recourir.
LA REINE.	LA REINE.
Deuiez-vous balancer à me nommer vn traiſtre?	Deviez-vous balancer à me nommer un traître?
D iij	 Dijà
DORIMAN.	DORIMAN.
La pitié l’empeſchoit, vous l’auez pû connoiſtre, Souffrez ſans auoir part à ſon laſche attentat, Qu’vn reſte de pitté le pleigne en cét eſtat.	La pitié l'empêchait, vous l'avez pu connaître, Souffrez sans avoir part à son lâche attentat, Qu'un reste de pitté le pleigne en cet état.
Di REINE.	Dis REINE.
Luy ſeul doit-il mourir ſans punir les complices?	Lui seul doit-il mourir sans punir les complices?
DORIMAN.	DORIMAN.
AVXIARI Le temps amenera celuy de leurs ſuplices:	AUXIARI Le temps amènera celui de leurs suplices:
Mais ſans plus differer eſcartons les mutins, Pour nous mettre à couuert de nos mauuais deſtins Comme i’ay deſia dit, helas!	Mais sans plus différer écartons les mutins, Pour nous mettre à couvert de nos mauvais destins Comme j'ai déjà dit, hélas!
la mort du Prince Eſtablit le repos de toute la Prouince;	la mort du Prince Établit le repos de toute la Province;
Plus de ſeditieux, plus de rebellion;	Plus de séditieux, plus de rébellion;
Sa mort fait diſſiper toute la faction, Di onilon 210 La cauſe n’eſtant plus, qui les fait entreprendre, Vous les verrez d’eux meſme a nous le venir rendre, ſloin Et chacun reuenans ſans force à ſondeuoir, Sans riſque à les punir nous ferons en pouuoir.	Sa mort fait dissiper toute la faction, onilon 210 La cause estant plus, qui les fait entreprendre, Vous les verrez eux même a nous le venir rendre, Sa Mort fait dis sans toute la faction, Sans risque on les punir nous ferons en pouvoir.
LA REINE.	LA REINE.
Mais ce n’eſt pas aſſez pour moy d’vne victime, Il en faut au moins deux poul tolerer te crime, Ou mon cœur autrement d’vne viue douleur, Va reſſentir ſans eux tous les coups du mal-heur:	Mais ce n'est pas assez pour moi d'une victime, Il en faut au moins deux poul tolérer te crime, Ou mon cœur autrement d'une vive douleur, Va ressentir sans eux tous les coups du malheur:
Mais il ne peut ſans vous auoir ce qu’il ſouhaite.	Mais il ne peut sans vous avoir ce qu'il souhaite.
DORIMAN.	DORIMAN.
S’il eſt en mon pouuoir de vous voir ſatisfaite, Madame, commandez, ie ſuis preſt d’obeir, I’executeray tout iuſques à me trahir.	S'il est en mon pouvoir de vous voir satisfaite, Madame, commandez, ie suis prêt d'obéir, J'exécuterai tout jusques à me trahir.
LA REINE.	LA REINE.
Ie le croy, Doriman, taſchez donc par adreſſe Qu'a la mort Seleucus condamne la Princeſſe;	Je le crois, Doriman, tâchez donc par adresse Qu'a la mort Seleucus condamne la Princesse;
Il ſuit voſtre conſeil, vous auez tout credit:	Il suit votre conseil, vous avez tout crédit:
Mais quoy vous palliſſez?	Mais quoi vous pallissez?
vous eſtes interdit?	vous êtes interdit?
Eſt-ce là vous trahir d’eſtre ſaiſi de crainte Quand ie cherche à venger l’Eſtat de Berecinte?	Est-ce là vous trahir d'être saisi de crainte Quand tu cherche à venger l'État de Berecinte?
La cauſe de nos maux & de tous nos mal-heurs?	La cause de nos maux et de tous nos malheurs?
vous iie relpondez pas â mes vmes dodreuis3	vous jie répondez pas â mes vmes dodreuis3
DORIMAN.	DORIMAN.
1 lladame, il eſt bien vray que mon eſprit s’eſtonne De voir iuſqu’à quel poinct le voſtre s’abandonne;	1 ladame, il est bien vrai que mon esprit s'étonne De voir jusqu'à quel point le vôtre s'abandonne;
Pardonnés ſi ie dis que l’animoſité.	Pardonnez si On dis que l'animosité.
Jous fait venir contre elle à certe extremité;	Jous fait venir contre elle à certe extrémité;
Mlon lexé los foix lortent laindeis la vie, Sins irriter les Dieux, ou la peine eſt ſuiuie.	Mlon lexé los faix lortent lainis la vie, Sins irriter les Dieux, ou la peine est suivie.
QUEM LAIREINE.	QUEM LAIREINE.
PO HON OI OD Quoy donc ie la verray regner en cette Cour?	PÔ HON OI OD Quoi donc je la verrai régner en cette Cour?
Se liguer contre nous pour venger ſon amour?	Se liguer contre nous pour venger son amour?
sous l’aueu de nos loix demeurante impunie, Nous preparer des maux de ſa haine infinie?	sous l'aveu de nos lois demeurante impunie, Nous préparer des maux de sa haine infinie?
Mon, non, oppoſons nous aux rigueurs de ces loys, les Dieux peimettent tout pour le ſalutides Roys;	Mon, non, opposons nous aux rigueurs de ces lois, les Dieux péimettent tout pour le salutides Rois;
dro loin d’attirer ſur nous leur haine & leur colere, Pour maintenir ſon Troſne on fait mourir ſon perez le pere à meſme droict il fait mourir ſon fils, lt le Sceptre des Roys ſe conſerue à ce prix.	dro loin d'attirer sur nous leur haine et leur colère, Pour maintenir son Trône on fait mourir son pérez le père à même droit il fait mourir son fils, lut le Sceptre des Rois se conserve à ce prix.
DORIMAN, lluſtoſt qu'elle periſſe il faut perir moy-meſme, bas.	DORIMAN, llustost qu'elle périsse il faut périr moi-même, bas.
ſmour vſons icy de queſque ſtratageme.	smour usons ici de quesque stratagème.
le l’aduoüray, Madame, elle eſt digne de mort;	le l'avouerai, Madame, elle est digne de mort;
complice d’vn Amant, c’eſt meriter ſon ſort.	complice d'un Amant, c'est mériter son sort.
Mlais Seleucus touché de tendreſſe pour elle.	Mlais Seleucus touché de tendresse pour elle.
2	2
LA REINE.	LA REINE.
C'eſt là le fondement de ma haine immortelle.	C'est là le fondement de ma haine immortelle.
bas.	bas.
DORIMAN.	DORIMAN.
Ne pourra pas d'abord reſpondre a vos ſouhaits, Il faut prendre ſon temps & ſonger à la paix, Appaiſer le tumulte.	Ne pourra pas d'abord répondre à vos souhaits, Il faut prendre son temps et songer à la paix, Apaiser le tumulte.
LA REYNE.	LA REINE.
Et bien que faut-il faire?	Et bien que faut-il faire?
DORIMAN, Faut-il vous dire encor ce que ie deuois taire?	DORIMAN, Faut-il vous dire encor ce que ici devais taire?
En vn mot enuoyez Prolomee au treſpas, Et preſſez-en le Roy pour ſauuer vos Eſtats;	En un mot envoyez Prolomée au trépas, Et pressez-en le Roi pour sauver vos États;
Le Prince n’eſtant plus, nous n’auons plus de craint Berecinte aduoüra ſon crime ſans contrainte;	Le Prince n'étant plus, nous n'avons plus de craint Berecinte aduoüra son crime sans contrainte;
Dira tout d’elle-meſme, & ne celera rien;	Dira tout d'elle-même, et ne cèlera rien;
Sa mort.	Sa mort.
Mais elle vient, ceſſons cét entretien.	Mais elle vient, cessons cet entretien.
LA REINE.	LA REINE.
La rougeur à ſa veuë au viſage me monte, Dans mon reſſentiment le dépit me ſurmonte;	La rougeur à sa vue au visage me monte, Dans mon ressentiment le dépit me surmonte;
Ie vous laiſſe, taſchez d’aprendre ſon ſecret, Ce que ie pourrois dire auprés d’elle eſt ſuſpect;	Je vous laisse, tâchez d'apprendre son secret, Ce que tu pourrais dire auprès d'elle est suspect;
Et puis ie vais preſſer la mort de Ptolomee, Pour enuoyer ſa teſte aux mutins de l’Armee.	Et puisque vais presser la mort de Ptolome, Pour envoyer sa tête aux mutins de l'Armée.
SCENE III.	SCÈNE III.
DORIMAN, BERECINTE, SABINT	DORIMAN, BÉRECINTE, SABINT
BERECINTE.	BÉRECINTE.
Que puis-je en eſperer, s’il agit contre moy?	Que puis-je en espérer, s'il agit contre moi?
D’exciter les mutins s’il m’accuſe luy-meſme?	D'exciter les mutins s'il m'accuse lui-même?
Tu le ſçais ſi ie crains dans ce peril extreſme Où ie preuois ſa mort?	Tu le sais si ici crains dans ce péril extrême Où ici prévois sa mort?
DORIMAN.	DORIMAN.
le Ia dols aborder, Taſcher qu’à mes raiſons elle puiſſe ceder?	le Ia dols aborder, Tâcher qu'à mes raisons elle puisse céder?
Abandonne le Prince.	Abandonne le Prince.
BERECINTE.	BÉRECINTE.
Et ie perds eſperance.	Et g perds espérance.
SABINE.	SABINE.
Les Dieux ſeront pour vous, ils ſont pour l’innocence	Les Dieux seront pour vous, ils sont pour l'innocence
DORIMAN.	DORIMAN.
Le pitoyable eſtat où vous mettent vos pleurs, Apporte iuſqu’à moy vos plus viues douleurs;	Le pitoyable état où vous mettent vos pleurs, Apporte jusqu'à moi vos plus vives douleurs;
lon cœur en eſt percé d’vne ſi rude attainte, Que pour vous l’expliquer ie ne le puis ſans crainte:	lon cœur en est percé d'une si rude attainte, Que pour vous l'expliquer toujours ne le puis sans crainte:
llais ne pourriez-vous pas faire vn effort ſur vous?	lais ne pourriez-vous pas faire un effort sur vous?
Sans encor exciter la rigueur de leurs coups, lu lien d’y reſiſter & rapeller vos forces, ous vous laiſſez aller à leur triſtes amorces;	Sans encor exciter la rigueur de leurs coups, lu lien d'y résister et rappeler vos forces, ous vous laissez aller à leur tristes amorces;
ti comme ſi leurs coups eſtoient remplis d’attraits, jous voulez contre vous qu’ils lancent tous leurs traits;	ty comme si leurs coups étaient remplis d'attraits, jou lez contre vous qu'ils lancent tous leurs traits;
qui r’animans leur force au torrent de vos larmes, lettent toute voſtre ame en de rudes allarmes:	qui ranimants leur force au torrent de vos larmes, lettent toute votre âme en de rudes alarmes:
llais il ne tient qu’à vous d’éuiter ce tourment;	lais il ne tient qu'à vous d'éviter ce tourment;
lamot, vn repentir, le chaſſe en vmmoment;	lamot, un repentir, le chasse en voment;
Seulement deſirez, vous trouuez le remede;	Seulement désirez, vous trouvez le remède;
la joye auſſi-toſt vient, & l’ennuy ceſſe & cedes Encor qu’on taſche icy d’attenter à vos iours, leſuis à vous, Madame, & i’y ſeray touſiours;	la joie aussitôt vient, et l'ennui cesse et cèdes Encor qu'on tâche ici d'attenter à vos jours, lesuis à vous, Madame, et j'y serai toujours;
llon appuy vous ſuffit pour eſtre en aſſurance, On n’entreprendra point ſur vous de violence, bur vous mettre à l’abry des injures du ſort, buiuez mes ſentimens, & prenez mon ſuport;	llon appui vous suffit pour être en assurance, On n'entreprendra point sur vous de violence, bur vous mettre à l'abri des injures du sort, buiez mes sentiments, et prenez mon support;
lbandonez ce Prince aux peines de ſon crime, lt laiſſez au mal-heur en faire vne victime;	lbandonez ce Prince aux peines de son crime, laît laissez au malheur en faire une victime;
0 Ne preuoyez-vous pas que dans l’eſtat qu’il eſt, Iien ne peut le ſouſt raire aux rigueurs d’vn Arreſt, Que malgré vos regrets le Roy veut qu’il periſſe, Et qu’en vain vous pleurez ſa perte & ſon ſupplice.	0 Ne prévoyez-vous pas que dans l'état qu'il est, Jien ne peut le sout raire aux rigueurs d'un Arrêt, Que malgré vos regrets le Roi veut qu'il périsse, Et qu'en vain vous pleurez sa perte et son supplice.
Son mal-heur eſt au poinct que qui parle pour luy, Il ſe rend criminel & ſe voit ſans appuy;	Son malheur est au point que qui parle pour lui, Il se rend criminel et se voit sans appui;
Et loing par ſes efforts de luy ſauuer la vie, ll en preſſe le terme, ou la ſienne eſt ſuiuie, Et perdant tout eſpoir en cette extremité, ll ſerepent trop tard d’auoir trop ſouhaité.	Et loin par ses efforts de même sauver la vie, ll en presse le terme, ou la sienne est suivie, Et perdant tout espoir en cette extrémité, l serepent trop tard d'avoir trop souhaité.
Reprenez donc vos ſens, fuyez le precipice, 1 L 2 2 Que vous creuſez vous meſme en pleurãt ſon ſupliee;	Reprenez donc vos sens, fuyez le précipice, 1 L 2 2 Que vous creusez vous même en pleurant son suplie;
Enfin defaites-vous de ſuiure vn mal-heureux, Qui par ſon mauuais ſort vous va perdre tous deux Qui porte ſes rigueurs à cette dependance, Que ii partage auec vous ſon crime & ſa ſouffrance	Enfin défaites-vous de suivre un malheureux, Qui par son mauvais sort vous va perdre tous deux Qui porte ses rigueurs à cette dépendance, Que ji partage avec vous son crime et sa souffrance
BEREGINTE.	BÉREGINTE.
Helas!	Hélas!
que ces raiſons ſont peu fortes pour moy, Qui loin de m’eſbranler affermiſſent ma foy;	que ces raisons sont peu fortes pour moi, Qui loin de m'ébranler affermissent ma foi;
Ie ne puis le celer, que ie mourrois contente, Mourant auecque luy c’eſt remplir mon attente;	Je ne puis le celer, que ici mourrais contente, Mourant auecque tu c'est remplir mon attente;
I1u noins maigre le fort nous nous verrons tous de Par vn heureux treſpas au dernier de nos vœux.	I1u noins maigre le fort nous nous verrons tous de Par un heureux trépas au dernier de nos vœux.
DORIMAN.	DORIMAN.
Que vous eſtes cruelle;	Que vous êtes cruelle;
ah!	ah!
ſongez-y, Madame, Dans voſtre emportement ie voy vortre belle ame:	songez-y, Madame, Dans votre emportement je vois vortre belle âme:
Mais encor vne fois ayez moins de rigueur, Et ne le ſuiuez pas pour ſuiure ſon mal-heur.	Mais encore une fois ayez moins de rigueur, Et ne le suivez pas pour suivre son malheur.
BEREONNTE.	BÉREONTE.
Ceſſez de m’en parler, c’eſt forcer ma conſtance, Ie ne puis plus ſouffrir vn diſcours qui m’offence.	Cessez de m'en parler, c'est forcer ma constance, Je ne puis plus souffrir un discours qui m'offense.
DORIMAN.	DORIMAN.
Ie me tais.	Je me tais.
ar quer ponte na porte lon amour?	ar quer ponte na porte lon amour?
ba	ba
BERECINTE.	BÉRECINTE.
Mais auant Doriman que de perdre le iour, Oſerois-je de vous me promettre vne grace?	Mais avant Doriman que de perdre le jour, Oserais-je de vous me promettre grâce?
DORIMAN.	DORIMAN.
Vous le pouuez, pour vous que faut-il que ie faſſe?	Vous le pouvez, pour vous que faut-il que deux fasse?
I’en atteſte les Dieux, s’il eſt en mon pouuoir, Madame, attendez tout de mon iuſte deuoir.	J'en atteste les Dieux, s'il est en mon pouvoir, Madame, attendez tout de mon juste devoir.
BERECINTE.	BÉRECINTE.
M Faites donc amener le Prince Ptolomee, Sa veuë eſt le ſeul bien de mon ame opprimee;	M Faites donc amener le Prince Ptolome, Sa vue est le seul bien de mon âme opprimée;
Au milieu des mal-heurs nous aurons le plaiſir De pouſſer l’vn à l’autre au moins quelque ſoûpir, Dans ces preſſents Adieux au plus fort des allarmes, Au deffaut de la voix nous tarirons nos larmes;	Au milieu des malheurs nous aurons le plaisir De pousser l'un à l'autre au moins quelque soupirons, Dans ces présents Adieux au plus fort des alarmes, Au défaut de la voix nous tarirons nos larmes;
Et l’amour dans nos cœuis ne failalit que les feux, Nous irons à la mort nous animans tous deux:	Et l'amour dans nos cœur ne failalit que les feux, Nous irons à la mort nous animant tous deux:
lais quoy vous témoignez vous faire vne cõtrainte?	lais quoi vous témoignez -vous faire une cõtrainte?
ctie vous voy changer de colere ou de crainte?	ctie vous vo iser de colère ou de crainte?
Seriez-vous ſi contraire à nos reſſentimens?	Seriez-vous si contraire à nos ressentiments?
Que de nous refuſer de plaindre nos tourmens?	Que de nous refuser de plaindre nos tourments?
DORIMAN.	DORIMAN.
lladame, croyez mieux du ſerment qui m’engage, leſens deſia pour vous de l’amour tout l’outrage;	ladame, croyez mieux du serment qui m'engage, les desya pour vous de l'amour tout l'outrage;
lele reſſentiment de vos viues douleurs lle force à deteſter l’auteur de vos mal-heurs;	le ressentiment de vos vives douleurs lè force à détester l'auteur de vos malheurs;
qui portant iuſqu’à moy voſtre rude ſupplice, lle font peine à vous rendre encor vn triſte office:	qui portant jusqu'à moi votre rude supplice, lèle font peine à vous rendre encor un triste office:
niuis vous le launaiter, le vaigrexceucen, Jous reuerrez le Prince, il faut vous contenter.	niuis vous le launaiter, le vaigrexceucen, Jous réverrez le Prince, il faut vous contenter.
a da d adu nva BERECIEB, ONDIRE.	a da dus nu nua BERECIEB, ONDIRE.
SABINE.	SABINE.
Nfin vous allez voir l’objet de voſtre flame.	Nfin vous allez voir l'objet de votre flamme.
L BERECINTE.	 LERCINTE.
D'vn bien ſuiuy de pleurs ne flate point mon ame;	D'un bien suivi de pleurs ne flatte point mon âme;
Scais-tu que la douleur de ne plus ſe reuoir, Doit en nous ſeparant nous mettre au dcleipoir?	Sais-tu que la douleur de ne plus se revoir, Doit en nous séparant nous mettre au dcleipoir?
luge de ces tranſports de perdre ce qu’on aime, Mlon cœur deſia fremit, & i’en ſents en moy-meſme Par le ſeul ſouuenir mes ſens ſe reuolter, ae ne ſeras-ce point venant à nous quitter?	luge de ces transports de perdre ce qu'on aime, Mlon cœur déjà frémit, et j'en sents en moi-même Par le seul souvenir mes sens se révolter, ae ne servas-ce point venant à nous quitter?
SABINE.	SABINE.
lladame eſperez mieux de voſtre grand courage, De vous-meſme attendez tout vn autre aduantage, l'amour, le ſeul amour fortifiera vos cœurs.	ladame espérez mieux de votre grand courage, De vous-même attendez tout un autre avantage, l'amour, le seul amour fortifiera vos cœurs.
BERECINTE.	BÉRECINTE.
Dis pluſtoſt que luy ſeul cauſera nos douleurs.	Dis plutôt que deux seul causera nos douleurs.
SABINE.	SABINE.
Peut-eſtre que les Dieux touchez de Pinnocence.	Peut-être que les Dieux touchés de Pinnocence.
Feront en vos faueurs êclater leur puiſſance, Que ne pouuant ſouffrir contre vous d’attentat, Ils changeront pour vous de victime à l’Eſtat.	Feront en vos faveurs éclater leur puissance, Que ne pouvant souffrir contre vous d'attentat, Il changeront pour vous de victime à l'État.
BERECINTE.	BÉRECINTE.
Tu te flates, Sabine, auec peu d’apparence, Les Dieux ſon irritez, ie preuoy leur vengence;	Tu te flattes, Sabine, avec peu d'apparence, Les Dieux son irrités, ie preuoy leur vengence;
Souuent pour des raiſons qu’ignorent les mortels, Et ſouuent le peruers ſans cauſes legitimes, Le comblent de bon-heur & couronnent ſes crimes.	Souvent pour des raisons qu'ignorent les mortels, Et souvent le pervers sans causes légitimes, Le comblent de bonheur et couronnent ses crimes.
SABINE.	SABINE.
Souuent apres auſſi laſſez de ſes forfaits, L’en voyants ſurchargé l’eſcraſent ſous le faix;	Souvent après aussi lassez de ses forfaits, L'en voyant surchargé l'écrasent sous le faix;
Et Iouuent l’innocent contre toute apparence, Au point de ſon treſpas attire leur clemence, Et ſe voit garenty de ſon prochain mal-heur.	Et Jouvent l'innocent contre toute apparence, Au point de son trépas attire leur clémence, Et se voit garenti de son prochain malheur.
BERECINTE.	BÉRECINTE.
Crois-tu que cét eſpoir ſoulage ma douleur?	Crois-tu que cet espoir soulage ma douleur?
Helas!	Hélas!
que ie ſuis loing d’vne grace ſemblable, Pour ſauuer l’innocent de punir le coupable, De croire que les Dieux voudroient s’armer pour nous,m iaiot i 2 Quãd iuſqu’icy nos maux ont monſtré leur courroux, Quand leur foudre eſt tout preſt de tomber ſur nos teſtes, 106 C’eſt ſe croire eſtre au port au milieu des tempeſtes;	que je suis loin d'une grâce semblable, Pour sauver l'innocent de punir le coupable, De croire que les Dieux voudraient s'armer pour nous, jaimot y 2 Quand jusqu'ici nos maux ont montré leur courroux, Quand leur foudre est tout prêt de tomber sur nos têtes, 106 C'est se croire être au port au milieu des tempêtes;
Non, non, ie n’attends pas de ſecours impreueu, De nous perdre tous deux il eſt trop reſolu.	Non, non, Madame n'attends pas de secours imprévu, De nous perdre tous deux il est trop résolu.
SABINE.	SABINE.
Madame, armez-vous donc d'vne ferme conſtance, Aux mal-heurs ſans remede il faut la patience;	Madame, armez-vous donc d'une ferme constance, Aux malheurs sans remède il faut la patience;
D'vne neceſſité faites vne vertu, Et ne nous montrez plus vn viſage abbatu:	D'une nécessité faites une vertu, Et ne nous montrez plus un visage abattu:
Mais Doriman reuient auecque Ptolomée.	Mais Doriman revient auecque Ptolomée.
BERE	BÉRE
BERECEINTE.	BÉRECEINTE.
De joye & de douleur mon ame eſt allarmée;	De joie et de douleur mon âme est alarmée;
Mon cœur à cét abord r’appelle u vigueur.	Mon cœur à cet abord rappelle vigueur.
SCENE V.	SCÈNE V.
PTOLOMEE, BERECINTE, DORIMAN, SABINE, LES GARDES.	PTOLOME, BERECINTE, DORIMAN, SABINE, LES GARDES.
DORIMAN.	DORIMAN.
IE ſatisfaits, Madame, aux vœux de voſtre cœur, IQuunt te ſȩay le mojen de vous eltre propice.	JE satisfaits, Madame, aux vœux de votre cœur, IQuunt te sais le mojen de vous eltre propice.
bas:	bas:
BERECINTE.	BÉRECINTE.
balliez-hous Teuls icy, joignez-y ce ſeruice.	balliez-hous Teuls ici, joignez-y ce service.
DORIMAN.	DORIMAN.
Madame, i’y conſents;	Madame, j'y consents;
Il faut les eſcouter.	Il faut les écouter.
PTOLOMEE.	PTOLOMEE.
Si preſt du coup fatal que ie dois redouter, Sur le poinct de ſeruir de victime à l'enuie, Et de voir par ma mort la fureur aſſouuie;	Si prêt du coup fatal que ainsi dois redouter, Sur le point de servir de victime à l'envie, Et de voir par ma mort la fureur assouuie;
Si preſt de vous quitter & de perdre le iour, Souffrez que mes regrets expliquent mon amours Le penſer de la mort, la perte de vos charmes, Dans mon ame agitée excitent mille allarmes;	Si prêt de vous quitter et de perdre le jour, Souffrez que mes regrets expliquent mon amours Le penser de la mort, la perte de vos charmes, Dans mon âme agitée excitent mille alarmes;
Et l’eſclat ſurprenant d'vne illuſtre beauté, Eſbranle ma conſtance & détruit ma fierté;	Et l'éclat surprenant d'une illustre beauté, Ébranle ma constance et détruit ma fierté;
Quelques ſoient les mal-heurs dont la mort me deliure, Sur le poinct d’expirer ie ſouhaite de viure;	Quelques soient les malheurs dont la mort me délivre, Sur le point d'expirer quelque souhaite de vivre;
Et pour mon cœur charmé, c’eſt vn plaiſir moins doux De mourir innocent, que de viure pour vous BERECINTE.	Et pour mon cœur charmé, c'est un plaisir moins doux De mourir innocent, que de vivre pour vous BERECINTE.
PTOLOMEE.	PTOLOMEE.
vous loupirez adorable Princene;	vous loupirez adorable Princène;
BERECINTE.	BÉRECINTE.
I’ay droict de ſoupirer, & le puis ſans foibleſſe:	J'ai droit de soupirer, et le puis sans faiblesse:
Mais ſi preſt du treſpas que vous allez ſouffris, C’eſt peu faire pour vous que pouſſer vn ſoûpir;	Mais si prêt du trépas que vous allez souffris, C'est peu faire pour vous que pousser un soupir;
Quand la peur de me perdre excite vos allarmes, C’eſt peu faire pour vous que de verſer des larmes;	Quand la peur de me perdre excite vos alarmes, C'est peu faire pour vous que de verser des larmes;
Et pour de vos mal-heurs interrompre le cours, Mes foupirs & mes pleurs ſont vn foible ſecours :	Et pour de vos malheurs interrompre le cours, Mes soupirs et mes pleurs sont un faible secours :
Mais dans ce iour funeſte où ie voy tout à craindre, Ie veux vous ſecourir, & ne puis que vous plaindre Et d’vn cœur enflamé c’eſt groſſir les douleurs, Que pouſſer des ſoûpirs & reſpandre des pleurs.	Mais dans ce jour funeste où je vois tout à craindre, Je veux vous secourir, et ne puis que vous plaindre Et d'un cœur enflamé c'est grossir les douleurs, Que pousser des soupirs et répandre des pleurs.
PTOLOMEE.	PTOLOMEE.
Si d’vn Prince amoureux vous aimaſtes la gloire, Soyez moins reſoluë à fleſtrir ma memoire;	Si d'un Prince amoureux vous aimâtes la gloire, Soyez moins résolue à flétrir ma mémoire;
Et ceſſez d’oppoſer par de doux attentats A l’eſclat de ma vie vn infame treſpas:	Et cessez d'opposer par de doux attentats OÙ l'éclat de ma vie un infâme trépas:
C’eſt trop peu d’auoir veu ma conſtance amoindrie, Voſtre ardante pitié rend mon ame attendrie, Et quelque fermeté dont ie ſois reueſtu, Voſtre extreme tendreſſe affoiblit ma vertu:	C'est trop peu d'avoir vu ma constance amoindrie, Votre ardante pitié rend mon âme attendrie, Et quelque fermeté dont je sois revêtu, Votre extrême tendresse affaiblit ma vertu:
D’vne indigne douleur vouloir eſtre la proye, De mes perſecuteurs c’eſt accroiſtre la ioye;	D'une indigne douleur vouloir être la proie, De mes persécuteurs c'est accroître la joie;
Et leur donner ſujet en entrant au oercueil, De pouuoir ſur ma honte affermir leur orgueil.	Et leur donner sujet en entrant au oercueil, De pouvoir sur ma honte affermir leur orgueil.
R’animez donc voſtre ame, & r’apellez vos forces, A mon cœur affligé ne donnez plus d’amorces, Redonnez la vigueur à mon cœur abbatu, Et qu’en vous imitant ie ſuiue la vertu;	R'animez donc votre âme, et rappelez vos forces, À mon cœur affligé ne donnez plus d'amorces, Redonnez la vigueur à mon cœur abattu, Et qu'en vous imitant imitant suiue la vertu;
La plus affreuſe mort me donne moins d’allarmes, Que ne font les douleurs qui vous cauſent des larmea llen Mon ame en eſt bleſſée auecque mille traits, Et la mort n’en a qu'vn ou brilient tant d'attraits;	La plus affreuse mort me donne moins d'alarmes, Que ne font les douleurs qui vous causent des larmea len Mon âme en est blessée était mille traits, Et la mort n'en a qu'un ou brilient tant d'attraits;
Tantoſt ie ſouhaitois cette heureuſe entreueuë, Mlais ie ne ſentois pas la douleur qui me tuë, lene preuoyois pas me ſeparant de vous, Que l’amour & la mort deuſſent joindre leurs coups.	Tantôt me souhaitais cette heureuse entrevue, Mlais ie ne sentais pas la douleur qui me tue, lene prévoyais pas me séparant de vous, Que l'amour et la mort dussent joindre leurs coups.
BERECINTE.	BÉRECINTE.
Ah!	Ah!
ceſſez ce diſcours qui trouble encor mon ame, Ne m’abandonnez pas aux rigueurs de ma flame, laiſſez à ma foibleſſe vn reſte de vigueur, lour plaindre les mal-heurs qui déchirẽt mon cœur;	cessez ce discours qui trouble encor mon âme, Ne m'abandonnés pas aux rigueurs de ma flamme, laissez à ma faiblesse un reste de vigueur, lour plaindre les malheurs qui déchirẽt mon cœur;
Ceſſez vous dis-je encor de redoubler ma peine, Où cede la raiſon au pauchant qui m’entraiſne :	Cessez vous dis-je encor de redoubler ma peine, Où cède la raison au pauchant qui m'entraîne :
ſouffrez qu’en ce moment ie partage auec vous le funeſte penſer des plus horribles coups;	souffrez qu'en ce moment ie partage avec vous le funeste penser des plus horribles coups;
Qu’au moins dãs vos douleurs ie puiſſe sãs cõtrainte, Sans partager vos maux, partager voſtre plainte;	Qu'au moins dans vos douleurs Seigneur puisse sons cõtrainte, Sans partager vos maux, partager votre plainte;
Et que malgré le ſort qui nous doit ſeparer, le puiſſe encor au moins prés de vous ſoupirer;	Et que malgré le sort qui nous doit séparer, le puisse encor au moins près de vous soupirer;
Afin que mes ſoupirs ſeruent de ſacrifices Pour donner à l’amour le plus doux des ſuplices, Qu’auant de nous quitter pour la derniere fois.	Afin que mes soupirs servent de sacrifices Pour donner à l'amour le plus doux des suplices, Qu'avant de nous quitter pour la dernière fois.
lh!	lh!
mon cœur à ce mot ſe refuſe la voix, ames relsreuorter lal vne tenle perte, ſe liurent des combats où mon ame eſt offerte;	mon cœur à ce mot se refuse la voix, âmes relsreuorter lal une tenle perte, se livrent des combats où mon âme est offerte;
leie voy ſans ſecours au milieu de leurs coups, Et ie n’ay que celuy que ie prends prés de vous.	leie vois sans secours au milieu de leurs coups, Et ici n'ai que celui que ie prends prends de vous.
PTOLOMEE.	PTOLOMEE.
Ah!	Ah!
Madame, c’eſt trop demeurer dans la peine.	Madame, c'est trop demeurer dans la peine.
Helas!	Hélas!
BERECINTE.	BÉRECINTE.
DORIMAN.	DORIMAN.
C'eſt trop entendre vn diſcours qui me geſne, bas.	C'est trop entendre un discours qui me gêne, bas.
Rompons cét entretien, c’eſt trop prendre ſur moy, Feignons d’auoir receu nouuelle ordre du Roy.	Rompons cet entretien, c'est trop prendre sur moi, Feignons d'avoir recevoir nouuelle ordre du Roi.
le m’oppoſe à regret à voſtre conference, Prenez-vous-en, Madame, à mon obeiſſance, le Roy mande le Prince, il faut vous ſeparer.	le m'oppose à regret à votre conférence, Prenez-vous-en, Madame, à mon obéissance, le Roi mande le Prince, il faut vous séparer.
E ij	E ij
BERECINTE.	BÉRECINTE.
Ne pouuer-vous encor vn moment differer?	Ne pouver-vous encor un moment différer?
DORIMAN.	DORIMAN.
Madame ie ne puis à moins de luy deſplaire, Vous connoiſſez le Roy, le reſte eſt à vous taire.	Madame ie ne puis à moins de Rome déplaire, Vous connaissez le Roi, le reste est à vous taire.
BÉRECINTE.	BÉRECINTE.
Ie vous entends.	Je vous entends.
Ah!	Ah!
Prince adieu donc pour iamais	Prince adieu donc pour jamais
TYGEOMLE.	TYGEOMLE.
Qu’à cét Adieu mon cœur eſt loing de ſes ſouhaits.	Qu'à cet Adieu mon cœur est loin de ses souhaits.
BERECINTE.	BÉRECINTE.
Puiſſe le iuſte Ciel par quelque heureuſe voye, M’accabler de douleur, & vous combler de ioye.	Puisse le juste Ciel par quelque heureuse voie, M'accabler de douleur, et vous combler de joie.
DORIAIITC.	DORIAITC.
Puiſſe pluſtoit le Crer proteger mes forfaits, Et de tous mes deſſeins ſeconder les effets.	Puisse plustoit le Cr protéger mes forfaits, Et de tous mes desseins seconder les effets.
E iij	 Ejà
ACTE V.	ACTE V.
& dernier.	et dernier.
SCENE PREMIERE.	SCÈNE PREMIÈRE.
DORIMAN, LVCIAN.	DORIMAN, LUCIAN.
LVCIAN.	LUCIAN.
bar I ſſAis dans ce grand eſpoir de tous vos auantages, VIIl pourroit ſe cacher de ſiniſtres preſages, Criſibas vit encor, & les coups de poignard Qui luy perce le ſein tous trois de part en part, N'ont pû vous l’immoler ſans vn reſte de vie, encor qu’auec ardeur ſa mort fut pourſuiuie.	bar I sAis dans ce grand espoir de tous vos avantages, VIl pourrait se cacher de sinistres présages, Crysibas vit encor, et les coups de poignard Qui avait perce le sein tous trois de part en part, N'ont pu vous l'immoler sans un reste de vie, encor qu'auec ardeur sa mort fut poursuivie.
DORIMAN.	DORIMAN.
Qui pût donc empeſcher de le voir expirer?	Qui put donc empêcher de le voir expirer?
LVCIAN.	LUCIAN.
Des ſoldats ſuruenus nous ont fait retirer, Attirez par ſes cris, & touchez de ſa peine, l'emporterent fanglant à la tente prochaine.	Des soldats survenus nous ont fait retirer, Attirez par ses cris, et touchés de sa peine, l'emportèrent sanglant à la tente prochaine.
le voyant reſpirer luy donnerent ſecours, Des ruiſſeaux de ſon ſang arreſterent le cours, Sa parole reuient, de tous ſe fait entendre:	le voyant respirer Seigneur donnèrent secours, Des ruisseaux de son sang arrêtèrent le cours, Sa parole revient, de tous se fait entendre:
llais de ce qu’il a dit ie n’ay pû rien apprendre.	lais de ce qu'il a dit ici n'ai pu rien apprendre.
DORIMAN.	DORIMAN.
yqu’il puiſſe leur diré à preſent ie crains peu Qu'on puiſſe à mes deſſeins donner vn defadueu;	yqu'il puisse leur diré à présent ie crains peu Qu'on puisse à mes desseins donner un désaveu;
le ſuis maiſtre de tout, ie le ſuis de l’Armée, Rien ne peut empeſcher la mort de Ptolomée, Il faut me l’immoler, ſoit de force ou de gré, L’amour veut ſon treſpas, la haine l’a iuré;	le suis maître de tout, je le suis de l'Armée, Rien ne peut empêcher la mort de Ptolomée, Il faut me l'immoler, soit de force ou de gré, L'amour veut son trépas, la haine l'a juré;
E iij Si le Ciel à mes vœux ſe declare contraire, Dans vn preſſant beſoin ie ſçay ce qu’il ſaut faire, Mon bras malgré les Dieux eſt maiſtre de mon ſort, La neceſſité veut Berecinte ou la mort, Ie n’ay point à choiſir où l’amour eſt le maiſtre, Il decide luy ſeul le ſort qu’il a fait naiſtre, S’emparant de mon cœur, ie tiens de ſon pouuoir, Si la force luy manque, il court au deſeſpoir, Il ſuit aueuglément tout ce qu’il ſe propoſe, Et chaſſe la raiſon pour ſouſtenir ſa cauſe;	ELLE jijOur le Ciel à mes vœux se déclare contraire, Dans un pressant besoin ie sçay ce qu'il saut faire, Mon bras malgré les Dieux est maître de mon sort, La nécessité veut Berecinte ou la mort, Je n'ai point à choisir où l'amour est le maître, Il décide lui seul le sort qu'il a fait naître, S'emparant de mon cœur, ie tiens de son pouvoir, Si la force avait manque, il court au désespoir, Il suit aveuglément tout ce qu'il se propose, Et chasse la raison pour soutenir sa cause;
Il deuient furieux quand il n’eſpere rien, Et par vn deſeſpoir il eſpere ſon bien:	Il devient furieux quand il n'espère rien, Et par un désespoir il espère son bien:
Ie me vois en eſtat de n’auoir rien à craindre, I’agis d’vne la goir de pouuoir tout contraindre, Ie braue le hazard, enfin ie ne crains pas, Ie Idis.	Je me vois en état de n'avoir rien à craindre, J'agis d'une la goir de pouuoir tout contraindre, Je brave le hasard, enfin ie ne crains pas, Je Idis.
.	.
LVCIAN.	LUCIAN.
Le Roy, Seigneur, addreſſe icy ſes pas.	Le Roi, Seigneur, adresse ici ses pas.
DORIMAN.	DORIMAN.
Va retrouuer Ihorbas, ce rejoinure l’Armée.	Va retrouver Ihorbas, ce rejoinure l'Armée.
SCENLIT LE ROY, DORIMAN.	SCENLIT LE ROI, DORIMAN.
EE Reor.	CE Reor.
TE ne le cele point, mon ame eſt allarmée, ILe nombre des mutins s’accroiſt de plus en plus, Ie te viens conſulter Doriman là-deſſus, Dans ce rencontre icy dis-moy que dois-je faire?	TE ne le cèle point, mon âme est alarmée, ILe nombre des mutins s'accroît de plus en plus, Je te viens consulter Doriman là-dessus, Dans ce rencontre ici dis-moi que dois-je faire?
DORIMAN.	DORIMAN.
Ie vous l’ay deſia dit, & ie ne puis vous taire Que le treſpas du Prince arreſte les mutins, Qu’il éuite le coup de nos mauuais deſtins, Et diſſipe l’orage, & chaſſe la tempeſte, Nous lauue enſn des maux que le Cier nous appreſte,	Je vous l'ai déjà dit, et ainsi ne puis vous taire Que le trépas du Prince arrête les mutins, Qu'il éuite le coup de nos mauvais destins, Et dissipe l'orage, et chasse la tempête, Nous lauve enn des maux que le Cier nous apprête,
LE ROY.	LE ROY.
In effect cette mort r’appelle leur deuoir, Détruit leur entrepriſe, & monſtre mon pouuoir;	In effet cette mort rappelle leur devoir, Détruit leur entreprise, et montre mon pouvoir;
J’auoir trop attendu ie ſçay trop le connoiſtre, Dés l’inſtant que i’ay veu les factieux paroiſtre, le deuois au moment l’enuoyer à la mort, leſerois hors d’eſtat de craindre vn mauuais ſort:	J'avoir trop attendu les sçay trop le connaître, Dès l'instant que j'ai vu les factieux paraître, le devais au moment l'envoyer à la mort, leserois hors d'état de craindre un mauvais sort:
Mais puis que ſon treſpas appaiſe le tumulte, lle venge des mutins, & punit leur inſulte, Va-t’en trouuer les Chefs de la rebellion, Meſſe-toy par addreſſe à leur ſedition, Teſmoigne que comme eux tu veux ſauuer le Prince, Eſtans maiſtres deſia de toute la Prouince, Mleſnage cependant l’Armee & les eſprits, Rende-t’en maiſtre abſolu comme moy de Memphis, Conduis leurs ſentiments, & les tiens en balance, Et differe toûjours d’vſer de violence;	Mais puis que son trépas appaise le tumulte, lè venge des mutins, et punit leur insulte, Va-t-en trouver les Chefs de la rébellion, Messe-toi par adresse à leur sédition, Témoigne que comme eux tu veux sauver le Prince, Étant maîtres déjà de toute la Province, Mlesnage cependant l'Armée et les esprits, Rende-t-en maître absolu comme moi de Memphis, Conduis leurs sentiments, et les tiens en balance, Et diffère toujours d'user de violence;
Chacun te deferant, tout eſt entre tes mains.	Chacun te déférant, tout est entre tes mains.
Et ta prudence ainſi peut rompre leurs deſſeins;	Et ta prudence ainsi peut rompre leurs desseins;
Dependant a ce tralltle on tranenera la teltes	Dependant à ce tralle on tranenera la teltes
DORIMAN.	DORIMAN.
Puis-je ſouhaiter plus que le coup qui s’appreſte?	Puis-je souhaiter plus que le coup qui s'apprête?
bas, Tout vient à mes deſirs autant bien que ie veux.	bas, Tout vient à mes désirs autant bien que tu veux.
VN GARDE entrant.	UN GARDE entrant.
Aux portes de Memphis nombre de factieux, Seigneur, force la garde, & tout eſt en allarmes, Le peuple fait des cris, & chacun eſt en larmes.	Aux portes de Memphis nombre de factieux, Seigneur, force la garde, et tout est en alarmes, Le peuple fait des cris, et chacun est en larmes.
LE ROY parlant à Doriman.	LE ROY parlant à Doriman.
Va-t’en les contenir, & ne differe plus, Repoſe-toy ſur moy pour agir au ſurplus.	Va-t-en les contenir, et ne diffère plus, Repose-toi sur moi pour agir au surplus.
Dans le reſſentiment d’vne iuſte vengence, Ie veux que le ſuplice eſgale leur offence.	Dans le ressentiment d'une juste vengence, Je veux que le suplice égale leur offense.
SCENE IV.	SCÈNE IV.
LE ROT, LESGANDES.	LE ROT, LESGANDES.
LE ROY.	LE ROY.
Quel poinct de mal-heur mon ſort me reduis-tu?	Quel point de malheur mon sort me réduis-tu?
AADe combien de penſers ſuis-je donc combatu?	ÀADe combien de pensers suis-je donc combattu?
A me vouloir venger plus mes deſirs s’augmentent, Plus de difficultez à mes yeux ſe preſentent:	À me vouloir venger plus mes désirs s'augmentent, Plus de difficultés à mes yeux se présent:
Tantoſt pour la Couronne on ne doit hazarder.	Tantôt pour la Couronne on ne doit hasarder.
On hazarde tantoſt quand on la veut garder, Pour punindes mutins ie ſuis dans la contraintes Et toutefois le ſort me donne de la crainte:	On hasarde tantôt quand on la veut garder, Pour punindes mutins ie suis dans la contraintes Et toutefois le sort me donne de la crainte:
Mais puis-je eſtre ſurpris d’vn pareil ſentiment?	Mais puis-je être surpris d'une pareil sentiment?
Puis-je me raualer à ce bas mouuement?	Puis-je me ravaler à ce bas mouvement?
Moy craindre!	Moi craindre!
moy ſouffrir, ie ne puis m’y reſoudre!	moi souffrir, Madame ne puis m'y résoudre!
Oü gronde le tonnerre, armons nous de la foudre;	Oui gronde le tonnerre, armons -nous de la foudre;
Puniſſons, puniſſons leurs laſches attentats, Et faiſons-leur ſentir la rigueur de mon bras;	Punissons, punissons leurs lâches attentats, Et faisons-leur sentir la rigueur de mon bras;
Commençons par la mort du traiſtre Ptolomee, Par ſa teſte eſtonnons les plus fiers de l’Armée, Apprenons par ce coup furqu ou va mon courroux, Et monſtrons par ſon ſang.	Commençons par la mort du traître Ptolome, Par sa tête étonnons les plus fiers de l'Armée, Apprenons par ce coup furqu ou va mon courroux, Et montrons par son sang.
SCENE V.	SCÈNE V.
LB ROY, BERECINTE.	LB ROY, BÉRECINTE.
BERECINTE eſcoutant.	BÉRECINTE écoutant.
SEigneur appaiſez-vous, Abbaiſſee à vos pieds, voyez couler mes larmes, lugez par vos tranſports quelles ſont mes allarmes?	SEigneur appaisez-vous, Abaisse à vos pieds, voyez couler mes larmes, lugez par vos transports quelles sont mes alarmes?
Soulagez par pitié de ſi viues douleurs, Et ne conſentez pas à mes derniers mal-heurs;	Soulagez par pitié de si vives douleurs, Et ne consentez pas à mes derniers malheurs;
Que la compaſſion ſur le courroux l’emporte, Que malgré l’impoſture elle ſoit la plus forte;	Que la compassion sur le courroux l'emporte, Que malgré l'imposture elle soit la plus forte;
En faueur de mes pleurs eſcoutez la pitié, Et rendez à mon cœur ſa plus digne moitié;	En faveur de mes pleurs écoutez la pitié, Et rendez à mon cœur sa plus digne moitié;
Voudriez-vous ſouffrir que par la calomnie, l’on pût vous imputer d’vſer de tyrannie?	Voudriez-vous souffrir que par la calomnie, l'on put vous imputer d'user de tyrannie?
Que par vn faux ſoubçon que l’enuie a cauſé, Vous ſoyez preuenu d’vn eſcrit ſuppoſé.	Que par un faux soubçon que l'envie a causé, Vous soyez prévenu d'une écrit supposé.
Ah!	Ah!
ne permettez pas ainſi qu’on vous ſurprenne, bamiriiez la ligdeur, que la ponte reureine;	ne permettez pas ainsi qu'on vous surprenne, bamiriez la ligédeur, que la ponte reureine;
Differez pour vn temps, c’eſt peu vous demander, IA delay de trois iours ſe peut bien accorder.	Différez pour un temps, c'est peu vous demander, IA délai de trois jours se peut bien accorder.
LE ROY.	LE ROY.
Par ce délay, Madame, où va voſtre eſperance?	Par ce délai, Madame, où va votre espérance?
BERECINTE.	BÉRECINTE.
Que les Dieux de le temps ferone voir i'nmocence, Qu’ils vous deſcouuriront toute la verité, Pour nous rendre à tous deux entiere liberté;	Que les Dieux de le temps ferone voir j'nmocence, Qu'ils vous découvriront toute la vérité, Pour nous rendre à tous deux entière liberté;
Ne me refuſez pas.	Ne me refusez pas.
LE ROY.	LE ROY.
Retirez-vous Princeſſe, le ne puis, & l'Eſtat dans ſa mort m mncereſſe;	Retirez-vous Princesse, le ne puis, et l'État dans sa mort m mnceresse;
Vous perdez voſtre temps auecque deſplaiſir, Pour garder mont pouuorr ie n'ay point à choiſire Rien ne peut le ſauuer, ſa mort eſt neceſſaire, cele dois immoler ce mortel aduerſaire.	Vous perdez votre temps auecque déplaisir, Pour garder mont pouuorr il n'ai point à choisire Rien ne peut le sauver, sa mort est nécessaire, cèle dois immoler ce mortel adversaire.
BERECINTE.	BÉRECINTE.
Ah!	Ah!
Seigneur eſcoutez.	Seigneur écoutez.
LE ROY.	LE ROY.
C’eſt trop vous eſcouter.	C'est trop vous écouter.
BERECINTE.	BÉRECINTE.
C’eſt auſſi trop ſouffrir me laiſſer mal-traiter, Sçachez qu’apres ſa mort ie ne veux point ſuruiure;	C'est aussi trop souffrir me laisser mal-traiter, Sachez qu'après sa mort Ne ne veux point survivre;
Iuſques dans le tombeæu que ie pretends le ſuiure:	Jusque dans le tombeæu que Il prétends le suivre:
Mais auſſi puis-je dire apres ce triſte adueu, Que vous n’auez pas dû nous eſcouter ſi peu;	Mais aussi puis-je dire après ce triste aveu, Que vous n'avez pas dû nous écouter si peu;
Que ce n’eſt pas aſſez d’vn foible & faux indice, Pour croire qu’vn grand Prince eſt digne du ſuplice, Il faut pour vos eſgaux eſtre ſans paſſion, Et pour le condamner plus de conuiction.	Que ce n'est pas assez d'une faible et faux indice, Pour croire qu'un grand Prince est digne du suplice, Il faut pour vos égaux être sans passion, Et pour le condamner plus de conviction.
C’eſt m’expliquer aſſez que ce n’eſt que l’enuie, Qui cherche à s’aſſouuir aux deſpens de ſa vie;	C'est m'expliquer assez que ce n'est que l'envie, Qui cherche à s'assouvir aux dépens de sa vie;
Que voſtre cruauté veut reſpandre ſon ſang.	Que votre cruauté veut répandre son sang.
Qu’elle à iuré ſa mort ſans regarder ſon rang.	Qu'elle à juré sa mort sans regarder son rang.
Ne vous contentez pas d’vne illuſtre victime, Puis qu’il eſt criminel, ie partage ſon crime, Commencez par la mienne à mieux fraper ſur nous, Immollez-nous enſemble à tout voſtre courroux, Par vn excez de haine accordez à nos ames, Le bien de nous vnir en coupant nos deux trames, Au moins dans le rombeau nous vniſſants tous deux, Nous deurons à la mort ce que n’ont pû nos vœux.	Ne vous contentez pas d'une illustre victime, Puis qu'il est criminel, nom partage son crime, Commencez par la mienne à mieux frapper sur nous, Imollez-nous ensemble à tout votre courroux, Par un excès de haine accordez à nos âmes, Le bien de nous unir en coupant nos deux trames, Au moins dans le rombeau nous unissant tous deux, Nous devrons à la mort ce que n'ont pu nos vœux.
LE ROY.	LE ROY.
LIltereſt de TEſtat, celtty de ma Couronne, Empeſche fortement qu’à ſon crime on pardonne, Tous vos emportements ſont icy ſuperflus, N’attendez que ſa mort.	LIlterest de TÉtat, celîti de ma Couronne, Empêche fortement qu'à son crime on pardonne, Tous vos emportements sont ici superflus, N'attendez que sa mort.
BERECINTE.	BÉRECINTE.
16 Ne puis-je rien de plus?	16 Ne puis-je rien de plus?
Apres tous mes efforts qui peut donc le deffendre?	Après tous mes efforts qui peut donc le défendre?
O Dieux!	Ô Dieux!
c’eſt de vous ſeuls de qui ie puis l’attendre.	c'est de vous seuls de qui tu puis l'attendre.
SCENE V.	SCÈNE V.
LE ROY, BERECINIE, SIRATON.	LE ROY, BÉRECINIE, SIRATON.
STRATON.	STRATON.
Out eſt en paix, Seigneur, les troubles ſont ceſſez, I Toute l’Armée eſt calme, & les mutins chaſſez:	Out est en paix, Seigneur, les troubles sont cessez, I Joute l'Armée est calme, et les mutins chassés:
Mlais Doriman.	Mlais Doriman.
LE ROY.	LE ROY.
Hé bien, Doriman?	Hé bien, Doriman?
a Paeil lone Dans l’Armée.	à Paeil lone Dans l'Armée.
Acheue.	Achève.
LE ROY.	LE ROY.
SIRATON.	SIRATON.
Eſt arreſté pour ſauuer Ptolomee, On doit vous l’enuoyer.	Est arrêté pour sauver Ptolomée, On doit vous l'envoyer.
E ROY.	E ROY.
Straton que me dis-tu?	Straton que me dis-tu?
BERECINTE.	BÉRECINTE.
qter enangement feureux à mon cœur abbatu.	qter enangement feureux à mon cœur abattu.
bas	bas
LE ROY.	LE ROY.
Doriman arreſté;	Doriman arrêté;
viendrois-tu me ſurprendre?	viendrais-tu me surprendre?
Eſt-ce la verité que tu me viens d’apprendre?	Est-ce la vérité que tu me viens d'apprendre?
STRATON.	STRATON.
N’en doutez point, Seigneur.	N'en doutez point, Seigneur.
LE ROY.	LE ROY.
Doriman arreſté!	Doriman arrêté!
0 Clel qui vid iamais plus de temerité!	0 Clel qui vit jamais plus de témérité!
Areſter Doriman, c’eſt ſe prendre à moy-meſme?	Arêter Doriman, c'est se prendre à moi-même?
Que ie perde pluſtoſt eſt Sceptre & Diadeſme, Si je manque à punir leur laſche trahiſon:	Que je perde plustost est Sceptre et Diadesme, Si je manque à punir leur lâche trahison:
Mais en ſçais-tu, dis-moy, la cauſe & la raiſon?	Mais en sais-tu, dis-moi, la cause et la raison?
STRATON.	STRATON.
Vous auez ſçeu, Seigneur, les troubles de l'Armée, Comme à ſauuer le Prince elle eſtoit animée;	Vous avez su, Seigneur, les troubles de l'Armée, Comme à sauver le Prince elle était animée;
Doriman a paru, le tumulte a ceſſé, Vn bruit ſourd & confus dans l’Armée eſt paſſé, Que Doriman du trouble auoit eſté la cauſe, Qu’aux dangers de la mort luy ſeul le Prince expoſe Que c’eſt luy par les ſiens qui fait les remumens, Et de ſes paſſions ils ſont les inſtrumens;	Doriman a paru, le tumulte a cessé, Un bruit sourd et confus dans l'Armée est passé, Que Doriman du trouble avait été la cause, Qu'aux dangers de la mort lui seul le Prince expose Que c'est pu par les siens qui fait les remuments, Et de ses passions ils sont les instruments;
Les amis de ce Prince ont veu ſa contenance, Qui s’eſtoient retirez pour eſtre en aſſeurance, Et luy ſuiuy des ſiens s’en va dans leur quartier, Pour les animer mieux leur parle le premier, Qu’il ſe joint auec eux pour ſauuer Ptolomée, Ou qu’il vouloit perir auec toute l’Armee;	Les amis de ce Prince ont vu sa contenance, Qui s'étaient retirez pour être en assurance, Et lui suivi des siens s'en va dans leur quartier, Pour les animer mieux leur parle le premier, Qu'il se joint avec eux pour sauver Ptolomée, Ou qu'il voulait périr avec toute l'Armée;
Ceux-cy deſabuſez, le voyans ſans appuy, Pour l’enuoyer vers vous ſe ſaiſirent de luy;	Ceux-cy désabusez, le voyant sans appui, Pour l'envoyer vers vous se saisirent de lui;
Aprenant ce deſſein il ſe met en deffence, Et pour mieux l’empeſcher on voit ſa violence.	Apprenant ce dessein il se met en défense, Et pour mieux l'empêcher on voit sa violence.
Tout cecy n’eſt qu’apres beaucoup d’emportemens, Pour exciter encor de nouueaux remumens.	Tout ceci n'est qu'après beaucoup d'emportements, Pour exciter encor de nouveaux remumens.
D Rel.	D Rel.
C’eſt vne inuention d’vn fait de politique, Que ſon eſprit adroit par mon ordre pratique, Il a diſſimulé pour ſonder les eſprits.	C'est une invention d'une fait de politique, Que son esprit adroit par mon ordre pratique, Il a dissimulé pour sonder les esprits.
STRATON.	STRATON.
Dites pluſtoſt, Seigneur, qu’il a trop entrepris, Quand il a veu la paix, eſtoit-il neceſiaire De s’emporter ſi fort?	Dites plutôt, Seigneur, qu'il a trop entrepris, Quand il a vu la paix, était-il nécessaire De s'emporter si fort?
LE ROY.	LE ROY.
Apres leur attentat?	Après leur attentat?
Auroit-il pû ſe taire	Aurait-il pu se taire
STRATON.	STRATON.
Pardonnez-moy, Seigneur, Ie deteſte ſon crime, & ie plaints ſon mal-heur, Et la Reine qui vient & le Prince auec elle.	Pardonnez-moi, Seigneur, Je déteste son crime, et votre plaints son malheur, Et la Reine qui vient et le Prince avec elle.
DERECINIE.	DERCINIE.
Quel heureux accident!	Quel heureux accident!
quelle grace nouuelle!	quelle grâce nouvelle!
bu SCENE	bu SCÈNE
SCENE VI.	SCÈNE VI.
LE ROY, LA REYNE, UECLOMEE, BERECINTE, STRATON.	LE ROY, LA REINE, UECLOMEE, BERECINTE, STRATON.
LA REYNE.	LA REINE.
V traiſtre Doriman ayant apris Seigneur, ULa noire trahiſon, & l’aueugle fureur, De ſes laſches projets la ruſe deſcouuerte llefait de ce meſchant ſolliciter la perte, l’ous ſcauez de Struton coime tout eit en paix?	V Votre Doriman ayant appris Seigneur, ULa noire trahison, et l'aveugle fureur, De ses lâches projets la ruse découverte lèlefait de ce méchant solliciter la perte, l'ous savez de Struton coime tout eit en paix?
B TRATON.	 BRATON.
ouy, ie l’ay dit, Madame.	oui, Seigneur l'ai dit, Madame.
LA REYNE.	LA REINE.
A-ton parlé iamais D'vn ſi laſche deſſein que conſpiroit ce traiſtre?	A-ton parlé jamais D'un si lâche dessein que conspirait ce traître?
pour mieux couurii la rule & le fendre le maiſtre lxprés il a mandé toutes nos garniſons, lt ſous rne retiete ii rait les trahiſons, lucian en mourant.	pour mieux couvri la rule et le fendre le maître lxprés il a mandé toutes nos garnisons, l' une rète retiéte ji rait les trahisons, lucian en mourant.
LE ROY.	LE ROY.
Que dites-vous, Madame?	Que dites-vous, Madame?
LA REYNE.	LA REINE.
Qu’auant que d’expirer il deteſta ſa flame, leſon fatal deſſein qui luy cauſoit la mort.	Qu'avant que d'expirer il détesta sa flamme, les fatal dessein qui te causait la mort.
LE ROY.	LE ROY.
Ce diſcours me ſurprend!	Ce discours me surprend!
LA REYNE.	LA REINE.
Ie m’eſtonne plus fort, Qu’à reuenir à vous il a fait reſiſtance, Et s’en eſt deffendu iuſqu’à la violence:	Je m'étonne plus fort, Qu'à revenir à vous il a fait résistance, Et s'en est défendu jusqu'à la violence:
le motif d’vne guerre a ſeruy de moyen la D'aſſembler noitre Armée, & s’en faire vn ſoûtien, Il a crû ſous nos murs pouuoir tout entreprendre, De luy tout accorder qu’on n’euſt pû ſe deffendre, Flattant ainſi ſes feux dans ſon mauuais deſſein, Contraindre la Princeſſe à luy donner la main, Et pouſſant plus auant vne derniere audace, Nous forcer d’y ſouſcrire auecque la menace.	le motif d'une guerre a servi de moyen la D'assembler notre Armée, et s'en faire un soutien, Il a cru sous nos murs pouvoir tout entreprendre, De Seigneur tout accorder qu'on n'eût pu se défendre, Flattant ainsi ses feux dans son mauvais dessein, Contraindre la Princesse à lui son la main, Et poussant plus avant une dernière audace, Nous forcer d'y souscrire avec la menace.
Du Prince Ptolomee apres ſon grand reuers, Ie n’ay point differé d’aller rompre les fers, Ayant veu que pour luy les Dieux eſtoient propices, Mettez-le auſſi cõme eux ſous vos meilleurs auſpices I’ay voulu l’amener vous demander raiſon Des injures d’vn laſche, & de ſa trahiſon;	Du Prince Ptolomée après son grand revers, Je n'ai point différé d'aller rompre les fers, Ayant vu que pour lui les Dieux étaient propices, Mettez-le aussi comme eux sous vos meilleurs auspices J'ai voulu l'amener vous demander raison Des injures d'un lâche, et de sa trahison;
munfang de vos elgaux, Seigneury tantes juſtice.	munfang de vos élgaux, Seigneuri tant justice.
LE ROY.	LE ROY.
29 I’ay peine à croire encor ſon meſchant artifice.	29 J'ai peine à croire encor son méchant artifice.
LA REYNE.	LA REINE.
Vous l’allez bien ſçauoir, on vous l’ameine icy, De ſa noire action vous ſerez eſclaircy, tar virdes miens bien-toſt vous le verrez confondre.	Vous l'allez bien savoir, on vous l'amène ici, De sa noire action vous serez éclairci, tar virdes miens bientôt vous le verrez confondre.
TTOLOMEE lu tlaritre criſibas que pourra-t’il reſpondre?	TTOLOME lu tlaritre crisibas que pourra-t-il répondre?
bus Grands Dieux mettez au iour toute la verſté!	bus Grands Dieux mettez au jour toute la versé!
SCENE VII.	SCÈNE VII.
LE ROY, LA REYNE, PTOLOMEE, BERECINTE, DORIMAN, STRATON, SABINE, LES GARDES.	LE ROY, LA REINE, PTOLOMEE, BERECINTE, DORIMAN, STRATON, SABINE, LES GARDES.
LE ROY.	LE ROY.
vous reproche icy beaucoup de laſcheté, OReſpondez Doriman à ce qu’on vous impute, Purgez-vous, autrement attendez voſtre cheute, Du crime conuaincu ie feray mon deuoir, le vous liure à nos Loix, & n’ay plus de pouuoir, la luſtice eſt icy la ſeule ſouueraine Qui regle entre vous deux qui doit ſubir la peine;	vous reproche ici beaucoup de lâcheté, ORespondez Doriman à ce qu'on vous impute, Purgez-vous, autrement attendez votre chute, Du crime convaincu ie ferai mon devoir, le vous livre à nos Lois, et n'ai plus de pouvoir, la lustice est ici la seule souveraine Qui règle entre vous deux qui doit subir la peine;
N’eſperez rien de moy qu’à garder l’équité, Et peſer les raiſons pour voir la verité.	N'espérez rien de moi qu'à garder l'équité, Et peser les raisons pour voir la vérité.
DORIMAN.	DORIMAN.
C'eſt de voſtre équité que ie veux tout attendre, Grand Roy, ie ne crains plus apres de me deffendre;	C'est de votre équité que sans veux tout attendre, Grand Roi, tu ne crains plus après de me défendre;
Elle eſt le ſeul appuy que ie veux prés de vous, Pour de mes ennemis repouſſer tous les coups.	Elle est le seul appui que personne veux près de vous, Pour de mes ennemis repousser tous les coups.
Pour me juſtifier de la noire impoſture, Où l’enuie a voulu me noircir de l’injure:	Pour me justifier de la noire imposture, Où l'envie a voulu me noircir de l'injure:
Sans vous parler, Seigneur, icy de mes exploits, Dont juſqu’icy la gloire a fait trembler les Rois;	Sans vous parler, Seigneur, ici de mes exploits, Dont jusqu'ici la gloire a fait trembler les Rois;
ſans r’appeller encor la candeur de ma vie, Dont la moindre action peut deffter l’enuie;	sans rappeler encor la candeur de ma vie, Dont la moindre action peut défter l'envie;
Il ne faut ſeulemenc que voir leur attentat, leur fureur contre moy quand ie ſers voſtre Eſtat;	Il ne faut seulemenc que voir leur attentat, leur fureur contre moi quand je sers votre État;
Pourquoy m’enurronner & ſur moy venir fondre, Sans me donner le temps de pouuoir leur reſpondre?	Pourquoi m'enurronner et sur moi venir fondre, Sans me donner le temps de pouvoir leur répondre?
ll eſt vray que ſurpris i’ay voulu reſiſter, legnorans leur deſfein ie n’ay pû m’arreſter;	ll est vrai que surpris j'ai voulu résister, legnorants leur dessein ie n'ai pu m'arrêter;
l’ay crû qu’à me brauer montoit leur inſolence, Qu'vn Prince intereſſé m’attiroit cette offence, Qu’au deſpens de ma vie ils vouloient ſe venger, En me croyant l’auteur de ſon preſſant danger;	l'ai cru qu'à me braver montait leur insolence, Qu'un Prince intéressé m'attirait cette offense, Qu'au dépens de ma vie ils voulaient se venger, En me croyant l'auteur de son pressant danger;
Secouru par les miens ie me mets en deffence, Et pour me garentir ie leurs faits reſiſtance;	Secouru par les miens on me mets en défense, Et pour me garentir toujours leurs faits résistance;
le veux d’vn vain effort arreſter leur fureur, Leur nombre ſe croiſſant, & les miens perdant ceur, Lucian des premiers a ſenty leur outrage, Et i’apprends par ſa mort juſqu’où venoit leur rage, On me ſaiſit au corps ſans reſpect de mon rang, Ie me vois mal-traiter, les miens couuerts de ſang, Et joignant ſans raiſon la menace à l’injure,	le veux d'un vain effort arrêter leur fureur, Leur nombre se croissant, et les miens perdant ceur, Lucian des premiers à senti leur outrage, Et j'apprends par sa mort jusqu'où venait leur rage, On me saisit au corps sans respect de mon rang, Je me vois mal-traiter, les miens couverts de sang, Et joignant sans raison la menace à l'injure,
F ij On m’ameine vers vous me tacher d’impoſture, Et ſans vouloir ſçauoir l’ordre que i’ay de vous, Sans in eſcouter parler, ils en viennent aux coups.	 ij On m'amène vers vous me tacher d'imposture, Et sans vouloir savoir l'ordre que j'ai de vous, Sans in coûter parler, ils en viennent aux coups.
LA REINE.	LA REINE.
Voſtre ordre n’eſtoit pas quãd l’Armee eſt tranquille, ullais De la porter encor à forcer cette ville, Nous contraindre en ces murs pour nous faire la loy, Vous rendre maiſtre enfin de la ville & du Roy, Et tenans dans vos mains les forces de l’Empire, A vos laſches projets nous forcer de ſouſcrire.	Votre ordre n'était pas quand l'Armée est tranquille, ais De la porter encor à forcer cette ville, Nous contraindre en ces murs pour nous faire la loi, Vous rendre maître enfin de la ville et du Roi, Et tenants dans vos mains les forces de l'Empire, À vos lâches projets nous forcer de souscrire.
DORIMAN.	DORIMAN.
Ptolomee eſt icy le ſeul qu’on doit punir, Les memt pounloluauer one rȩeu teus preuenir.	Ptolomée est ici le seul qu'on doit punir, Les mémt pounoluaver one réu neus prévenir.
PTOLOMEE.	PTOLOMEE.
Vous ne reſpondez pas à ce que dit la Reine.	Vous ne répondez pas à ce que dit la Reine.
DORIMAN.	DORIMAN.
De reſpondre pour vous me dois-je mettre en peine?	De répondre pour vous me dois-je mettre en peine?
Il s’agit de vos faits & ie ſuis innocent, Et vous deuez parler où le crime eſt preſſant.	Il s'agit de vos faits et Seigneur suis innocent, Et vous devez parler où le crime est pressant.
PTOLOMEE.	PTOLOMEE.
Mon eſtroite priſon eſt vn fort teſmoignage, Poul n’eſtre point meſſe dans ce qui vous engage, Et la rebellion qu’on me veut rejetter, Trouue en voſtre refus dequoy vous l’imputer, Mon abſence & vos gens m’empeſchent de répondre.	Mon étroite prison est un fort témoignage, Poul n'être point messe de ce qui vous engage, Et la rébellion qu'on me veut rejetter, Trouve en votre refus dequoy vous l'imputer, Mon absence et vos gens m'empêchent de répondre.
DORIMAN.	DORIMAN.
On n’agiſſoit pour vous, c’eſt trop pour vous conTondre, Et la lettre ſurpriſe eſt vn puiſſant garand, Pour monſtrer qui de nous ſur l’Eſtat entreprend, Vous eſtes conuaincu malgré vos artifices, Vos gens ont acheué d’apprendre vos complices.	On n'agissait pour vous, c'est trop pour vous conTondre, Et la lettre surprise est un puissant garant, Pour montrer qui de nous sur l'État entreprend, Vous êtes convaincu malgré vos artifices, Vos gens ont achevé d'apprendre vos complices.
PTOLOMEE.	PTOLOMEE.
Mais la Reine a connu mes projets innocens, Le diſcours qu’elle a fait tombe aſſez dans ce ſens, Et la preuue que i’ay de ma priſon ouuerte, Monitre qui de nous deux dont plus cramare ſa perte.	Mais la Reine a connu mes projets innocents, Le discours qu'elle a fait tombe assez dans ce sens, Et la preuve que j'ai de ma prison ouverte, Monitre qui de nous deux dont plus cramare sa perte.
DORIMAN.	DORIMAN.
la Reine eſt preuenuë, & par de faux rapports On a ſceu la porter à vous mettre dehors:	la Reine est prévenue, et par de faux rapports On a su la porter à vous mettre dehors:
Mais il ne s’enſuit pas d’en eſtre moins coupable, le Roy pour en juger ſera plus équitable, ll' nicaura me purger des danmables roupçons, Que l’impoſture a pris de vos ſeules leçons.	Mais il ne s'ensuit pas d'en être moins coupable, le Roi pour en juger sera plus équitable, ll' nicaura me purger des danmables roupçons, Que l'imposture a pris de vos seules leçons.
LA REYNE.	LA REINE.
Voicy venir Cleon qui nous vient tout apprendre.	Voici venir Cleon qui nous vient tout apprendre.
SCENE VIII.	SCÈNE VIII.
LE ROY, LA REYNE, PTOLOMEE, DERECINTE, DORMMAN, CLEON, LES GARDES.	LE ROY, LA REINE, PTOLOMEE, DERECINTE, DORMAN, CLEON, LES GARDES.
CLEON.	CLEON.
Vy Madame i’ay ſceu ce qui vous va ſurprendre, ULe bruit qu’on a ſemé ne ſe trouue point faux, Et i’ay ſçeu deſcouurir la ſource de nos maux;	Vi Madame j'ai su ce qui vous va surprendre, ULe bruit qu'on a semé ne se trouve point faux, Et j'ai su découvrir la source de nos maux;
Criſibas expirant a deſchargé ſon maiſtre, ſccuſe Doriman comme luy d’eſtre traiſtre, lour l’entendre parier le le luis aile von, Suiuant voſtre ordre exprés, ie viens tout de ſcauoir.	Crysibas expirant a déchargé son maître, scuse Doriman comme lui d'être traître, lour 'entendre parier le le luis aile von, Suivant votre ordre exprès, tu viens tout de savoir.
LE KOY.	LE OY.
Hé bien dõc qu’à-t’il dit?	Hé bien dont qu'à-t-il dit?
dites tout ſans rien feindre?	dites tout sans rien feindre?
Ne me déguiſez rien.	Ne me déguisez rien.
DORIMAN.	DORIMAN.
Mon cœur comience a cruidre um.	Mon cœur comience a crudre um.
CLEON.	CLEON.
Apres mille regrers, apres mille remors,	Après mille regrers, après mille remors,
E iij	 Ejà
Que par vn repentir il a pouſſé dehors, Tout preſt de rẽdre l’ame à peine ouurant la bouche, Il me tint ce diſcours dont le penſer me touche:	Que par un repentir il a poussé dehors, Tout prêt de rendre l'âme à peine ouvrant la bouche, Il me tint ce discours dont le penser me touche:
Ie ſuis digne de mort, dit-il, verſant des pleurs, Digne d’eſtre accablé ſous le poids des mal-heurs, Que cõtre moy les Dieux armẽt leur main du foudre, Pour punir mes forfaits & me reduire en poudre;	Je suis digne de mort, dit-il, versant des pleurs, Digne d'être accablé sous le poids des malheurs, Que cõtre moi les Dieux armablé en du poudre, Pour punir mes forfaits et me réduire en poudre;
Mon crime eſt ſans exemple, & ſi plein de fureur, Que le ſeul ſouuenir me fait fremir d’horreur;	Mon crime est sans exemple, et si plein de fureur, Que le seul souvenir me fait frémir d'horreur;
Ie ne puis m’excuſer d’auoir trahy mon Maiſtre, D’auoir preſté la main à luy cauſer vn traiſtre;	Je ne puis m'excuser d'avoir trahi mon Maître, D'avoir prêté la main à lui causer un traître;
Oüy Doriman a ſeeu ſeduire mon eſprit, Au poinct que d’accorder de faire vn faux eſcrit;	Oui Doriman a sû séduire mon esprit, Au point que d'accorder de faire un faux écrit;
Comme ſeul ie ſçauois changer mon eſcriture, Qu’on a pû iuſqu’icy deſcouurir l’impoſture, Que le Prince luy-meſme à ces traits contrefaits, De la lettre a douté s’il n’a point fait les traits:	Comme seul ici savais changer mon écriture, Qu'on a pu jusqu'ici découvrir l'imposture, Que le Prince lui-même à ces traits contrefaits, De la lettre a douté s'il n'a point fait les traits:
Mais i’ay plus fait encor pour comble de malice, Ie ſuis le meſſager pour couurir l’artifice, Feignant d’eſtre ſurpris dans le piege tendu, On m’arreſte ſans force où i’eſtois attendu, On me conduit au Roy, vous auez ſçeu le reſte, Et comme ma reſponce au Prince fut funeſte, Vous auez encor ſçeu le mauuais traitement Que le Roy du depuis luy fait inceſſamment, Comme on pourſuit ſa mort auec violence.	Mais j'ai plus fait encor pour comble de malice, Je suis le messager pour couvrir l'artifice, Feignant d'être surpris dans le piège tendu, On m'arrête sans force où j'étais attendu, On me conduit au Roi, vous avez su le reste, Et comme ma réponse au Prince fut funeste, Vous avez encor su le mauvais traitement Que le Roi du depuis lui fait incessamment, Comme on poursuit sa mort auec violence.
Là reprenant haleine il garde le ſilence, Puis vn moment apres il pourſuit ſon diſcours;	Là reprenant haleine il garde le silence, Puis un moment après il poursuit son discours;
C’eſt Doriman, dit-il, qui met fin à mes iours, De la crainte qu’il a que i’euſſe dit ſon crime, Me fait de ſa fureur la premiere victime:	C'est Doriman, dit-il, qui met fin à mes jours, De la crainte qu'il a que j'eusse dit son crime, Me fait de sa fureur la première victime:
Mais les Dieux ont permis que i’euſſe aſſez de voix Pour le faire tomber ſous la rigueur des Loix, Le declarer l’auteur des trotbres de lhimnée, Et l’ennemy iuré du Prince Ptolomée.	Mais les Dieux ont permis que j'eusse assez de voix Pour le faire tomber sous la rigueur des Lois, Le déclarer l'auteur des trotbres de lhimnée, Et l'ennemi juré du Prince Ptolomée.
Par de foibles regards exprimant ſa douleur, D'vn cuiſant repentir pour la plus forte marque, con ame en ce moment alla joindre la Parque.	Par de faibles regards exprimant sa douleur, D'un cuisant repentir pour la plus forte marque, con âme en ce moment alla joindre la Parque.
LE ROY.	LE ROY.
la mort a preuenu tout ce que la fureur e, lour punir vn tel crime euſt inuenté d’horreur, les forfaits ſont plus grands que non pas ſon ſuplice, falloit qu’en public on en fit la Iuſtice.	la mort a prévenu tout ce que la fureur eût, lour punir un tel crime eût inventé d'horreur, les forfaits sont plus grands que non pas son supplice, fallait qu'en public on en fit la Justice.
a vous dont l’inſolence eſt venuë à ce poinct qu'à l’impoſture on voit l'attentat eſtre joint, qui par la calomnie auez ſçeu me ſurprendre, lletendez-vous encor apres de vous deffendre?	à vous dont l'insolence est venue à ce point qu'à l'imposture on voit l'attentat être joint, qui par la calomnie avez sçeu me surprendre, lletendez-vous encore après de vous défendre?
loy!	loi!
vous que i’auois crû plein de ſincerité;	vous que j'avais cru plein de sincérité;
lous que trop de fortune auoit ſi haut monté;	lous que trop de fortune avait si haut monté;
faut donc aujourd’huy dans ce grand auantage, que ma faueur vous ſerue à me faire vn outrage!	faut donc aujourd'hui dans ce grand avantage, que ma faveur vous serve à me faire un outrage!
tpar vn artifice aueuglant ma bonté, ay ſeruy de ſouſtien à voſtre laſcheté.	tpar ici artifice aveuglant ma bonté, ai servi de soutien à votre lâcheté.
la!	la!
ie ſçauray punir vile tene impoſture;	Ne sçauray punir vile téne imposture;
loſtre mort apprendra iuſqu’où va cette injure.	lotre mort apprendra jusqu'où va cette injure.
PTOLOMEE.	PTOLOMEE.
llil Seigneur, pardonnez.	llil Seigneur, pardonnez.
LE ROY.	LE ROY.
Ie ſçay ce que ie dois, Inſi laſche attentat l'abandonne à nos Loix:	Je sais ce que personne dois, Insi lâche attentat l'abandonne à nos Lois:
lais ſçachons la penree apres cette menuui, ſſcoutons ſa reſponce, & voyons ſon audace.	lais sezachons la penre après cette menuvi, scoutons sa réponse, et voyons son audace.
le Prince eſt ínnocent, & vous vn ſcelerat, ouuez-vous le nier apres voſtre attentat?	le Prince est Hannocent, et vous un scélérat, ouvez-vous le nier après votre attentat?
parle, parle meſchant.	parle, parle méchant.
DORIMAN.	DORIMAN.
Ie n’ay rien à reſpondre, lles crimes auerez ſeruent à me confondre;	Je n'ai rien à répondre, lles crimes avérez servent à me confondre;
lay merité la mort, ie n’y repugne pas, te plus grand de mes maux ce n’eſt point le treſpas:	la mérité la mort, Elle n'y répugne pas, te plus grand de mes maux ce n'est point le trépas:
lais c’eſt d’auoir manqué d’aſſouuir mon enuie, Que ma haine ſubſiſte, & mon Riual en vie?	lais c'est d'avoir manqué d'assouvir mon envie, Que ma haine sujet, et mon Rival en vie?
Mais puis qu’il faut perir ſignalons noſtre mortAllons de crime en crime affronter noſtre ſort, Mourons;	Mais puis qu'il faut périr signalons notre mortAllons de crime en crime affronter notre sort, Mourons;
Mais meritons du moins noſtre ſuplice.	Mais méritons du moins notre suplice.
EA REINE.	EA REINE.
O Dieux!	Ô Dieux!
LE ROY.	LE ROY.
Gardes qu’on le ſaiſiſſe.	Gardes qu'on le saisisse.
PTOLOMEE.	PTOLOMEE.
Ah!	Ah!
monſtre eſpouuentable.	montre espouuentable.
P**I* DORIMAN.	P*I* DORIMAN.
O trop injuſtes Dieux, Falloit-il commencer pour n’acheuer pas mieux?	Ô trop injustes Dieux, Fallait-il commencer pour n'achever pas mieux?
Pourquoy m’empeſchez-vous d’aſſouuir ma vengeance?	Pourquoi m'empêchez-vous d'assouvir ma vengeance?
Mon bras ſçaura monſtrer malgré vous ſa puiſſance, Et pour l’auoir manqué voyez-le m’en punir, C’en eſt fait.	Mon bras saura montrer malgré vous sa puissance, Et pour l'avoir manqué voyez-le m'en punir, C'en est fait.
Il ſe frappe.	Il se frappe.
le	le
LE ROY.	LE ROY.
Quoy!	Quoi!
ce traiſtre a ſçeu me preuenir?	ce traître a su me prévenir?
Il dérobe ſa vie aux rigueurs du ſuplice, Qu’on taſche à le ſauuer pour en faire Iuſtice.	Il dérobe sa vie aux rigueurs du supplice, Qu'on tâche à le sauver pour en faire Justice.
DORIMAN.	DORIMAN.
L’on peut deſſus mon corps exercer des tourmens, Ie ſçay trop meriter les plus grands chaſtimens:	L'on peut dessus mon corps exercer des tourments, Je sais trop mériter les plus grands châtiments:
Mais en eſt-il d’eſgal à le voir me ſuruiure, Mon cœur noyé de ſang veut encor le pourſuiure, Et mon corps chancelant chargé de ſes forfaits, Voudroit tomber ſur luy, l’eſcraſer ſous ſon faix, Pour donner à mon bras dans vn reſte de vie Le pouuoir d’aſſouuir deſſus luy ſon enuie, Qui r’animant ſa force à le voir abbatu, Pourroit d’vn dernier coup ſignaler ſa vertu;	Mais en est-il d'égal à le voir me survivre, Mon cœur noyé de sang veut encor le poursuivre, Et mon corps chancelant chargé de ses forfaits, Voudrait tomber sur lui, l'écraser sous son faix, Pour donner à mon bras dans un reste de vie Le pouvoir d'assouvir dessus lui-même envie, Qui ranimant sa force à le voir abattu, Pourrait d'un dernier coup signal sa vertu;
lais les Dieux ennemis de ce haut auantage, Ne veulent que moy ſeul de victime à ma rage, qui retenans mon bras qui luy perçoit le ffanc, N'en ont ſouffert le coup que dans ſon propre ſang Origoureux Deſtin!	lais les Dieux ennemis de ce haut avantage, Ne veulent que moi seul de victime à ma rage, qui retenants mon bras qui avait perçait le ffanc, N'en ont souffert le coup que dans son propre sang Origoureux Destin!
LA REINE.	LA REINE.
O Ciel!	Ô Ciel!
quelle eſt ſa rage?	quelle est sa rage?
TIOLOMEE.	TIOLOME.
t’on rien veu de meſme?	t'on rien vu de même?
BERECINTE.	BÉRECINTE.
Et peut-on dauantage?	Et peut-on davantage?
LE ROY.	LE ROY.
eon le tlre d’ley, cemonre lurieux, ene puis plus ſouffrir cét objet odieux.	eu le tre d'ley, cemonre lurieux, ene puis plus souffrir cet objet odieux.
SCENE IX.	SCÈNE IX.
EROY, LA REYNE, PTOLOMEE, BERECINTE.	EROY, LA REINE, PTOLOME, BERECINTE.
LE ROY.	LE ROY.
Rince de tous vos maux effacez la memoire, Ie reconnois ma faute, & vous rends vôtre gloire, traiſtre Doriman qui cauſa mon courroux, leſt attiré ſur luy ce qui fut contre vous, lablions le paſſe, reprenons l'allegreſſe, tince viuez contant, ie vous rends la Princeſſe.	Rince de tous vos maux effacés la mémoire, Je reconnais ma faute, et vous rends votre gloire, traître Doriman qui causa mon courroux, lest attiré sur lui ce qui fut contre vous, lablions le passe, reprenons l'allégresse, tince vivez contant, sans vous rends la Princesse.
PTOLOMEE.	PTOLOMEE.
del excez de bonté vous me monſtrez, Seigneur!	dél excès de bonté vous me montrez, Seigneur!
del bon-heur eſt le mien apres cette faueur!	de bonheur est le mien après cette faveur!
En parlant à la Reyne.	En parlant à la Reine.
qle ne vous dois-je point à vous auſſi Madame?	Oqle ne vous dois-je point à vous aussi Madame?
VN GARDE entrant.	UN GARDE entrant.
traiſtre Doriman, Seigneur, a rendu fame, Tounours en plarphenant contre les Immortele.	traître Doriman, Seigneur, a rendu famé, Tounours en plarphenant contre les Imortele.
LE ROY.	LE ROY.
Et nous pour reparer ſon crime à leurs Autels, Allons leur preſenter nos cœurs en ſacrifices, Loüer leurs ſaints decrets, & deteſter ſes vices, Et pour comble de joye allons en meſme iour Acheuer l’Hymenée, & couronner l'Amour.	Et nous pour réparer son crime à leurs Autels, Actons leur présenter nos cœurs en sacrifices, Louer leurs saints décrets, et détester ses vices, Et pour comble de joie allons en même jour Achever l'Hyménée, et couronner l'Amour.
