A PARIS,	À PARIS,
M.	M.
DC.	DC.
LXVIII.	LXVIII.
A SON ALTESSE SERENISSIME MONSEIGNEVR, LE PRINCE.	À SON ALTESSE SERENISIME MONSEIGNEUR, LE PRINCE.
MONSEIGNEVR, N'en déplaiſe à nos beaux Eſprits, je ne vois rien de plus ennuyeux que les Epitres	MONSEIGNEUR, N'en déplaise à nos beaux Esprits, je ne vois rien de plus ennuyeux que les Épîtres
Dedicatoires;	Dédicatoires;
& VOSTRE ALTESSE SERENISSIME trouuera bon, s’il luy plait, que je ne ſitiue point icy le ſtyle de ces Meſſieurs là;	et VÔTRE ALTESSE SERENISIME trouvera bon, s'il était plaît, que je ne sitive point ici le style de ces Messieurs là;
& refuſe de me ſeruir de deux, ou trois miſerables penſées, qui ont eſté tournées, & retournées tant de fois, qu’elles ſont vſées de tous les côtez.	et refuse de me servir de deux, ou trois misérables pensées, qui ont été tournées, et retournées tant de fois, qu'elles sont usées de tous les côtés.
Le nom du grand CONDE' eſt vn nom trop glorieux, pour le traiter comme on fait tous les autres Noms.	Le nom du grand CONDE' est un nom trop glorieux, pour le traiter comme on fait tous les autres Noms.
Il ne faut l’appliquer ce Nom Illuſtre, qu’à des Employs qui ſoient dignes de luy;	Il ne faut l'appliquer ce Nom Illustre, qu'à des Emplois qui soient dignes de lui;
& pour dire de belles choſes, je voudrois parler de le mettre à la teſte d’vne Armée, plûtoſt qu’à la teſte d’vn Liure:	et pour dire de belles choses, je voudrais parler de le mettre à la tête d'une Armée, plutôt qu'à la tête d'un Livre:
Et je conçois bien mieux ce qu’il eſt capable de faire, en l’oppoſant aux forces des ennemis de cét Etat, qu'en l’oppoſant à la critiquedtd Ennemis d’vne Comedie.	Et je conçois bien mieux ce qu'il est capable de faire, en l'opposant aux forces des ennemis de cet État, qu'en l'opposant à la critiqued Ennemis d'une Comédie.
Ce n’eſt pas, MONSEIGNEVR, que la glorieuſe approbation de V.	Ce n'est pas, MONSEIGNEUR, que la glorieuse approbation de V.
A.	A.
S.	S.
ne fût vne puiſſante protection pour toutes ces ſortes d’Ouurages, & qu’on ne ſoit perſuadé des lumieres de voſtre Eſprit, autant que de l’intrepidité de voſtre Cœur, & de la grandeur de voſtre Ame.	ne fût une puissante protection pour toutes ces sortes d'Ouvrages, et qu'on ne soit persuadé des lumières de votre Esprit, autant que de l'intrépidité de votre Cœur, et de la grandeur de votre Âme.
On ſçait par toute la Terre, que l’éclat de voſtre merite n'eſt point renfermé dans les bornes de cette valeur indomptable, qui ſe fait des Adorateurs chez ceux-méme qu’elle ſurmonte, qu’il s’étend ce Merite, juſques aux connoiſſances les plus fines & les plus releuées;	On sais par toute la Terre, que l'éclat de votre mérite n'est point renfermé dans les bornes de cette valeur indomptable, qui se fait des Adorateurs chez ceux-même qu'elle surmonte, qu'il s'étend ce Mérite, jusqu' aux connaissances les plus fines et les plus relevées;
& que les deciſions de voſtre jugement ſur tous les Ouurages d’eſprit, ne manquent point d’eſtre ſuiuies par le ſentiment des plus delicats.	et que les décisions de votre jugement sur tous les Ouvrages d'esprit, ne manquent point d'être suivies par le sentiment des plus délicats.
Mais on ſçait auſſi, MONSEIGNEVR, que toutes ces glorieuſes approbations, dont nous nous vantons au Public, ne nous coûtent rien à faire imprimer, & que ce ſont des choſes dont nous diſpoſons comme nous voulons.	Mais on sait aussi, MONSEIGNEUR, que toutes ces glorieuses approbations, dont nous nous vantons au Public, ne nous coûtent rien à faire imprimer, et que ce sont des choses dont nous disposons comme nous voulons.
On ſçait, diſ-je, qu'vne Epitre Dedicatoire dit tout ce qu’il luy plait, & qu’vn Autheur eſt en pouuoir d’aller ſai ſir les Perſonnes les plus Auguſtes, & de parer de leurs grands Noms les premiers feuillets de ſon Liure;	On sais, dis-je, qu'une Épitre Dédicatoire dit tout ce qu'il lui plaît, et qu'un Auteur est en pouvoir d'aller sais sûr es Personnes les plus Augustes, et de parer de leurs grands Noms les premiers feuillets de son Livre;
qu’il a la liberté de s’y donner autant qu’il veut l’honneur de leur eſtime, yauMienercevunta quu nent jamais ſongé à l’eſtre.	qu'il a la liberté de s'y donner autant qu'il veut l'honneur de leur estime, yauMiencevunta quu nent jamais songé à l'être.
Ie n’abuſeray, MONSEIGNEVR, ny de voſtre Nom, ny de vos bontez, pour combattre les Cenſeurs de l’Amphitryon, & m'attribuer vne gloire, que je n’ay pas peuteſtre meritée;	Je n'abuserai, MONSEIGNEUR, ni de votre Nom, ni de vos bontés, pour combattre les Censeurs de l'Amphitryon, et m'attribuer une gloire, que je n'ai pas peutestre méritée;
& je ne prens la liberté de vous offrir ma Comedie, que pour auoir lieu de vous dire, que ie regarde inceſſamment, auec vne profonde veneration les grandes qualitez que vous joignez au ſang Auguſte, dont vous tenez le jour, & que je ſuis, MONSEIGNEVR, auec tout le reſpect poſſible, & tout le zele imaginable, De voſtre Alteſſe Sereniſſime,	et je ne prends la liberté de vous offrir ma Comédie, que pour avoir lieu de vous dire, que ie regarde incessamment, avec quelque profonde vénération les grandes qualités que vous joignez au sang Auguste, dont vous tenez le jour, et que je suis, MONSEIGNEUR, avec tout le respect possible, et tout le zèle imaginable, De votre Altesse Serenissime,
Le tres-humble, tres-obeïſſant, & tres-obligé ſeruiteur.	Le très-humble, très-obeïssant, et très-obligé serviteur.
MOLIERE.	MOLIÈRE.
A i	À y
Extraict du Priuilege du Roy.	Extrait du Privilège du Roi.
Ar la Grace & Priuilege du Roy, donné I à Saint Germain en Laye, le 20.	Ar la Grâce et Privilège du Roi, donné I à Saint Germain en Laye, le 20.
jour de Fevrier 1668.	jour de Février 1668.
Signé, par le Roy en ſon Conſeil Margeret:	Signé, par le Roi en son Conseil Margèret:
Il eſt permis à I.	Il est permis à I.
B.	B.
P.	P.
Moliere, de faire imprimer par tel Libraire ou Imprimeur qu’il voudra choiſir, vne Piece de Theatre de ſa compoſition, intitulée, l’Amphitryon, pendant le temps & eſpace de cinq années entieres & accomplies, à commencer du jour qu’elle ſera acheuée d’imprimer:	Molière, de faire imprimer par tel Libraire ou Imprimeur qu'il voudra choisir, une Pièce de Théâtre de sa composition, intitulée, l'Amphitryon, pendant le temps et espace de cinq années entières et accomplies, à commencer du jour qu'elle sera achevée d'imprimer:
& defenſes ſont faites à tous autres Libraires & Imprimeurs, d’imprimer ou faire imprimer, vendre & debiter ladite Piece, ſans le conſentement de l’Expoſant, ou de ceux qui auront droit de luy;	et défenses sont faites à tous autres Libraires et Imprimeurs, d'imprimer ou faire imprimer, vendre et débiter ladite Pièce, sans le consentement de l'Exposant, ou de ceux qui auront droit de lui;
à peine aux contreuenans de trois mille liures d’amende, conhrederamauunAemprurtea coutreraits, & de tous deſpens, dommages & intereſts, ainſi que plus au long il eſt porté par leſdites Lettres de Priuilege.	à peine aux contrevenants de trois mille livres d'amende, conhrederamauunAemprurtea coutreraits, et de tous dépens, dommages et intérêts, ainsi que plus au long il est porté par lesdites Lettres de Privilège.
Et reuit neut Dn miouruus a cedé & tranſporté ſon droit de Priuilege à IEAN RIBOV, Marenana Libraire à Paris, pour en joüir ſuiuant l’accord fait entr’eux.	Et révit neut D miouruus a cédé et transporté son droit de Privilège à JEAN RIBOU, Marenana Libraire à Paris, pour en jouir suivant l'accord fait entr'eux.
Regiſtré ſur le Liure de la Communauté, ſuiuant l’Arreſt de la Cour de Parlement.	Registré sur le Livre de la Communauté, suivant l'Arrest de la Cour de Parlement.
Achevé d’imprimer pour la premiere fois le 5.	Achevé d'imprimer pour la première fois le 5.
Mars 1668.	Mars 1668.
Av.	Av.
ROY Sur la conqueſte de la E runene corrtres,	ROY Sur la conquête de la E runène corrtres,
E ſont faits inoüis GRAND Roy que tes  victoires;	E sont faits inoüis GRAND Roi que tes victoires;
L’auenir aura peine à les bien conceuoir:	L'avenir aura peine à les bien concevoir:
Et de nos vieux Heros, les pompeuſes Hiſtoires, Ne nous ont point chanté ce que tu nous fais voir.	Et de nos vieux Héros, les pompeuses Histoires, Ne nous ont point chanté ce que tu nous fais voir.
N’atten pas au retour d’vn ſi fameux Ouurage, Des ſoins de noſtre Muſe, vn éelatant homage, Cét exploit en demande, il le faut auouer;	N'atten pas au retour d'un si fameux Ouvrage, Des soins de notre Muse, un éelatant hommage, Cet exploit en demande, il le faut avouer;
Mais nos Chanſons GRAND Rox ne ſont pas ſi-toſt preſtes;	Mais nos Chants GRAND Rox ne sont pas sitôt prêtes;
Et tu mets moins de temps à faire tes cõqueſtes, Qu’il n’en faut pour les bien louer.	Et tu mets moins de temps à faire tes cõquestes, Qu'il n'en faut pour les bien louer.
La Scene eſt à Thébes, deuant la Maiſon d’Amphitryon.	La Scène est à Thébes, devant la Maison d'Amphitryon.
AMPHITRYON, COMEDIE.	AMPHITRYON, COMÉDIE.
PROLOGVE.	PROLOGUE.
MERCVRE ſur vn nuage, LA NVICT, dans vn char traiſné par deux cheuaux.	MERCURE sur un nuage, LA NVICT, dans un char traîné par deux chevaux.
MERCVRE.	MERCURE.
OVT beau charmante nuit;	OUT beau charmante nuit;
daignez F vous arrefrer :	daignez F vous arrefrer :
Il eſt certain ſecours que de vous on deſire:	Il est certain secours que de vous on désire:
Et j’ay deux mots à vous dire, De la part de Iupiter.	Et j'ai deux mots à vous dire, De la part de Jupiter.
LA NVICT.	LA NVICT.
Ah, ah, c’eſt vous Seigneur Mercure;	Ah, ah, c'est vous Seigneur Mercure;
Qui vous eût deuiné-là dans cette poſture?	Qui vous eût deviné-là dans cette posture?
MERCVRE.	MERCURE.
Ma foy, me trouuant las, pour ne pouuoir fournir Aux differens employs où Iupiter m’engage, Ie me ſuis doucement aſſis ſur ce nuage, pour vous attendre venir.	Ma foi, me trouvant las, pour ne pouvoir fournir Aux différents emplois où Jupiter m'engage, Je me suis doucement assis sur ce nuage, pour vous attendre venir.
LA NVICT.	LA NVICT.
Vous vous moquez, Mercure, & vous n’y ſongez pas, oled-Il bien à des Dieux de dire qu’ils ſont las?	Vous vous moquez, Mercure, et vous n'y songez pas, oled-Il bien à des Dieux de dire qu'ils sont las?
MERCVRE.	MERCURE.
Les Dieux ſont-ils de fer?	Les Dieux sont-ils de fer?
LA NVICT.	LA NVICT.
Non, mais il faut ſans ceſſe Garder le Decorum de la diuinité;	Non, mais il faut sans cesse Garder le Décorum de la divinité;
Il eſt de certains mots, dont l’vſage rabaiſſe Cette ſublime qualité;	Il est de certains mots, dont l'usage rabaisse Cette sublime qualité;
Et que pour leur indignité Il eſt bon qu’aux Hommes on laiſſe.	Et que pour leur indignité Il est bon qu'aux Hommes on laisse.
MERCVRE.	MERCURE.
A voſtre aiſe vous en parlez;	À votre aise vous en parlez;
Et vous auez, la belle, vne chaiſe roulante, Où par deux bons cheuaux, en Dame nonchalante, Vous vous faites trainer par tout ou vous voulez, Mais de moy ce n’eſt pas de meſme;	Et vous avez, la belle, une chaise roulante, Où par deux bons chevaux, en Dame nonchalante, Vous vous faites trainer par tout ou vous voulez, Mais de moi ce n'est pas de même;
Et ie ne puis vouloir, dans mon deſtin fatal, Aux poëtes aſſez de mal, De leur impertinance extréme, D’auoir, par vne injuſte loy, Dont on veut maintenir l’vſage, A chaque Dieu, dans ſon employ, Donné quelqu’allûre en partage, Et de me laiſſer à pié, moy, Comme vn Meſſager de Village.	Et petit ne puis vouloir, dans mon destin fatal, Aux poètes assez de mal, De leur impertinance extrême, D'avoir, par une injuste loi, Dont on veut maintenir l'usage, À chaque Dieu, dans son emploi, Donné quelqu'allûre en partage, Et de me laisser à pie, moi, Comme un Messager de Village.
Moy qui fuis, comme on ſçait, en terre & dans les Cieux, Le fameux Meſſager du souuerain des Dieux, Et qui ſans rien exagerer, par tous les employs qu’il me donne, Aurois beſoin, plus que perſonne D auoir dequoy me voſturer.	Moi qui fuis, comme on sait, en terre et dans les Cieux, Le fameux Messager du souverain des Dieux, Et qui sans rien exagérer, par tous les emplois qu'il me donne, Aurais besoin, plus que personne D avoir dequoy me vosturer.
LA NVICT.	LA NVICT.
Que voulez-vous faire à cela?	Que voulez-vous faire à cela?
Les Poëtes font à leur guiſe, Ce n’eſt pas la ſeule ſottiſe, l2 Qu’on voit faire à ces Meſſieurs-là.	Les Poètes font à leur guise, Ce n'est pas la seule sottise, l2 Qu'on voit faire à ces Messieurs-là.
Mais contr’eux toutefois voſtre ame à tort s’irrité, Et vos aiſles aux piez ſont vn don de leurs ſoins.	Mais contr'eux toutefois votre âme à tort s'irrité, Et vos ailes aux pieds sont un don de leurs soins.
MERCVRE.	MERCURE.
Oüy, mais pour aller plus viſte, Eſt-ce que l’on s’en laſſe moins?	Oui, mais pour aller plus vite, Est-ce que l'on s'en lasse moins?
LA NVICI.	LA NVICI.
Laiſſons cela, Seigneur Mercure, Et ſçachons ce dont il s’agit.	Laissons cela, Seigneur Mercure, Et sachons ce dont il s'agit.
MERCVRE.	MERCURE.
C’eſt Iupiter comme ie vous l’ay dit, Qui de voſtre manteau veut la faueur obſcure pour certaine douce auanture, Qu’vn nouuel Amour luy fournit.	C'est Jupiter comme ie vous l'ai dit, Qui de votre manteau veut la faveur obscure pour certaine douce aventure, Qu'un nouvel Amour lui fournit.
Sespratiques, ie croy, ne vous ſont pas nouuelles Bien ſouuent pour la terre il neglige les Cieux, Et vous n’ignorez pas que ce Maiſtre des Dieux Aime à s’humaniſer pour des Beautez mortelles, Et ſçait cent tours ingenieux, Pour mettre à bout les plus cruelles.	Sespratiques, votre crois, ne vous sont pas nouvelles Bien souvent pour la terre il néglige les Cieux, Et vous n'ignorez pas que ce Maître des Dieux Aime à s'humaniser pour des Beautés mortelles, Et Sait cent tours ingénieux, Pour mettre à bout les plus cruelles.
Des yeux d’Alemene il a ſenti les coups;	Des yeux d'Allemène il a senti les coups;
Et tandis qu’au milieu des Beotiques Plaines;	Et tandis qu'au milieu des Beotiques Plaines;
Amphitryon ſon Epous Commande aux Troupes Thebaines.	Amphitryon son Épous Commande aux Troupes Thebaines.
Il en a pris la forme, & reçoit là-deſſous Vn ſoulagement à ſes peines, Dans la poſſeſſion des plaiſirs les plus doux, L’Etat des Mariez à ſes feux eſt propice:	Il en a pris la forme, et reçoit là-dessous Un soulagement à ses peines, Dans la possession des plaisirs les plus doux, L'État des Mariés à ses feux est propice:
L’Hymen ne les a joints que depuis quelques jours, Et la jeune chaleur de leurs tendres amours.	L'Hymen ne les a joints que depuis quelques jours, Et la jeune chaleur de leurs tendres amours.
A fait que Iupiter à ce bel Attifice S’eſt auisé d’auoir recours.	A fait que Jupiter à ce bel Attifice S'est avisé d'avoir recours.
Son ſtratageme icy ſe trouue ſalutaire:	Son stratagème ici se trouve salutaire:
Mais prés de maint objet chery, Pareil déguiſement ſeroit pour ne rien faire;	Mais près de maint objet chéri, Pareil déguisement serait pour ne rien faire;
Et ce n'eſt pas par tout vn bon moy en de plaire Que la figure d’vn mary.	Et ce n'est pas par tout un bon moi en de plaire Que la figure d'une mari.
LA NVICT.	LA NVICT.
I'admire Iupiter, & ie ne comprens pas, Tous les déguiſemens qui luy viennent en teſte.	J'admire Iupiter, et ainsi ne comprends pas, Tous les déguisements qui lui viennent en tête.
MERCVRE.	MERCURE.
Il veut goûter par la toute ſorte d’Etats.	Il veut goûter par la toute sorte d'États.
Et c’eſt agir en Dieu qui n’eſt pas beſte.	Et c'est agir en Dieu qui n'est pas bête.
Dans quelque rang qu’il ſoit des Mortels regardé, Ie le tiendrois fort miſerable, S’il ne quittoit jamais ſa mine redoutable, Et qu’au faiſte des Cieux il fut toûjours guindé.	Dans quelque rang qu'il soit des Mortels regardé, Je le tiendrais fort misérable, S'il ne quittait jamais sa mine redoutable, Et qu'au faîte des Cieux il fut toujours guindé.
Il n’eſt point à mon gré de plus ſotte Methode, Que d’eſtre empriſonné toûjours dans la grandeur;	Il n'est point à mon gré de plus sotte Méthode, Que d'être emprisonné toujours dans la grandeur;
Et ſur tout, aux tranſports de l’amoureuſe ardeur, La grande qualité deuient fort incommode Iupiter qui ians doute en plaiis re connoit, Sçait deſcendre du haut de ſa gloire ſuprême;	Et sur tout, aux transports de l'amoureuse ardeur, La grande qualité devient fort incommode Jupiter qui jans doute en plaiis re connaît, Sait descendre du haut de sa gloire suprême;
Et pour entrer dans tout ce qu’il luy plait, Il ſort tout à fait de luy-meſme, Et ce n’eſt plus alors Iupiter qui paroît,	Et pour entrer dans tout ce qu'il était plaît, Il sort tout à fait de m-même, Et ce n'est plus alors Jupiter qui paraît,
LA NVICT.	LA NVICT.
paſſe encor de le voir de ce ſublime Etage Dans celuy des hommes venir;	passe encor de le voir de ce sublime Éthage Dans celui des hommes venir;
grendre tous les tranſports que leur cœut peut fournir, Et ſe faire à leur badinage;	grendre tous les transports que leur cœut peut fournir, Et se faire à leur badinage;
Si dans les changemens où ſon humeur l’engage A la nature Humaine, il s’en vouloit tenir, Mais de voir Jupiter Taureau, Serpent, Cygne, ou quelque autre choſe, ye ne troude point cela beau y Et ne m’eſtonne pas ſi par fois on en cauſe.	Si dans les changements où son humeur l'engage À la nature Humaine, il s'en voulait tenir, Mais de voir Jupiter Taureau, Serpent, Cygne, ou quelque autre chose, ie ne troude point cela beau y Et ne m'étonne pas si par fois on en cause.
MERCVRE.	MERCURE.
Laiſſons dire tous les Cenſeurs, Tels changemens ont leurs douceurs, Qui paſſent leur intelligence;	Laissons dire tous les Censeurs, Tels changements ont leurs douceurs, Qui passent leur intelligence;
Ce Dieu ſçait ce qu’il fait auſſi bien là qu’ailleuls, Et dans les mouuemẽs de leurs tendres ardeurs, Les beſtes ne ſont pas ſi beſtes que l’on penſe.	Ce Dieu sçait ce qu'il fait aussi bien là qu'ailleuls, Et dans les mouvements de leurs tendres ardeurs, Les bêtes ne sont pas si bêtes que l'on pense.
LA NVICT.	LA NVICT.
Reuenons à l’objet dont il a les faueurs, Si par ſon ſtratagême il void ſa flame heureuſe, Que peut il ſouhaiter, & qu’eſt-ce que ie puis.	Revenons à l'objet dont il a les faveurs, Si par son stratagème il void sa flame heureuse, Que peut il souhaiter, et qu'est-ce que je puis.
MERCVRE.	MERCURE.
Que vos cheuaux par vous au petit pas reduits, Pour ſatisfaire aux vœux de ſon Ame amouD’vne nuict ſi delicieuſe,  Treuſe, Faſſent la plus longue des nuicts.	Que vos chevaux par vous au petit pas réduits, Pour satisfaire aux vœux de son Âme amouD'une nuit si délicieuse, Treuse, Fassent la plus longue des nuits.
Qu’à ſes tranſports vous donniez plus d’eſpace, Et retardiez la naiſſance du jour, Qui doit auancer le retour De celuy dont il tient la place.	Qu'à ses transports vous donniez plus d'espace, Et retardiez la naissance du jour, Qui doit avancer le retour De celui dont il tient la place.
LA NVICT.	LA NVICT.
Voilà ſans doute vn bel Employ Que le Graad Iupiter m’apreſte;	Voilà sans doute un bel Emploi Que le Graad Jupiter m'apprête;
„00 Et l’on donne vn nom fort honneſte Au ſeruice qu’il veut de moy.	„0 Et l'on donne un nom fort honnête Au service qu'il veut de moi.
MERCVRE.	MERCURE.
Pour vne jeune Déeſſe, Vous eſtez bien du bon temps!	Pour une jeune Déesse, Vous estez bien du bon temps!
Vn tel employ n’eſt baſſeſſe, Que chez les petites Gens.	Un tel emploi n'est bassesse, Que chez les petites Gens.
Lors que dans vn haut rang on a l’heur de paroiſtre, .	Lors que dans un haut rang on a l'heur de paraître, .
Tout ce qu’on fait eſt toûjours bel & bon;	Tout ce qu'on fait est toujours bel et bon;
Lt laiuant ce qu’on peut eſtre:	Lt laivant ce qu'on peut être:
Les choſes changent de nom.	Les choses changent de nom.
LA NVICT.	LA NVICT.
Sur de pareilles matieres Vous en ſçauez plus que moy :	Sur de pareilles matières Vous en savez plus que moi :
Et pour accepter l’Employ, I’en veux croire vos lumieres.	Et pour accepter l'Emploi, J'en veux croire vos lumières.
MERCVRE.	MERCURE.
He, là, là, Madame la nuict, Vn peu doucement je vous prie, Vous auez dans le monde vn bruit De n’eſtre pas ſi rencherie.	He, là, là, Madame la nuit, Un peu doucement je vous prie, Vous avez dans le monde quelque bruit De n'être pas si renchérie.
On vous fait Confidente en cent climats diuers, De beaucoup de bonnes affaires, Et je crois à parler à ſentimens ouuerts Que nous ne nous en deuons gueres.	On vous fait Confidente en cent climats divers, De beaucoup de bonnes affaires, Et je crois à parler à sentiments ouverts Que nous ne nous en devons guère.
LA NVICT.	LA NVICT.
Laiſſons ces contrarietez, Et demeurons ce que nous ſommes, N’appreſtons point à rire aux hommes, En nous diſant nos veritez.	Laissons ces contrariétés, Et demeurons ce que nous sommes, N'apprêtons point à rire aux hommes, En nous disant nos vérités.
MERCVRE.	MERCURE.
Adieu, je vay là bas dans ma commi ſſion Dépoüiller promptemẽt la forme de Mercure, Pour y veſtir la figure Du valet d’Amphi trion.	Adieu, je vais là bas dans ma commi ssion Dépouiller promptement la forme de Mercure, Pour y vêt la figure Du valet d'Amphi trion.
LA NVICT.	LA NVICT.
Moy dans cette Hemiſphere auec ma ſuite obſcure Ie vais faire vne ſtation.	Moi dans cette Hémisphère avec ma suite obscure Je vais faire une station.
MERCVRE.	MERCURE.
Bon-jour la Nuict.	Bonjour la Nuit.
LA NVICT.	LA NVICT.
Adieu Mercure.	Adieu Mercure.
Mercure deſcend de ſon Nuage en Terre, & la Nuict paſſe dans ſon Char.	Mercure descend de son Nuage en Terre, et la Nuit passe dans son Char.
AAGIBIRMniEIC.	AAGIBIRMniEIC.
SCENE PREMIERE.	SCÈNE PREMIÈRE.
SOSIE.	SOSIE.
Vi va là?	Vi va là?
Heu?	Heu?
Ma peur, à chaque pas s’accroiſt, Meſſieurs, amy de tout le monde, Ah!	Ma peur, à chaque pas s'accroît, Messieurs, ami de tout le monde, Ah!
qu’elle audace ſans ſeconde, De marcher à l’heure qu’il eſt !	qu'elle audace sans seconde, De marcher à l'heure qu'il est !
Que mon Maiſtre couuert de gloire, Me joüe icy d’vn vilain tour?	Que mon Maître couvert de gloire, Me joue ici d'un vil tour?
Quoy?	Quoi?
Si pour ſon prochain il auoit quelque amour M’auroit-il fait partir par vne nuit ſi noire, Et pour me renuoyer annoncer ſon retour, Et le detail de ſa victoire, Ne pouuoit-il pas bien attendre qu’il fut jour?	Si pour son prochain il avait quelque amour M'aurait-il fait partir par une nuit si noire, Et pour me renvoyer annoncer son retour, Et le détail de sa victoire, Ne pouvait-il pas bien attendre qu'il fut jour?
10 COMEDIE.	10 COMÉDIE.
Soſie à quelle ſeruitude Tes jours ſont-ils aſſujettis?	Sosie à quelle servitude Tes jours sont-ils assujettis?
Noſtre ſort eſt beaucoup plus rude Chez les Grands que chez les petits.	Notre sort est beaucoup plus rude Chez les Grands que chez les petits.
Ils veulent que pour eux tout ſoit dans la Nature Obligé de s’immoler.	Ils veulent que pour eux tout soit dans la Nature Obligé de s'immoler.
Iour, & nuict, gréle, vent, peril, chaleur, froidure, Dés qu’ils parlent il faut voler, Vingt-ans d’aſſidu ſeruice N’en obtiennent rien pour nous e Le moindre petit caprice Nous attire leur courroux.	Jour, et nuit, grèle, vent, péril, chaleur, froidure, Dès qu'ils parlent il faut voler, Vingt-ans d'assidu service N'en obtiennent rien pour nous eût Le moindre petit caprice Nous attire leur courroux.
Cependant noſtre ame inſenſée , S’acharne au vain honneur de demeurer prét d’eux;	Cependant notre âme insensée , S'acharne au vain honneur de demeurer prêt d'eux;
Et s’y veur contenter de la fauſe penſée, Qu’ont tous les autres gens que nous ſommes heureux, Vers la retraite en vain la raiſon nous appelle;	Et s'y veur contenter de la fausse pensée, Qu'ont tous les autres gens que nous sommes heureux, Vers la retraite en vain la raison nous appelle;
En vain noſtre dépit quelquefois y conſent:	En vain notre dépit quelquefois y consent:
Leur veue a ſur noſtre zele Vn aſcendant trop puiſſant;	Leur veue a sur notre zèle Un ascendant trop puissant;
Et la moindre faueur d’vn coup d’œil careſſant;	Et la moindre faveur d'autre coup d'œil caressant;
Nous r’engage de plus belle.	Nous rengage de plus belle.
Mais enfin dans l’obſcurité, Ie voy noſtre maiſon, & ma frayeur s’euade.	Mais enfin dans l'obscurité, Je vois notre maison, et ma frayeur s'évade.
Il me faudroit, pour l’Ambaſſade, Quelque diſcours premedité.	Il me faudrait, pour l'Ambassade, Quelque discours prémédité.
Ie dois aux yeux d’Alcmene vn portrait Militaire Du grand Combat qui met nos ennemis à bas?	Je dois aux yeux d'Alcmène un portrait Militaire Du grand Combat qui met nos ennemis à bas?
Mais comment Diantre le faire, Si ie ne m’y trouuay pas?	Mais comment Diantre le faire, Si tu ne m'y trouvai pas?
AMl lIIXIeNeN.	AMl lIXIeNeN.
1 N’importe parlons-en & d’eſtoc & de taille, Comme oculaire témoin.	1 N'importe parlons-en et d'étoc et de taille, Comme oculaire témoin.
Combien de Gens font-ils des recits de Bataille, Dont ils ſe ſont tenus loin?	Combien de Gens font-ils des récits de Bataille, Dont ils se sont tenus loin?
Pour joüer mon roole ſans peine, Ie le veux vn peu repaſſer:	Pour jouer mon roole sans peine, Je le veux un peu repasser:
Voicy la chambre, ou j’entre en courrier que l’on meine, Il poſe ſa Et cette Lanterne eſt Alcmene, Lanterne A qui je me dois adreſſer, à terre & luy Madame Amphitryon mon Maiſtre adreſſe ſon & voſtre Epoux, compliment.	Voici la chambre, ou j'entre en courrier que l'on mène, Il pose sa Et cette Lanterne est Alcène, Lanterne A qui je me dois adresser, à terre et et Ainsi Amphitryon mon Maître adresse son et votre Époux, compliment.
Bon?	Bon?
beau debut?	beau début?
l’Eſprit toûjours plein de vos charmes M’a voulu choiſir entre tous, Pour vous donner auis du ſuccez de ſes armes, Et du deſir qu’il a de ſe voir prés de vous.	l'Esprit toujours plein de vos charmes M'a voulu choisir entre tous, Pour vous donner avis du succès de ses armes, Et du désir qu'il a de se voir près de vous.
Ha!	Ha!
vrayment mon pauure Soſie, A te voir j’ay la joye au Cœur.	vraiment mon pauvre Sosie, À te voir j'ai la joie au Cœur.
Madame?	Madame?
ce m’eſt trop d’honneur, Et mon deſtin doit faire enuie.	ce m'est trop d'honneur, Et mon destin doit faire envie.
Bien répondu?	Bien répondu?
Comment ſe porte Amphitryon.	Comment se porte Amphitryon.
Madame, en homme de Courage, Dans les occaſions où la gloire l’engage.	Madame, en homme de Courage, Dans les occasions où la gloire l'engage.
Fort bien?	Fort bien?
belle Conception?	belle Conception?
Quand viendra-t’il, par ſon retour charmant Rendre mnun lime jatlspare e Le plûtoſt qu’il pourra, Madame, aſſurément;	Quand viendra-t-il, par son retour charmant Rendre ménun lime jatlspare e Le plutôt qu'il pourra, Madame, assurément;
Mais bien plus tard que ſon cœur ne ſouhaite, A h!	Mais bien plus tard que son cœur ne souhaite, A h!
Mais quel eſt l’Etat ou la Guerre l’a mis?	Mais quel est l'État ou la Guerre l'a mis?
Que dit-il?	Que dit-il?
Que fait-il?	Que fait-il?
contente vn peu mon ame.	contente un peu mon âme.
Il dit moins qu’il ne fait, Mada me B iij	Il dit moins qu'il ne fait, Mada me B jijà
Mais leur chaleur par nous fut bien-toſt reprimée,	Mais leur chaleur par nous fut bientôt reprimée,
Et fait trembler ſes Ennemis.	Et fait trembler ses Ennemis.
Peſte?	Peste?
où prend mon Eſprit toutes ces gentilleſſes?	où prend mon Esprit toutes ces gentillesses?
Que font les reuoltez?	Que font les révoltés?
dy-moy, quel eſt leur ſort?	dis-moi, quel est leur sort?
Ils n’ont pû reſiſter, Madame à noſtre effort:	Ils n'ont pu résister, Madame à notre effort:
Nous les auons taillez en pieces, Mis Pteleras leur chef à mort;	Nous les avons taillez en pièces, Mis Pteleras leur chef à mort;
Pris Telebe d’aſſaut, & déja dans le Port Tout retentit de nos Proueſſes.	Pris Telebe d'assaut, et déjà dans le Port Tout retentit de nos Prouesses.
Ah!	Ah!
quel ſuccez!	quel succès!
ô Dieux!	ô Dieux!
qui l’eût pú jamais croire?	qui l'eût peste jamais croire?
Raconte-moy, Soſie vn tel euenement.	Raconte-moi, Sosie un tel événement.
Ie le veux bien, Madame, & ſans m’enfler de gloire, Du détail de cette victoire Ie puis parler tres-ſçauamment.	Je le veux bien, Madame, et sans m'enfler de gloire, Du détail de cette victoire Je puis parler très-sçauamment.
Figurez-vous donc que Telebe, Madame, eſt de ce coſté C’eſt vne Ville en verité, Il marque les lieux Auſſi grande quaſi que Thebe.	Figurez-vous donc que Télèbe, Madame, est de ce côté C'est une Ville en vérité, Il marque les lieux Aussi grande quasi que Thebe.
ſur ſa main, La Riuiere eſt comme là.	sur sa main, La Rivière est comme là.
Icy nos gens ſe comparent :	Ici nos gens se comparent :
Et l’eſpace que voilà, Nos ennemis l’occuperent.	Et l'espace que voilà, Nos ennemis l'occupèrent.
Sur vn haut, vers cét endroit, Eſtoit leur Infanterie;	Sur un haut, vers cet endroit, Était leur Infanterie;
Et plus bas du coſté droit Eſtoit la Caualerie.	Et plus bas du côté droit Était la Cavalerie.
ou à terre.	ou à terre.
Aprés auoir aux Dieux adreſſé les prieres Tous les Ordres donnez on donne le ſignal.	Après avoir aux Dieux adressé les prières Tous les Ordres donnés on donne le signal.
Les Ennemis penſant nous tailler des croupieres, Firent trois pelotons de leurs gens à chctial;	Les Ennemis pensant nous tailler des croupières, Firent trois pelotons de leurs gens à chtial;
Et vous allez voir comme quoy.	Et vous allez voir comme quoi.
Voilà noſtre auant-garde, à bien faire animée;	Voilà votre avant-garde, à bien faire animée;
Là les Archers de Creon noſtre Roy;	Là les Archers de Creon notre Roi;
Et Voicy le Corps d’Armée, Qui d’abord.	Et Voici le Corps d'Armée, Qui d'abord.
Attendez le Corps d’Armée 2 peur.	Attendez le Corps d'Armée 2 peur.
I’entens quelque bruit ce me ſemble.	J'entends quelque bruit ce me semble.
On fait vn peu de bruit.	On fait un peu de bruit.
MERCVRE, ſous la forme de Soſie.	MERCURE, sous la forme de Sosie.
Ous ce mi nois, qui luy reſſemble, O Chaſſons de ces lieux ce cauſeur;	Ous ce mi nois, qui lui ressemble, Ô Chassons de ces lieux ce causeur;
Dont l’abord importun troubleroit la douceur Que nos Amans goûtent enſemble.	Dont l'abord importun troublerait la douceur Que nos Amans goûtent ensemble.
SOSIE.	SOSIE.
Mon Cœur tant ſoit peu ſe raſſure;	Mon Cœur tant soit peu se rassure;
Et je penſe que ce n’eſt rien.	Et je pense que ce n'est rien.
Crainte pourtant de ſiniſtre auanture, Allons chez nous acheuer l’entretien.	Crainte pourtant de sinistre aventure, Allons chez nous achever l'entretien.
MERCVRE.	MERCURE.
Tu ſeras plus fort que Mercure, Ou je t’en empecheray bien.	Tu seras plus fort que Mercure, Ou je t'en empêcherai bien.
SOSIE.	SOSIE.
Cette nuit, en longueur, me ſemble ſans pareille:	Cette nuit, en longueur, me semble sans pareille:
Il faut depuis le temps que je ſuis en chemin, Ou que mon Maiſtre ait pris le ſoir pour le mitin ----- ------ Ou que trop tard au lict le blond Phebus ſommeille, Pour auoir trop pris de lon vin.	Il faut depuis le temps que je suis en chemin, Ou que mon Maître ait pris le soir pour le mitin -à- --Dix -dix -vis -lard au lit le blond Phebus sommeille, Pour avoir trop pris de lon vin.
MERCVRE.	MERCURE.
Comme auec irreuerence Parle des Dieux ce Maraut?	Comme a irreuerence Parle des Dieux ce Maraud?
Mon bras ſçaura bien tantoſt Châtier cetté inſolence;	Mon bras Saura bien tôt Châtier cetté insolence;
Et je vais m'egayer auec Iuy comme nfaut, En luy volant ſon nom, auec ſa reſſemblance.	Et je vais m'égayer avec Jui comme nfaut, En tu volant son nom, avec sa ressemblance.
SOSIE.	SOSIE.
Ah!	Ah!
par ma foy, j’auois raiſon !	par ma foi, j'avais raison !
C’eſt fait de moy, chetiue creature.	C'est fait de moi, chétive créature.
Ie voy deuant noſtre maiſon, Certain homme dont l’encolure Ne me preſage rien de bon.	Je vois devant notre maison, Certain homme dont l'encolure Ne me présage rien de bon.
Pour faire ſemblant d’aſſurance Ie veux chanter vn peu icy.	Pour faire semblant d'assurance Je veux chanter un peu ici.
Jl chante;	Il chante;
& lors que Mercure parle, ſa voix s’affoiblit peu à peu.	et lors que Mercure parle, sa voix s'affaiblit peu à peu.
MERCVRE.	MERCURE.
Qui uone ent-ce Coquin, qui prenu tant de licence, Que de chanter, & m’etourdir ainſi?	Qui Que ent-ce Coquin, qui prenu tant de licence, Que de chanter, et m'étourdir ainsi?
Veut-il qu’à l’étriller, ma main vn peus’aplique?	Veut-il qu'à l'étriller, ma main un pus'applique?
SOSIE.	SOSIE.
Cét homme, aſſurement n’ayme pas la Muſique,	Cet homme, assurément n'aime pas la Musique,
MERCVRE.	MERCURE.
Depurs plus d’vne femaine, Ie n’ay trouué perſonne à qui rompre les os.	Dépurs plus d'une semaine, Je n'ai trouvé personne à qui rompre les os.
La vertu de mon bras ſe perd dans le repos;	La vertu de mon bras se perd dans le repos;
Et je cherche quelque dos, Pour me remettre en haleine.	Et je cherche quelque dos, Pour me remettre en haleine.
SOSIE.	SOSIE.
Quel Diable d’homme eſt cacy?	Quel Diable d'homme est caci?
De mortelles frayeurs je ſens mon ame atteinte.	De mortelles frayeurs je sens mon âme atteinte.
Mais pourquoy trembler tant auſſi?	Mais pourquoi trembler tant aussi?
Peut-eſtre a-t’il dans l’Ame autant que moy de crainte, Et que le drolle parle ainſi, Pour me cacher ſa peur, ſoue vne audace feinte.	Peut-être a-t-il dans l'Âme autant que moi de crainte, Et que le drolle parle ainsi, Pour me cacher sa peur, soue une audace feinte.
Ouy, ouy, ne ſouffrons point qu’on nous croye vn Oyſon, Si je ne ſuis hardy, tâchons de le parêtre, Faiſons-nous du cœur par raiſon.	Oui, oui, ne souffrons point qu'on nous croie un Oison, Si je ne suis hardi, tâchons de le parêtre, Faisons-nous du cœur par raison.
fruuleul comme moy, je ſuis fort, j’ay bon maiſtre, Et vorta hontle mahlon.	fruuleul comme moi, je suis fort, j'ai bon maître, Et vorta hontle mahlon.
Qui va-la?	Qui va-la?
MERCVRE.	MERCURE.
SOSTE.	SOSTE.
Moy.	Moi.
MERCVRE.	MERCURE.
Qui, moy.	Qui, moi.
SOSIE.	SOSIE.
–*- Moy.	–*- Moi.
Courage, Soſie.	Courage, Sosie.
MEACV RE.	MEACV RE.
Quel eſt ton ſort, dis-moy?	Quel est ton sort, dis-moi?
SOSIE.	SOSIE.
D’eſtre homme & de parler.	D'être homme et de parler.
MERCVRE.	MERCURE.
Es-tu Maiſtre ou Valet?	Es-tu Maître ou Valet?
SOSIE.	SOSIE.
Comme il me prend enuie.	Comme il me prend envie.
MERCVRE.	MERCURE.
Où s’adreſſent tes pas?	Où s'adressent tes pas?
SOSIE.	SOSIE.
Ou j'ay dencan d'uncis	Ou j'ai dencan d'uncis
MERCVRE.	MERCURE.
Ah!	Ah!
cecy me deplait.	ceci me déplaît.
SOSIE.	SOSIE.
I’en ay l’ame rauie.	J'en ai l'âme ravie.
MERCVRE.	MERCURE.
Reſolument par force ou par amour, Ie veux ſçauoir de toy, traiſtre.	Résolument par force ou par amour, Je veux savoir de toi, traître.
Ce quulmluio, dontu riens auuuejour;	Ce quulmluio, dontu riens auuuejour;
Où tu vas, à qui tu peux eſtre.	Où tu vas, à qui tu peux-même.
SOSIE.	SOSIE.
Ie fais le bien, & le mal tour à tour?	Je fais le bien, et le mal tour à tour?
Ie viens de la, vais là, j’appartiens à mon Maiſtre.	Je viens de la, vais là, j'appartiens à mon Maître.
MERCVRE.	MERCURE.
Tu montres de l’eſprit, & je te vois en train De trancher auec moy de l’homme d’impor tance , Il me prend vn deſir, pour faire connoiſſance, De te donner vn foufflet de ma main.	Tu montres de l'esprit, et je te vois en train De trancher avec moi de l'homme d'impor tance , Il me prend un désir, pour faire connaissance, De te donner un soufflet de ma main.
A moy-meſme?	À moi-même?
SOSIE.	SOSIE.
MERCVRE.	MERCURE.
.	.
A toyememe, a t’en volla certaine Il luy donne vn ſoufflet.	À toyememe, a -t-en vola certaine Il lui donne un soufflet.
SOSIE.	SOSIE.
Ah, ah, c’eſt tout de bon!	Ah, ah, c'est tout de bon!
MERCVRE.	MERCURE.
Non, ce n’eſt que pour rire, Et repondre à tes quolibets.	Non, ce n'est que pour rire, Et répondre à tes quolibets.
SOSIE.	SOSIE.
Tu Dieu, l’Amy, ians vous rien dire, Comme vous baillez des ſoufflets?	Tu Dieu, l'Ami, jant vous rien dire, Comme vous baillez des soufflets?
MERCVRE.	MERCURE.
Ce ſont là de mes moindres coups;	Ce sont là de mes moindres coups;
Des petite ſoufflets ordinaires.	Des petite soufflets ordinaires.
SOSIE.	SOSIE.
Si j’eſtois auſſi prompt que vous, Nous Ierrons de benes anaires,	Si j'étais aussi prompt que vous, Nous Jerrons de benes aires,
MERCVRE.	MERCURE.
Tout cela n’eſt encore rien, Pour y faire quelque pauſe:	Tout cela n'est encore rien, Pour y faire quelque pause:
Nous verrons bien autre choſe;	Nous verrons bien autre chose;
Pourſuiuons noſtre entretien.	Poursuivons notre entretien.
SOSIE.	SOSIE.
Jl veut s’en aller.	Il veut s'en aller.
Ie quitte la partie.	Je quitte la partie.
MERCVRE.	MERCURE.
Oü vas-tu ?	Oui vas-tu ?
SOSIE.	SOSIE.
Que t’importe?	Que t'importe?
MERCVRE.	MERCURE.
Ie veux ſçauoir où tu vas,	Je veux sais où tu vas,
b olſ.	 bls.
Me faire ouurir cette porte?	Me faire ouvrir cette porte?
Pourquoy retiens-tu mes pas?	Pourquoi retiens-tu mes pas?
MERCVRE.	MERCURE.
Si juſqu’à l’approcher tu pouſſes ton audace, Ie fais ſur toy pleuuoir vn orugo de coups.	Si jusqu'à l'approcher tu pousses ton audace, Je fais sur toi pleuvoir un orugo de coups.
OSIE.	OSIE.
Quoy!	Quoi!
tu veux s par ta menace M’empecher d’entrer chez-nous?	tu veux s ' a menace M'empêcher d'entrer chez-nous?
MEREVRE.	MEREURE.
Comment, chez-nous?	Comment, chez-nous?
SOSIE.	SOSIE.
Ouy, chez-nous.	Oui, chez-nous.
MERCVRE.	MERCURE.
O le Traitre !	Ô le Taitre !
Tu te dis de cette maiſon?	Tu te dis de cette maison?
OSIE.	OSIE.
Fort bien, Amphitryon n’en eſt-il pas le Maiſtre?	Fort bien, Amphitryon n'en est-il pas le Maître?
MERCVRE.	MERCURE.
Hé bien que fait cette raiſon?	Hé bien que fait cette raison?
le ſuis ſon valet.	le suis son valet.
SOSIE.	SOSIE.
MERCVRE.	MERCURE.
To y?	To y?
SOSIE.	SOSIE.
Moy.	Moi.
MEROIREZ Son Valet?	MEROIREZ Son Valet?
SOSTE.	SOSTE.
Sans doute.	Sans doute.
MERCVRE.	MERCURE.
Valet d’Amphitryon?	Valet d'Amphitryon?
SOSIE.	SOSIE.
D’Amphitryon;	D'Amphitryon;
de luy.	de notre.
Ton nom eſt.	Ton nom est.
MERCVRE.	MERCURE.
SOSIE.	SOSIE.
Soſie.	Sosie.
hil d deav daus Heu?	hil d au daus Heu?
Comment?	Comment?
SOSIE.	SOSIE.
Soſie.	Sosie.
MERCVRE.	MERCURE.
Ecoute.	Écoute.
Sçais tu que de ma main je t’aſſomme aujourd’huy?	Sais -tu que de ma main je t'assomme aujourd'hui?
o a aa Pourquoy, de quelle rage eſt ton ame ſaiſie?	ô a la Pourquoi, de quelle rage est ton âme saisie?
MERCVNES Qui te donne, diſ-moy cette temerité, De prendre le nom de Soſie?	MERCUNES Qui te donne, dis-moi cette témérité, De prendre le nom de Sosie?
SOSIE.	SOSIE.
Moy, je ne le prens point, je l’ay toûjours porté.	Moi, je ne le prends point, je l'ai toujours porté.
MERCVRE.	MERCURE.
O le menſonge horrible!	Ô le mensonge horrible!
& l’impudence extreme!	et l'impudence extrême!
Tu M’oles loutend que soncun tonnon a	Tu M'oles loutend que soncun tonnon a
OSIE.	OSIE.
Fort bien je le ſoûtiens, par la grande raiſon, Qu’ainſi l’a fait des Dieux la puiſſance ſuprême:	Fort bien je le soutiens, par la grande raison, Qu'ainsi l'a fait des Dieux la puissance suprême:
Le quiin eit pas en moy de pouuoir dire non, Et d’eſtre vn autre que moy-méme.	Le quiin eit pas en moi de pouvoir dire non, Et d'être un autre que moi-même.
Mercure le bat.	Mercure le bat.
MERCVRE.	MERCURE.
pilile coups de baiton doident eſtre le prix D’vne pareille effronterie.	pilile coups de baiton doident être le prix D'une pareille effronterie.
SOSTE.	SOSTE.
Iuſtice, Citoyens, au ſecours je vous prie?	Justice, Citoyens, au secours je vous prie?
MERCVRE.	MERCURE.
Comment, Bourreau, tu fais de cris?	Comment, Bourreau, tu fais de cris?
BOSTE.	BÔTE.
De mille coups tu me meurtris, Et tu ne veux pas que je crie ?	De mille coups tu me meurtris, Et tu ne veux pas que je crie ?
MERCVRE.	MERCURE.
C’eſt ainſi que mon Bras.	C'est ainsi que mon Bras.
SOSIE.	SOSIE.
L’action ne vaut rien, Tu triomphes de l’auantage Que te donne ſur moy mon mãque de courage, Et ce n’eſt pas en vſer bien;	L'action ne vaut rien, Tu triomphes de l'avantage Que te donne sur moi mon manque de courage, Et ce n'est pas en user bien;
C’eſt pure fanfaronnerie, De vouloir profiter de la Poltronnerie, me evan da danaquenansccraa y Battre vn homme à jeu ſeur, n’eſt pas d’vne ugild aide, Et le cœur eſt digne de blame, Contre les gens qui n’en ont pas.	C'est pure fanfaronnerie, De vouloir profiter de la Poltronnerie, me evan da danaquenansccraa y Battre un homme à jeu sûr, n'est pas d'une ugild aide, Et le cœur est digne de blâme, Contre les gens qui n'en ont pas.
MERCVRE.	MERCURE.
Hé bien, es tu Soſie à preſent?	Hé bien, es tu Sosie à présent?
qu’en dis-tu'	qu'en dis-tu'
SOSIE.	SOSIE.
Tes coups n’ont point en moy fait de metamotphoſe, Et tout le changement qui ſe trouue à la choſe e el d’eſtre Sone bartu.	Tes coups n'ont point en moi fait de métamotphose, Et tout le changement qui se trouve à la chose é el d'être Sone bartu.
MERCVRE.	MERCURE.
Encor cent autres coups pour cette autre impudence.	Encor cent autres coups pour cette autre impudence.
SOSIE.	SOSIE.
De grace fais tréue à tes coups.	De grâce fais trêve à tes coups.
MRERCVNE.	MRERCUNE.
Fais donc tréue à ton inſolenee.	Fais donc trêve à ton insolence.
OSIE.	OSIE.
Tout ce qu’il te plairra, je garde le ſilence, La diſpute eſt par trop inégale entre nous.	Tout ce qu'il te plaira, je garde le silence, La dispute est par trop inégale entre nous.
MERCVRE.	MERCURE.
Es-tu Soſie encor?	Es-tu Sosie encor?
d’y, Traiſtre !	d'y, Traître !
OSIE.	OSIE.
Heras -je luis ce que tu veux, Diſpoſe de mon ſort tout au gré de tes vœux, Ton bras t’en a fait le maiſtre.	Heras je luis ce que tu veux, Dispose de mon sort tout au gré de tes vœux, Ton bras t'en a fait le maître.
MERCVRE.	MERCURE.
Ton Nom eſtoit Soſie, à ce que tu diſois.	Ton Nom était Sosie, à ce que tu disais.
doore.	doore.
Il eſt vray, juſqu’icy j’ay cru la choſe claire:	Il est vrai, jusqu'ici j'ai cru la chose claire:
Mais ton Baſton ſur cette affaire, Ma fait voit que ie m’abuſois.	Mais ton Bâton sur cette affaire, Ma fait voit que sans m'abusais.
MERCVRE.	MERCURE.
C’eſt moy qui ſuis Soſie, & tout Thebe l’auoüe, Amphitryon jamais n’en eut d’autre que moy.	C'est moi qui suis Sosie, et tout Thebe l'auoüe, Amphitryon jamais n'en eut d'autre que moi.
Toy Soſie?	Toi Sosie?
S Culu.	 Sulu.
MERCVRE.	MERCURE.
Ouy Soſie, & ſi quelqu’vn s’y joüe, Il peut bien prendre garde à ſoy.	Oui Sosie, et si quelqu'un s'y joie, Il peut bien prendre garde à soi.
SOSIE.	SOSIE.
Ciel!	Ciel!
me faut-il ainſi renoncet à moy-méme;	me faut-il ainsi renoncet à moi-même;
Et par vn impoſteur me voir volet mon nom!	Et par un imposteur me voir volet mon nom!
Que ſon bon-heur eſt extréme, De ce que je ſuis poltron !	Que son bonheur est extrême, De ce que je suis poltron !
Sans cela par la mort.	Sans cela par la mort.
MERCVRE.	MERCURE.
Entre les dents, je penſe, Tu murmures, je ne ſçay quoy?	Entre les dents, je pense, Tu murmures, je ne sais quoi?
OSIE.	OSIE.
Non, mais au Nom des Dieux, donne moy la licence Fis.	Non, mais au Nom des Dieux, donne -moi la licence Fis.
L.	L.
De parler vn moment à toy.	De parler un moment à toi.
Parle.	Parle.
MERCVRE.	MERCURE.
SOSIE.	SOSIE.
hluro promees mo y de grace, Que les coups n’en ſeront point.	hluro promées mo y de grâce, Que les coups n'en seront point.
Signons vne Tréue.	Signons une Trêve.
MERCVRE.	MERCURE.
Va je t’accorde ce point.	Va je t'accorde ce point.
Paſſe,	Passe,
OSIE.	OSIE.
400 Qui te jette, ay moyy duns cette fantaiſie, Que te reuiendra-t’il de m’enleuer mon nom?	400 Qui te jette, ai -moii duns cette fantaisie, Que te reviendra-t-il de m'enlever mon nom?
Et peux-tu falre enfin quand tu ſerois denion, Que je ne ſois pas moy?	Et peux-tu falre enfin quand tu serais denion, Que je ne sois pas moi?
que ie ne ſois Soſie?	que ici ne sois Sosie?
MERCVRE.	MERCURE.
Comment tu peux.	Comment tu peux.
SOSIE.	SOSIE.
Ah!	Ah!
tout doux :	tout doux :
Nous auons fait tréue aux coups.	Nous avons fait trêve aux coups.
MERCVRE.	MERCURE.
ioy!	joi!
pendart, impoſteur, Coquin.	pendard, imposteur, Coquin.
SOSIE.	SOSIE.
Pour des injures, Dy-m’en tant que tu voudras, Ce ſont legeres bleſſures, C i ut ju ne m en Taenc pas.	Pour des injures, Dis-m'en tant que tu voudras, Ce sont légères blessures, Ç y ut ju ne m en Taenc pas.
MERCVRE.	MERCURE.
Tu te dis Soſie.	Tu te dis Sosie.
SOSIE.	SOSIE.
Ouy, quelque conte friuoſe.	Oui, quelque conte frivose.
MERCVRE, cnojje rompo noitte cleuc, & repreat ma pârole.	MERCURE, cnojà rompo noitte cleuc, et repreat ma pâtrole.
SOSIE.	SOSIE.
N’importe, je ne puis m’aueantir pout toy, Et ſouffrir vn diſcours, ſi loin de l’apparence, Eſtre ce que ie ſuis, eſt-il en ta puiſſance?	N'importe, je ne puis m’avantir pout toi, Et souffrir un discours, si loin de l'apparence, Être ce que je suis, est-il en ta puissance?
Et puis-je ceſſer d’eſtre moy?	Et puis-je cesser d'être moi?
S’auiſa-t’on jamais d’vne choſe pateille?	S'avisa-t-on jamais d'une chose pateille?
Et peut-on dementir cent indices preſſans l̀ Réue-je?	Et peut-on démentir cent indices pressants l Ue-je?
eſt-ce que ie ſommeille, Ay je l’eſprit troublé par des tranſports puiſ ſans ?	est-ce que ici sommeille, Ai je l'esprit troublé par des transports puis sans ?
Ne ſens-je pas bien que ie veille?	Ne sens-je pas bien que ici veille?
Ne ſuis-je pas dans mon bon ſens?	Ne suis-je pas dans mon bon sens?
Mon Maiſtre, Amphitryon, ne m’a t’il pas commis, A venir en ces lieux, vers Alemene ſa femme?	Mon Maître, Amphitryon, ne m'a -t-il pas commis, À venir en ces lieux, vers Alémène sa femme?
Ne luy dois-je pasfaire en luy vantant ſa flame, Vn recit de ſes faits contre nos Ennemis?	Ne lui dois-je pasfaire en peine vantant sa flamme, Un récit de ses faits contre nos Ennemis?
Ne ſuis-je pas du port arriué tout à l’heure?	Ne suis-je pas du port arrivé tout à l'heure?
Ne tiens-je pas vne lanterne en main?	Ne tiens-je pas une lanterne en main?
Ne te trouue-je pas deuant noſtre demeure?	Ne te trouve-je pas devant notre demeure?
Ne t’y parle-je pas d’vn Eſprit tout humain Ne te tiens-tu pas fort de ma poltronerie, Pour m’empeſcher d’entrer chez-nous?	Ne t'y parle-je pas d'un Esprit tout humain Ne te tiens-tu pas fort de ma poltronerie, Pour m'empêcher d'entrer chez-nous?
N’as-tu pas ſur mon dos extreé ta furie?	N'as-tu pas sur mon dos extré ta furie?
Ne m'as-ta point roué de coups?	Ne m'as-ta point roué de coups?
Ah!	Ah!
tout cela n’eſt que trop veritable.	tout cela n'est que trop véritable.
Ceſſe donc d’inſulter au ſort d’vn Miſerable, Et fallle à mon deuoil s acquiter de les loins.	Cesse donc d'insulter au sort d'un Misérable, Et fallle à mon dévoil s acquiter de les loins.
MERCVRE.	MERCURE.
Arreſte, ou ſur ton dos le moindre pas attire, Vn aſſommant éclat de mon juſte couroux;	Arrête, ou sur ton dos le moindre pas attire, Un assommant éclat de mon juste courroux;
Tout ce que tu viens de dire, Eſt à moy, hormis les coups.	Tout ce que tu viens de dire, Est à moi, hormis les coups.
C’eſt moy qu’Amphitryon députe vers Alcmene, Et qui du port Perſique atriue de ce pas, Moy qui viens annoncer la valeur de ſon bras, Que nous fait remporter vne victoire pleine, Et de nos Ennemis a mis le Chef à bas.	C'est moi qu'Amphitryon députe vers Alcène, Et qui du port Persique atrive de ce pas, Moi qui viens annoncer la valeur de son bras, Que nous fait remporter une victoire pleine, Et de nos Ennemis a mis le Chef à bas.
C’eſt moy qui ſuis Soſie, enfin de certitude;	C'est moi qui suis Sosie, enfin de certitude;
Fils de Daue honneſte Berger;	Fils de Dave honnête Berger;
Ftere d’Arpage, mort en Païs Eſtranger;	Frère d'Arpage, mort en Pays Étranger;
Mary de Cleanthis la Prude, Dont l’humeur me fait enrager, Qui dans Thebe ay receu mille coups d’étriuiere, Sans en auoit jamais dit rien :	Mari de Cléanthis la Prude, Dont l'humeur me fait enrager, Qui dans Thebe ai reçu mille coups d'étrivière, Sans en avait jamais dit rien :
Et jadis en public fus marqué par derriere, Pour eſtre trop homme de bien.	Et jadis en public fus marqué par derrière, Pour être trop homme de bien.
SOSIE.	SOSIE.
Il a raiſon.	Il a raison.
A moins d’eſtre Soſic, On ne peut pas ſçauoir tout ce qu’il dit.	À moins d'être Sosic, On ne peut pas savoir tout ce qu'il dit.
Et dans l’étonncment, dont mon ame eſt ſaiſie, Ie commence, à mon tour, à le croire vn petit, En effet, maintenant que ie le conſidere, le voy qu’il a de moy, taille, mine, action;	Et dans l'étonncment, dont mon âme est saisie, Je commence, à mon tour, à le croire un petit, En effet, maintenant que je le considère, le vois qu'il a de moi, taille, mine, action;
Faiſons-luy quelque queſtion, Afin d’éclaircir ce myſtere.	Faisons-lui quelque question, Afin d'éclaircir ce mystère.
Parmy tout le Butin fait ſur nos Ennemie, Qu’eſt-ce qu’Amphitryon obtient pour ſon pattage?	Parmi tout le Butin fait sur nos Ennemie, Qu'est-ce qu'Amphitryon obtient pour son pattage?
MERCVRE.	MERCURE.
Cinq fort gros diamans, en nœud proprement Dont leur Chef ſe paroit comme d’vn tare Ouuragc.	Cinq fort gros diamants, en nœud proprement Dont leur Chef se parait comme d'un tare Ouvragc.
SOSIE.	SOSIE.
A qui deſtine-t’il vn ſi riche Preſent?	À qui destine-t-il un si riche Prent?
MERCVREI A ſa femme, & ſur elle il le veut voir paroître.	MERCUREY À sa femme, et sur elle il le veut voir paraître.
SDSIE.	SDSIE.
Mais où, pour l’apporter eſt-il mis à preſent?	Mais où, pour l'apporter est-il mis à présent?
MERCVRE.	MERCURE.
Dans vn coffret, ſeellé des Armes de mon Maiſtre.	Dans un coffret, sellé des Armes de mon Maître.
SOSIE.	SOSIE.
Il ne ment pas d’vn mot, à châque repartie, Et de moy ie commence à douter tout de bon.	Il ne mens pas d'H mot, à chaque répartie, Et de moi ici commence à douter tout de bon.
Prés de moy, par la force, il eſt déja Soſie:	Près de moi, par la force, il est déjà Sosie:
Il pourroit bien encor l’eſtre par la taiſon.	Il pourrait bien encor l'être par la taison.
pourtant, quand je me tâte, & que ie me rappelle, Il me ſemble que je ſuis moy.	pourtant, quand je me tâte, et que personne me rappelle, Il me semble que je suis moi.
Où puis-je rencontrer quelque clarté fidelle, Pour démeler ce que ie voy?	Où puis-je rencontrer quelque clarté fidèle, Pour démeler ce que ici vois?
Ce que i’ay fait tout ſeul, & que n’a veu perſoune, A moins d’eſtre moy-meſme, on ne le peut ſçauoir.	Ce que j'ai fait tout seul, et que n'a vu persoune, A moins d'être moi-même, on ne le peut sçauoir.
Par cette queſtion, il faut que je l’étonne;	Par cette question, il faut que je l'étonne;
e ent dequoy le contondre, & nous allons le voir.	eu ent dequoy le contondre, et nous allons le voir.
Lors qu’on eſtoit aux mains, que fis-tu dans nos Tentes, Où tu courus ſeul te fourrer !	Lors qu'on était aux mains, que fis-tu dans nos Tentes, Où tu courus seul te fourrer !
MERCVRE.	MERCURE.
D’vn jambon.	D'un jambon.
SOSIE.	SOSIE.
L y vollae.	L y volàe.
MERCVRE.	MERCURE.
Que j’allay déterrer, Ie couppay brauement deux Tranches ſueculentes, Dont ie ſçeus fort bien me bourrer Et joignant à cela d’vn vin que l’on ménage, Et dont auant le goût, les yeux ſe contentoient, Ie pris vn peu de courage Pour nos gens qui ſe battoient.	Que j'allai déterrer, Je couppai bravement deux Tranches sueculentes, Dont ie us fort bien me bourrer Et joignant à cela d'un vin que l'on menage, Et dont avant le goût, les yeux se contentaient, Je pris un peu de courage Pour nos gens qui se battaient.
SOSIE.	SOSIE.
Cette preuue ſans pareille, En ſa faueur conclut bien;	Cette preuve sans pareille, En sa faveur conclut bien;
Et l’on n’y peut dire rien, S’il n’eſtoit dans la Bouteille.	Et l'on n'y peut dire rien, S'il n'était dans la Bouteille.
Ie ne ſçaurois nier aux preuues qu’on m’expoſe, que tu le lois Soſie, & j’y doune ma voix, Mais ſi tu l’es, dy-moy qui tu veux que ie ſois;	Je ne saurais nier aux prévues qu'on m'expose, que tu le lois Sosie, et j'y doune ma voix, Mais si tu l'es, dis-moi qui tu veux que sans sois;
Car encor faut-il bien que je ſois quelque choſe.	Car encor faut-il bien que je sois quelque chose.
MERCVRE.	MERCURE.
Quand ie ne ſeray plus Soſie, Sois-le, j’en demeute d’accord, Mais tant que je le ſuis ie te garautis mort, Si tu prens cette fantaiſie.	Quand ici ne serai plus Sosie, Sois-le, j'en demute d'accord, Mais tant que je le suis ie te garautis mort, Si tu prends cette fantaisie.
SOSIE.	SOSIE.
Tout cét embarras met mon Eſprit ſur les dents;	Tout cet embarras met mon Esprit sur les dents;
Et la raiſon à ce qu’on void s’oppoſe.	Et la raison à ce qu'on voit s'oppose.
Mais il faut terminer enfin par quelque choſe.	Mais il faut terminer enfin par quelque chose.
Et le plus court pour moy c’eſt d’entrer la dedans.	Et le plus court pour moi c'est d'entrer la dedans,
MERCVRE.	MERCURE.
Ah!	Ah!
tu prens donc, Pendart, goût à la BaſtoTade,	tu prends donc, Pendard, goût à la BâtoTade,
OSIE.	OSIE.
Ah!	Ah!
qu’eſt-cecy Grands Dieux!	qu'est-ceci Grands Dieux!
Il frape vn ton plus fort;	Il frappe un ton plus fort;
Et mon dos pour vn mois en doit eſtre malade.	Et mon dos pour un mois en doit être malade.
Laiſſons ce Diable d’homme, & retournons au POIC.	Laissons ce Diable d'homme, et retournons au POIC.
O juſte Ciel!	Ô juste Ciel!
j’ay fait vne belle Ambaffade,	j'ai fait une belle Ambaffade,
MERCVRE.	MERCURE.
Enfin, je l’ay fait fuyr;	Enfin, je l'ai fait fuir;
& ſous ce traitement.	et sous ce traitement.
De beaucoup d’actions, il a receu la peine;	De beaucoup d'actions, il a reçu la peine;
Mais je voy rupiter, que lort erunement Reconduit l’Amoureuſe Alcmene.	Mais je vois rupiter, que lort erunement Reconduit l'Amoureuse Alcène.
SCENE III.	SCÈNE III.
21DVG IVPITER, ALCMENE, CLEANTHIS, MERCVRE.	21DUG IVPITER, ALCMENE, CLEANTHIS, MERCURE.
VPITER.	VPITER.
Effendez, chere Alemene, aux flambeaux D d’aprocher, 6 Ils m’offrent des plaiſirs, en m’offrant voſtre veüe, Mais ils pourroient iey découurir ma venue, Qu’il eſt à propos de cacher.	Effendez, chère Alémène, aux flambeaux D 'approcher, 6 Ils m'offrent des plaisirs, en m'offrant votre vue, Mais ils pourraient ici découvrir ma venue, Qu'il est à propos de cacher.
Mon amour, que geſnoient tous les ſoins éclatans, Où me tenoit lié la gloire de nos armes, Au deuoir de ma charge, a volé les inſtans, Qu’il vient de donner à vos charmes.	Mon amour, que gênaient tous les soins éclatants, Où me tenait lié la gloire de nos armes, Au devoir de ma charge, a volé les instants, Qu'il vient de donner à vos charmes.
Ce vol, qu’à vos beautez mon Cœur a conſacré, Poutroit eſtre blâmé dans la bouche publique;	Ce vol, qu'à vos beautés mon Cœur a consacré, Poutrait être blâmé dans la bouche publique;
Et j’en veux, pour témoin vnique, Celle qui peut m’en ſçauoir gté.	Et j'en veux, pour témoin unique, Celle qui peut m'en savoir gté.
ALCMENE.	ÀLCMENE.
Ie prens, Amphitryon, grande part à la gloire, Que répandent ſur vous vos illuſtres exploicts;	Je prends, Amphitryon, grande part à la gloire, Que répandent sur vous vos illustres exploits;
Et l’éclat de voſtre victoire Sçait toucher de mon cœur les ſenſibles endroits;	Et l'éclat de votre victoire Sait toucher de mon cœur les sensibles endroits;
Mais quand je voy que cét honneur fatal Eloigne de moy ce que j’ayme, Ie ne puis m’empeſcher dans ma tendreſſe ex.	Mais quand je vois que cet honneur fatal Éloigne de moi ce que j'aime, Je ne puis m'empêcher dans ma tendresse ex.
tréme, De luy vouloir vn peu de mal, Et d’oppoſer mes vœux à cét ordre ſuprême, Qui des Thebains vous fait le general.	trême, De beau vouloir un peu de mal, Et d'opposer mes vœux à cet ordre suprême, Qui des Thébains vous fait le général.
C’eſt vne douce choſe, apres vne victoire, Que la gloire, où l’on voit ce qu’on aime éleué;	C'est une douce chose, après une victoire, Que la gloire, où l'on voit ce qu'on aime élevé;
Mais parmy les perils meſlez à cette gloire, Vn triſte coup, Helas!	Mais parmi les périls mêlés à cette gloire, Un triste coup, Hélas!
eſt bien-toſt arriué:	est bientôt arrivé:
De combien de frayeurs a-t-on l’Ame bleſſée, Au moindre choc dont on entend parler?	De combien de frayeurs a-t-on l'Âme blessée, Au moindre choc dont on entend parler?
Voit-on, dans les horreurs d’vne telle penſée, Par où jamais ſe conſoler Du coup, dont on eſt menacée?	Voit-on, dans les horreurs d'une telle pensée, Par où jamais se consoler Du coup, dont on est menacée?
Et de quelque Laurier qu’on couronne vn vainqueur;	Et de quelque Laurier qu'on couronne un vainqueur;
Quelque part que l’on ait à cét honneur ſupreme, ſ cœur, Vaut-il ce qu’il en coûte aux tendreſſes d’vn Qui peut, à tout moment, trembler pour ce qu’il aime?	Quelque part que l'on ait à cet honneur suprême, s cœur, Vaut-il ce qu'il en coûte aux tendresses d'un Qui peut, à tout moment, trembler pour ce qu'il aime?
IVPITER.	IUPITER.
Ie ne voy rien en vous, dont mon feu ne s’augmente, Tout y marque à mes yeux vn cœur bien enſ amé, Et c’eſt, je vous l’auoüe vne choſe charmante, De ttouuer tant d’amour dans vn objet aimé;	Je ne vois rien en vous, dont mon feu ne s'augmente, Tout y marque à mes yeux un cœur bien ens amé, Et c'est, je vous l'auoüe une chose charmante, De touver tant d'amour dans un objet aimé;
Mais, ſi je l’oſe dire, vn ſcrupule me geſne, Aux tendres ſenti més que vous me faites voir;	Mais, si je l'ose dire, un scrupule me gêne, Aux tendres senti après que vous me faites voir;
Et pour les bien goûter, mon amour, chere Alcmene, Voudroit n’y voir entrer, rien de voſtre deuoir:	Et pour les bien goûter, mon amour, chère Alcmène, Voudrait n'y voir entrer, rien de votre devoir:
Qu’à voſtre ſeule ardeur, qu’à ma ſeule perſonne, Ie dune nes raueurs que je reçois de vous;	Qu'à votre seule ardeur, qu'à ma seule personne, Je dune nés raveurs que je reçois de vous;
Et que la qualité que j’ay de voſtre Epoux, Ne fut point ce qui me les donne.	Et que la qualité que j'ai de votre Époux, Ne fut point ce qui me les donne.
ALCMENE.	ÀLCMENE.
C’eſt de ce nom pourtant, que l’ardeur qui me brûle, Tient le droit de paroiſtre au jour, Et je ne comprens rien à ce nouueau ſcrupule, Dont s’embarraſſe voſtre amour.	C'est de ce nom pourtant, que l'ardeur qui me brûle, Tient le droit de paraître au jour, Et je ne comprends rien à ce nouveau scrupule, Dont s'embarrasse votre amour.
IPITER.	IPITER.
Ah!	Ah!
ce que j’ay pour vous d’ardeur, & de tendreſſe, Paſſe auſſi celle d’vn Epoux;	ce que j'ai pour vous d'ardeur, et de tendresse, Passe aussi celle d'un Époux;
Et vous ne ſçauez pas, dans des momens ſi doux, Quelle en eſt la delicateſſe.	Et vous ne savez pas, dans des moments si doux, Quelle en est la délicatesse.
Vous ne conceuez point qu’vn cœur bien amoureux, Sur cent petits égards s’attache auec étude;	Vous ne concevez point qu'a cœur bien amoureux, Sur cent petits égards s'attache avec étude;
Et ſe fait vne inquietude, De la maniere d’eſtre heureux.	Et se fait une inquiétude, De la manière d'être heureux.
En moy, belle, & charmante Alcmenes Vous voyez vn mary, vous voyez vn amant;	En moi, belle, et charmante Alcenes Vous voyez un mari, vous voyez un amant;
Mais l’amant ſeul me touche, à parler franchement, Et je ſens prés de vous, que le mary le geſne;	Mais l'amant seul me touche, à parler franchement, Et je sens près de vous, que le mari le gêne;
Cet Amant, de vos vœux, jaloux au dernier point, Souhaitte qu’à luy ſeul voſtre Cœur s’abandonne, Et ſa paſſion ne veut point, De ce que le mary luy donne.	Cet Amant, de vos vœux, jaloux au dernier point, Souhaite qu'à lui seul seul Cœur s'abandonne, Et sa passion ne veut point, De ce que le mar y Rome.
Il veut de pure ſource, obtenir vos ardeurs, Et ne veut rien tenir des nœuds de l’Hymenée:	Il veut de pure source, obtenir vos ardeurs, Et ne veut rien tenir des nœuds de l'Hyménée:
Rien d’vn fâcheux deuoir, qui fait agir les cœurs, Et par qui, tous les jours, des plus cheres faueurs, La douceur eſt empoiſonnée.	Rien d'un fâcheux devoir, qui fait agir les cœurs, Et par qui, tous les jours, des plus chères faveurs, La douceur est empoisonnée.
Dans le ſcrupule enfin, dont il eſt combattu, Il veut, pour ſatisfaire à ſa delicateſſe, Que touo le leparien daueute puraſeſſe;	Dans le scrupule enfin, dont il est combattu, Il veut, pour satisfaire à sa délicatesse, Que touo le parien daveute purasesse;
Que le mary ne ſoit que pour voſtre vertu, Et que de voſtre cœur, de bonté reueſtu, L’Amant ait tout l’amour & toute la tendreſſe.	Que le mari ne soit que pour votre vertu, Et que de votre cœur, de bonté revêtu, L'Amant ait tout l'amour et toute la tendresse.
ALCMENE.	ÀLCMENE.
Amphitryon, en verité, Vous vous moquez, de tenir ce langage:	Amphitryon, en vérité, Vous vous moquez, de tenir ce langage:
Et j’aurois peur qu’õ ne vous crût pas ſage, Si de quelqu’vn vous eſtiez écouté.	Et j'aurais peur qu'on ne vous crût pas sage, Si de quelqu'un vous étiez écouté.
PITER.	PITER.
Ce diſcours eſt plus raiſonnable, Alemene, que vous ne penſez:	Ce discours est plus raisonnable, Alémène, que vous ne pensez:
Mais vn plus long ſéjour me rendroit trop coupable, Et du tetour au port, les momens ſont preſſez, Adieu, de mon deuoit l’étrange Barbarie, Pour vn temps, m’arrache de vous, Mais belle Alemene, au moins, quand vous verrez l’Epous, Songez à l’Amant je vous prie.	Mais un plus long séjour me rendrait trop coupable, Et du tour au port, les moments sont pressez, Adieu, de mon devait l'étrange Barbarie, Pour un temps, m'arrache de vous, Mais belle Allemène, au moins, quand vous verrez l'Épous, Songez à l'Amant je vous prie.
ALCMENE.	ÀLCMENE.
Ie ne lepare pornt ce qu'vinent les Dieux, Et l’Epoux, & l’Amant, me ſont fort precieux.	Je ne lépare pornt ce qu'vinent les Dieux, Et l'Époux, et l'Amant, me sont fort précieux.
CLEANTHIS.	CLÉANTHIS.
O Ciel!	Ô Ciel!
que d’aimables careſſes D’vn Epoux ardement chefy !	que d'aimables caresses D'un Époux ardement chefi !
Et que mon traiſtre de mary Eſt loin de toutes ces tendreſſes!	Et que mon traître de mari Est loin de toutes ces tendresses!
MERCVRE.	MERCURE.
La Nuit, qu’il me faut auertir, N’a plus qu’à plier tous ſes voiles;	La Nuit, qu'il me faut avertir, N'a plus qu'à plier tous ses voiles;
Et pour effacer les Etoiles, Le Soleil, de ſon lit, peut maintenant ſortir:	Et pour effacer les Étoiles, Le Soleil, de son lit, peut maintenant sortir:
SCENE IV.	SCÈNE IV.
CLEANTHIS, MERCVRE.	CLEANTHIS, MERCURE.
Mercure veut s’en aller.	Mercure veut s'en aller.
CLEANTHIS.	CLÉANTHIS.
Voy?	Vois?
c’eſt ainſi que l’on me quitte?	c'est ainsi que l'on me quitte?
MERCVRE.	MERCURE.
Et comment donc?	Et comment donc?
ne veux-tu pas, Que de mon deuoir je m’acquite?	ne veux-tu pas, Que de mon devoir je m'acquite?
Et que d’Amphitryon j’aille ſuiure les pas?	Et que d'Amphitryon j'aille suivre les pas?
CLEANTHIS	CLÉANTHIS
CLEANTHIS.	CLÉANTHIS.
Mais auec cette bruſquerie, Fraiſtre, de moy te leparer.	Mais avec cette brusquerie, Fraître, de moi te léparer.
MERCVRE.	MERCURE.
Le beau ſujet de fâcherie!	Le beau sujet de fâcherie!
Nous auons tant de temps enſemble à demeurer.	Nous avons tant de temps ensemble à demeurer.
CLEANTHIS.	CLÉANTHIS.
Mais quoy!	Mais quoi!
partir ainſi d’vne façon brutale, bans me dire vn leul mot de douceut pour regale?	partir ainsi d'une façon brutale, bans me dire un leul mot de doucut pour régale?
MERCVRE.	MERCURE.
Diantre, où veux-tu que mon eſprit T’aille chercher des fariboles?	Diantre, où veux-tu que mon esprit T'aille chercher des fariboles?
gumit ans uc Marrage epunent lex paroles ;	gumit ans us Marrage épunent lex paroles ;
Et depuis vn long temps, nous nous ſommés tout dit.	Et depuis un long temps, nous nous sommès tout dit.
CLEANTHIS.	CLÉANTHIS.
Regarde, traiſtre, Amphitryon.	Regarde, traître, Amphitryon.
Voy combien pour Alcmene, il étale de flame, Et rougis la-deſſus, du peu de paſſion, Que tu témoignes pour ta femme.	Vois combien pour Alcmène, il étale de flamme, Et rougis la-dessus, du peu de passion, Que tu témoignes pour ta femme.
MERCVRE.	MERCURE.
Hé, mon Dieu, Cleanthis, ils ſont encor Amans.	Hé, mon Dieu, Cléanthis, ils sont encor Amants.
Il eſt certain âge où tout paſſe, Et ce qui leur ſied bien dans leurs cemmancemens, En nous, vieux mariez, auroit mauuaiſe grace.	Il est certain âge où tout passe, Et ce qui leur sied bien dans leurs cemmancemens, En nous, vieux mariez, aurait mauvaise grâce.
Il nuus fartort bt au voir, attathés face à face, A pouſſer les beaux ſentimens!	Il nuus fartort bt au voir, attathés face à face, A pousser les beaux sentiments!
CLEANTHIS.	CLÉANTHIS.
Quoy!	Quoi!
ſuis-je hots d’eſtat, perfide d’eſperer, Qu'vn cœur auprez de moy ſcupire.	suis-je hots d'état, perfide d'espérer, Qu'un cœur auprez de moi scupire.
MERCVRE.	MERCURE.
Non, je n’ay garde de le dire;	Non, je n'ai garde de le dire;
Mais je ſuis trop barbon, pour oſer ſoûpirer;	Mais je suis trop barbon, pour oser soupirer;
Et je lerois creuer de Ire.	Et je lerais crèver de Ire.
CLEANTHIS.	CLÉANTHIS.
Meritois-tu, pendart, cet inſigne bon-heur, De te voir, pour Epouſe, vne femme d’hont, neur?	Méritais-tu, pendard, cet insigne bonheur, De te voir, pour Épouse, une femme d'hont, neur?
MERCVRE.	MERCURE.
Mon Dieu, tu n’es que trop honneſte, Ce grand bon-heur ne me vaut rien;	Mon Dieu, tu n'es que trop honnête, Ce grand bonheur ne me vaut rien;
Ne ſois point ſi femme de bien, Et me romps vn peu moins la teſte.	Ne sois point si femme de bien, Et me romps un peu moins la tête.
CLEANTHIS.	CLÉANTHIS.
Comment!	Comment!
de trop bien viure, on te voit me blãmer ?	de trop bien vivre, on te voit me blammer ?
MERCVRE.	MERCURE.
La douceur d’vne femme eſt tout ce qui me charme, Et ta vertu fait vn vacarme, Qui ne ceſſe de m’aſſommer.	La douceur d'une femme est tout ce qui me charme, Et ta vertu fait un vacarme, Qui ne cesse de m'assommer.
CLEANTHIS.	CLÉANTHIS.
Il te faudroit de cœurs pleins de fauſſes tendreſſes, De ces femmes aux beaux & louables talens, Qui ſçauent accabler leurs maris de cateſ ſes, Pour leur faire aualer l’vſage des galans.	Il te faudrait de cœurs pleins de fausses tendresses, De ces femmes aux beaux et louables talents, Qui savent accabler leurs maris de cates ses, Pour leur faire avaler l'usage des galants.
an E l e v n de Ma foy veux-tu que je te diſe?	an E l' est né de Ma foi veux-tu que je te dise?
Vn mal d’opinon ne touche que les ſots, Et je prendrois pour ma deuiſe, Moins d’honneur, & plus de repos.	Un mal d'opinon ne touche que les sots, Et je prendrais pour ma devise, Moins d'honneur, et plus de repos.
CLEANTHIS.	CLÉANTHIS.
Comment!	Comment!
tu ſouffrirois, ſans nulle repug nance, Quua j’aymaſſe vn galant auee toute licenee.	tu souffrirais, sans nulle répug ance, Qu 'aimasse un galant auee toute lycène.
MERCVRE.	MERCURE.
Oüy, ſi je n’eſtois plus de-tes cris rebattu, Et qu’on te vit changer d’humeur & de methode.	Oui, si je n'étais plus detes cris rebattu, Et qu'on te vit changer d'humeur et de méthode.
l’ayme mieux vn vice commode, Qu’vne fatigante vertu.	l'aime mieux un vice commode, Qu'une fatigante vertu.
nuieu;	nuivu;
cſeanthis, ma chere ame, Il me faut ſuiure Amphitryon.	céanthis, ma chère âme, Il me faut suivre Amphitryon.
CLEANTHIS.	CLÉANTHIS.
Pourquoy, pour punir cét infame, Mon cœur n’a-t-il aſſez de reſolution?	Pourquoi, pour punir cet infâme, Mon cœur n'a-t-il assez de résolution?
Ah;	Ah;
que dans cette cecunon.	que dans cette cecunon.
l’enrage d’eſtre honneſte femme!	l'enrage d'être honnête femme!
Fin du premier Acte.	Fin du premier Acte.
MCIE II	MCIE II
SCENE IREMIENE.	SCÈNE IREMIENE.
2 L CMR01 M1 AMPHITRYON, SOSIE.	2 L MR01 M1 AMPHITRYON, SOSIE.
AMPHITRYON.	AMPHITRYON.
Ien-ça, bourreau, vien-ça.	Jen-ça, bourreau, viens-ça.
Sçais-tu, Maiſtre Fripon, Qu’à te faire aſſommer, ton diſcours peut ſuffire ?	Sais-tu, Maître Fripon, Qu'à te faire assommer, ton discours peut suffire ?
Et que pour te traitter comme je le deſire, Mon courroux n’att end qu’vn baſton ?	Et que pour te traiter comme je le désire, Mon courroux n'att end qu'un bâton ?
D ij	D ij
SOSIE.	SOSIE.
Si vous le prenez ſur ce ton, Monſieur, je n’ay plus rien à dire;	Si vous le prenez sur ce ton, Monsieur, je n'ai plus rien à dire;
Et vous aurez toujours raiſon.	Et vous aurez toujours raison.
AMPHITRYON.	AMPHITRYON.
Quoy!	Quoi!
tu veux me donner pour des veritez, trarrere 5 Des contes que je vois d’extrauagance outrez?	tu veux me donner pour des vérités, trarre 5 Des contes que je vois d'extravagance outrez?
SOSIE.	SOSIE.
Non je ſuis le vaſet, & vous eſtés le maiſtre;	Non je suis le vaset, et vous êtes le maître;
Il n’en ſera, Monſieur, que ce que vous vou	Il n'en sera, Monsieur, que ce que vous vou
AMPHITRYOZ.	AMPHITRYOZ.
drez.	drez.
Cà, je veux étouffer le courroux qui m’enflame, Et, tout du long, t’oüir ſur ta commiſſion.	Çà, je veux étouffer le courroux qui m'enflamme, Et, tout du long, t'oüir sur ta commission.
Il faut, auant que voïr ma femme, Que je débroüille icy cette confuſion, Rappelle tous tes ſens;	Il faut, avant que voïr ma femme, Que je débrouille ici cette confusion, Rappelle tous tes sens;
r’entre bien dans ton ame, Et répons mot pour mot, à chaque queſtion.	rentre bien dans ton âme, Et réponds mot pour mot, à chaque question.
SOSIE.	SOSIE.
Mais de peur d’incongruité, Ditez-moy, de grace, a l’auance, De quel air il vous plait que cecy ſoit traitté.	Mais de peur d'incongruité, Ditez-moi, de grâce, à l'avance, De quel air il vous plaît que ceci soit traité.
Parleray-je, Monſteur, ſelon ma conſcience;	Parlerai-je, Monsieur, selon ma conscience;
Où comme auprez des grands on le voit vſité?	Où comme auprez des grands on le voit usité?
Faut-il dire la verité;	Faut-il dire la vérité;
Où bien vſer de complaiſance?	Où bien user de complaisance?
AMPHITRYON.	AMPHITRYON.
Non, je ne te vettx oonger, Qu’à me tendre de tout vn conte fore ſincere;	Non, je ne te vettx oonger, Qu'à me tendre de tout un compte fore sincère;
OSIE.	OSIE.
Bon, c’eſt aſſez, laiſſez-moy faire:	Bon, c'est assez, laissez-moi faire:
Vous n’auez qu'a ni mnterioger.	Vous n'avez qu'a ni méntérioger.
AMPHITRYON.	AMPHITRYON.
Sur l’ordre que tantoſt, je t’auois ſçeu preſcrire?	Sur l'ordre que tantôt, je t'avais su prescrire?
SOSIE.	SOSIE.
Ie ſuis party, les Cieux, d’vn noir creſpe voilez, Peſtant fort contre vous dans ce fâcheux martyre, Et maudiſſant vingt fois l’ordre dont vous parlez.	Je suis parti, les Cieux, d'un noir crêpe voilez, Pétant fort contre vous dans ce fâcheux martyre, Et maudissant vingt fois l'ordre dont vous parlez.
AMIIIINPON.	AMIIINPON.
Comment, Coquin?	Comment, Coquin?
SOSIE.	SOSIE.
Monſieur vous n’auez rien qu’à dire.	Monsieur vous n'avez rien qu'à dire.
Ie mentiray, ſi vous voulez.	Je mentirai, si vous voulez.
AMPHITRYON.	AMPHITRYON.
Voila comme emmurcumondre pour nous du zele.	Voilà comme emmurcumondre pour nous du zèle.
Paſſons.	Passons.
Sur les chemins, que t’eſt-il arriué?	Sur les chemins, que t'est-il arrivé?
SOSIE.	SOSIE.
D’auoir frayeur mortelle, Au moindre objet que j’ay trouué.	D'avoir frayeur mortelle, Au moindre objet que j'ai trouvé.
Poltron!	Poltron!
AMPHITRYON.	AMPHITRYON.
SOSIE.	SOSIE.
En nous formant, nature a ſes caprices, Diuers penchans en nous elle fait obſeruer, Les vns à s’expoſer, trouuent mille delices:	En nous formant, nature a ses caprices, Divers penchant en nous elle fait observer, Les uns à s'exposer, trouvent mille délices:
Moy, j’en trouue à me conſeruer.	Moi, j'en trouve à me conserver.
AMPHITRYON.	AMPHITRYON.
Arriuant au logis.	Arrivant au logis.
JOSIE.	JOSIE.
I’ay deuant noſtre porte, En moy-méme voulu répeter vn petit, Sur quel ton, & de quelle ſorte, Ie ferois du combat le glorieux recit.	J'ai devant notre porte, En moi-même voulu répéter un petit, Sur quel ton, et de quelle sorte, Je ferais du combat le glorieux récit.
En ſuite?	En suite?
A MPHITRYON.	À MPHITRYON.
D iij	 Dijà
SOSIE.	SOSIE.
Onin eſt venu tibtibier, & mettre en peine.	Onin est venu tibtibier, et mettre en peine.
Et qui :	Et qui :
AMPHITRYON.	AMPHITRYON.
SOSIE.	SOSIE.
Sofie, vn moy, de vos ordres jaloux, Que vous auez du poit enuoyé vers Alcmene, Le qur de vos iecreis à condloiſſance pleine, Comme le moy qui parle à vous.	Sofie, un moi, de vos ordres jaloux, Que vous avez du poit envoyé vers Alcene, Le qur de vos iecreis à condloissance pleine, Comme le moi qui parle à vous.
AMPHIIRYON.	AMPHIIRYON.
Quels contes !	Quels contes !
SOSIE.	SOSIE.
Non, Monſieur, c’eſt la verité pure.	Non, Monsieur, c'est la vérité pure.
Celmoy, pruiule que moymeſt au logis trouué?	Celmoi, pruivle que moymest au logis trouvé?
Et j’eſtois venu, ie vous jure, Auant que ie fuſſe arriué.	Et j'étais venu, je vous jure, Avant que tu fusse arrivé.
AMPHITRYON.	AMPHITRYON.
D’où peut proceder, je te prie, Ce galimatias maudrt?	D'où peut procéder, je te prie, Ce galimatias maudrt?
Eſt-ce ſonge?	Est-ce songe?
eſt-ce yvrognerie?	est-ce yvrognerie?
Alienation d’eſprit?	Alienation d'esprit?
Ou mechante plaiſanterie?	Ou méchante plaisanterie?
SOSIE.	SOSIE.
Non, c’eſt la choſe comme elle eſt, Et point du tout conte friuole.	Non, c'est la chose comme elle est, Et point du tout compte frivole.
Ie ſuis homme d’honneur, j’en donne ma parole, Et vous m’en croirez, s’il vous plait, Ie vous dy que croyant n’eſtre qu’vn ſeul Sofie, Ie me ſuis trouué deux chez nous, Et que de ces deux moy piquez de jalouſie, L’vn eſt à la maiſon, & l’autre eſt auec vous.	Je suis homme d'honneur, j'en donne ma parole, Et vous m'en croirez, s'il vous plaît, Je vous dis que croyant n'être qu'un seul Sofie, Je me suis trouvé deux chez nous, Et que de ces deux moi piquez de jalousie, L'un est à la maison, et l'autre est avec vous.
Que le moy quę voity, charge de famtude, A trouué l’autre moy, frais, gaillard & diſpos, Et n’ayant d’autre inquietude, Que de batue, a canes desos.	Que le moi quę voiti, charge de famude, A trouvé l'autre moi, frais, gaillard et dispos, Et n'ayant d'autre inquiétude, Que de batue, à canes desos.
AMPHITRYON.	AMPHITRYON.
Il faut eſtre, je le confeſſe, D’vn eſprit bien poſé, bien tranquille, & bien dous, Pour ſouffrit qu’vn valet, de chanſons me repaiſſe.	Il faut être, je le confesse, D'un esprit bien posé, bien tranquille, et bien dous, Pour souffrit qu'un valet, de chansons me repaisse.
SOSIE.	SOSIE.
Si vous vous mettez en courroux, Plus de conferentce entre nous;	Si vous vous mettez en courroux, Plus de conférentce entre nous;
Vous ſçauez que d’abord tout ceſſe	Vous savez que d'abord tout cesse
AMPHITRYON.	AMPHITRYON.
Non, ſans emportement, je te veux écouter.	Non, sans emportement, je te veux écouter.
le Pay pronto,urare duay euboune coutience, Au myſtere nouueau que tu me viens conter;	le Pai prompo,urare duai euboune coutience, Au mystère nouveau que tu me viens conter;
Eſt-il quelque ombre d’apparence.	Est-il quelque ombre d'apparence.
OSIE.	OSIE.
Non;	Non;
vous auez raiſon, & la choſe à chacun, Hors de creance doit paroiſtre, C’eſt vn fait à n’y rien cunhornis, Vn conte extrauagant, ridicule, importun, Cela choque le ſens commun:	Vous avez raison, et la chose à chacun, Hors de créance doit paraître, C'est un fait à n'y rien cunhornis, Vn conte extravagant, ridicule, importun, Cela choque le sens commun:
Mais cela ne iaiſſe pas d’eſtre.	Mais cela ne jaisse pas d'être.
AMPHITRYON.	AMPHITRYON.
Le moyen d’en rien croire, à moins qu’eſtre inſenſé?	Le moyen d'en rien croire, à moins qu'être insensé?
SOSIE.	SOSIE.
I me,	I me,
Ie ne l’ay pas crû moy, ſans vne peine extreIe me ſuis, d’eſtre deux, ſenty l’eſprit Bleſſé.	Je ne l'ai pas cru moi, sans une peine extrémIe me suis, d'être deux, senti l'esprit Blessé.
Et long-temps d’impoſteur, j’ay traitté cé moy méme, Mais à me reconnoiſtre, enfin il m’a forcé:	Et longtemps d'imposteur, j'ai traité cé moi -même, Mais à me reconnaître, enfin il m'a forcé:
l’ay veu que c’eſtoit moy, lans aucun u tratagéme, Der piez juſqu’à la teſte, il eſt comme moy fait;	l'ai vu que c'était moi, lans aucun u tratagème, Der pieds jusqu'à la tête, il est comme moi fait;
Beau, l’air noble, bien pris, les manieres charmantes :	Beau, l'air noble, bien pris, les manières charmantes :
Enfin deux gouttes de lait Ne ſont pas plus reſſemblantes;	Enfin deux gouttes de lait Ne sont pas plus ressemblantes;
Et n’eſtoit que ſes mains ſont vn peu trop pefante 5 I’en ſerois fort ſatisfait.	Et n'était que ses mains sont un peu trop pesante 5 J'en serais fort satisfait.
AMPHITRYON.	AMPHITRYON.
A quelle patſence Il raut que ie m'exhorte!	À quelle patsence Il raut que sans m'exhorte!
Mais enfin, n’és-tu pas entré dans la maiſon?	Mais enfin, n'avez-tu pas entré dans la maison?
OSIE.	OSIE.
Bon, entré!	Bon, entré!
Hé de quelle ſorte?	Hé de quelle sorte?
Ay-ie voulu jamais entendre de raiſon?	Ai-je voulu jamais entendre de raison?
La lle nie luis je pas Mterun nonte porte ?	La lèle nie luis -je pas Mtérun nonte porte ?
AMPHITRYON.	AMPHITRYON.
Comment donc?	Comment donc?
SOSIE.	SOSIE.
Auec vn baſton, Dont men totent encor vne douleur tres forte.	Avec un bâton, Dont men totent encor un douleur très forte.
1	1
2 AMETATIRTON.	2 AMETATIRTON.
On t’a battu !	On t'a battu !
SOSIE.	SOSIE.
Vrayment!	Vraiment!
AMPHITRYON.	AMPHITRYON.
Et qui!	Et qui!
SOSIE.	SOSIE.
Moy.	Moi.
AMPHIIRYOR.	AMPHIIRYOR.
Toy te battre!	Toi te battre!
SOSIE.	SOSIE.
Ouy moy;	Oui moi;
non pas le moy d’icy.	non pas le moi d'ici.
Mais le moy du Logis, qui frape comme quatre.	Mais le moi du Logis, qui frappe comme quatre.
AMPHITRYON.	AMPHITRYON.
Te confonde le Ciel de me parler ainſi l	Te confonde le Ciel de me parler ainsi l
OSIE.	OSIE.
Ce ne ſont point de badi nages;	Ce ne sont point de badi nages;
Le moy que j’ay trouue tantoſt, Sur le moy qui vous parle, a des grands auantages :	Le moi que j'ai trouve tantôt, Sur le moi qui vous parle, a des grands avantages :
Il a le bras fort, le cœur haut;	Il a le bras fort, le cœur haut;
I’en ay receu des témoignages:	J'en ai reçu des témoignages:
Et te Drauie de moy ma luné comme il faut, C’eſt vn drole qui fait des rages.	Et te Dravie de moi ma luné comme il faut, C'est un drôle qui fait des rages.
AMPAIIRYON.	AMPAIIRYON.
Acheuons, as-tu veu ma femme.	Achevons, as-tu vu ma femme.
SOSIE.	SOSIE.
Non.	Non.
AMPHITRYON.	AMPHITRYON.
Toutquoy :	Toutquoy :
SOSIE.	SOSIE.
Par vne raiſon aſſez forte.	Par une raison assez forte.
AMPHITRYON.	AMPHITRYON.
Qui t’a fait y manquer, Maraut, expliquetoy?	Qui t'a fait y manquer, Maraud, expliquoi?
SOSIE.	SOSIE.
Faut-il le repeter vingt-fois de meſme ſorte!	Faut-il le répéter vingt-fois de même sorte!
Moy, vous dy-je, ce moy plus robuſte que moy;	Moi, vous dis-je, ce moi plus robuste que moi;
Ce moy, qui s’eſt de force emparé de la porte.	Ce moi, qui s'est de force emparé de la porte.
Ce moy, qui m’a fait filer doux:	Ce moi, qui m'a fait filer doux:
Ce moy, qui le ſeul moy veut eſtre:	Ce moi, qui le seul moi veut être:
Ce moy, de moy meſme jaloux:	Ce moi, de moi -même jaloux:
De mey tairrant, dont le coulloux, Au moy poltron s’eſt fait connoiſtre:	De me tairrant, dont le coulloux, Au moi poltron s'est fait connaître:
Enfin ce Moy qui ſuis chez nous:	Enfin ce Moi qui suis chez nous:
Ce moy, qui s’eſt montré mon Maiſtre;	Ce moi, qui s'est montré mon Maître;
Ce moy qui m’a roüé de coups.	Ce moi qui m'a roüé de coups.
AMPHITRYON.	AMPHITRYON.
Il faut que ce matin, à force de trop boire, Il ſe ſoit troublé le Cerueau.	Il faut que ce matin, à force de trop boire, Il se soit troublé le Cerveau.
SOSIE.	SOSIE.
Ie veux eſtre pendu, ſi j’ay bu que de l’eau:	Je veux être pendu, si j'ai bu que de l'eau:
A mon ſerment on m'en peut croire,	À mon serment on m'en peut croire,
AMPHITRYON.	AMPHITRYON.
Il faut donc qu’au ſommeil tes ſens ſe ſoient portez!	Il faut donc qu'au sommeil tes sens se soient portés!
Et qu’vn ſonge fâcheux, dans ſes confus myſteres, I ait rait voir toutes les chimeres Dont tu me fais des veritez.	Et qu'autre songe fâcheux, dans ses confus mystères, I ait rait voir toutes les chimères Dont tu me fais des vérités.
SOSIE.	SOSIE.
Tout auſſi peu je n’ay point ſommeillé Et n’en ay meſme aucune enuie.	Tout aussi peu je n'ai point sommeillé Et n'en ai même aucune envie.
Ie vous parle bien éueillé;	Je vous parle bien éveillé;
l eitois blen cucille ce natin lur Ma vie.	 litais blen cucille ce natin lur Ma vie.
Et bien éueillé meſme eſtoit l’autre Soſie Quand il m’a ſi bien etrillé.	Et bien éveillé même était l'autre Sosie Quand il m'a si bien étrillé.
AMPHITRYON.	AMPHITRYON.
cuj-moy, je t’impoſe filence, C’eſt trop me fatiguer l’eſprit.	cuj-moi, je t'impose silence, C'est trop me fatiguer l'esprit.
Et je ſuis vn vray fou, d’auoir la patience, D’écouter d’vn valet, les ſottiſes qu’il dit.	Et je suis un vrai fou, d'avoir la patience, D'écouter d'un valet, les sottises qu'il dit.
SOSIE.	SOSIE.
Tous ſes diſcours ſont de ſottiſes, Partant d’vn Homme ſans éclat:	Tous ses discours sont de sottises, Partant d'un Homme sans éclat:
Ce ſeroit paroles exquiſes Si c’eſtoit vn grand qui parlât.	Ce serait paroles exquises Si c'était un grand qui parlât.
AMPHITRYON.	AMPHITRYON.
Entrons ſans d’auantage attendre.	Entrons sans d'avantage attendre.
Mais Alcmene paroît auec tous ſes appas:	Mais Alcène paraît avec tous ses appas:
En ce moment, ſans doute elle ne m’attend pas.	En ce moment, sans doute elle ne m'attend pas.
Et mon abord la va ſurprendre.	Et mon abord la va surprendre.
SCENE II.	SCÈNE II.
ALCMENE, CLEANTHIS, AMPTIIIRTON, JOJIE.	ÀLCMENE, CLEANTHIS, AMPTIIRTON, JOJIE.
ALCMENE.	ÀLCMENE.
Llons pour mon Epoux Cleanthis, vers A les Dieux.	Llons pour mon Époux Cléanthis, vers A les Dieux.
Nous acquiter de nos hommages, Et les remercier des ſuccez glorieux, Dont Thebes, par lon bras, goute les auantages.	Nous acquitter de nos hommages, Et les remercier des succès glorieux, Dont Thebes, par lon bras, goute les avantages.
O Dieux!	Ô Dieux!
AMPHITRYON.	AMPHITRYON.
Faſſe le Ciel qu’Amphitryon vainqueur Auec plaiſir ſoit reueu de ſa femme;	Fasse le Ciel qu'Amphitryon vainqueur Avec plaisir soit revu de sa femme;
Et que ce lout fauorable a ma ſlame Vous redonne à mes yeux, auec le meſme cœur, Que j’y retrouue autant d’ardedr, Que vous en rapporte mon Ame.	Et que ce lout favorable a ma slâme Vous redonne à mes yeux, avec le même cœur, Que j'y retrouve autant d'ardedr, Que vous en rapporte mon Âme.
A LCMENE.	À LCMENE.
Quoy!	Quoi!
de retour ſi-toſt!	de retour sitôt!
AMPHITRYON.	AMPHITRYON.
Certes, c’eſt en ce jour, Me donner de vos feux vn mauuais témoig nage, Et ce, Quoy ſi-toſt de retour, En ces oecaſions n’eſt guere le langage D’vn cœur bien enflamé d’amour.	Certes, c'est en ce jour, Me donner de vos feux un mauvais témoig nage, Et ce, Quoi sitôt de retour, En ces oecasions n'est guère le langage D'un cœur bien enflammé d'amour.
l’oſois me flater en moy-méme, Que loin de vous j’aurois trop demeuré L’attente d’un retour ardemment deſité, Donne à tous les inſtans vne longueur extréEt l’abſence de ce qu’on ayme, Ime, Quelque peu qu’elle dure, a toûjours trop duré.	l'osais me flatter en moi-même, Que loin de vous j'aurais trop demeuré L'attente d'un retour ardemment désité, Donne à tous les instants quelque longueur extréEt l'absence de ce qu'on aime, Ime, Quelque peu qu'elle dure, a toujours trop duré.
Ie ne voy.	Je ne vois.
ALCMENE.	ÀLCMENE.
AMPHITRION.	AMPHITRYON.
Non Alcmene à ſon impatience On meſure le temps en de pareils états, Et vous contés les momens de l’abſence, En perſonne qui n’ayme pas.	Non Alcène à son impatience On mesure le temps en de pareils états, Et vous contez les moments de l'absence, En personne qui n'aime pas.
Lors que l’on ayme comme il faut, Le moindre éloignement nous tue, Et ce dont on cherit la veue, Ne reuient jamais aſſez-toſt.	Lors que l'on aime comme il faut, Le moindre éloignement nous tue, Et ce dont on chérit la vue, Ne revient jamais assez-tôt.
De voſtre accueil, je le confeſſe, Se plaint icy mon amoureuſe ardeur;	De votre accueil, je le confesse, Se plaint ici mon amoureuse ardeur;
Et j’attendois de voſtre Cœur, D’autres tranſports de joye & de tendreſſe.	Et j'attendais de votre Cœur, D'autres transports de joie et de tendresse.
ALCMENE.	ÀLCMENE.
I’ay peine à comprendre ſur quoy Vous fondez les diſcours que je vous entends faire;	J'ai peine à comprendre sur quoi Vous fondez les discours que je vous entends faire;
Et ſi vous vous plaignez de moy, Ie ne ſçay pas de bonne foy Ce qu’il faut pour vous ſatisfaire.	Et si vous vous plaignez de moi, Je ne sais pas de bonne foi Ce qu'il faut pour vous satisfaire.
Hier au ſoir, ce me ſemble, à voſtre heureux Tetout , On me vit témoigner vne joye aſſez teudre, Et rendre aux ſoins de voſtre amour, Tout ce que de mon Cœur vous auiez lieu d’attendre.	Hier au soir, ce me semble, à votre heureux Tetout , On me vit témoigner une joie assez teudre, Et rendre aux soins de votre amour, Tout ce que de mon Cœur vous aviez lieu d'attendre.
Comment!	Comment!
AMPHITRION.	AMPHITRYON.
ALCMENE.	ÀLCMENE.
ALCMENE.	ÀLCMENE.
Ne fis-je pas éclater à vos yeux 39 Les ſoudains mouuemens d’vne entiere allegreſſe?	Ne fis-je pas éclater à vos yeux 39 Les soudains mouvements d'une entière allégresse?
Et le tranſport d’vn Cœur peut-il s’expliquer mieux, Au tetour d’vn Epoux qu’on ayme auec ten22 AHIIRRON.	Et le transport d'un Cœur peut-il s'expliquer mieux, Au tetour d'un Époux qu'on aime te ten22 AHIRRON.
Idreſſe!	Idresse!
ALCMENE.	ÀLCMENE.
Que meſme voſtre amour Montra de mon accueil vne joye incroyable:	Que même votre amour Montra de mon accueil une joie incroyable:
Et que m'ayant quittée à la pointe du jour;	Et que m'ayant quittée à la pointe du jour;
Ie ne voy pas qu’à ce ſoudain retour Ma ſurpriſe ſoit ſi coupable.	Je ne vois pas qu'à ce soudain retour Ma surprise soit si coupable.
AMPHITRYON.	AMPHITRYON.
Eſt-ce que du retour, que j’ay precipité, Vn ſonge cette nuict, Alcmene, dans voſtre ame, A preue nu la verité.	Est-ce que du retour, que j'ai précipité, Un songe cette nuit, Alcène, dans votre âme, A preuve nu la vérité.
Et que m'ayant peuuente en dormant bien traité, Voſtre cœur ſe croit vers ma flame, Aſſez amplement acquité.	Et que m'ayant peuvente en dormant bien traité, Votre cœur se croit vers ma flamme, Assez amplement acquité.
ALCMENE.	ÀLCMENE.
Eſt-ce qu’vne vapeur, par la malignité, Amphitryon, a dans voſtte ame, Du retour d’hyer au ſoir, broüillé la verité!	Est-ce qu'une vapeur, par la malignité, Amphitryon, a dans vostte âme, Du retour d'hier au soir, brillé la vérité!
Et que du doux accueil duquel ie m’acquitay, venrt.	Et que du doux accueil duquel Seigneur m'acquitai, venrt.
eum pretend a ma hame;	eum prétend à ma hame;
Rauir toute l’honneſteté!	Ravir toute l'honnêteté!
AMPHITRYON.	AMPHITRYON.
Cette vapeur dont vous me regalez Eſt vn peu, ce me ſemble, eſtrange.	Cette vapeur dont vous me régalez Est un peu, ce me semble, étrange.
A LCMENE.	À LCMENE.
C’eſt ce qu’on peut donner pour change, Ela roige dane vous me pallce.	C'est ce qu'on peut donner pour change, Éla roige dane vous me pallce.
A MPHITRYON.	À MPHITRYON.
A moins d’vn ſonge on ne peut pas ſans doute, Exculer ce qu’icy, voſtre bouche me dit.	À moins d'un songe on ne peut pas sans doute, Exculer ce qu'ici, votre bouche me dit.
ALCMENE.	ÀLCMENE.
A moins d’vne vapeur qui vous trouble l’Eſprit, On ne peut pas fauuer, et que de vous j’écoute.	À moins d'une vapeur qui vous trouble l'Esprit, On ne peut pas sauver, et que de vous j'écoute.
AMPHITRTON.	AMPHITRTON.
Laiſſons vn peu cette vapeur Alcmene.	Laissons un peu cette vapeur Alcène.
ALCMENE.	ÀLCMENE.
Laiſſons vn peu ce ſonge, Amphitryon.	Laissons un peu ce songe, Amphitryon.
AMPHITRYON.	AMPHITRYON.
Sur le ſujet dont eſt queſtion, Il n’eſt guere de jeu que trop loin on ne meine.	Sur le sujet dont est question, Il n'est guère de jeu que trop loin on ne mène.
ALCMENE.	ÀLCMENE.
Sans doute;	Sans doute;
& pour marque certaine Ie commence à ſentir vn peu d’émotion.	et pour marque certaine Je commence à sentir un peu d'émotion.
AMPHITRYON.	AMPHITRYON.
Eſt-ce donc que parlà, vous voulez eſſayer, al teparer l'aceuen dont je vous ay rart plainte.	Est-ce donc que parlà, vous voulez essayer, al teparer l'acven dont je vous ai rart plainte.
A LCMENE.	À LCMENE.
Eſt-ce donc que par cette feinte Vous deſirez vous égayer!	Est-ce donc que par cette feinte Vous désirez -vous égayer!
A MPHITRYON.	À MPHITRYON.
entiade grace, cenons, aaremeney je tous prie;	entiade grâce, cenons, aaremeni je tous prie;
Et parlons ſerieuſement.	Et parlons sérieusement.
A LCMENE.	À LCMENE.
Amphitryon c’eſt trop pouſſer l’amuſement;	Amphitryon c'est trop pousser l'amusement;
Finiſſons cette raillerie.	Finissons cette raillerie.
AMPHITRYON.	AMPHITRYON.
Quoy!	Quoi!
vous olez me foutenir en race, Que plutoſt qu’à cette heure on m’ait icy pû voir ?	vous olez me soutenir en race, Que plutôt qu'à cette heure on m'ait ici pu voir ?
ALCMENE.	ÀLCMENE.
Quoy !	Quoi !
vous voulez nier auec audace, Qué des hyer, en ces Ileux vous vintez vers le A MPHITRYON.	vous voulez nier avec audace, Qué des hier, en ces Ileux vous vintez vers le A PHITRYON.
Iſoir?	Isoir?
Moy, je vins hyer?	Moi, je vins hier?
A LCMENE.	À LCMENE.
ounmuoute ne den deuunt rirdrorc, Vous vous en eſtez retourne.	ounmute ne den dévunt rirdrorc, Vous vous en estez retourne.
AMPHITRYON.	AMPHITRYON.
Ciel!	Ciel!
vn pareil débat, s’eſt-il pû voir encorel Et qui, de tout cecy, ne ſeroit étonné Soſie?	un pareil débat, s'est-il pu voir encorel Et qui, de tout ceci, ne serait étonné Sosie?
SOSIE.	SOSIE.
Elle a beſoin de ſix grains d’Elebore, Monſieur, ſon Eſprit eſt tourné!	Elle a besoin de six grains d'Élébore, Monsieur, son Esprit est tourné!
AMPHITRYON.	AMPHITRYON.
Alcmene au nom de tous les Dieux, Ce diſcours a d’étranges ſuites, Reprenez vos ſens vn peu mieux;	Alcène au nom de tous les Dieux, Ce discours à d'étranges suites, Reprenez vos sens un peu mieux;
Et penſez à ce que vous dites.	Et pensez à ce que vous dites.
ALCMENE.	ÀLCMENE.
I’y penſe meurement auſſi, Et tous ceux du logis ont veu voſtre arriuée.	J'y pense meurement aussi, Et tous ceux du logis ont vu votre arrivée.
I’ignore quel motif vous fait agir ainſi :	J'ignore quel motif vous fait agir ainsi :
Mais ſi la choſe auoit beſoin d’eſtre prouuée;	Mais si la chose avait besoin d'être prouvée;
S’il eſloit vray qu’on peut ne s’en ſouuenir pas;	S'il esloit vrai qu'on peut ne s'en souvenir pas;
De qui puis je tenir, que de vous la nouuelle, Du dernier de tous vos combats ?	De qui puis je tenir, que de vous la nouvelle, Du dernier de tous vos combats ?
nt les cinq dfamans que portoit Pterelas, Qu’a fait, dans la nuict eternel le, Tomber l’effort de voſtre Bras !	nt les cinq dfamants que portait Prelas, Qu'a fait, dans la nuit éternel le, Tomber l'effort de votre Bras !
En pourroit-on vouloir vn plus ſeur témoignage !	En pourrait-on vouloir un plus sûr témoignage !
AMPHITRYON.	AMPHITRYON.
Quoy!	Quoi!
je vous ay déja donné	je vous ai déjà donné
E ij Le nœud des diamans que j’eux pour mon partage, Lt que je vous ay deſtine.	E ij Le nœud des diamants que j'eux pour mon partage, Lt que je vous ai destine.
ALCMENE.	ÀLCMENE.
Aſſurément.	Assurément.
Il n’eſt pas diffieile De vous en bien conuaincre.	Il n'est pas diffieile De vous en bien convaincre.
SOSIE.	SOSIE.
Elle ſe moque, & je le tiens icy;	Elle se moque, et je le tiens ici;
honneur s ia femte ent fnutile,	honneur s' a femte ent fnutile,
AMPHITRYON.	AMPHITRYON.
Le Cachet eſt entier.	Le Cachet est entier.
ALC MBI HI Eſt-ce vn e viſion?	ÀLC MBI HI Est-ce un vision?
Tenez, trouueren vous cette pieuue aſſez forte.	Tenez, trouveren vous cette pieuve assez forte.
AMPHITRYON.	AMPHITRYON.
Ah Ciel!	Ah Ciel!
ô juſte Ciel !	ô juste Ciel !
ALCMENE.	ÀLCMENE.
Allez Amphitryon, Vous vous moquez d’en vſer de la ſorte;	Allez Amphitryon, Vous vous moquez d'en user de la sorte;
Et vous en devriez auoir confuſion.	Et vous en devriez avoir confusion.
AMPHITRYON.	AMPHITRYON.
Romps vite ce Cachet.	Romps vite ce Cachet.
Ayant ouuert le Coffret.	Ayant ouvert le Coffret.
SOSIE.	SOSIE.
Ma foy la place eſt vuide, Il faut que par magie on ait ſçeu le tirer :	Ma foi la place est vid, Il faut que par magie on ait su le tirer :
Ou bien que de layememme, nl fort venu ſans guide, Vers celle qu’il a ſçeu qu’on en vouloit parer.	Ou bien que de layememme, nl fort venu sans guide, Vers celle qu'il a su qu'on en voulait parer.
AMPHITRYON.	AMPHITRYON.
O Dieux, dont le pouuoir ſur les choſes preſide, Quelle eſt cette auanture!	Ô Dieux, dont le pouvoir sur les choses preside, Quelle est cette aventure!
& qu’en puis-je augurer, Dont mon amour ne s’intimide!	et qu'en puis-je augurer, Dont mon amour ne s'intimide!
SOSIE.	SOSIE.
Si ſa bouche dit vray nous auons meſme ſort;	Si sa bouche dit vrai nous avons même sort;
Et de meime que moy, Monſieur, vous eſtes double,	Et de meime que moi, Monsieur, vous êtes double,
AMPATTAYON.	AMPATTAYON.
Tais-toy.	Tais-toi.
A LCMENE:	À LCMENE:
Surquoy vous étonner ſi fort?	Surquoy vous étonner si fort?
Et d’où peut naiſtre ce grand trouble!	Et d'où peut naître ce grand trouble!
AMPHITRYON.	AMPHITRYON.
O Ciel!	Ô Ciel!
quel étrange embarras !	quel étrange embarras !
Ie voy des incidens qui paſſent la nature, Et mon honneur redoute vne auanture, Que mon Eſprit ne comprend pas !	Je vois des incidents qui passent la nature, Et mon honneur redoute une aventure, Que mon Esprit ne comprend pas !
ALCMENE.	ÀLCMENE.
Songez vous en tenant cette preuue ſenſible Aine Mer encor voltreretour prene.	Songez -vous en tenant cette preuve sensible Aine Mer encor voltreretour prène.
AMPHITRYON.	AMPHITRYON.
Non;	Non;
mais à ce retour, daignez s’il eſt poſſiMe conter ce qui s’eſt paſſé.	mais à ce retour, daignez s'il est possiMe conter ce qui s'est passé.
ble,	blé,
ALCMENE.	ÀLCMENE.
Puiſque vous demandez vn recit de la choſe.	Puisque vous demandez un récit de la chose.
Dua voulel die uout que ce neroit pas vous ?	Dua voule die out que ce nérait pas vous ?
AMPHITRYON.	AMPHITRYON.
Pardonnez-moy, mais j’ay certaine cauſe Qui me fait demander ce recit entre nous.	Pardonnez-moi, mais j'ai certaine cause Qui me fait demander ce récit entre nous.
ALCMENE.	ÀLCMENE.
Les ſoucis importuns qui nous peuuent ſaiſir	Les soucis importuns qui nous peuvent saisir
Vous ont ils rart ir rinte en perure la memoire?	Vous ont ils rart ir rinte en pure la mémoire?
AMPHITRYON.	AMPHITRYON.
Peut-eſtre;	Peut-être;
mais enfin, vous me ferez plaiſir Dem en dire toute l’Hiſtoire.	mais enfin, vous me ferez plaisir Dem en dire toute l'Histoire.
ALCMENE.	ÀLCMENE.
L’Hiſtoire n’eſt pas longue.	L'Histoire n'est pas longue.
A vous ie m’auanY3 Pleine d’vne aimable ſurpriſe:	À vous ie m'avanY3 Pleine d'une aimable surprise:
renutement je vous embrallay ;	renutement je vous embrallai ;
Et témoignay ma joye à plus d’vne repriſe.	Et témoignai ma joie à plus d'une reprise.
AMPHITRYON, en ſoy même.	AMPHITRYON, en soi -même.
Ah!	Ah!
d’vn ſi doux accueil je me ſerois paſſé.	d'un si doux accueil je me serais passé.
ALCMENE.	ÀLCMENE.
Vous me fiſtes d’abord ce preſent d’importance, Que du butin conquis vous m’auiez deſtiné, Voſtre cœur auec vehemence, M’étala de ſes feux toute la violence, Et les ſoius importuns qui l’auoient enchaiſné;	Vous me fîtes d'abord ce présent d'importance, Que du butin conquis vous m'aviez destiné, Votre cœur avec véhémence, M'étala de ses feux toute la violence, Et les soius importuns qui l'avaient enchaîné;
L’aiſe de me reuoir, les tourmens de l’abſence, Pout le luey, que ioilipatience, Pour le retour s’eſtoit donné.	L'aie de me revoir, les tourments de l'absence, Pout le luei, que joilipatience, Pour le retour s'était donné.
Lt jamais voſtre amour en pareille occurrence, Ne me parut ſi tendre, & ſi paſſion né.	Lt jamais votre amour en pareille occurrence, Ne me parut si tendre, et si passion né.
AMPHITRYON.	AMPHITRYON.
en ſoy même.	en soi -même.
Peut-on plus viuement ſe voit aſſaſſiné.	Peut-on plus vivement se voit assassiné.
ALCMENE.	ÀLCMENE.
Tous ces franſports, toute cette tendre ſſe, Cõme vourcroyez bien ne me déplaiſoient pas:	Tous ces fransports, toute cette tendre sse, Comme vourroyez bien ne me déplaisaient pas:
Et s’il faut que je le confeſſe, Mon cœur, Amphitryon, y trouuoit mille ap pas.	Et s'il faut que je le confesse, Mon cœur, Amphitryon, y trouvait mille ap pas.
AMPHITRYON.	AMPHITRYON.
En ſuite s’il vous plaît.	En suite s'il vous plaît.
ALCMENE.	ÀLCMENE.
Nous nous entrecoupâmes De mille queſtions, qui pouuoient nous toucher On ſeruit teſte à teſte, enſemble nous ſoupâiije 3 Et le ſoupé ſiny, nous nous fûmes coucher.	Nous nous entrecoupâmes De mille questions, qui pouvaient nous toucher On servit tête à tête, ensemble nous soupâiije 3 Et le soupé siny, nous nous fûmes coucher.
ei ll enie Nro iv.	ei ll enie Nro yu.
Enſemble!	Ensemble!
ALCMENE.	ÀLCMENE.
Aſſurément, qu’elle eſt cette demande?	Assurément, qu'elle est cette demande?
AMPHITRYON.	AMPHITRYON.
Ah!	Ah!
c’eſt icy le coup le plus cruel de tous!	c'est ici le coup le plus cruel de tous!
Et dont à s’aſſûrer, trembloit mon feu jalous!	Et dont à s'assure, tremblait mon feu jalous!
ALCMENE.	ÀLCMENE.
D'ou vous vient à ce mot vne rougeur igrande ?	D'ou vous vient à ce mot une rougeur ygrande ?
Ay-je fait quelque mal, de coucher auec vous?	Ai-je fait quelque mal, de coucher avec vous?
AMPHITRYON.	AMPHITRYON.
Non, ce n’eſtoit pas moy, pour ma douleur ſenncler.	Non, ce n'était pas moi, pour ma douleur senncler.
Et qui dit qu’hyer icy mes pas ſe ſont portez, Dit de toutes les raunetez, La fauſſeté la plus horrible.	Et qui dit qu'hier ici mes pas se sont portés, Dit de toutes les raunetés, La fausseté la plus horrible.
Amphitryon.	Amphitryon.
ALCMENE.	ÀLCMENE.
AMPHITRYON.	AMPHITRYON.
Perfide!	Perfide!
ALCMENE.	ÀLCMENE.
Ah!	Ah!
quel emportement!	quel emportement!
AMPHITRION.	AMPHITRYON.
Non, non, plus de douceur, & plus defference, Cereuers vient à bout de toute ma conſtance, Et mon cœur ne reſpire en ce fatal moment,	Non, non, plus de douceur, et plus déférence, Cereuers vient à bout de toute ma constance, Et mon cœur ne respire en ce fatal moment,
ALCMENE.	ÀLCMENE.
De qui donc vous venger?	De qui donc vous venger?
Et quel manque de foy, Vous fait icy me traiter de coupable?	Et quel manque de foi, Vous fait ici me traiter de coupable?
AMPHITRYON.	AMPHITRYON.
Ie ne ſçay pas;	Je ne sais pas;
mais ce n’viten pas moy;	mais ce n'éviten pas moi;
Et c’eſt vn deſeſpoir qui de tout rend capable.	Et c'est un désespoir qui de tout rend capable.
ALCMENE.	ÀLCMENE.
Allez indigne Epoux, le fait parle de ſoy;	Allez indigne Époux, le fait parle de soi;
Et l’impoſture eſt effroyable;	Et l'imposture est effroyable;
C’eſt trop me pouſſer la deſſus;	C'est trop me pousser la dessus;
Et d’infidelité me voir trop condamnée.	Et d'infidélité me voir trop condamnée.
Si vous cherchez dans ces tranſports conſus, Vn pretexte à briſer les nœuds d’vn Hymenée, Qui me tient à vous enchaiſnée;	Si vous cherchez dans ces transports consus, Un prétexte à briser les nœuds d' Hyménée, Qui me tient à vous enchaînée;
Tous ces détours ſont ſuperflus:	Tous ces détours sont superflus:
Et me voila déterminée, A ſouffrir qu’en ce jour nos liens ſoient rompus.	Et me voilà déterminée, A souffrir qu'en ce jour nos liens soient rompus.
AMPHITRION.	AMPHITRYON.
Apres l’indigne affront que l’on me fait connoiſtre, C’eſt bien à quoy ſans doute il faut vous preparer.	Après l'indigne affront que l'on me fait connaître, C'est bien à quoi sans doute il faut vous préparer.
C’eſt le moins qu’on doit voir, & les choſes peut-eſtre, Pourront n’en pas là demeurer.	C'est le moins qu'on doit voir, et les choses peut-être, Pourront n'en pas là demeurer.
Le des-honneur eſt ſeur, mon mal-heur m’eſt viſible, Et mon amour en vain voudroit me l’obſcurcir, Mais le détail encor ne m’en eſt pas ſenſible;	Le des-honneur est sûr, mon malheur m'est visible, Et mon amour en vain voudrait me l'obscurcir, Mais le détail encor ne m'en est pas sensible;
Et mon juſte courroux pretend s’en éclaircir.	Et mon juste courroux prétend s'en éclaircir.
Voſtre frere déja, peut hautement répondre Que juſqu’à ce matin je ne l’ay point quitté.	Votre frère déjà, peut hautement répondre Que jusqu'à ce matin je ne l'ai point quitté.
Ie m’en vais le chercher, afin de vous confondre, Sur ce retour qui m’eſt fauſſement imputé.	Je m'en vais le chercher, afin de vous confondre, Sur ce retour qui m'est faussement imputé.
Apres nous percerons juſqu’au fond du myſtere, Iuſques à preſent inouy;	Après nous percerons jusqu'au fond du mystère, Jusques à présent inouï;
ne dans les mouuemens d’vne juſte colere, Malheur à qui m’aura trahy.	ne dans les mouvements d'une juste colère, Malheur à qui m'aura trahi.
Monſieur.	Monsieur.
OOOEE.	OOOOE.
AMPHITRION.	AMPHITRYON.
Ne m’accompagne pas;	Ne m'accompagne pas;
et demeure icy pour m’attendre.	et demeure ici pour m'attendre.
CLEANTHIS.	CLÉANTHIS.
Faut-il.	Faut-il.
ALCMENE.	ÀLCMENE.
Ie ne puis rien entendre, Laiſſe-moy ſeule, & ne ſuy point mes pas.	Je ne puis rien entendre, Laisse-moi seule, et ne suis point mes pas.
OULNNE III.	OÙLNE III.
CLEANTHIS, SOSIE.	CLEANTHIS, SOSIE.
CLEANTHIS.	CLÉANTHIS.
L faut que quelque choſe ait broüillé ſa cera uelle:	L faut que quelque chose ait brouillé sa cera uelle:
Mais le frere ſur le champ, Finira cette querelle.	Mais le frère sur le champ, Finira cette querelle.
SOSIE.	SOSIE.
C’eſt icy, pour mon Maiſtre, vn coup aſſez touchant;	C'est ici, pour mon Maître, un coup assez touchant;
Et ſon auanture eſt eruelle.	Et son aventure est ervelle.
le crains fort pour mon fait quelque choſe aprochant,	le crains fort pour mon fait quelque chose approchant,
CLEANTHIS.	CLÉANTHIS.
Voyez s’il me viendra ſeulement aborder?	Voyez s'il me viendra seulement aborder?
Mais je veux m’empécher de rien fuire paroiſtre.	Mais je veux m'empêcher de rien fuire paraître.
SOSIE.	SOSIE.
La choſe quelquefois eſt fâcheuſe à connoiſtre, Et je tremble, à la demander.	La chose quelquefois est fâcheuse à connaître, Et je tremble, à la demander.
Ne vaudroit-il point mieux, pour ne rien hazarder, Ignorer ce qu’il en peut-eſtre?	Ne vaudrait-il point mieux, pour ne rien hasarder, Ignorer ce qu'il en peut-être?
Allons tout coup vaille, il faut voir Et je ne m’en ſçaurois deffendre.	Allons tout coup vaille, il faut voir Et je ne m'en saurais défendre.
La foibleſſe humaine eſt d’auoir Des curiomez d apprendre, Ce qu’on ne voudroit pas ſçauoir.	La faiblesse humaine est d'avoir Des curiomez dès apprendre, Ce qu'on ne voudrait pas savoir.
Dieu te gard, Cleanthis.	Dieu te gard, Cléanthis.
CLEANTHIS.	CLÉANTHIS.
Ah, ah, tu t’en auiſes, Traiſtre, de t’aprocher de nous!	Ah, ah, tu t'en avises, Traître, de t'approcher de nous!
eaAus.	eaAus.
Mon Dieu, qu’as-tu?	Mon Dieu, qu'as-tu?
toûjours on te voit en couroux, Et ſur rien, tu te formaliſes.	toujours on te voit en courroux, Et sur rien, tu te formalises.
CLEANTHIS.	CLÉANTHIS.
Qu’appelles-tu ſur rien?	Qu'appelles-tu sur rien?
dy?	dis?
SOSIE.	SOSIE.
I’appelle ſur rien, Ce qui ſur rien s’appelle en vers, ainſi qu’en proſe;	J'appelle sur rien, Ce qui sur rien s'appelle en vers, ainsi qu'en prose;
Et rien, comme tu le ſçais bien, Veut dire rien, ou peu de choſe.	Et rien, comme tu le sais bien, Veut dire rien, ou peu de chose.
CLEANTHIS.	CLÉANTHIS.
Ie ne ſçay qui me tient, infame, Que je ne t’arrache les yeux;	Je ne sais qui me tient, infâme, Que je ne t'arrache les yeux;
Et ne t’apprenne où va le courroux d’vne femme.	Et ne t'apprenne où va le courroux d'une femme.
SOSIE.	SOSIE.
Hola.	Holà.
D’où te vient donc ce tranſport furieux?	D'où te vient donc ce transport furieux?
CLEANTHIS.	CLÉANTHIS.
tamappelles donc rien, le proceue, peut-eſtre, Qu’auec moy ton cœur a tenu?	tamappelles donc rien, le proçue, peut-être, Qu'avec moi ton cœur a tenu?
SOSIE.	SOSIE.
Et quel.	Et quel.
CLEANTHIS.	CLÉANTHIS.
Quoy, tu fais l’ingenu !	Quoi, tu fais l'ingénu !
Tu veux dire qu’icy tu nés pas reuenu?	Tu veux dire qu'ici tu nés pas revenu?
SOSIE.	SOSIE.
Non, je ſçay fort bien le contraire, Mals jene ten rais pas le ſin , Nous auons bû de ce ne ſçay quel vin, Qui m'a fait oublier tout ce que j’ay pu faire.	Non, je sais fort bien le contraire, Mals jène ten rais pas le sin , Nous avons bu de ce ne sais quel vin, Qui m'a fait oublier tout ce que j'ai pu faire.
CLEANTHIS.	CLÉANTHIS.
Tu crois peut eſtre excuſer par ce trait.	Tu crois peut être excuser par ce trait.
OSIE.	OSIE.
Ruau stout de bons tu n’en peux croire, l’eſtois dans vn eſtat, où je puis auoir fait Des choſes, dont j’aurois regret, Et dont ie n’ay nulle memoire.	Ruau stout de bons tu n'en peux croire, l'étais dans un état, où je puis avoir fait Des choses, dont j'aurais regret, Et dont je n'ai nulle mémoire.
CLEANTHIS.	CLÉANTHIS.
Tu ne te ſouuiens point du tout de la maniere, Dont tu m’as ſçeu traitter, eſtant venu du Port?	Tu ne te souviens point du tout de la manière, Dont tu m'as su traiter, étant venu du Port?
SOSIE.	SOSIE.
Non plus que rien, tu peux m’en faire le rapport, Ie ſuis equitable, & ſincere;	Non plus que rien, tu peux m'en faire le rapport, Je suis équitable, et sincère;
Et me condemneray moy-meſme, ſi j’ay tort.	Et me condemnerai moi-même, si j'ai tort.
CLEANTHIS.	CLÉANTHIS.
Comment!	Comment!
Amphitryon m’ayant ſçeu diſpoſer, Iuſqu’à ce que tu vins j’auois pouſſé ma veilles Mais je ne vis jamais vne froideur pareille;	Amphitryon m'ayant su disposer, Jusqu'à ce que tu vins j'avais poussé ma veilles Mais je ne vis jamais froideur pareille;
De ta femme, il fallut moy-meſme t’auiſer;	De ta femme, il fallut moi-même t'aviser;
Et lors que je fus te baiſer, Tu détournas le nez, & me donnas l’oreille ?	Et lors que je fus te baiser, Tu détournas le nez, et me donnas l'oreille ?
Bon!	Bon!
SOGIE.	SOGIE.
CLETRITIIJ.	CLETRITII.
Comment bon ?	Comment bon ?
SOSIE.	SOSIE.
Mon Dieu tu ne ſçais pas pourquoy.	Mon Dieu tu ne sais pas pourquoi.
Cleanthis je tiens ce langage.	Cléanthis je tiens ce langage.
I’auois mangé de l’ail, & fis en homme ſage.	J'avais mangé de l'ail, et fis en homme sage.
De détourner vn peu mon haleine de toy.	De détourner un peu mon haleine de toi.
CLEANTHIS.	CLÉANTHIS.
Ie te ſçeus exprimer des tendreſſes de cœur.	Je te sus exprimer des tendresses de cœur.
Mais à tous mes diſcours tu fus comme vne ſouche, Et jamais vn mot de douceur, Ne te peut ſortir de la bouche.	Mais à tous mes discours tu fus comme une souche, Et jamais un mot de douceur, Ne te peut sortir de la bouche.
Courage.	Courage.
SOSIE.	SOSIE.
CLEANTHIS.	CLÉANTHIS.
Enfin ma flame eut beau s’emanciper Sa chaſte ardeur en toy ne trouua rien que glace, Et dans vit ter fétour ie te vis la tromper, Iuſqu’à faire refus de prendre au lit la place, Que les Loix de P'riyuien t’obiigent d’occuOSIE.	Enfin ma flamme eut beau s'émanciper Sa chaste ardeur en toi ne trouva rien que glace, Et dans vit ter fétour On te vis la tromper, Jusqu'à faire refus de prendre au lit la place, Que les Lois de P'riyuien t'obiuent d'occuOSIE.
per.	per.
Quoy!	Quoi!
je ne couchay point.	je ne couchai point.
CLEANTHIS.	CLÉANTHIS.
Non, lacne,	Non, lacne,
SOSIE.	SOSIE.
Eſt-il poſſible!	Est-il possible!
CLEANTHIS,	CLEANTHIS,
CLEANTHIS.	CLÉANTHIS.
Traiſtre, il n’eſt que trop aſſuré, C’eſt de tous les affronts, l’affront le plus ſenſible;	Traître, il n'est que trop assuré, C'est de tous les affronts, l'affront le plus sensible;
Et loin que ce matin, ton cœur l’ait reparé, Tu t’és d’auec moy ſeparé, Par des uircouit elaigees d’vn mépris tout viſible.	Et loin que ce matin, ton cœur l'ait réparé, Tu t'avez d'avec moi séparé, Par des uircouit élaiges d'Han mépris tout visible.
Viuat, Soſie!	Vivat, Sosie!
SOSIE.	SOSIE.
CLEANTHIS.	CLÉANTHIS.
Hé quoy!	Hé quoi!
ma plainte à cét effet, Tu ris apres ce bel Ouurage?	ma plainte à cet effet, Tu ris après ce bel Ouvrage?
SOSIE.	SOSIE.
Que le luis de moy vaereie:	Que le luis de moi vaèreie:
CLEANTHIS.	CLÉANTHIS.
Exprime-t on ainſi le regret a vn outrage?	Exprime-t -on ainsi le regret a un outrage?
SOSIE.	SOSIE.
le n’aurois jamais crû que j’euſſe eſté ſi ſage.	le n'aurais jamais cru que j'eusse été si sage.
CLEANTHIS.	CLÉANTHIS.
Loin de te condamner d’vn ſi perfide trait, Tu m’en fais éclater la joye en ton viſage.	Loin de te condamner d'vn si perfide trait, Tu m'en fais éclater la joie en ton visage.
OSIE.	OSIE.
Mon Dieu, tout doucement, ſi je parois joyeux, Croy que j’en ay dans l’Ame vne raiſon tres forte :	Mon Dieu, tout doucement, si je parais joyeux, Crois que j'en ai dans l'Ame un raison très forte :
Et que, ſans y penſer, je ne fis jamais mieux, Que d’en vſer tantoſt auec toy de la ſorte.	Et que, sans y penser, je ne fis jamais mieux, Que d'en user tantôt apprendre toi de la sorte.
CLEANTHIS.	CLÉANTHIS.
Traiſtre te moques-ru de moy !	Traître te moque-ru de moi !
OSIE.	OSIE.
Non, je te parle auec franchiſe:	Non, je te parle avec franchise:
En l’eſtat où j’eſtois, j’auois certain effroy, Dont, auec ton diſcours, mon ame s’eſt remiſe.	En l'état où j'étais, j'avais certain effroi, Dont, avec ton discours, mon âme s'est remise.
le m’apprehendois foit, & craignois qu’aucc toy Ie nouno miaqueique rottne.	le m'appréhendais soit, et craignais qu'aucc toi Je nouvno miaqueique rottne.
CLEANTHIS.	CLÉANTHIS.
Quelle eſt cette frayeur?	Quelle est cette frayeur?
& ſçachons donc pourquoy ?	et sachons donc pourquoi ?
OSIE.	OSIE.
Les Medecins di ſent quand on eſt yvre Que de ſa femme on ſe doit abſtenir;	Les Médecins di sent quand on est ivre Que de sa femme on se doit abstenir;
Et que dans cét état, il ne peut prouenir Que des enfans peſans, & qui ne ſçauroient viure.	Et que dans cet état, il ne peut provenir Que des enfants pesants, et qui ne sauraient vivre.
Voy, ſi mon cœur n’eût ſçeu de froideur ſe munir, Quels inconueniens auroient pû s’en enſuiure?	Vois, si mon cœur n'eût su de froideur se munir, Quels inconvéniens auraient pu s'en ensuivre?
CLEANTHIS.	CLÉANTHIS.
Ie me moque des Medecins, Auec leurs raiſonnemens fades, Qu’ils reglent ceux qui ſont malades, Sans vouloir gouuerner les gens qui ſont bien ſains.	Je me moque des Médecins, Avec leurs raisonnements fades, Qu'ils règlent ceux qui sont malades, Sans vouloir gouverner les gens qui sont bien sains.
Ils ſe mélent de trop d’affaires, De pretendre tenir nos chaſtes feux geſnez;	Ils se mêlent de trop d'affaires, De prétendre tenir nos chastes feux gênés;
Et tur les jours caniculaires, Ils nous donnent encor, auec leurs loix ſeueres, De cent ſots contes par le nez.	Et tur les jours caniculaires, Ils nous donnent encor, avec leurs lois sévères, De cent sots contes par le nez.
Tout doux.	Tout doux.
SOSIE.	SOSIE.
CLEANTHIS.	CLÉANTHIS.
Non, je ſouſtiens, que cela conelut mal, Ces raiſons ſont raiſons d’extrauagantes Teſtes;	Non, je soutiens, que cela conelut mal, Ces raisons sont raisons d'extravagantes Testes;
Il n’eſt ny vin, ny temps qui puiſſe eſtre fatal, A remplir le deuoir de l’Amour conjugal, Et les Medecins ſont des Beſtes.	Il n'est assez vin, ni temps qui puisse être fatal, A remplir le devoir de l'Amour conjugal, Et les Médecins sont des Bêtes.
SOSIE.	SOSIE.
Contr’eux je t’en ſupplie appaiſe ton courroux, Ce ſont d’honneſtes gens, quoy que le monde en diſe.	Contr'eux je t'en supplie apaise ton courroux, Ce sont d'honnêtes gens, quoi que le monde en dise.
CLEANTHIS.	CLÉANTHIS.
Tu n’es pas où tu crois;	Tu n'es pas où tu crois;
En vain tu files doux.	En vain tu files doux.
Ton excuſe n’eſt pas vne excuſe de miſe:	Ton excuse n'est pas une excuse de mise:
Et je me veux venger, toſt ou tard, entre nous, De l’ait dont chaque jour ie voy qu’on me mépriſe, Des diſcours de tantoſt, ie garde tous les coups, Et tâcheray d’vſer, lâche, & perfide Epoux De cette nounta quauommeeuninue peamle.	Et je me veux venger, tôt ou tard, entre nous, De l'ait dont chaque jour ie vois qu'on me méprise, Des discours de tantôt, ie garde tous les coups, Et tâcherai d'user, lâche, et perfide Époux De cette nouvnta quauommeeuninue peamle.
Quoy.	Quoi.
SOSIE.	SOSIE.
CLEANTHIS.	CLÉANTHIS.
Tu m’as dit tantoſt, que tu conſentois fort.	Tu m'as dit tantôt, que tu consentais fort.
Lâche, que j’en aimaſſe vn autre.	Lâche, que j'en aimasse un autre.
OSIE.	OSIE.
Ah!	Ah!
pour cét article, j’ay tort, Ie m’en dedis, il y va trop du noſtre Oarde toy bien de muiure ce tranſport.	pour cet article, j'ai tort, Je m'en dédis, il y va trop du nôtre Arde toi bien de muire ce transport.
CLEANTHIS.	CLÉANTHIS.
Si je puis vne fois pourtant, Sur mon Eſprit gagner la choſe.	Si je puis quelque fois pourtant, Sur mon Esprit gagner la chose.
OSIE.	OSIE.
Fais à ce diſcours quelque pauſe.	Fais à ce discours quelque pause.
Amphitryon reuient qui me paroît content.	Amphitryon revient qui me paraît content.
SCENE IV.	SCÈNE IV.
APAALC CEDAN MITS, SOSIE.	APALC CÉDAN MITS, SOSIE.
IVPITER.	IUPITER.
E viens prendre le temps de rapaiſer AlcA mene, De bannir les chagrins, que ſon cœur veur garder, Et dõner à mes feux, dans ce ſoin qui m’améne Le doux plaiſir de ſe raccommoder Alcmene eſt là-haut n’eſt-ce pas?	E viens prendre le temps de rapaiser AlcA mène, De bannir les chagrins, que son cœur veur garder, Et donner à mes feux, dans ce soin qui m'amène Le doux plaisir de se raccommoder Alcène est là-haut n'est-ce pas?
CLEANTHIS.	CLÉANTHIS.
Ouy pleine d vne inquietude, Qui cherche de la ſolitude;	Oui pleine d une inquiétude, Qui cherche de la solitude;
Lt qui m’a deffendu d’accompagner ſes pat.	Lt qui m'a défendu d'accompagner ses pat.
PITER.	PITER.
Quelque defenſe qu’elle ait faite Elle ne ſera pas pour moy.	Quelque défense qu'elle ait faite Elle ne sera pas pour moi.
CLEANTHIS.	CLÉANTHIS.
pon -cilagiin, à ce que jo voy A fait vne prompte retraitte.	pon -ilagiin, à ce que jo vois A fait ton prompte retraite.
SCENE V.	SCÈNE V.
CLEANTHIS, SOSIE.	CLEANTHIS, SOSIE.
SOSIE.	SOSIE.
Ve dis-tu Cleanthis, de ce joyeux main ti en Apres ſon fracas effroyable?	Ve dis-tu Cléanthis, de ce joyeux main ty en Après son fracas effroyable?
CLEANTHIS.	CLÉANTHIS.
Que ſi toutes nous faiſions bien, Nous donnerions, tous les Hommes au Diable, Et que le meſſleur n'en vaut rien.	Que si toutes nous faisions bien, Nous donnerions, tous les Hommes au Diable, Et que le messleur n'en vaut rien.
SOSIE.	SOSIE.
Cela ſe dit dans le courrous!	Cela se dit dans le courrous!
Mais aux Hommes, par trop, vous eſtes accrochées, Et vous ſeriez ma Ioy, toutes bien empéchées, Si le Diable les prenoit tous.	Mais aux Hommes, par trop, vous êtes accrochées, Et vous seriez ma Joi, toutes bien empêchées, Si le Diable les prenait tous.
CLEANTHIS.	CLÉANTHIS.
Vrayment.	Vraiment.
SOSIE.	SOSIE.
Les voicy, taiſons-nous.	Les voici, taisons-nous.
SCENE VI.	SCÈNE VI.
IVPITER, ALCMENE, CLEANTHIS, SOSIE.	IUPITER, ALCMENE, CLEANTHIS, SOSIE.
.	.
JVPITER.	JUPITER.
J Oulez-vous me deſeſperer?	J Oulez-vous me désespérer?
* Helas!	* Hélas!
arreſtez belle Alemene.	arrêtez belle Alémène.
ALCMENE.	ÀLCMENE.
Non, auec l’Autheur de ma peine, Ie ne puis du tout demeurer.	Non, avec l'Auteur de ma peine, Je ne puis du tout demeurer.
IVPITER.	IUPITER.
De grace.	De grâce.
A LCMINE.	À LCMINE.
La iſſe 7-moy.	La isse 7-moi.
IVPITER.	IUPITER.
Quoy.	Quoi.
F iij	 Fij
ALCMENE.	ÀLCMENE.
narnel-mdy, vous dis-je	narnel-médi, vous dis-je
VPITER.	VPITER.
Ses pleurs touchent mon ame, & ſa douleur m’afflige.	Ses pleurs touchent mon âme, et sa douleur m'afflige.
Souffrez que mon Cœur.	Souffrez que mon Cœur.
A LCMENE.	À LCMENE.
Non, ne ſu uez point mes pas,	Non, ne su uez point mes pas,
AVITIEIVOù voulez-vous aller?	AUITIEIVOù voulez-vous aller?
ALCMENE.	ÀLCMENE.
Où vous ne ſerez pas.	Où vous ne serez pas.
VPITER.	VPITER.
Ce vous eſt vne attente vaine, Ie tiens à vos beautez par vn nœud trop ſerré, Pour pouuoir vn moment en eſtre ſeparé, le vous luiuray par tout Alcmene.	Ce vous est une attente vaine, Je tiens à vos beautés par un nœud trop serré, Pour pouvoir un moment en être séparé, le vous luiurai par tout Alcène.
ALCMENE.	ÀLCMENE.
Et moy par tout je vous fuiray.	Et moi par tout je vous fuirai.
PITER.	PITER.
Ie ſuis donc bien épouuentable !	Je suis donc bien épouuentable !
ALCMEZE.	ÀLCMEZE.
Plus qu’on ne peut dire à mes yeux.	Plus qu'on ne peut dire à mes yeux.
Ouy, je vous voy, comme vn Monſtre effroyaVn Monſtre cruel, furieux, [ble;	Oui, je vous vois, comme un Monstre effroyaUn Montre cruel, furieux, [ble;
Et dont l’approche eſt redoutable;	Et dont l'approche est redoutable;
Comme vn Monſtre à fuir en tous lieux.	Comme un Monstre à fuir en tous lieux.
Mon cœur ſouffre à vous voir, vne peine int ciojaure, C’eſt vn ſuppli ce qui m’acable;	Mon cœur souffre à vous voir, une peine int ciojaure, C'est un suppli ce qui m'acable;
Et je ne voy rien ſous les Cieux, D'affreux, d’horrible.	Et je ne vois rien sous les Cieux, D'affreux, d'horrible.
d’odieux, Qui ne me fut, plus que vous, ſuportable.	d'odieux, Qui ne me fut, plus que vous, suportable.
PITER.	PITER.
En voila bien, helas!	En voilà bien, hélas!
que voſtre bouche dit!	que votre bouche dit!
ALCMENE.	ÀLCMENE.
I'en ay dans le Cœur dauantage;	J'en ai dans le Cœur davantage;
Et pour s’exprimer tout, ce eœur a du dépit, De ne point trouuer de Iangage,	Et pour s'exprimer tout, ce eœur a du dépit, De ne point trouver de Jangage,
IVPITER.	IUPITER.
Hé!	Hé!
que vous a donc fait ma flame, Pour me pouuoir, Aleméne, en monſtre regar der ?	que vous a donc fait ma flamme, Pour me pouvoir, Aleméne, en montre regar der ?
ALCMENE.	ÀLCMENE.
Ah!	Ah!
juſte Clel!	juste Clél!
cela peut-ſrre demander?	cela peut-srerre demander?
Et n’eſt-ce pas pour mettre à bout vne Ame	Et n'est-ce pas pour mettre à bout une Âme
IVPITER.	IUPITER.
Ah!	Ah!
d’vn eſprit plus adoucy.	d'un esprit plus adouci.
ADOMDHE.	ADOMDHÉ.
Non, je ne veux, du tout, vous voir, ny vous entendre.	Non, je ne veux, du tout, vous voir, ni vous entendre.
VPITER.	VPITER.
Auez-vous bien le cœut de me traiter ainſi?	Avez-vous bien le cœut de me traiter ainsi?
Eſt-ce là cét amour ſi tendre, Qui deuoit tant durer, quand ie vins hyer icy?	Est-ce là cet amour si tendre, Qui devait tant durer, quand ie tu hier ici?
ALCMENE.	ÀLCMENE.
Non, non, ce ne l’eſt pas;	Non, non, ce ne l'est pas;
& vos lâches injures En ont autrement ordonné.	et vos lâches injures En ont autrement ordonné.
Il n’eſt plus, cét amour tendre, & paſſionné;	Il n'est plus, cet amour tendre, et passionné;
Vous l’auez dans mon cœur, par cent viues bleſſures Cruellement affaſſine.	Vous l'avez dans mon cœur, par cent vives blessures Cruellement affassine.
C’eſt en ſa place vn courroux inflexible;	C'est en sa place un courroux inflexible;
Vn vif reſſentiment, vn dépit inuincible;	Un vif ressentiment, un dépit invincible;
Vn deſeſpoir d’vn Cœur juſtement animé;	Un désespoir d'un Cœur justement animé;
Qui pretend vous hair, pour cet affront ſenſible, Autant qu’il eſt marry de vous auoir aymé:	Qui prétend vous haïr, pour cet affront sensible, Autant qu'il est marri de vous avoir aimé:
Et c’eſt haïr autant qu’il eſt poſſible.	Et c'est haïr autant qu'il est possible.
IVPITER.	IUPITER.
Helas!	Hélas!
que voſtre amour n’auoit guere de force, Si de ſi peu de choſe on le peut voir mourir !	que votre amour n'avait guère de force, Si de si peu de chose on le peut voir mourir !
Ce qui n’eſtoit que jeu, doit-il faire vn diuorce, Et d’vne raillerie, a-t’on lieu de s’aigrir?	Ce qui n'était que jeu, doit-il faire un divorce, Et d'une raillerie, a-t-on lieu de s'aigrir?
ALCMENE.	ÀLCMENE.
Ah!	Ah!
c’eſt cela dont ie ſuis offencée;	c'est cela dont je suis offensée;
Et que ne peut pardonner mon courroux.	Et que ne peut pardonner mon courroux.
Des veritables traits d’vn mouuement jaloux, Ie me trouuerois moins bleſſée;	Des véritables traits d'une mouvement jaloux, Je me trouverais moins blessée;
La jalouſie a des impreſſions, Dont bien ſouuent la force nous entraiſne;	La jalousie a des impressions, Dont bien souvent la force nous entraîne;
Et l’Ame la plus ſage en ces occaſions, Sans doute, auec aſſez de peine Répond de ſes émotions.	Et l'Âme la plus sage en ces occasions, Sans doute, avec assez de peine Répond de ses émotions.
1 L’emportement d’vn cœur qui peut s’eſtre abuſé, A dequoy ramener vne Ame qu’il offence;	1 L'emportement d'être cœur qui peut s'être abusé, A dequoy ramener une Âme qu'il offense;
Et dans l’amour qui luy donne naiſſance, Il trouue au moins, malgré toute ſa violence, Des raiſons pour eſtre excuſé De ſemblables tranſpotts, contre vn reſſentiment, Pour defence toûjours, ont ce qui les fait naiſtre, Et l’on donne grace, aiſement, A ce dont on n’eſt pas le maiſtre, Mais que de gayeté de cœur On paſſe aux mouuemens d’vne fureur extreme, Que ſans cauſe l'on vienne, auec tant de rigueur, Bleſſet la tendreſſe, & l’honneus D’vn cœur qui chérement nous aime?	Et dans l'amour qui lui donne naissance, Il trouve au moins, malgré toute sa violence, Des raisons pour être excusé De semblables transpotts, contre un ressentiment, Pour défense toujours, ont ce qui les fait naître, Et l'on donne grâce, aisément, A ce dont on n'est pas le maître, Mais que de gaieté de cœur On passe aux mouvements d'une fureur extrême, Que sans cause l'on vienne, auec tant de rigueur, Blesset la tendresse, et l'honnus D’-un cœur qui chèrement nous aime?
All:	All:
t eit un coup tiep eruer en luy Meme, Et que jamais n’oublîra ma douleur.	 tit un coup tiep erver en lui -même, Et que jamais n'oublîtra ma douleur.
IVPITER.	IUPITER.
Oüy, vous auez raiſon, Alcmene, il ſe faut rendre;	Oui, vous avez raison, Alcène, il se faut rendre;
Cette action, ſans doute, eſt vn crime odieux, Ie ne pretends plus le deffendre;	Cette action, sans doute, est un crime odieux, Je ne prétends plus le défendre;
Mais ſouffrez que mon cœur s’en deffende à vos yeux.	Mais souffrez que mon cœur s'en défende à vos yeux.
Et donne au voſtre à qui ſe prendre, De ce tranſport injurieux;	Et donne au vôtre à qui se prendre, De ce transport injurieux;
A vous en faire vn aueu veritable, L’Epoux, Alemene, a commis tout le mal.	À vous en faire un aveu véritable, L'Époux, Alémène, a commis tout le mal.
C’eſt l’Epoux, qu’il vous faut regarder en coupable, L’Amant n’a point de part à ce tranſport brutal;	C'est l'Époux, qu'il vous faut regarder en coupable, L'Amant n'a point de part à ce transport brutal;
Et de vous offenſer, ſon cœur n’eſt point capable, Il a pour vous ce cœur, pour jamais y penſet Trop de reſpect, & de tendreſſe;	Et de vous offenser, son cœur n'est point capable, Il a pour vous ce cœur, pour jamais y penset Trop de respect, et de tendresse;
Et ſi de faire rien à vous pouuoir bleſſer, Il auoit eu la coupable foibleſſe, De cent coups à vos yeux il voudroit le percer.	Et si de faire rien à vous pouvoir blesser, Il avait eu la coupable faiblesse, De cent coups à vos yeux il voudrait le percer.
Mais l’Epoux eſt ſorty de ce reſpect ſoûmis, Où pour vous on doit toûjours eſtre, A ſon dur procedé, l’Epoux ſe fait connoiſtre, Et par le droit d’Hymen, il s’eſt crû tout permis :	Mais l'Époux est sorti de ce respect émis, Où pour vous on doit toujours être, A son dur procédé, l'Époux se fait connaître, Et par le droit d'Hymen, il s'est cru tout permis :
Oüy, c’eſt luy, qui ſans doute, eſt crimi nel vers vous;	Oui, c'est ainsi, qui sans doute, est crimi nel vers vous;
Luy ſeul a maltraitté voſtre aymable perſonne.	Lui seul a maltraité votre aimable personne.
Haiſſez, déteſtez l’Epoux, I'y conſens, & vous l’abandonne:	Haissez, détestez l'Époux, J'y consens, et vous l'abandonne:
Mais, Alcmene, ſauuez l’amant de ce courroux Qu’vne telle offenſe vous donne.	Mais, Alcmène, sauvez l'amant de ce courroux Qu'une telle offense vous donne.
N’en jettez pas ſur luy l’effet.	N'en jettez pas sur lui l'effet.
Démélez-le vn peu du coupable;	Démélez-le un peu du coupable;
Et pour eſtre enfin équi table, Ne le puniſſez point de ce qu’il n’a pas fait	Et pour être enfin équi table, Ne le punissez point de ce qu'il n'a pas fait
ALCMENE.	ÀLCMENE.
Ah!	Ah!
toutes ces ſubtilitez N’ont que des excuſes friuoles;	toutes ces subtilités N'ont que des excuses frivoles;
Et pour les eſprits irritez, Ce ſont de contre-temps, que de telles paroles.	Et pour les esprits irrités, Ce sont de contre-temps, que de telles paroles.
Ce detour ridicule eſt en vain pris par vous, Ie ne diſtingue rien en celuy qui m’offence, Tout y deuient l’objet de mon courroux, Et dans ſa juſte violence, Sont confondus, & l’Amant & l’Epoux.	Ce détour ridicule est en vain pris par vous, Je ne distingue rien en celui qui m'offense, Tout y devient l'objet de mon courroux, Et dans sa juste violence, Sont confondus, et l'Amant et l'Époux.
Tous deux de meſme ſorte occupent ma penſée.	Tous deux de même sorte occupent ma pensée.
Et des meſmes couleurs, par mon ame bleſſée, Tous deux ils ſont periito a mes yeux Tous deux ſont criminels, tous deux m’ont offencée;	Et des mêmes couleurs, par mon âme blessée, Tous deux ils sont périto à mes yeux Tous deux sont criminels, tous deux m'ont offensée;
Et tous deux me ſont odieux.	Et tous deux me sont odieux.
ITER.	ITER.
Hé bien, puiſque vous le voulez, Il faut donc me charger du crime;	Hé bien, puisque vous le voulez, Il faut donc me charger du crime;
Oüy vous auez raiſon, lors que vous m’immor lez, A vos reſſentimens, en coupable victime, Vn trop juſte dépit contre moy vous anime, Et tout ce grand courroux, qu’icy vous étalez Ne me fait endurer qu’vn tourment legitime.	Oui vous avez raison, lors que vous m'immor lez, À vos ressentiments, en coupable victime, Un trop juste dépit contre moi vous anime, Et tout ce grand courroux, qu'ici vous étalez Ne me fait endurer qu'un tourment légitime.
C’eſt auec droit que mon abord vous chaſſe, Et que de me fuir en tous lieux, Voſtre cole re me menaſſe.	C'est assez droit que mon abord vous chasse, Et que de me fuir en tous lieux, Votre colle re me menace.
AMTIIIIRION Ie dois vous eſtre vn objet odieux.	AMTIIIIRION Je dois vous être un objet odieux.
Vous deuez me vouloir vn mal prodigieux, Il n’eſt aucune horreur, que mon forfait ne paſſe, D’auoir offencé vos beaux yeux.	Vous devez me vouloir un mal prodigieux, Il n'est aucune horreur, que mon forfait ne passe, D'avoir offensé vos beaux yeux.
C’eſt vn crime à bleſſer les hommes, & les Dieux;	C'est un crime à blesser les hommes, et les Dieux;
Et je merite enfin pour punir cette audace, Que contre moy voſtre haine ramaſſe Tous les traits les plus furieux:	Et je mérite enfin pour punir cette audace, Que contre moi votre haine ramasse Tous les traits les plus furieux:
Mais mon cœur vous demande grace, Pour vous la demander ie me jette à genoux;	Mais mon cœur vous demande grâce, Pour vous la demander un me jette à genoux;
Et la demande au nom de la plus viue flame, Du plus tendre amour, dont vne ame Puiſſe jamais brûler pour vous, Si voſtre cœur, charmante Alcmene, Me refuſe la grace, où j’oſe recourir;	Et la demande au nom de la plus vive flamme, Du plus tendre amour, dont une âme Puisse jamais brûler pour vous, Si votre cœur, charmante Alcène, Me refuse la grâce, où j'ose recourir;
Il faut qu’vne atteinte ſoudaine, M’arrache, en me faiſant mourir, Aux dures rigueurs d’vne peine, Que je ne ſçaurois plus ſouffrir:	Il faut qu'une atteinte soudaine, M'arrache, en me faisant mourir, Aux dures rigueurs d'une peine, Que je ne saurais plus souffrir:
Oüy cét état me deſeſpere;	Oui cet état me désespère;
Alcmene ne preſumez pas, Qu’aimant, comme ie fais, vos celeſtes appas, Ie pui ſſe viure vn jour auec voſtre colere.	Alcène ne présumez pas, Qu'aimant, comme tu fais, vos célestes appas, Je puy sse vivre un jour avec votre colère.
Déja, de ces momens, la barbare longueur, Fait, ſous des atteintes mortelles, Succomber tout mon triſte cœur, Et de mille Vautours, les bleſſures cruelles, N’ont rien de comparable à ma viue douleur.	Déjà, de ces moments, la barbare longueur, Fait, sous des atteintes mortelles, Succomber tout mon triste cœur, Et de mille Vautours, les blessures cruelles, N'ont rien de comparable à ma vive douleur.
Alemene, vous n’auez qu’à me le declarer, S’il n’eſt point de pardon que je doiue eſperer?	Alémène, vous n'avez qu'à me l' déclarer, S'il n'est point de pardon que je doive espérer?
Cette épée auſſi-toſt, par vn coup fauorable, Va percer à vos yeux, le cœur d’vn miſerable;	Cette épée aussitôt, par un coup favorable, Va percer à vos yeux, le cœur d'un misérable;
Ce cœur, ce traiſtre cœur, trop digne d’expiPuis qu’il a peu fâcher vn objet adorable, Heureux, en deſcendant au tenebreux ſejour, Si de voſtre courroux mon trépas vous rameine, Etyne laiſſe en voſtre ame, apres ce triſte jour, Aucune impreſſion de haine, Au ſouuenir de mon amour.	Ce cœur, ce traître cœur, trop digne d'expiPuis qu'il a pu fâcher un objet adorable, Heureux, en descendant au ténébreux séjour, Si de votre courroux mon trépas vous ramène, Etyne laisse en votre âme, après ce triste jour, Aucune impression de haine, Au souvenir de mon amour.
C’eſt tout ce que j'aticno;	C'est tout ce que j'aticno;
pour faueur ſouueraine.	pour faveur souveraine.
ALCUENE.	ÀLCUENE.
Ah!	Ah!
trop cruel Epoux!	trop cruel Époux!
TVPIIER.	TUPIIER.
Dites, parlez, Alcmene.	Dites, parlez, Alcène.
ALCMENE.	ÀLCMENE.
Paucxrencor pour pous, conteruer des bontez, Et vous voir m’outrager, par tant d’indignitez.	Paucxrencor pour pous, conterver des bontés, Et vous voir m'outrager, par tant d'indignités.
PITER.	PITER.
Quelque reſſentiment, qu’vn outrage nous cauſe, Tient-il contre vn remords d’vn cœur bien enflamé ?	Quelque ressentiment, qu'autre outrage nous cause, Tient-il contre un remords d'un cœur bien enflammé ?
ol Le MENE.	ol Le MÈNE.
Vn cœur bien plein de flame, à mille motts s’expoſe, Plutoſt que de vouloir fâcher l’objet aimé.	Un cœur bien plein de flamme, à mille motts s'expose, Plutôt que de vouloir fâcher l'objet aimé.
ITER.	ITER.
nmuo oname quenſa vn, moins on trouue de peine.	nmuo on quenza un, moins on trouve de peine.
ALEMENE.	ÀLEMENE.
Non, ne m’en parlez point, vous meritez ma haine,	Non, ne m'en parlez point, vous méritez ma haine,
IVPITER.	IUPITER.
Vous me haiſſez donc?	Vous me haïssez donc?
ALCMENE.	ÀLCMENE.
I’y fais tout mon effort, Et j’ay dépit de voir, que toute voſtre offence, Ne puiſle de mon cœur, juſqu’à cette vengeance, Faſre encor aller le tran'port.	J'y fais tout mon effort, Et j'ai dépit de voir, que toute votre offense, Ne puisle de mon cœur, jusqu'à cette vengeance, Fasre encor aller le tranport.
IVPITER.	IUPITER.
Mais pourquoy cette violence, Iuiſque pour vous verger, ie vous offre ma ient) Prononcez-en l’Arreſt, & j’obeïs ſur l'heure,	Mais pourquoi cette violence, Juisque pour vous verger, Elle vous offre ma jent) Prononcez-en l'Arrest, et j'obéis sur l'heure,
ALCMENE.	ÀLCMENE.
Qui ne ſçauroit hair, peut-il vouloir qu’on meure ?	Qui ne saurait haïr, peut-il vouloir qu'on meure ?
PITER.	PITER.
Et moy je ne puis viure, à moins que vous Cette colere qui m’accable, [quittiez.	Et moi je ne puis vivre, à moins que vous Cette colère qui m'accable, [quittiez.
Et que vous m’accordiez le pardon fauorable, Que je vous demande a vos piez Reſoluez icy l’vn des deux Ou de punir, ou bien d’abſoudre.	Et que vous m'accordiez le pardon favorable, Que je vous demande à vos pieds Résoluez ici l'un des deux Ou de punir, ou bien d'absoudre.
ALCMENE.	ÀLCMENE.
Helas!	Hélas!
ce que ie puis reſoudre, Paroit bien plus, que ie ne veux!	ce que ici puis résoudre, Parait bien plus, que sans ne veux!
Luus voulon iouncuir le courroux qu’on me Mon cœur a trop ſçeu me trahir, [donne, Dire qu’on ne ſçauroit hair,;	Luus voulon jouncuir le courroux qu'on me Mon cœur a trop su me trahir, [donne, Dire qu'on ne saurait haïr,;
N’eſt-ce pas dire qu’on pardonne?	N'est-ce pas dire qu'on pardonne?
TPITER.	TPITER.
Ah!	Ah!
belle Alcmene, il faut que comblé d’alle greſſe.	belle Alcmène, il faut que comblé d'allé gresse.
ALCMENE.	ÀLCMENE.
Ibleſſe.	Iblesse.
Laiſſez, je me veux mal de mon trop de foi	Laissez, je me veux mal de mon trop de foi
PITER.	PITER.
Va Soſie, & dépeſche-toy, Voir dans les doux tranſpoits dont mon ame eſt charnée, Ce que tu trouueras d’Officiers de l’Armée;	Va Sosie, et dépêche-toi, Voir dans les doux transpoits dont mon âme est charnée, Ce que tu trouveras d'Officiers de l'Armée;
Et les inuite à diner auec moy, Tandis que d’icy ie le chaſſe, Mercure y remplira ſa place.	Et les inuite à dîner avec moi, Tandis que d'ic ie le chasse, Mercure y remplira sa place.
SCENE VII.	SCÈNE VII.
CLEANTHIS SOSIE.	CLÉANTHIS SOSIE.
SOSIE.	SOSIE.
E bien, tu vois, Cleanthis, ce menage.	E bien, tu vois, Cléanthis, ce menage.
H Veux-tu qu’à leur exemple icy, Nous faſſions entre nous vn peu de paix auſſi?	H Veux-tu qu'à leur exemple ici, Nous fassions entre nous un peu de paix aussi?
Quelque petit rapatriage?	Quelque petit rapatriage?
CLEANTHIS.	CLÉANTHIS.
C’eſt pour ton nez, vrayment, cela ſe fait ainſi.	C'est pour ton nez, vraiment, cela se fait ainsi.
SOSIE.	SOSIE.
Quoy!	Quoi!
tu ne veux pas?	tu ne veux pas?
CLEANTHIS.	CLÉANTHIS.
NOHe	NOHe
SOSIE.	SOSIE.
Il ne m’inporte guere, Tant pis pour toy.	Il ne m'inporte guère, Tant pis pour toi.
CLEANTHIS.	CLÉANTHIS.
Là, là, reuien.	Là, là, revien.
SOSIE.	SOSIE.
Non morbleu, ie n’en feray rien, Et ie veux eſtre, à mon tour en colere.	Non morbleu, Seigneur n'en ferai rien, Et deux veux être, à mon tour en colère.
CLEANTHIS.	CLÉANTHIS.
Va, va, traiſtre, faiſte-inoy fatre» On ſe laſſe parfois, d’eſtre femme de bien, Fin du ſeçond Acte.	Va, va, traître, faîte-inoi fatre " On se lasse parfois, d'être femme de bien, Fin du seçond Acte.
ACTE III	ACTE III
DCHEDIHHAIIENE.	DCHÉDIHHAIENE.
AMPHITRYON.	AMPHITRYON.
Vy, ſans doute le ſort tout exprez me le O cache;	Vi, sans doute le sort tout exprez me le Ô cache;
Et des tours que je fais, à la fin, ie ſuis las;	Et des tours que je fais, à la fin, je suis las;
Il n’eſt point de deſtin plus cruel, que ie ſçache, Ie ne ſçaurois trouuer, portant par tous mes pas, Celuy qu’à chercher ie m’atrache.	Il n'est point de destin plus cruel, que sans sache, Je ne saurais trouver, portant par tous mes pas, Celui qu'à chercher Seigneur m'atrache.
Et ie trouue tous ceux, que ie ne cherche pas.	Et ici trouve tous ceux, que ainsi ne cherche pas.
Mil le fâcheux cruels, qui ne penſent pas l’eſtre, De nos faits, auec moy, ſans beaucoup me connoiſtre, Viennent ſe réjoüir, pour me faire enrager.	Mil le fâcheux cruels, qui ne pensent pas l'être, De nos faits, sans moi, sans beaucoup me connaître, Viennent se réjouir, pour me faire enrager.
Dans l’embarras cruel du ſoucy qui me bleſſe, De leurs embraſſemens, & de leur allegreſſe, Sur mon inquietude, ils viennent tous charger, En vain à paſſer ie m’apreſte, Pour fuir leurs perſecutions.	Dans l'embarras cruel du souci qui me blesse, De leurs embrassements, et de leur allégresse, Sur mon inquiétude, ils viennent tous charger, En vain à passer ie m'apprête, Pour fuir leurs persécutions.
Leur tuante amitié, de tous coſtez m’arreſte;	Leur tuante amitié, de tous côtés m'arrête;
Et tandis qu’à l’ardeur de leurs expreſſions, Ie répons d’vn geſte de teſte;	Et tandis qu'à l'ardeur de leurs expressions, Je réponds d'un geste de tête;
Ie leur donne, tout bas, cent maledictions.	Je leur donne, tout bas, cent malédictions.
Ah!	Ah!
qu'on eſt peu flaté de louangeja nonneur, Et de tout ce que donne vne grande victoire,	qu'on est peu flatté de louangejà nonneur, Et de tout ce que donne une grande victoire,
Lors que dans l’ame on ſouffre vne viue douIeur !	Lors que dans l'âme on souffre une vive douIeur !
Et que l’on donneroit volontiers cette gloite, Pour auoir le repos du Cœur !	Et que l'on donnerait volontiers cette gloite, Pour avoir le repos du Cœur !
Ma jalouſie, a tout propos, Me promene ſur ma diſgrace;	Ma jalousie, a tout propos, Me promène sur ma disgrâce;
Et plus mon eſprit y repaſſe, Moins j’en puis débroüil ler le funeſte cahos.	Et plus mon esprit y repasse, Moins j'en puis débroüil ler le funeste cahos.
Le vol des diamans n’eſt pas ce qui m’étonne :	Le vol des diamants n'est pas ce qui m'étonne :
On leue les cachets, qu’on ne l’aperçoit pas.	On lève les cachets, qu'on ne l'aperçoit pas.
Mais le don, qu’on veut qu’hier j’en vins faire en perſonne, Eſt-ce qui fait icy mon eruel embarras.	Mais le don, qu'on veut qu'hier j'en vins faire en personne, Est-ce qui fait ici mon ervel embarras.
La nature, parfois;	La nature, parfois;
produit des reſſemblances, Dont quelques impoſteurs ont pris droit d’as buſer:	produit des ressemblances, Dont quelques imposteurs ont pris droit d'as buser:
Mais il eſt hors de ſens, que ſous ces apparences, Vn homme, pour Epoux, ſe puiſſe ſuppoſer;	Mais il est hors de sens, que sous ces apparences, Un homme, pour Époux, se puisse supposer;
Et dans tous ces rapports, ſont mille differences, Dont ſe peut vne femme aiſement auiſer.	Et dans tous ces rapports, sont mille différences, Dont se peut une femme aisément aviser.
Des charmes de la Theſſalie, On vente de tout temps les merueilleux effets;	Des charmes de la Thessalie, On vente de tout temps les merveilleux effets;
Mais les contes fameux, qui par tout en ſont faits, Dans mon eſprit toûjours, ont paſſé pour folie;	Mais les contes fameux, qui par tout en sont faits, Dans mon esprit toujours, ont passé pour folie;
Et ce ſeroit du ſort vne étrange rigueur.	Et ce serait du sort une étrange rigueur.
Qu’au ſortir d’vne ample victoire, Ie fuſſe contraint de les croire, Aux deſpens de mon propre honneur.	Qu'au sortir d'une ample victoire, Je fusse contraint de les croire, Aux dépens de mon propre honneur.
Ie veux la retâter ſur ce fâcheux myſtere;	Je veux la retâter sur ce fâcheux mystère;
Et voir ſi ce n’eſt point vne vaine chimere, Qui ſur ſes ſens troublez ait ſçeu prendre creAh!	Et voir si ce n'est point une vaine chimère, Qui sur ses sens troublés ait su prendre créh!
faſſe le Ciel équitable, Que ce penſer ſoit ve ritable;	fasse le Ciel équitable, Que ce penser soit vit ritable;
Et que, pour mon bon-heur, elle ait perdu *eiperts.	Et que, pour mon bonheur, elle ait perdu *éiperts.
SCENE II.	SCÈNE II.
MERCVRE, AMPHITRYON.	MERCURE, AMPHITRYON.
AMPHITRYON.	AMPHITRYON.
D’où vient donc qu'a cette heure on ferme cette porte.	D'où vient donc qu'a cette heure on ferme cette porte.
MERCVRE.	MERCURE.
Hola, tout douccinent;	Holà, tout douccinent;
qui frape?	qui frappe?
AMPHITRYON.	AMPHITRYON.
Mioy.	Mioi.
MERCVRE.	MERCURE.
Qui, moy?	Qui, moi?
AMPHITRYON.	AMPHITRYON.
Ah!	Ah!
ouure.	ouvre.
MERCVRE.	MERCURE.
Comment, cuure?	Comment, cuvre?
& qui de ne es-tu, toy;	et qui de ne es-tu, toi;
G iij Qui rais tant de ratarte, e parles de la forte?	G Gij Qui rais tant de ratarte, eu parles de la forte?
AMPHITRYON.	AMPHITRYON.
Quoy.	Quoi.
tu ne me connois pas?	tu ne me connais pas?
MERCVRE.	MERCURE.
Non, Et n’en ay pas la moindre enuie,	Non, Et n'en ai pas la moindre envie,
A MPHITRYON.	À MPHITRYON.
Tout le monde pend plaujpard idy la raiſon;	Tout le monde pend plaujpard idi la raison;
Eſt-ce vn mal répandu?	Est-ce un mal répandu?
Soſie, hola, Soſie.	Sosie, holà, Sosie.
MERCVRE.	MERCURE.
Hé bien, Soſie:	Hé bien, Sosie:
ouy, c’eſt mon nom As-tu peur que ie ne l’oublie?	oui, c'est mon nom As-tu peur que je ne l'oublie?
AMPHITRYON.	AMPHITRYON.
Me vois-tu bien?	Me vois-tu bien?
MERCVRE.	MERCURE.
port blen qui peut pouſſer ton bras A faire vne rumeur ſi grande!	port blen qui peut pousser ton bras À faire une rumeur si grande!
Et que de mandes-tu là-bas ?	Et que de mandes-tu là-bas ?
AMPHITRYON.	AMPHITRYON.
Moy, pendart, ce que je demande?	Moi, pendard, ce que je demande?
MERCVRE.	MERCURE.
Que ne demandes-tu donc pas?	Que ne demandes-tu donc pas?
Parle, ſi tu veux qu’on t’entende.	Parle, si tu veux qu'on t'entende.
AMPHITRYON.	AMPHITRYON.
Attens, traiſtre, auec vn baſton Ie vais là-haut me faïre entendre;	Attends, traître, avec un bâton Je vais là-haut me faïre entendre;
Et de bonne façon t’apprendre n moeei parler lur ce tons.	Et de bonne façon t'apprendre n moeei parler lur ce tons.
MERCVRE.	MERCURE.
Tout beau, ſi pour heurter, tu fais la moindre inſtance, Ie t’enuoyray d’icy des Meſſagèrs fâcheux.	Tout beau, si pour heurter, tu fais la moindre instance, Je t'enuoyray d'ici des Messagrs fâcheux.
AMmiC.	AMmiC.
O Ciel!	Ô Ciel!
Vit-on jamais vne telle inſolence!	Vit-on jamais une telle insolence!
Là peut-on conceuoir d’vn ſeruiteur, d’vn gueux?	Là peut-on concevoir d'un serviteur, d'un gueux?
MERCVRE.	MERCURE.
Hé bien!	Hé bien!
qu’eſt-ce?	qu'est-ce?
m’as-tu tout parcouru par ordre:	m'as-tu tout parcouru par ordre:
M’as-tu de tes gros yeux aſſez conſideré?	M'as-tu de tes gros yeux assez considéré?
Comme il les écarquille, & paroit éfaré!	Comme il les écarquille, et parait éfaré!
Si des regards on pouuoit mordre, Il m’auroit déja déchiré.	Si des regards on pouvait mordre, Il m'aurait déjà déchiré.
.	.
AMPHITRYON.	AMPHITRYON.
Moy meſme ie fremis, de ce que tu t’apreſtes, Auec ces impudens propos, Que tu groſſis ponr toy d’etroyables tempeſtes!	Moi -même ie fremis, de ce que tu t'aprêtes, Avec ces impudents propos, Que tu grossis ponr toi d'étroyables tempêtes!
Quels orages de coups vont fondre ſur ton dos!	Quels orages de coups vont fondre sur ton dos!
MERCVRE.	MERCURE.
L’amy, ſi de ces lieux tu ne veux diſparoiſtre, Tu pourras y gagner quelque contuſion.	L'ami, si de ces lieux tu ne veux disparaître, Tu pourras y gagner quelque contusion.
AMPHITRYON.	AMPHITRYON.
Ah!	Ah!
tu Içauras maraut, a ta confuſion, Ce que c’eſt qu’vn valet, qui s’attaque à ſon Maiſtre.	tu Içauras maraud, a ta confusion, Ce que c'est qu'un valet, qui s'attaque à son Maître.
MERCVRE.	MERCURE.
Toy mon Maiſtre?	Toi mon Maître?
A MIAIANTOI.	À MIAIANTOI.
Oüy coquin, m’oſes-tu méconnoiſtre!	Oui coquin, m'oses-tu méconnaître!
MERCVRE.	MERCURE.
Ie n’en reconnois point d’autre qu’Amphitryon.	Je n'en reconnais point d'autre qu'Amphitryon.
AMPHITRYON.	AMPHITRYON.
Et c’eſt Amphitryon, qui hors moy le peut  entie es	Et c'est Amphitryon, qui hors moi le peut entie es
Amphitryon?	Amphitryon?
MERCVRE.	MERCURE.
AMPHITRYON.	AMPHITRYON.
Sans doute.	Sans doute.
MERCVRE.	MERCURE.
Ah!	Ah!
quel le viſion !	quel le vision !
Dy-nous vn peu.	Dis-nous un peu.
Quel eſt le cabaret honneſte, Cuiotts tone re serueau?	Quel est le cabaret honnête, Cuiotts ton re veau?
AMPHITRYON.	AMPHITRYON.
Comment lencor!	Comment lencor!
MERCVRE.	MERCURE.
Eſtoit-ce vn vin à faire feſte?	Était-ce un vin à faire fête?
AMPHITRYON.	AMPHITRYON.
Ciel !	Ciel !
M IenReL.	M MenReL.
Eſtoit-il vieux, ou nouueau ?	Était-il vieux, ou nouveau ?
AMPHIIRYON.	AMPHIIRYON.
Que de coups!	Que de coups!
MERCVRE.	MERCURE.
Le nouueau donne fort dans la teſte, Quand on le veut boire ſans eau.	Le nouveau donne fort dans la tête, Quand on le veut boire sans eau.
AMPHITRYON.	AMPHITRYON.
Ah!	Ah!
je t’arracheray cette langue, ſans doute.	Je t'arracherai cette langue, sans doute.
MERCVRE.	MERCURE.
Paſſe mon cher amy, croy moy, Que quelqu’vn icy ne t’ecoute.	Passe mon cher ami, crois -moi, Que quelqu'un ici ne t'oute.
Ie reſpecte le vin:	Je respecte le vin:
va-t’en, retire-toy;	va-t-en, retire-toi;
Et laiſſe Amphitryon dans les plaiſirs qu’il goûte	Et laisse Amphitryon dans les plaisirs qu'il goûte
AMPHITRYON.	AMPHITRYON.
Comment!	Comment!
Amphitryon eſt-là dedans?	Amphitryon est-là dedans?
M ERCVRE.	M ERCURE.
Qui couuert des Lauriers d’vne victoire pleine, Eſt auprez de la belle Alcmene, A jouir des douceurs d’vn aimable entretien, Apres le demelé d’vn amoureux caprice, Ils gouſtent le plaiſir de s’eſtre rajuſtez.	Qui couvert des Lauriers d'une victoire pleine, Est auprez de la belle Alcène, A jouir des douceurs d'un aimable entretien, Après le demelé d'un amoureux caprice, Ils goûtent le plaisir de s'être rajustez.
Garde toy de troubler leurs douces priuautez.	Garde toi de troubler leurs douces privautés.
Si tu n'e veux qu’il ne puniſſe L’excez de tes temeritez.	Si tu n'e veux qu'il ne punisse L'excès de tes témérités.
OIII.	ÔII.
AMPHITRYON.	AMPHITRYON.
H!	H!
quel étrange coup m’a-t’il porté dans A l'Ame!	quel étrange coup m'a-t-il porté dans A l'Âme!
En quel trouble cruel, jette-t’il mon Eſprit?	En quel trouble cruel, jette-t-il mon Esprit?
Et ſi les choſes ſont, comme le Traiſtre dit, Oùvois-je icy reduits, mon Honneur & ma flame?	Et si les choses sont, comme le Traître dit, Oùvois-je ici réduits, mon Honneur et ma flamme?
A quel party me doit reſoudre ma raiſon?	À quel parti me doit résoudre ma raison?
Ay-je l’éclat, ou le ſecret à prendre?	Ai-je l'éclat, ou le secret à prendre?
Et dois-je en mon courroux renfermer ou teprendre Le des-honneur en ma maiſon?	Et dois-je en mon courroux renfermer ou teprendre Le déshonneur en ma maison?
Ah !	Ah !
faut-il conſulter dans vn affront ſi rude?	faut-il consulter dans un affront si rude?
de n'ej nen a pictendre, ce rrou a menager;	de n'éj nen a pictendre, ce rrou à ménager;
Et toute mon iuqui erude Ne doit aller qu’à me venger.	Et toute mon juqui erude Ne doit aller qu'à me venger.
SCENNE IV.	SCÈNE IV.
SOSIE, NAVCRATES, POLIDAS, AMPHITRYON.	SOSIE, NAUCRATES, POLIDAS, AMPHITRYON.
SOSIE.	SOSIE.
Onſieur, auec mes ſoins tout ce que j’ay M pû faire, C’eſt de vous amener ces Meſſieurs que voicy.	Onsieur, avec mes soins tout ce que j'ai M u faire, C'est de vous amener ces Messieurs que voici.
AMPHITRYON.	AMPHITRYON.
Ah!	Ah!
vous voila?	vous voilà?
SOSIE.	SOSIE.
Monſieur.	Monsieur.
AMPHITRYON.	AMPHITRYON.
Inſolent, temeraire.	Insolent, téméraire.
Quoy.	Quoi.
SOSIE.	SOSIE.
AAPHITRYON:	AAPHITRYON:
Ie vous apprendray de me traiter ainſi.	Je vous apprendrai de me traiter ainsi.
SOSIE.	SOSIE.
Qu’eſt-ce donc?	Qu'est-ce donc?
qu’auez-vous?	qu'avez-vous?
AMPHITRYON.	AMPHITRYON.
Ce que j’ay yiiiſerable?	Ce que j'ai yiisérable?
SOSIE.	SOSIE.
Hola, Memeurs, veneraone toſt,	Holà, Memeurs, veneraone tôt,
NAVC RATES.	NAUC RATES.
Ahi.	Ahi.
de grace arreſtez.	de grâce arrêtez.
SOSIE.	SOSIE.
Dequoy ſuis-je coupablel	Dequoy suis-je coupablel
AMPHITRYON.	AMPHITRYON.
Tu me le demandes, maraut?	Tu me le demandes, maraud?
Lulnez-moy ſatisfaire vn courroux Iegitime.	Lulnez-moi satisfaire un courroux Ségitime.
SOSIE.	SOSIE.
Lors que l’on pend quelqu’vn on luy dit pourquoy c’eſt.	Lors que l'on pend quelqu'un on lui dit pourquoi c'est.
NA CRMTES.	NA CRMTES.
Daignez-nous dire, au moins quel peut eſtre ſon crime.	Daignez-nous dire, au moins quel peut être son crime.
SOSIE.	SOSIE.
Meſſieurs, tenez bon, s’il vous plaît.	Messieurs, tenez bon, s'il vous plaît.
AMPHITRYON.	AMPHITRYON.
Comment, il vient d’auoir l’audace, De me fermer ma porte au nez?	Comment, il vient d'avoir l'audace, De me fermer ma porte au nez?
Et de joindre encor la menace A mille propos effrenez !	Et de joindre encor la menace À mille propos effréné !
Ah!	Ah!
coquin.	coquin.
SOSIE.	SOSIE.
Ie ſuis mort.	Je suis mort.
NAVCRATES.	NAUCRATES.
Calmez cette colere.	Calmez cette colère.
Meſſieurs.	Messieurs.
SOSIE.	SOSIE.
FOLIDAJ.	FOLIDAJ.
Qu'eſt ce?	Qu'est ce?
SOSIE.	SOSIE.
M'a-t’il frapé?	M'a-t-il frappé?
AMPHITRYON.	AMPHITRYON.
Non il faut qu’il ait le ſalaire Des mots, ou tout à l’heure, il s’eſt émancipé.	Non il faut qu'il ait le salaire Des mots, ou tout à l'heure, il s'est émancipé.
SOSIE.	SOSIE.
Comment cela ſe peut-il faire, Si j’eſtois par voſtre ordre autre part occupé?	Comment cela se peut-il faire, Si j'étais par votre ordre autre part occupé?
Ces Meſſieurs ſont icy, pour rendre témoig.	Ces Messieurs sont ici, pour rendre témoig.
nage, Qu'à diſner auec vous je les viens d’inuiter.	nage, Qu'à dîner avec vous je les viens d'inviter.
A AY ERIIEJ.	A AY ERIIEJ.
Il eſt vray qu’il nous vient de faire ce meſſaEt n’a point voulu nous quitter.	Il est vrai qu'il nous vient de faire ce messaEt n'a point voulu nous quitter.
AMPHITRYON.	AMPHITRYON.
Qui t’a donné cét ordre?	Qui t'a donné cet ordre?
SOSIE.	SOSIE.
Vous.	Vous.
Et quand?	Et quand?
AMPHITRYON.	AMPHITRYON.
SOSIE.	SOSIE.
Apres voſtre paix faite, Au milieu des tranſports d’vne ame ſatisfaite, D’auoir d’Alemene appaiſé le courrous.	Après votre paix faite, Au milieu des transports d'une âme satisfaite, D'avoir d'Alemène apaisé le courrous.
A MPHITRYON.	À MPHITRYON.
O Ciel!	Ô Ciel!
chaque inſtant, chaque pas, Ajoûte quelque choſe à mon cruel martyre!	chaque instant, chaque pas, Ajoute quelque chose à mon cruel martyre!
Et dans ce fatal embarras, Ie ne ſçay plus que croire, ny que dire.	Et dans ce fatal embarras, Je ne sais plus que croire, ni que dire.
NAVCRATES.	NAUCRATES.
Tout ce que de chez vous il vient de nous conter, Surpaſſe ſi fort la nature, Qu’auant que de rien faire, & de vous emporter, Vous deuez éclaircir toute cette auanture.	Tout ce que de chez vous il vient de nous conter, Surpasse si fort la nature, Qu'avant que de rien faire, et de vous emporter, Vous devez éclaircir toute cette aventure.
AMPHITRYON.	AMPHITRYON.
Allons, vous y pourrez ſeconder mon effort;	Allons, vous y pourrez seconder mon effort;
Et le Ciel à propos, icy vous a fait rendre.	Et le Ciel à propos, ici vous a fait rendre.
Voyons quelle fortune en ce iour peut m’attendre.	Voyons quelle fortune en ce jour peut m'attendre.
Débouillons ce myſtere, & ſçachons noſtre lal e.	Débouillons ce mystère, et sachons notre lal e.
Helas!	Hélas!
ie brûle de l’apprendre;	Ne brûle de l'apprendre;
Et je le crains plus que la mort !	Et je le crains plus que la mort !
DCENEVT IVPITER, AMPHITRION, NAVCRATES, POLIDAS,SOSIE.	DCENEUT IVPITER, AMPHITRYON, NAUCRATES, POLIDAS,SOTIE.
IVPITER.	IUPITER.
Vel bruit à deſcendre m’oblige?	Vel bruit à descendre m'oblige?
Et qui frape en Maiſtre ou ie ſuis?	Et qui frappe en Maître ou tu suis?
A MPHIT RYON.	À MPHIT RYON.
Que vois je juſtes Dieux!	Que vois je justes Dieux!
1	1
NAVCRATES.	NAUCRATES.
NAVCRATES.	NAUCRATES.
Ciel!	Ciel!
quel eſt-ce prodige!	quel est-ce prodige!
Quoy!	Quoi!
deux Amphittyons Icy nous ſont proAMPHITRYON.	deux Amphittyons Ici nous sont proAMPHITRYON.
[duits!	[duits!
Mon Ame demeure tranſic.	Mon Âme demeure transic.
Helas!	Hélas!
ie n’en puis plus;	Elle n'en puis plus;
l’auenture eſt à bout:	l'aventure est à bout:
EGenee 7 Et ce que ie voy, me dit tout.	EGenee 7 Et ce que je vois, me dit tout.
NAVCRATES.	NAUCRATES.
Plus mes regards ſur eux s’attachent fortement, Plus ie trouue qu’en tout, l’vn à l’autre eſt ſemblable.	Plus mes regards sur eux s'attachent fortement, Plus Seigneur trouve qu'en tout, l'un à l'autre est semblable.
SO DID.	SO DID.
Meſſieurs, voicy le veritable;	Messieurs, voici le véritable;
L’autre eſt vn impoſteur digne de châtiment.	L'autre est un imposteur digne de châtiment.
POLIDAS, Certes ce raport admirable, Suſpend icy mon jugement.	POLIDAS, Certes ce rapport admirable, Suspend ici mon jugement.
AMPHITRYON.	AMPHITRYON.
C’eſt trop eſtre eludez par vn fourbe execrable, Il faut auec ce fer, rompre l’enchantement.	C'est trop être éludez par un fourbe exécrable, Il faut avec ce fer, rompre l'enchantement.
Arreſtez.	Arrêtez.
NAV CRATES.	NAU CRATES.
AMPHITRYON.	AMPHITRYON.
Laiſſez-moy.	Laissez-moi.
NAVCRATES.	NAUCRATES.
Di eux!	Di eux!
que voulez-vous faire?	que voulez-vous faire?
AMPHITRYON.	AMPHITRYON.
Punir d’vn impoſteur les lâches trahiſons.	Punir d'unir d' unirons unes trahisons.
PITER.	PITER.
Tout beau l’emportement eſt fort peu neceſſaire;	Tout beau l'emportement est fort peu nécessaire;
Et lors que de la ſorte on ſe met en colere, On fait croite qu'on a de mauuanes raiſons.	Et lors que de la sorte on se met en colère, On fait croite qu'on a de mauvanes raisons.
OSIE.	OSIE.
Oüy, c’eſt vn Enchanteur, qui porte vn caractere, Pour reſſembler aux Maiſtres des Maiſons.	Oui, c'est un Enchanteur, qui porte un caractère, Pour ressembler aux Maîtres des Maisons.
A MPHITRYON.	À MPHITRYON.
Ie te feray pour ton partage, Sentir par mille coups, ces propos outrageans.	Je te ferai pour ton partage, Sentir par mille coups, ces propos outrageants.
SOSIE.	SOSIE.
Mon Maiſtre eſt homme de courage;	Mon Maître est homme de courage;
Et ne ſouffrira point, que l’on batte ſes gens.	Et ne souffrira point, que l'on batte ses gens.
AMPHITRYON.	AMPHITRYON.
Laiſſez-moy m’aſſouuir dans mon courroux extreme, Et lauer mon affront au ſang d’vn ſcelerat.	Laissez-moi m'assouvir dans mon courroux extrême, Et laver mon affront au sang d'un scélérat.
NAVCRAIES.	NAUCRAIES.
Nous ne ſouffrirons point cet étrange combat D’Amphitryon, contre luy-meſme.	Nous ne souffrirons point cet étrange combat D'Amphitryon, contre notre-même.
AMPHITRYON.	AMPHITRYON.
Quoy!	Quoi!
mon honneur, de vous, reçoit ce traitement ?	mon honneur, de vous, reçoit ce traitement ?
Et mes Amis, d’vn fourbe, embraſſant la déTente * Loin d’eſtre les premiers à prendre ma vengence, Eux-meſmes font obſtacle à mon reſſentiment?	Et mes Amis, d'une fourbe, embrassant la déTente * Loin d'être les premiers à prendre ma vengence, Eux-mêmes font obstacle à mon ressentiment?
NAVCRATES.	NAUCRATES.
Que voulez-vous qu’à cette veüe Faſſent nos reſolutions;	Que voulez-vous qu'à cette vue Fassent nos résolutions;
Lors que par deux Amphitryons, Toute noſtre chaleur demeure ſuſpenduë!	Lors que par deux Amphitryons, Toute notre chaleur demeure suspendue!
A vous faire éclater noſtre zele aujourd’huy, Nous craignons de faitlir & de vous inctonnoiſtre;	À vous faire éclater notre zèle aujourd'hui, Nous craignons de faitlir et de vous inctonnoistre;
Nous voyons bien en vous Amphitryon paroiſtre, Du ſalut des Thebains le glorieux appuy :	Nous voyons bien en vous Amphitryon paraître, Du salut des Thébains le glorieux appui :
Mais nous le voyons tous auſſi paroiſtre en luy;	Mais nous le voyons tous aussi paraître en Seigneur;
Et ne ſçaurions iuger dans lequel il peut eſtre.	Et ne saurions juger dans lequel il peut être.
Noſtre party n’eſt point douteux, Et l’impoſteur par nous doit mordre la pouſſiere :	Notre parti n'est point douteux, Et l'imposteur par nous doit mordre la poussière :
Mais ce par fait rapport le cache entre vous deux;	Mais ce par fait rapport le cache entre vous deux;
Et c’eſt vn coup trop hazardeux, Pour l’entreprendre ſans lumiere :	Et c'est un coup trop hasardeux, Pour l'entreprendre sans lumière :
Auec douceur laiſſez nous voir, De quel coſté peut eſtre l’impoſture;	Avec douceur laissez nous voir, De quel côté peut -être l'imposture;
Et dés que nous aurons démelé l’auanture, Il ne nous faudra point dire noſtre deuoir.	Et dès que nous aurons démelé l'aventure, Il ne nous faudra point dire notre devoir.
PITER.	PITER.
Oüy, vous auez raiſon:	Oui, vous avez raison:
Et cette reſſemblance, A douter de tous deux, vous peut authoriſer.	Et cette ressemblance, A douter de tous deux, vous peut autoriser.
Ie ne m’offence point de vous voir en balance:	Je ne m'offense point de vous voir en balance:
Ie ſuis plus raiſonnable, & ſçay vous excuſer.	Je suis plus raisonnable, et sais vous excuser.
L’œil ne peut entre nous faire de difference;	L'œil ne peut entre nous faire de différence;
Et je voy qu’aiſement on s’y peut abuſer.	Et je vois qu'aisément on s'y peut abuser.
Vous ne me voyez point témoigner de colere, Point mettre l’epée à la main.	Vous ne me voyez point témoigner de colère, Point mettre l'épée à la main.
C’eſt vn mauuais moyen d’éclaircir ce myſtere;	C'est un mauvais moyen d'éclaircir ce mystère;
Et j’en puis trouuer vn plus doux, & plus certain.	Et j'en puis trouver un plus doux, et plus certain.
L’vn de nous eſt Amphitryon;	L'un de nous est Amphitryon;
Et tous deux à vos yeux, nous le pouuons paroiſtre.	Et tous deux à vos yeux, nous le pouvons paraître.
C’eſt à moy de finir cette confuſion;	C'est à moi de finir cette confusion;
Et je prétens me faire à tous ſi bien coun viſtre L eſtre, Qu’aux preſſantes clartez de ce que ie puis Luy meſme ſoit d’accord du ſang qui m’a fait naiſtr,	Et je prétends me faire à tous si bien coun vite L être, Qu'aux pressantes clartés de ce que tu puis Lui même soit d'accord du sang qui m'a fait naîtr,
Il n’ait plus de rien dire aucune occaſion.	Il n'ait plus de rien dire aucune occasion.
C’eſt aux yeux des Thebains, que ie veux auce vous, De la verité pure, ouurir la connoiſſance;	C'est aux yeux des Thébains, que je veux auce vous, De la vérité pure, ouvrir la connaissance;
Et la choſe ſans douté eſt aſſez d’importance, Pour affecter la circonſtance, De l’eclaircir aux yeux de tous.	Et la chose sans douté est assez d'importance, Pour affecter la circonstance, De l'éclaircir aux yeux de tous.
Alcmene attend de moy ce public témoignage.	Alcène attend de moi ce public témoignage.
Sa vertu, que l’éclat de ce deſordre outrage, Veut qu’on la juſtifie, & j’en vais prendre ſoin.	Sa vertu, que l'éclat de ce désordre outrage, Veut qu'on la justifie, et j'en vais prendre soin.
C’eſt à quoy mon amour enuers elle m’engage;	C'est à quoi mon amour envers elle m'engage;
Et des plus nobles Chefs, ie fais vn aſſemblage, Pour l’éclairciſſement, dont ſa gloire a beſoin, Attendant auec vous ces témoins ſouhaitez, Myee, je vons plle , aglcabte De venir honnorer la Table Où vous a Soſie inuitez.	Et des plus nobles Chefs, on fais un assemblage, Pour l'éclaircissement, dont sa gloire a besoin, Attendant avec vous ces témoins souhaitez, Myee, je vons plèle , aglabte De venir honorer la Table Où vous a Sosie invitez.
SOSIE.	SOSIE.
Ie ne me trompois pas, Meſſieurs, ce mot termine Toute l’i rreſolution:	Je ne me trompais pas, Messieurs, ce mot termine Toute l'y résolution:
Le veritable Amphitryon, Eſt l’Amphitryon ou l’on diſne.	Le véritable Amphitryon, Est l'Amphitryon ou l'on dîne.
AMPHITRYON.	AMPHITRYON.
O Ciel!	Ô Ciel!
puis-je plus bas me voir humilié!	puis-je plus bas me voir humilié!
Quoy!	Quoi!
faut-il que j’entende icy, pour mon martyre, Toue ce que limponteur;	faut-il que j'entende ici, pour mon martyre, Toue ce que limponteur;
à mes yeux vient de dire;	à mes yeux vient de dire;
Et que dans la fureur, que ce diſcours m’inſpire, On me tienne le bras lié!	Et que dans la fureur, que ce discours m'inspire, On me tienne le bras ié!
NAVCRATES.	NAUCRATES.
Vous vous plaignez à tort.	Vous vous plaignez à tort.
Permettez-nous d’attendre,	Permettez-nous d'attendre,
L’éclaireiſſement, qui doit rendre Les reſſentimens de ſaiſon.	L'éclaireissement, qui doit rendre Les ressentiments de saison.
Ie ne ſçay pas s’il impoſe:	Je ne sais pas s'il impose:
Mais il parle ſur la choſe, Comme s’il auoit raiſon.	Mais il parle sur la chose, Comme s'il avait raison.
AMPHITRYON.	AMPHITRYON.
Allez, foibles Amys, & flatez l’impoſture.	Allez, faibles Amis, et flattez l'imposture.
Thebes en a pour moy de tout autres que vous:	Thebes en a pour moi de tout autres que vous:
Et le vais en trouuer, qui partageanc l’injure, Sçauront preſter la main à mon juſte courroux.	Et le vais en trouver, qui partageanc l'injure, Sauront prêter la main à mon juste courroux.
IVPITER.	IUPITER.
He bien, je les attens;	He bien, je les attends;
& ſçauray décider Le differend en leur preſence.	et saurai décider Le différend en leur présence.
AMPHITRYON.	AMPHITRYON.
Fourbe, tu crois par-là peut-eſtre t’éuader:	Fourbe, tu crois par-là peut-être t'évader:
Mais rien ne te ſçauroit ſauuer de ma venIVPITER.	Mais rien ne te saurait sauver de ma venIVPITER.
Igeance,	Igeance,
A ces injurieux propos le ne daigne à preſent reſpondre;	À ces injurieux propos le ne daigne à présent répondre;
Et tantoſt je ſçauray confondre Cette fureur, auec deux mots.	Et tantôt je saurai confondre Cette fureur, avec deux mots.
a MI IIIERIOI.	à MI IIERIOI.
Le Ciel meſme, le Ciel, ne t’y ſçauroit ſouſtraire:	Le Ciel même, le Ciel, ne t'y saurait soustraire:
Et juſques aux Enſers j’tray ſuiure tes pas.	Et jusques aux Ensers j'ai suivre tes pas.
VPITER.	VPITER.
Il ne ſera pas neceſſaire, Et l’on verra tantoſt, que ie ne fuïray pas.	Il ne sera pas nécessaire, Et l'on verra tantôt, que tu ne fuirai pas.
A Mll IIlalo iCo Allons, courons, auant que d’auec eux il ſorte, Aſſembler des Amis qui ſuiuent mon courroux, Et chez moy venons à main forte Pour le percer de mille coups.	À Mll IIlalo iCo Allons, courons, avant que d'avec eux il sorte, Assembler des Amis qui suivent mon courroux, Et chez moi venons à main forte Pour le percer de mille coups.
IVPITER.	IUPITER.
Point de façons, je vous corjure H ii.	Point de façons, je vous corjure H ji.
mmdrond viue duuin ra uiailon,	mémdrond vive duvin ra uiailon,
NAVCRATES.	NAUCRATES.
Certes, toute cette auanture Confond le ſens, & la raiſou.	Certes, toute cette aventure Confond le sens, et la raisou.
OSIE.	OSIE.
Faites tréue, Meſſieurs, à toutes vos ſurpriſes;	Faites trêve, Messieurs, à toutes vos surprises;
Et pleins de joye, alloz tabler juſqu’à demain, Que je vais m’en donner!	Et pleins de joie, alloz tabler jusqu'à demain, Que je vais m'en donner!
& me mettre en be au train, De raconter mes vaillantiſes!	et me mettre en be au train, De raconter mes vaillantises!
Ie brûle d’en venir aux priſes;	Je brûle d'en venir aux prises;
Et jamais ie n’eus tant de faim.	Et jamais ici n'eus tant de faim.
SCENEVI.	SCENEVI.
MERCVRE, SOSIE.	MERCURE, SOSIE.
MERCVRE.	MERCURE.
Rreſte.	Rrête.
Quoy!	Quoi!
tu viens icy mettre ton nez, A Impudent fleureur de cuiſine?	tu viens ici mettre ton nez, A Impudent fleureur de cuisine?
SOSIE.	SOSIE.
Ah!	Ah!
de grace, tout doux.	de grâce, tout doux.
MERCVRE.	MERCURE.
Ah!	Ah!
vous y retournez, Ie vous ajuſteray l’échine.	vous y retournez, Je vous ajusterai l'échine.
SOSIE.	SOSIE.
Helas!	Hélas!
braue, & genereux Moy, Modere toy, ie t’en ſupplie, Soſie, épagne vn peu Soſie;	brave, et généreux Moi, Modere toi, tu t'en supplie, Sosie, épagne un peu Sosie;
Et ne te plais point tant à fraper deſſus toy.	Et ne te plais point tant à frapper dessus toi.
MERCVRE.	MERCURE.
Qui de t’appeller de ce nom, A pu te donner la licence!	Qui de t'appeler de ce nom, A pu te donner la licence!
Ne t’en ay-je pas fait vne expreſſe de ffence, Sous peine d’eſſuyer mille coups de Baſton?	Ne t'en ai-je pas fait une expresse de sensé, Sous peine d'essuyer mille coups de Bâton?
SOSIE.	SOSIE.
C’eſt vn nom que tous deux nous pouuons à la fois, Poſſeder ſous vn meſme Maiſtre.	C'est un nom que tous deux nous pouvons à la fois, Posséder sous un autre Maître.
Tour Soſie en tous lieux, on ſçait me reconnoiſtre :	Tour Sosie en tous lieux, on sais me reconnaître :
Ie ſouffre bien que tu le ſois;	Je souffre bien que tu le sois;
Souffre auſſi, que ie le puiſſe eſtre.	Souffre aussi, que ainsi le puisse être.
Laiſſons aux deux Amphitryons, Palle ccrater aea juiouncs, Et parmy leurs contentions, Faiſons en bonne paix, viure les deux Soſies.	Laissons aux deux Amphitryons, Palle ccrater a juiouncs, Et parmi leurs contentions, Faisons en bonne paix, vivre les deux Sosies.
MERCVRE.	MERCURE.
Non, c’eſt aſſez d’vn ſeul, & je ſuis obſtiné, emne pome ſuunemuepartage.	Non, c'est assez d'un seul, et je suis obstiné, emne pome suunemuepartage.
SOSIE.	SOSIE.
Du pas deuant, ſur moy, tu prendras l’auantage, le ſeray le cadet, & tu ſeras l’aiſné.	Du pas devant, sur moi, tu prendras l'avantage, le serai le cadet, et tu seras l'aîné.
MERCVRE.	MERCURE.
Non, vn frere incommode, & n’eſt pas de mon gouſt, Et je veux eſtre fils vnique.	Non, un frère incommode, et n'est pas de mon goût, Et je veux être fils unique.
O dla re.	Ô dla re.
O cœur barbare & yr annique !	Ô cœur barbare et yr annique !
Souffte qu’au moius ie ſois ton ombre.	Souffte qu'au moius un sois ton ombre.
MERCVRE.	MERCURE.
Point du tout.	Point du tout.
SOSIE.	SOSIE.
Que d’vn peu de pitié ton Ame s’humaniſe.	Que d'un peu de pitié ton Âme s'humanise.
En cette qualité ſouffre moy prés de toy?	En cette qualité souffre moi près de toi?
Ie te ſeray par tout vne ombre ſi ſoumiſe, Que ta leras content de moy.	Je te serai par tout une ombre si soumise, Que ta leras content de moi.
MERCVRE.	MERCURE.
Point de quartier:	Point de quartier:
immuable eſt la loy.	immuable est la loi.
Si d’entrer la-dedans, tu prens, encor l’audace, Mille coups en ſeront le fruit.	Si d'entrer la-dedans, tu prends, encor l'audace, Mille coups en seront le fruit.
SOSIE.	SOSIE.
nud l u qu'ele etrange aigrace Pauure Soſie es-tu reduit?	nud l u qu'èle étrange aigrace Pauvre Sosie ès-tu réduit?
MERCVRE.	MERCURE.
Quoy!	Quoi!
ta bouche ſe licencie, A te donner encor vn nom, que je défens.	ta bouche se licencie, À te donner encor nom, que je défends.
SOSIE.	SOSIE.
Non ce n’eſt pas moy que j’entens;	Non ce n'est pas moi que j'entends;
Et je parle d’vn vieux Soſie, Qur lut jauis de mes parens, Qu’auec tres grande Barbarie, A l’heure du diſné l’on chaſſa de ceans.	Et je parle d'un vieux Sosie, Qur lut javis de mes parents, Qu'avec très grande Barbarie, A l'heure du dîné l'on chassa de céans.
MERCVRE.	MERCURE.
Prens garde de tomber dans cette freneſie;	Prends garde de tomber dans cette frénésie;
Si tu veux demeurer au nombre des viuans.	Si tu veux demeurer au nombre des vivants.
SOSIE.	SOSIE.
Que je te roſſerois, il pauois du courage, Double fils-de-Putain, de trop d’orgueil enflé!	Que je te rosserais, il pavais du courage, Double fils-Pain, de trop d'orgueil enflé!
Que dis-tu?	Que dis-tu?
MERCVRE.	MERCURE.
SOSIE.	SOSIE.
Percir.	Percir.
MERCVRE.	MERCURE.
Tu tiens, ie croy quelque langage.	Tu tiens, Seigneur crois quelque langage.
OSIE.	OSIE.
Demandez ie n’ay pas ſoufflé.	Demandez esprit n'ai pas soufflé.
MERCVRE.	MERCURE.
Certain mot de fiis-de-Putain, A pourtant frapé mon oreille:	Certain mot de fiis-de-Putain, A pourtant frappé mon oreille:
nn ent tren de paa calaine	nn ent tren de pa calaine
SOSIE.	SOSIE.
C’eſt donc vn perroquet que le beau temps réueille.	C'est donc un perroquet que le beau temps réveille.
MERCVRE.	MERCURE.
Adieu lors que le dos pourra te démanger, Voila l’endroit où je demeure.	Adieu lors que le dos pourra te démanger, Voilà l'endroit où je demeure.
SOSIE.	SOSIE.
Ciel!	Ciel!
que l’heure de manger, Pour eſtre mis dehors, eſt vne maudite heure:	que l'heure de manger, Pour être mis dehors, est une maudite heure:
Allons, cedons au ſort dans noſtre affliction.	Allons, cédons au sort dans notre affliction.
Suiuons-en aujourd’huy l’aueugle fantaiſie;	Suivons-en aujourd'hui l'aveugle fantaisie;
Et par vne juſte vnion, toiguons le Maincarean vore , Au malheureux Amphitryon.	Et par une juste toujours, toiguons le Maincarean vore , Au malheureux Amphitryon.
SCENE VII.	SCÈNE VII.
AMPHITRYON, ARGATIPHONTIDAS, POSICLES, SOSIE.	AMPHITRYON, ARGATIPHONTIDAS, POSICLES, SOSIE.
AMPHITRYON.	AMPHITRYON.
Rreſtez-là, Meſſieurs, ſuiuez nous d’vn A peu loin;	Rrestez-là, Messieurs, suivez nous d'un A peu loin;
De fudanecz tous, le vous pne s Que quand il en ſera beſoin.	De fudanecz tous, le vous pie d Que quand il en sera besoin.
POSICLES.	POSICLES.
Ie comprens que ce coup doit fort toucher voſtre Ame.	Je comprends que ce coup doit fort toucher votre Âme.
AMPHITRYON.	AMPHITRYON.
Ah!	Ah!
de tous les coſtez, mortelle eſt ma douleur !	de tous les côtés, mortelle est ma douleur !
Et je ſouffre pour ma flame, Autune que pour mon nonneur.	Et je souffre pour ma flamme, Autune que pour mon nonneur.
POSICLES, Si cette reſſemblance eſt telle que l’on dit, Alcmene, ſans eſtre coupable.	POSICLES, Si cette ressemblance est telle que l'on dit, Alcène, sans être coupable.
AMPHITRYON.	AMPHITRYON.
Ah!	Ah!
ſur le fait dont il s’agit, L’erreur ſimple deuient vn crime veritable, Et ſans conſentement, l’innocence y perit.	sur le fait dont il s'agit, L'erreur simple devient un crime véritable, Et sans consentement, l'innocence y périt.
De ſemblables erreurs, quelque iour qu’on leur donne, Touchent des endroits delicats:	De semblables erreurs, quelque jour qu'on leur donne, Touchent des endroits délicats:
Et la raiſon bre rrenuene lee paruonne;	Et la raison bre rrenuene lee parvonne;
Que l’Honneur, & l’Amour, ne les pardonnent pas.	Que l'Honneur, et l'Amour, ne les pardonnent pas.
ARGATIPHONTIDAS.	ARGATIPHONTIDAS.
Je n’embarraſſe point là-dedans ma penſée:	Je n'embarrasse point là-dedans ma pensée:
Mais je hais vos Meſſieurs, de leurs honteux delais;	Mais je hais vos Messieurs, de leurs honteux délais;
Et c’eſt vn procedé dont j’ay l’ame bleſſée;	Et c'est un procédé dont j'ai l'âme blessée;
Et que les gens de cœur n’aprouueront jamais, Quand quelqu’vn nous employe, on doit, teſte baiſſée, Se jetter dans ſes intereſts.	Et que les gens de cœur n'approuveront jamais, Quand quelqu'un nous emploie, on doit, tête baissée, Se jeter dans ses intérêts.
Argatiphontidas ne va point aux accords.	Argatiphontidas ne va point aux accords.
Ecouter d’vn Amy raiſonner l’auerſaire, Pour des Hommes d’honneur, n’eſt point vn coup à faire:	Écouter d'un Ami raisonner l'aversaire, Pour des Hommes d'honneur, n'est point un coup à faire:
Il ne faut écouter que la vengeance alors.	Il ne faut écouter que la vengeance alors.
Le Procez ne me ſçauroit plaire;	Le Procès ne me saurait plaire;
Et l’on doit commancer toûjours dans ſes tranſports, Par bailler, ſans aueun Myſtere, De l’épée au trauers du corps.	Et l'on doit commencer toujours dans ses transports, Par bailler, sans aveun Mystère, De l'épée au travers du corps.
Oüy vous verrez, quoy qu’il auienne, Qu’Argatiphontidas marche droit ſur ce point;	Oui vous verrez, quoi qu’il avienne, Qu'Argatiphontidas marche droit sur ce point;
Et de vous il faut que j’obtienne, Que le pendart ne meure point, D’vne autre main, que de la mienne.	Et de vous il faut que j'obtienne, Que le pendard ne meure point, D'une autre main, que de la mienne.
Allons.	Allons.
AMPHITRYON.	AMPHITRYON.
SOSIE.	SOSIE.
Ie viens, Monſieur, ſubir à vos genoux, Le juſte châtiment d’vne audace maudite.	Je viens, Monsieur, subir à vos genoux, Le juste châtiment d'une audace maudite.
Frapez, battez, chargez, accablez-moy de coups;	Frappez, battez, chargez, accablez-moi de coups;
Tuez-moy dans voſtre courroux:	Tuez-moi dans votre courroux:
Vous fairez bien ie le merite:	Vous fairez bien beau le mérite:
Et ie n'en drruy pas vir ieur mot contre vous,	Et ici n'en drui pas vir jeur mot contre vous,
AMPHITRYON.	AMPHITRYON.
Leue-toy, Que fait-on?	Leve-toi, Que fait-on?
SOSIE.	SOSIE.
L’on ma chaſſé tout net:	L'on ma chassé tout net:
Et croyant à manger, m’aller, comme eux ébattre;	Et croyant à manger, m'aller, comme eux ébattre;
Ie ne ſongeois pas qu’en effet.	Je ne songeais pas qu'en effet.
Ie m’attendois-là pour me battre.	Je m'attendais-là pour me battre.
oüy, l’autre moy, valet de l’autre vous, a fait Tout de nouueau, le Diable à quatre.	oui, l'autre moi, valet de l'autre vous, a fait Tout de nouveau, le Diable à quatre.
La rigueur d’vn pareil deſtin, Monſieur, aujourd’huy hous talonne, Et l’on me Des-ſoſie enfin, Comme on vous Des-Amphitryonne.	La rigueur d'Han pareil destin, Monsieur, aujourd'hui hous talonne, Et l'on me Des-sosie enfin, Comme on vous Des-Amphitryonne.
Suy-moy.	Sui-moi.
AMPHITRYON.	AMPHITRYON.
SOSIE.	SOSIE.
N’eſt-il pas mieux, de voir s’il vient perſonne.	N'est-il pas mieux, de voir s'il vient personne.
SCENE VIII.	SCÈNE VIII.
CLEANTHIS, NAVCRATES, POLIDAS, SOSIE, AMPHITRYON, ARGATIPHONTIDAS POSTCLES.	CLEANTHIS, NAUCRATES, POLIDAS, SOSIE, AMPHITRYON, ARGATIPHONTIDAS POSTCLES.
CLEATHIS.	CLÉTHIS.
Ciel !	Ciel !
1 AMIHIIRION.	1 AMIHIRION.
Qui t’épouuante ainfi?	Qui t'épouvante ainsi?
Quelle eſt la peur, que ie t’inſptte?	Quelle est la peur, que ici t'insptte?
CLEANTHIS.	CLÉANTHIS.
Las lvous eſtez l'àvhaut, & je vous vois icy!	Las lvous estez l'àvhaut, et je vous vois ici!
YAVCRATES.	YAUCRATES.
Ne vous preſſez point, le voicy, Pour donner deuant tous, les clartez, qu’on deſire;	Ne vous pressez point, le voici, Pour donner devant tous, les clartés, qu'on désire;
Et qui, ſi l’on peut croire à ce qu’il vient de dire, Sçauront vous affranchir de trouble, & de ſoucy.	Et qui, si l'on peut croire à ce qu'il vient de dire, Sauront vous affranchir de trouble, et de souci.
1 20	1 20
SCENE	SCÈNE
SCENE IX.	SCÈNE IX.
MERCVRE, CLEANTHIS NAVCRATES, POLIDAS, SOSIE, AMPHITRYON, ARGATIPHONTIDAS, POSICLES.	MERCURE, CLÉANTHIS NAUCRATES, POLIDAS, SOSIE, AMPHITRYON, ARGATIPHONTIDAS, POSICLES.
MERCVRE.	MERCURE.
Vy vous l’allez voir tous:	Vi vous l'allez voir tous:
& ſçachez, par O auance, Que c’eſt le grand Maiſtre des Dieux;	et sachez, par Ô avance, Que c'est le grand Maître des Dieux;
Que ſous les traits cheris de cette reſſemblance;	Que sous les traits chéris de cette ressemblance;
Alcmene a fait, du Ciel, deſcendre dans ces li eux.	Alcène a fait, du Ciel, descendre dans ces li eux.
Et quand à moy, je ſuis Mercure, Qui ne ſçachant que faire, ay roſſé tant ſoit peu, Celuy, dont j’ay pris la figure :	Et quand à moi, je suis Mercure, Qui ne sachant que faire, ai rossé tant soit peu, Celui, dont j'ai pris la figure :
Mais de s’en conſoler, il a maintenant lieu, Et les coups de baſton d’vn Dieu, Font honneur à qui les endure.	Mais de s'en consoler, il a maintenant lieu, Et les coups de bâton d'un Dieu, Font honneur à qui les endure.
SOSIE.	SOSIE.
Ma foy, Monſieur le Dieu je ſuis voſtre valet, Ie me ſerois paſſé de voſtre fantaiſie.	Ma foi, Monsieur le Dieu je suis votre valet, Je me serais passé de votre fantaisie.
M ERCVRE.	M ERCURE.
Ie luy donne à preſent congé d’eſtre Soſie, Ie ſuis las de porter vn viſage ſi laid;	Je lui donne à présent congé d'être Sosie, Je suis las de porter un visage si laid;
Et je m’en vais au Ciel, auec de l’Ambroiſie, Il vole M’en débarbouiller tout à fait.	Et je m'en vais au Ciel, avec de l'Ambroisie, Il vole M'en débarbouiller tout à fait.
dans le ciel.	dans le ciel.
SOSIE.	SOSIE.
Le Ciel, de m’approcher, t’oſte à jamais l’enuie, Ta fureur s’eſt par trop acharnée apres moy:	Le Ciel, de m'approcher, t'ôte à jamais l'envie, Ta fureur s'est par trop acharnée après moi:
Et je ne vis de ma vie, Vn Dieu paur Drable que toy.	Et je ne vis de ma vie, Un Dieu paur Able que toi.
SCENE X.	SCÈNE X.
IVPITER, CLEANTHIS, NAVCRATES, POLIDAS, SOSIE, AMPHTIRYON, ARGATIPHONTIDAS, POSICLES.	IUPITER, CLÉANTHIS, NAUCRATES, POLIDAS, SOSIE, AMPHTIRYON, ARGATIPHONTIDAS, POSICLES.
VPITER.	VPITER.
Dans vne nuë.	Dans une nue.
Egarde, Amphitryon, quel eſt ton impoR ſteur;	Egarde, Amphitryon, quel est ton impoR steur;
Et ſous tes propres traits, voy Iupiter paroiſtre, A ces marques, tu peux aiſement le connoiſtre;	Et sous tes propres traits, vois Jupiter paraître, À ces marques, tu peux aisément le connaître;
Et c’eſt aſſez, je croy, pour remettre ton cœur Dans l’eſtat auquel il doit eſtre, Et rétablir chez toy, la paix & la douceur.	Et c'est assez, je crois, pour remettre ton cœur Dans l'état auquel il doit être, Et rétablir chez toi, la paix et la douceur.
Mon nom, qu’inceſſamment toute la terre adore, Etouffe icy les bruits, qui pouuoient éclater.	Mon nom, qu'incessamment toute la terre adore, Étouffe ici les bruits, qui pouvaient éclater.
Vn partage auec Iupiter, N’a rien du tout qui des-honnore:	Un partage Ju Piter, N'a rien du tout qui déshonore:
Et fans doute, il ne peut eſtre que glorieux, De ſe voir le Rruar du Sotiuerain des Dleux, Ie m’y vois pour ta flame, aucun lieu de murmure;	Et sans doute, il ne peut être que glorieux, De se voir le Ruar du Sotiuerain des Dleux, Je m'y vois pour ta flamme, aucun lieu de murmure;
Et c’eſt moy, dans cette auanture, Qui tout Dieu que ie ſuis, dois eſtre le jaloux.	Et c'est moi, dans cette aventure, Qui tout Dieu que je suis, dois été le jaloux.
Alcmene eſt toute à toy, quelque ſoin qu’on employe;	Alcène est toute à toi, quelque soin qu'on emploie;
Et ce doit à tes feux eſtre vn objet bien doux, De voir que pour luy plaire, il n’eſt point d’autre voye, Que de paroiſtre ſon Epoux.	Et ce doit à tes feux être un objet bien doux, De voir que pour lui plaire, il n'est point d'autre voie, Que de paraître son Époux.
Que Iupiter orné de ſa gloire immortelle, Par luy meſme, n’a pû triompher de ſa foy;	Que Jupiter orné de sa gloire immortelle, Par Ah même, n'a pu triompher de sa foi;
Et ce qu’il a receu d’elle, N’a par ſon cœur ardent eſté donné qu’à toy.	Et ce qu'il a reçu d'elle, N'a par son cœur ardent été donné qu'à toi.
SOSIE.	SOSIE.
Le Seigneur Iupiter ſçait dorer la pillule.	Le Seigneur Jupiter sais dorer la pillule.
PITER.	PITER.
Sors donc des noirs chagrins, que ton cœur a ſoufferts;	Sors donc des noirs chagrins, que ton cœur a soufferts;
Et rends le calme entier à l’ardeur qui te brûle.	Et rends le calme entier à l'ardeur qui te brûle.
Chez toy, doit naiſtre vn fils qui ſous le nom d’Hercule, Remplira de ſes faits, tout le vaſte Vniuers.	Chez toi, doit naître un fils qui sous le nom d'Hercule, Remplira de ses faits, tout le vaste Univers.
L’eclat d’vne fortune, en mille biens feconde, Faira connoiſtre à tous, que ie ſuis ton ſupport;	L'éclat d'une fortune, en mille biens féconde, Faira connaître à tous, que ie suis ton support;
Et je mettray tout le monde Au point d’enuier ton ſort, Tu peux hardiment te flâter De ces siperances donneco, C’eſt vn crime d’en douter, Les paroles de lupiter, Sont des Atreſts des deſtinées.	Et je mettrai tout le monde Au point d'envier ton sort, Tu peux hardiment te flatter De ces sipérances donneco, C'est un crime d'en douter, Les paroles de lupiter, Sont des Atrêts des destinées.
Il ſe pert dans les Nuës.	Il se pert dans les Nues.
NAVCRATES.	NAUCRATES.
Certes ie ſuis rauy de ces marques brillantes.	Certes Princes suis ravi de ces marques brillantes.
OSIE.	OSIE.
Meſſieurs, voulez vous bien ſuiure mes ſentimens?	Messieurs, voulez -vous bien suivre mes sentiments?
Ne vous embarquez nullement, Dans ces douceurs congratulantes, C’eſt vn mauuais embarquement :	Ne vous embarquez nullement, Dans ces douceurs congratulantes, C'est un mauvais embarquement :
Et d’vne & d’autre part pour vn tel compliment, Les Phraſes ſont embaraſſantes, Le grand Dreu Iupiter nous ſait beaucoup d’honneur;	Et d'une et d'autre part pour un tel compliment, Les Phrases sont embarrassantes, Le grand Dév Jupiter nous sait beaucoup d'honneur;
Et ſa bonté ſans doute, eſt pour nous ſans ſeconde:	Et sa bonté sans doute, est pour nous sans seconde:
Il nous promet l’infaillible bon-heur, D’vne fortune en mille biens feconde;	Il nous promet l'infaillible bonheur, D'une fortune en mille biens éconde;
Et chez nous il doit naiſtre vn fils d’vn tres grand cœur, Tout cela va le mieux du monde.	Et chez nous il doit naître un fils d'un très grand cœur, Tout cela va le mieux du monde.
Mais enfin coupons au diſcours;	Mais enfin coupons au discours;
Et que chacun chez ſoy, doucement ſe retire, Sur telles affaires ioûjours, Le meilleur eſt de ne rien dire.	Et que chacun chez soi, doucement se retire, Sur telles affaires toujours, Le meilleur est de ne rien dire.
FIN.	FIN.
