DOM PEDRE, Roy d’Aragon.	DOM PÉDRE, Roi d'Aragon.
L’INFANTE, ſa ſœur, Maiſtreſſe de DomBernard.	L'INFANTE, sa sœur, Maîtresse de DomBernard.
IGNES,	IGNÉS,
DOM	DOM
N TDERIVIIRE E TIDNENE TRAGI-COMEDIE.	 NDERIVIIRE E TIDNENE TRAGI-COMÉDIE.
1 E I L SCENE IREMIERE.	1 Y I L CÈNE IREMIERE.
D.	D.
LOPE DE LVNE.	LOPE DE LUNE.
LAZARILLE Valet de chambre.	LAZARILLE Valet de chambre.
D.	D.
LOPE.	LOPE.
NFIN, cher Lazarille, vn plut heureux Genie MNN Nous va, de nos deſtins, forcer la tirannie, Et ce bras l’aura miſe au rang des ennemis, Qu'au ioug de cét Eſtat ſes exploits ont ſouſmis.	NFIN, cher Lazarille, un plut heureux Génie MN Nous va, de nos destins, forcer la tyrannie, Et ce bras l'aura mise au rang des ennemis, Qu'au joug de cet État ses exploits ont sousmis.
A D.	À D.
Bernard rend au Prince vn digne témoignage Des fruits qu’à l’Arragon a produits mõcourage, Qui fera ſucceder l’eſpoir que ie baſtis, Sur la deſtruction des Sardes déconfis;	Bernard rend au Prince un digne témoignage Des fruits qu'à l'Aragon a produits moncourage, Qui fera succéder l'espoir que sans bâtis, Sur la destruction des Sardes déconfis;
Oüy, i’oze ſur l’eſpoirque Dom Bernard me donne, Pretendre à des degrés proches de la Couronne;	Oui, j'ose sur l'espoirque Dom Bernard me donne, Prétendre à des degrès proches de la Couronne;
Et ſi l’ame eſt prophete en ſes preſſentiments, De grands effets ſuiuront ces nobles mouuements, Qui ne me flattent pas d’vne faueur commune, Et me font deffier l’orgueil de la fortune.	Et si l'âme est prophète en ses pressentiments, De grands effets suivront ces nobles mouvements, Qui ne me flattent pas d'une faveur commune, Et me font défier l'orgueil de la fortune.
LAZARILLE.	LAZARILLE.
Le fatal aſcendant qui gouuerne vos iours, Sera donc bien changé, de ce qu’il fut touſiours;	Le fatal ascendant qui gouverne vos jours, Sera donc bien changé, de ce qu'il fut toujours;
Car depuis qu'à vos pas mon mauuais ſort m'attache, Le malheur qui vous ſuit, n’a guiere eu de relaſche.	Car depuis qu'à vos pas mon mauvais sort m'attache, Le malheur qui vous suit, n'a guière eu de relâche.
D.	D.
LOPE.	LOPE.
Il eſt vray que iamais les deſtins rigoureux N’ont rendu ſous le ciel, de iours plus malheureux;	Il est vrai que jamais les destins rigoureux N'ont rendu sous le ciel, de jours plus malheureux;
Et que touts les reuers du ſort & de l’enuie, Semblent pour ſeul objet auoir choiſi ma vie.	Et que touts les revers du sort et de l'envie, Semblent pour seul objet avoir choisi ma vie.
Mes plus heureux ſuccés n’ont iamais veu ce bras, Sans me couſter du ſang, acheuer de combats;	Mes plus heureux succès n'ont jamais vu ce bras, Sans me coûter du sang, achever de combats;
Mes plus iuſtes deſſeins n’ont iamais eu d’iſfuë Qui rempliſt mon attente, où qui ne l’ayt deceuë.	Mes plus justes desseins n'ont jamais eu d'issue Qui remplît mon attente, où qui ne l'ait déçue.
Ie ſuis encor à voir le ſeul, & premier fruict Que iamais, ou l’amour, ou le ieu m’ait produit.	Je suis encor à voir le seul, et premier fruit Que jamais, ou l'amour, ou le jeu m'ait produit.
I'eſperois à la Cour, vaincre par ma conſtance, De cet aſtre inclement la maligne influence, Quand auec Dom Bernard, Catalan comme moy.	J'espérais à la Cour, vaincre par ma constance, De cet astre inclément la maligne influence, Quand avec Dom Bernard, Catalan comme moi.
Ie veins auec mes vœux, offrir monbras au Roy, Et comme à la valeur, qui m’eſt hereditaire, Chercher à ſucceder aux emplois de mon pere;	Je veins avec mes vœux, offrir monbras au Roi, Et comme à la valeur, qui m'est héréditaire, Chercher à succéder aux emplois de mon père;
Mais touſiours quelque obſtacle arreſtant mes deſſeins, Pour moy fermoit au Prince, & l’oreille, & les mains:	Mais toujours quelque obstacle arrêtant mes desseins, Pour moi fermait au Prince, et l'oreille, et les mains:
Au lieu qu’vne fortune à mille autres ſeconde;	Au lieu qu'une fortune à mille autres seconde;
Mais à qui Dom Bernard, n’a rien qui ne répõde) D’abord l’inſinuant, en l’eſtime du Roy Ouuroit touſiours pour luy, ce qu’il fermoit pour moy, Miſt bien- toſt ce grand homme, au plus haut de ſa roué;	Mais à qui Dom Bernard, n'a rien qui ne répondait toujours D'abord l'insinuant, en l'estime du Roy Ouvrait toujours pour lui, ce qu'il fermait pour moi, Mît bien- tôt ce grand homme, au plus haut de sa roué;
Et l’eſleuant ſi haut, me laiſſa dans la bouë.	Et l'élevant si haut, me laissa dans la boue.
Enfin, ayant acquis, par nos communs tributs, Luy de telles faueurs, moy de ſi longs rebuts;	Enfin, ayant acquis, par nos communs tributs, Lui de telles faveurs, moi de si longs rebuts;
Les Sardes reuoltez nous ont ouuert la lice, Où ie pouuois du ſort affronter l’iniuſtice;	Les Sardes révoltés nous ont ouvert la lice, Où tu pouuois du sort affronter l'injustice;
Et me le ſoümettant, arracher de ce bras, Les janenrs qu'il me don, & ne me donne pas.	Et me le soumettant, arracher de ce bras, Les janrs qu'il me don, et ne me donne pas.
LAZARILLE.	LAZARILLE.
A voir de quels dedains la fortune me traite, Nous deuons eſtre nés deſſous meſme planete;	À voir de quels dédains la fortune me traite, Nous devons être nés dessous même planète;
Iamais occaſion d’intereſt, ou d’honneur, Par ſon euenement n’a marqué mon bon-heur;	Jamais occasion d'intérêt, ou d'honneur, Par son événement n'a marqué mon bonheur;
Mais ſur tout, qu’en mon choix le ſort me fut contraire, Quand me donnant à vous, Vrfinſuiuit Cabreret Son maiſtre aupres du Roy, poſſede vn rang ſi haut Que tout rit à ſes vœux, que rien ne luy deffaut:	Mais sur tout, qu'en mon choix le sort me fut contraire, Quand me donnant à vous, Vrfinsuivit Cabreret Son maître auprès du Roi, possède un rang si haut Que tout rit à ses vœux, que rien ne lui défaut:
Et dans le triſte cours du malheur qui vous preſſe, Cette lame enroüillée eſt toute ma richeſſe.	Et dans le triste cours du malheur qui vous presse, Cette lame enroüillée est toute ma richesse.
D.	D.
L'OPE.	L'OPE.
Le ſeruice important qu’a rendu ma valeur, Fera bien-toſt ceſſer, ta plainte, & mon malheur, Les fruits de l’amitié, dont Cabrere m’honore, Ne peuuent plus tarder & ſont tout preſts d’éclore:	Le service important qu'a rendu ma valeur, Fera bientôt cesser, ta plainte, et mon malheur, Les fruits de l'amitié, dont Cabre m'honore, Ne peuvent plus tarder et sont tout prêts d'éclore:
T'attends de ſon pacquet, que ie viens rendre au L’infaillible faueur d’vn honorable employ:	T'attends de son pacquet, que deux viens rendre au L'infaillible faveur d'un honorable emploi:
aie en Et puis.	aie en Et puis.
mais quelle peine eſt celle où ie me treuue?	mais quelle peine est celle où ici me trouve?
O de mon mauuais ſort la plus fatale épreuue!	Ô de mon mauvais sort la plus fatale épreuve!
Et qui de mes malheurs, me rend le plus confus?	Et qui de mes malheurs, me rend le plus confus?
Ce paquet.	Ce paquet.
LAZARILLE.	LAZARILLE.
Eſt perdu.	Est perdu.
D.	D.
LOPE.	LOPE.
Ie ne le treuue plus;	Je ne le trouve plus;
O Negligence inſigne!	Ô Negligence insigne!
& ſurpriſe importune!	et surprise importune!
Puſaeini ppeusut joing, à ſipeu de jortunes Et ſi mal conſerué le gage glorieux, Qui deuoit rendre au Roy, mon nom ſi precieux?	Pusaeini ppeusut join, à sipeu de jortunes Et si mal conservé le gage glorieux, Qui devait rendre au Roi, mon nom si précieux?
LAZARILLE.	LAZARILLE.
Le ſort nous en veut trop, il faut qu’il nous acheüe, Et ſahaine eſt pour nous, sas quartier, & sas trefue;	Le sort nous en veut trop, il faut qu'il nous achue, Et sahaine est pour nous, sas quartier, et sas trêve;
Mais voyez, biẽ, peut-eſtre aurez vous mal cherché;	Mais voyez, bien, peut-être aurez vous mal cherché;
Vous l’auiez ce matin, où nous auons couché, L’auriez-vous oublié?	Vous l'aviez ce matin, où nous avons couché, L'auriez-vous oublié?
cherchez mieux ie vous prie.	cherchez mieux ie vous prie.
D.	D.
LOPE.	LOPE.
Ie l’auray pû laiſſerdedans l'Hoſtellerie, Mais retourner ſi loing, feroit vn vain ſoucy, Puis qu'enfin, auiourd’huy, Cabrere arriue icy;	Je l'aurai pu laisserdedans l'Hôtellerie, Mais retourner si loin, ferait un vain souci, Puis qu'enfin, aujourd'hui, Cabre arrive ici;
Et que ſur le chemin, ma bleſſeure r’ouuerte, De trois, ou quatre iours m'ayant couſté la perte, Afait d’autant de temps, auancer ſon retour;	Et que sur le chemin, ma blessure rouverte, De trois, ou quatre jours m'ayant coûté la perte, Afait d'autant de temps, avancer son retour;
Si bien qu’auiourd’huy meſme, on l’attẽd à la Cour, Où la voix ſuppleant la perte de ſa lettre, M’obtiendra les effets, que i'oſois m’en promettre:	Si bien qu'aujourd'hui même, on l'attend à la Cour, Où la voix suppléant la perte de sa lettre, M'obtiendra les effets, que j'osais m'en promettre:
S’il ſe peut, tout esfois, faiſons ſçauoir au Roy, Quels exploits en Sardaigne, ont eſtablyſa loy;	S'il se peut, tout éfois, faisons sçauoir au Roi, Quels exploits en Sardagne, ont establysa loi;
muu tet grands ſuccés luy faiſant des peintures, Sans nous manifeſter, contons nos aduantures;	mu tet grands succès était faisant des peintures, Sans nous manifester, contons nos aventures;
Pour donner audience, il ſe doit rendre icy.	Pour donner audience, il se doit rendre ici.
LAZARILLE.	LAZARILLE.
Qelqu'vn fort de ſachambre.	Quelqu'un fort de sachambre.
de dolE.	de dolE.
Auançons, le voicy.	Avançons, le voici.
SCLINEIE LE ROY, LE COMTE, CAPITAINE des Gardes, Suitte d’Archers.	SCLINEIE LE ROI, LE COMTE, CAPITAINE des Gardes, Suite d'Archers.
D.	D.
LOPE, LAZARILLE.	LOPE, LAZARILLE.
LE COMTE.	LE COMTE.
JOs ſoins du grand Trajan vous font le vif V exemple, Siles Roysſont des Dieux, leur Palais eſt vntem.	JOs soins du grand Trajan vous font le vif V exemple, Siles Rois des Dieux, leur Palais est untem.
Onpountouts il eſt iuſte, & lienueprier, Et dont iamais l’accés ne ſe doit denier.	Onpountouts il est juste, et lienprier, Et dont jamais l'accès ne se doit denier.
E OY.	E OY.
Le plus digne degré de la grandeur d’vn maiſtre, Eſt d’eſtre égal aux ſiens, autant qu’il le peut eſtre;	Le plus digne degré de la grandeur d'un maître, Est d'être égal aux siens, autant qu'il le peut être;
Il s’eſleue plus haut par cet abaiſſement, C’eſt de ſa dignité le plus ſeur fondement, Et de l’art de regner la plus haute ſcience.	Il s'élever plus haut par cet abaissement, C'est de sa dignité le plus sûr fondement, Et de l'art de régner la plus haute science.
LE COMTE.	LE COMTE.
Chacun peut approcher:	Chacun peut approcher:
le Roy donne audience.	le Roi donne audience.
D.	D.
LOPE s’auançant.	LOPE s'avançant.
Si prompt à le ſeruir, ie tremble à l’aborder.	Si prompt à le servir, je tremble à l'aborder.
LAZARILLE.	LAZARILLE.
L'occaſion vous rit.	L'occasion vous rit.
D.	D.
LOPE.	LOPE.
Ciel, fais la ſucceder.	Ciel, fais la succéder.
Mais on m’a preuenu;	Mais on m'a prévenu;
SCENVE ILI D.	SCENVE ILI D.
SANCHE Gouuerneur de Saragoſſe.	SANCHE Gouverneur de Saragosse.
Sire, vn bruit populaire, Iette icy la terreur de l’Infant voſtre frere;	Sire, un bruit populaire, Jette ici la terreur de l'Infant votre frère;
L’armée eſt décampee, & s’auance à grands pas, L’aduantage conſiſte à ne l’attendre pas;	L'armée est décampée, et s'avance à grands pas, L'avantage consiste à ne l'attendre pas;
Et le mal nous preſſant, empeſcher qu’il n’empire Et ne vienne attaquer le cœur de voſtre Empire:	Et le mal nous pressant, empêcher qu'il n'empire Et ne vienne attaquer le cœur de votre Empire:
Vous riſqués vn grand ſiege, en attendant plus tard, Saragoſſe eſt au throne vn important rampart.	Vous risquez un grand siège, en attendant plus tard, Saragosse est au trone un important rampart.
LE ROY.	LE ROY.
Mes ordres pouruoiront contre cette diſgrace, Cependant, trauaillez, à bien munir la place;	Mes ordres pourvoiront contre cette disgrâce, Cependant, travaillez, à bien munir la place;
Et pouruoir de deffenſe aux endroits importants, Sans ſemer la frayeur parmy les habitants;	Et pourvoir de défense aux endroits importants, Sans semer la frayeur parmi les habitants;
Allez, qu’vn autre approche.	Allez, qu'un autre approche.
SCENE IV.	SCÈNE IV.
ENVEEV LE SECRETAIRE, LE ROY.	ENVEUE LE SECRÉTAIRE, LE ROY.
LE COMTE, D.	LE COMTE, D.
LO PE, LAZARILLE, LDATS.	LO PE, LAZARILLE, LDATS.
D.	D.
LOPE s’auançant.	LOPE s'avançant.
O Sort, ſois moy propice!	Ô Sort, sois moi propice!
Ne voila pas encor, vn traict de ſon caprice!	Ne voilà pas encor, un trait de son caprice!
Voy combien de hazards m’oſtent l’occaſion;	Vois combien de hasards m'ôtent l'occasion;
LAZARILLE.	LAZARILLE.
Ie forcenne de rage & de confuſion.	Je forcenne de rage et de confusion.
LE SECRETAIRE, au Roy, luy donnant vne lettre.	LE SECRÉTAIRE, au Roi, lui donnant une lettre.
Sire, aux moindres faueurs, qu’vne maiſtreſſe enuoye, C’eſt trop faire achepter, qu’en retarder la joye.	Sire, aux moindres faveurs, qu'une maîtresse envoie, C'est trop faire acheter, qu'en retarder la joie.
LE ROY, la baiſant & l’ouurant.	LE ROY, la baisant et l'ouvrant.
Cher gage d’vne main pleine de tant d’appas, Me viens-tu prononcer l'arreſt de mon treſpas?	Cher gage d'une main pleine de tant d'appas, Me viens-tu prononcer l'arrêt de mon trépas?
Ou flechiray-ie enfin la fierté qui reietté Vne ame aſſuiettie au foug at fa fuiette?	Ou fléchirai-je enfin la fierté qui rejetté Vne âme assuiettie au foug at fa fuite?
LAZARILLE.	LAZARILLE.
Quelqu’vn profitera du temps que vous perdés.	Quelqu'un profitera du temps que vous perdez.
D.	D.
Loiimiuançant.	Loiimiuançant.
Prince, rare ornement.	Prince, rare ornement.
Le Roy lit, attendez.	Le Roi lit, attendez.
LE COMTE, le faiſant retirer.	LE COMTE, le faisant retirer.
LE ROY, liſant la lettre.	LE ROY, lisant la lettre.
Ne ſoüillés point grãd Roy, les glorieuſes marques, Puipur le reſte des Monarques, Font briller voſtre Majeſté, Par vne paßion à ſon repos fatale, D’vn indigne attentat de voſtre ame Royale, Sur mon honneſteté.	Ne soüillés point grand Roi, les glorieuses marques, Puipur le reste des Monarques, Font briller votre Majesté, Par une passion à son repos fatale, D'un indigne attentat de votre âme Royale, Sur mon honnêteté.
I'ay trop long-temps ſouffert à vos ardeurs paßées, Ces friuoles écrits, porteurs de vos penſées, Ne m’en honorez plus, Ou me continuant cet honneur qui m'offence, Me vous offencez, pas, ou d’vn iuſte ſilence, Ou d’on libre refus:	J'ai trop longtemps souffert à vos ardeurs passées, Ces frivoles écrits, porteurs de vos pensées, Ne m'en honorez plus, Ou me continuant cet honneur qui m'offense, Me vous offensez, pas, ou d'un iuste silence, Ou d'on libre refus:
Il dit, ne liſant plus.	Il dit, ne lisant plus.
O rigueur inhumaine!	Ô rigueur inhumaine!
ô beauté tyrannique!	ô beauté tyrannique!
Qui cauſant mõ amour, deffends qu'elle s’explique, Beau, mais funeſte eſcueil, inſenſible rocher.	Qui causant mon amour, défends qu'elle s'explique, Beau, mais funeste écueil, insensible rocher.
Allez:	Allez:
LAZARILLE.	LAZARILLE.
LE COMIE.	LE COMIE.
Il ne lit plus, vous pouuez approcher;	Il ne lit plus, vous pouvez approcher;
D.	D.
LOPE s’approchant.	LOPE s'approchant.
Enfin tu ſeras laſſe, ô cruelle fortune!	Enfin tu seras lasse, ô cruelle fortune!
De me perſecuter & de m’eſtre importune;	De me persécuter et de m'être importune;
Prince amour des climats, où vous donnez la loy, Et de vos ennemis, la terreur & rejproy;	Prince amour des climats, où vous donnez la loi, Et de vos ennemis, la terreur et reprois;
Si voſtre Majeſté doit treuuer quelques charmes Au fidele recit du ſucces de ſes armes;	Si votre Majesté doit trouver quelques charmes Au fidèle récit du succès de ses armes;
I'oze ſatisfaiſant à ma commißion, Me promettre l’honneur de ſon attention.	J'ose satisfaisant à ma commission, Me promettre l'honneur de son attention.
LE ROY lit vn mot, ou deux, & puis dit.	LE ROY lit un mot, ou deux, et puis dit.
Et vantons orgueilleux, les droits d’vn Couronne, Et le faux aſcendant que ſon éclat nous donne;	Et vantons orgueilleux, les droits d'un Couronne, Et le faux ascendant que son éclat nous donne;
Pourrois-ie obtenir moins deſſous vn nom priué, Qu'en ce grade eminent, où ie ſuis eſleué!	Pourrais-je obtenir moins dessous un nom privé, Qu'en ce grade éminent, où ie tu esleué!
nne ingrurit fuieme u te pomume dedaigne!	nne ingrurit fuième ! te pomume dédaigne!
D.	D.
LOPE.	LOPE.
L’eſtat où Dom Bernard a reduit la Sardaigne, neru ilemoren t Durope, & ue voſtre fureur, Aux lieux plus écartés ſemera la terreur.	L'état où Dom Bernard a réduit la Sardaigne, nervu ilémoren t Urope, et ue votre fureur, Aux lieux plus écartés sèmera la terreur.
LE ROY liſant.	LE ROY lisant.
Ne m’en honorés plus, Oume continuant, cet honneur qui m'offence, Ne vous offencez pas, ou d’vn iuſte ſilence, Où d’vn libre refus.	Ne m'en honorez plus. Oume continuant, cet honneur qui m'offense, Ne vous offensez pas, ou d'un juste silence, Où d'un libre refus.
Il dit en ſuitte.	Il dit en suite.
Traicter de ces froideurs, le feu qui me deuore, Moy ſon Prince:	Traicter de ces froideurs, le feu qui me dévore, Moi son Prince:
ſon Roy, mais ſon Roy qui l’adore.	son Roi, mais son Roi qui l'adore.
D.	D.
LOPE.	LOPE.
Quand l’appareil fut preſt, & que de vos vaiſſeaux Dom Bernard eut couuert l’humide ſein des eaux, Les vents en meſme inſtant, furent ſans violence, Et volontairement s’impoſerent ſilence;	Quand l'appareil fut prêt, et que de vos vaisseaux Dom Bernard eut couvert l'humide sein des eaux, Les vents en même instant, furent sans violence, Et volontairement s'imposèrent silence;
La mer auec reſpect porta ce grand fardeau, Qui des Sardes alloit la faire le tombeau.	La mer avec respect porta ce grand fardeau, Qui des Sardes allait la faire le tombeau.
LE ROY.	LE ROY.
Mais, ô trouble friuole & vaine réuerie, Amoureux ie puis craindre, & Monarque ie prie, muijuney& puimapaummuumſpauis ſuperflus, Qui pouuant tout, demande, eſt digne du refus.	Mais, ô trouble frivole et vaine réuerie, Amoureux ie puis craindre, et Monarque quelque prie, muijune puimapaummuumspauis superflus, Qui pouvant tout, demande, est digne du refus.
D.	D.
LOPE.	LOPE.
L’air & la mer, enfin comme vos tributaires, Prirent voſtre party, contre vos aduerſaires;	L'air et la mer, enfin comme vos tributaires, Prirent votre parti, contre vos adversaires;
LE ROY.	LE ROY.
Mais au trouble importun, dont i’eſtois diuerty, N’ayant rien entendu, ie n’ay rien reparty;	Mais au trouble importun, dont j'étais diverti, N'ayant rien entendu, toujours n'ai rien réparti;
Cette diſtraction eſt vn deffaut aux Princes, Qui doiuent touſiours mettre, au bien de leurs Prouinces, Leur plus preſent objet, & leur ſoing le plus haut, Rappelons noſtre eſprit, & couurons ce deffaut.	Cette distraction est un défaut aux Princes, Qui doivent toujours mettre, au bien de leurs Provinces, Leur plus présent objet, et leur soing le plus haut, Rappelons notre esprit, et couvrons ce défauts.
ſe leuant.	se levant.
Ie ſonge à preuenir le ſiege qui s’appreſte, Si vous m’auez, ſeruy, dreßés voſtre requeſte, I'en verray le merite, & i’auray ſoing de vous.	Je songe à prévenir le siège qui s'apprête, Si vous m'avez, servi, dressés votre requête, J'en verrai le mérite, et j'aurai soin de vous.
LAZARILLE le ſuiuant.	LAZARILLE le suivant.
Denos Aſtres enfin nous vaincrons le courroux.	Denos Astres enfin nous vaincrons le courroux.
B	B
NE LE ROY, LE COMTE, LE SECRETAIRE.	NE LE ROY, LE COMTE, LE SECRÉTAIRE.
LE ROY.	LE ROY.
Voy ie regne, & regnant n’oze dire que i’ayme!	Vo ie règne, et régnant n'ose dire que j'aime!
Ie ſers, & ne puis plaire auec vn Diadeſme!	Je sers, et ne puis plaire auec un Diadesme!
Toy, dece triſte écrit funeſte meſſager, Autheur de mon ennuy, trauaille à l’alleger, Et ſi tu veux qu’encor quelque attente me flatte, Va m’obtenir, Perez, de cette belle ingrate, La faueur de paſſer en ſon appartement, Et ſans l’incommoder, luy parler vn moment.	Toi, dece triste écrit funeste messager, Auteur de mon ennui, travaille à l'alléger, Et si tu veux qu'encor quelque attente me flatte, Va m'obtenir, Pèrez, de cette belle ingrate, La faveur de passer en son appartement, Et sans l'incommoder, lui parler un moment.
Va i’attends ſa reſponſe:	Va j'attends sa réponse:
ha Comte, eſt-il poßible, Que ce front couronné cache vn cœur je ſenſible!	ha Comte, est-il puible, Que ce front couronné cache un cœur je sensible!
Et qu’vne dependante, & ſuiette beauté, A de ſi longs efforts, en cache vn indomté?	Et qu'une dépendante, et suite beauté, A de si longs efforts, en cache un indomté?
Par quel droict vantons nous malheureux que nous ſommes, L'aduantage des Roys, ſur le reſte des hommes, Si ſuiets comme vous à noſtre paßion, Nous ſouſtenons ſi mal cette preſomption, Que d’vn ſimple regard, qu’vn bel œil nous enuoye Nos libertez, ſouuent ſont la honteuſe proye?	Par quel droit vantons nous malheureux que nous sommes, L'avantage des Rois, sur le reste des hommes, Si sujets comme vous à notre passion, Nous soutenons si mal cette présomption, Que d'un simple regard, qu'un bel œil nous envoie Nos libertés, souvent sont la honteuse proie?
LECOMTE.	LECOMTE.
Le maineur de fouffrir pour a aymables obiets, Eſt le ſort außi bien des Roys que des ſuiets.	Le maineur de souffrir pour a aimables objets, Est le sort aussi bien des Rois que des sujets.
LE ROY.	LE ROY.
Ma plus ſenſible peine, en ce que ie propoſe, Eſt que mon deſſein meſme, à mon deſſein s’oppoſe, Et que pouuant vſer d’vn pouuoir abſolu, Ie ceſſe de vouloir, ſi toſt que i’ay voulu;	Ma plus sensible peine, en ce que femme propose, Est que mon dessein même, à mon dessein s'oppose, Et que pouvant user d'une pouvoir absolu, Je cesse de vouloir, si tôt que j'ai voulu;
Que dans la meſme cauſe, & criminel, & iuge, De l’obiet offencé ie deuiens le refuge, Et de quelques efforts que ie ſois combatu, Nay pas aſſez à amour pour manquer de vertu.	Que dans la même cause, et criminel, et juge, De l'objet offensé ie deuiens le refuge, Et de quelques efforts que je sois combattu, Nais pas assez à amour pour manquer de vertu.
Ainſi mon cœurpre ßé par l’vn & l’autre extréme, Eſt le champ d’vn cõbat de moy contre moy-méme, Qui laſche, ou genereux, fotoie, ou jort que ie ſuis, Protege enméme temps, l’honneur que ie pourſuis.	Ainsi mon cœurpre ssé par l'un et l'autre extrême, Est le champ d'un combat de moi contre moi-même, Qui lâche, ou généreux, foie, ou jort que je suis, Prote enméme temps, l'honneur que je suis.
LE COMTE.	LE COMTE.
C’eſt par ce beau combat, que vous rendez des marques, Du plus conſiderable, & plus grãd des monarques;	C'est par ce beau combat, que vous rendez des marques, Du plus considérable, et plus grãd dés monarques;
L’amour eſt vn doux mal commun à tous les Rois, Mais peu de la raiſon luy font ſuiure les loix, Peu ſçauent auec luy moderer leur puiſſance, Et quand il oſe trop, reprimer ſa licence;	L'amour est un doux mal commun à tous les Rois, Mais peu de la raison y font suivre les lois, Peu sçauent avec lui modérer leur puissance, Et quand il ose trop, réprimer sa licence;
Ces qualitez außi vous attirent nos vœux, De Pedre, & non du Roy, le monde eſt amoureux;	Ces qualités aussi vous attirent nos vœux, De Pèdre, et non du Roi, le monde est amoureux;
Et le ſurnom de Grand que l’Arragon vous donne, Vient plus de vos vertus, que de voſtre couronne;	Et le surnom de Grand que l'Aragon vous donne, Vient plus de vos vertus, que de votre couronne;
C’eſt vn malheur d’vn thrône où l’on eſt eſleué, Qu'eſtre touſiours en butte, & touſiours obſerué;	C'est un malheur d'être thrône où l'on est élevé, Qu'être toujours en butte, et toujours observé;
Qu’il ne ſoit mur ſi fort, dans les Palais des Princes, 4 Que ne puiſſent percer les yeux de leurs Prouinces, Toutes leurs actions regardans leurs ſuiets, De leurs ſuiets außi, ſont touſiours les obiets;	Qu'il ne soit mur si fort, dans les Palais des Princes, 4 Que ne puissent percer les yeux de leurs Provinces, Toutes leurs actions regardants leurs sujets, De leurs sujets aussi, sont toujours les objets;
Auec le peuple enfin ils partagent vn tiltre, Et iuges de l’eſtat, l’eſtat eſt leur arbitre:	Avec le peuple enfin ils partagent un titre, Et juges de l'état, l'état est leur arbitre:
Pour voſtre Majeſté, c’eſt vn repos bien doux, De pouuoir ſans rien craindre, eſtre iugé de tous;	Pour votre Majesté, c'est un repos bien doux, De pouvoir sans rien craindre, être jugé de tous;
Et c'eſt pour vn Monarque vne vertu ſublime, De hayr comme vous, iuſqu’à l’ombre du crime;	Et c'est pour un Monarque une vertu sublime, De haïr comme vous, jusqu'à l'ombre du crime;
D’estre vn ſi ſaint exemple, aux yeux de voſtre Cour, Et pouuoir accorder l’innocence & l’amour.	D'être un si saint exemple, aux yeux de votre Cour, Et pouvoir accorder l'innocence et l'amour.
LE ROY.	LE ROY.
LE ROY.	LE ROY.
L'intereſt qui m’allie auecques la Nauarre;	L'intérêt qui m'allie apprendre la Navarre;
Pouuoit ſeul me priuer d’vne beauté ſi rare;	Pouvait seul me priver d'une beauté si rare;
Et toute autre raiſon moins vtile à l’eſtat, La ſplendeur de mon rang, le nom de Potentat, Cequountee ſontomeno v one uuuucoſperance, Ne me pourroient rauir l’heur de ſon alliance.	Et toute autre raison moins vtyle à l'état, La splendeur de mon rang, le nom de Potentat, Cequountee sontomeno v one uuuucosperance, Ne me pourraient ravir l'heur de son alliance.
e d eu D.	Je d eu D.
LOPE DE LVNE, LAZARILLE, LEROY, LE COMTE, GARDES.	LOPE DE LUNE, LAZARILLE, LEROY, LE COMTE, GARDES.
LAZARILLE.	LAZARILLE.
Occaſion vous rit, mais ne la manqués pas.	Occasion vous rit, mais ne la manquez pas.
D.	D.
LOPE.	LOPE.
Elle eſt trop fauorable, ô ſort guide mes pas?	Elle est trop favorable, ô sort guide mes pas?
LE ROY prenantlarequeſte.	LE ROY prenantlarequête.
Donnez;	Donnez;
D.	D.
LOPE.	LOPE.
Cemot, grand Roy, s’il ne vous importune, Vous fera ſouuenir de Dom Lope de Lune;	Cemot, grand Roi, s'il ne vous importune, Vous fera souvenir de Dom Lope de Lune;
Autrefois par ſa charge, illuſtre en cette Cour, Sous l’heureux Souuerain, dont vous tenez le iour;	Autrefois par sa charge, illustre en cette Cour, Sous l'heureux Souverain, dont vous tenez le jour;
Qui iuſques à la mort, paya de ſa perſonne, Et fiſt de tout ſon ſang, hommage à la Couronne.	Qui jusques à la mort, paya de sa personne, Et fît de tout son sang, hommage à la Couronne.
LE NO Y Iiſant.	LE NÔ Y Jisant.
Dum Rope de .	Dum Rope de .
ALNVT VII.	ÀLNUT VII.
LE SECRETAIRE, LE ROY, D.	LE SECRÉTAIRE, LE ROY, D.
LOPE LE COMTE, LAZARILLE, GARDES.	LOPE LE COMTE, LAZARILLE, GARDES.
LE SECRETAIRE.	LE SECRÉTAIRE.
Seigneur, Leonor paſſe icy.	Seigneur, Leonor passe ici.
Pour aller chez l'Infante, auancez, la voicy.	Pour aller chez l'Infante, avancés, la voici.
Hors:	Hors:
LE COMTE, à D.	LE COMTE, à D.
LOPE.	LOPE.
D.	D.
LOPE ſortant.	LOPE sortant.
O de mon malheur, cruelle experience!	Ô de mon malheur, cruelle expérience!
LAZARILLE le ſuiuant.	LAZARILLE le suivant.
O la dure vertu, que tant de patience!	Ô la dure vertu, que tant de patience!
SCLNVE V III LEONOR, LE ROY, LE COMTE, LE SECRETAIRE, GARDES, LE ROY reledant noonor, quren entrant fait vn faux-pas.	SCLNVE V III LEONOR, LE ROY, LE COMTE, LE SECRÉTAIRE, GARDES, LE ROY reledant noonor, quren entrant fait un faux-pas.
E' Madame!	E' Madame!
LI LEONOR.	LI LEONOR.
Beigneur, c'efe on pun-neut pour moy, Le Roy Qu'ayant à choir, ma cheute arriue aux pieds du nant ia R Dont le rang me preſcrit l’eſtat où ie me treuue.	Beigneur, c'efe on pun-neut pour moi, Le Roi Qu'ayant à choir, ma chute arrive aux pieds du nant ja R Ont le rang me prescrit l'état où je me trouve.
LE ROY.	LE ROY.
C’eſt de voſtre merite vne infaillible preuue, Que pour vous releuer & ſeruir au beſoin, A mes mains la fortune, en ait commis le ſoin;	C'est de votre mérite ici infaillible preuve, Que pour vous relever et servir au besoin, À mes mains la fortune, en ait commis le soin;
Oüy, Madame, ce ſoin tõbe en des mains puiſsãtes, Capables de remplir & paſſer vos attentes, .	Oui, Madame, ce soin tombe en des mains puissants, Capables de remplir et passer vos attentes, .
Qui vous peuuent dõner vn rang qui vous deffaut, Et ne releuent point, ſans eſleuer bien haut.	Qui vous peuvent donner un rang qui vous défaut, Et ne relèvent point, sans élever bien haut.
LEONOR.	LEONOR.
Que puis-ie deſormais craindre de la fortune, Si me terraçant meſme elle m'eſt importune;	Que puis-je désormais craindre de la fortune, Si me terraçant même elle m'est importune;
Si ma cheute m'eſleue, & ſi choir eſt vn ſaut, Pour me rendre plus ferme, & m’eſleuer plus haut, C’eſt d’vn bonheur inſigne vne preuue conſtante.	Si ma chute m'élève, et si choir est un saut, Pour me rendre plus ferme, et m'élever plus haut, C'est d'un bonheur insigne une preuve constante.
LE ROI Où s’addreſſent vos pas?	LE ROI Où s'adressent vos pas?
LEONOR.	LEONOR.
Ie paſſois chez l’Infante,	Je passais chez l'Infante,
Ie vous yrends:	Je vous yrends:
E ROY.	E ROY.
LEONOR.	LEONOR.
Seigneur!	Seigneur!
LE ROY.	LE ROY.
Accordez moy ce poinct, Mandez des cruautez, mais n’en exercez point, Rebutez, meſpriſez, tuez dans vne lettre, Mais preſente, ſouffrez ce qui ſe peut permettre, Et ne refuſez pas vne ciuilité,	Accordez -moi ce point, Mandez des cruautés, mais n'en exercez point, Rebutez, méprisez, tuez dans une lettre, Mais présente, souffrez ce qui se peut permettre, Et ne refusez pas une civilité,
LEONOR.	LEONOR.
Si i’oſois remonſtrer à voſtre Majeſté, Vnquuque ſi haut poinct que ſa bonté m’oblige, Ilm'eſt de conſéquence eſtant.	Si j'osais remontrer à votre Majesté, Unquuque si haut point que sa bonté m'oblige, Ilm'est de conséquence étant.
LE ROY.	LE ROY.
Allons vous diſ-je, Souffrez que ie vous rende en ſon appartement, Et là nous en viendrons ſur l’éclairciſſement.	Allons vous dis-je, Souffrez que je vous rende en son appartement, Et là nous en viendrons sur l'éclaircissement.
{OEIVS IAT DOM LOPE DE LVNE, LAZARILLE, ſortant de l’antichambre.	UOEIUS IAT DOM LOPE DE LUNE, LARILLE, sortant de l'antichambre.
LAZARILLE.	LAZARILLE.
V'attendons nous encor, malheureux que nous ſommes?	V'attendons nous encor, malheureux que nous sommes?
I’aybien veu du pays, i’ay bien conneu des hõmes, Mais ie n’en ay point veu, que le ciel en courroux, Rende par leur malheur ſi celebres que nous;	J'aibien vu du pays, j'ai bien connu des hommes, Mais des n'en ai point vu, que le ciel en courroux, Rende par leur malheur si célèbres que nous;
Et vous deuiendrez Grand, vanité ridicule!	Et vous deviendrez Grand, vanité ridicule!
Vous pourriés eſtre vn Mars, vn Ceſar, vn Hercule Que le ſort enragé qui talonne vos pas, pous neurteroit entor, & ne toum piroit pas.	Vous pourriez être un Mars, un César, un Hercule Que le sort enragé qui talonne vos pas, pous neurterait entor, et ne toum irait pas.
D.	D.
LOPE.	LOPE.
Sa rigueur en effet m’oppoſe tant d’obſtacles, Que pourtes vaincre tous, ue fuuuroit des miracles;	Sa rigueur en effet m'oppose tant d'obstacles, Que pourtes vaincre tous, ue fuurait des miracles;
Mais le Roy peut rentrer, attendons ſon retour.	Mais le Roi peut rentrer, attendons son retour.
LALARILEL.	LALARILEL.
O l’importun meſtier, que celuy de la cour!	Ô l'importun métier, que celui de la cour!
Il treuue la requeſte, & la ramaſſant dit.	Il trouve la requête, et la ramassant dit.
Qu'eſt-ce cy?	Qu'est-ce cy?
quelque traict encor de la fortune?	quelque trait encor de la fortune?
Qu'eſt-ce?	Qu'est-ce?
D.	D.
LOPE.	LOPE.
LAZARILLE liſant.	LAZARILLE lisant.
Requeſte au Roy de Dom Lope de Lune;	Requête au Roi de Dom Lope de Lune;
Et voſtre ame eſt prophete en ſespreſſentiments, De grands effets ſuiuront vos nobles moueements?	Et votre âme est prophète en sespressentiments, De grands effets suivront vos nobles mouéments?
Le ley Vous pouuez, ſur l’eſpoir que Dom Bernard vous donne, Pretendre à des degrez, proches de la couronne:	Le lei Vous pouvez, sur l'espoir que Dom Bernard vous donne, Prétendre à des degré, proches de la couronne:
Vous eſtes fort auant dedans l’eſprit du Roy, Vous ne ponuez manquer d’vn honorable employ:	Vous êtes fort avant dedans l'esprit du Roi, Vous ne ponvez manquer d'un honorable emploi:
Pour vous ſeul deſormais, les aſtres s’intereſſent, O de combien de vent les hommes ſe repaiſſent!	Pour vous seul désormais, les astres s'intéressent, Ô de combien de vent les hommes se repaissent!
Tenez, voſtre requeſte a fait vn grand effet, Et vous auez raiſon d’eſtre fort ſalisfait, Eue a des pieds du Prince eſſuyé la poußiere.	Tenez, votre requête a fait un grand effet, Et vous avez raison d'être fort salissait, Eue a des pieds du Prince essuyé la passion.
D.	D.
LOPE.	LOPE.
Dieut iamais deſeſpoir eut-il tant de matiere?	Dieut jamais désespoir eut-il tant de matière?
Dom Bernard qui peut tout, en vain me veut du bien, Ma valeur ſert l’Eſtat, & ne me produit rient y Ma parole eſt ſoufferte, & n’eſt point ecoutée, Ma requeſte eſt receuë, & puis eſt reiettée, I’ay touſiours lieu d’eſpoir, iamais d’euenement, Tout me rit, tout me flatte, & touſiours vainement;	Dom Bernard qui peut tout, en vain me veut du bien, Ma valeur sert l'État, et ne me produit rient y Ma parole est soufferte, et n'est point ecoutée, Ma requête est reçue, et puis est reiettée, J'ai toujours lieu d'espoir, jamais d'événement, Tout me rit, tout me flatte, et toujours vainement;
La fortune nous traicte auec trop d’iniuſtice, Pour nous promettre plus de vaincre ſon caprice.	La fortune nous traicte auec trop d'injustice, Pour nous promettre plus de vaincre son caprice.
Ne nous obſtinons plus en vne ingrate cour, Puiſque Cabrere arriue, attendons ſon retour;	Ne nous obstinons plus en une ingrate cour, Puisque Cabre arrive, attendons son retour;
Mais ſans plus nous flatter d’vne eſperance vaine, Sans que mes intereſts luy couſtent plus de peine;	Mais sans plus nous flatter d'une espérance vaine, Sans que mes intérêts Seigneur coûtent plus de peine;
Payons ſon amitié ſeulement d’vn adieu, Et fuyons pour iamais de ce funeſte lieu.	Payons son amitié seulement d'une adieu, Et fuyons pour jamais de ce funeste lieu.
reque- ſte	reque- te
2 TI	2 TY
SCENE PREMIERE.	SCÈNE PREMIÈRE.
DOM BERNARD, D.	DOM BERNARD, D.
LOPE, LAZARILLE.	LOPE, LAZARILLE.
M DOM BERNARD.	M DOM BERNARD.
Voy ce grand cœur s’esbranle, & Dom Lope de Lune Veut tourner lâchement le dos à la fortune, Et parmy ſes exploits laiſſera raconter, Qu'il eſt vn ennemy, qu’il a pù redouter?	Vois ce grand cœur s'ébranle, et Dom Lope de Lune Veut tourner lâchement le dos à la fortune, Et parmi ses exploits laissera raconter, Qu'il est un ennemi, qu'il a pù redouter?
I D.	I D.
LOPE.	LOPE.
Apres vne ſi longue, & ſi triſte auanture, Apres tant de mal-heurs, & de cette nature;	Après une si longue, et si triste aventure, Après tant de malheurs, et de cette nature;
Apres tant de reuers, de rebuts, de meſpris Capables de laſſer les plus fermes eſprits;	Après tant de revers, de rebuts, de mépris Capables de lasser les plus fermes esprits;
Quand Quand ie ne croirois pas mon malheur inuincible, deſtide tigeigey relen injemlele.	Quand Quand Madame ne croirais pas mon malheur invincible, destide tigeigey relen injemle.
D.	D.
BERNARD.	BERNARD.
Comme les Souuerains n’ont pas des droicts communs, Ils veulent quelquefois des deuoirs importuns, Et moins par nos effets que par noſtre conſtance.	Comme les Souverains n'ont pas des droits communs, Ils veulent quelquefois des devoirs importuns, Et moins par nos effets que par notre constance.
De nos affections éprouuent l’importance;	De nos affections éprouvent l'importance;
Tel que la Cour rebutte ou ne careſſe pas, Souuent mal à propos ſe laſſe au dernier pas;	Tel que la Cour rebutte ou ne caresse pas, Souvent mal à propos se lasse au dernier pas;
Et ſans la lâcheté de retourner arriere, Trouuoit vne Couronne au bout de ſa carriere;	Et sans la lâcheté de retourner arrière, Trouvait une Couronne au bout de sa carrière;
Ie ſçay que le deſtin qui diſpenſe les rangs, Tient pour nous les donner, des moyens differents;	Je sais que le destin qui dispense les rangs, Tient pour nous les donner, des moyens différents;
Par des chemins diuers, eleue aux grandes choſes, Et les ſeme à ſon gré, d’épines, ou de roſes;	Par des chemins divers, élève aux grandes choses, Et les seme à son gré, d'épines, ou de roses;
Ie ſçay que par vn heur qui ne ſe conçoit pas, Pour arriuer ſi haut, ie n’ay pas fait vn pas;	Je sais que par un heur qui ne se conçoit pas, Pour arriver si haut, ie n'ai pas fait un pas;
Et que tout mon credit & toute ma puiſſance, Ne ſont qu'vn ſimple effet de mon obeïſſance;	Et que tout mon crédit et toute ma puissance, Ne sont qu'un simple effet de mon obéissance;
Que ie meritois moins, que vous ne meritez, Et qu’on m'a tout donné ce que vous acheptez;	Que était méritais moins, que vous ne méritez, Et qu'on m'a tout donné ce que vous achettez;
Mais ce meſme deſtin dont l’aueugle caprice, Me fait tant de faueur, à vous tant d’iniuſtice, Peut de la meſme main, dont il m’a fait monter, Et vous mettre en ma place, & m'en precipiter;	Mais ce même destin dont l'aveugle caprice, Me fait tant de faveur, à vous tant d'injustice, Peut de la même main, dont il m'a fait monter, Et vous mettre en ma place, et m'en précipiter;
De ma part ſoyez ſeur d’vne ardeur ſans pareille, Et qu’au poinct où du Roy ie poſſede l’oreille, Deu pun que junamoioponuu umdaſoupaits, Mes ſoins vous produiront d’infaillibles ſuccés.	De ma part soyez sûr d'une ardeur sans pareille, Et qu'au point où du Roi ie possede l'oreille, Deu pun que junamoioponu umdasoupaits, Mes soins vous produiront d'infaillibles succès.
D.	D.
LOPE.	LOPE.
Quelques traits ſi perçants dont la douleur me touche, Auet tette vonte vous me fermez la bouche, Et ie tiendray l’honneur de voſtre affection, Pour le plus digne obiet de mon ambition.	Quelques traits si perçants dont la douleur me touche, Auet tette vonte vous me fermez la bouche, Et ton tiendrai l'honneur de votre affection, Pour le plus digne objet de mon ambition.
D.	D.
BERNARD.	BERNARD.
Au reſte de quei eu voyez vons vibtante?	Au reste de quei eu voyez vons vibtante?
D.	D.
LOPE.	LOPE.
Ce nom m'eſt incognu.	Ce nom m'est inconnu.
D.	D.
BERNARD.	BERNARD.
Quoy le nom de l’Infante!	Quoi le nom de l'Infante!
Ce nom, par qui le ciel nous voulut exprimer, L’inuincible pouuoir qui force de l’aymer?	Ce nom, par qui le ciel nous voulut exprimer, L'invincible pouvoir qui force de l'aimer?
Et treuue tous les cœurs ſans deffenſe, & ſans armes?	Et trouve tous les cœurs sans défense, et sans armes?
D.	D.
LOPE.	LOPE.
I'en confondois le nom, mais i’en cognois les charmes;	J'en confondais le nom, mais j'en connais les charmes;
Et ſi mon mauuais ſort me permet d’en parler, N’ay rien veu ſous le ciel qu’on luy puiſſe égaler;	Et si mon mauvais sort me permet d'en parler, N'ai rien vu sous le ciel qu'on lui puisse égaler;
Ny qui ſouſmettevne ame auecques plus d’empire Mais quelque haut deſſein que l’amour vous inſire;	Ni qui soumette âme était plus d'empire Mais quelque haut dessein que l'amour vous insire;
Voſtre heur & vos vertus, vous la peuuent donner, Et ce leur ſeroit peu que de vous couronner.	Votre heur et vos vertus, vous la peuvent donner, Et ce leur serait peu que de vous couronner.
D.	D.
BERNARD.	BERNARD.
Traictons auec reſpect les dignitez ſupreſmes, Et ne touchons iamais iuſques aux diadeſmes;	Traitons toujours respect les dignités suprêmes, Et ne touchons jamais jusques aux diadèmes;
Les Ciel qui les ſacra, veut qu’ils ſoient reuerez, Et n’ouure point l’oreille aux vœux immoderez.	Les Ciel qui les sacrés, veut qu'ils soient révérez, Et n'ouvre point l'oreille aux vœux immodéré.
Allons de nos lauriers faire hommage à ſes charmes, Et rendre compte au Roy du ſuccés de ſes armes;	Allons de nos lauriers faire hommage à ses charmes, Et rendre compte au Roi du succès de ses armes;
Venez les veritez que i’y diray de vous, Feront de ce recit, les brillants les plus doux.	Venez les vérités que j'y dirai de vous, Feront de ce récit, les brillants les plus doux.
BCLIVD IT LE ROY, LE COMTE, GARDES,	BCLIVD IT LE ROI, LE COMTE, GARDES,
LE COMTE voyant le Roy aſſoupy.	LE COMTE voyant le Roi assoupi.
Veltrauan intrumn run ue vijtre viſage, VPreſque du mouuement vous derobe l’vſage.	Veltravan intrumn run ue vijtre visage, VOdresque du mouvement vous derobe l'usage.
Et vous cauſe, Seigneur, cet aſſoupiſſement?	Et vous cause, Seigneur, cet assoupissement?
LE ROY.	LE ROY.
Le ſommeil nous preſſant ſe vainc malaiſément, La muſique, le ieu, cent tours à la feneſtre, De cet Aſtre inhumain, qui n’a daigné paroiſtre, Cent plaintes à ſa porte, & cent ſouſpirs ſans fruit, M'ont oſté le repos de l’ame & de la nuict;	Le sommeil nous pressant se vainc malaisément, La musique, le jeu, cent tours à la fenêtre, De cet Astre inhumain, qui n'a daigné paraître, Cent plaintes à sa porte, et cent soupirs sans fruit, M'ont ôté le repos de l'âme et de la nuit;
Tant que m’ayant des ſens preſque interdit l'vLe iour, veut de la nuict, me repuirtr loutrage;	Tant que m'ayant des sens presque interdit l'uNe jour, veut de la nuit, me répuirtr outrage;
Mais Dom Bernard arriue, & vient d’vn doux reſueil, Guerir ma laßjtude, & charmer mon ſommeil;	Mais Dom Bernard arrive, et vient d'Homme doux réveil, Guer ma lassjtude, et charmer mon sommeil;
Il a tant fait pour moy, que pour ſa recompenſe, Mon pouuoir auiourd huy cognop fuirimpuspance.	Il a tant fait pour moi, que pour sa récompense, Mon pouvoir aujourd' hui connop fuirimpuspance.
LE COMTE.	LE COMTE.
Les prix qui d’vn grand cœur ſuiuent les grands exploits, Sont les plus clairs brillãts des Couronnes des Rois;	Les prix qui d'un grand cœur suivent les grands exploits, Sont les plus clairs brillants des Couronnes des Rois;
Aux grandes actions leur charme nous inuite, Par eux l’ame s’eſleue, & la vertu s’excite;	Aux grandes actions leur charme nous inuite, Par eux l'âme s'élève, et la vertu s'excite;
Par eux il n’eſt deſſein dont on ne vienne à bout, Et ne rien épargner, eſt l’art d’acquerir tout;	Par eux il n'est dessein dont on ne vienne à bout, Et ne rien épargner, est l'art d'acquérir tout;
Mais ſi pour vn ſuiet, iamais vos mains Royales, Ont eu lieu de s’ouurir, & d’eſtre liberales;	Mais si pour un sujet, jamais vos mains Royales, Ont eu lieu de s'ouvrir, et d'être libérales;
Dom Bernard ſi fameux par tant d’occaſions, Eſt le plus digne obiet de vos profuſions;	Dom Bernard si fameux par tant d'occasions, Est le plus digne objet de vos profusions;
Puiſqu'aux nobles trauaux de te courage illuſtre, Les armes d’Arragon doiuẽt leur plus beau luſtre;	Puisqu'aux nobles travaux de te courage illustre, Les armes d'Aragon doivent leur plus beau lustre;
Et qu’enfin quelque éclat dont il ſoit reueſtu, Son rang ſera touſiours moindre que ſa vertu.	Et qu'enfin quelque éclat dont il soit revêtu, Son rang sera toujours moindre que sa vertu.
LE RO Ie cognoy ma foibleſſe, à le bien recognoiſtre, Il épuiſe ma force, à force de l’accroiſtre:	LE RO Je connais ma faiblesse, à le bien reconnaître, Il épuise ma force, à force de l'accroître:
Iunstommans bien-faits, il l’emporte ſur moy, Ie luy donne en vaſſal & luy me donne en Roy:	Junstommants bienfaits, il l'emporte sur moi, Je lui donne en vassal et lu me donne en Roi:
Mais l’amitié qui rend toute choſe commune, Luy va comme mon cœur, partager ma fortune, Et ſur ſon ſeul merite appuyer mon pouuoir, Il arriue, auançons, allons le receuoir, M0 Et baſtir auiourd’huy le plus haut edifice, Qu'ayent iamais epeut te ſort & ta iaſtice.	Mais l'amitié qui rend toute chose commune, Lui va comme mon cœur, partager ma fortune, Et sur son seul mérite appuyer mon pouvoir, Il arrive, avançons, allons le recevoir, M0 Et bâtir aujourd'hui le plus haut édifice, Qu'aient jamais éput te sort et ta jastice.
SCEND IIE D.	SCEND IIE D.
BERNARD DE CABRERE, D.	BERNARD DE CABRERE, D.
LOPE, LAZARILLE, SOLDATS.	LOPE, LAZARILLE, SOLDATS.
LEROY, LECOMTE, GARDES.	LEROY, LECOMTE, GARDES.
D.	D.
BERNAR D auxpieds du Roy.	BERNAR D auxpieds du Roi.
Eigneur!	Eigneur!
8 LE ROY.	8 LE ROY.
Vous à mes pieds!	Vous à mes pieds!
Gloire de cet eſtat, Vous de ma dignité le plus brillant éclat;	Gloire de cet état, Vous de ma dignité le plus brillant éclat;
Heureux reſtaurateur & ſouſtien de mon thrône, Ie vous faits Admiral!	Heureux restaurateur et soutien de mon trône, Je vous faits Admiral!
D.	D.
DERNARD.	DERNARD.
Moy, Sire,	Moi, Sire,
O Ciel!	Ô Ciel!
D.	D.
BERNARD.	BERNARD.
LE ROY.	LE ROY.
Ioignez aux miens ces inuincibles bras, Qui par tant de trauaux & par tant de combats, Ont ſi bien ſouſtenu le faix de mon Empire.	Ioignez aux miens ces invincibles bras, Qui par tant de travaux et par tant de combats, Ont si bien soutenu le faix de mon Empire.
D.	D.
BERNARD.	BERNARD.
Ama confuſion, ils ſont plus chargez, Sire, Du faix de vos bienfaits, que du faix des lauriers, Que vous ont moiſſonnez vos illuſtres guerriers;	Ama confusion, ils sont plus chargez, Sire, Du faix de vos bienfaits, que du faix des lauriers, Que vous ont moissonnés vos illustres guerriers;
Bien plus qu’eux, & que moy, voſtre nom est la foudre, Qui tonne, eſtonne, frappe, & reduit tout en poudre;	Bien plus qu'eux, et que moi, votre nom est la foudre, Qui tonne, étonne, étonne, et réduit tout en poudre;
Dom Pedre ſeul, abſent, porte plus de terreur, Que de nos bras prefents u pau tuunue fureur;	Dom Pedre seul, absent, porte plus de terreur, Que de nos bras présents pau tuunue fureur;
Et par voſtre faueur tant de fois confirmée, Vous me payez les prix de voſtre renommée, Et me recognoiſſez de vos propres exploits, Puiſque voſtre ſeul bruictrange tout ſous vos loix.	Et par votre faveur tant de fois confirmée, Vous me payez les prix de votre renommée, Et me reconnaissez de vos propres exploits, Puisque votre seul bruitrange tout sous vos lois.
I OY.	I OY.
Faiſons qu’auec le temps, l’Arragon puiſſe apprendre, Qui de nous ſçaura mieux, ou receuoir, ou rendre;	Faisons qu'avec le temps, l'Aragon puisse apprendre, Qui de nous saura mieux, ou recevoir, ou rendre;
Et qui d’affection aura mieux combattu, Ie ne me laſſeray qu’apres voſtre vertu;	Et qui d'affection aura mieux combattu, Je ne me lasserai qu'après votre vertu;
Et de ce ſeul combat, vous enuieray la gloire, De celuy de Sardaigne, apprenez moy l’Hiſtoire;	Et de ce seul combat, vous envierai la gloire, De celui de Sardaigne, apprenez moi l'Histoire;
Donnez vn ſiege au Comte.	Donnez un siège au Compte.
D.	D.
BERNARD.	BERNARD.
A peine vos vaiſſeaux, Deradez trauerſoient le vaſte champ des eaux, Que les vents ennemis de cette humide plaine, Selon noſtre beſoin, meſurans leur haleine, D’irritez qu’ils eſtoient, außi-toſt appaiſez, Feirent voir le reſpect que vous leur impoſez;	À peine vos vaisseaux, Déradez traversaient le vaste champ des eaux, Que les vents ennemis de cette humide plaine, Selon était besoin, mesurants leur haleine, D'irrités qu'ils étaient, aussitôt apaisez, Féirent voir le respect que vous leur imposez;
Cette ſeiche foreſt, eut enfin de Neptune, L’inconſtante faueur, à tel poinct opportune;	Cette seiche forêt, eut enfin de Neptune, L'inconstante faveur, à tel point opportune;
Qu’auec vn ſeul Soleil, vne nuict ſeulement, Veid & noſtre arriuée, & noſtre embarquement, L’aurore alloit ſortir, quand ie feis prendre terre A ces Mars Eſpagnols, ces Demons de la guerre, Ces fleaux des attentats,& des rebellions, Que l’honneur d’eſtre à vous, rend autant deLions.	Qu'avec un seul Soleil, une nuit seulement, Veid et notre arrivée, et notre embarquement, L'aurore allait sortir, quand je feis prendre terre À ces Mars Espagnols, ces Demons de la guerre, Ces fléaux des attentats,et des rebellions, Que l'honneur d'être à vous, rend autant deLions.
Comme l’ardeur peut tout, iointe à l’intelligence, Le temps fut meſnagé par tant de diligence;	Comme l'ardeur peut tout, jointe à l'intelligence, Le temps fut ménagé par tant de diligence;
Que le camp découuert, les murs des ennemis, Auant qu’vn vent de flame en eut porté l’aduis,	Que le camp découvert, les murs des ennemis, Avant qu'un vent de flamme en eut porté l'avis,
Et que de noſtre abord Calaris aduertie Pûſt, où nous priſmes port, faire aucune ſortie;	Et que de notre abord Calaris avertie Pût, où nous prîmes port, faire aucune sortie;
Nul ne gardoit l’accés de ces perfides murs, Mais pour eſtre deſerts, les champs n’eſtoient pas ſeurs.	Nul ne gardait l'accès de ces perfides murs, Mais pour être déserts, les champs n'étaient pas sûrs.
Car cette ingratte ville en ruſes trop experte, Auoit d’arbres couchez, la campagne couuerte.	Car cette ingrate ville en ruses trop experte, Avait d'arbres couchez, la campagne couverte.
Et parſemé de clouds les chemins d’alentour, Qui nous feirent beſoin & d’adreſſe, & de iour.	Et parsemé de clouds les chemins d'alentour, Qui nous féirent besoin et d'adresse, et de jour.
L’vn & l’autre à la fin, nous aydant le paſſage, Apres vn long trauail du piege nous degage;	L'autre et l'autre à la fin, nous aidant le passage, Après un long travail du piège nous dégage;
Et ſuiuant vn ſentier qui deſcend d’vn coſteau, A ſon pied verdiſſant, nous trouuons vn ruiſſeau, Dont le trouble criſtal qui ſortoit d’vne roche, De gens qui le fouloient, nous feiſt iuger l’aproche;	Et suivant un sentier qui descend d'un costeau, À son pied verdissant, nous trouvons un ruisseau, Dont le trouble cristal qui sortait d'une roche, De gens qui le foulaient, nous feist juger l'approche;
Là chacun attentif, conſiderant les lieux, Vn brillant eſcadron ſe preſente à nos yeux, Dont le maintien ſuperbe, & le riche equipage, Loin de nous eſtonner, nous enfle le courage, Nous fait ſauter de ioye, & nous promet le fruict, Du penible trauail de l’onde & de la nuict.	Là chacun attentif, considérant les lieux, Un brillant escadron se présente à nos yeux, Dont le maintien superbe, et le riche équipage, Loin de nous étonner, nous enfle le courage, Nous fait sauter de joie, et nous promet le fruit, Du pénible travail de l'onde et de la nuit.
Il n’eſt ſoldat ſi las, à qui le cœur ne vole, Et qui n’ait la vigueur comme l’ame Eſpagnole;	Il n'est soldat si las, à qui le cœur ne vole, Et qui n'ait la vigueur comme l'âme Espagnole;
Et preſque en vn inſtant touts nos rangs diſpoſez, Separent les trois corps dont ils ſont compoſez.	Et presque en un instant touts nos rangs disposés, Séparent les trois corps dont ils sont composés.
LE ROY aſſoupy & comme endormy.	LE ROY assoupi et comme endormi.
En vain dans cet excés de gloire & d’allegreſſe, Ie tâche à reſiſter au ſommeil qui me preße.	En vain dans cet excès de gloire et d'allégresse, Je tâche à résister au sommeil qui me pressée.
D.	D.
BERNARD.	BERNARD.
L’eſcadron recognu, lors que pour l’inueſtir, Noſtre auant-garde enfin commença de partir, Au meſme inſtant des arcs de ce peuple rebelle, Nous viſmes deßus nous fondre vne eſpaiße greſle, Qui tant que püt durer vn choc ſi violent, A leur temerité fut vn rampart volant:	L'escadron reconnu, lors que pour l'investir, Notre avant-garde enfin commença de partir, Au même instant des arcs de ce peuple rebelle, Nous vîmes dessus nous fondre un espaisse grêle, Qui tant que pu durer un choc si violent, À leur témérité fut un ramart volant:
Il ſemble à cet effort que nos rangs ſe ſeparent, Mais leurs traits épuiſez, nos forces ſe declarent, Et nous fondõs ſureux plus prompts que les éclairs Ne nous frappent la veuë, & ne percent les airs;	Il semble à cet effort que nos rangs se séparent, Mais leurs traits épuisez, nos forces se déclarent, Et nous fondons fureux plus prompts que les éclairs Ne nous frappent la vue, et ne percent les airs;
Le plus hardy s’effroye à ces viues alarmes, Rien ne reſiſte plus au torrent de nos armes, Et nous pauons le champ d’vn meſlange confus, De bras, de pieds, de corps, d’arcs, de traicts, & d’eſcus, Ceux enfin que la fuite a ſauuez de l’orage, A leur ville alarmée annoncent ce naufrage;	Le plus hardi s'effroie à ces vives alarmes, Rien ne résiste plus au torrent de nos armes, Et nous pavons le champ d'un mélange confus, De bras, de pieds, de corps, d'arcs, de traits, et d'écus, Ceux enfin que la fuite a sauvez de l'orage, A leur ville alarmée annoncent ce naufrage;
On s’y prepare au ſiege, on en munit le fort, Et la rebellion tente vn dernier effort;	On s'y prépare au siège, on en munit le fort, Et la rébellion tente un dernier effort;
Mais, Sire, ce Heros, ce prodige incroyable, MouAdmirable aux vainqueurs, aux vaincus effro-ſranc yable, Des ſiecles à venir, futur eſtonnement, Et de celuy qui court, la gloire & l’ornement;	Mais, Sire, ce Héros, ce prodige incroyable, MouAdmirable aux vainqueurs, aux vaincus effrosranc yable, Des siècles à venir, futur étonnement, Et de celui qui court, la gloire et l'ornement;
Pour tout comprendre enfin, le Grand Lope de Lune, Par vne inuention fameuſe, & non commune, Qu'vn Grec tenta iadis ſur l’empire Latin, A rendu vain l’effort de ce peuple mutin:	Pour tout comprendre enfin, le Grand Lope de Lune, Par un invention fameuse, et non commune, Qu'un Grec tenta jadis sur l'empire Latin, A rendu vain l'effort de ce peuple mutin:
Il ſe tire du camp, s’eſtant auec courage, Decoupé d’vn poignard, le ſein, & le viſage, L Lunc.	Il se tire du camp, s'étant ap courage, Découpé d'une poignard, le sein, et le visage, L Unc.
Le Roy dort.	Le Roi dort.
Et deſſus vn coureur, qu’il rend preſque aux abois, A leurs murs arriué, s’eſcrie à haute voix, Si chez vous la vertu peut treuuer quelque azyle, O Sardes genereux!	Et dessus un coureur, qu'il rend presque aux abois, À leurs murs arrivé, s'écrie à haute voix, Si chez vous la vertu peut trouver quelque azyle, Ô Sardes généreux,
ouurez moy voſtre ville, Si l’homme, encor pour l’hõme a quelque humanité, Sauuez moy d’vn tyran & de ſa cruauté, Onouure, à ſa requeſte;	ouvrez moi votre ville, Si l'homme, encor pour l'homme à quelque humanité, Sauvez moi d'un tyran et de sa cruauté, Onouvre, à sa requête;
il obtient audience, Et ſur l’eſprit de touts, gaigne tant de creance, Du à la teſte ſouuent de cinq ou puu tmre-eux, Nous venant faire au camp des deffis genereux, En differentes fois, il ſe feiſt des plus braues, Par noſtre intelligence, vn tel nombre d’eſclaues, Qu'enfin touts ioincts enſemble, & s’eſtant par moyens, Lo4 Pratiqué le ſecours de quelques Cytoyens, Par qui de ce ſecret ie receus le meßage, Dans les murs ennemis, ils ſe firent paßage, Et Dom Lope, s’acquiſt vn renom glorieux, Qui faict reuiure en luy l’eſclat de ſes ayeux?	il obtient audience, Et sur l'esprit de touts, gagne tant de créance, Du à la tête souvent de cinq ou pu tmre-eux, Nous venant faire au camp des défis généreux, En différentes fois, il se feist des plus braves, Par notre intelligence, un tel nombre d'esclaves, Qu'enfin touts joints ensemble, et s'étant par moyens, Lo4 Pratiqué le secours de quelques Cytoyens, Par qui de ce secret avait reçus le message, Dans les murs ennemis, ils se firent passage, Où Les Rage, ôacquît renom glorieux, Qui fait reuiure en lui éclat de ses aïeux?
LE ROY s’eſueillant.	LE ROY s'éveillant.
Que dira Dom Bernard, d’vn ſi profond ſilence?	Que dira Dom Bernard, d'un si profond silence?
De ce facheux ſommeil, ſorçons la violence:	De ce fâcheux sommeil, sorçons la violence:
Et prétons mieux l’oreille au recit des combats, De qui ſi dignement nous a preté le bras.	Et prétons mieux l'oreille au récit des combats, De qui si dignement nous a prêté le bras.
D.	D.
BERNARD.	BERNARD.
Dom Raimond de Moncade, a dans cet te victoire, Par des faits inouys éterniſé ſa gloire, Ermerne.	Dom Raimond de Moncade, a dans cet te victoire, Par des faits inouïs éternisé sa gloire, Ermerne.
LE ROY.	LE ROY.
Oriſtan, eſt ſon gouuernement.	Oristan, est son gouvernement.
D.	D.
BERNARD.	BERNARD.
Le Duc de Ribagorce a ſeruy dignement;	Le Duc de Ribagorce a servi dignement;
Et d’vn cœur indompté, ſignalé ſa vaillance.	Et d'un cœur indompté, signalé sa vaillance.
LE ROY.	LE ROY.
Saſſaris & Sora, ſeront ſa recompenſe.	Sassaris et Sora, seront sa récompense.
D.	D.
BERNARD.	BERNARD.
Pem Nugue à noſtre eſpoir fut vn notable appuy, Et d’vn bras genereux,	Pem Nugue à notre espoir fut un notable appui, Et d'un bras généreux,
LE ROY.	LE ROY.
Calaris eſt pour luy;	Calaris est pour cela;
Et vous reſtaurateur de la gloire publique, Ie vous faits Duc de Vas, & Comte de Modique;	Et vous restaurateur de la gloire publique, Je vous faits Duc de Vas, et Comte de Modique;
D.	D.
BERNARD.	BERNARD.
Uoprunmutung 5Seigneur, pour vn ſuiet ſi bas!	Uoprunmutung 5Seigneur, pour un sujet si bas!
Semes auec les mains, & ne répandés pàs;	Semes avec les mains, et ne répandez pays;
Voſtre profuſion en me chargeant, m’accàble, Et d’vn ſi lourd fardeau ma force eſt incapable.	Votre profusion en me chargeant, m'accàble, Et d'un si lourd fardeau ma force est incapable.
ER OY.	ER OY.
Ce prix me laiſſe encor la qualité d’ingrat, Et charge peu le bras qui ſouſtient tout l'Eſtat;	Ce prix me laisse encor la qualité d'ingrat, Et charge peu le bras qui soutient tout l'État;
Acheuons voſtre Cour, & paſſons chez l’Infante, Où nous conſulterons d’vne affaire importante, Pour qui voſtre retour nous arriue à propos, Et qui ne peut encor vous ſouffrir de repos;	Achevons votre Cour, et passons chez l'Infante, Où nous consulterons d'une affaire importante, Pour qui votre retour nous arrive à propos, Et qui ne peut encor vous souffrir de repos;
Touts s’en vont hormis D.	Touts s'en vont hormis D.
Lope, & Lazarille.	Lope, et Lazarille.
LAZARILLE.	LAZARILLE.
JOus auiez bien raiſon d’attendre ſa venuë, V Voila voſtre vertu dignement recognuë;	JOus aviez bien raison d'attendre sa venue, V Voila votre vertu dignement reconnue;
Voſtre credit eſt grand, on vous voit de bon œil, Et le Roy vous a fait vn fauorable acceuil;	Votre crédit est grand, on vous voit de bon œil, Et le Roi vous a fait un favorable acceuil;
Dom Bernard.	Dom Bernard.
D.	D.
LOPE.	LOPE.
Que veux-tu?	Que veux-tu?
ma raiſon elle-meſme, S’egare & m’abandonne en ce malheur extréme;	ma raison elle-même, S'égare et m'abandonne en ce malheur extrême;
Non tu n'es point pour moy, (dure fatalité!	Non tu n'es point pour moi, (dure fatalité!
Fille comme on te croit, de la neceßité;	Fille comme on te croit, de la necessité;
Elle n'eſtablit point ton ordre ineuitable, Par ton propre deſſein, tu nous es redoutable;	Elle n'établit point ton ordre inévitable, Par ton propre dessein, tu nous es redoutable;
Ma diſgrace n'eſt plus vn caprice du ſort, Tu ne me heurtes point parvn aueugle effort;	Ma disgrâce n'est plus un caprice du sort, Tu ne me heurtes point parvn aveugle effort;
Vne haine immortelle, vne inuincible rage, Vn deßein déclaré, t’obſtine à cet outrage.	Une haine immortelle, une invincible rage, Un dessein déclaré, t'obstine à cet outrage.
1- N En vain par tant d’exploits, ie m'acquiers tant de bruit, A qui tu veux du mal, tout trauail eſt ſans fruict:	1- N En vain par tant d'exploits, une m'acquiers tant de bruit, À qui tu veux du mal, tout travail est sans fruit:
Apres tant de ſoucis, i’eſpererois des roſes, Si tu ſuiuois pour moy, l’ordre commun des choſes, Mais tu l’enfrains barbare, & pour moy ſeulemẽt, Ton aueugle conduite eſt ſans aueuglement, Pour moy ſeul vn prodigue, vn genereux Monarque, Iette ſur ſon renom, vne honteuſe marque, Et ta rigueur en fait par vne iniuſte loy, D'vn Auguſte pourtouts, vn Tybere pour moy;	Après tant de soucis, j'espérerais des roses, Si tu suivais pour moi, l'ordre commun des choses, Mais tu l'enfrains barbare, et pour moi seulement, Ton aveugle conduite est sans aveuglement, Pour moi seul un prodigue, une généreux Monarque, Jette sur son renom, une honteuse marque, Et ta rigueur en fait par une injuste loi, D'un Auguste pourtouts, Tibère pour moi;
Quoy tant de grands effets, tant d’illuſtres offices, Perdent donc en monbras, le titre de ſeruices?	Quoi tant de grands effets, tant d'illustres offices, Perdent donc en monbras, le titre de services?
LAZARILLE.	LAZARILLE.
Vn malheureux enfin, a beau ſe deſoler, Beau ſe plaindre des Cieux, & beau les quereler;	Un malheureux enfin, a beau se désoler, Beau se plaindre des Cieux, et beau les quereler;
Ils verſent ſans deſſein les plaiſirs & les peines, Ils ne ſont point garands des affaires humaines, Et toute la nature en vain leur veut aider, A qui naiſt ſans honheur, rien ne peut ſucceder,	Ils versent sans dessein les plaisirs et les peines, Ils ne sont point garants des affaires humaines, Et toute la nature en vain leur veut aider, À qui naît sans honheur, rien ne peut succéder,
SCENVE V D.	SCENVE V D.
BERNARD, LE COMTE, D.	BERNARD, LE COMTE, D.
LOPE, LAZARILLE.	LOPE, LAZARILLE.
D.	D.
BERNARD embraſſant D.	BERNARD embrassant D.
Lope.	Lope.
DLuſt au ciel, cher de Lune, & ie le dis ſans T feinte, Que le ſort qui vous liure vne ſi rude atteinte, Et contre qui pour vous, touts mes ſouhaits ſont vains, Suiuiſt ſon inconſtance, & nous changeaſt de mains La diſgrace du Roy, me ſeroit moins ſenſible, Que le meſpris qu’il fait de ce bras inuincible;	DLût au ciel, cher de Lune, et ainsi le dis sans T feinte, Que le sort qui vous livre toujours si rude atteinte, Et contre qui pour vous, touts mes souhaits sont vains, Suivist son inconstance, et nous changeast de mains La disgrâce du Roi, me serait moins sensible, Que le mépris qu'il fait de ce bras invincible;
Qui ſeul dans la Sardaigne a reſtably ſes loix, Et dont vn ſceptre ſeul, peut payer les exploits.	Qui seul dans la Sardaigne a rétabli ses lois, Et dont un sceptre seul, peut payer les exploits.
D.	D.
LOPE.	LOPE.
Voſtre heur, parfait amy, vous dure autant d’années, Que m’ont duré d’inſtants mes triſtes deſtinées;	Votre heur, parfait ami, vous dure autant d'années, Que m'ont duré d'instants mes tristes destinées;
Le Roy vous depoſant les charges de l’Eſtat, Me fait iuſtice en vous, & ne m'eſt plus ingrat;	Le Roi vous déposant les charges de l'État, Me fait justice en vous, et ne m'est plus ingrat;
Q 9 Quoy qu'vne méme main vous eſleue, & m’abaiſſe, Le rebut m’en eſt doux, puis qu'elle vous careſſe;	 9 Quoi qu'une même main vous esleue, et m'abaisse, Le rebut m'en est doux, puis qu'elle vous caresse;
Et la moitié de moy qu’elle laiſſe ſi bas, Eclatte en la moitié, qui regit ſes Eſtats;	Et la moitié de moi qu'elle laisse si bas, Éclatte en la moitié, qui régit ses États;
Viuez donc d’Arragon, & l’amour & la gloire, Des plus chers fauoris effacez la memoire, Qu'aucun ſoin ne vous trouble en vos emplois nouueaux, Et Souueraindes mers, dõnez des frains aux eaux Tandis que de fortune éprouuant l’autre face, Chetif & triſte obiect d’opprobre, & de diſgrace, Ie gouſteray chez moy pour le moins le bonheur, De ſçauoir mon amy dans ce haut rang d’honneur;	Vivez donc d'Aragon, et l'amour et la gloire, Des plus chers favoris effacés la mémoire, Qu'aucun soin ne vous trouble en vos emplois nouveaux, Et Souueraindes mers, dõnez des frains aux eaux Tandis que de fortune éprouvant l'autre face, Chétif et triste objet d'opprobre, et de disgrâce, Je goûterai chez moi pour le moins le bonheur, De mi mon ami dans ce haut rang d'honneur;
Et pouuoir oppoſer à ſa rigueur extréme, Le bien qu'elle me fait en vn autre moy-meſme.	Et pouvoir opposer à sa rigueur extrême, Le bien qu'elle me fait en un autre moi-même.
D.	D.
BERNARD.	BERNARD.
Auec plus d’eſperance, épargnez ma douleur, Et croyez que ie tiens à ſenſible malheur, De pouuoir oppoſer à ſa faueur extréme, Le mal qu’elle me fait en vn autre moy-meſme.	Avec plus d'espérance, épargnez ma douleur, Et croyez que personne tiens à sensible malheur, De pouvoir opposer à sa faveur extrême, Le mal qu'elle me fait en un autre moi-même.
LE COMTE.	LE COMTE.
Il eſt vray que iamais vertu n’auoit produit, De ſi fameux ſuccés auec ſi peu de fruict, Et que d’vn art ſçauant, & d’vn pinceau fidelle;	Il est vrai que jamais vertu n'avait produit, De si fameux succès avec si peu de fruit, Et que d'H art savant, et d'un pinceau fidèle;
Dom Bernard en a fait la peinture ſi belle;	Dom Bernard en a fait la peinture si belle;
Qu'enfin ſans vous flatter, il faut qu’à ce recit, Quelque grand ſoin du Prince ait diuerti l’eſprit, Pour en auoir lai ßé la gloire ſans ſeconde, Si ſterile pour vous & pour luy ſi feconde.	Qu'enfin sans vous flatter, il faut qu'à ce récit, Quelque grand soin du Prince ait diverti l'esprit, Pour en avoir lai de la gloire sans seconde, Si stérile pour vous et pour lui si féconde.
D.	D.
LOPE.	LOPE.
Le fauorable accés qu’elle a dans vos eſprits, Me la rend trop fertile, & m’eſt vn prix ſans prix.	Le favorable accès qu'elle a dans vos esprits, Me la rend trop fertile, et m'est un prix sans prix.
D.	D.
BERNARD.	BERNARD.
Nous reuerons le Roy, la priere obſtinée, pecouc eueiquesſeusey cuino iu ueſtinée.	Nous révérons le Roi, la prière obstinée, pécouc eueiquesseusei cuin yu uestinée.
Ce vous ſera du moins vn fruict de ſon refus, Si nous n’obtenons rien, que de n’eſperer plus;	Ce vous sera du moins un fruit de son refus, Si nous n'obtenons rien, que de n'espérer plus;
Mais il repoſe, adieu.	Mais il repose, adieu.
D.	D.
LOPE.	LOPE.
Le ciel vous ſoit propice, Et me faſſe acquiter de cet heureux office!	Le ciel vous soit propice, Et me fasse acquitter de cet heureux office!
O foibleſſe!	Ô faiblesse!
ô contrainte!	ô contrainte!
indigne d’vn grand cœur, D’auoir pour la vertu recours à la faueur!	indigne d'un grand cœur, D'avoir pour la vertu recours à la faveur!
Laſche, deurois-ie encor.	Lâche, devrais-je encor.
LENVE VE D.	LENVE VE D.
LOPE, DOROTHEE à la feneſtre.	LOPE, DOROTHÉE à la fenêtre.
LAZARILLE.	LAZARILLE.
DOROTHEE luy iettant vne lettre.	DOROTHÉE était jetant une lettre.
Dom Lope, cette lettre, Qu'en voſtre propre main i’ay charge de remettre, Vous inuite à meſler du myrthe à vos lauriers, Et des ſuccés d’amour, à vos ſuccés guerriers;	Dom Lope, cette lettre, Qu'en votre propre main j'ai charge de remettre, Vous inuite à mêler du myrthe à vos lauriers, Et des succès d'amour, à vos succès guerriers;
Soyez diſcret, adieu, l'obiet qui vous l'adreſſe, Eſt d’vn rãg & d’vn ſang, digne d’vne maiſtreſſe,	Soyez discret, adieu, l'objet qui vous l'adresse, Est d'un rang et d'un sang, digne d'une maîtresse,
Elle ſort de la feneſtre.	Elle sort de la fenêtre.
D.	D.
LOPE ramaſſant la lettre.	LOPE ramassant la lettre.
Veillons nous, réuons nous?	Veillons -nous, réuons -nous?
puis-ie eſtre en meſme iour, Si mal auec le ſort, & bien auec l’amour!	puis-je être en même jour, Si mal avec le sort, et bien apprendre l'amour!
LAZARILLE.	LAZARILLE.
Non non, cet enragé vous eſtant ſi contraire, Quelle eſt la malheureuſe, à qui vous pourriez plaire?	Non non, cet enragé vous étant si contraire, Quelle est la malheureuse, à qui vous pourriez plaire?
A D.	À D.
LOPE DE LVNE.	LOPE DE LUNE.
Au voyage de Vas, où nous ſuiuions le Roy.	Au voyage de Vas, où nous suivions le Roi.
Vne ſecrette ardeur, vous engagea ma foy, Et vous ayant depuis conſerué mon hommage, Vous en veut auiourd’huy confier le ſecret, Venez ce ſoir au parc, ſeul, fidele, & diſcret, En ſçauoir dauantage.	Une secrète ardeur, vous engagea ma foi, Et vous ayant depuis conservé mon hommage, Vous en veut aujourd'hui confier le secret, Venez ce soir au parc, seul, fidèle, et discret, En savoir davantage.
Il continuë.	Il continue.
Violante:	Violante:
eſt-ce vn ſonge!	est-ce un songe!
eſt-ce vne illuſion?	est-ce une illusion?
De quoy me flattes-tu chere confuſion?	De quoi me flattes-tu chère confusion?
Violante!	Violante!
l’Infante, à mon ſuiet atteinte!	l'Infante, à mon sujet atteinte!
O glorieux meſlange & d’eſpoir & de crainte!	Ô glorieux mélange et d'espoir et de crainte!
Beau ſonge, qui promets plus que ie ne pretends, Dißipe toy bien tard, & dure moy long-temps:	Beau songe, qui promets plus que je ne prétends, Dipe toi bien tard, et dure moi longtemps:
Ie veis l’Infante à Vas, ma doute n’eſt point vai3 Des appas innocens n’accuſons plus la haine, Si de cette Princeſſe ils m’ont acquis les vœux, L’heur qu’ils m'õt procuré m’eſleue au deſſus d’eux;	Je veis l'Infante à Vas, ma doute n'est point vai3 Des appas innocents n'accusons plus la haine, Si de cette Princesse ils m'ont acquis les vœux, L'heur qu'ils m'ont procuré m'esleue au dessus d'eux;
Mais tirons nous dicy, que mon tranſport n’euente, Les ſecrets mouuemens d’vne ardeur imprudente, Qui pourroit ruiner le plus heureux eſpoir, que l'amour a mortel feiſt iamais conceuoir,	Mais tirons nous dicy, que mon transport n'évente, Les secrets mouvements d'une ardeur imprudente, Qui pourrait ruiner le plus heureux espoir, que l'amour a mortel feît jamais concevoir,
LAZARILLE le ſuiuant.	LAZARILLE le suivant.
L’Infante!	L'Infante!
ô qu’il eſt vaintô quelle extrauagance!	ô qu'il est vaintô quelle extravagance!
Tant de malheur, luy ſouffre encor tant d’arroance!	Tant de malheur, Seigneur souffre encor tant d'arroance!
Luy, l’Infante!	Lui, l'Infante!
vn moment l’auoit bien releué!	un moment l'avait bien relevé!
Cherchons, cherchons party, mon maiſtre eſt acheué.	Cherchons, cherchons parti, mon maître est achevé.
MOu.	MOu.
TITIE IIL	TITIE IIL
SUENDATDHRERE L’INFANTE, LEONOR.	SUENDATDHRERE L'INFANTE, LEONOR.
Mai L’INFANTE.	Mai L'INFANTE.
SOmteſſe, voſtre eſprit trop aiſement s’altere La plus belle vertu n’eſt pas la plus auſtere, Les regards, l’entretien de modeſtes esbats, Exercent ſa candeur & ne l'offencent pas.	SOmtesse, votre esprit trop aisément s'altère La plus belle vertu n'est pas la plus austère, Les regards, l'entretien de modestes ébats, Exercent sa candeur et ne l'offensent pas.
Si vous n’aymez l’amant, ſouffrez en la perſonne;	Si vous n'aimez l'amant, souffrez en la personne;
LEONOR.	LEONOR.
L’approche en eſt ſuſpecte auec vne Couronne, Toute honneſte qu'elle eſt, elle fait murmurer, Et ſouuent deshonore, à force d’honorer.	L'approche en est suspecte avec une Couronne, Toute honnête qu'elle est, elle fait murmurer, Et souvent déshonore, à force d'honorer.
Le Roy ne peut déplaire auec toutes les marques, Qui font conſiderer les plus parfaits Monarques:	Le Roi ne peut déplaire avec toutes les marques, Qui font considérer les plus parfaits Monarques:
Mais d’autant plus l’honneur, qu’il me fait de ſes vœux, En iette dans les cœurs, des ſentiments douteux.	Mais d'autant plus l'honneur, qu'il me fait de ses vœux, En jette dans les cœurs, des sentiments douteux.
L’INFANTE.	L'INFANTE.
Fonder ſur des ſoupçons cette rigueur extréme, Eſt bien mal ménager l’eſpoir d’vn diadéme;	Fonder sur des soupçons cette rigueur extrême, Est bien mal ménager l'espoir d'un diadème;
Il en peut faire vn iour tribut à vos appas, Ses jevreis jentimems ne s’en cioignent pas;	Il en peut faire un jour tribut à vos appas, Ses jevreis jentimems ne s'en cioignent pas;
De moindres paßions ont fait des Souueraines, Et vous eſtes d’vn ſang qui peut dõner des Reines;	De moindres passions ont fait des Souveraines, Et vous êtes d'un sang qui peut donner des Reines;
LEONOR.	LEONOR.
Quelques ſi doux attraits dont on puiſſe éclatter, Des thrônes ne ſont pas des prix à meriter.	Quelques si doux attraits dont on puisse éclatter, Des trônes ne sont pas des prix à mériter.
Le ridicule eſpoir de cet honneur inſigne, Le deuroit rebuter, & m’en rendroit indigne;	Le ridicule espoir de cet honneur insigne, Le devrait rebuter, et m'en rendrait indigne;
Mais vous ſur qui le ciel répand à pleines mains, Les treſors qu’il départ aux plus heureux humains, Et dont les ornements & du corps& de l’ame, Iettent dans touts les cœurs, le reſpect, & la flame;	Mais vous sur qui le ciel répand à pleines mains, Les trésors qu'il départ aux plus heureux humains, Et dont les ornements et du corps de l'âme, Jettent dans touts les cœurs, le respect, et la flamme;
Vous dont tout le ſangregne, & fait par tout des loix, C’eſt pour vous que l’amour a deſtiné des Rois.	Vous dont tout le sangregne, et fait par tout des lois, C'est pour vous que l'amour a destiné des Rois.
La Murcie, & Leon preſſent auec inſtance, Par leurs ambaſſadeurs, voſtre illuſtre alliance;	La Murcie, et Léon pressent avec instance, Par leurs ambassadeurs, votre illustre alliance;
Et quelque ſi haut thrône, où vous veuillez, monter Il ſera glorieux de l’heur de vous porter.	Et quelque si haut thrône, où vous veuillez, monter Il sera glorieux de l'heur de vous porter.
L’INFANTE.	L'INFANTE.
Indifferente encor ie n'épouſe perſonne, Ie laiſſe au Roy mon frere, à choiſir ma Couronne, Et quoy que de mon fort apent vraount les cieux, Ne prends que par ſes mains, ny voy que par ſes yeux;	Indifférente encor ie n'épouse personne, Je laisse au Roi mon frère, à choisir ma Couronne, Et quoi que de mon fort apent vrount les cieux, Ne prends que par ses mains, ainsi vois que par ses yeux;
LEONOR.	LEONOR.
Il m’eſt donc libre enfin de vous ouurir mon ame, Puiſque voſtre froideur autoriſe ma flame;	Il m'est donc libre enfin de vous ouvrir mon âme, Puisque votre froideur autorise ma flamme;
Et qu’encor ſans deſſein, & ſans election, Vous pouuez, a pprouuer mon inclination;	Et qu'encor sans dessein, et sans élection, Vous pouvez, a pprouver mon inclination;
Ie ne le puis nier, i’ay creu qu’en voſtre grace, Dom Bernard que i’adore, occupoit quelque place;	Je ne le puis nier, j'ai cru qu'en votre grâce, Dom Bernard que j'adore, occupait quelque place;
Et dans ce ſentiment taſchois de reprimer Le mouuement ſecret qui me force à l’aimer;	Et dans ce sentiment tâchais de réprimer Le mouvement secret qui me force à l'aimer;
Ie ſçay voſtre naiſſance & qu’en ce rang ſupréme, On ne vous peut pretendre à moins d’vn diadéme;	Je sais votre naissance et qu'en ce rang suprême, On ne vous peut prétendre à moins d'un diadème;
Mais d’ailleurs ſon bonheur à ſon meriteégal, Fait (comme par vn charme aux libertez fatal,) Preſque de touts les cœurs, des conqueſtes ſecretes, Qui me rendoient ſuppeut t'etat que vons enfaites.	Mais d'ailleurs son bonheur à son meriteégal, Fait (comme par un charme aux libertés fatal,) Presque de touts les cœurs, des conquêtes secrètes, Qui me rendaient supput t'état que vons enfaites.
Ialouſe, I'alouſe, ie tenois pour vn tribut d’amour, Le fauorable accueil qu’a trouué ſon retour;	Jalouse, J'alouse, on tenais pour un tribut d'amour, Le favorable accueil qu'a trouvé son retour;
Et quoy que tant d’honneur luy ſoit troplegitime, Ay creu qu’il procedoit d'ailleurs que de l’eſtime;	Et quoi que tant d'honneur lui soit tropélégitime, Ai cru qu'il procédait d'ailleurs que de l'estime;
Mais grace à vos froideurs, mes vœux ſont accomplis, Mes doutes reſolus, mes maux enſeuelis;	Mais grâce à vos froideurs, mes vœux sont accomplis, Mes doutes résolus, mes maux ensevelis;
I'oze meſme eſperer que par voſtre aßiſtance, Le Roy me permettant l’heur de cette alliance, Et perdant vn eſpoir qui ne luy produit rien, Auecques mon repos, rétablira le ſien.	J'ose même espérer que par fois assistance, Le Roi me permettant l'heur de cette alliance, Et perdant un espoir qui ne lui produit rien, Avecques mon repos, rétablira le sien.
L’INFANTE.	L'INFANTE.
Quoy qu’au choix d’vn amant, mon ame irreſoluë, Sur cette paßion, ſoit encor abſoluë, Et que ce Dom Bernard, de qui les qualitez, Triomphent (dites-vous) de tant de libertez, Quelques myrthes nouueaux, qui luy couurent la teſte, N’ait pas ſuiet encor de vanter ma conqueſte;	Quoi qu'au choix d'Hannant, mon âme irrésolue, Sur cette passion, soit encor absolue, Et que ce Dom Bernard, de qui les qualités, Triomphent (dites-vous) de tant de libertés, Quelques myrthes nouveaux, qui lui couvrent la tête, N'ait pas sujet encor de vanter ma conquête;
Ie ne puis toutesfois ſi toſt determiner, Sur le conſentement de vous l abandonner;	Je ne puis toutefois si tôt déterminer, Sur le consentement de vous l abandonner;
Et ſur voſtre creance, ou fauſſe, ou legitime, Que l’eſtat que i’en faits, doiue paſſer l’eſtime.	Et sur votre créance, ou fausse, ou légitime, Que l'état que j'en faits, doive passer l'estime.
Et le peu de reſpect que vous me faités voir, D'auoir eu du de ßein, où i’en pouuois auoir,	Et le peu de respect que vous me faitez voir, D'avoir eu du de ssein, où j'en pouvais avoir,
Mon cœur deſia touché de ſes vertus inſignes, Conçoit en ſa faueur des ſentiments ſi dignes, Qu'auant que d’en reſoudre & d’en rien ordonner, Auec plus de loiſir, ie veux l’examiner;	Mon cœur déjà touché de ses vertus insignes, Conçoit en sa faveur des sentiments si dignes, Qu'avant que d'en résoudre et d'en rien ordonner, Avec plus de loisir, je veux l'examiner;
Qui peut faire d’vn Roy negliger le ſeruage, Se pourra bien treuuer digne de mon hommage;	Qui peut faire d'un Roi négliger le servage, Se pourra bien trouver digne de mon hommage;
Et m’eſt autant qu’à vous, preferable à des Rois, S’il eſt aſſez puiſſant pour me donner des loix.	Et m'est autant qu'à vous, préférable à des Rois, S'il est assez puissant pour me donner des lois.
C’eſtoit manquer à vous, d’adreſſe & de prudence, Que de mettre à mes yeux vos feux en euidence, Sans ſçauoir ſi mon cœur y pourroit conſentir, Puis que ſi peu de cœurs s’en peuuent garantir.	C'était manquer à vous, d'adresse et de prudence, Que de mettre à mes yeux vos feux en évidence, Sans savoir si mon cœur y pourrait consentir, Puis que si peu de cœurs s'en peuvent garantir.
Vous auez deu ſçauoir qu’à l’humeur de la femme, C’eſtoit perſuader que deffendre vne flamme;	Vous avez dev sçauoir qu'à l'humeur de la femme, C'était persuader que défendre une flamme;
Et que la jalouſie & ſur tout dans la Cour, Eſt mere außi ſouuent, que fille de l’amour.	Et que la jalousie et sur tout dans la Cour, Est mère aussi souvent, que fille de l'amour.
Le temps me donnera l’aduis que ie dois prendre, Sur ce que ie vous doibs ou permettre, ou deffendre;	Le temps me donnera l'avis que ici dois prendre, Sur ce que je vous doibs ou permettre, ou défendre;
Cependant deliurez voſtre eſprit d’vn tourment, Qui luy pourroit durer peut-eſtre vainement.	Cependant délivrez votre esprit d'un tourment, Qui Qui pourrait durer peut-être vainement.
Elle s’enva la regardant de coſté.	Elle s'enva la regardant de côté.
DCENSII LEONOR ſeule.	DCENSII LEONOR seule.
On non, ie n’ay manqué, ny d’art, ny de prudence, Quand i’ay mis à vos yeux, mes feux en euidence;	On non, notre n'ai manqué, Seigneur d'art, ni de prudence, Quand j'ai mis à vos yeux, mes feux en évidence;
I’en obtiens les effets que i’en ay ſouhaittez, Puiſque i’ay par les miens les voſtres euentez.	J'en obtiens les effets que j'en ai souhaitez, Puisque j'ai par les miens les vôtres éventez.
Iuſqu’icy l’abuſée auoit creu me les taire, Mais l’œil eſt aux amants vn mauuais ſecretaire;	Jusqu'ici l'abusée avait cru me les taire, Mais l'œil est aux amants un mauvais secrétaire;
Et l’on voit aisément vn feu bien embrazé, Au trauers du criſtal dont il eſt compoſé;	Et l'on voit aisément un feu bien embrasé, Au travers du cristal dont il est composé;
Cent fois de leurs regards, la rencontre fatale, M'a fait voir cette flame, & monſtré ma riuale;	Cent fois de leurs regards, la rencontre fatale, M'a fait voir cette flamme, et montré ma rivale;
Cent ſouſpirs étouffez, & cent geſtes confus, M'auoient dit le ſecret qu'elle ne cache plus;	Cent soupirs étouffés, et cent gestes confus, M'avaient dit le secret qu'elle ne cache plus;
I’ay mieux leu qu’elle enfin dans ſa propre penſée, Sa bonté pour le Prince eſtoit intereßée, Et penſant m’esblouyr, vouloit moins partãt d’art, Le placer dans mon cœur, qu’en chaſſer Dom Bernard, Mais en vain elle attend l’auis qu’elle doit prẽdre, Sur ce qu'elle me doit, ou permettre, ou deffendre;	J'ai mieux lu qu'elle enfin dans sa propre pensée, Sa bonté pour le Prince était interessée, Et pensant m'éblouir, voulait moins partout d'art, Le placer dans mon cœur, qu'en chasser Dom Bernard, Mais en vain elle attend l'avis qu'elle doit prendre, Sur ce qu'elle me doit, ou permettre, ou défendre;
Où le deßein eſt prix, ſon ordre eſt ſuperflu, Elle n’entreprend pas vn cœur irreſolu;	Où le dessein est prix, son ordre est superflu, Elle n'entreprend pas un cœur irrésolu;
Et quoy qu'elle preſume auecques ſa puißance, Doit craindre mõ amour, plus que moy ſa deffenſe.	Et quoi qu'elle présume auecques sa puissance, Doit craindre mon amour, plus que moi sa défense.
SCEIVEIII DE SECRETAIRE, LEONOR.	SCEIVEII DE SECRÉTAIRE, LEONOR.
LEONOR.	LEONOR.
V’eſt-ce Perés ?	V'est-ce Perrez ?
LE SECRETAIRE.	LE SECRÉTAIRE.
Le Roy touſiours inquieté, S'informe a tous moments queue eſt voſtre ſanté.	Le Roi toujours inquiété, S'informe a tous moments queue est votre santé.
LEONOR.	LEONOR.
Ses ſoings m’honorent trop.	Ses soins m'honorent trop.
LE SECRETAIRE.	LE SECRÉTAIRE.
Il ſe plaind, il ſouſpire, Et vous le poſſedez, auecques tant d’empire, Que toute ſa ſplendeur n’a rien de precieux, A l’egal d’vn regard qu’il reçoit de vos yeux;	Il se plaind, il soupire, Et vous le possédez, avec tant d'empire, Que toute sa splendeur n'a rien de précieux, À l'égal d'un regard qu'il reçoit de vos yeux;
Ce thrône qu’auiourd’huy tout l’vniuers reuere, Eſt vn ſiege, où deſia chacun vous conſidere;	Ce trône qu'aujourd'hui tout l'Univers révère, Est un siège, où déjà chacun vous considère;
Et tous ſes entretiens font aisément iuger, Des paßions qu’il a de vous le partager.	Et tous ses entretiens font aisément juger, Des passions qu'il a de vous le partager.
LEONOR.	LEONOR.
Outre que de l’Eſtat les raiſons importantes;	Outre que de l'État les raisons importantes;
Au party de Nauarre attachent ſes attentes, Ie ne ſçay quel meſpris ſtupide ou genereux, Quelque éclat qu’ait vn thrône, en détourne mes vœux;	Au parti de Navarre attachent ses attentes, Je ne sais quel mépris stupide ou généreux, Quelque éclat qu'ait un trône, en détourne mes vœux;
Ie t’ay mis à la Cour, & croyſans imprudence, Pouuoir ſur vn ſecret, prendre ta confidence, Et m’ozant repoſer ſur ta diſcretion, Intereſſer tes ſoins dedans ma paßion.	Je t'ai mis à la Cour, et croissants imprudence, Pouvoir sur un secret, prendre ta confidence, Et m'osant reposer sur ta discrétion, Intéresser tes soins dedans ma passion.
LE GLERETAINE.	LE GLÈRETAINE.
Si vous m’honorez tant, ie chery moins la vie, Que ie ne feray l’heur de vous auoir ſeruie.	Si vous m'honorez tant, je chéri moins la vie, Que ie ne ferai l'heur de vous avoir servie.
LEONOR.	LEONOR.
Pour Cabrere en vn mot, mon cœur bruſle d’amour:	Pour Cabre en un mot, mon cœur brûle d'amour:
Mais comme ſes vertus charment toute la Cour;	Mais comme ses vertus charment toute la Cour;
Et qu’il treuue par tout des vœux ſi legitimes, Il compte encor l'Infante au rang deſes victimes, Dont le deſſein du mien trauerſera le cours, Si ma flame en ton art ne treuue vn prompt ſecours.	Et qu'il trouve par tout des vœux si légitimes, Il compte encor l'Infante au rang deses victimes, Dont le dessein du mien traversera le cours, Si ma flamme en ton art ne trouve un prompt secours.
Tu peux de Dom Bernard imiter l’écriture, Fay moy de ſon amour vne viue peinture, Couchez y touts les traits, dõt la main d’vn amant Nous peut repreſenter vn ſenſible tourment;	Tu peux de Dom Bernard imiter l'écriture, Fais moi de son amour une vive peinture, Couchez y touts les traits, dont la main d'un amant Nous peut représenter un sensible tourment;
Et dont on peut toucher le cœur d’vne maiſtreſſe, Souſcry là de ſon nom, la ferme & me l’adreſſe.	Et dont on peut toucher le cœur d'une maîtresse, Souscri là de son nom, la ferme et me l'adresse.
Prepare à mon eſpoir cet heureux fondement, Le reſte parmes ſoins, concerté dextrement:	Prépare à mon espoir cet heureux fondement, Le reste parmes soins, concerté dextrement:
Si beaucoup de malheur n'euente l'artifice, De ſes pretentions détruira l’edifice.	Si beaucoup de malheur n'évente l'artifice, De ses prétentions détruira l'édifice.
LE SECRETAIRE.	LE SECRÉTAIRE.
Cent deſpeſches au Roy, que i’ay de Dom Bernard, Me feront imiter ſa lettre auec tant d’art, Et ſi bien ſucceder le glorieux office Que ie me rends moy-meſme, en vous rendant ſeruice, Que Dom Bernard luy meſme, heſiteroit en vain, Et dedans mon ecrit recognoiſtroit ſa main,	Cent dépêches au Roi, que j'ai de Dom Bernard, Me feront imiter sa lettre avec tant d'art, Et si bien succéder le glorieux office Que on me rends moi-même, en vous rendant service, Que Dom Bernard lui -même, hésiterait en vain, Et dedans mon écrit reconnaîtrait sa main,
LEONOR s’en allant.	LEONOR s'en allant.
Ie t'attends, mais ſur tout, ſois diſcret, & fidele.	Je t'attends, mais sur tout, sois discret, et fidèle.
LE SECRETAIRE.	LE SECRÉTAIRE.
Ce ſeruice à l’inſtant, außi prompt que mon zele, Dedans ce cabinet vous va prouuer ma foy, Puis ſur voſtre ſanté, ie reueray le Roy.	Ce service à l'instant, aussi prompt que mon zèle, Dedans ce cabinet vous va prouver ma foi, Puis sur votre santé, je révérai le Roi.
SCLIVETI LE SECRETAIRE ſeul entrant dans le cabinet, où il treuue vne écritoire, du papier, & des lettres de Dom Bernard.	SCLIVETI LE SECRÉTAIRE seul entrant dans le cabinet, où il trouve une écritoire, du papier, et des lettres de Dom Bernard.
A promeſſe m'engage en vn peril extréMrne.	A promesse m'engage en un péril extrême.
Ie trahy D.	Je trahi D.
Bernard, l’Infante, & le Roy meſme;	Bernard, l'Infante, et le Roi même;
Mais quel aueugle ſoin, ne dois-ie à qui ie doy Ce que i'aydans la Cour de credit (S d employ?	Mais quel aveugle soin, ne dois-je à qui belle dois Ce que j'aidans la Cour de crédit (S d emploi?
Et pour qui puis-ie mieux, (ô frayeur importune!	Et pour qui puis-je mieux, (ô frayeur importune!
Que pour qui la ſouſtient, haſarder ma fortune?	Que pour qui la soutient, hasarder ma fortune?
Il lit vne des lettres de D.	Il lit notre des lettres de D.
Bernard.	Bernard.
Sire, par le pacquet qu’on me rend auiourd’huy, I’aprends trop.	Sire, par le pacquet qu'on me rend aujourd'hui, J'aprends trop.
D.	D.
Bernard;	Bernard;
cette lettre eſt de luy	cette lettre est de Seigneur
Il en lit vne autre.	Il en lit autre.
Noſtre entrepriſe, Sire, eſt ſi preſte d’éclore, Qu'auant que le courrier.	Notre entreprise, Sire, est si prête d'éclore, Qu'avant que le courrier.
cette ſeconde encore;	cette seconde encore;
Autre.	Autre.
Sire, auant mon depart, i’aurois executé, Les ordres que i’auois de voſtre Majeſté;	Sire, avant mon départ, j'aurais exécuté, Les ordres que j'avais de votre Majesté;
Sans l’auis important que ie ne vous puis taire.	Sans l'avis important que tu ne vous puis taire.
, Il continuë, ayant leu.	, Il continue, ayant lu.
Sur celle cy ma main forme ton caractere;	Sur celle cy ma main forme ton caractère;
Ce genre d’écriture, a qui tu peux vanter La tienne aſſez conforme, eſt aisé d'imiter;	Ce genre d'écriture, a qui tu peux vanter La tienne assez conforme, est aisé d'imiter;
Il écrit, regardant la lettre de Dom Bernard.	Il écrit, regardant la lettre de Dom Bernard.
EIVE LE ROY, LE SECRETAIRE.	EIVE LE ROY, LE SECRÉTAIRE.
Auray-ie point de trefue, aymable ViolenC Souſpirs deſauoüez qui troublez mon ſilence, Que ma raiſon condamne & ne peut étouffer!	Aurai-je point de trouve, aimable ViolenC Soupirs desauoüez qui troublés mon silence, Que ma raison condamne et ne peut étouffer!
Et d’vn ingrate enfin, ne puis-je triompher?	Et d'un ingrate enfin, ne puis-je triompher?
Dous jetongatemps entorinfupportables flammes, Sans eſpoir d’allegeance,	Dous jetongatemps entorinfupportables flammes, Sans espoir d'allégeance,
LE SECRETAIRE écriuant.	LE SECRÉTAIRE écrivant.
Exercent ſur les ames.	Exercent sur les âmes.
LE DY.	LE DY.
Mais que fait la Perés?	Mais que fait la Perrez?
il ſçait ma paßion, Et s'acquitte ſi mal de ſa commißion?	il sait ma passion, Et s'acquitte si mal de sa commise?
Differant Differant ſa réponſe, il prolonge mes peines;	Différant Différant sa réponse, il prolonge mes peines;
Qu'ecrit-tl t'approthons.	Qu'écrit-tl t'aprothons.
LE SECRETAIRE écriuant.	LE SECRÉTAIRE écrivant.
Des teſtes Souueraines.	Des têtes Souueraines.
LEI OY.	LEI OY.
M'ourdit-il quelque trame, & ſa fidelité Se relaſcheroit-elle à quelque fauſſeté?	M'ourdit-il quelque trame, et sa fidélité Se relâcherait-elle à quelque fausseté?
LE SECREI AIRE écriuant.	LE SÉCREI AIRE écrivant.
Mais, belle Leonor, ſi mon amour extréme;	Mais, belle Leonor, si mon amour extrême;
LE ROY.	LE ROY.
du prpouuumout,mefier tobiet qued'aime!	du prpouuumout,mefier tobjet qued'aime!
LE SECRETAIRE écriuant.	LE SECRÉTAIRE écrivant.
Et les fers glorieux.	Et les fers glorieux.
LE ROY.	LE ROY.
A celle que ie ſers, Parler inſolemment & de feux& de fers!	À celle que ici sers, Parler insolemment et de feuxet de fers!
LE SECRETAIRE écriuant.	LE SECRÉTAIRE écrivant.
L’eclat.	L'éclat.
LE OY.	LE OY.
Oſeroit-il ſçachant que ie l’adore, Pretendre, l’arrogant, aux faueurs que i’implore?	Oserait-il sçachant que . l'adore, Pretendre, l'arrogant, aux faveurs que j'implore?
Auroit-il l’inſolence & la temerité, De former vn deſſein.	Aurait-il l'insolence et la témérité, De former un dessein.
El DLERETAIRE.	Él DLERETAIRE.
Et par ſa pureté.	Et par sa pureté.
LE ROY entrant dans le cabinet.	LE ROY entrant dans le cabinet.
Mais en puis-je eſtre en doute, & ſi long-temps attendre?	Mais en puis-je être en doute, et si longtemps attendre?
LE SECRETAIRE écriuant.	LE SECRÉTAIRE écrivant.
ie prelena,.	Elle prena,.
LE ROY luy arrachant l’écrit.	LE ROY te arrachant l'écrit.
Voyons traiſtre, à quoy tu peux pretendre.	Voyons traître, à quoi tu peux prétendre.
LU CECRETAIRE ſurpris.	LU CECRETAIRE surpris.
Arien, Sire, i’ecry.	Arien, Sire, j'écri.
LE ROY.	LE ROY.
Donne moy cet écrit:	Donne -moi cet écrit:
Dieux!	Dieux!
DETCABRERE.	DETCABRERE.
LE SECRETAIRE.	LE SECRÉTAIRE.
LE ROY.	LE ROY.
Que dois-je inferer de ce trouble d’eſprit?	Que dois-je inférer de ce trouble d'esprit?
Perfide!	Perfide!
quelle foyveux-tu que i'en preſume?	quelle foiveux-tu que j'en présume?
LE SECRETAIRE.	LE SECRÉTAIRE.
I'écriuois ſans deſſein, que d’éprouuer ma plume;	J'écrivais sans dessein, que d'éprouver ma plume;
LE ROY lit.	LE ROY lit.
Ie ne demande pas vne ſource de flames, Que vous me permettiez vne neceßité, Le pouuoir que vos yeux exercent ſur les ames, Doit répondre pour moy de ma captiuité;	Je ne demande pas une source de flammes, Que vous me permettiez une necemité, Le pouvoir que vos yeux exercent sur les âmes, Doit répondre pour moi de ma captivité;
Ie ſçay bien que mõ rãg deshonore vos chaiſnes, Et que voſtre beau joug aux libertez fatal, Semble faiſant ployer des teſtes Souueraines, Tomber indignement ſur le col d’vn vaſſal.	Je sais bien que mon rãg deshonore vos chaînes, Et que votre beau joug aux libertés fatal, Semble faisant ployer des têtes Souveraines, Tomber indignement sur le col d'un vassal.
Mais, belle Leonor, ſi mon amour extréme, Et les fers glorieux où ie ſuis arreſté;	Mais, belle Leonor, si mon amour extrême, Et les fers glorieux où je suis arrêté;
Ne brillent par l’éclat que tette vn diadéme, Ils brillent par ma flamme & par ſa pureté.	Ne brillent par l'éclat que tette un diadème, Ils brillent par ma flamme et par sa pureté.
L'hymenen uprannasirrris	L'hymen uprannasirrris
LE ROY continuë.	LE ROY continue.
Et cette audace, traiſtre?	Et cette audace, traître?
Seigneur!	Seigneur!
LE SECRETAIRE.	LE SECRÉTAIRE.
LE Y.	LE Y.
Eſt le reſpect d’vn vaſſal à ſon maiſtre!	Est le respect d'un vassal à son maître!
I’ay fait vn digne choix, & verſois mon ſecret, Dans vne ame loyale, & dans vn ſein diſcret, Quoy perfide!	J'ai fait un digne choix, et versais mon secret, Dans une âme loyale, et dans un sein discret, Quoi perfide!
vne ardeur de ſens ſi dépourueuë, Te fait leuer les yeux où ie porte la veuë, Et tes feux inſolents me donnent pour riual, L’indigne agent des miens, vn Miniſtre, vn vaſſal C’eſt auec iuſte droit, traiſtre que ie te fie Les ſecrets concernants mon honneur & ma vie, Si tu me peux tramer ce deſtable tour, Et ſi tu m’es perfide en vn crime d’amour;	une ardeur de sens si dépourvue, Te fait lever les yeux où il porte la vue, Et tes feux insolents me donnent pour rival, L'indigne agent des miens, Seigneur Ministre, un vassal C'est avec juste droit, traître que sans te fie Les secrets concernants mon honneur et ma vie, Si tu me peux tramer ce destable tour, Et si tu m'es perfide en un crime d'amour;
C’eſt là ce zele ardent que tu faiſois paroiſtre?	C'est là ce zèle ardent que tu faisais paraître?
Hola Gardes!	Holà Gardes!
ALNE VI GARDES,LE ROY, LE SECRETAIRE.	ALNE VI GARDES,LE ROY, LE SECRÉTAIRE.
L.	L.
GARDE.	GARDE.
Seigneur!	Seigneur!
LE ROY.	LE ROY.
Aricfecome jet traiſtre;	Aricfece jet traître;
LE ROY.	LE ROY.
Et dans l'’horreur d’vne affreuſe priſon, Qui ne ſera pas noir, comme ſa trahiſon;	Et dans l'horreur d'une affreuse prison, Qui ne sera pas noir, comme sa trahison;
Menez le de ſon crime attendre le ſupplice.	Menez le de son crime attendre le supplice.
DHODOMHTAIRE.	DHODOMHTAIRE.
Faites moy grace, Sire.	Faites -moi grâce, Sire.
LE B 0Y.	LE B Y.
On te fera iuſtice.	On te fera justice.
Hi	Hi
SCEIVEVIE LE ROIleul	SCEIVEUIE LE ROIleul
Nne reprimant pas cette temerité, L I’admets des attentats ſur mon authorité;	Nne réprimant pas cette témérité, L 'admets des attentats sur mon autorité;
L’offenſe negligée, à la fin deuient noſtre, Qui ſouffre vne licence, en authoriſe vne autre, Et qui peut ſur ſes vœux permette vn attentat, A la meſme inſolence expoſe ſon Eſtat.	L'offense négligée, à la fin devient notre, Qui souffre une licence, en autorise une autre, Et qui peut sur ses vœux permette un attentat, À la même insolence expose son État.
Aamiral, & le Comje ignorants de ſon criNme, T'enteront de fléchir mon courroux legitime, Et priez, de ſa part, viennent prier pour luy, Mais.	Aamiral, et le Comje ignorants de son criNme, T'enteront de fléchir mon courroux légitime, Et priez, de sa part, viennent prier pour lui, Mais.
SCENNVMI LE ROY, LE COMTE, D.	SCENUMI LE ROI, LE COMTE, D.
BERN.	BERN.
LE ROY.	LE ROY.
DOM BERNARD.	DOM BERNARD.
Grand Roy, du merne & tepen, & uuppuy;	Grand Roi, du merne et tepen, et uppui;
Dont l'ame genereuſe à chaque inſtant conuie, Les cœurs les moins zelez au meſpris de la vie;	Dont l'âme généreuse à chaque instant convie, Les cœurs les moins zélé au mépris de la vie;
Vn deuoir d’amitie, d’honneur, de pieté, demren jounene cers egrre lajete.	Un devoir d'amitié, d'honneur, de piété, démren jounène cers égré lajette.
Poir.	Poir.
LE ROY.	LE ROY.
Si vous ignorez le ſujet de ma haine, Vous venez mal inſtruicts du ſujet qui vous meine, Que l’intereſt d’vn homme indigne de pitié, N'entre point en commerce, auec noſtre amitié;	Si vous ignorez le sujet de ma haine, Vous venez mal instruits du sujet qui vous mène, Que l'intérêt d'un homme indigne de pitié, N'entre point en commerce, avec notre amitié;
Vous plaignez ſon malheur, moy ie ſçay ſon audace Son nom ſeul vous feroit encourir ma diſgrace;	Vous plaignez son malheur, moi -même sais son audace Son nom seul vous ferait encourir ma disgrâce;
S’il a lieu de vanter ſes ſeruices paßés, Sa derniere action les a touts effacez, Erierit jui ja joy des taſtnes cierhedes,	S'il a lieu de vanter ses services passés, Sa dernière action les a touts effacés, Erierit jui ja joi des tâtnes cierhedes,
LE COMTE.	LE COMTE.
Peut-eſtre vn faux rapport.	Peut-être un faux rapport.
LE ROY.	LE ROY.
Mes yeux me ſont fideles;	Mes yeux me sont fidèles;
Et iuge de ſoy-meſme, il ſçait ſi i’ay raiſon;	Et juge de soi-même, il sait si j'ai raison;
D.	D.
BERNARD.	BERNARD.
Eſt-ce vne offence, Sire, indigne de pardon?	Est-ce une offense, Sire, indigne de pardon?
LE ROY.	LE ROY.
Ce n'eſt qu'vn attentat, quis aareife à moy-méme;	Ce n'est qu'un attentat, quis alareife à moi-même;
D.	D.
BERNARD bas.	BERNARD bas.
C’eſt vn traict, cher amy, de ton malheur extréme, Qui te faiſant tober dans quelque aueugle erraur, Ta d’vn Prince ſi iuſte, excité la fureur!	C'est un trait, cher ami, de ton malheur extrême, Qui te faisant tober dans quelque aveugle erraur, Ta d'un Prince si juste, excité la fureur!
LE ROY.	LE ROY.
Vout ſçauez Admiral, cõme en toute autre choſe, Voſtre vouloir du mien abſolument diſpoſe;	Vout votre Admiral, comme en toute autre chose, Votre vouloir du mien absolument dispose;
Propoſez, ordonnez, prenez, faites, oſtez, En tout, pour toute loy, ſuiuez vos volontez, Et de grace exceptez, cette ſeule requeffe, Sans vous, ſon attentat luy couſteroit la teſte;	Proposez, ordonnez, prenez, faites, ôtez, En tout, pour toute loi, suivez vos volontés, Et de grâce exceptez, cette seule requeffe, Sans vous, son attentat te coûterait la tête;
Seul i’en ſçay l’inſolence, & ſans plus m'exprimer, Tiens pour mon ennemy qui l’ozera nommer;	Seul j'en sais l'insolence, et sans plus m'exprimer, Tiens pour mon ennemi qui l'osera nommer;
Au reſte de Carlos, les troupes inſolentes, Par le pays voiſin comme vn foudre volantes, Ce ſoir meſme, au rapport de quelques eſpions, Pretendent s’auancer iuſqu’à nos baſtions;	Au reste de Carlos, les troupes insolentes, Par le pays voisin comme un foudre volantes, Ce soir même, au rapport de quelques espions, Pretendent s'avancer jusqu'à nos bâtions;
Si rencontre, Admiral, fut iamais opportune, Faites voir auiourd’huy quelle eſt voſtre fortune;	Si rencontre, Admiral, fut jamais opportune, Faites voir aujourd'hui quelle est ainsi fortune;
Tout l’eſpoir de l’Eſtat à vos ſoings eſt commis, Couppezauant la nuict, ia martne aux ennemis;	Tout l'espoir de l'État à vos soings est commis, Coupezavant la nuit, ja martne aux ennemis;
De De vos troupes à peine encore deſarmées, R’alliez ſur le champ les ardeurs r’allumées, Et parmy ce peril me conſeruant vos iours, Soyez ce Dom Bernard que vous eſtes touſiours;	De De vos troupes à peine encore désarmées, R'alliés sur le champ les ardeurs rallumées, Et parmi ce péril me conservant vos jours, Soyez ce Dom Bernard que vous êtes toujours;
D.	D.
BERNARD.	BERNARD.
Ie ne me preuaudray dans aucune auanture, Que deua quine de cojere orouuure;	Je ne me prévaudrai dans aucune aventure, Que deva quine de cojère orouvre;
uiſmr eje ile ciulexdaxsalls queenca y mumenommude, uouuluauidomté,	uismr eje île civlexdaxsalls queenca y mumenommude, uouuluauidomté,
Le Roy s’en va embraſſant D.	Le Roi s'en va embrassant D.
Bernard.	Bernard.
JCEIVE IY D.	JCIVE IY DY.
BERNARD, D.	BERNARD, D.
LOPE, LAZARIL.	LOPE, LAZARIL.
D.	D.
LOPE.	LOPE.
Tbien, mon ſeul recours, & ſincere & fidele.	Tbien, mon seul recours, et sincère et fidèle.
LAmy, des vrais amis le plus parfait modele, Ay-je lieu d’eſperer?	LAmi, des vrais amis le plus parfait modèle, Ai-je lieu d'espérer?
qu’auez vous fait pour moy?	qu'avez -vous fait pour moi?
Qu'a permis ma fortune?	Qu'a permis ma fortune?
auez vous veu le Roy?	avez vous vu le Roi?
Hat i’apprends ſa réponſe en la voſtre ſi lente:	Hat j'apprends sa réponse en la vôtre si lente:
Cette douleur muette eſt vne voix parlante, Parlez parlez, le ſort ne frappe plus en nous, Que des cœurs de long-temps endurcis à ſes coups.	Cette douleur muette est une voix parlante, Parlez parlez, le sort ne frappe plus en nous, Que des cœurs de longtemps endurcis à ses coups.
D.	D.
BERNARD.	BERNARD.
Quelle offence Dom Lope, aueugle ou volontaire.	Quelle offense Dom Lope, aveugle ou volontaire.
Vous a ſi fort du Roy ſuſcité la cholere?	Vous a si fort du Roi suscité la colère?
D.	D.
LOPE.	LOPE.
Moy l’offencer helas!	Moi l'offenser hélas!
moy m’adreſſer au Roy, A qui par tant de ſang i’ay ſignalé ma foy!	moi m'adresser au Roi, À qui par tant de sang j'ai signalé ma foi!
A moy, me reprocher vn crime qui le touche!	À moi, me reprocher un crime qui le touche!
Et ce reproche encor ſortir de voſtre bouche!	Et ce reproche encor sortir de votre bouche!
Vous m’eſtiez trop benins, ô deſtins inhumains!	Vous m'étiez trop bénins, ô destins inhumains!
Et voicy de vos coups, le ſeul dont ie me me plains.	Et voici de vos coups, le seul dont je me me plains.
Si c’eſt vn crime helas!	Si c'est un crime hélas!
d’auoir fait de mes vẽines, Aux champs de ſes combats de ſanglantes fonteines;	d'avoir fait de mes vœines, Aux champs de ses combats de sanglantes fonteines;
Et plus mon ennemy, que touts ſes ennemis, M'eſtre mis en l’eſtat, où mon zele m’a mis;	Et plus mon ennemi, que touts ses ennemis, M'être mis en l'état, où mon zèle m'a mis;
M’eſtre par vne ardeur illuſtre & non commune, Liure ſeul en oſtage aux mains de la fortune, Et contre mon viſage à moy-meſme inhumain, Auoir en ſa faueur armé ma propre main;	M'être par une ardeur illustre et non commune, Livre seul en ôtage aux mains de la fortune, Et contre mon visage à moi-même inhumain, Avoir en sa faveur armé ma propre main;
Si pour ces actions ſa haine eſt legitime, I'en ſouffre le reproche, & confeſſe mon crime;	Si pour ces actions sa haine est légitime, J'en souffre le reproche, et confesse mon crime;
Mais ailleurs des bienfaits & des vœux eternels Seroient le chaſtiment de pareils criminels.	Mais ailleurs des bienfaits et des vœux éternels Seraient le châtiment de pareils criminels.
D.	D.
BERNARD.	BERNARD.
Quelque reſſort du Ciel où nous ne voyons goutte, Fait prendre à nos deſtins cette diuerſe route, Fait que par des nœuds d’or, le Roy m’attache à luy Et parſemant de fleurs le chemin que ie ſuy, Semble épuiſé pour moy, d’influences benignes, Ne pouuoir ſur vos pas ſemer que des eſpines;	Quelque ressort du Ciel où nous ne voyons goutte, Fait prendre à nos destins cette diverse route, Fait que par des nœuds d'or, le Roi m'attache à luiNe parsemant de fleurs le chemin que je suis, Semble épuisé pour moi, d'influences bénignes, Ne pouvoir sur vos pas semer que des épines;
Mais ſes deſcrets ſans doute außi ſages que ſaints Sous vn ſi grand malbeur cachent de grãds deſſeins;	Mais ses décrets sans doute aussi sages que saints Sous un si grand malbeur cachent de grands desseins;
I'en preſume pour vous quelque grande aduanture Et doute auec raiſon ſi ma route eſt plus ſeure.	J'en présume pour vous quelque grande aventure Et doute avec raison si ma route est plus sûre.
Au premier mot enfin que i’ay parlé pour vous, Le Roy s’eſt emporté d’vn ſi boüillant courroux, Et paliſſant m’a veu d’vn regard ſi farouche, Qu'à peine auois-je ouuert, qu’il m'a fermé la bouche;	Au premier mot enfin que j'ai parlé pour vous, Le Roi s'est emporté d'un si bouillant courroux, Et palissant m'a vu d'H regard si farouche, Qu'à peine avais-je ouvert, qu'il m'a fermé la bouche;
Ne ſe plaint pas de moins que d’vne trahiſon, Et nous à deffendu iuſques à voſtre nom;	Ne se plaint pas de moins que d'une trahison, Et nous à défendu jusques à votre nom;
Mais pendant que le temps eſſuyera ſa colere, Cher de Lune, & de grace, acceptez ma priere;	Mais pendant que le temps essuiera sa colère, Cher de Lune, et de grâce, acceptez ma prière;
Contez tout mon credit, mes biens, mes qualitez, Moins au rang de mes biens que de vos dignitez;	Comptez tout mon crédit, mes biens, mes qualités, Moins au rang de mes biens que de vos dignités;
Tenez malgré le ſort dans ce malheur extréme, Touts les bienfaits du Roy, comme faits à vousL’heur le mieux eſtably, n’eſt aſſeuré de rien, Et peut-eſtre qu’vn iour vous me le rendrezbien.	Tenez malgré le sort dans ce malheur extrême, Touts les bienfaits du Roi, comme faits à vousL'heur le mieux établi, n'est assuré de rien, Et peut-être qu'un jour vous me le rendrezbien.
Nul bien n’eſt immortel qu’apres que nous le ſommes, L’homme eſt mal aſſeuré, quand il ſe fie aux hommes.	Nul bien n'est immortel qu'après que nous le sommes, L'homme est mal asseuré, quand il se fie aux hommes.
Ct qu'on gaigne vien-toſt, ſe peut perdre dans peu, Tout dépend du hazard & la vie eſt vn feu.	Ct qu'on gagne vientôt, se peut perdre dans peu, Tout dépend du hasard et la vie est un feu.
D.	D.
LOPE.	LOPE.
Làt pluſtoſt mon malheur dure autant que ma vie;	Làt plutôt mon malheur dure autant que ma vie;
Que iamais aucun traict ou de haine ou d’enuie, Attaque la plus noble & plus rare vertu, Dont iamais conquerant ait eſté reueſtu?	Que jamais aucun traict ou de haine ou d'envie, Attaque la plus noble et plus rare vertu, Dont jamais conquérant ait été revêtu?
Quelque important deſſein qu’eut pour moy la fortune, Ie tiendrois ſa faueur à ce pria impertune;	Quelque important dessein qu'eût pour moi la fortune, Je tiendrais sa faveur à ce pria impertune;
Le Roy vous fait iuſtice, & parmy ſes ſujets, N’a point pour ſes faueurs de ſi dignes obiets, Il ne peut plus ſans vous regner, qu’il ne ſuccombe, Et vous ne pouuez choir que ſon trône ne tombe.	Le Roi vous fait justice, et parmi ses sujets, N'a point pour ses faveurs de si dignes objets, Il ne peut plus sans vous régner, qu'il ne succombe, Et vous ne pouvez choir que son trône ne tombe.
D.	D.
BERNARD.	BERNARD.
Au reſte Dom Carlos preſt de nous inueſtir;	Au reste Dom Carlos prêt de nous investir;
Sans perdre tun ſeul moment nous preſſe de partir, Et de faire marcher nos trouppes ramaßées, Contre ſes legions deſia trop auancées;	Sans perdre tun seul moment nous presse de partir, Et de faire marcher nos troupes ramassées, Contre ses légions déjà trop avancées;
Voſtre bras peut du Prince y vaincre le courroux, Et certain du ſuccés, ſi ie le ſuis de vous, I'oze eſperer de voir au retour de l’armée, y opre matneurteuer a voort senommee;	Votre bras peut du Prince y vaincre le courroux, Et certain du succès, si toujours le suis de vous, J'ose espérer de voir au retour de l'armée, y opre matneurteuer a voort senommee;
Mais le temps preſſe.	Mais le temps presse.
D.	D.
LOPE.	LOPE.
Helas cette neceßité, De mon deſtin encor marque la dureté!	Hélas cette necemité, De mon destin encor marque la dureté!
Et ſuiuant de l’honneur l’ordonnance importuIe manque vn rendez-vous, d’où dépend ma fortune.	Et suivant de l'honneur l'ordonnance importuIe manque un rendez-vous, d'où dépend ma fortune.
blums puifants motifs des eſprits genereux!	blums puifants motifs des esprits généreux!
Gloire, deuoir, honneur, triomphez de mes vœux, Pour ſeruir qui nous hait, negligeons qui nous ayme, Et ſuiuons la vertu pour l’amour d’elle meſme.	Gloire, devoir, honneur, triomphez de mes vœux, Pour servir qui nous hait, négligeons qui nous aime, Et suivons la vertu pour l'amour d'elle même.
D.	D.
BERNARD.	BERNARD.
Mais ſi ce rendez-vous, vous importe ſi fort:	Mais si ce rendez-vous, vous importe si fort:
D.	D.
LOPE.	LOPE.
Laiſſons en l'importance au caprice duſort;	Laissons en l'importance au caprice dusort;
Et formons nous plutoſt à ſouffrir ſes outrages, Qu'à laiſſer de ſon gré dépendre nos courages;	Et formons nous plutôt à souffrir ses outrages, Qu'à laisser de son gré dépendre nos courages;
Faiſons tant qu'à la fin de ma gloire confus, Il ſe laiſſe conter au rang de mes vaincus.	Faisons tant qu'à la fin de ma gloire confus, Il se laisse conter au rang de mes vaincus.
L’adorable beauté qui flatte mon attente, Vaut biende mon courage vne preuue importanEt me priuer vn ſoir du beau iour de ſes yeux, Pour vne occaſtondel en meriter mieux.	L'adorable beauté qui flatte mon attente, Vaut biende mon courage une preuve importanEt me priver un soir du beau jour de ses yeux, Pour une occastondel en mériter mieux.
ARTES L	ARTES L
SCENE PREMIERE.	SCÈNE PREMIÈRE.
LE ROY, LE COMTE, LEONOR,	LE ROY, LE COMTE, LEONOR,
LE ROY.	LE ROY.
D’vn droict plus abſolu ſur moy que ſur vous meſme, Sans reſerue exercez voſtre pouuoir ſupréme;	D'un droit plus absolu sur moi que sur vous même, Sans réserve exercez votre pouvoir suprême;
N’employez à voſtre ayde, autre que voſtre ſoin, Et faites vous le bien dont vous auezbeſoin;	N'employez à votre aide, autre que votre soin, Et faites -vous le bien dont vous avezbesoin;
Vous verrez en effet ſi cette amour vous flatte, Ie feray vanité d’obliger vne ingrate;	Vous verrez en effet si cette amour vous flatte, Je ferai vanité d'obliger une ingrate;
Et de perſuader vn inſenſible objet, Qu’encor que ſouuerain, ie l’adore en ſujet;	Et de persuader un insensible objet, Qu'encor que souuerain, Seigneur l'adore en sujet;
, N’oze nourrir pour luy de flame intereßée, Ny iuſqu’à vos faueurs eſleuer ma penſée;	, N'ose nourrir pour lui de flamme interessée, Ni jusqu'à vos faveurs élever ma pensée;
D’vn ſouuerain empire accompliſſez vos vœux, Et dites ſeulement ie commande & ie veux;	D'un souverain empire accomplissez vos vœux, Et dites seulement un commande et et veux;
Vous meſme exaucez vous.	Vous -même exaucez -vous.
2 LEONOR.	2 LEONOR.
Vous agreerez donc, Sire, Qu'en faueur de Perés i’exerce cet empire;	Vous agréerez donc, Sire, Qu'en faveur de Pères j'exerce cet empire;
Comte, du Secretaire, allezbriſer les fers, C'eſt par mon ordre, allez.	Comte, du Secrétaire, allezbriser les fers, C'est par mon ordre, allez.
LECOMTE.	LECOMTE.
Madame, ie vous ſerts.	Madame, Seigneur vous serts.
SCENE II.	SCÈNE II.
εε 28:	2 28:
0 DCEIVEII LEROY, LEONOR, GARDES.	0 DCEIVEII LEROI, LEONOR, GARDES.
LE ROY.	LE ROY.
Ay peine à conceuoir quelle humeurinegale, LVous faiſant mal-traicter vne flame royale, Vous fait prendre intereſt en l’amour d’vn vaſſal.	Ai peine à concevoir quelle humeurinegale, LUous faisant mal-traicter une flamme royale, Vous fait prendre intérêt en l'amour d' vassal.
LEONOR.	LEONOR.
Ie comprends beaucoup moins voſtre eſprit inegal:	Je comprends beaucoup moins votre esprit inégal:
Qui ne vous ſouffrant point de flame intereßée, Et dans ce grand reſpect reſtraignant ſa penſée, S’ombrage toutefois d’vn acte de pitié, Non pas de mon amour, mais de mon amitié.	Qui ne vous souffrant point de flamme interessée, Et dans ce grand respect restraignant sa pensée, S'ombrage toutefois d'un acte de pitié, Non pas de mon amour, mais de mon amitié.
LE ROY.	LE ROY.
Par quel orgueil peut-on meriter voſtre haine?	Par quel orgueil peut-on mériter votre haine?
Si l’amitié vous fait luy remettre ſa peine, Aluy que i’ay ſurpris vous traçant ſon amour, Que ſa main inſolente oſoit bien mettre au iour;	Si l'amitié vous fait esprit remettre sa peine, Alui que j'ai surpris vous traçant son amour, Que sa main insolente osait bien mettre au jour;
Et voſtre authorité protege ſon audace, Apres qu'à Dom Bernard, i'ay refuſe ſa grace.	Et votre autorité prote son audace, Après qu'à Dom Bernard, j'ai refuse sa grâce.
LEONOR.	LEONOR.
Sa naiſſance, Seigneur, & ſa condition Iuſtifieront touſiours mon inclination:	Sa naissance, Seigneur, et sa condition Justifieront toujours mon inclination:
Et croyant propoſer vn ſoupçon legitime, Vous auriez mal aßis l’honneur de voſtre eſtime.	Et croyant proposer un soupçon légitime, Vous auriez mal assez l'honneur de votre estime.
C’eſt vne peur außi qui nemt peui frapper, Et ie prends peu de peine à vous en detromper.	C'est assez peur aussi qui nemt peu frapper, Et tu prends peu de peine à vous en détromper.
LE ROY.	LE ROY.
Ce n’eſt pas d’a preſent, inſenſible, inhumaine, Que pour mes intereſts vous prenez peu de peins;	Ce n'est pas d'a présent, insensible, inhumaine, Que pour mes intérêts vous prenez peu de peins;
Et que de vos rigueurs mon eſprit combattu, Eſt forcé d’exercer vne auſtere vertu.	Et que de vos rigueurs mon esprit combattu, Est forcé d'exercer une austère vertu.
LEONOR.	LEONOR.
Qui peut impunément prendre touté licence, Doit d’autant moins vouloir qu’il a plus de puiſflinece Et n’acquiert touts les vœux, qu’en moderant les ſiens:	Qui peut impunément prendre touté licence, Doit d'autant moins vouloir qu'il a plus de puisfline Et n'acquiert touts les vœux, qu'en modérant les siens:
Se poſſeder ſoy-meſme eſt le plus grand des biens;	Se posséder soi-même est le plus grand des biens;
Aux Rois nõ plus qu'à nous, tout n'eſt pas legitime.	Aux Rois nomme plus qu'à nous, tout n'est pas légitime.
LE ROY.	LE ROY.
O raiſon incommode!	Ô raison incommode!
importune maxime!	importune maxime!
Qui diſpoſant de nous faites d’vn Potentat, Moins vn Prince abſolu qu’vn ſerfde ſon Eſtat;	Qui disposant de nous faites d'un Potentat, Moins un Prince absolu qu'un serfde son État;
Si vous ne permettez à des mains Souueraines, Vn libre attachement, & le choix de leurs chaiſnes, Qeren doumipuomampiuj& puuauts rigueurs Faut-il former des vœux où repugnent nos cœurs!	Si vous ne permettez à des mains Souveraines, Un libre attachement, et le choix de leurs chaînes, Qéren doumipuomampiujet puvauts rigueurs Faut-il former des vœux où répugnent nos cœurs!
LEONOR.	LEONOR.
Außi bien que l’Eſtat, l’Honneur a ſes maximes, Qui font fune nofenenn fuiennoe dummegitimes;	Aussi bien que l'État, l'Honneur a ses maximes, Qui font fune nofenn fuiennoe dummegitimes;
Et l’inegalité de nos conditions, N'admet ny noſtre hymen, ny nos affections.	Et l'inégalité de nos conditions, N'admet ni nôtre hymen, ni nos affections.
LE ROY.	LE ROY.
Ainſi donc que le mal, donnez la medecine, Pour en coupper le cours, couppez en la racine;	Ainsi donc que le mal, donnez la médecine, Pour en coupper le cours, coupez en la racine;
Et dans l’inquietude où ie languy pour vous, Reprimez mes ſouhaits par le choix d’vn eſpoux;	Et dans l'inquiétude où belle langui pour vous, Reprimez mes souhaits par le choix d' Houx;
Pour m’oſter tout l’eſpoir pour qui mõ cœur ſouſpire, Faites vnpoſſeſſeur des faueurs où i’aſpire;	Pour m'ôter tout l'espoir pour qui mon cœur soupire, Faites vnpossesseur des faveurs où j'aspire;
Faites vn homme heureux, ſi quelqu'vn dans ma Cour, A des conditions dignes de voſtre amour.	Faites un homme heureux, si quelqu'un dans ma Cour, À des conditions dignes de votre amour.
Quelque haute ſpendeur dont l’eclat l’enuironne, En quelque illuſtre employ qu’il ſerue ma Couronne, Quoy qu’il poſſede enfin capable de charmer, Il ne vous couſtera qu’vn ſouhait à former, Et mon mal de ſon bien tirera ſon remede.	Quelque haute spendeur dont l'éclat l'environne, En quelque illustre emploi qu'il serve ma Couronne, Quoi qu'il possède enfin capable de charmer, Il ne vous coûtera qu'un souhait à former, Et mon mal de son bien tirera son remède.
LEONOR.	LEONOR.
Il n’eſt point de faueur que cette offre n’excede, Et puis qu'il m’eſt permis de choiſir mon vainceur:	Il n'est point de faveur que cette offre n'excède, Et puis qu'il m'est permis de choisir mon vainceur:
I'oze me declarer, & vous ouurir mon cœur:	J'ose me déclarer, et vous ouvrir mon cœur:
Le vol quoy qu'eſleué, que mon amour ſe donne, N’a point pour but, vn frõt chargé d’vne couronne;	Le vol quoi qu'élevé, que mon amour se donne, N'a point pour but, un front chargé d'une couronne;
Mais vn bras qui vous ſert & qui s’en peut don ner, Quand ſon ambition le voudra couronner.	Mais un bras qui vous sert et qui s'en peut don ner, Quand son ambition le voudra couronner.
Vn qui veut bien dépendre, & vaſſal volontaire, Sous le ioug de vos loix, tient le ſort tributaire;	Un qui veut bien dépendre, et vassal volontaire, Sous le joug de vos lois, tient le sort tributaire;
Luy ſeul, ſi quelque obiet peut ſur ma liberté, Pretendre quelque atteinte, ou quelque autorité;	Lui seul, si quelque objet peut sur ma liberté, Pretendre quelque atteinte, ou quelque autorité;
De ce leger honneur peut flatter ſon attente.	De ce léger honneur peut flatter son attente.
LE ROY.	LE ROY.
Nommez le donc.	Nommez le donc.
LEONOR.	LEONOR.
Son nom, eſt.	Son nom, est.
Mais voicy l’Infanté.	Mais voici l'Infanté.
SEAE III L’INFANTE, LE COMTE,LE SECR.	SEAE III L'INFANTE, LE COMTE,LE SECR.
LE ROY, GARDES.	LE ROY, GARDES.
LE SECRET AIRE à genoux.	LE SECRET AIRE à genoux.
Ire, quels vœux rendray-je à voſtre MajeS'ſté?	Ire, quels vœux rendrai-je à votre Majesse?
LE ROY.	LE ROY.
Ie n’ay pas ordonné de voſtre liberté:	Je n'ai pas ordonné de votre liberté:
LEONOR.	LEONOR.
C’eſt moy qui vous la rends pour vous l’auoir rauie, Et ſa perte ſans moy, vous eut couſté la vie;	C'est moi qui vous la rends pour vous l'avoir ravie, Et sa perte sans moi, vous eut cousté la vie;
Soyez en moins prodigue, & menagez là mieux.	Soyez en moins prodigue, et ménagez là mieux.
LINFANTE.	LINFANTE.
Seigneur, ce Dom Bernard ce vainceur glorieux, Qui de tant de Heros efface les Hiſtoires, Et qui peut moins conter de iours que de victoires, K iij Dont preſque les ſuccés precedent les ſouhaits, Suiuy de tout le peuple entre dans le Palais, A ſa reception ſa vertu vous inuite.	Seigneur, ce Dom Bernard ce vainceur glorieux, Qui de tant de Héros efface les Histoires, Et qui peut moins conter de jours que de victoires, Dont presque les succés precedent les souhaits, Suiuy de tout le peuple entre dans le Palais, A sa réception sa vertu vous inuite.
LE ROY.	LE ROY.
Allons & rendons luy l’accueil qu’elle merite;	Allons et rendons lui l'accueil qu'elle mérite;
Paiſons en vnexempie iauſire à nos neueux, Et comme ſes trauaux, rendons ſes prix fameux.	Paisons en unexempie jusire à nos neueux, Et comme ses travaux, rendons ses prix fameux.
LEONOR bas.	LEONOR bas.
Tu m’oppoſes amour, vne forte aduerſaire, Aauiuu nugcontre iu ſour, uu promeſfe uu frere;	Tu m'opposes amour, une forte adversaire, Aauju nugcontre ju sour, promesse frère;
Et ce gage royal aſſeure mon eſpoir, Contre tout ce qu'elle a de charme & de pouuoir.	Et ce gage royal assure mon espoir, Contre tout ce qu'elle a de charme et de pouvoir.
SENDIV D.	SENDIV D.
BERNARD auec le baſtonde General.	BERNARD était le bâtonde Général.
D.	D.
LOPE, LA ZARILLE, SOLDATS.	LOPE, LA ZARILLE, SOLDATS.
LE ROY, L’INFANTE, LEONOR.	LE ROY, L'INFANTE, LEONOR.
D.	D.
LOPE entrant dità l’oreille à D.	LOPE entrant dità l'oreille à D.
Bernard.	Bernard.
Velque part que mon bras ait en voſtre victoire, Des menaces du Roy conſeruez la memoire:	Velque part que mon bras ait en votre victoire, Des menaces du Roi conservez la mémoire:
DrtatSta tuy mon nomt an ieuus du combat.	DrtatSta tui mon nomt an jeuus du combat.
D.	D.
BERNARD.	BERNARD.
Ie parleray de vous, ſous le nom de ſoldat.	Je parlerai de vous, sous le nom de soldat.
LE ROY l’embraſſant.	LE ROY l'embrassant.
Quoy c'eſt vous Duc d’Alcale, honneur de ma Prouince, Glorieux compagnon des ſoins de voſtre Prince!	Quoi c'est vous Duc d'Alcale, honneur de ma Province, Glorieux compagnon des soins de votre Prince!
Voſtre retour ſurprend, & pour vous les inſtants En gloire ſi feconds, font l’office des ans;	Votre retour surprend, et pour vous les instants En gloire si féconds, font l'office des ans;
Ie doits aux actions dont voſtre hiſtoire eſt plaine, Vn triomphe au deſſus de la pompe Romaine:	Je doits aux actions dont votre histoire est plaine, Un triomphe au dessus de la pompe Romaine:
Mais attendãt ce prix de vos exploits vainceurs, Commencez, par celuy des eſprits & des cœurs;	Mais attendant ce prix de vos exploits vainceurs, Commencez, par celui des esprits et des cœurs;
Arurſtoſur tes fronts t'auegreſe puplique, Dont en voſtre faueur, toute la cour s’explique;	Arurstosur tes fronts t'avegrese puplique, Dont en votre faveur, toute la cour s'explique;
Poſſedez voſtre gloire & cepenuuur contez, Albe, Vrgel, & Venoſque entre vos qualitez.	Possédez votre gloire et cepenuuur comptez, Albe, Vrgel, et Venosque entre vos qualités.
D.	D.
BERNARD.	BERNARD.
Ha, Sire!	Ha, Sire!
à vos bienfaits impoſez, des limites:	à vos bienfaits imposés, des limites:
LE ROY.	LE ROY.
Ils n’en auront iamais non plus que vos merites;	Ils n'en auront jamais non plus que vos mérites;
Apprenez nous enfin le plus grand des exploits;	Apprenez nous enfin le plus grand des exploits;
Qeme font it pius gina & te pius craint des Rois.	Queme font it pius gina et te pius craint des Rois.
D.	D.
BERNARD.	BERNARD.
DBet- Si toſt que i’eus reioinct vos legions fideles, lus l'in Degoutanttes encor du ſang de vos rebelles, Lconot Et les cœurs encor pleins des nobles ſentiments;	DBet- Si tôt que j'eus rejet vos légions fidèles, lus l'in Dégoutantes encor du sang de vos rebelles, Léconot Et les cœurs encor pleins des nobles sentiments;
Qui portent aux progrés des grands euenements.	Qui portent aux progrès des grands événements.
Ce grand corps pour ſon chef au trauail inſenſible, Cet inuincible bras d’vn Monarque inuincible;	Ce grand corps pour son chef au travail insensible, Cet invincible bras d'un Monarque invincible;
Marche ſous le pouuoir que vous m’auiez commis, Et bruſle de ſe rendre au camp des ennemis;	Marche sous le pouvoir que vous m'aviez commis, Et brûle de se rendre au camp des ennemis;
Nous marchons iuſqu’au point que de ſes voiles ſombres, La nuict ſur l’vniuers vient eſtendre les ombres, Et que deux eſpions ſurpris à Laugarez, M’apprirent effrayez que l’armee eſtoit prés;	Nous marchons jusqu'au point que de ses voiles sombres, La nuit sur l'univers vient étendre les ombres, Et que deux espions surpris à Laugarés, M'apprirent effrayez que l'armée était près;
A ce bruit épandu le ſangboût, le cœur vole, Nous trouuons en la nuict vn obſtacle friuole, Nous marchons ſans broncher dans les plus ſombres lieux, Pour y guider nos pas, nos cœurs nous ſeruẽt d’yeux, Et l’ardeur qui conduit nos armes inuincibles, Craint d’autãt moins les coups, qu’ils ſeront moins viſibles;	À ce bruit épandu le sangboût, le cœur vole, Nous trouvons en la nuit un obstacle frivole, Nous marchons sans broncher dans les plus sombres lieux, Pour y guider nos pas, nos cœurs nous servent d'yeux, Et l'ardeur qui conduit nos armes invincibles, Craint d'autant moins les coups, qu'ils seront moins visibles;
Enfin dans le ſilence & l’ombrede la nuict, Par vn taillis eſpois, nos rangs filants ſans bruict, Et de tous les coſtez chacun prettant l’oreille, Dans ce calme profond, vn bruit ſourd nous réueille;	Enfin dans le silence et l'ombrede la nuit, Par un taillis épois, nos rangs filants sans bruit, Et de tous les côtés chacun prétant l'oreille, Dans ce calme profond, un bruit sourd nous réueille;
Que du commencement nous ne diſtinguons pas, Mais qui s’eſleue enfin & croiſt à chaque pas, On fait alte, & la doute eſt bien-toſt confirmée, Nous diſcernons au bruit la marche de l’armée;	Que du commencement nous ne distinguons pas, Mais qui s'esleue enfin et croît à chaque pas, On fait alte, et la doute est bientôt confirmée, Nous discernons au bruit la marche de l'armée;
Ie cueille les aduis en ce beſoing inſtant, Autant à noſtre honneur qu’à l’Eſtat important.	Je cueille les avis en ce besoin instant, Autant à notre honneur qu'à l'État important.
Et le deſſein formé, faits donner les alarmes, Par vn ſon de tambours, de trompetes & d’armes, Capable par ſon bruit d’exciter tant d’horreur, Que parmy tout le Camp il iette la terreur:	Et le dessein formé, faits donner les alarmes, Par un son de tambours, de trompetés et d'armes, Capable par son bruit d'exciter tant d'horreur, Que parmi tout le Camp il jette la terreur:
Pendant qu’il delibere au coup de ce tounerre, Dans vn canton du bois le noſtre ſe reſſerre;	Pendant qu'il délibère au coup de ce tounerre, Dans un canton du bois le nôtre se resserre;
Et chacun (mais toûjours par le ſoin quei’en prẽds) En eſtat de donner, s’y couche dans ſes rangs;	Et chacun (mais toujours par le soin quei'en prends) En état de donner, s'y couche dans ses rangs;
Sur ce temps vn ſoldat de merite & de marque, Pour qui i'aurois beſoin, ô genereux Monarque, De toute l’eloquence & de toutes les voix, Dont le Senat Romain retentiſt autres fois;	Sur ce temps un soldat de mérite et de marque, Pour qui j'aurais besoin, ô généreux Monarque, De toute l'éloquence et de toutes les voix, Dont le Sénat Romain retentît autres fois;
Et que l’antiquité donne à la renommée, Tirant un Camp-volant du gros de noſtre armée;	Et que l'antiquité donne à la renommée, Tirant un Camp-volant du gros de notre armée;
Deſcend vne colline, & d’vn cœur indomté, Fauoriſé des lieux & de l’obſcurité, Par vn ſentier ſecret ſe iette où l’aduerſaire, Deſſus cette ſurpriſe, effrayé delibere;	Descend une colline, et d'un cœur indomté, Favorisé des lieux et de l'obscurité, Par un sentier secret se jette où l'adversaire, Dessus cette surprise, effrayé délibère;
Il laſche apres le pied, recule en combattant Feint de faire retraite, & retourne à l’inſtant;	Il lâche après le pied, recule en combattant Feint de faire retraite, et retourne à l'instant;
Suit enfin ſi long-temps ce genereux caprice, Et donne aux ennemis vn ſi long exercice, Que les plus aguerris, & les plus gens de cœur, Douuemnamouitunuuueur puus muſic vigueur, Pendant que dans le bois à l’abry de l’orage, Des noſtres repoſants, la force ſe meſnage.	Suit enfin si longtemps ce généreux caprice, Et donne aux ennemis un si long exercice, Que les plus aguerris, et les plus gens de cœur, Douuemnamouitunuuueur puus music vigueur, Pendant que dans le bois à l'abri de l'orage, Des nôtres repos, la force se ménage.
LE ROI.	LE ROI.
Sous ce nom de Soldat il parle de ſes faits, Et veut, taiſant le ſien, s’épargner mes bienfaits.	Sous ce nom de Soldat il parle de ses faits, Et veut, taisant le sien, s'épargner mes bienfaits.
D.	D.
BERNARD.	BERNARD.
A peine de la nuict, le iour tiroit les voiles, Et de ſes traits dorez faiſoit fuyr les Eſtoiles, Que nos gens reioignant ce genereux ſoldat, Delaſſez, frais, diſpos, & bruſlans du combat, Ont paru dans la plaine & fait voir ſur leur face, Aux ennemis tremblants leur martiale audace;	À peine de la nuit, le jour tirait les voiles, Et de ses traits dorés faisait fuir les Étoiles, Que nos gens rejoignant ce généreux soldat, Délassez, frais, dispos, et brûlants du combat, Ont paru dans la plaine et fait voir sur leur face, Aux ennemis tremblants leur martiale audace;
Les deux Camps approchez, enfin ce jeune Mars, S’eſtant ſaiſy d’ardeur, d’vn de nos eſtendards,	Les deux Camps approchés, enfin ce jeune Mars, S'étant saisi d'ardeur, d'un de nos étendards,
Pour exciter encor nos vigueurs r’affermies, Le lançant dans les rangs des trouppes ennemies, Retirons, a t’il dit, Cœurs nobles & vaillants, Les drappeaux d’Arragon des mains des Caſtillants;	Pour exciter encor nos vigueurs raffermies, Le lançant dans les rangs des troupes ennemies, Retirons, a t'il dit, Cœurs nobles et vaillants, Les drapeaux d'Aragon des mains des Castillants;
Donnons mes compagnons.	Donnons mes compagnons.
A cemot il s’auance, Le Cimetere en main comme vn foudre s’eſlance, Et ſans rien redouter paſſant de rang en rang, Atout le Camp qui ſuit, fraye vn chemin de ſang:	À cédot il s'avance, Le Cimetère en main comme un foudre s'élance, Et sans rien redouter passant de rang en rang, Atout le Camp qui suit, fraie un chemin de sang:
Tout l’obſtacle où nos bras lançent noſtre t'onnerre, Contre noſtre valeur, ne ſemble que du verre;	Tout l'obstacle où nos bras lançent notre t'onnerre, Contre notre valeur, ne semble que du verre;
A ce choc, l’ennemy deſia demy deſtruit, Par l’incommodité du trauail de la nuict, Deffend ſi foiblement & ſa vie & ſa gloire, Qu'il ſemble hors d’eſpoir, negliger la victoire;	À ce choc, l'ennemi déjà demi détruit, Par l'incommodité du travail de la nuit, Défend si faiblement et sa vie et sa gloire, Qu'il semble hors d'espoir, négliger la victoire;
Et nous vouloir oſter preuoyant ſon malheur, La gloire que l’obſtacle apporte à la valeur.	Et nous vouloir ôter prévoyant son malheur, La gloire que l'obstacle apporte à la valeur.
Ce noble cœur enfin pour preſſer ſa conqueſte, Du premier qu’il rencontre ayant tranché la teſte;	Ce noble cœur enfin pour presser sa conquête, Du premier qu'il rencontre ayant tranché la tête;
Et l’expoſant en veuë à touts les deux partis, Le Ciel (dit-il) eſt iuſte, & nous a garantis;	Et l'exposant en vue à touts les deux partis, Le Ciel (dit-il) est juste, et nous a garantis;
Ce bras, de Dom Carlos, vient d’expier l’audace.	Ce bras, de Dom Carlos, vient d'expier l'audace.
Le ſang des ennemis à ce diſcours ſe glace, Et les plus fiers du ſort deteſtants la rigueur, A peine pour la fuitte ont aſſez de vigueur;	Le sang des ennemis à ce discours se glace, Et les plus fiers du sort détestants la rigueur, À peine pour la fuite ont assez de vigueur;
Tout nous fait iour, tout ploye, & par ce ſtratã reſme, Noſtre victoire arriue à ſa gloire ſupréme;	Tout nous fait jour, tout ploie, et par ce stratang rême, Notre victoire arrive à sa gloire suprême;
Ie n’oſe vous nommer ce demon des combats, Mais ie le nommeaſſez en ne le nommant pas:	Je n'ose vous nommer ce démon des combats, Mais grands le nommeassez en ne le nommant pas:
mimen puo meua puluſuepur la violence, Qui me ferme la bouche, & m’oblige au ſilence;	mimen pu meua pulusuepur la violence, Qui me ferme la bouche, et m'oblige au silence;
de lte le Mifante.	de lte le Mifante.
C’eſt aſſez le nommer, que de taire ſon nom.	C'est assez le nommer, que de taire son nom.
LINFANTE.	LINFANTE.
Certes ſa modeſtie eſt ſans comparaiſon.	Certes sa modestie est sans comparaison.
LEONONDAS.	LENONDAS.
O vainqueur fortuné que le ciel me deſtine!	Ô vainqueur fortuné que le ciel me destine!
Que ne peut point ton bras, ſi ton œil aſſaßine!	Que ne peut point ton bras, si ton œil assamène!
LE ROY.	LE ROY.
Ce que vous auez dit, & que vous auez teu, M'apprend de ce ſoldat, le nom & la vertu;	Ce que vous avez dit, et que vous avez tu, M'apprend de ce soldat, le nom et la vertu;
Et mon foible pouuoir ſçait trop à quoy l’inuite, L’ineſtimable excés d’vn ſi rare merite.	Et mon faible pouvoir sais trop à quoi l'inuite, L'estimable excès d'un si rare mérite.
LINFANTE bas.	LINFANTE bas.
Mon cœur eſt le ſeul pruusgme ue ſu ouceur.	Mon cœur est le seul pruusgme ue su ouceur.
D.	D.
LOPE à LAZARILLE.	LOPE à LAZARILLE.
Ma patience enſin laſſera mon malbeur.	Ma patience ensin lassera mon malbeur.
LAZARILLE.	LAZARILLE.
Meſnagez donc le temps & vous faites cognoiſtre.	Mesnagez donc le temps et vous faites connaître.
D.	D.
LOPE.	LOPE.
Attendons que le Roy m’ordonne de paroiſtre.	Attendons que le Roi m'ordonne de paraître.
D.	D.
BERNARD.	BERNARD.
Dom Nugue, & Dom Bernard en ce dernier com, enr 3 De leur zele ordinaire ont ſeruy voſtre Eſtat;	Dom Nugue, et Dom Bernard en ce dernier com, enr 3 De leur zèle ordinaire ont servi votre État;
Et peu dans cette hiſtoire ont mieux gagné leur place.	Et peu dans cette histoire ont mieux gagné leur place.
LE NOY.	LE NOY.
Deux Comtez leur ſeront des arres de ma grace;	Deux Comtez leur seront des arrêtés de ma grâce;
Mais ie cherche, Admiral, & ne voy point de quo M’acquitter enuers vous de ce que ie vous doy.	Mais grande cherche, Admiral, et ne vois point de qu 'acquitter envers vous de ce que je vous dois.
D.	D.
BERNARD.	BERNARD.
Sans plus reuer, Seigneur, ce penſer vous acquitte, Que de l’heur d’eſtre à vous dépend tout mõ merite:	Sans plus rêver, Seigneur, ce penser vous acquitte, Que de l'heur d'être à vous dépend tout mon mérite:
Que c’eſt de vos bontez que ie tiens tout mon bien, Que ie ſuis auiourd’huy, qu’hyer ie n'eſtois rien;	Que c'est de vos bontés que Un tiens tout mon bien, Que Que suis aujourd'hui, qu'hier notre n'étais rien;
Que mon deſtin ſans vous n’a que l’eclat du verre, Et qu’ayant comme Dieu fait vn homme de terre, Comme Dieu quelque iour, vous le pourrés chaſſer, Et de voſtre preſence & de voſtre penſer.	Que mon destin sans vous n'a que l'éclat du verre, Et qu'ayant comme Dieu fait un homme de terre, Comme Dieu quelque jour, vous le pourrez chasser, Et de votre présence et de votre penser.
LE ROY.	LE ROY.
Puiſſay-ie à ſon courroux eſtre à iamais en butte, Et mon trône tomber le iour de voſtre cheutte.	Puissé-je à son courroux être à jamais en butte, Et mon trône tomber le jour de votre chute.
Ie cognois ma foibleſſe, & ſçay que ie ne puis, Faire rien d’immortel, mortel comme ie ſuis;	Je connais ma faiblesse, et sais que personne ne puis, Faire rien d'immortel, mortel comme tu suis;
Mais ie mettray mon heur, & ma gloire ſupréme, A me faire vn vaſſal plus puiſſant que moy-méme, mmdoupummautn puipiuuiront nos vœux, Douter à l’Arragon qui regnera des deux;	Mais mille mettrai mon heur, et ma gloire suprême, A me faire un vassal plus puissant que moi-même, médoupummaut puipiviront nos vœux, Douter à l'Aragon qui régnera des deux;
Puiſque ma paßion apres tant d’auantures, Comme voſtre vertu doit eſtre ſans meſures.	Puisque ma passion après tant d'aventures, Comme votre vertu doit été sans mesures.
L’INFANTE bas.	L'INFANTE bas.
Sans moy ie le croy pauure auecques tant de bien, Et ne me donner pas, c’eſt ne luy donner rien.	Sans mo ie le crois pauvre avec tant de bien, Et ne me donner pas, c'est ne lui donner rien.
LEONORabas.	LEONORabas.
Ses bienfaits ſont trop peu pour ſon merite extréme, S’il ne luy fait encor vn preſent de moy-meſme.	Ses bienfaits sont trop peu pour son mérite extrême, S'il ne le fait encor un présent de moi-même.
Touts s’en vont, le Roy conduit Leonor, & D.	Touts s'en vont, le Roi conduit Leonor, et D.
Bernard l'Infante.	Bernard l'Infante.
ENTE DOM LOPE, LAZARILLE.	ENTE DOM LOPE, LAZARILLE.
D.	D.
LOPE.	LOPE.
Voy!	Voi!
de tant de fumée il flatte mon eſpoir, Et plain de mon eſtime, il s’en va ſans me voir?	de tant de fumée il flatte mon espoir, Et plain de mon estime, il s'en va sans me voir?
Quoy!	Quoi!
d’vne telle amour i’oze nourrir l’attente, Et ne me puis vanter d’vn regard de l’Infante;	d'une telle amour j'oze nourrir l'attente, Et ne me puis vanter d'un regard de l'Infante;
Moy qui des mains du frere & des yeux de la ſœur, M’eſtois (à ce retour) promis tant de douceur!	Moi qui des mains du frère et des yeux de la sœur, M'étais (à ce retour) promis tant de douceur!
Eſt-ce que l’vn differe, & l’autre dißimule!	Est-ce que l'un diffère, et l'autre dissimule!
Mais, ô friuole eſpoir vanité ridicule!	Mais, ô frivole espoir vanité ridicule!
L’vn auec tant d’eſtime, & l’autre tant d’amour, N’auroient pas d’vn regard, honoré mon retour;	L'un avec tant d'estime, et l'autre tant d'amour, N'auraient pas d'un regard, honoré mon retour;
Mais voicy.	Mais voici.
SCLILVL DOROTHEE, D.	SCLILUL DOROTHÉE, D.
LOPE.	LOPE.
DOROTHEE.	DOROTHÉE.
Voy Dom Lope, vne ardeurſi ſenſible, Rencontre-t’elle en vous vne ame inacceßible?	Vois Dom Lope, une ardeurs sensible, Rencontre-t-elle en vous une âme inaccemible?
Ie croyois qu’en amour, traicter ſi froidement, Ne fuſt vne vertu que pour nous ſeulement;	Je croyais qu'en amour, traicter si froidement, Ne fût une vertu que pour nous seulement;
Quel roole ioüerons nous, chetifues que nous ſommes, Si la rigueur deuient la qualité des hommes?	Quel roole jouerons nous, chétifues que nous sommes, Si la rigueur devient la qualité des hommes?
S’ils refuſent des vœux à des vœux mutuels, Vrayement il vous fied bien de faire les cruels;	S'ils refusent des vœux à des vœux mutuels, Vraiment il vous sied bien de faire les cruels;
Et vouloir vous meſler de noſtre perſonnage, Vous que le Ciel n'a faits que pour nous rendre hommage, Que pour ployer le col ſous noſtre authorité.	Et vouloir vous mêler de notre personnage, Vous que le Ciel n'a faits que pour nous rendre hommage, Que pour ployer le col sous notre autorité.
Et nous faire tribut de voſtre liberté:	Et nous faire tribut de votre liberté:
D.	D.
LOPE.	LOPE.
Il paroiſt par l’acceuil que m’a fait Violante, Que cette qualité me ſeroit meſſeante, Et l’on redoute peu la rigueur d’vn Amant, Qon ne daigne nonoreru vn tegaru ſeulement.	Il paraît par l'acçuil que m'a fait Violante, Que cette qualité me serait messeante, Et l'on redoute peu la rigueur d'un Amant, Anon ne daigne nonoreru un tegaru seulement.
DOROTHEE.	DOROTHÉE.
Qui manque vn rendez-vous, fait bien voir qu’il neglige Les plus cheres faueurs dontvne Amante oblige.	Qui manque un rendez-vous, fait bien voir qu'il néglige Les plus chères faveurs dontvne Amante oblige.
D.	D.
LOPE.	LOPE.
I'ay differé d’vn ſoir, les offres de mes vœux, Pour l’aller meriter par vn exploit fameux;	J'ai différé d'Hommes soir, les offres de mes vœux, Pour l'aller mériter par un exploit fameux;
Et ſignalant mon nom en ce combat inſigne, N’ay manqué de la voir, que pour m’en rendre dine.	Et signal mon nom en ce combat insigne, N'ai manqué de la voir, que pour m'en rendre dine.
DOROTHEE.	DOROTHÉE.
Ie ſçay bien que l’amour marche apres le deuoir, Voſtre excuſe eſt de miſe, & ſe peut receuoir:	Je sais bien que l'amour marche après le devoir, Vostre excuse est de mise, et se peut recevoir:
Mais pour tout reparer, & voir ſi l’on vous ayme, Venez ce ſoir au parc, la propoſer vous meſme;	Mais pour tout réparer, et voir si l'on vous aime, Venez ce soir au parc, la proposer vous -même;
Eſt-ce vous témoigner vn cœur aſſez, eſpris, Qu'auec vne faueur chaſtier vn meſpris?	Est-ce vous témoigner un cœur assez, épris, Qu'avec une faveur châtier un mépris?
Au reſte cette amour tendant à l’hymenée, Iugez de la grandeur qui vous eſt deſtinée,	Au reste cette amour tendant à l'hyménée, Jugez de la grandeur qui vous est destinée,
M	M
D.	D.
LOPE.	LOPE.
Puis-je ſi malheureux n’auoir pas pour ſuſpect, D'vn aſtre ſi malin ce fauorable aſpect?	Puis-je si malheureux n'avoir pas pour suspect, D'un astre si malin ce favorable aspect?
DOROTHEE.	DOROTHÉE.
Ele a ce ſeul regret de n'eſtre pua pourueuë, De toute la beauté qui peut charmer la veuë.	Éle à ce seul regret de n'être pua pourvue, De toute la beauté qui peut charmer la vue.
D.	D.
LOFE.	LOFE.
Quel plus diuin obiet peut enchanter les ſens?	Quel plus divin objet peut enchanter les sens?
DOROTHEE.	DOROTHÉE.
Et de voir que deſia l’auare faulx du temps, Ait de ſes plus beaux iours rauy quelque partie.	Et de voir que déjà l'avare faulx du temps, Ait de ses plus beaux jours ravi quelque partie.
D.	D.
LOPE.	LOPE.
Ie ne puis que répondre à tant de modeſtie, Que par tout le reſpect & la confuſion, Dont vn cœur eſt capable en cette occaſion.	Je ne puis que répondre à tant de modestie, Que par tout le respect et la confusion, Dont un cœur est capable en cette occasion.
DOROTHEE.	DOROTHÉE.
Elle pretend de plus auant que le iour paſſe, Par vn gage amoureux vous confirmer ſa grace, Lazarille auec moy viendra le receuoir.	Elle prétend de plus avant que le jour passe, Par un gage amoureux vous confirmer sa grâce, Lazarille avec moi viendra le recevoir.
D.	D.
LOPE.	LOPE.
O cãprices du ſort qui vous peut conceuoir!	Ô coprices du sort qui vous peut concevoir!
Contraire il aſſaßine, & fauorable accable, D'vn heur ſi ſurprenant, vn bomme eſt-il capable?	Contraire il assassine, et favorable accable, D'un heur si surprenant, un bomme est-il capable?
LAZARILLE.	LAZARILLE.
Auec la vanité dont vous vous paiſſez tous, Vous tiendrez pour affront que le Ciel pleu ſur colo y De plus puiſſants que vous, acceptez tout ſans honte,	Avec la vanité dont vous vous paissez tous, Vous tiendrez pour affront que le Ciel pleu sur colo y De plus puissants que vous, acceptez tout sans honte,
Vien.	Viens.
DOROTHEE à LAZARILLE.	DOROTHÉE à LAZARILLE.
LAZARILLE la ſuiuant.	LAZARILLE la suivant.
Ie reuiens, & vous en rends bon conte.	Je reviens, et vous en rends bon conte.
SCLAVEVIE D.	SCLVEVIE D.
BERNARD, D.	BERNARD, D.
LOPE.	LOPE.
D.	D.
BERNARD.	BERNARD.
Admire (mon cher Lope) & cet eſtonnement, Ie laiſſe ſans diſcours & ſans raiſonnement;	Admire (mon cher Lope) et cet étonnement, Je laisse sans discours et sans raisonnement;
Le tourtoux opſine, dont le Ciel vous outrage, Et ſa lenteur extréme à vous tourner viſage;	Le tourtoux opsine, dont le Ciel vous outrage, Et sa lenteur extrême à vous tourner visage;
Le Roy.	Le Roi.
D.	D.
LOPE.	LOPE.
Quelque malheur dont ie ſois combattu;	Quelque malheur dont ici sois combattu;
Vn fort eſpoir renaiſt à ma foible vertu;	Un fort espoir renaît à ma faible vertu;
En ſuitte de mes maux dont le torrent s’écoule, Les biens ſemblent, comme eux, me venir tout en foule, Ce ciel qui me ſembloit meſme plaindre le iour, S’eſpuiſe en ma faueur par les mains de l’amour;	En suite de mes maux dont le torrent s'écoule, Les biens semblent, comme eux, me venir tout en foule, Ce ciel qui me semblait même plaindre le jour, S'épuise en ma faveur par les mains de l'amour;
Pardonnez, Admiral, ſi mon trop long ſilence, Vous a de ce beau mal caché la violence;	Pardonnez, Admiral, si mon trop long silence, Vous a de ce beau mal caché la violence;
Puiſque ie croyois moins par ma diſcretion, Vous taire vn iuſte eſpoir, qu’vne preſomption;	Puisque ici croyais moins par ma discrétion, Vous taire un juste espoir, qu'une présomption;
Mais pouuãt auioura muy ſonuerterte eſperance, Sur vne trop ſolide & trop claire apparence;	Mais pouvant aujoura mui sonverterte espérance, Sur une trop solide et trop claire apparence;
Ie vous dois reueler cet important ſecret, Que ie ne puis verſer dans vn ſein plus diſcret:	Je vous dois révéler cet important secret, Que je ne puis verser dans un sein plus discret:
Mais craignant d’euenter vne ſi belle flame, Cherchons vn lieu plus propre à vous ouurir mon ame;	Mais craignant d'éventer une si belle flamme, Cherchons lieu plus propre à vous ouvrir mon âme;
El pouuoir muaerer par dos jagesaants;	El pouvoir muaerer par dos jagesaants;
Le tranſport ſurprenant dont mes ſens ſont rauis.	Le transport surprenant dont mes sens sont ravis.
D.	D.
BERNARD.	BERNARD.
I'ay bien creu que du ciel la iuſtice future, Vous deuroit reſeruer quelque haute aduanture;	J'ai bien cru que du ciel la justice future, Vous devrait réserver quelque haute aventure;
Et que ſes tugements außt fages que ſaincts, Sous de ſi grands malheurs cachoient de grands deſſeins.	Et que ses tugements aussi autant que saints, Sous de si grands malheurs cachaient de grands desseins.
LT 4 T L	LT 4 T 
SCENL IREMTERE.	SCENL IREMTERE.
DOM BERNARD ſeul.	DOM BERNARD seul.
Alouſe paßion, dangereuſe couleuure, Qui pour nuire ou creuer, mets tout poiſon en œuure;	Alouse passion, dangereuse couleuvre, Qui pour nuire ou créver, mets tout poison en œuvre;
Fille à qui te fait naiſtre ingrate & ſans pitié, Au moins tuant l’amour, épargne l’amitié;	Fille à qui te fait naître ingrate et sans pitié, Au moins tuant l'amour, épargne l'amitié;
Et ne m’engendre pas d’vne rage commune, Et l’oubly de l’Infante, & la haine de Lune!	Et ne m'engendre pas d'une rage commune, Et l'oubli de l'Infante, et la haine de Lune!
De Lune dont les faits m’ont ſeruy de degrez, A monter à des rangs de tant d’yeux reuerez, Ce de Lune inuaincu dont la valeur extréme, A tant fait pour ma gloire, & ſi peu pour luy-méme.	De Lune dont les faits m'ont servi de grés, A monter à des rangs de tant d'yeux révérez, Ce de Lune invaincu dont la valeur extrême, A tant fait pour ma gloire, et si peu pour lui-même.
Laiſſons libres ſes vœux à de libres appas, Et complices du ſort, ne l’entreprenons pas.	Laissons libre ses vœux à de libres appas, Et complices du sort, ne l'entreprenons pas.
Sa rage aſſez long-temps contre luy mutinée, A ſous vn mauuais aſtre ourdy ſa deſtinée:	Sa rage assez longtemps contre peine mutinée, A sousfin mauvais astre ourdi sa destinée:
Souffrons luy les aſpects de douceur & d’amour, Dont l’honore auiourd’huy l’aſtre de cette Cour:	Souffrons luy les aspects de douceur et d'amour, Dont l'honore aujourd'hui l'astre de cette Cour:
La voicy, cachons nous, & détournons la veuë, De vevtauvuanit, quitharme, mun qui tue.	La voici, cachons -nous, et détournons la vue, De vevtauvuanit, quitharme, mun qui tue.
SCEIEEI L’INFANTE, D.	SCEIEI L'INFANTE, D.
BERNARD.	BERNARD.
L’INFANTE.	L'INFANTE.
Voy me fuyr, Admiral!	Vois me fuir, Admiral!
quoy vouloir m'éuiter!	quoi vouloir m'éviter!
Ay je des qualitez à tant eſpouuanter?	Ai je des qualités à tant épouvanter?
D.	D.
BERNARD.	BERNARD.
Vous reſuiez, & i’ay creu que quelque inquietude, Vous obligeoit, Madame, à cette ſolitude.	Vous rêviez, et j'ai cru que quelque inquiétude, Vous obligeait, Madame, à cette solitude.
L’INFANTE.	L'INFANTE.
Il eſt vray, mais vous ſeul me pouuez releuer, Du ſoin qui m’inquiete & qui me fait réuer Auiourd’huy Dom Bernard que la Cour vous contemple, Dans le plus haut éclat, d’vn Heros ſans exemple;	Il est vrai, mais vous seul me pouvez relever, Du soin qui m'inquiète et qui me fait réuer Auiourd’hui Dom Bernard que la Cour vous contemple, Dans le plus haut éclat, d'un Héros sans exemple;
Qu’on vous voit auec ioye, autant & plus puißant, Que fut iamais vaſſal d’vn Roy recognoiſſant;	Qu'on vous voit approie, autant et plus puissant, Que fut jamais vassal d'un Roi reconnaissant;
Que l’vn & l’autre ſexe, en voſtre heur s’intereſent, Les Dames ſont en peine à qui vos vœux s’adreſſent, Et quels heureux appas, en la guerre des cœurs, Remporteront ſur vous le titre des vainqueurs;	Que l'autre et l'autre sexe, en votre heur s'interesent, Les Dames sont en peine à qui vos vœux s'adressent, Et quels heureux appas, en la guerre des cœurs, Remporteront sur vous le titre des vainqueurs;
Carvous ne voudriez pas qu’on vous crût inuincible A la force d’vn ſexe, à qui tout eſt poßible;	Carvous ne voudriez pas qu'on vous crut invincible À la force d'un sexe, à qui tout est possible;
Qui ſe peut tout ſouſmettre, & de qui les regards Forçoient les Scipions, & domptoient les Ceſars.	Qui se peut tout soumettre, et de qui les regards Forçaient les Scipions, et domptaient les Césars.
Cét honneur s’eſtant donc fait tant d’ambitieuſes;	Cet honneur s'étant donc fait tant d'ambitieuses;
Moy comme la plus ieune & des plus curieuſes, I’ay voulu me charger de la commißion De leur faire ſçauoir voſtre inclination;	Moi comme la plus jeune et des plus curieuses, J'ai voulu me charger de la commion De leur faire savoir votre inclination;
Et c’eſtoit le ſuiet de mon inquietude.	Et c'était le sujet de mon inquiétude.
D.	D.
BERNARD.	BERNARD.
Mon plus ardent deſir & ma plus chere eſtude, Sont de ſeruir ce ſexe adorable & charmant, Dont touſiours la conqueſte honore en deſarmant.	Mon plus ardent désir et ma plus chère étude, Sont de servir ce sexe adorable et charmant, Dont toujours la conquête honore en désarmant.
L’INFANTE.	L'INFANTE.
Ces termes generaux me laiſſans incertaine, Me laiſſent ſans moyen ae tes tirerde perne;	Ces termes généraux me laissant incertaine, Me laissent sans moyen ae tes tirerde perne;
Et ne nous obligeant que d’vn deuoir communPour ſeruir trop u vviets, vous n'en ſeruez pas vn.	Et ne nous obligeant que d'un devoir communPour servir trop u vviets, vous n'en servez pas un.
D.	D.
BERNARD.	BERNARD.
Vous m’ordonnez, Madame, vn excez d’inſolence Qu'ont aſſez publié mes yeux & mon ſilence, Et quelque viue ardeur dont on ſoit enflammé, Lim portance n'eſt pas d’aymer, mais d’eſtre aymé;	Vous m'ordonnez, Madame, une excès d'insolence Qu'ont assez publié mes yeux et mon silence, Et quelque vive ardeur dont on soit enflammé, Lim portance n'est pas d'aimer, mais d'être aimé;
Et fonder ſon eſpoir deſſus quelque apparence.	Et fonder son espoir dessus quelque apparence.
EINFANIE, Craignez vous de déplaire?	EINFANIE, Craignez -vous de déplaire?
aymez ſans eſperance,	aimez sans espérance,
D.	D.
BERNARD.	BERNARD.
Reſtrainct dans ce reſpect ie puis vous obeyr, I’ayme donc vn obiet que nul ne peut hayr;	Restrainct dans ce respect , puis vous obéir, J'aime donc un objet que nul ne peut haïr;
Qui par vos propres yeux vous a cent fois rauie, Que ſeule vous pouuez contempler ſans enuie.	Qui par vos propres yeux vous a cent fois ravie, Que seule vous pouvez contempler sans envie.
Qui vous contemple außi, ſans en eſtrejaloux, Et qui n’a rien d’intime & de cher comme vous;	Qui vous contemple aussi, sans en êtrejaloux, Et qui n'a rien d'intime et de cher comme vous;
Vn treſor preferable à toute ma fortune, Le ſeul Soleil enfin digne de cette Lune, 8 ſe fait redouter partant d’effets diuers, Et qui peut en ſon cercle enfermer l’Vniuers.	Un trésor préférable à toute ma fortune, Le seul Soleil enfin digne de cette Lune, 8 se fait redouter partant d'effets divers, Et qui peut en son cercle enfermer l'Univers.
Par voſtre ſage aduis ſouffrant ſa preferance, I'ayme ſans intereſt, & ſers ſans eſperance.	Par votre sage avis souffrant sa préférence, J'aime sans intérêt, et sers sans espérance.
Ie voy ce clair Soleil, ie tremble à ſon aſpect, L’amour pour l’amitié s’impoſe ce reſpect;	Je vois ce clair Soleil, Seigneur tremble à son aspect, L'amour pour l'amitié s'impose ce respect;
*a.	*a.
L'intereſt de l’amy m'eſloigne de l’amante, Mais le temps éteindra cette ardeur, Violante;	L'intérêt de l'ami m'éloigne de l'amante, Mais le temps éteindra cette ardeur, Violante;
Ie l’ay nommée, adieu.	Je l'ai nommée, adieu.
DCENE III L’INFANTE ſeule.	DCENE III L'INFANTE seule.
De ce propos confus, Qu'ay-je lieu d’inſerer ou deſſein, ou refus;	De ce propos confus, Qu'ai-je lieu d'insérer ou dessein, ou refus;
Ie cherche des clartez & n’en rencontre aucune, Ny dedans ce Soleil, ny dedans cette Lune;	Je cherche des clartés et n'en rencontre aucune, Ni dedans ce Soleil, Seigneur dedans cette Lune;
Pour me tirer de ſoin, i’augmente mon tourment, Et voulant m'éclaircir, crois mon aueuglement.	Pour me tirer de soin, j'augmente mon tourment, Et voulant m'éclaircir, crois mon aveuglement.
Achercher toutefois le ſens de ce langage, Quelque rayon de iour penetre ce nuage;	Achercher toutefois le sens de ce langage, Quelque rayon de jour penetre ce nuage;
Cette Lune feconde en tant d’effets diuers, Et qui peut en ſon cercle enfermer l’uniuers, Eſt le Prince mon frere, ame de cet empire, Et ce Soleil pour qui l’vn & l’autre ſouſpire, Eſt cette Leonor, pour qui toute la Cour N'aplus que des regatus ue reſpets & d'amonr;	Cette Lune féconde en tant d'effets divers, Et qui peut en son cercle enfermer l'univers, Est le Prince mon frère, âme de cet empire, Et ce Soleil pour qui l'un et l'autre soupire, Est cette Leonor, pour qui toute la Cour N'applus que des régatus ue respets et d'amron;
Mais ſi la jalouſie auec quelque iuſtice, A iamais dans vne ame exercé ſon caprice, Ie rabbatray le vol de ſa temerité, Auecques tant d’empire & de ſeuerité, Et ſçauray de tel air ranger ce grand courage, Que tamais ſa beauté ne cauſera d’ombrage.	Mais si la jalousie avec quelque justice, A jamais dans une âme exercé son caprice, Je rabatrai le vol de sa témérité, Avecques tant d'empire et de sévérité, Et saurai de tel air ranger ce grand courage, Que tamais sa beauté ne causera d'ombrage.
SCEIVEEV D.	SCEIVEEU D.
LOPE, L’INFANTE.	LOPE, L'INFANTE.
D.	D.
LOPE.	LOPE.
JNe fois declaré le ſort nous rit touſiours, V Voicy l’Infante, Amour, i’implore tõſecours, Ie tremble à voſtre approche, & mon reſpect, Madame, Auec touts ſes efforts veut retenir ma flame;	JNe fois déclaré le sort nous rit toujours, V Oici l'Infante, Amour, j'implore tõsecours, Je tremble à votre approche, et mon respect, Madame, Avec touts ses efforts veut retenir ma flamme;
Mais ma flame plus forte enfin que mon reſpect, M'expoſe à ſouſtenir voſtre adorable aſpect;	Mais ma flamme plus forte enfin que mon respect, M'expose à soutenir votre adorable aspect;
A l’ardeur de vos feux mon ame accouſtumée Sçait qu’elle ne peut plus en eſtre conſommée;	À l'ardeur de vos feux mon âme accoutumée Sait qu'elle ne peut plus en être consommée;
Son repos ſe rencontre en ſon embragement, Et ce qui la détruit, deuient ſon aliment;	Son repos se rencontre en son embragement, Et ce qui la détruit, devient son aliment;
Quoy que par ma naiſſance à la voſtre inegale, Mon eſpoir s’eſleuant außi-toſt ſe rauale, Et que ie ſemble prendre vn vet trop arrogant.	Quoi que par ma naissance à la vôtre inégale, Mon espoir s'élevant aussitôt se ravale, Et que ici semble prendre un vêt trop arrogant.
L’INFANTE eſtonnée.	L'INFANTE étonnée.
O Dieu!	Ô Dieu!
que veut ce fol!	que veut ce fol!
& cet extrauagant?	et cet extravagant?
D.	D.
LOPE.	LOPE.
Vos propres mains, Madame, ont auoüé l’audace, De ce feu qui chez vous rencontre tant de glace;	Vos propres mains, Madame, ont auoüé l'audace, De ce feu qui chez vous rencontre tant de glace;
Et m'ont fait eſperer quand vos yeux m'ont bleßé.	Et m'ont fait espérer quand vos yeux m'ont blesié.
ETNFANIE.	ETNFANIE.
Qu'entends-jelhola, quelqu’vn, chaſſez cet inſenſé.	Qu'entends-jélholà, quelqu'un, chassez cet insensé.
D.	D.
LOPE.	LOPE.
Atort de mes tributs voſtre heauté s’irrite, Ie ne ſuy que la loy que vous m’auez preſcrite, Ie bruſle par voſtre ordre, & par luy ie vous ſerts, Il m’allume mes feux, il m’attache mes fers;	Atort de mes tributs votre heauté s'irrite, Je ne suis que la loi que vous m'avez prescrite, Je brûle par votre ordre, et par notre laisser vous serts, Il m'allume mes feux, il m'attache mes fers;
Et ma ſouſmißion plus que mon arrogance.	Et ma sousmission plus que mon arrogance.
L’INFANTE.	L'INFANTE.
Dieu!	Dieu!
quelle frenaiſie, & quelle extrauagancel.	quelle frénaisie, et quelle extravagancel.
A*Mme-- D.	A*Mme- D.
LOPE.	LOPE.
Il ne me manquoit plus que cette qualité.	Il ne me manquait plus que cette qualité.
Mais de quel vain eſpoir m'auezvous donc flatté?	Mais de quel vain espoir m'auezvous donc flatté?
L'INFANTE.	L'INFANTE.
Et fureurit faiſit, ie trains quelque diſgrace, Aucun ne vient, fuyons & cedons luy la place.	Et fureurit faisit, ie trains quelque disgrâce, Aucun ne vient, fuyons et cédons toujours la place.
D.	D.
EOILo.	EOILo.
Quoy fol & furieux !	Quoi fol et furieux !
ôCiel!	ôCiel!
mais le Roy vient.	mais le Roi vient.
LINFANTE.	LINFANTE.
Sire, oyez quels diſcours cet inſensé me tient.	Sire, oyez quels discours cet insensé me tient.
DEIVE LE ROY, GARDES,D.	DEIVE LE ROY, GARDES,D.
LOPE, L’INFANTE.	LOPE, L'INFANTE.
D.	D.
LOPE.	LOPE.
Sprouuons auiourd’huy ſa haine ou ſon eſtiOme, Ouurons nous, oyons tout, le deſeſpoir anime.	Sprouvons aujourd'hui sa haine ou son étiOme, Ouvrons nous, oyons tout, le désespoir anime.
Sire, apres des rebuts ſilong-temps éprouuez, Ie demande audience, & vous me la deuez;	Sire, après des rebuts silong-temps éprouvés, Je demande audience, et vous me la devez;
2 Tout mon corps vous parlant par de ſanglantes bouches, Dont il auroit touché les cœurs les plus farouches.	2 Tout mon corps vous parlant par de sanglantes bouches, Dont il aurait touché les cœurs les plus farouches.
N’a pû dans voſtre ſein treuuer le cœur d’vn Roy, N’ayant pû vous reſoudre à rien faire pour moy;	N'a pu dans votre sein trouver le cœur d'un Roi, N'ayant pu vous résoudre à rien faire pour moi;
I’ay donc lieu de tenter ſi la voix ordinaire, N'y rencontrera point vn cœur plus debonnaire;	J'ai donc lieu de tenter si la voix ordinaire, N'y rencontrera point un cœur plus débonnaire;
La vertu rebutée apres tant de meſpris, Sans ternir ſon éclat, peut demander ſon prix.	La vertu rebutée après tant de mépris, Sans ternir son éclat, peut demander son prix.
Ie pourrois (il eſt vray) paſſer pour temeraire, Si ie vous propoſois vne vertu vulgaire, Mais la mienne eſt celebre, & peu ſans vanité, Ont fait ce que i’ay fait pour voſtre Majeſté:	Je pourrais (il est vrai) passer pour téméraire, Si je vous proposais une vertu vulgaire, Mais la mienne est célèbre, et peu sans vanité, Ont fait ce que j'ai fait pour votre Majesté:
Et i’aprends toutefois pour tout fruict de mon gele, Que vous me ſoupçonnez du titre d’infidele.	Et j'apprends toutefois pour tout fruit de mon gèle, Que vous me soupçonnez du titre d'infidèle.
Moy traiſtre, moy perfide!	Moi traître, moi perfide!
en quoy Roy d’Arraon D’vne tache ſi noire ay-je ſoüillé mon nom?	en quoi Roi d'Arraon D'une tache si noire ai-je soüillé mon nom?
Et merité de vous l’iniuſte violence, Qui veut l’enſeuelir dans la nuict du ſilence?	Et mérité de vous l'injuste violence, Qui veut l'ensuelir dans la nuit du silence?
LE ROY.	LE ROY.
Que veut cet homme!	Que veut cet homme!
ôCiel!	ôCiel!
D.	D.
LOPE.	LOPE.
Homme!	Homme!
oüy ſans me flatter, C’eſt vne qualité dont ie me puis vanter:	oui sans me flatter, C'est une qualité dont personne me puis vanter:
Oüy, Seigneur, ie ſuis homme, & quelque fois plus qu’homme, Quand ie crois trop l’ardeur qui pour vous me conſomme, Et quand dans les dangers où l’on me voit courir, Ie crois eſtre immortel & ne pouuoir perir.	Oui, Seigneur, je suis homme, et quelque fois plus qu'homme, Quand tu crois trop l'ardeur qui pour vous me consomme, Et quand dans les dangers où l'on me voit courir, Je crois être immortel et ne pouvoir périr.
I FANTE.	I SANTÉ.
Iugez quel embarras me cauſoit ſa rencontre?	Jugez quel embarras me causait sa rencontre?
Iuſte Ciel!	Juste Ciel!
D.	D.
LOPE.	LOPE.
F OY.	F OY.
Eſt-il fol?	Est-il fol?
L’INFANTE.	L'INFANTE.
Son geſte vous le monſtres	Son geste vous le monstres
OY ſe retirant.	OY se retirant.
Paſſe, que me veux-tus	Passe, que me veux-tus
D.	D.
LOPE.	LOPE.
A quelle épreuue o Cieux!	À quelle épreuve ô Cieux!
metlez vous ma vertu?	metlez -vous ma vertu?
Si de l’abord des Rois le merite eſt indigne.	Si de l'abord des Rois le mérite est indigne.
1.	1.
GARDES le tirant par les eſpaules.	GARDES le tirant par les épaules.
Toſt dehors:	Tôt dehors:
Cardes mettez le horst ô la folie infigne!	Cardes mettez le horst ô la folie insigne!
D.	D.
LOPE.	LOPE.
O mon cœur!	Ô mon cœur!
ô mes bras indomptez!	ô mes bras indomptés!
Vous m’auez procuré de belles qualitez, Pour auoir ſi bien fait noſtre fortune eſt grande, Quandonſert on eſt ſage, & fol quand on demande.	Vous m'avez procuré de belles qualités, Pour avoir si bien fait notre fortune est grande, Quandonsert on est sage, et fol quand on demande.
SCENEV.	SCENEU.
ALNE LE ROY, L’INFANTE.	ÀLNE LE ROY, L'INFANTE.
LE ROY.	LE ROY.
VE fol peint par ces mots, mon deſtin rigouY reux, Et me fait le portraict de moy-meſme amoureux;	VE fol peint par ces mots, mon destin rigouis reux, Et me fait le portrait de moi-même amoureux;
Ie bruſle ſans eſpoir, ie ſerts ſans recompenſe, Mon ſeruice eſt ſouffert, & ma priere offence;	Je brûle sans espoir, ie serts sans récompense, Mon service est souffert, et ma prière offense;
L’eſtat, ma cher ſœur, où Dieu m’a deſtiné, Comme ie le regis, m’a touſiours gouuerné;	L'état, ma cher sœur, où Dieu m'a destiné, Comme ie le régis, m'a toujours gouverné;
Y regnant, i’ay ſuiuy les loix qu’il m’a données, Iay dans ſes intereſts mes pa ßions bornées;	Y régnant, j'ai suivi les lois qu'il m'a données, Iais dans ses intérêts mes pa ssions bornées;
Ie les eſpouſois ſeuls;	Je les épousais seuls;
mais auiourd’huy l’amour Plus abſolu que luy, veut regner à ſon tour.	mais aujourd'hui l'amour Plus absolu que Elle, veut régner à son tour.
Il ne peut plus ſouffrir qu'en l’ardeur qui me preſſe, Il contraigne ſon maiſtre auenoneue jumuiſtreſſe;	Il ne peut plus souffrir qu'en l'ardeur qui me presse, Il contraigne son maître auenoneue jumuistresse;
Et diſpoſant de moy faſſe d’vn Potentat, Moins vn Prince en effet, qu’vn ſerf de ſon Eſtat;	Et disposant de moi fasse d'un Potentat, Moins un Prince en effet, qu'un serf de son État;
En cette paßion l’intereſt de Cabrere, Seul preferable au mien pourroit m'eſtre contraiA quoy que Leonor me reduiſe aujourdhuy, Ses mepris me plairoient, ſesvœux eſtants pour luy, Et mon reſpect iroit iuſqu à la deference;	En cette passion l'intérêt de Cabre, Su préférable au mien pourroit m'ère contraiA quoi que Leonor me réduise aujourdhuy, Ses mépris me plairoient, sesvœux étants pour lui, Et mon respect iroit iusqu la déférence;
De pouuoir, enamour, ſouffrir ſa preference;	De pouvoir, enamour, souffrir sa préférence;
L’INFANTE.	L'INFANTE.
Ha!	Ha!
vous pouuez, Seigneur, eſleuer vn vaſſal, Au rang d’vn fauory, mais non pas d’vnriual;	vous pouvez, Seigneur, élever un vassal, Au rang d'un favori, mais non pas d'vnriual;
Si ce reſpect en vous treuoit tant de foibleße, S’il eſtoit ſi puiſſant pres de voſtre maiſtreſſe;	Si ce respect en vous trouvait tant de foiblesse, S'il était si puissant pres de votre maîtresse;
A quel poinct ſon pouuoir ne s’eſtendroit il pas, Et deſſus vos ſujets, & deſſus vos eſtats?	À quel point son pouvoir ne s'étendrait -il pas, Et dessus vos sujets, et dessus vos états?
LE ROY.	LE ROY.
Dedans les ſentiments que ſa vertu m’inſpire, Luy pouuant außi bien dépoſer mon Empire, Que la pretention d ion ouſed amourenx, Ie voudrois couronner ſon front, comme ſes yeux.	Dedans les sentiments que sa vertu m'inspire, Lui pouvant aussi bien déposer mon Empire, Que la prétention d ion ouséd amourenx, Je voudrais couronner son front, comme ses yeux.
Sondons de qui ſon cœur recognoiſt la puiſſance, Pour m’en faire vne loy d’eſpoir ou de deffence;	Sondons de qui son cœur reconnaît la puissance, Pour m'en faire une loi d'espoir ou dé sensé;
L’INFANTE le ſuiuant.	L'INFANTE le suivant.
Enfant pere des arts, Ingenieux tourment, Fay regner ma riuale & m’acquiers mon amant.	Enfant père des arts, Ingénieux tourment, Fais régner ma rivale et m'acquiers mon amant.
SCEEVDVL D.	SCEUDVL D.
BERNARD, D, LOPE.	BERNARD, D, LOPE.
D.	D.
BERNARD.	BERNARD.
Voy rien ne vous ſuccede?	Vois rien ne vous succède?
& le Prince & l’Infante, De cet indigne accueil ont traicté voſtre attente?	et le Prince et l'Infante, De cet indigne accueil ont traité votre attente?
D.	D.
LOPE.	LOPE.
Ils m’ont traicté d’vn nom que i’ay bien mertté, Si quelque eſpoir encor flatte ma vanité, Si ſacrifiant plus à mes erreurs paſſees, I'en fais le fondement de mes folles penſees;	Ils m'ont traité d'un nom que j'ai bien merté, Si quelque espoir encor flatte ma vanité, Si sacrifiant plus à mes erreurs passe, J'en fais le fondement de mes folles pensées;
Et ſi dans les perils d’vne fameuſe mort, Ie ne vais contenter la cruauté dù ſort.	Et si dans les périls d'une fameuse mort, Je ne vais contenter la cruauté dù sort.
I’ay veu cent fois le ports & la vague plus forte, Quand i’y penſe arriuer à l’inſtant me r’emporte, I’ay faict tout ce que peut pour preuue de ſa foy, Vn captif pour ſõ maiſtre, vn ſubiect pour ſon Roy;	J'ai vu cent fois le ports et la vague plus forte, Quand j'y pense arriver à l'instant me remporte, J'ai fait tout ce que peut pour prévue de sa foi, Un captif pour sont maître, un sujet pour son Roi;
En mille occaſions i’ay la parque affrontee, Meſme par les meſpris ma foy s’eſt excitee;	En mille occasions j'ai la parque affronte, Même par les mépris ma foi s'est excite;
Et plus i’ay pour l’eſtat acheué de trauaux, Plus il me fait d’iniure, & ſe rit de mes maux;	Et plus j'ai pour l'état achevé de travaux, Plus il me fait d'injure, et se rit de mes maux;
La terre ainſi de fleurs & de moiſſon parée, Eſt prodigue à la main, dont elle eſt dechirée, Et d’vn ſeruile effort ranimant ſa vigueur, Donne à qui plus contre elle exerce de rigueur;	La terre ainsi de fleurs et de moisson parée, Est prodigue à la main, dont elle est déchirée, Et d'H servile effort ranimant sa vigueur, Donne à qui plus contre elle exerce de rigueur;
Mais le plus rude affront dõt ie reſſents l’atteinte, Eſt ce fatal appas, cette mortelle feinte, Dont la ſuperbe Infante a voulu colorer L’eſpoir qu'elle ſemoit, pour me deſeſperer;	Mais le plus rude affront dõt le ressents l'atteinte, Est ce fatal appas, cette mortelle feinte, Dont la superbe Infante a voulu colorer L'espoir qu'elle semait, pour me désespérer;
Quand ie n'oze eſtre Amant, on m’ordonne de l’ere, Pour me traicter de fol, on me le fait paroiſtre;	Quand notre n'ose être Amant, on m'ordonne de l'ère, Pour me traiter de fol, on me le fait paraître;
Et le frere & la ſœur tous deux également.	Et le frère et la sœur tous deux également.
Font de mes paßions leur diuertiſſement.	Font de mes passions leur divertissement.
LAZARILLE apportant vne eſcharpe de toile d’or, & vne lettre à D.	LAZARILLE apportant une écharpe de toile d'or, et une lettre à D.
Lope.	Lope.
SENVEVIE LAZARILLE, D.	SENVEUIE LAZARILLE, D.
LOPE, D.	LOPE, D.
BERN.	BERN.
Enez voſtre fortune eſt en haute poſture, IO le diuin obiect!	Enez votre fortune est en haute posture, JO le divin objet!
l’aymable ceature!	l'aimable ceature!
Ses charmes m’ont ſurpris, & iamais le Soleil, En, vn oblique tour, n’a rien veu de pareil, Crt gages vout font foy de ſon amour extréme.	Ses charmes m'ont surpris, et jamais le Soleil, En, Un oblique tour, n'a rien vu de pareil, Crt gages vout font foi de son amour extrême.
D.	D.
LOPE.	LOPE.
Qui te les a donnez?	Qui te les a donnés?
LAZARILLE.	LAZARILLE.
Violante elle meſme;	Violante elle -même;
D.	D.
LOPE.	LOPE.
Croiray-je à ſes écrits, quand ſes yeux inhumains.	Croirai-je à ses écrits, quand ses yeux inhumains.
Par vn ſi froid accueil ont dementy ſes mains?	Par un si froid accueil ont démenti ses mains?
LAZARILLE.	LAZARILLE.
diauie queut u ompie aauis eſt ceiit ptolante?	diavie queut u ompie aavis est ciit ptolante?
D.	D.
LOPE.	LOPE.
I'ay penſe ſous ce nom rẽdre hommage à l’Infante!	J'ai pense sous ce nom rendre hommage à l'Infante!
LAZARILLE riant.	LAZARILLE riant.
A l’Infante!	À l'Infante!
écoutez d’vn fidelle pinceau, Ie vais de ſa beauté vous faire le tableau;	écoutez d'un fidèle pinceau, Je vais de sa beauté vous faire le tableau;
Sous ce nom captieux, ie preparois ma veuë, Aux celeſtes attraits dont l’Infante eſt pourueuë;	Sous ce nom captieux, je préparais ma vue, Aux célestes attraits dont l'Infante est pourvue;
Mais pour toute merueille Ignés ne m’a faiſt voir Qu'vn Spectre & qu’vn fantoſme horrible d'onceuoir, La plus belle moitié de ce mouuant ſchelette, Couché deſſous ſon lict, & deſſous ſa toilette;	Mais pour toute merveille Ignès ne m'a faisut voir Qu'un Spectre et qu'un fantôme horrible d'oncvoir, La plus belle moitié de ce mouvant schette, Couché dessous son lit, et dessous sa toilette;
D’abord que i’ay monté s’aiuſtant auec ſoing, Elle a pris ſes patins pour me voir de plus loing;	D'abord que j'ai monté s'aiustant avec soin, Elle a pris ses patins pour me voir de plus loing;
Pour ſecond ornement, i’ay veu ſur ſes eſpaules, Vn abregé des monts qui ſeparent les Gaules;	Pour second ornement, j'ai vu sur ses épaules, Un abrégé des monts qui séparent les Gaules;
Son front où l’on diroit que le ſoch a paſſé, S’eſleue à hauts ſillons ſur vn œil enfoncé, Qu'on peut dire vn ſoleil non par ce qu’il eſclaiMais par ce qu’il eſt ſeul &, qu’il n’a point defreLet emps a pris plaiſir par de longs accidents, A ronger & pourrir l’iuoire de ſes dents;	Son front où l'on dirait que le soch a passé, S'esleue à hauts sillons sur un œil enfoncé, Qu'on peut dire un soleil non par ce qu'il éclaiMais par ce qu'il est seul et, qu'il n'a point défreLet emps a pris plaisir par de longs accidents, A ronger et pourrir l'ivoire de ses dents;
D’vn art mal agencé le plaſtre & la peinture, Sur ſa pendante ioüe ont caché la nature:	D'un art mal agencé le plâtre et la peinture, Sur sa pendante joue ont caché la nature:
Rien ne la pare enfin qui ne ſoit emprunté.	Rien ne la pare enfin qui ne soit emprunté.
Pour ſon poil il eſt ſien, pour l’auoir achepté;	Pour son poil il est sien, pour l'avoir acheté;
Mais il fut autres fois celuy d’vne autre teſte.	Mais il fut autres fois celui d'une autre tête.
Faictes en bien le vain;	Faictes en bien le vain;
voila voſtre conqueſte Qui chez l’Infante au reſte a quelque authorité, Mais ie ne vous puis dire en quelle qualité, Sinon qu'elle à ſonnom, muts nonpus fonmerde.	voilà votre conquête Qui chez l'Infante au reste à quelque autorité, Mais ainsi ne vous puis dire en quelle qualité, Sinon qu'elle à sonnom, muts nonpus fonmerde.
D.	D.
BERNARD.	BERNARD.
C’eſt vne vielle fille & preſque decrepite, Qui la ſert à la chambre, & dans quelque credit, D.	C'est une vielle fille et presque décrépite, Qui la sert à la chambre, et dans quelque crédit, D.
LOPE jettant la letre & l’escharpe.	LOPE jetant la letre et l'écharpe.
Quel mortel à ce poinct fut iamais interdit?	Quel mortel à ce point fut jamais interdit?
D.	D.
BERNARD.	BERNARD.
Moy certes, comme apres leur longue experience, poomuux ciennens uvourut ovſirt paiience.	Moi certes, comme après leur longue expérience, poomuux ciennents ouvourut ovirt paiience.
I'en demeure confus & pour leur appreil, Me treuue à bout außi d’adreſſe & de conſeil.	J'en demeure confus et pour leur appréil, Me trouve à bout aussi d'adresse et de conseil.
D.	D.
LOPE comme deſeſperé.	LOPE comme désespéré.
Et pour ton faſte encor i’exercerois mes armes, Et dans ta vanité ie treuuerois des charmes, Et ie voudrois encor mordre à tes hameçons, Cour ingrate où l’art ſeul eſtalle ſes leçons, Et qui hors d’vn amy dont la bonté ſincere Luy faict auoir pour moy des ſentiments de frere, N'offres dans les malheurs dont ie ſuis combatu, Ny Cecours, ny ſouſtien à ma foible vertu:	Et pour ton faste encor j'exercerais mes armes, Et dans ta vanité homme trouverais des charmes, Et belle voudrais encor mordre à tes hameçons, Cour ingrate où l'art seul estalle ses leçons, Et qui hors d'un ami dont la bonté sincère Lui fait avoir pour moi des sentiments de frère, N'offres dans les malheurs dont ie suis combattu, Ni Cecours, ni soutien à ma faible vertu:
Cour où la valeur meſme eſt trop fauoriſee, Alors qu'elle eſt ſoufferte, ou n'eſt que meſpriſee:	Cour où la valeur même est trop favorisée, Alors qu'elle est soufferte, ou n'est que méprisée:
Cour fantoſme pompeux de qui les vanitez, Engagent la prudence à tant de lâchetez!	Cour fantôme pompeux de qui les vanités, Engagent la prudence à tant de lâchetés!
Cour où la verité paſſe pour vn beau ſonge, Où le plus haut credit eſt le prix du menſonge;	Cour où la vérité passe pour un beau songe, Où le plus haut crédit est le prix du mensonge;
Qui n'eſt à bien parler, qu'vn ſeruage doré, Vn ſupplice agreable, vn enfer adoré;	Qui n'est à bien parler, qu'autre servage doré, Un supplice agréable, un enfer adoré;
Dans tes pieges encor ma raiſon retenuë, Me pourroit arreſter, quand tu m'es ſi cognuë?	Dans tes pièges encor ma raison retenue, Me pourrait arrêter, quand tu m'es si connue?
Ie ſerois inſenſible & mes lâches tributs, Iuſtifieroient enfin ma honte, & tes rebuts;	Je serais insensible et mes lâches tributs, Justifieraient enfin ma honte, et tes rebuts;
braſeĩt A dieu parfaict amy, ſeul à qui ſans caprice, La Cour eſt genereuſe, & le ſort rend iuſtice.	braseint A dieu parfait ami, seul à qui sans caprice, La Cour est généreuse, et le sort rend justice.
Vn mortel malheureux au poinct où ie le ſuis, Par vne illuſtre mort doibt borner ſes ennuys;	Un mortel malheureux au point où tu le suis, Par une illustre mort doibt borner ses ennuis;
Voyant Ou s’il ne perd au moins, doibt cacher vne vie, rille pa A tant d’indignitez & d’affronts aſſeruie;	Voyant Ou s'il ne perd au moins, doibt cacher une vie, rille pa Y tant d'indignités et d'affronts asservie;
iecthas Laſche de mon affront veus tu porter les marques?	Acthas Lâche de mon affront vus tu porter les marques?
M CixRTMmM Si vous n’en eſperez que de ſœurs de Monarques;	M MixRTMmM Si vous n'en espérez que de sœurs de Monarques;
Et ſi iamais d’ailleurs nous n’en deuons porter, Nous auons tout loiſir d’aller les meriter.	Et si jamais d'ailleurs nous n'en devons porter, Nous avons tout loisir d'aller les mériter.
D.	D.
BERNARD voulant retenir D.	BERNARD voulant retenir D.
Lope.	Lope.
Le temps peut tout changer, cependãt cher de Lune, En ma protection bornez voſtre fortune;	Le temps peut tout changer, cependant cher de Lune, En ma protection bornez votre fortune;
Si vous vous eſloignez, vous oſtez à l'Eſtat, Sa plus noble deffenſe & ſon meilleur ſoldat;	Si vous vous éloignez, vous ôtez à l'État, Sa plus noble défense et son meilleur soldat;
Ecoutez, affendeZ.	Écoutez, affendez.
Il continuë ſeul.	Il continue seul.
O fatale aduanture!	Ô fatale aventure!
De la haine du ſort effroyable peinture!	De la haine du sort effroyable peinture!
Auuovon importumte ueceure quu fan puiſſants, de ejulun faigemnen delaf Syuse	Auvovon importumte ecure quu fan puissants, de ejulun faigemnen délaf Syuse
SCEIVEVIII LEROY, LE COMTE,LESECRET.	SCEIVEVIII LEROI, LE COMTE,LESECRET.
GARDES, D.	GARDES, D.
BERNARD.	BERNARD.
LE ROY.	LE ROY.
E voicy, preuenons ou ſondons ſon attente, LAmenez Leonor, & vous Comte l’Infante;	E voici, prévenons ou sondons son attente, LAmenez Leonor, et vous Comte l'Infante;
Ae se Approchez Dom Bernard, de ce fameux Eſtat Premiere creature, & ſecond Potentat;	Ae se Approchez Dom Bernard, de ce fameux État Première créature, et second Potentat;
Le Ciel qui pour mouuoir a beſoing de deux poles, BernVeut que pour bien regner i’emprunte vos eſpaules, Et que le lourd fardeau de mon Gouuernement, Sur vo uscomme ſur moy, treuue ſon mouuëment.	Le Ciel qui pour mouvoir a besoin de deux pôles, BernVeut que pour bien régner j'emprunte vos épaules, Et que le lourd au de mon Gouvernement, Sur vo uscomme sur moi, trouve son mouvement.
D.	D.
BERNARD.	BERNARD.
Sans reſerue, Seigneur, ie dois tout à l'Empire, Mais ſous l’autorité du ioug où ie reſpire;	Sans réserve, Seigneur, je dois tout à l'Empire, Mais sous l'autorité du joug où notre respire;
Sous vos droits abſolus mes ordres ſont ſoufferts, Mais bien differemment, vous regnez, & ie ſerts Vn vaſſal peut d’vn Roy ſouſtenir la puiſſance, Mais s’il ſe la partage, il prend trop de licence;	Sous vos droits absolus mes ordres sont soufferts, Mais bien différemment, vous régnez, et notre serts Un vassal peut d'un Roi soutenir la puissance, Mais s'il se la partage, il prend trop de licence;
Et quand de tant d’honneur il ſe laiſſe combler, Il ſe charge d’vn faix qui le doit accabler:	Et quand de tant d'honneur il se laisse combler, Il se charge d'une faix qui le doit accabler:
Quand d’vn œil trop ardent le Soleil voit la terre, Le Ciel s’en obſcurcit, il s’en forme vn tonnerre, Et par l’excez d’ardeur qu’il a mal employé, L'opiect qu'il careſſoit, eſt ſouuent foudroyé, momuepurje en faifamnamenmtumde perile, Ou trop d'eau ta ſuomerge & ta tenu inutile;	Quand d'un oeil trop ardent le Soleil voit la terre, Le Ciel s'en obscurcit, il s'en forme un tonnerre, Et par l'excès d'ardeur qu'il a mal employé, L'opject qu'il caressait, est souvent foudroyé, momuepurje en faifamnamenmtumde perile, Ou trop d'eau ta superge et ta tenu inutile;
Dans vos faueurs enfin laiſſés moy ſouuenir, Que ſorty du neant ie puis y reuenir;	Dans vos faveurs enfin laissés moi souvenir, Que sorti du néant tu puis y revenir;
LE ROY.	LE ROY.
Si ie ne vous cheris d’vn amour ordinaire, Ie n’ayme pas en vous vne vertu vulgaire, Et la veux Couronner par vn hymen fameux, Où meſme voſtre choix n’eſpargne pas mes vœux, Sans reſerue voyez pour cet hymen inſigne, Tout ce qu’à vos regards la Cour a de plus digne, Tout ce que l’Arragon a de plus eſclattant, Le preſent n'en ſuiura vos vœux que d’vn inſtant.	Si personne ne vous chéris d'espar ordinaire, Je n'aime pas en vous une vertu vulgaire, Et la veux Couronner par un hymen fameux, Où même vôtre choix n'épargne pas mes vœux, Sans réserve voyez pour cet hymen insigne, Tout ce qu'à vos regards la Cour a de plus digne, Tout ce que l'Aragon a de plus éclatant, Le présent n'en suivra vos vœux que d'un instant.
D.	D.
BERNARD.	BERNARD.
Leur vol trop orgueilleux m’oblige à les reſtraindre.	Leur vol trop orgueilleux m'oblige à les restraindre.
LE ROY.	LE ROY.
A quoy m’eſtant egal ne pouuez vous attaindre!	À quoi m'étant égal ne pouvez vous attaindre!
Vous pouuez Admiral, ie vous le dis encor, A mon excluſion pretendre à Leonor:	Vous pouvez Admiral, je vous le dis encor, À mon exclusion prétendre à Leonor:
Puiſqu a mon propre mien voſtre peur m'eſt preferable, Et que vous m'eſtes cher autant qu’elle adorable:	Puisqu à mon propre mien votre peur m'est préférable, Et que vous m'êtes cher autant qu'elle adorable:
D.	D.
BERNARD.	BERNARD.
Mon cœur quelque reſpect qu’il vous ayt conſerué, OZe tenter vn vol encor plus eſleue;	Mon cœur quelque respect qu'il vous ait conservé, OZe tenter un vol encor plus esleue;
Mais taiſant ceſte ardeur qui me faict méconnoiI'ayme-mieux me punir, que meriter de l’eſtre.	Mais taisant cette ardeur qui me fait méconnoiI' que-mieux me punir, que mériter de l'être.
LE ROY.	LE ROY.
Ce vol eſt trop borné, s’il ne va qu’à ma ſœur, Et cette meſme nuict vous en rend poſſeſſeur:	Ce vol est trop borné, s'il ne va qu'à ma sœur, Et cette même nuit vous en rend possesseur:
Ne me celez donc point ſi cette amour vous touche,	Ne me celez donc point si cette amour vous touche,
D.	D.
BERNARD.	BERNARD.
Ent run crime du cœur n’engagez, point la bouche;	Ent run crime du cœur n'engagez, point la bouche;
Puiſque touts mes trauaux & futurs & paſſez,	Puisque touts mes travaux et futurs et passez,
LE ROY.	LE ROY.
Voſtre ſilence parle & me la nomme aſſez;	Votre silence parle et me la nomme assez;
Ouy monfrere en fonnon, iene poy voſtre homma	Oui monfrere en fonnon, iene poi votre homma
SCENE DERNIERE.	SCÈNE DERNIÈRE.
LINTAIN TE,DE GOMTE,LEONOR LE SECRETAIRE d’vn coſté.	LINTAIN TE,DE GOMTE,LEONOR LE SECRÉTAIRE d'un côté.
LE ROY, D.	LE ROY, D.
BERNARD d’autre coſté.	BERNARD d'autre côté.
EDROIALIRIANTE.	EDROIALIRIANTE.
IN Amant ſe declare à qui ie vous engage, V Ses vœux (ma chere ſœur) ſeront ils reiettez?	IN Amant se déclare à qui je vous engage, V Ses vœux (ma chère sœur) seront ils rejettez?
L’INFANTE.	L'INFANTE.
Non, ſide Dom Berhmrunules qualitez;	Non, side Dom Berhmrunules qualités;
LE ROY les faiſant embraſſer.	LE ROY les faisant embrasser.
Ibinale nom mqme anceques ſemne.	Ibinale nom même anceques semne.
D.	D.
BERNARD.	BERNARD.
Ocher & doux tranſport que cet eſpoir m’excite!	Ocher et doux transport que cet espoir m'excite!
Sienelar quele congej, ney ent dcente, Plutoſt qu’vn ſi beau ſonge, oſte moy la clarté.	Sienelar quele congej, ney ent denté, Plutôt qu'un si beau songe, ôte moi la clarté.
LEONOR les voyant s’embraſſer.	LEONOR les voyant s'embrasser.
Que vois-je !	Que vois-je ?
ô iuſte Ciel!	ô juste Ciel!
quoy, Seigneur, la parole!	quoi, Seigneur, la parole!
N’eſt-elle plus aux Rois, qu'vn ſonge, ou qu'vne Idole?	N'est-elle plus aux Rois, qu'un songe, ou qu'une Idole?
Dematin queitpue ouiet qui ne puſt enflammer, Ne me deuoit couſter qu’vn ſouhait a former;	Dematin queitpue ouiét qui ne pût enflammer, Ne me devait coûter qu'une souhait à former;
Et cette offre ce ſoir, me laiſſe voir l’Infante, Embraſſant Dom Bernard, étouffer mon attente.	Et cette offre ce soir, me laisse voir l'Infante, Embrassant Dom Bernard, étouffer mon attente.
LE ROY.	LE ROY.
Si ie manque à ma foy, c’eſt pour vous la donner, Pour vous la tenir mieux, & pour vous couron-braſit.	Si grande manque à ma foi, c'est pour vous la donner, Pour vous la tenir mieux, et pour vous couron-brasit.
ner;	ner;
Pour accorder, Madame, à voſtre amour extréme, Cet heureux Dom Bernard en vn autre luy-méme;	Pour accorder, Madame, à votre amour extrême, Cet heureux Dom Bernard en un autre lui-même;
Et ſous vn nœud ſacré ſouſmette en ce beau iour, Ets iutjons de l'Eſtar à tents dt v'amonr.	Et sous un nœud sacré sousmette en ce beau jour, Ets jutjons de l'Étar à tents d 'amonr.
LEONOR.	LEONOR.
L’iniure qui d’vn Roy partage la puiſſance, Et qui place en ſon trône, eſt vne heureuſe offence.	L'injure qui d'He Roy partage la puissance, Et qui place en son trône, est une heureuse offense.
LE ROY.	LE ROY.
Comme ſur mon eſprit, regnez ſur mas Eſtats, Allons.	Comme sur mon esprit, régnez sur mas États, Allons.
Mais quel écrit trouuay-je ſous mes pas?	Mais quel écrit trouvai-je sous mes pas?
D.	D.
BERNARD.	BERNARD.
D'vne vieille ſuiuante à ce Lope de Lune, Dont la ſeule valeur égale l’infortune.	D'une vieille suivante à ce Lope de Lune, Dont la seule valeur égale l'infortune.
Ce prodige animé dont les geſtes guerriers, Vous ont couuert le front de vos plus beaux lauriers;	Ce prodige animé dont les gestes guerriers, Vous ont couvert le front de vos plus beaux lauriers;
Et de ſon plus beau luſtre embelly voſtre regne, Qui repouſſa l’Infant, quiſouſmit la Sardaigne, Et dont la renommée auec tant de ſuccés, Dans voſtre eſprit encor n’a ſçeu treuuer d’accés.	Et de son plus beau lustre embelli votre règne, Qui repoussa l'Infant, quisousmit la Sardaigne, Et dont la renommée auec tant de succès, Dans votre esprit encor n'a su trouver d'accès.
LE ROY.	LE ROY.
Quel malheur l’a priué de ma recognoiſſance?	Quel malheur l'a privé de ma reconnaissance?
D.	D.
BERNARD.	BERNARD.
Sa der niere infortun eeſt encor ſonab ſence;	Sa der nière infortun eest encor son sence;
Carapres touts mes ſoings en vain officieux, Pos tongs revuts enſin tont tuape de tes teux.	Caraprès touts mes soins en vain officieux, Pos tongs revuts ensin tont tuape de tes teux.
18 Moyennez ſon retour;	18 Moyennez son retour;
ma grace auec vſure, Du merite ignoré reparera l’iniure;	ma grâce avec usure, Du mérite ignoré réparera l'injure;
Pniſque i'éprouue en vous qu’vn Roy recognoiſ121 A force de donner, en deuient plus puiſſant.	Pnisque j'éprouve en vous qu'un Roi reconnais121 A force de donner, en devient plus puissant.
IN.	IN.
Exiraiti an Irmbege au Roy,	Exiraiti an Irmbege au Roi,
AR Grace & Priuilege du Roy, donné à Paris le 11.	AR Grâce et Privilège du Roi, donné à Paris le 11.
Mars 1647.	Mars 1647.
Signé, Par le Roy enſon Conſeil, LE BRVN.	Signé, Par le Roi enson Conseil, LE BRVN.
Il eſt permis à ANTOINE DE SOMMAVILLE, Marchand Libraire à Paris, d’imprimer ou faire imprimer vne Comedie intitulée, Dom Bernard de Cabrere, & ce durant le temps & eſpace de cinq ans, à compter du iour que ledit Liure ſera acheué d’imprimer.	Il est permis à ANTOINE DE SOMAUILLE, Marchand Libraire à Paris, d'imprimer ou faire imprimer une Comédie intitulée, Dom Bernard de Cabre, et ce durant le temps et espace de cinq ans, à compter du jour que ledit Livre sera achevé d'imprimer.
Et deffences à tous autres d’en vendre ny diſtribuer d’autre impreſſion que de celle qu’aura fait ou teit faire ledit debonimauie, à peme de enqcens liures d’amende, ainſi qu’il eſt plus amplement porté dans les Lettres cydeſſus dattées.	Et défenses à tous autres d'en vendre ni distribuer d'autre impression que de celle qu'aura fait ou te faire ledit débonimavie, à peme de enqcens livres d'amende, ainsi qu'il est plus amplement porté dans les Lettres cydessus dattées.
Et ledit de Sommauille a aſſocié audit Priuilege Touſſainct Quinet, außi Marchand Libraire à Paris, ſuiuant l’accord fait entr'eux.	Et ledit de Sommauille a associé audit Privilège Toussaint Quinet, aussi Marchand Libraire à Paris, suivant l'accord fait entr'eux.
Les Exemplaires ont eſté fournis.	Les Exemplaires ont été fournis.
Exiraiti an Irmbege au Roy,	Exiraiti an Irmbege au Roi,
AR Grace & Priuilege du Roy, donné à Paris le 11.	AR Grâce et Privilège du Roi, donné à Paris le 11.
Mars 1647.	Mars 1647.
Signé, Par le Roy enſon Conſeil, LE BRVN.	Signé, Par le Roi enson Conseil, LE BRVN.
Il eſt permis à ANTOINE DE SOMMAVILLE, Marchand Libraire à Paris, d’imprimer ou faire imprimer vne Comedie intitulée, Dom Bernard de Cabrere, & ce durant le temps & eſpace de cinq ans, à compter du iour que ledit Liure ſera acheué d’imprimer.	Il est permis à ANTOINE DE SOMAUILLE, Marchand Libraire à Paris, d'imprimer ou faire imprimer une Comédie intitulée, Dom Bernard de Cabre, et ce durant le temps et espace de cinq ans, à compter du jour que ledit Livre sera achevé d'imprimer.
Et deffences à tous autres d’en vendre ny diſtribuer d’autre impreſſion que de celle qu’aura fait ou teit faire ledit debonimauie, à peme de enqcens liures d’amende, ainſi qu’il eſt plus amplement porté dans les Lettres cydeſſus dattées.	Et défenses à tous autres d'en vendre ni distribuer d'autre impression que de celle qu'aura fait ou te faire ledit débonimavie, à peme de enqcens livres d'amende, ainsi qu'il est plus amplement porté dans les Lettres cydessus dattées.
Et ledit de Sommauille a aſſocié audit Priuilege Touſſainct Quinet, außi Marchand Libraire à Paris, ſuiuant l’accord fait entr'eux.	Et ledit de Sommauille a associé audit Privilège Toussaint Quinet, aussi Marchand Libraire à Paris, suivant l'accord fait entr'eux.
Les Exemplaires ont eſté fournis.	Les Exemplaires ont été fournis.
