M.	M.
DC.	DC.
LXIII.	LXIII.
Auec Priuilege du Roy.	Avec Privilège du Roi.
4 MADAME.	4 MADAME.
ADAME, ALTESSE ROYALE, ſur le titre de L’ECOLE DES FEMMES, & l’offre qu’il vous en feroit.	ADAME, ALTESSE ROYALE, sur le titre de L'ECOLE DES FEMMES, et l'offre qu'il vous en ferait.
Mais pour moy, MADAME, ie vous auoüe mon foible.	Mais pour moi, MADAME, je vous auoüe mon faible.
Ie ne ſçay point cét art de trouuer des rapports entre des choſes ſi peu proportionnées;	Je ne sais point cet art de trouver des rapports entre des choses si peu proportionnées;
& quelques belles lumieres, que mes Confreres les Autheurs me donnent tous les iours ſur de pareils ſujets, ie ne voy point ce que VOSTRE ALTESSE ROYALE pourroit auoir à démeſler auec la Comedie que ie luy preſente.	et quelques belles lumières, que mes Confrères les Auteurs me donnent tous les jours sur de pareils sujets, notre ne vois point ce que VOTRE ALTESSE ROYALE pourrait avoir à démêler avec la Comédie que de lui presente.
On n’eſt pas en peine, ſans doute, comment il faut faire pour vous loüer.	On n'est pas en peine, sans doute, comment il faut faire pour vous louer.
La matiere, MADAME, ne ſaute que trop aux yeux, & de quelque coſté qu'on vous regarde, on rencontre Gloire ſur Gloire, & qualitez ſur qualitez.	La matière, MADAME, ne saute que trop aux yeux, et de quelque côté qu'on vous regarde, on rencontre Gloire sur Gloire, et qualités sur qualités.
Vous en auez, MADAME, du coſté du rang, & de la naiſſance, qui vous font reſpecter de toute la terre.	Vous en avez, MADAME, du côté du rang, et de la naissance, qui vous font respecter de toute la terre.
Vous en auez du coſté des Graces, & de l’Eſprit, & du Corps, qui vous font admirer de toutes les perſonnes, qui vous voyent.	Vous en avez du côté des Grâces, et de l'Esprit, et du Corps, qui vous font admirer de toutes les personnes, qui vous voient.
Vous en auez du coſté de l’ame, qui, ſi l’on oſe parler ainſi, vous font aymer de tous ceux qui ont l’honneur d’approcher de vous:	Vous en avez du côté de l'âme, qui, si l'on ose parler ainsi, vous font aimer de tous ceux qui ont l'honneur d'approcher de vous:
Ie veux dire cette douceur pleine de Charmes, dont vous daignez temperer la fierté des grands titres que vous portez;	Je veux dire cette douceur pleine de Charmes, dont vous daignez tempérer la fierté des grands titres que vous portez;
cette bonté toute obligeante;	cette bonté toute obligeante;
cette affabilité genereuſe, que vous faites paroiſtre pour tout le monde* Et ce ſont particulierement ces dernieres pour qui ie ſuis, & dont ie ſens fort bien que ie ne me pourray taire quelque iour.	cette affabilité généreuse, que vous faites paraître pour tout le monde* Et ce sont particulièrement ces dernières pour qui ie suis, et dont ici sens fort bien que personne ne me pourrai taire quelque jour.
Mais encore vne fois, MADAME, ie ne ſçay point le biais de faire entrer icy des veritez éclatantes, & ce ſont choſes, à mon aduis, & d’vne trop vaſte eſtendüe;	Mais encore une fois, MADAME, on ne sais point le biais de faire entrer ici des vérités éclatantes, et ce sont choses, à mon avis, et d'une trop vaste étendue;
& d’vn merite tropreleué, pour les vouloir renfermer dans vne Epiſtre, & les meſler auec des bagatelles.	et d'autre mérite troprelevé, pour les vouloir renfermer dans une Épître, et les mêler avec des bagatelles.
Tout bien conſideré, MADAME, Ie ne voy rien à faire icy pour moy, que de vous Dédier ſimplement ma Comedie, & de vous aſſeurer auec tout le reſpect, qu’il m’eſt poßible, que ie ſuis de VOSTRE ALTESSE	Tout bien considéré, MADAME, Je ne vois rien à faire ici pour moi, que de vous Dédier simplement ma Comédie, et de vous assurer auec tout le respect, qu'il m'est possible, que je suis de VÔTRE ALTESSE
MADAME, Le tres-humble, tres-obeïſſant, & tresobligé ſeruiteur I.	MADAME, Le très-humble, très-obeïssant, et trèsobligé serviteur I.
B.	B.
MOLIERE.	MOLIÈRE.
TRCMETTAL.	TRCMETTAL.
IEN des gens ont frondé d’abord cette Comedie:	JEN des gens ont frondé d'abord cette Comédie:
mais les rieurs ont eſté pour elle, & tout le mal qu’on en a pû dire, n’a pû faire qu’elle n’ait eu vn ſuccez, dont ie me contente.	mais les rieurs ont été pour elle, et tout le mal qu'on en a pu dire, n'a pu faire qu'elle n'ait eu un succès, dont je me contente.
Ie ſçay qu’on attend de moy, dans cette impreſſion, quelque Preface, qui reſponde aux cenſeurs, & rende raiſon de mon Ouurage;	Je sais qu'on attend de moi, dans cette impression, quelque Préface, qui réponde aux censeurs, et rende raison de mon Ouvrage;
& ſans doute que ie ſuis aſſez redeuable à toutes les perſonnes, qui luy ont donné leur approbation, pour me croire obligé de deffendre leur iugement, contre celuy des autres:	et sans doute que je suis assez redevable à toutes les personnes, qui luitaît donné leur approbation, pour me croire obligé de défendre leur jugement, contre celui des autres:
mais il ſe trouue qu’vne grande partie des choſes, que i’aurois à dire ſur ce ſuiet, eſt deja dans vne Diſſertation, que i’ay faite en Dialogue, & dont ie ne ſçay encore ce que ie feray.	mais il se trouve qu'une grande partie des choses, que j'aurais à dire sur ce sujet, est déjà dans une Dissertation, que j'ai faite en Dialogue, et dont tu ne sais encore ce que je ferai.
L’idée de ce Dialogue, ou ſi l’on veut, de cette petite.	L'idée de ce Dialogue, ou si l'on veut, de cette petite.
Comedie, me vint aprés les deux ou trois premieres repreſentations de ma Piece;	Comédie, me vint après les deux ou trois premières représentations de ma Pièce;
le la dis cette idée dans vne maiſon où ie me trouuay vn ſoir, & d’abord vne perſonne de qualité, dont l’oſprit eſt aſſez connû dans le monde, & qui me fait l’hõneur de m’aymer, trouua le projet aſſez à ſon gré, non ſeulement pour me ſolliciter d’y mettre la main, mais encore pour l’y mettre luy-meſme, & ie fus eſtonné que deux iours aprés il me monſtra toute l’affaire executée, d’vne maniere, à la verité, beaucoup plus Galante, & plus Spirituelle, que ie ne puis faire, mais où ie trouuay des choſes trop aduantageuſes pour moy, & i’eus peur, que ſi ie produiſois cét Ouurage ſur noſtre Theatre, on ne m’accuſaſt d’abord d’avoir mendié les loüanges, qu’on m’y donnoit.	le la dis cette idée dans une maison où tu me trouvai un soir, et d'abord une personne de qualité, dont l'osprit est assez connu dans le monde, et qui me fait l'honneur de m'aimer, trouva le projet assez à son gré, non seulement pour me solliciter d'y mettre la main, mais encore pour l'y mettre h-même, et même eu estonné que deux jours après il me montrera toute l'affaire exécutée, d'une manière, à la vérité, beaucoup plus Galante, et plus Spirituelle, que je ne puis faire, mais où je trouvai des choses trop avantageuses pour moi, et j'eus peur, que si ie produisais cet Ouvrage sur notre Theatre, on ne accusât abord avoir mendié les loüanges, on y donnoit.
Cependant cela m’empeſcha, par quelque conſideration, d’acheuer ce que i’auoie commencé;	Cependant cela m'empêcha, par quelque considération, d'achever ce que j'avoie commencé;
mais tant de gens me preſſent tous les jours de le faire, que ie ne ſçay ce qui en ſera, & cette incertitude eſt cauſe, que ie ne mets point dans cette Preface, ce qu’on verra dãs la Critique, en cas que ie me reſolue à la faire paroiſtre.	mais tant de gens me pressent tous les jours de le faire, que je ne sais ce qui en sera, et cette incertitude est cause, que je ne mets point dans cette Préface, ce qu'on verra dans la Critique, en cas que je me résolue à la faire paraître.
S’il faut que cela ſoit, ie le dis encore, ce ſera ſeulement pour vanger le public du chagrin delicat de certaines gens;	S'il faut que cela soit, ie le dis encore, ce sera seulement pour venger le public du chagrin délicat de certaines gens;
car pour moy ie m’en tiens aſſez vangé par la Reuſſite de ma Comedie, & ie ſouhaite que toutes celles, que ie pourray faire, ſoient traittées par eux, comme celle-cy, pourueu que le reſte ſuiue de meſme.	car pour mo ie m'en tiens assez vengé par la Réussite de ma Comédie, et quelque souhaite que toutes celles, que sans pourrai faire, soient traitées par eux, comme celle-cy, pourvu que le reste suive de même.
Extraict da Timmegidd Roy.	Extrait da Timmégid Roi.
AR Grace & Priuilege du Roy, donné à J Paris, le 4.	AR Grâce et Privilège du Roi, donné à J Paris, le 4.
Feurier 1663.	Février 1663.
Signé par le Roy en ſon Conſeil, GVITONNEAV.	Signé par le Roi en son Conseil, GUITONNEAU.
Il eſt permis à GVILLAVME DE LVYNE Marchand Libraire de Noſtre bonne Ville de Paris, de faire imprimer vne Piece de Theatre, de la Compoſition du Sieur MOLIERE Intitulée:	Il est permis à GUILLAUME DE LUYNE Marchand Libraire de Notre bonne Ville de Paris, de faire imprimer une Pièce de Théâtre, de la Composition du Sieur MOLIÈRE Intitulée:
L'Eſcole des Femmes, pendant le temps de ſix années;	L'École des Femmes, pendant le temps de six années;
Et deffences ſont faites à toutes perſonnes de quelque qualité & condition qu’ils ſoient, d’imprimer, vendre ny débiter ladite Comedie de l’Eſcole des Femmes, à pemne de fin frares d’amande, & de tous deſpens, dommages & intereſts:	Et défenses sont faites à toutes personnes de quelque qualité et condition qu'ils soient, d'imprimer, vendre ici débiter ladite Comédie de l'École des Femmes, à pemne de fin frares d'amende, et de tous dépens, dommages et intérêts:
Comme ieſt plus amplement porté par leſdites Lettres.	Comme iest plus amplement porté par lesdites Lettres.
Alheué d’imprimer pour la premiere fois, le 17.	Alheué d'imprimer pour la première fois, le 17.
Mars 1663.	Mars 1663.
Les Exemplaires ont eſté fournis.	Les Exemplaires ont été fournis.
Regiſtré ſur le Liure de la Communauté des Marchands Libraires & Imprimeurs, le 16.	Registré sur le Livre de la Communauté des Marchands Libraires et Imprimeurs, le 16.
Mars 1663.	Mars 1663.
Signé, DVBRAY.	Signé, DUBRAY.
Syndic.	Syndic.
Et ledit DE LVYNE a fait part du Priuilege cy-deſſus, aux Sieurs SERCY, LOLY, BILLAINE, LOYSON ) GVIGNARD, BARBIN, & QVINET, pour en joüir le temps porté par iceluy.	Et ledit DE LUYNE a fait part du Privilège cy-dessus, aux Sieurs SERCY, LOLY, BILLAINE, LOISON ) GUIGNARD, BARBIN, et QUINET, pour en jouir le temps porté par icelui.
LES PERSONNAGES 22oſ h anon ARNOLPHE, Autrement Monſieur  MVV.	LES PERSONNAGES 22os h ânon ARNOLPHE, Autrement Monsieur MUV.
de la Souche.	de la Souche.
AGNES, 6 Ieune Fille innocente eleuée par Arnolphe.	AGNES, 6 Jeune Fille innocente élevée par Arnolphe.
GEORGETTE, Payſanne, ſervante d’Arnolphe.	GEORGETTE, Paysanne, servante d'Arnolphe.
CHRYSALDE, Amy d’Arnolphe.	CHRYSALDE, Ami d'Arnolphe.
21 DES FEMMES, COMEDIE.	21 DES FEMMES, COMÉDIE.
ACTE I.	ACTE I.
SCENE PREMIERE.	SCÈNE PREMIÈRE.
CHRISHEDE IICNOETHE.	CHRISHÉDE IICNOETHE.
12 CHRISALDE.	12 CHRISALDE.
Ors venez, dites-vous, pour luy donner la main?	Ors venez, dites-vous, pour lui donner la main?
ARNOLPHE.	ARNOLPHÉ.
Oüy, ie veux terminer la choſe dans demain.	Oui, Seigneur veux terminer la chose dans demain.
CHRISALDE.	CHRISALDE.
Nous ſommes icy ſeuls, & l’on peut, ce me ſemble, Sans craindre d’eſtre oüis, y diſcourir enſemble.	Nous sommes ici seuls, et l'on peut, ce me semble, Sans craindre d'être ouïs, y discourir ensemble.
2!	2!
Voulez-vous qu’en Amy ie vous ouure mon cœur?	Voulez-vous qu'en Ami vertu vous ouvre mon cœur?
Voſtre deſſein, pour vous, me fait trembler de peur;	Votre dessein, pour vous, me fait trembler de peur;
Et de quelque façon que vous tourniez l’affaire, Prendre Femme, eſt a vons vircoup bien temeraire.	Et de quelque façon que vous tourniez l'affaire, Prendre Femme, est a virons vircoup bien téméraire.
ARNOLPHE.	ARNOLPHÉ.
Il eſt vray, noſtre Amy.	Il est vrai, notre Ami.
Peut-eſtre que chez vous Vous trouuez des ſujets de craindre pour chez nous;	Peut-être que chez vous Vous trouvez des sujets de craindre pour chez nous;
Et voſtre front, ie croy, veut que du Marlage, Les Cornes ſoient par tout l’infaillible apanage.	Et votre front, ie croy, veut que du Marage, Les Cornes soient par tout l'infaillible apanage.
CHRISALDE.	CHRISALDE.
Ce ſont coups du Hazard, dõt on n’eſt point garand;	Ce sont coups du Hasard, dont on n'est point garant;
Et bien ſot, ce me ſemble, eſt le ſoin qu’on en prend.	Et bien sot, ce me semble, est le soin qu'on en prend.
Mais quand ie crains pour vous, c’eſt cette raillerie Dont cent pauures Maris ont ſouffert la furie:	Mais quand ici crains pour vous, c'est cette raillerie Dont cent pauvres Maris ont souffert la furie:
Car enfin vous ſçauez, qu’il n’eſt grands, ny petits, Que de voſtre critique on ait veus garantis;	Car enfin vous savez, qu'il n'est grands, ni petits, Que de votre critique on ait vus garantis;
Oarvos plus grãds plaiſirs sõt, par tout où vous eſtes, De faire cent éclats des intrigues ſecrettes.	Oarvos plus grands plaisirs sont, par tout où vous êtes, De faire cent éclats des intrigues secrètes.
ARNOLPHE.	ARNOLPHÉ.
Fort bien:	Fort bien:
Eſt-il au Monde vne autre Ville auſſi, Où l’on ait des Maris ſi patients qu’icy?	Est-il au Monde une autre Ville aussi, Où l'on ait des Maris si patients qu'ici?
Eſt-ce qu’on n’en voit pas de toutes les eſpeces, Qui ſont accommodez chez eux de toutes pieces?	Est-ce qu'on n'en voit pas de toutes les espèces, Qui sont accommodés chez eux de toutes pièces?
L’vn amaſſe du bien, dont ſa Femme fait part A ceux qui prennent ſoin de le faire Cornard.	L'un amasse du bien, dont sa Femme fait part À ceux qui prennent soin de le faire Cornard.
L’autre vn peu plus heureux, mais non pas moins inVoit faire tous les jours despresẽs à ſa Fẽme, [fame, Et d’aucun ſoin jaloux n’a l’eſprit combattu, Parce qu’elle luy dit que c’eſt pour ſa vertu.	L'autre un peu plus heureux, mais non pas moins inVait faire tous les jours despresẽs à sa Femme, [fâme, Et d'aucun soin jaloux n'a l'esprit combattu, Parce qu'elle avait dit que c'est pour sa vertu.
L'vn fait beaucoup de bruit, qui ne luyſert de gueres;	L'un fait beaucoup de bruit, qui ne luisert de guères;
L’autre, en toute douceur, laiſſe aller les affaires, Et voyant arriuer chez luy le Damoiſeau, Prend fort honneſtement ſes gands, & ſon manteau.	L'autre, en toute douceur, laisse aller les affaires, Et voyant arriver chez lui le Damoiseau, Prend fort honnêtement ses gants, et son manteau.
L’vne de ſon Galant, en adroite Femelle, Fait fauſſe confidence à ſon Eſpoux fidelle, Qui dort en ſeureté ſur vn pareil appas, Et le plaint, ce Galant, des ſoins qu’il ne perd pas.	L'une de son Galant, en adroite Femelle, Fait fausse confidence à son Époux fidèle, Qui dort en sûreté sur un pareil appas, Et le plaint, ce Galant, des soins qu'il ne perd pas.
L’autre, pour ſe purger de ſa magnificence, Dit qu’elle gagne au jeu l’argent qu’elle dépenſe;	L'autre, pour se purger de sa magnificence, Dit qu'elle gagne au jeu l'argent qu'elle dépense;
Et le Mary beneſt, ſans ſonger à quel jeu, Sur les gains qu’elle fait, rend des graces à Dieu.	Et le Mari benêt, sans songer à quel jeu, Sur les gains qu'elle fait, rend des grâces à Dieu.
Enfin ce ſont par tout des ſujets de Satyre, Et comme Spectateur, ne puis-je pas en rire?	Enfin ce sont par tout des sujets de Satire, Et comme Spectateur, ne puis-je pas en rire?
Puis-je pas de nos Sots.	Puis-je pas de nos Sots.
CHRISALDE.	CHRISALDE.
Oüy:	Oui:
mais qui rit d’autruy, Doit craindre, qu’en reuanche, on rie auſſi de luy.	mais qui rit d'autrui, Doit craindre, qu'en revanche, on rie aussi de Seigneur.
I’entens parler le monde, & des gens ſe délaſſent A venir debiter les choſes qui ſe paſſent:	J'entends parler le monde, et des gens se délassent À venir débiter les choses qui se passent:
Mais quoy que l’on diuulgue aux endroits où ie ſuis, Iamais on ne m’a veu triompher de ces bruits;	Mais quoi que l'on divulgue aux endroits où tu suis, Jamais on ne m'a vu triompher de ces bruits;
I’y ſuis aſſez modeſte;	J'y suis assez modeste;
& bien qu’aux occurences Ie puiſſe condamner certaines tolerances;	et bien qu'aux occurences Je puisse condamner certaines tolérances;
Que mon deſſein ne ſoit de ſouffrir nullement, Ce que d’aucuns Maris ſouffrent paiſiblement, Pourtant ie n’ay iamais affecté de le dire;	Que mon dessein ne soit de souffrir nullement, Ce que d'aucuns Maris souffrent paisiblement, Pourtant grande n'ai jamais affecté de le dire;
Car enfin il faut craindre vn reuers de Satyre, Et l’on ne doit iamais jurer, ſur de tels cas, De ce qu’on pourra faire, ou bien ne faire pas.	Car enfin il faut craindre un revers de Satire, Et l'on ne doit jamais jurer, sur de tels cas, De ce qu'on pourra faire, ou bien ne faire pas.
Ainſi quand à mon front, par vn ſort qui tout meine, Il ſeroit arriué quelque diſgrace humaine, Apres mon procedé, ie ſuis preſque certain Qu’on ſe contentera de s’en rire ſous-main;	Ainsi quand à mon front, par un sort qui tout mène, Il serait arrivé quelque disgrâce humaine, Après mon procédé, ils suis presque certain Qu'on se contentera de s'en rire sous-main;
Et peut-eſtre qu’encor i’auray cet auautage, 10 Que quelques bonnes gens diront, que c’eſt dõmage!	Et peut-être qu'encor j'aurai cet avantage, 10 Que quelques bonnes gens diront, que c'est dommage!
Mais de vous, cher Compere, il en eſt autrement, Ie vous le dis encor, vous riſquez diablement.	Mais de vous, cher Compère, il en est autrement, Je vous le dis encor, vous risquez diablement.
4 Comms ſur les Maris accuſez de ſouffrance, De tout temps voſtre langue a daubé d’importance.	4 Comms sur les Maris accusés de souffrance, De tout temps vôtre langue a daubé d'importance.
Qu’on vous a veu contr’eux vn Diable déchainé;	Qu'on vous a vu contre eux un Diable déchaîné;
Vous deuez marcher droit, pour n’eſtre point berné;	Vous devez marcher droit, pour n'être point berné;
Et s’il faut que ſur vous on ait la moindre priſe, Gare qu’aux Carreiouls on ne vous ejuipauſſe, Et.	Et s'il faut que sur vous on ait la moindre prise, Gare qu'aux Carrejouls on ne vous éjuipausse, Et.
ARNOLPHE.	ARNOLPHÉ.
Mon Dieu, noſtre Amy, ne vous tourmẽtez point;	Mon Dieu, notre Ami, ne vous tourmentez point;
Bien hupé qui pourra m’attraper ſur ce poinct.	Bien hupé qui pourra m'attraper sur ce point.
Ie ſçay les tours ruſez, & les ſubtiles trames, Dont, pour nous en plãter, ſçauent vſer les Femmes, Et comme on eſt dupé par leurs dexteritez;	Je sais les tours rusés, et les subtiles trames, Dont, pour nous en planter, savent user les Femmes, Et comme on est dupé par leurs dextérités;
Coiſſle cet acemdene Pay pris mes ſedretee, Et celle que i’épouſe, a toute l’innocence Qui peut ſauuer mon front de maligne innuence.	Coissle cet acemdene Pay pris mes sedretee, Et celle que j'épouse, a toute l'innocence Qui peut sauver mon front de maligne innuence.
CHRISALDE.	CHRISALDE.
Et que pretendez-vous qu’vne Sotte en vn mot.	Et que prétendez-vous qu'une Sotte en un mot.
ARNOLPHE.	ARNOLPHÉ.
Epouſer vne Sotte, eſt pour n’eſtre point Sot:	Épouser une Sotte, est pour n'être point Sot:
Ie crois, en bon Chreſtien, voſtre moitié fort ſage;	Je crois, en bon Chrétien, votre moitié fort sage;
Mais vne Femme habile eſt vn mauuais préſage, Et ie ſçay ce qu’il couſte à de certaines gens, Pour auoir pris les leurs auec trop de talens.	Mais une Femme habile est un mauvais présage, Et tu sais ce qu'il coûte à de certaines gens, Pour avoir pris les leurs esprit trop de talents.
Moy i’irois me charger d’vne Spirituelle, Qui ne parleroit rien que Cercle, & que Ruelle?	Moi j'irais me charger d'une Spirituelle, Qui ne parlerait rien que Cercle, et que Ruelle?
Qui de Proſe, & de Vers, feroit de doux écrits, Et que viſiteroient Marquis, & beaux Eſprits, Tandis que, ſous le nom du Mary de Madame, Ie ſerois comme vn Saint, que pas-vn ne reclame?	Qui de Prose, et de Vers, ferait de doux écrits, Et que visiteraient Marquis, et beaux Esprits, Tandis que, sous le nom du Mari de Madame, Je serais comme un Saint, que pas-un ne réclame?
Non, non, ie ne veux point d’vn Eſprit qui ſoit haut, Et Femme qui compoſe, en ſçait plus qu’il ne faut.	Non, non, Madame ne veux point d'une Esprit qui soit haut, Et Femme qui compose, en sait plus qu'il ne faut.
Ie pretens que la mienne, en clartez peu ſublime, Meſme ne ſçache pas ce que c’eſt qu’vne Rime;	Je prétends que la mienne, en clartés peu sublime, Même ne sache pas ce que c'est qu'une Rime;
Et s’il faut qu’auec elle on jouë au Corbillon, Et qu’on vienne à luy dire, à ſon tour, qu’y met-on?	Et s'il faut qu'avec elle on joue au Corbillon, Et qu'on vienne à lui dire, à son tour, qu'y met-on?
Ie veux qu’elle réponde, vne tarte à la créme;	Je veux qu'elle réponde, une tarte à la crème;
En vn mot, qu’elle ſoit d’vne ignorance extréme;	En un mot, qu'elle soit d'une ignorance extrême;
Et c’eſt aſſez pour elle, à vous en bien parler, De ſçauoir prier Dieu, m’aimer, coudre, & filer.	Et c'est assez pour elle, à vous en bien parler, De savoir prier Dieu, m'aimer, coudre, et filer.
CHRISALDE.	CHRISALDE.
Vne Femme ſtupide eſt donc voſtre Marotte?	Une Femme stupide est donc votre Marotte?
ARNOLPHE.	ARNOLPHÉ.
Tant, que i’aimerois mieux vne laide, bien ſotte, Qu’vne Femme fort belle, auec beaucoup d’eſprit.	Tant, que j'aimerais mieux une laide, bien sotte, Qu'une Femme fort belle, avec beaucoup d'esprit.
CHRISALDE.	CHRISALDE.
a ciplit, u la bcautt.	a ciplit, la bcautt.
ARNOLPHE.	ARNOLPHÉ.
L’honneſteté ſuffit.	L'honnêteté suffit.
CHRISALDE.	CHRISALDE.
Mais comment voulez-vous, apres tout, qu’vne beſte Puiſſe iamais ſçauoir ce que c’eſt qu’eſtre honneſte?	Mais comment voulez-vous, après tout, qu'une bête Puisse jamais savoir ce que c'est qu'être honnête?
Outre qu’il eſt aſſez ennuyeux, que ie croy, D’auoir toute ſa vie vne beſte auec ſoy, Penſez-vous le bien prendre, & que ſur voſtre idée La ſeureté d’vn front puiſſe eſtre bien fondée?	Outre qu'il est assez ennuyeux, que sans crois, D'avoir toute sa vie une bête avec soi, Pensez-vous le bien prendre, et que sur votre idée La sûreté d'un front puisse être bien fondée?
Vne Femme d’eſprit peut trahir ſon deuoir;	Une Femme d'esprit peut trahir son devoir;
Mais il faut, pour le moins, qu’elle oſe le vouloir;	Mais il faut, pour le moins, qu'elle ose le vouloir;
Et la ſtupide au ſien peut manquer d’ordinaire, Sans en auoir l’enuie, & ſans penſer le faire.	Et la stupide au sien peut manquer d'ordinaire, Sans en avoir l'envie, et sans penser le faire.
ARNOLPHE.	ARNOLPHÉ.
A ce bel argument, à ce diſcours profond, Ce que Pantagruel à Panurge répond.	À ce bel argument, à ce discours profond, Ce que Pantagruel à Panurge répond.
Preſſez-moy de me joindre à Fẽme autre que ſotte;	Pressez-moi de me joindre à Femme autre que sotte;
Preſchez, patrocinez juſqu’à la Pentecoſte, Vous ſerez ébahy, quand vous ſerez au bout, Que vous ne m’aurez rien perſuadé du tout.	Prêchez, patrocinez jusqu'à la Pentecte, Vous serez ébahi, quand vous serez au bout, Que vous ne m'aurez rien persuadé du tout.
A iij	À jijà
CHRISALDE.	CHRISALDE.
le ne vo us dis pius mor.	le ne vo us dis pius mór.
ARNOLPHE.	ARNOLPHÉ.
Chacun a ſa methode.	Chacun a sa méthode.
En Femme, comme en tout, ie veux ſuiure ma mode;	En Femme, comme en tout, je veux suivre ma mode;
Ie me voy riche aſſez, pour pouuoir, que ie croy, Choiſir vne moitié, qui tienne tout de moy, Et de qui la ſoûmiſe, & pleine dépendance, N’ait à me reprocher aucun bien, ny naiſſance.	Je me vois riche assez, pour pendant, que je cro, Choisir une moitié, qui tienne tout de moi, Et de qui la soumise, et pleine dépendance, N'ait à me reprocher aucun bien, ni naissance.
Vn air doux, & poſé, parmy d’autres enfans, M’inſpira de l’amour pour elle, dés quatre ans:	Un air doux, et posé, parmi d'autres enfants, M'inspira de l'amour pour elle, dès quatre ans:
Sa Mere ſe trouuant de pauureté preſſée, De la luy demander il me vint la penſée, Et la bonne Payſanne, apprenant mon deſir, A s’oſter cette charge eut beaucoup de plaiſir.	Sa Mère se trouvant de pauvreté pressée, De la peine demander il me vint la pensée, Et la bonne Paysanne, apprenant mon désir, À s'ôter cette charge eut beaucoup de plaisir.
Dans vn petit Couuent, loin de toute pratique, Ie la fis éleuer, ſelon ma politique, C’eſt à dire ordonnant quels ſoins on employroit, Pour la rendre idiote autant qu’il ſe pourroit.	Dans un petit Couvent, loin de toute pratique, Je la fis élever, selon ma politique, C'est à dire ordonnant quels soins on emploierait, Pour la rendre idiote autant qu'il se pourrait.
Dieu mercy, le ſuccés a ſuiuy mon attente, Et grande, ie l’ay veuë à tel poinct innocente, Que i’ay beny le Ciel d’auoir trouué mon fait, Pour me faire vne Femme au gré de mon ſouhait.	Dieu merci, le succès a suivi mon attente, Et grande, tu l'ai vue à tel point innocente, Que j'ai béni le Ciel d'avoir trouvé mon fait, Pour me faire une Femme au gré de mon souhait.
Ie l’ay donc retirée;	Je l'ai donc retirée;
& comme ma demeure A cent ſortes de monde eſt ouuerte à toute heure, Ie l’ay miſe à l’écart, comme il faut tout préuoir, Dans cette autre Maiſon, où nul ne me vient voir;	et comme ma demeure A cent sortes de monde est ouverte à toute heure, Je l'ai mise à l'écart, comme il faut tout prévoir, Dans cette autre Maison, où nul ne me vient voir;
Et pour ne point gaſter ſa bonté naturelle, Ie n’y tiens que des gens tout auſſi ſimples qu’elle.	Et pour ne point gâter sa bonté naturelle, Je n'y tiens que des gens tout aussi simples qu'elle.
Vous me direz pourquoy cette narration?	Vous me direz pourquoi cette narration?
C’eſt pour vous rendre inſtruit de ma précaution.	C'est pour vous rendre instruit de ma précaution.
Le reſultat de tout, eſt qu’en Amy fidelle, Ce ſoir, ie vous inuite à ſouper auec elle:	Le résultat de tout, est qu'en Ami fidèle, Ce soir, je vous inuite à souper avec elle:
Ie veux que vous puiſſiez vn peu l’examiner, Et voir, ſi de mon choix on me doit condamner.	Je veux que vous puissiez un peu l'examiner, Et voir, si de mon choix on me doit condamner.
I’y conſens.	J'y consens.
CHRISALDE.	CHRISALDE.
ARNOLPHE.	ARNOLPHÉ.
y ouo pourren, dans cette conference, Iuger de ſa perſonne, & de ſon innocence.	y ouo pourren, dans cette conférence, Juger de sa personne, et de son innocence.
CHRISALDE.	CHRISALDE.
Pour cette article la, ce que vous m’auez dit, Ne peut.	Pour cet article la, ce que vous m'avez dit, Ne peut.
ARNOLPHE.	ARNOLPHÉ.
La verité paſſe encor mon recit.	La vérité passe encor mon récit.
Dans ſes ſimplicitez à tous coups ie l’admire, Et par fois elle en dit, dont ie pâme de rire.	Dans ses simplicités à tous coups Seigneur l'admire, Et par fois elle en dit, dont notre pâme de rire.
L’autre jour (pourroit-on ſe le perſuader) Elle eſtoit fort en perne, ce ie vint demander, Auec vne innocence à nulle autre pareille, Si les enfans qu’on fait, ſe faiſoient par l'oreille.	L'autre jour (pourrait-on se le persuader) Elle était fort en perne, ce ie vint demander, Avec une innocence à nulle autre pareille, Si les enfants qu'on fait, se faisaient par l'oreille.
CHRISALDE.	CHRISALDE.
le Me Iejouis Ioit, Seigneur Arnolpne.	le Me Jejouis Joit, Seigneur Arnolpne.
ARNOLPHE.	ARNOLPHÉ.
Bon, Me voulez-vous toûjours appeller de ce nom?	Bon, Me voulez-vous toujours appeler de ce nom?
CHRISALDE.	CHRISALDE.
Ah!	Ah!
malgré que i’en aye, il me vient à la bouche, Lt iumais le ne tonge a Momeur de ja Soucne, Qui diable vous a fait auſſi vous auiſer, A quarante & deux ans, de vous débaptiſer?	malgré que j'en aie, il me vient à la bouche, Lt jumais le ne tonge a Momeur de ja Soucne, Qui diable vous a fait aussi vous aviser, A quarante et deux ans, de vous débaptiser?
Et d’vn vieux tronc pourry de voſtre Metairie, Vous faire dans le Monde vn nom de Seigneurie?	Et d'un vieux tronc pourri de votre Métairie, Vous faire dans le Monde un nom de Seigneurie?
ARNOLPHE.	ARNOLPHÉ.
Outre que la Maiſon par ce nom ſe connaiſt, La Souche, plus qu’Arnolphe, à mes oreilles plaiſt.	Outre que la Maison par ce nom se connaît, La Source, plus qu'Arnolphe, à mes oreilles plaît.
CHRISALDE.	CHRISALDE.
Quel abus, de quitter le vray nom de ſes Peres, Pour en vouloir prendre vn baſty ſur des chimeres?	Quel abus, de quitter le vrai nom de ses Pères, Pour en vouloir prendre un bâti sur des chimères?
De la pluſpart des gens c’eſt la démangeaiſon;	De la plupart des gens c'est la démangeaison;
Et ſans vous embraſſer dans la comparaiſon, Ie ſçais vn Païſan, qu’on appelloit gros Pierre, Qui n’ayãt, pour toutbiẽ, qu’vn ſeulquartierde terre;	Et sans vous embrasser dans la comparaison, Je sais un Paysan, qu'on appelait gros Pierre, Qui n'ayant, pour toutbien, qu'un seulquartierde terre;
Yfit tout à l’entour raire vn roſſe bourbeux, Et de Monſieur de l’Iſle en prit le nom pompeux.	Yfit tout à l'entour raire un rosse bourbeux, Et de Monsieur de l'Isle en prit le nom pompeux.
ARNOLPHE.	ARNOLPHÉ.
Vous pourriez vous paſſer d’exemples de la ſorte:	Vous pourriez vous passer d'exemples de la sorte:
Mais enfin de la Souche eſt le nom que ie porte;	Mais enfin de la Souche est le nom que je porte;
I’y vois de la raiſon, i’y trouue des appas, Et m’appeller de l’autre, eſt ne m’obliger pas.	J'y vois de la raison, j'y trouve des appas, Et m'appeler de l'autre, est ne m'obliger pas.
CHRDSÆLDE.	CHRDSÆLDE.
Cependant la pluſpart ont peine à s’y ſoûmettre, Et ie voy meſme encor des adreſſes de Lettre.	Cependant la plupart ont peine à s'y soumettre, Et tu vo même encor des adresses de Lettre.
ARNOLPHE.	ARNOLPHÉ.
Ie le ſouffre aiſément de qui n’eſt pas inſtruit;	Je le souffre aisément de qui n'est pas instruit;
Mais vous.	Mais vous.
CIIRISALDE.	CIIRISALDE.
Soit.	Soit.
Là-deſſus nous n’aurons point de bruit, Et ie prendray le ſoin d’accouſtumer ma bouche A ne plus vous nommer que Monſieur de la Souche.	Là-dessus nous n'aurons point de bruit, Et grands prendrai le soin d'accoutumer ma bouche À ne plus vous nommer que Monsieur de la Souche.
ARNOLPHE.	ARNOLPHÉ.
Adieu:	Adieu:
Ie frape icy, pour donner le bon jour, Et dire ſeulement, que ie ſuis de retour.	Je frappe ici, pour donner le bon jour, Et dire seulement, que tu suis de retour.
CHRISALDE s’en allant.	CHRISALDE s'en allant.
Ma foy ie le tiens fou de toutes les manieres.	Ma foi ici le tiens fou de toutes les manières.
ARNOLPHE.	ARNOLPHÉ.
Il eſt vn peu bleſſé ſur certaines matieres.	Il est un peu blessé sur certaines matières.
Choſe étrange de voir, comme auec paſſion, Vn chacun eſt chauſſé de ſon opinion!	Chose étrange de voir, comme avec passion, Un chacun est chaussé de son opinion!
Hola.	Holà.
SCENE II.	SCÈNE II.
ALAIN, GEORGETTE, ARNOLPHE.	ALAIN, GEORGETTE, ARNOLPHÉ.
ARNOLPHE.	ARNOLPHÉ.
Ouurez.	Ouvrez.
On aura, que ie penſe, Grande jojeu me ronj apres dix jours d’abſence.	On aura, que personne pense, Grande jojeu me ronj à dix jours d'absence.
Qui va là?	Qui va là?
ALAIN.	ALAIN.
Moy.	Moi.
ARNOLPHE.	ARNOLPHÉ.
ALAIN.	ALAIN.
Georgette?	Georgette?
CESRGETTE, Hé bien?	CESRGETTTE, Hé bien?
ALRIN.	ÀLRIN.
Ouure là bas.	Ouvre là -bas.
GEORGETTE.	GEORGETTE.
ALAIN.	ALAIN.
a peoy.	a péoi.
GEORGETTE.	GEORGETTE.
Ma foy ie n’iray pas,	Ma foi ici n'irai pas,
Ie n’iray pas auſſi.	Je n'irai pas aussi.
ALAIN.	ALAIN.
ARNOLPHE.	ARNOLPHÉ.
Belle ceremonie, Pour me laiſſer dehors, Hola ho ie vous prie.	Belle cérémonie, Pour me laisser dehors, Holà ho ie vous prie.
A V	À V
Qui frape?	Qui frappe?
GEORGETTE.	GEORGETTE.
ARNOLPHE.	ARNOLPHÉ.
Voſtre Maiſtre.	Votre Maître.
GEORGETTE.	GEORGETTE.
Alain?	Alain?
AEMIIV.	AEMIV.
Quoy?	Quoi?
Ouure viſte.	Ouvre vite.
GEORGETTE.	GEORGETTE.
C’eſt Monſieu,	C'est Monsieur,
ALAIN.	ALAIN.
Cuule, tey.	Cule, tei.
GEORGETTE.	GEORGETTE.
Ie ſouſfle noſtre feu.	Je souffle notre feu.
ALAIN.	ALAIN.
I’empeſche, peur du Chat, que mõ Moineau ne ſorte.	J'empêche, peur du Chat, que mon Moineau ne sorte.
ARNOLPHE.	ARNOLPHÉ.
Quiconque de vous deux n’ouurira pas la porte, N’aura point a manger de prus de quatle jours, Ha.	Quiconque de vous deux n'ouvrira pas la porte, N'aura point à manger de prus de quatle jours, Ha.
GEORGETTE.	GEORGETTE.
Par quelle raiſon y venir quand i’y cours.	Par quelle raison y venir quand j'y cours.
ALAIN.	ALAIN.
Pourquoy plutoit que moy?	Pourquoi plutait que moi?
le plaiſant ſtrodagéme?	le plaisant stratagème?
GEORGETTE.	GEORGETTE.
Oſte-toy donc de là.	Ost-toi donc de là.
ALAIN.	ALAIN.
Non, oſte-toy, toy-méme.	Non, ôte-toi, toi-même.
GEORGETTE.	GEORGETTE.
Ie veux ouurir la porte.	Je veux ouvrir la porte.
ALAIN.	ALAIN.
Et ie veux l’ouurir, moy.	Et Ne veux l'ouvrir, moi.
GEORGETTE.	GEORGETTE.
Tu ne l’ouuriras pas.	Tu ne l'ouvriras pas.
ALAIN.	ALAIN.
Ny toy non plus.	Ni toi non plus.
GEORGETTE.	GEORGETTE.
Ny toy.	Ni toi.
ARIVOLPHE.	ARIVOLPHÉ.
Il faut que i’aye icy l’ame bien patiente.	Il faut que j'aie ici l'âme bien patientée.
ALAIN.	ALAIN.
Au moins c’eſt moy, Monſieur.	Au moins c'est moi, Monsieur.
C’eſt moy.	C'est moi.
GEORGETTE.	GEORGETTE.
Ie ſuis voſtre Seruante,	Je suis votre Servante,
Ie te.	Je te.
ALAIN.	ALAIN.
Sans le reſpect de Monſieur que voila,	Sans le respect de Monsieur que voilà,
ARNOLPHE receuant vn coup d’Alain, Peſte.	ARNOLPHÉ recevant un coup d'Alain, Peste.
ADIITS.	ADIITS.
Pardon.	Pardon.
ANNOLIHE.	ANNOLIHÉ.
Voyez ce lourdaut là.	Voyez ce lourdaud -là.
ALAIN.	ALAIN.
C’eſt elle auſſi, Monſieur.	C'est elle aussi, Monsieur.
ARNOLPHE.	ARNOLPHÉ.
Que tous deux on ſe taiſe.	Que tous deux on se taise.
Songez à me répondre, & laiſſons la fadaiſe.	Songez à me répondre, et laissons la fadaise.
Hé bien, Alaiſ, colment le porte-t on icy?	Hé bien, Alais, colment le porte-t on ici?
ALAIN.	ALAIN.
Monſieur, nous nous.	Monsieur, nous nous.
Monſieur, nous nous por.	Monsieur, nous nous por.
Dieu mercy;	Dieu merci;
Nous nous.	Nous nous.
Arnolphe oſte par trois fois le chapeau de deſſus la teſte d’Alain.	Arnolphe ôte par trois fois le chapeau de dessus la tête d'Alain.
ARNOLPHE.	ARNOLPHÉ.
Qui vous apprend, impertinente beſte, A parler deuant moy, le chapeau ſur la teſte?	Qui vous apprend, impertinente bête, À parler devant moi, le chapeau sur la tête?
ALAIN.	ALAIN.
Vous faites bien, i’ay tort.	Vous faites bien, j'ai tort.
ARNOLPHE à Alain.	ARNOLPHE à Alain.
ruites deſcendre Agnés.	ruites descendre Agnès.
à Geor.	à Geor.
Lors que ie m’en allay, fut-elle triſte aprés?	Lors que ici m'en allai, fut-elle triste après?
Triſte!	Triste!
Non.	Non.
GEORGETTE.	GEORGETTE.
ARNOLPHE.	ARNOLPHÉ.
Non !	Non !
GEORGETTE.	GEORGETTE.
ohait.	ohait.
GEORGETTE.	GEORGETTE.
Oüy, ie meure, une vous crojoit ronue ſetour a toute neure;	Oui, Seigneur meure, une vous crojait ronue setour a toute neure;
Et nous n’oyions iamais paſſer deuant chez nous, Eneual, Aine, ou Mauiet, qu'ene ne pine podr vous.	Et nous n'oyions jamais passer devant chez nous, Enval, Aine, ou Maujet, qu'ene ne pine odr vous.
CLASM126 AGNES, ALAIN, GEORGETTE, ARNOLPHE.	CLASM126 AGNES, ALAIN, GEORGETTE, ARNOLPHÉ.
ARNOLPHE.	ARNOLPHÉ.
A beſogne à la main, c’eſt vn bon témoignage.	À besogne à la main, c'est un bon témoignage.
LHé bien, Agnés, ie ſuis de retour du voyage, En eſtes-vous bien aiſe?	LHé bien, Agnès, je suis de retour du voyage, En êtes-vous bien aise?
AGNES.	AGNES.
Ouy, Monſieur, Dieu mercy.	Oui, Monsieur, Dieu merci.
ARNOLPHE.	ARNOLPHÉ.
Et moy de vous reuoir, ie ſuis bien aiſe auſſi:	Et moi de vous revoir, je suis bien aise aussi:
Vous vous eſtes toûjours, cõme onvoit, bien portée?	Vous vous êtes toujours, comme onvait, bien portée?
AGNES.	AGNES.
Hors les puces, qui m’ont la nuit inquietée.	Hors les puces, qui m'ont la nuit inquiétée.
ARNOLPHE.	ARNOLPHÉ.
Ah!	Ah!
vous aurez dans peu quelqu’vn pour les chaſſer.	vous aurez dans peu quelqu'vn pour les chasser.
AGNES, Vous me ferez plaiſir.	AGNES, Vous me ferez plaisir.
ARNOLPHE.	ARNOLPHÉ.
Ie le puis bien penſer.	Je le puis bien penser.
Que faites-vous donc là?	Que faites-vous donc là?
AGNES, Ie me fais des Cornettes, Vos Chemiſes de nuit, & vos Coiffes ſont faites.	AGNES, Je me fais des Cornettes, Vos Chemises de nuit, et vos Coiffes sont faites.
ARNOLPHE.	ARNOLPHÉ.
Ha!	Ha!
voila qui va bien;	voilà qui va bien;
allez, montez là-haut, Ne vous ennuyez point, ie reuiendray tantoſt, Et ie vous parleray d’affaires importantes.	allez, montez là-haut, Ne vous ennuyez point, tu reviendrai tantôt, Et quelque vous parlerai d'affaires importantes.
Tous eſtans rentrez.	Tous étants rentrez.
Heroïnes du temps, Meſdames les Sçauantes, Pouſſeuſes de tendreſſe & de beaux ſentimens, Ie défie à la fois tous ros Vers, vos Romans, Vos Lettres, Billets doux, toute voſtre Science, De valoir cette honneſte & pudique ignorance,	Héroïnes du temps, Mesdames les Savantes, Pousseuses de tendresse et de beaux sentiments, Je défie à la fois tous ros Vers, vos Romans, Vos Lettres, Billets doux, toute votre Science, De valoir cette honnête et pudique ignorance,
SCENE IV.	SCÈNE IV.
HORACE, ARNOLPHE.	HORACE, ARNOLPHÉE.
ARNOLPHE.	ARNOLPHÉ.
NE n’eſt point par le bien qu’il faut eſtre ébloüy;	NE n'est point par le bien qu'il faut être ébloui;
CEt pourueu que l’honneur ſoit.	CEt pourvu que l'honneur soit.
Que vois-je?	Que vois-je?
Eſt-ce?	Est-ce?
Oüy.	Oui.
Ie me trompe.	Je me trompe.
Nenny.	Nenni.
Sifait.	Sifait.
Non, c’eſt luy-méme.	Non, c'est autre-même.
Hor.	Hor.
HORACE.	HORACE.
Seigneur Ar.	Seigneur Ar.
ARNOLPHE.	ARNOLPHÉ.
Horace.	Horace.
HORACE.	HORACE.
Arnolphe.	Arnolphe.
ARNOLPHE.	ARNOLPHÉ.
Et depuis quand icy?	Et depuis quand ici?
Ah!	Ah!
joye extréme?	joie extrême?
HORACE.	HORACE.
Depuis neuf jours.	Depuis neuf jours.
ARNOLPHE.	ARNOLPHÉ.
Vrayment.	Vraiment.
HORACE.	HORACE.
Ie fus d’abord cnez vous, inlals Inutileihent.	Je fus d'abord cnez -vous, inlals Inutileihent.
ARNOLPHE.	ARNOLPHÉ.
I’eſtois à la campagne.	J'étais à la campagne.
HORACE.	HORACE.
Oüy, depuis deux journées,	Oui, depuis deux journées,
ARNOLPHE.	ARNOLPHÉ.
O comme les enfans croiſſent en peu d’années!	Ô comme les enfants croissent en peu d'années!
I’admire de le voir au poinct où le voila, Apres que le l’ay veu pas plus grand que cela.	J'admire de le voir au point où le voilà, Apres que le l'ai vu pas plus grand que cela.
Vous voyez.	Vous voyez.
HORACE.	HORACE.
ARNOLPHE.	ARNOLPHÉ.
Mais, de grace, Oronte voſtre Pere, Mon bon & cher Amy, que i’eſtime & reuere, Que fait-il?	Mais, de grâce, Oronte votre Père, Mon bon et cher Ami, que j'estime et révère, Que fait-il?
que dit-il?	que dit-il?
eſt-il toûjours gaillard:	est-il toujours gaillard:
A tout ce qui le touche, il ſçait que ie prens part.	À tout ce qui le touche, il sait que Dieu prends part.
Nous ne nous sõmes veus depuis quatre ans ensẽble,	Nous ne nous sommes vus depuis quatre ans ensemble.
HORACE.	HORACE.
Ny, qui plus eſt, écrit l’vn à l’autre, me ſemble.	Ni, qui plus est, écrit l'un à l'autre, me semble.
Il eſt, Seigneur Arnolphe, encor plus gay que nous, Et i’auois de ſa part vne Lettre pour vous;	Il est, Seigneur Arnolphe, encor plus gai que nous, Et j'avais de sa part une Lettre pour vous;
Mais depuis par vne autre il m’apprend ſa venuë, Et la raiſon encor ne m’en eſt pas connuë.	Mais depuis par une autre il m'apprend sa venue, Et la raison encor ne m'en est pas connue.
Sçauez-vous qui peut-eſtre vn de vos Citoyens, Qui retourne en ces lieux auec beaucoup de biens, Qu’il s’eſt en quatorze ans acquis dans l’Amerique?	Savez-vous qui peut-être un de vos Citoyens, Qui retourne en ces lieux avec beaucoup de biens, Qu'il s'est en quatorze ans acquis dans l'Amérique?
AANOETHE.	AANOTHÉE.
Non:	Non:
Vous a-t’on point dit cõme on le nomme?	Vous a-t-on point dit comme on le nomme?
HORACL.	HORACL.
Enrique.	Enrique.
Non.	Non.
ARNOLPHE.	ARNOLPHÉ.
al e le MeSs Mon Pere m’en parle, & qu’il eſt reuenu, Comme s’il deuoit m’eſtre entierement connu, Et m’écrit qu’en chemin enſemble ils ſe võt mettre, Pour vn fait important que ne dit point ſa Lettre,	al eu le MeSs Mon Père m'en parle, et qu'il est revenu, Comme s'il devait m'être entièrement connu, Et m'écrit qu'en chemin ensemble ils se vont mettre, Pour un fait important que ne dit point sa Lettre,
ARNOLPHE.	ARNOLPHÉ.
I'auray certainement grande joye à le voir, Et pour le regaler, ie feray mon pouuoir.	J'aurai certainement grande joie à le voir, Et pour le régaler, je ferai mon pouvoir.
Apres auoir leu la Lettre.	Apres avoir lu la Lettre.
Il faut, pour des Amis, des Lettres moins ciuiles, Et tous ces complimens ſont choſes inutiles;	Il faut, pour des Amis, des Lettres moins civiles, Et tous ces compliments sont choses inutiles;
Sans qu’il priſt le ſoucy de m’en écrire rien, Vous pouuez librement diiporer de mon bien.	Sans qu'il prît le souci de m'en écrire rien, Vous pépé librement diiporer de mon bien.
HORACE.	HORACE.
de fuis fiomme à ſaiſir les gens par leurs paroles, Et i’ay preſentement beſoin de cent piſtoles.	de fuis fiomme à saisir les gens par leurs paroles, Et j'ai présentement besoin de cent pistoles.
ARNOLPHE.	ARNOLPHÉ.
Ma foy, c’eſt m’obliger, que d’en vſer ainſi, Et ie me réjoüis de les auoir icy.	Ma foi, c'est m'obliger, que d'en user ainsi, Et personne me réjouis de les avoir ici.
daldez aumlabounle.	daldez aumlabounle.
HORACE.	HORACE.
Il faut.	Il faut.
ARNOLPHE.	ARNOLPHÉ.
Laiſſons ce ſtile.	Laissons ce style.
Hé bien, comment encor trouuez-vous cette Ville?	Hé bien, comment encor trouvez-vous cette Ville?
HORACE.	HORACE.
Nombreuſe en Citoyens, ſuperbe en baſtimens, Et i’en croy merueilleux les diuertiſſemens.	Nombreuse en Citoyens, superbe en bâtiments, Et j'en crois merveilleux les divertissements.
ARNOLPHE.	ARNOLPHÉ.
Chacun a ſes plaiſirs, qu’il ſe fait à ſa guiſe:	Chacun a ses plaisirs, qu'il se fait à sa guise:
Mais pour ceux que du nom de Galans on baptiſe, Ils ont en ce Païs dequoy ſe contenter, Car les Femmes y ſont faites à coquetter.	Mais pour ceux que du nom de Galants on baptise, Ils ont en ce Pays dequoy se contenter, Car les Femmes y sont faites à coqueter.
On trouue d’humeur douce & la brune, & la blonde, Et les Maris auſſi les plus benins du monde:	On trouve d'humeur douce et la brune, et la blonde, Et les Maris aussi les plus bénins du monde:
C’eſt vn plaiſir de Prince, & des tours que ie voy, Ie me donne ſouuent la Comedie à moy.	C'est un plaisir de Prince, et des tours que je vois, Je me donne souvent la Comédie à moi.
Peut-eſtre en auez-vous déja féru quelqu’vne:	Peut-être en avez-vous déjà féru quelqu'une:
Vous eſt-il point encor arriué de fortune?	Vous est-il point encore arrivé de fortune?
Les gens faits comme vous, font plus que les écus, Et vous eſtes de taille à faire des Cocus.	Les gens faits comme vous, font plus que les écus, Et vous êtes de taille à faire des Cocus.
HORACE, A ne vous rien cacher de la verité pure, I’ay d’amour en ces lieux eu certaine auanture, Et l’amitié m’oblige à vous en faire part.	HORACE, À ne vous rien cacher de la vérité pure, J'ai d'amour en ces lieux eu certaine aventure, Et l'amitié m'oblige à vous en faire part.
ARNOLPHE.	ARNOLPHÉ.
Bon, voicy de nouueau quelque conte gaillard, Et ce ſera dequoy mettre ſur mes tablettes.	Bon, voici de nouveau quelque conte gaillard, Et ce sera dequoy mettre sur mes tablettes.
TORACE, Mais, degrace, qu’aù moins ces choſes ſoiẽt ſecrettes.	TORACE, Mais, degrâce, qu'aù moins ces choses soient secrètes.
Oh.	Oh.
ARNOLPHE.	ARNOLPHÉ.
HORACE.	HORACE.
Vous n’ignorez pas qu’en ces occaſions Vn ſecret éuenté rompt nos pretentions.	Vous n'ignorez pas qu'en ces occasions Un secret éventé rompt nos prétentions.
Ie vous auoüeray donc auëc pleine franchiſe, Qu’icy d’vne Beauté mon ame s’eſt épriſe:	Je vous auoüeray donc auec pleine franchise, Qu'ici d'une Beauté mon âme s'est éprise:
Mes petits ſoins d’abord ont eu tant de ſuccés, Que ie me ſuis chez elle ouuert vn doux accés;	Mes petits soins d'abord ont eu tant de succès, Que ie me suis chez elle ouvert un doux accès;
Et ſans trop me vanter, ny luy faire vne injure, Mes affaires y ſont en fort bonne poſture.	Et sans trop me vanter, ni lui faire une injure, Mes affaires y sont en fort bonne posture.
Et c’eſt?	Et c'est?
ARNOLPHE riant.	ARNOLPHÉ riant.
HORACE luy montrant le logis d'Agnés- Vn jeune objet qui loge en ce logis, Dont vous voyez d’icy que les murs ſont rougis, Simple à la verité, par l’erreur ſans ſeconde D’vn Homme qui la cache au commerce du monde, Mais qui dans l’ignorance où l’on veut l’aſſeruir, Fait briller des attraits capables de rauir, Vn air tout engageant, ie ne ſçay quoy de tendre, Dont il n’eſt point de cœur qui ſe puiſſe defendre:	HORACE-même montrant le logis d'Agnès- On jeune objet qui loge en ce logis, Dont vous voyez d'ici que les murs sont rougis, Simple à la vérité, par l'erreur sans seconde D' Homme qui la cache au commerce du monde, Mais qui dans l'ignorance où l'on veut l'asservir, Fait briller des attraits capables de ravir, Un air tout engageant, tu ne sais quoi de tendre, Dont il n'est point de cœur qui se puisse défendre:
Mais, peut-eſtre, il n’eſt pas que vous n’ayez bienveu Ce jeune Aſtre d’amour de tant d’attraits pourueu:	Mais, peut-être, il n'est pas que vous n'ayez bienvu Ce jeune Astre d'amour de tant d'attraits pourvu:
C’eſt Agnés qu’on l’appelle.	C'est Agnès qu'on l'appelle.
ARNOLPHE à part, Ah!	ARNOLPHE à part, Ah!
ie creue.	Elle crève.
HORACE, Pour l’Homme.	HORACE, Pour l'Homme.
C’eſt, ie croy, de la Zouſſe, ou Souche, qu’on le nõme, Ie ne me ſuis pas fort arreſté ſur le nom;	C'est, Seigneur crois, de la Zousse, ou Source, qu'on le nomme, Je ne me suis pas fort arrêté sur le nom;
Riche, à ce qu’on m’a dit, mais des plus ſenſez, non.	Riche, à ce qu'on m'a dit, mais des plus sensés, non.
Et l’on m’en a parie comme d'mn fefdleule.	Et l'on m'en a parie comme d'mn fefleule.
Le connoiſſez-vous point?	Le connaissez-vous point?
ARNOLPHE à parcLa fâcheuſe pilule!	ARNOLPHÉ à parcLa fâcheuse pilule!
HORACE.	HORACE.
Eni vous ne uitee mor.	Eni vous ne uite mór.
ARNOL'PHE.	ARNOL'PHÉ.
Eh oüy, ie le connoy.	Eh oui, ie le connais.
HORACE, C’eſt vn fou, n’eſt-ce pas?	HORACE, C'est un fou, n'est-ce pas?
ARNOLPHE.	ARNOLPHÉ.
Eh.	Eh.
HORACE.	HORACE.
Qu’en dites-vous?	Qu'en dites-vous?
quoy?	quoi?
Eh?	Eh?
c’eſt à dire oüy.	c'est -à -dire oui.
Ialoux?	Jaloux?
à faire rire.	à faire rire.
Sot?	Sot?
ie voy qu’il en eſt ce que l'on m’a pû dire.	Ce vois qu'il en est ce que l'on m'a pu dire.
Enfin l’aimable Agnés a ſceu m’aſſujettir, C’eſt vn joly bijou, pour ne vous point mentir, Et ce ſeroit peché, qu’vne Beauté ſi rare Fut laiſſée au pouuoir de cet Homme bizarre.	Enfin l'aimable Agnès a su m'assujettir. C'est un joli bijou, pour ne vous point mentir, Et ce serait péché, qu'une Beauté si rare Fut laissée au pouvoir de cet Homme bizarre.
Pour moy, tous mes efforts, to9 mes vœux lespl9 doux, Vont à m’en rendre maiſtre, en dépit du jaloux;	Pour moi, tous mes efforts, tous mes vœux lespl9 doux, Vont à m'en rendre maître, en dépit du jaloux;
Et l’argent que de vous i’emprunte auec franchiſe, N’eſt que pour mettre à bout cette juſte entrepriſe.	Et l'argent que de vous j'emprunte avec franchise, N'est que pour mettre à bout cette juste entreprise.
Voꝰ ſçauez mieuxque moi quelsqueſoiẽt nos efforts, Que l’argent eſt la clef de tous les grands reſſorts, Et que ce doux metal qui frape tant de teſtes, En amour, comme en guerre, auance les conqueſtes.	Vojestez mieuxque moi quelsquesaient nos efforts, Que l'argent est la clef de tous les grands ressorts, Et que ce doux métal qui frappe tant de têtes, En amour, comme en guerre, avance les conquêtes.
Vous me ſemblez chagrin;	Vous me semblez chagrin;
ſeroit-ce qu’en effet Vous delaprouderiez le deſſein que i’ay fait?	serait-ce qu'en effet Vous délaprouderiez le dessein que j'ai fait?
ARNOLPHE.	ARNOLPHÉ.
Non, c’eſt que ie ſongeois.	Non, c'est que ie mongeais.
HORACE.	HORACE.
Cet entretien vous laſſe;	Cet entretien vous lasse;
Adieu, i’iray chez vous tantoſt vous rendre grace.	Adieu, j'irai chez vous tantôt vous rendre grâce.
Ah!	Ah!
faut-il.	faut-il.
ARNOLPHE.	ARNOLPHÉ.
HORACE reuenant- Derechef, veüillez eſtre diſcret, Et n’allez pas, de grace, éuenter mon ſecret.	HORACE revenant- Derechef, veuillez être grâce, Et n'allez pas, de grâce, éventer mon secret.
ARNOLPHE.	ARNOLPHÉ.
Que ie ſens dans mon ame.	Que ie sens dans mon âme.
HORACE reuenantEt ſur tout à mon Pere, Qui s’en feroit peut-eſtre vn ſujet de colere.	HORACE revenantEt sur tout à mon Père, Qui s'en ferait peut-être un sujet de colère.
ARNOLPHE croyant qu’il reuient encore, Oh.	ARNOLPHÉ croyant qu'il revient encore, Oh.
Oh que i’ay ſouffert durant cet entretien!	Oh que j'ai souffert durant cet entretien!
Iamais trouble d’eſprit ne fut égal au mien.	Jamais trouble d'esprit ne fut égal au mien.
Auec quelle imprudence, & quelle haſte extréme, Il m’eſt venu conter cette affaire à moy-méme!	Avec quelle imprudence, et quelle hâte extrême, Il m'est venu conter cette affaire à moi-même!
Bien que mon autre nom le tienne dans l’erreur, Etourdy, montra-t’il iamais tant de fureur?	Bien que mon autre nom le tienne dans l'erreur, Éourdi, montra-t-il jamais tant de fureur?
Mais ayant tant ſouffert, ie deuois me contraindre, Iuſques à m’éclaircir de ce que ie dois craindre, A pouſſer juſqu’au bout ſon caquet indiſcret, Et ſçauoir pleinement leur commerce ſecret.	Mais ayant tant souffert, je devais me contraindre, Jusques à m'éclaircir de ce que ie dois craindre, A pousser jusqu'au bout son caquet indiscret, Et savoir pleinement leur commerce secret.
Tâchons à le rejoindre, il n’eſt pas loin ie penſe, Tirons-en de ce fait l’entiere confidence;	Tâchons à le rejoindre, il n'est pas loinie pense, Tirons-en de ce fait l'entière confidence;
Ie tremble du malheur qui m’en peut arriuer, Et l’on cherche ſouuent plus qu’on ne veut trouuer,	Je tremble du malheur qui m'en peut arriver, Et l'on cherche souvent plus qu'on ne veut trouver,
Fin du Premier Acte.	Fin du Premier Acte.
ACTE II.	ACTE II.
SCENE TREMIERE,	SCÈNE TREMIERE,
ARNOLPHE.	ARNOLPHÉ.
L m’eſt, lors que i’y penſe, auantageux ſans doute, D’auoir perdu mes pas, & pû manquer ſa route:	 L'est, lors que j'y pense, avantageux sans doute, D'avoir perdu mes pas, et pu manquer sa route:
P Car enfin, de mon cœur le trouble imperieux N’euſt pû ſe renfermer tout entier à ſes yeux, Il euſt fait éclater l’ennuy qui me deuore, Et ie ne voudrois pas qu’il ſceût ce qu’il ignore.	P Car enfin, de mon cœur le trouble impérieux N'eût pu se renfermer tout entier à ses yeux, Il eût fait éclater l'ennui qui me dévore, Et quelque ne voudrais pas qu'il sût ce qu'il ignore.
Mais ie ne ſuis pas Homme à gober le morceauEt laiſſer vn champ libre aux vœux du Damoiſeau, I’en veux rompre le cours, & ſans tarder, apprendre Iuſqu’où l'intelligence entr’eux a pû s’étendre:	Mais petit ne suis pas Homme à gober le morceaut laisser un champ libre aux vœux du Damoiseau, J'en veux rompre le cours, et sans tarder, apprendre Jusqu'où l'intelligence entr'eux a pu s'étendre:
I’y prens, pour mon honneur, vn notable intereſt, Ie la regarde en Femme, aux termes qu’elle en eſt, Elle n’a pû faillir, ſans me couurir de honte, Et tout ce qu’elle a fait, enfin eſt ſur mon compte.	J'y prends, pour mon honneur, un notable intérêt; Je la regarde en Femme, aux termes qu'elle en est, Elle n'a pu faillir, sans me couvrir de honte, Et tout ce qu'elle a fait, enfin est sur mon compte.
Eloignement fatal!	Éloignement fatal!
Voyage malheureux!	Voyage malheureux!
Frapant à Ia porte.	Frappant à Ia porte.
SCENE II.	SCÈNE II.
ALAIN, GEORGETTE, ARNOLPHE.	ALAIN, GEORGETTE, ARNOLPHÉ.
ARNOLPHE.	ARNOLPHÉ.
Paix.	Paix.
Venez-çà tous deux:	Venez-çà tous deux:
Palſez-là, paſſez-là.	Palsez-là, passez-là.
Venez-là, venez dis-je.	Venez-là, venez dis-je.
GEORGETTEAh!	GERGETTTEAh!
vous me tantes peurs de tout mon fang ſe fige.	vous me tantes peurs de tout mon sang se fige.
ARNOLPHE.	ARNOLPHÉ.
c elt done ain, qu’ablent, vous m’auez obey, Et tous deux, de concert, vous m’auez donc trahy?	ç donc done ain, qu'ablent, vous m'avez obéi, Et tous deux, de concert, vous m'avez donc trahi?
GEORGETTE.	GEORGETTE.
Eh ne me mangez pas, Monſieur, ie vous conjure.	Eh ne me mangez pas, Monsieur, on vous conjure.
ALAIN à part.	ALAIN à part.
Quelque Chien enragé l’a mordu, ie m’aſſeure.	Quelque Chien enragé l'a mordu, Elle m'assure.
ARNOLPHE.	ARNOLPHÉ.
Ouf.	Ouf.
Ie ne puis parler, tant ie ſuis préuenu, Ie ſuffoque, & voudrois me pouuoir mettre nû.	Je ne puis parler, tant grands suis prévenu, Je suffoque, et voudrais me pouvoir mettre nu.
Vous auez donc ſouffert, ô canaille maudite, Qu’vn Hõme ſoit venu.	Vous avez donc souffert, ô canaille maudite, Qu'un Homme soit venu.
Tu veux prendre la fuite?	Tu veux prendre la fuite?
Il faut que ſur le champ.	Il faut que sur -le -champ.
Si tu bouges.	Si tu bouges.
Ie veux Que vous me diſiez.	Je veux Que vous me disiez.
Euh?	Euh?
Oüy, ie veuxque to9 deux.	Oui, Seigneur veuxque tous deux.
22 Quiconque remûra, par la mort, ie l’aſſomme.	22 Quiconque remura, par la mort, Elle l'assomme.
Cõme eſt-ceque chez moy s’eſt introduit cet Hõme?	Comme est-ceque chez moi s'est introduit cet Homme?
Eh?	Eh?
parlez, dépeſchez, viſte, promptement, toſt, Sans reſver, veut-on dire	parlez, dépêchez, vite, promptement, tôt, Sans rêver, veut-on dire
ALAIN & GEORGETTE.	ALAIN et GEORGETTE.
Ahi, an.	Ahi, an.
GEORGETTE.	GEORGETTE.
Le cœur me faut.	Le cœur me faut.
ALAIN.	ALAIN.
ARNOLPHE.	ARNOLPHÉ.
Ie ſuis en eau, prenons vn peu d’haleine, Il faut que ie m’éuente, & que ie me promeine.	Je suis en eau, prenons un peu d'haleine, Il faut que ie j'évente, et que Ne me promène.
Aurois-je deuiné, quand ie l'ay veu petit, Qu’il croiſtroit pour cela?	Aurais-je deviné, quand ici l'ai vu petit, Qu'il croîtrait pour cela?
Ciel!	Ciel!
que mõ cœur pâtit!	que mon cœur pâtit!
Ie penſe qu’il vaut mieux que de ſa propre bouche Ie tire auec douceur l’affaire qui me touche:	Je pense qu'il vaut mieux que de sa propre bouche Je tire avec douceur l'affaire qui me touche:
Tâchons à moderer noſtre reſſentiment.	Tâchons à modérer notre ressentiment.
Patience, mon cœur, doucement, doucement, Leuez-vous, & rentrant, faites qu’Agnés deſcende.	Patience, mon cœur, doucement, doucement. Levez-vous, et rentrant, faites qu'Agnès descende.
Arreſtez.	Arrêtez.
Sa ſurpriſe en deuiendroit moins grande, Du chagrin qui me trouble, ils iroient l’auertir;	Sa surprise en deviendrait moins grande, Du chagrin qui me trouble, ils iraient l'avertir;
Et moy-méme ie veux l’aller faire ſortir.	Et moi-même ici veux l'aller faire sortir.
Que l’on m’attende icy.	Que l'on m'attende ici.
SCENE III.	SCÈNE III.
ALAIN, GEORGETTE.	ALAIN, GEORGETTE.
GEORGETTE.	GEORGETTE.
Monduus qu'il eſt terrible!	Monduus qu'il est terrible!
Ses regards m’ont fait peur, mais vne peur horrible, Et iamais le ne vis vn plus hideux Chreſtien.	Ses regards m'ont fait peur, mais ainsi peur horrible, Et jamais le ne vis un plus hideux Chrétien.
ALAIN.	ALAIN.
Ce Monſieur l’a fâché, ie te le diſois bien.	Ce Monsieur l'a fâché, Seigneur te le disais bien.
GEORGETTE.	GEORGETTE.
Mais que diantre eſt-ce là, qu’auec tant de rudeſſe Ii nous fait au logis garder noſtre Maiſtreſſe?	Mais que diantre est-ce là, qu'avec tant de rudesse Ji nous fait au logis garder notre Maîtresse?
D’où vient qu’à tout le monde ii veut tant la cacher, Et qu’il ne ſçauroit voir perſonne en approcher?	D'où vient qu'à tout le monde ji veut tant la cacher, Et qu'il ne saurait voir personne en approcher?
ALAIN.	ALAIN.
C’eſt que cette action le met en jalouſie.	C'est que cette action le met en jalousie.
TEORGETTE.	TERGETTTE.
Mais d’où vient qu’il eſt pris de cette fantaiſie?	Mais d'où vient qu'il est pris de cette fantaisie?
ALAIN.	ALAIN.
Cela vient.	Cela vient.
Cela vient, de ce qu’il eſt jaloux.	Cela vient, de ce qu'il est jaloux.
GEORGETTE.	GEORGETTE.
Oüy:	Oui:
mais pourquoy l’eſt-il?	mais pourquoi l'est-il?
& pourquoy ce couroux?	et pourquoi ce courroux?
ALAIN.	ALAIN.
C’eſt que la jalouſie.	C'est que la jalousie.
Entens-tu bien, Georgette.	Entends-tu bien, Georgette.
Eſt vne choſe.	Est une chose.
la.	la.
qui fait qu’on s’inquiete.	qui fait qu'on s'inquiète.
Et qui chaſſe les gens d’autour d’vne maiſon.	Et qui chasse les gens d'autour d'une maison.
Ie m’en vais te bailler vne comparaiſon, Afin de conceuoir la choſe dauantage.	Je m'en vais te bailler une comparaison, Afin de concevoir la chose davantage.
Dis-moy, n’eſt-il pas vray, quãd tu tiens ton potage, Que ſi quelque affamé venoit pour en manger, Tu ſerois en colere, & voudrois le charger?	Dis-moi, n'est-il pas vrai, quand tu tiens ton potage, Que si quelque affamé venait pour en manger, Tu serais en colère, et voudrais le charger?
GEOROETTE.	GEROTTTE.
Oüy, ie comprens cela.	Oui, Seigneur comprends cela.
ALAIN.	ALAIN.
C’eſt juſtement tout comme.	C'est justement tout comme.
La Femme eſt en effet le potage de l’Homme;	La Femme est en effet le potage de l'Homme;
Et quand vn Homme voit d’autres Hõmes par fois, Qui veulent dans ſa ſoupe aller tremper leurs doigts, Il en montre auſſi-toſt vne colere extréme.	Et quand un Homme voit d'autres Hommes par fois, Qui veulent dans sa soupe aller tremper leurs doigts, Il en montre aussitôt une colère extrême.
GEORGETTE.	GEORGETTE.
Ouy.	Oui.
Ihais pourquoychacun n'e fait-ir pas de méme?	Ihais pourquoichacun n'e fait-ir pas de même?
Et que nous en voyons qui paroiſſent joyeux, Lors que leurs Femmes ſont auec les biaux Monſieux?	Et que nous en voyons qui paraissent joyeux, Lors que leurs Femmes sont avec les beaux Monsieurs?
ALAIN.	ALAIN.
C’eſt que chacun n’a pas cette amitié gouluë, Qui n’en veut que pour ſoy.	C'est que chacun n'a pas cette amitié goulue, Qui n'en veut que pour soi.
GEORGETTE.	GEORGETTE.
Ie le voy qui reuient.	Je le vois qui revient.
Si ie n’ay la berluë,	Si ici n'ai la berlue,
ALAIN.	ALAIN.
Tes yeux ſont bons, c’eſt luy.	Tes yeux sont bons, c'est lui.
GEORGETTE.	GEORGETTE.
Voy comme il eſt chagrin.	Vois comme il est chagrin.
ALAIN.	ALAIN.
C’eſt qu’il a de l’ennuy.	C'est qu'il a de l'ennui.
SCENE IV.	SCÈNE IV.
ARNOLPHE, AGNES, ALAIN, GEORGETTE.	ARNOLPHÉ, AGNES, ALAIN, GEORGETTE.
ARNOLPHE.	ARNOLPHÉ.
TN certain Grec, diſoit à l’Empereur Auguſte, V Comme vne inſtruction vtile, autant que iuſte, Que lors qu’vne auanture en colere nous met, Nous deuons auant tout;	TN certain Grec, disait à l'Empereur Auguste, V Comme une instruction vtyle, autant que juste, Que lors qu'une aventure en colère nous met, Nous devons avant tout;
dire noſtre Alphabet.	dire notre Alphabet.
Afin que dans ce temps la bile ſe tempere, Et qu’on ne faſſe rien que l'on ne doiue faire.	Afin que dans ce temps la bile se tempère, Et qu'on ne fasse rien que l'on ne doive faire.
I’ay ſuiui ſa leçon ſur le ſujet d’Agnés;	J'ai suivi sa leçon sur le sujet d'Agnès;
Et ie la fais venir dans ce lieu tout exprés, 1 Sous pretexte d’y faire vn tour de promenade;	Et ici la fais venir dans ce lieu tout exprès, 1 Sous prétexte d'y faire un tour de promenade;
Aun que les ſoupçons de mon eſprit malade Aument rul le uncours la mettre adroſtement:	Aun que les soupçons de mon esprit malade Aument rul le cours la mettre adrostement:
Et luy ſondant le cœur s’éclaircir doucement.	Et nos sondant le cœur s'éclaircir doucement.
Venez, Agnés.	Venez, Agnès.
Rentrez.	Rentrez.
2	2
Fort belle.	Fort belle.
ATIT	ATIT
ARNOLPHE.	ARNOLPHÉ.
de beau four	de beau four
AGNES.	AGNES.
IA MC(OUI 8 Fort beau!	JA MCOUI 8 Fort beau!
ARNOLPHE.	ARNOLPHÉ.
Quelle nouuelle?	Quelle nouvelle?
AGNES.	AGNES.
Ie petit chat eſt mort.	Je petit chat est mort.
HROMEM ARNOLPHE.	HROMEM ARNOLPHÉE.
AmSI PN I AIMN 44 C’eſt dommage:	AmSI PN I IMN 44 C'est dommage:
mais quoy Nous ſommes tous mortels, & chacun eſt pour ſoy Lors que i’eſtois aux champs n’a-t’il point fait de pluyedo inmus obmncladrads no auov id	mais quoi Nous sommes tous mortels, et chacun est pour soi Lors que j'étais aux champs n'a-t-il point fait de pludo inmus obmncladrads nô auov id
AGNES.	AGNES.
Non.	Non.
ARNOLPHE.	ARNOLPHÉ.
Vous ennuyoit-il?	Vous ennuyait-il?
AGNES.	AGNES.
9 Iamais ie ne m’ennuye.	9 Jamais Seigneur ne m'ennuie.
ARNOLPHE.	ARNOLPHÉ.
&u auez-vous fait encorces neur ou dia lours-ci?	etu avez-vous fait encorces neur ou dia lours-cy?
AGNES.	AGNES.
01I Six chemiſes, ie penſe, & ſix coiffes auſſi.	U01I Six chemises, Seigneur pense, et six coiffes aussi.
ARNOLPHE ayant un peu reſué, Le monde, chere Agnes, eſt vne eſtrange choſe.	ARNOLPHÉ ayant un peu rêvé, Le monde, chère Agnès, est une étrange chose.
Voyez la médiſance, & comme chacun cauſe.	Voyez la médisance, et comme chacun cause.
Quelques voiſins m’ont dit:	Quelques voisins m'ont dit:
qu’vn ieune homme inconnu, Eſtoit en mon abſence à la maiſon venu;	qu'un jeune homme inconnu, Était en mon absence à la maison venu;
Que vous auiez foufert la veue & les harangues.	Que vous aviez souffert la vue et les harangues.
Mais ie n’ay point pris foy ſur ces méchantes lanẽs!	Mais ici n'ai point pris foi sur ces méchantes lanêts!
51 sugnmmoro ed ruconuoanrd aub.	51 sugnmmoro ed ruconvoanrd aub.
ime Et i’ay voulu gager que c’eſtoit fauſſement.	ime Et j'ai voulu gager que c'était faussement.
AGNES.	AGNES.
Mon Dieu, ne gagez pas, vous perdriez vrayment.	Mon Dieu, ne gagez pas, vous perdriez vraiment.
ANNOLIAE.	ANNOLIAE.
Quoy!	Quoi!
c’eſt la verité qu’vn homme,.	c'est la vérité qu'un homme,.
AGNES.	AGNES.
Choſe ſeure.	Chose sûre.
Il n’a preſque bougé de chez nous, ie vous iure.	Il n'a presque bougé de chez nous, je vous jure.
ARNOLPHE à part.	ARNOLPHE à part.
Cet adueu qu’elle fait auec ſincerité, Me marque pour le moms lon igenuite.	Cet aveu qu'elle fait avec sincérité, Me marque pour le moments lon igenvuite.
2 Mais il me ſemble, Agnés, ſi ma memoire eſt bonne, Que i’auois derendu que vous viſſiez perſonne.	2 Mais il me semble, Agnès, si ma mémoire est bonne, Que j'avais derendu que vous vissiez personne.
MD AGNES.	MD AGNES.
MM Oüy:	MM Oui:
mais quand ie l’ay veu, vous ignorez pourquoy, Et vous en auriez fait, ſans doute, autant que moy.	mais quand ici l'ai vu, vous ignorez pourquoi, Et vous en auriez fait, sans doute, autant que moi.
tl la n oslisa Peut-eſtre:	tl la n oslà Peut-être:
mais enfin, contez-moy cette Hiſtoire.	mais enfin, contez-moi cette Histoire.
AGNES.	AGNES.
Elle eſt fort eſtonnante & difficile à croire.	Elle est fort étonnante et difficile à croire.
I’eſtois ſur le Balcon à trauailler au frais:	J'étais sur le Balcon à travailler au frais:
Lors que ie vis paſſer ſous les arbres d’auprés Vn ieune homme bien fait, qui rẽcontrant ma veuë, D’vne humble reuerence auſſi-toſt me ſaluë.	Lors que ici vis passer sous les arbres d'auprès Un jeune homme bien fait, qui rẽcontrant ma vue, D'une humble révérence aussitôt me saluë.
Moy, pour ne point manquer à la ciuilité, Ie fis la reuerence auſſi de mon coſté.	Moi, pour ne point manquer à la civilité, Je fis la révérence aussi de mon côté.
Soudain, il me refait vne autre reuerence.	Soudain, il me refait une autre révérence.
Moy, i’en refais de meſme vne autre en diligence;	Moi, j'en refais de même un autre en diligence;
Et luy d’vne troiſieſme auſſi-toſt repartant, D'vne troiſieſme auſſi i’y repars à l’inſtant.	Et Elle d'une troisième aussitôt repartant, D'une troisième a j'y repars à l'instant.
Il paſſe, vient, repaſſe, & touſiours de plus belle Me fait à chaque fois reuerence nouuelle.	Il passe, vient, repasse, et toujours de plus belle Me fait à chaque fois révérence nouvelle.
Et moy, qui tous ces tours fixement regardois.	Et moi, qui tous ces tours fixement regardais,
, Nouuelle reuerence auſſi ie luy rendois.	, Nouuelle révérence aussi ieclamp rendais.
Tant, que ſi ſur ce point la nuit ne fut venuë, Toûjours comme cela ie me ſerois tenuë.	Tant, que si sur ce point la nuit ne fut venue, Toujours comme cela ie me serais tenue.
Ne voulant point ceder & receuoir l’ennuy, Qu’il me puſt eſtimer moins ciuile que luy.	Ne voulant point céder et recevoir l'ennui, Qu'il me pût estimer moins ciuile que mille.
1 2	1 2
ARNOLPHE.	ARNOLPHÉ.
Fort bien.	Fort bien.
1a dun m ivn M BAgo	1a dun m ici M AGo
1107 AGNES.	1107 AGNES.
Le lendemain eſtant ſur noſtre porte, Vne vieille m’aborde en parlant de la ſorte.	Le lendemain étant sur notre porte, Une vieille m'aborde en parlant de la sorte.
Mon enfant, le bon-Dieu puiſſe-t’il vous benir, Et dans tous vos attraits long-tẽps vous maintenir.	Mon enfant, le bon-Dieu puisse-t-il vous bénir, Et dans tous vos attraits longtemps vous maintenir.
28 Il ne vous a pas faite vne belle perſonne;	28 Il ne vous a pas faite une belle personne,
Afin de mal-vſer des choſes qu’il vous donne.	Afin de mal-vser des choses qu'il vous donne.
Et vous deuez ſçauoir que vous auez bleſſé Vn cœur, qui de s’en plaindre eſt auiourd’huy forcé	Et vous devez savoir que vous avez blessé Un cœur, qui de s'en plaindre est aujourd'hui forcé
ARNOLPHE à part.	ARNOLPHE à part.
Ah ſupoſt de Sathan, execrable damnée.	Ah suppôt de Satan, exécrable damnée.
AGNES.	AGNES.
.	.
4 (4t.	4 (4t.
̀ L.	§ L.
ſG2N4 Moy, i’ay bleſſé quelqu’vn?	sG2N4 Moi, j'ai blessé quelqu'un?
fis-je toute eſtonnée, Oüy, dit-elle, bleſſé, mais bleſſé tout de bon;	fis-je toute étonnée, Oui, dit-elle, blessé, mais blessé tout de bon;
Et c’eſt l’homme qu’hier vous viſtes du Balcon.	Et c'est l'homme qu'hier vous vîtes du Balcon.
Helas!	Hélas!
qui pourtoit, dis-je, en auoir eſté caule?	qui pourrait, dis-je, en avoir été caule?
Sur luy ſans y penſer, fis-je choir quelque choſe?	Suriblé sans y penser, fis-je choir quelque chose?
Non, dit-elle, vos yeux ont fait ce coup fatal, Et c’eſt de leurs regards qu’eſt venu tout ſon mal.	Non, dit-elle, vos yeux ont fait ce coup fatal, Et c'est de leurs regards qu'est venu tout son mal.
Hé, mon Dieu!	Hé, mon Dieu!
ma ſurpriſe eſt, fis-je, ſans ſecbnde.	ma surprise est, fis-je, sans second.
Mes yeux ont-ils du mal pour en donner au monde?	Mes yeux ont-ils du mal pour en donner au monde?
Oüy, fit-elle, vos yeux, pour cauſer le trépas Ma fille, ont vn venin que vous ne ſçauez pas.	Oui, fit-elle, vos yeux, pour causer le trépas Ma fille, ont un venin que vous ne savez pas.
En vn mot, il languit le pauure miſerable.	En un mot, il languit le pauvre misérable.
Et s’il faut, pourſuiuit la vieille charitable, Que voſtre cruauté luy refuſe vn ſecours, 9 C’eſt vn homme à porter en terre dans deux iours.	Et s'il faut, poursuivit la vieille charitable, Que votre cruauté lui refuse un secours, 9 C'est un homme à porter en terre dans deux jours.
Mon Dieu!	Mon Dieu!
i’en aurois, dy-je, vne douleur bien grãde.	j'en aurais, dis-je, une douleur bien grande.
Mais pour le ſecourir, qu’eſt-ce qu’il me demande?	Mais pour le secourir, qu'est-ce qu'il me demande?
Mon enfant, me dit-elle, il ne veut obtenir, Que le bien de vous von de rous entretenir.	Mon enfant, me dit-elle, il ne veut obtenir, Que le bien de vous von de rous entretenir.
Vos yeux peuuent eux ſeuls empeſcher ſa ruine, Et du mal qu’ils ont fait eſtre la medecine.	Vos yeux peuvent eux seuls empêcher sa ruine, Et du mal qu'ils ont fait être la médecine.
Helas!	Hélas!
volontiers, dis-je, & puis qu’il eſt ainſi, Il peut tant qu’il voudra me venir voir icy.	volontiers, dis-je, et puis qu'il est ainsi, Il peut tant qu'il voudra me venir voir ici.
ARNOLPHE à part.	ARNOLPHE à part.
Ah ſorciere maudite, empoiſonneuſe d’ames, Puiſſe l’Enfer payer tes charitables trames.	Ah sorcière maudite, empoisonneuse d'âmes, Puisse l'Enfer payer tes charitables trames.
AGNES.	AGNES.
Voila comme il me vit & receut gueriſon.	Voilà comme il me vit et reçut guérison.
2411 Vous-meſme, à voſtre aduis, n’ay-je pas eu raiſon?	2411 Vous-même, à votre avis, n'ai-je pas eu raison?
Et pouuois-je apres tout auoir la conſcience De le laiſſer mourir faute d’vne aſſiſtance?	Et pouvais-je après tout avoir la conscience De le laisser mourir faute d'une assistance?
4 1V mey qui compatis taiit aun gens qu’on fait ſouffrir, Et ne puis ſans pleurer voir vn poulet mourif.	4 1U mei qui compatis taiit aun gens qu'on fait souffrir, Et ne puis sans pleurer voir un poulet mourif.
ARNOLPHE bas.	ARNOLPHE bas.
Tout cela n’eſt party que d’vne ame innocente;	Tout cela n'est parti que d'une âme innocente;
Et i’en dois accuſer mon abſence imprudente, Qui ſans guide a laiſſé cette bonté de mœurs Eiporée aux aguets des ruſez ſeducteurs.	Et j'en dois accuser mon absence imprudente, Qui sans guide a laissé cette bonté de mœurs Eiporée aux aguets des rusés séducteurs.
Ie crains que le pendart, dans ſes vœux temeraires, Vn peu plus fort que jeu n’ait pouſſé les affaires.	Je crains que le pendard, dans ses vœux téméraires, Un peu plus fort que jeu n'ait poussé les affaires.
AUNES.	AUNES.
Qu’auez-vous?	Qu'avez-vous?
vous grondez, ce me ſemble, vn petit.	vous grondez, ce me semble, un petit.
Eſt-ce que c’eſt mal fait ce que ie vous ay dit?	Est-ce que c'est mal fait ce que je vous ai dit?
ARNOLPHE.	ARNOLPHÉ.
Non.	Non.
Mais de cette veuë apprenez-moy les ſuites, Et comme le ieune homme a paſſé ſes viſites.	Mais de cette vue apprenez-moi les suites, Et comme le jeune homme a passé ses visites.
AGNES.	AGNES.
Helas!	Hélas!
ſi vous ſçauiez, comme il eſtoit rauy.	si vous savez, comme il était ravi.
Comme il perdit ſon mal, ſi toſt que ie le vy;	Comme il perdit son mal, si tôt que ie le vis;
Le preſent qu’il m’a fait d’vne belle caſſette, Et l’argent qu’en ont eu noſtre Alain & Georgette.	Le présent qu'il m'a fait d'une belle cassette, Et l'argent qu'en ont eu notre Alain et Georgette.
Vous l’aymeriez ſans doute, & diriez comme nous.	Vous l'aimeriez sans doute, et diriez comme nous.
ARNOLPHE.	ARNOLPHÉ.
Oüy;	Oui;
mais que faiſoit-il eſtant ſeul auec vous?	mais que faisait-il étant seul avec vous?
AGNES.	AGNES.
Il iuroit, qu’il m’aimoit d’vne amour ſans ſeconde:	Il jurait, qu'il m'aimait d'une amour sans seconde:
Et me diſoit des mots les plus gentils du monde:	Et me disait des mots les plus gentils du monde:
Des choſes que iamais rien ne peut égaler.	Des choses que jamais rien ne peut égaler;
Et dont, toutes les fois que ie l’entends parler, B iij 2 La douceur me chatoüille, & là dedans remuë certan ie ne Içay quoy, dont ie luis toute émeuë	Et dont, toutes les fois que ie l'entends parler, B ij 2 à douceur me chatouille, et là -dedans remue certan ie ne Içai quoi, dont notre luis toute émue
ARNOLPHE à part.	ARNOLPHE à part.
O fâcheux examen d’vn myſtere fatal, à Agné, Où l’examinateur ſouffre ſeul tout le mal!	Ô fâcheux examen d'une mystère fatal, à Agné, Où l'examinateur souffre seul tout le mal!
2 Outre tous ces diſcours, toutes ces gentilleſſes, Ne vous faiſoit-il point auſſi quelques careſſes?	2 Outre tous ces discours, toutes ces gentillesses, Ne vous faisait-il point aussi quelques caresses?
AGNES.	AGNES.
Ontant;	Ontant;
il mie prenoſt & les mains & les bras, Et de me les baiſer il n’eſtoit iamais las.	il mie prenost et les mains et les bras, Et de me les baiser il n'était jamais las.
ARNOLPHE.	ARNOLPHÉ.
la voyãt Ne vous a-t-il point pris, Agnés, quelqu’autre choſe interdit Ouf.	la voyant Ne vous a-t-il point pris, Agnès, quelque autre chose interdit Ouf.
im tuuantla	im tuuantla
AGNES.	AGNES.
Hé, il m’a.	Hé, il m'a.
ARNOLPHE.	ARNOLPHÉ.
AGNES.	AGNES.
A.	A.
a.	a.
iveIRE ON X Pris.	iveIRE ON X Pris.
de a Aυqι	de a Aυqι
nArſenvo DhiL.	nArsenvo DhiL.
nomui duoir l Euh !	nom duoir l Euh !
AGNES.	AGNES.
MTOUMHA L oiud amisuaLe.	MTOUMHA L ois amisuaLène.
ARNOLPHE.	ARNOLPHÉ.
Plaiſt-il?	Plaît-il?
OXT AGNES.	OXT AGNES.
Ie n’oſe, Et vous vous laicilerez peut-eſtre contre moy.	Je n'ose, Et vous vous laicilerez peut-être contre moi.
ARNOLPHE.	ARNOLPHÉ.
Non.	Non.
m	m
AGNES.	AGNES.
DOL IR Si fait.	DOL IR Si fait.
ARNOLPHE.	ARNOLPHÉ.
Mon-dieul non.	Mon-dieul non.
ELSAGNES.	ELSAGNES.
MID BObEI  Iurez donc voſtre foy.	MID BObEI Jurez donc votre foi.
ARNOLPHE.	ARNOLPHÉ.
Ma foy, ſoit.	Ma foi, soit.
do	do
AGGNNES.	AGGNES.
EISLVIIOAAgAT  Il m’a pris.	EISLVIIOAgAT Il m'a pris.
vous ſerez en colere;	vous serez en colère;
Non.	Non.
ARNOLPHE, M7 A1	ARNOLPHÉ, M7 A1
Si.	Si.
EMGHELIA A CI LT LLIJ	ÉMGHÉLIA À CY LT LLIJ
ARNOLPHE.	ARNOLPHÉ.
Non, non, non, non!	Non, non, non, non!
Diantret que de myſterel Qu’eſt-ce qu’il vour apii	Diantre que de mystèrel Qu'est-ce qu'il vour api
AGNES.	AGNES.
T.	T.
ARNOLPHE à part.	ARNOLPHE à part.
Ie ſouffre en damné.	Je souffre en damné.
AGNES.	AGNES.
Il m’a pris le ruban que vous m’auiez donné.	Il m'a pris le ruban que vous m'aviez donné.
a vous dile le vrajyle May punien denendre.	à vous dile le vrajile Ma junien denendre.
ARNOLPHE reprenant haleins.	ARNOLPHE reprenant haleins.
Pane pour le ruban.	Pane pour le ruban.
Mais ie voülois apprendre, S’il ne vous a rien fait que vous baiſer les bras.	Mais ici voulais apprendre, S'il ne vous a rien fait que vous baiser les bras.
AGNES.	AGNES.
Comment.	Comment.
Eſt-ce qu’on fait d’autres choſes?	Est-ce qu'on fait d'autres choses?
ARNOLPHE.	ARNOLPHÉ.
Non pas.	Non pas.
Mais pour guerir du mal qu’il dit qui le poſſede, N’a-t’il point exigé de vous d’autre remede?	Mais pour guérir du mal qu'il dit qui le possède, N'a-t-il point exigé de vous d'autre remède?
AGNES.	AGNES.
Non.	Non.
Vous pouuez iuger s’il en euſt demandé, Que pour le ſecourir i’aurois tout accordé.	Vous pouvez juger s'il en eût demandé, Que pour le secourir j'aurais tout accordé.
ARNOLPHE.	ARNOLPHÉ.
Grace aux bontez du Ciel, i’en ſuis quitte à bon cõte.	Grâce aux bontés du Ciel, j'en suis quitte à bon compte.
Si i’y retombe plus ie veux bien qu’on m’affronte.	Si j'y retombe plus ie veux bien qu'on m'affronte.
Chut.	Chut.
De voſtre innocence, Agnés, c’eſt vn effet, Ie ne vous en dis mot, ce qui s’eſt fait eſt fait.	De votre innocence, Agnès, c'est un effet, Je ne vous en dis mot, ce qui s'est fait est fait.
Ie ſçay qu’en vous flattant le Galand ne deſire Que de vous abuſer, & puis apres s’en rire.	Je sais qu'en vous flattant le Galant ne désire Que de vous abuser, et puis après s'en rire.
HENES.	HÉNES.
Oh!	Oh!
point.	point.
Il me l’a dit plus de vingt fois à moy.	Il me l'a dit plus de vingt fois à moi.
ARNOLPHE.	ARNOLPHÉ.
Ah!	Ah!
vous ne ſçauez pas ce que c’eſt que ſa foy.	vous ne savez pas ce que c'est que sa foi.
Mais enfin:	Mais enfin:
apprenez qu’accepter desſ caſſettes, Et de ces beaux blondins écouter les ſornettes:	apprenez qu'accepter dess cassettes, Et de ces beaux blondins écouter les sornettes:
Que le ſamer pareux a loree de langueur Baiſer ainſi les mains, & chatoüiller le cœur:	Que le samer pareux à lorée de langueur Baiser ainsi les mains, et chatouiller le cœur:
Elt vn peche mortel des plus gros qu’il ſe faſſe.	Elt un pèche mortel des plus gros qu'il se fasse.
110 MAGNES.	110 MAGNES.
Vn peché, dites-vous, & la raiſon de grace?	Un péché, dites-vous, et la raison de grâce?
L ARNOLPHE.	 LRNOLPHÉ.
La raiſon?	La raison?
la raiſon, eſt l’arreſt prononcé, Que par ces actions le Ciel eſt courroucé.	la raison, est l'arrêt prononcé, Que par ces actions le Ciel est courroucé.
AGNES.	AGNES.
Courrouce.	Courrouce.
Mais pourquoy faut-il qu’il s’en courrouC’eſt vne choſe, helas!	Mais pourquoi faut-il qu'il s'en courrouC'est une chose, hélas!
ſi plaiſante & ſi douce.	si plaisante et si douce.
[ ce?	[ ce?
I’admire quelle ioye on gouſte à tout cela.	J'admire quelle joie on goûte à tout cela.
Et ie ne ſçauois point encor ces choſes-là.	Et ici ne savais point encor ces choses-là.
I1ne Ro fiIIEs Oüy.	I1ne Ro fiIIEs Oui.
C’eſt vn grand plaiſir que toutes ces tendreſſes, Ces propos ſi gentils, & ces douces careſſes:	C'est un grand plaisir que toutes ces tendresses, Ces propos si gentils, et ces douces caresses:
Mais il faut le gouſter en toute honneſteté, Et qu’en ſe mariant le crime en ſoit oſté.	Mais il faut le goûter en toute honnêteté, Et qu'en se mariant le crime en soit ôté.
1 AGNES.	1 AGNES.
N’eſt-ce plus vn peché lors que l’on ſe marie?	N'est-ce pas un péché lors que l'on se marie?
ARNOLPHE.	ARNOLPHÉ.
Non 211	Non 211
AGNES.	AGNES.
11 Mariez-moy donc promptement, ie vous prie.	11 Mariez-moi donc promptement, je vous prie.
ARNOLPHE.	ARNOLPHÉ.
Or vout le lounaitez, ie le ſouhaite auſſi, Et pour vous marier on me reuoit icy.	Or vout le lounaitez, on le souhaite aussi, Et pour vous marier on me revoit ici.
AONES.	ÀONES.
Eſt-il poſſible?	Est-il possible?
ARNOLPHE.	ARNOLPHÉ.
Oüy.	Oui.
AGNES.	AGNES.
Que vous me ferez aiſe!	Que vous me ferez aise!
ARNOLPHE.	ARNOLPHÉ.
Oüy, ie ne doute point que l'hyhien ne rous plaiſe.	Oui, Seigneur ne doute point que l'hyhien ne rous plaise.
AGNES.	AGNES.
Vous nous voulez nous deux.	Vous nous voulez nous deux.
ARNOLPHE.	ARNOLPHÉ.
Rien de plus aſſeuré,	Rien de plus assuré,
i o la nor Que ſi cela ſe fait, ie vous careſſeray!	y ô la nor Que si cela se fait, je vous caresserai!
ARNOLPHE.	ARNOLPHÉ.
né, la choſe ſera de ma part reciproque.	né, la chose sera de ma part reciproque.
AGNES.	AGNES.
Ie ne reconnois point pour moy, quand on ſe mocParlez-vous tout de bon?	Je ne reconnais point pour moi, quand on se moParlez-vous tout de bon?
31 que.	31 que.
ARNOLPHE.	ARNOLPHÉ.
2110 Oüy, vous le pourrez voir.	2110 Oui, vous le pourrez voir.
AGNES.	AGNES.
Nous ſerons mariez?	Nous serons mariés?
A RNOLPHE.	À RNOLPHÉ.
Oüy.	Oui.
AGNES.	AGNES.
10.	10.
Mais quand ?	Mais quand ?
B	B
ARNOLPHE.	ARNOLPHÉ.
Dés ce ſoir?	Dès ce soir?
Dés ce ſoir.	Dès ce soir.
AGNES riant.	AGNES riant.
ARNOLPHE.	ARNOLPHÉ.
Dés ce ſoir.	Dès ce soir.
Cela vous fait donc rire,?	Cela vous fait donc rire,?
Oüy.	Oui.
ARNOLPHE.	ARNOLPHÉ.
Vous voir bien contente, eſt ce que ie deſire.	Vous voir bien contente, est ce que ie désire.
AGNES.	AGNES.
Helas!	Hélas!
que ie vous ay grande obligation!	que ici vous ai grande obligation!
Et qu'aucelpruuraq de datisfaction!	Et qu'aucelpruuraq de datisfaction!
Auee qui:	Avée qui:
ARNOLPHE.	ARNOLPHÉ.
AGNES.	AGNES.
Auec.	Avec.
là.	là.
ARNOLPHE.	ARNOLPHÉ.
Là.	Là.
là n’eſt pas mon compte.	là n'est pas mon compte.
A choiſir vn mary, vous eſtes vn peu prompte.	À choisir un mari, vous êtes un peu prompte.
C’eſt vn autre en vn mot que ie vous tiens tout preſt, Et quant au Monſieur, là.	C'est un autre en un mot que je vous tiens tout prêt, Et quant au Monsieur, là.
Ie pretens, s’il vous plaiſt, Deuſt le mettre au tombeau le mal dõt il vous berce, Qu’auec luy deſormais vous rompiez tout cõmerce:	Je prétends, s'il vous plaît, Deût le mettre au tombeau le mal dont il vous berce, Qu'avec lui désormais vous rompiez tout commerce:
Que venant au logis pour voſtre compliment ous ray icihneraunee la porte honneſtement, Et luy iettant, s’il heurte, vn grez par la feneſtre, L’obligiez tout de bon a ne plus y pareſtre.	Que venant au logis pour votre compliment ous rai iciherauneée la porte honnêtement, Et tu jetant, s'il heurte, un grès par la fenêtre, L'obligiez tout de bon à ne plus y paraître.
M’entendez-vous, Agnés?	M'entendez-vous, Agnès?
moy, caché dans vn coin, De voſtre procedé ie ſeray le témoin.	moi, caché dans un coin, De votre procédé entre serai le témoin.
AGNES.	AGNES.
Las!	Las!
il eſt ſi bien fait.	il est si bien fait.
C’eſt.	C'est.
ARNOLPHE.	ARNOLPHÉ.
Ah que de langage!	Ah que de langage!
AGNES.	AGNES.
Ie n’auray pas le cœur.	Je n'aurai pas le cœur.
ARNOLPHE.	ARNOLPHÉ.
Point de bruit dauantage.	Point de bruit davantage.
Montez là-haut.	Montez là-haut.
Au a Mve Mais quoy, voulez-vous.	Au a Mue Mais quoi, voulez-vous.
ARNOLPHE, C’eſt aſſez.	ARNOLPHÉ, C'est assez.
Ie ſuis Maiſtre, ie parle, allez, obeïſſez.	Je suis Maître, notre parle, allez, obéissez.
Fin du 11.	Fin du 11.
Adte	Adte
ICIE IIII	ICIE IIII
SCENE PREMIERE.	SCÈNE PREMIÈRE.
uy moon Ca  ARNOLPHE, AGNES, ALAIN, GEORGETTE.	Oui moon Ca ARNOLPHE, AGNES, ALAIN, GEORGETTE.
R02	R02
28 ARNOLPHE, 2 VY:	28 ARNOLPHÉ, 2 VI:
tout a bien eſté, ma ioye eſt ſans pareille.	tout a bien été, ma joie est sans pareille.
Vous auez là ſuiui mes ordres à merueille:	Vous avez là suivi mes ordres à merveille:
Confondu de tout poinct le blondin ſeducteur;	Confondu de tout point le blondin séducteur;
Et voila dequoy ſert vn ſage directeur.	Et voilà dequoy sert un sage directeur.
Voſtre innocence, Agnés, auoit eſté ſurpriſe, Voyez, ſans y penſer où vous vous eſtiez miſe.	Votre innocence, Agnès, avait été surprise, Voyez, sans y penser où vous vous étiez mise.
Vous enfiliez tout droit, ſans mon inſtruction, Le grand chemin d’Enfer & de perdition.	Vous enfiliez tout droit, sans mon instruction, Le grand chemin d'Enfer et de perdition.
De tous ces Damoizeaux on ſçait trop les couſtumes.	De tous ces Damoiseaux on sait trop les coutumes.
Ils ont de beaux canons, force rubans, & plumes, Grãds cheueux, belles dents, & des propos fort doux:	Ils ont de beaux canons, force rubans, et plumes, Grands cheveux, belles dents, et des propos fort doux:
Mais comme ie vous dis la griffe eſt là deſſous.	Mais comme ici vous dis la griffe est là -dessous.
Et ce ſont vrais Sathans, dont la gueule alterée De l’honneur feminin cherche à faire curée.	Et ce sont vrais Satans, dont la gueule altérée De l'honneur féminin cherche à faire curée.
Mais encore vne fois, grace au ſoin apporté, Vous en eſtes ſortie auec honneſteté.	Mais encore une fois, grâce au soin apporté, Vous en êtes sortie avec honnêteté.
L’air dont ie vous ay veu luy ietter cette pietre, Qui de tous ſes deſſeins a mis l’eſpoir par terre, Me confirme encor mieux à ne point differer Les Nopces, où ie dis qu’il vous faut preparer.	L'air dont je vous ai vu lui jeter cette piètre, Qui de tous ses desseins à mis l'espoir par terre, Me confirme encor mieux à ne point différer Les Nopces, où ie dis qu'il vous faut préparer.
Mais auant toute choſe il eſt bon de vous faire Quelque petit diſcours, qui vous ſoit ſalutaire.	Mais avant toute chose il est bon de vous faire Quelque petit discours, qui vous soit salutaire.
Vn ſiege au frais icy.	Un siège au frais ici.
Vous, ſi iamais en rien.	Vous, si jamais en rien.
GEORGETTE.	GEORGETTE.
De toutes vos leçons nous nous ſouuiendrons bien.	De toutes vos leçons nous nous souviendrons bien.
Cet autre Monſieur là nous en faiſoit accroire.	Cet autre Monsieur là nous en faisait accroire.
Mais.	Mais.
ALATN.	ÀLATN.
S’il entre iamais, ie veux iamais ne boire.	S'il entre jamais, votre veux jamais ne boire.
Auſſi bien eſt-ce vn ſot, il nous a l’autre fois Donné deux eſcus d’or qui n’eſtoient pas de poids.	Aussi bien est-ce un sot, il nous a l'autre fois Donné deux écus d'or qui n'étaient pas de poids.
ARNOLPHE.	ARNOLPHÉ.
Ayez donc pour ſouper tout ce que ie deſire.	Ayez donc pour souper tout ce que On désire.
Et pour noſtre contract, comme ie viens de dire, Faites venir icy l’vn ou l’autre au retour, Le Notaire qui loge au coin de ce carfour.	Et pour notre contrat, comme ils viens de dire, Faites venir ici l'un ou l'autre au retour, Le Notaire qui loge au coin de ce carrefour.
SCENE II.	SCÈNE II.
souinc sNusieo lagoi lid dotso onv ARNOLPHE, AGNES.	souinc sNusieo lagoi lid dotso onv ARNOLPHE, AGNES.
ARNOLPHE aſſs.	ARNOLPHE asss.
2 402 ROI A.	2 402 ROI A.
Gnés, pour m’écouter, laiſſez-là voſtre ouurage.	Gnès, pour m'écouter, laissez-là votre ouvrage.
Fl Leuez vn peu la teſte, & tournez le viſage.	Fl Leuez un peu la tête, et tournez le visage.
Là, regardez-moy là, durant cet entretien:	Là, regardez-moi là, durant cet entretien:
114 Et iuſqu’au moindre mot imprimez-le vous bien.	114 Et jusqu'au moindre mot imprimez-le -vous bien.
Ie vous épouſe, Agnés, & cent fois la iournée Vous deuez benir l’heur de voſtre deſtinée:	Je vous épouse, Agnès, et cent fois la journée Vous devez bénir l'heur de votre destinée:
Contempler la baſſeſſe où vous auez eſté, 2111 Et dans le meſme temps admirer ma bonté, Qui de ce vil eſtat de pauure Villageoiſe, 210 Vous fait monter au rang d’honorable Bourgeoiſe:	Contempler la bassesse où vous avez été, 2111 Et dans le même temps admirer ma bonté, Qui de ce vil état de pauvre Villageoise, 210 Vous fait monter au rang d'honorable Bourgeoise:
Et ioüyr de la couche & des embraſſemens, 7110 D’vn homme qui fuyoit tous ces engagemens;	Et jouir de la couche et des embrassements, 7110 D'un homme qui fuyait tous ces engagements;
Et dont à vingt partis fort capables de plaire, B Le cœur a refuſé l’honneur qu’il vous veut faire.	Et dont à vingt partis fort capables de plaire, B Le cœur a refusé l'honneur qu'il vous veut faire.
Vous deuez touſiours, dis-je, auoir deuant les yeux Le peu que vous eſtiez ſans ce nœud glorieux;	Vous devez toujours, dis-je, avoir devant les yeux Le peu que vous étiez sans ce nœud glorieux;
Afin que cet obiet d’autant mieux vous inſtruiſe, A meriter l’eſtat où ie vous auray miſe;	Afin que cet objet d'autant mieux vous instruise, A mériter l'état où ie vous aurai mise;
111 A touſiours vous connoiſtre, & faire qu’à iamais Ie puiſſe me louër de l’acte que ie fais.	111 À toujours vous connaître, et faire qu'à jamais Je puisse me louer de l'acte que tu fais.
Le mariage, Agnés, n’eſt pas vn badinage.	Le mariage, Agnès, n'est pas un badinage.
15 2 1.	15 2 1.
10U A d’auſteres deuoirs le rang de femme engage:	10U À d'austères devoirs le rang de femme engage:
Et vous n’y montez pas, à ce que ie pretens, Pour eſtre libertine & prendre du bon temps.	Et vous n'y montez pas, à ce que ie pretens, Pour être libertine et prendre du bon temps.
Voſtre ſexe n’eſt là que pour la dépendance.	Votre sexe n'est là que pour la dépendance.
Du coſté de la barbe eſt la toute-puiſſance.	Du côté de la barbe est la toute-puissance.
Bien qu’on ſoit deux moitiez de la ſocieté, Ces deux moitiez pourtant n’ont point d’egalité:	Bien qu'on soit deux moitiés de la société, Ces deux moitiés pourtant n'ont point d'égalité:
L’vne eſt moitié ſupréme, & l’autre ſubalterne:	L'une est moitié suprême, et l'autre subalterne:
L’vne en tout eſt ſoumiſe à l’autre qui gouuerne.	L'une en tout est soumise à l'autre qui gouverne.
Et ce que le ſoldat dans ſon deuoir inſtruit Monſtre d’obeïſſance au Chef qui le conduit, Le Valet à ſon Maiſtre, vn Enfant à ſon Pere, A ſon Superieur le moindre petit Frere, N’approche point encor de la docilité, Et de l’obeïſſance, & de l’humilité, Et du profond reſpect, où la femme doit eſtre Pour ſon mari, ſon Chef, ſon Seigneur & ſon MaiLors qu’il iette ſur elle vn regard ſerieux, Son deuoir auſſi-toſt eſt de baiſſer les yeux;	Et ce que le soldat dans son devoir instruit Monstre d'obéissance au Chef qui le conduit, Le Valet à son Maître, un Enfant à son Père, À son Supérieur le moindre petit Frère, N'approche point encor de la docilité, Et de l'obéissance, et de l'humilité, Et du prof respect, où la femme doit être Pour son mari, son Chef, son Seigneur et son MaiLors qu'il jette sur elle un regard sérieux, Son devoir aussitôt est de baisser les yeux;
Et de n’oſer iamais le regarder en face Iſtre.	Et de n'oser jamais le regarder en face Istre.
Que quand d’vn doux regard il luy veut faire grace.	Que quand d'un doux regard il lui veut faire grâce.
C’eſt ce qu’ẽtendent mal les femmes d’auiourd’huy;	C'est ce qu'entendent mal les femmes d'aujourd'hui;
Mais ne vous gaſtez pas ſur l’exemple d’autruy.	Mais ne vous gâtez pas sur l'exemple d'autrui.
Gardez-vous d’imiter ces coquettes vilaines, Dont par toute la Ville on chante les fredaines:	Gardez-vous d'imiter ces coquettes vilaines, Dont par toute la Ville on chante les fredaines:
Et de vous laiſſer prendre aux aſſauts du malin, C’eſt à dire, d’oüyr aucun ieune blondin.	Et de vous laisser prendre aux assauts du malin, C'est -à -dire, d'ouïr aucun jeune blondin.
Songez qu’en vous faiſant moitié de ma perſonne;	Songez qu'en vous faisant moitié de ma personne;
C’eſt mon honneur, Agnés, que ie vous abandonne:	C'est mon honneur, Agnès, que je vous abandonne:
Que cet honneur eſt tendre, & ſe bleſſe de peu;	Que cet honneur est tendre, et se blesse de peu;
Que ſur vn tel ſujet il ne fant point de jeu:	Que sur un tel sujet il ne fant point de jeu:
Et qu’il eſt aux Enfers des chaudieres boüillantes, Où l’on plonge à lamais les femmes mal viuantes.	Et qu'il est aux Enfers des chaudières bouillantes, Où l'on plonge à lamais les femmes mal vivantes.
Ce que ie vous dis là ne ſont pas des chanſons:	Ce que ici vous dis là ne sont pas des chansons:
Et vous deuez du cœur deuorer ces leçons.	Et vous devez du cœur dévorer ces leçons.
Si voſtre ame les ſuit & fuït d’eſtre coquette, Elle ſera toûjours comme vn lis blanche & nette?	Si votre âme les suit et fût d'être coquette, Elle sera toujours comme un lis blanche et nette?
Mais s’il faut qu’à l’honneur elle faſſe vn faux-bonElle deuiendra lors noire comme vn charbon.	Mais s'il faut qu'à l'honneur elle fasse un faux-bonElle deviendra lors noire comme un charbon.
Vous paroiſtrez à tous vn obiet effroyable, Et vous irez vn iour, vray partage du diable, Boüillir dans les Enfers à toute eternité:	Vous paraîtrez à tous un objet effroyable, Et vous irez un jour, vrai partage du diable, Bouillir dans les Enfers à toute éternité:
Dont vous veüille garder la Celeſte bonté.	Dont vous veuille garder la Céleste bonté.
Faites la reuerence.	Faites la révérence.
Ainſi qu’vne Nouice Par cœur dans le Couuent doit ſçauoir ſon office;	Ainsi qu'une Novice Par cœur dans le Couvent doit savoir son office;
Entrant au mariage il en faut faire autant:	Entrant au mariage il en faut faire autant:
Et voicy dans ma poche vn écrit important Qui vous enſeignera l’office de la femme.	Et voici dans ma poche un écrit important Qui vous enseignera l'office de la femme.
I’en ignore l’Autheur:	J'en ignore l'Auteur:
mais c’eſt quelque bonne ame.	mais c'est quelque bonne âme.
Et le veua que ce lon vonre vinque entretien.	Et le veua que ce lon vonre vinque entretien.
Tenez:	Tenez:
voyons vn peu ſi vous le lirez bien.	voyons un peu si vous le lirez bien.
AGNES lit.	AGNES lit.
LES MAXIMES DV MARIAGE, LES DEVOIRS DE LA FEMME MARIEE.	LES MAXIMES DU MARIAGE, LES DEVOIRS DE LÀ FEMME MARIE.
Auec ſon Exercice iournalier.	Avec son Exercice journalier.
I.	I.
MAXIME.	MAXIME.
Elle qu’vn lien honneſte, CFait entrer au lict d’autruy:	Elle qu'un lien honnête, CAit entrer au lit d'autrui:
Doit ſe mettre dans la teſte, Malgré le train d’auiourd' huy, Iluy.	Doit se mettre dans la tête, Malgré le train d'aujourd' hui, Ilui.
Que l'hôme qui la prend, ne la prena que pour	Que l'hôme qui la prend, ne la prena que pour
ARNOLPHE.	ARNOLPHÉ.
Ie vous expliqueray ce que cela veut dire.	Je vous expliquerai ce que cela veut dire.
Mais pour l’heure preſente il he faut rien que lire.	Mais pour l'heure présente il hé faut rien que lire.
J	J
AGNES pourſuit.	AGNES poursuit.
II.	II.
MAXIME.	MAXIME.
Elle ne ſe doit parer Qu’autant que peut deſirer Le mari qui la poßede.	Elle ne se doit parer Qu'autant que peut désirer Le mari qui la passée.
C'eſt luy que touche ſeul le ſoin de ſa beauté;	C'est lui que touche seul le soin de sa beauté;
Et pour rien doit eſtre conté:	Et pour rien doit être conté:
Que les autres la trouuent laide.	Que les autres la trouvent laide.
III.	III.
MAXIME.	MAXIME.
Loin, ces eſtudes d’œillades, Ces eaux, ces blancs, ces pommades, Et mille ingrediens qui font des teints fleuris.	Loin, ces études d'œillades, Ces eaux, ces blancs, ces pommades, Et mille ingrédients qui font des teints fleuris.
A l'honneur tous ler iours ce ſont drogues mortel.	À l'honneur tous les jours ce sont drogues mortel.
ua cauuue ds paleiſa ceuue.	Oua cauve ds palevisa ceuve.
Se prennent peu pour les maris.	Se prennent peu pour les maris.
les.	les.
IV.	IV.
MAXIME.	MAXIME.
Sous ſa coiffe en ſortant, comme l’honueur l’ordonne, nquu pamafuamuamutautuuuge ls coup.	Sous sa coiffe en sortant, comme l'honnueur l'ordonne, nu pamafuamuamutautuuuge ls coup.
Car pour bien plaire à ſon Eſpoux, Elle ne doit plaire à porſonne.	Car pour bien plaire à son Époux, Elle ne doit plaire à porsonne.
2	2
V.	V.
MAXIME.	MAXIME.
Honteux, dont au mari la viſite ſe rend, La bonne regle deffend De receuoir aucune ame.	Honteux, dont au mari la visite se rend, La bonne règle défend De recevoir aucune âme.
Ceux qui de galante humeur, N'ont affaire qu’à Madame, N'accommodent pas Monſieur.	Ceux qui de galante humeur, N'ont affaire qu'à Madame, N'accommodent pas Monsieur.
VI.	VI.
MAXIME.	MAXIME.
Il faut des preſens des hommes Qu'elle ſe deffende bien.	Il faut des présents des hommes Qu'elle se défende bien.
Car dans le ſiecle où nous ſommes On ne donne rien pour rien.	Car dans le siècle où nous sommes On ne donne rien pour rien.
VII.	VII.
MAXIME.	MAXIME.
Dans ſes meubles, deuft.	Dans ses meubles, déft.
elle en auoir de l'ennui, Il ne faut eſcritoire, ancre, papier ny plumes.	elle en avoir de l'ennui, Il ne faut écritoire, ancre, papier ni plumes.
Le mari doit, dans les bonnes couſtumes, Eſcrire tout ce qui s’écrit chez lui,	Le mari doit, dans les bonnes coutumes, Écrire tout ce qui s'écrit chez lui,
VIII.	VIII.
MAXIME.	MAXIME.
Ces ſocietez déreglées, Qu’on nomme belles aſſemblées, Des femmes, tous les iours corrompent les eſprits.	Ces sociétés déréglées, Qu'on nomme belles assemblées, Des femmes, tous les jours corrompent les esprits.
En bonne Politique on les doit interdire;	En bonne Politique on les doit interdire;
Car c’est là, que l’on conſpire Contre les pauures maris.	Car c'est là, que l'on conspire Contre les pauvres maris.
IX.	IX.
MAXIME.	MAXIME.
Toute ſemme qui veut à l’honneur ſe voüer, Doit ſe deffendre de ioüer, Comme d'vne choſe funeste.	Toute semme qui veut à l'honneur se vouer, Doit se défendre de jouer, Comme d'une chose funeste.
Car le ieu fort deceuant Pouſſe vne femme ſouuent, Aiouer de tout ſon reſte.	Car le jeu fort décevant Pousse une femme souvent, Ajouer de tout son reste.
X.	X.
MAXIME.	MAXIME.
Des promenades du temps, Ou repas qu'on donne aux champs Il ne faut point qu'elle eſſaye.	Des promenades du temps, Ou repas qu'on donne aux champs Il ne faut point qu'elle essaye.
Seion tes prhudaxcarneuma, Le mari dans ces cadeaux Eſt touſiours ceiuy qui paye.	Seion tes prhudaxcarneuma, Le mari dans ces cadeaux Est toujours celui qui paye.
24	24
XI.	XI.
MAXIME.	MAXIME.
ARNOLPHE.	ARNOLPHÉ.
Vous acheuerez ſeule, & pas à pas tantoſt Ie vous expliqueray ces choſes comme il faut, Ie me ſuis ſouuenu d’vne petite affaire.	Vous achèverez seule, et pas à pas tantôt Je vous expliquerai ces choses comme il faut, Je me suis souvenu d'une petite affaire.
Ie n’ay qu’vn mot à dire, & ne tarderay guere.	Je n'ai qu'un mot à dire, et ne tarderai guère.
Rentrez:	Rentrez:
& conſeruez ce Liure cherement.	et conservez ce Livre chèrement.
Si le Notaire vient, qu’il m’attende vn moment.	Si le Notaire vient, qu'il m'attende un moment.
SCENE III.	SCÈNE III.
ARNOLPHE.	ARNOLPHÉ.
E ne puis faire mieux que d’en faire ma femme.	ET ne puis faire mieux que d'en faire ma femme.
I Ainſi que ie voudray, ie tourneray cette ame.	I Ainsi que ici voudrai, Seigneur tournerai cette âme.
Cõme vn morceau de cire entre mes mains elle eſt, Et ie luy puis donner la forme qui me plaiſt.	Comme un morceau de cire entre mes mains elle est, Et ie cy puis donner la forme qui me plaît.
Il s’en eſt peu fallu que, durant mon abſence, On ne m’ait attrapé par ſon trop d’innocence, Mais il vaut beaucoup mieux, à dire verité, Que la femme qu’on a pêche de ce coſté.	Il s'en est peu fallu que, durant mon absence, On ne m'ait attrapé par son trop d'innocence, Mais il vaut beaucoup mieux, à dire vérité, Que la femme qu'on a pèche de ce côté.
De ces ſortes d’erreurs le remede eſt facile.	De ces sortes d'erreurs le remède est facile.
Toute perſonne ſimple aux leçons eſt docile:	Toute personne simple aux leçons est docile:
Et ſi du bon chemin on l’a fait écarter Deux mots incontinent l’y peuuent rejetter.	Et si du bon chemin on l'a fait écarter Deux mots incontinent l'y peuvent rejetter.
Mais vne femme habile eſt bien vne autre beſte.	Mais quelque femme habile est bien une autre bête.
Noſtre ſort ne dépend que de ſa ſeule teſte:	Notre sort ne dépend que de sa seule tête:
De ce qu’elle s’y met, rien ne la fait gauchir, Et nos enſeignemens ne font là que blanchir.	De ce qu'elle s'y met, rien ne la fait gauchir, Et nos enseignements ne font là que blanchir.
Son bel eſprit luy ſert à railler nos maximes, A ſe faire ſouuent des vertus de ſes crimes:	Son bel esprit homme sert à railler nos maximes, À se faire souvent des vertus de ses crimes:
Et trouuer, pour venir à ſes coupables fins, Des détours à duper l’adreſſe des plus fins.	Et trouver, pour venir à ses coupables fins, Des détours à duper l'adresse des plus fins.
Pour ſe parer du coup en vain on ſe fatigue.	Pour se parer du coup en vain on se fatigue.
Vne femme d’eſprit eſt vn diable en intrigue:	Une femme d'esprit est un diable en intrigue:
Et dés que ſon caprice a prononcé tout bas L’arreſt de noſtre honneur, il faut paſſer le pas.	Et dès que son caprice a prononcé tout bas L'arrêt de notre honneur, il faut passer le pas.
Beaucoup d’honneſtes gens en pourroient bien que Enfin mon eſtourdy n’aura pas lieu d’en rire.	Beaucoup d'honnêtes gens en pourraient bien que Enfin mon étourdi n'aura pas lieu d'en rire.
[dire.	[dire.
Par ſon trop de caquet il a ce qu’il luy faut.	Par son trop de caquet il a ce qu'il lui faut.
Voila de nos François l’ordinaire defaut.	Voilà de nos Français l'ordinaire défaut.
DMIAN Dans la poſſeſſion d’vne bonne fortune, Le ſecret eſt toûjours ce qui les importune;	DMIAN Dans la possession d'une bonne fortune, Le secret est toujours ce qui les importune;
Et la vanité ſotte a pour eux tant d’appas, Qu’ils ſe pendroient plutoſt que de ne cauſer pas.	Et la vanité sotte a pour eux tant d'appas, Qu'ils se pendraient plutôt que de ne causer pas.
O que les femmes ſont du diable bien tentées, Lors qu’elles vont choiſir ces teſtes éuentées!	Ô que les femmes sont du diable bien tentées, Lors qu'elles vont choisir ces têtes éventées!
ne que.	ne que.
Mais le voien cacnons ilous toujours bien, Et découurons vn peu quel chagrin eſt le ſien.	Mais le voien cacnons ilous toujours bien, Et découurons un peu quel chagrin est le sien.
SCENE IV HORACE, ARNOLPHE.	SCÈNE IV HORACE, ARNOLPHE.
HORACE.	HORACE.
E reuiens de chez vous, & le deſtin me montre IQu’il n’a pas reſolu que ie vous y rencontre.	E reviens de chez vous, et le destin me montre IQu’il n'a pas résolu que je vous y rencontre.
Mais i’iray tant de fois qu’enfin quelque moment.	Mais j'irai tant de fois qu'enfin quelque moment.
ARNOLPHE.	ARNOLPHÉ.
Hé mon Dieu!	Hé mon Dieu!
n’entrons point dans ce vain compliRien ne me faſche tant que ces ceremonies, ſment.	n'entrons point dans ce vain complivrien ne me fâche tant que ces cérémonies, sment.
Et ſi l’on m’en croyoit, elles ſeroient bannies.	Et si l'on m'en croyait, elles seraient bannies.
C’eſt vn maudit vſage, & la pluſpart des gens Y perdent ſottement les deux tiers de leur temps.	C'est un maudit usage, et la plupart des gens Y perdent sottement les deux tiers de leur temps.
Mettons donc ſans façons.	Mettons donc sans façon.
Hé bien.	Hé bien.
vos amourettes.	vos amourettes.
Puis-ie, Seigneur Horace, apprẽdre où vous en eſtes?	Puis-je, Seigneur Horace, apprendre où vous en êtes?
I’eſtois tantoſt diſtrait par quelque viſion:	J'étais tantôt distrait par quelque vision:
Mais depuis là-deſſus i’ay fait reflexion.	Mais depuis là-dessus j'ai fait réflexion.
De vos premiers progrez i’admire la viteſſe, Et dans l’éuenement mon ame s’intereſſe.	De vos premiers progrès j'admire la vitesse, Et dans l'événement mon âme s'intéresse.
HORACE.	HORACE.
47 Ma foy, depuis qu’à vous s’eſt découuert mon cœur, Il eſt à mon amour arriué du malheur.	47 Ma foi, depuis qu'à vous s'est découvert mon cœur, Il est à mon amour arrivé du malheur.
FA	FA
ARNOLPHE.	ARNOLPHÉ.
Oh, oh!	Oh, oh!
comment cela?	comment cela?
AGNES.	AGNES.
La fortune cruelle, A ramené des champs le patron de la belle.	La fortune cruelle, A ramené des champs le patron de la belle.
ARNOLPHE.	ARNOLPHÉ.
Quel malheur!	Quel malheur!
HORACE.	HORACE.
Et de plus, à mon tres-grand regret, mi a leeu de naaa deul le cailiflerce leclee.	Et de plus, à mon très-grand regret, mi a levu de naaa deul le cailiflerce leclée.
ARNOLPHE.	ARNOLPHÉ.
D’où diantrela-t-il ſi toſt appris cette auanture?	D'où diantrela-t-il si tôt appris cette aventure?
HORACE.	HORACE.
Ie ne ſçay.	Je ne sais.
Mais enfin c’eſt vne choſe ſeurc.	Mais enfin c'est une chose sûrc.
Ie penſois aller rendre, à mon heure à peu prés, Ma petite viſite à ſes ieunes attraits.	Je pensais aller rendre, à mon heure à peu prés, Ma petite visite à ses jeunes attraits.
coro que elangeant pour moy de ton & de viſage, Et Seruante & Valet m’ont bouché le paſſage, Et d’vn :	coro que élangeant pour moi de ton et de visage, Et Servante et Valet m'ont bouché le passage, Et d'un :
retirez-vous, vous nous importunez.	retirez-vous, vous nous importunez.
M’ont aſſez rudement fermé la porte au nez.	M'ont assez rudement fermé la porte au nez.
25	25
ARNOLPHE.	ARNOLPHÉ.
La porte au nez!	La porte au nez!
HORACE.	HORACE.
Au nez.	Au nez.
I	I
ARNOLPHE.	ARNOLPHÉ.
La choſe eſt vn peu forte.	La chose est un peu forte.
HORACE.	HORACE.
.	.
1 I’ay voulu leur parler au trauers de la porte:	1 J'ai voulu leur parler au travers de la porte:
Mais à tous mes propos ce qu’ils ont répondu C’eſt, vous n’entrerez point, Monſieur l’a defendu.	Mais à tous mes propos ce qu'ils ont répondu C'est, vous n'entrerez point, Monsieur l'a défendu.
ARNOLPHE.	ARNOLPHÉ.
Ils n’ont donc point ouuert ?	Ils n'ont donc point ouvert ?
1 HORACE.	1 HORACE.
Non.	Non.
Et de la feneſtre Agnés m’a confirmé le retour de ce Maiſtre;	Et de la fenêtre Agnès m'a confirmé le retour de ce Maître;
nu me chanant de là d’vn ton plein de fierté, Accompagné d’vn grez que ſa main a ietté.	nu me chanant de là d'un ton plein de fierté, Accompagné d'un grès que sa main a jeté.
ANNOLIHE.	ANNOLIHÉ.
Comment d’vn grez?	Comment d'un grès?
HORACE.	HORACE.
D’vn grez de taille non petits Dont on a par ſes mains regalé ma viſite.	D'un grès de taille non petits Dont on a par ses mains régalé ma visite.
A11e RueMmnne.	A11ée RueMmnne.
Diantre!	Diantre!
ce ne ſont pas des prunes que cela, Et le trouue laicneux l’eitat ou vous voila.	ce ne sont pas des prunes que cela, Et le trouve laiceux l'éitat ou vous voilà.
HORACE.	HORACE.
Il eſt vray, ie ſuis mal par ce retour funeſte.	Il est vrai, ie suis mal par ce retour funeste.
ARNOLPHE.	ARNOLPHÉ.
Certes i’en ſuis faſché pour vous, ie vous proteſte.	Certes j'en suis fâché pour vous, je vous proteste.
HORACE.	HORACE.
cet noine me fomprtout.	cet noine me fomprîtout.
ARNOLPHE.	ARNOLPHÉ.
Oüy, mais cela n’eſt rien, Et de vous racrocher vous trouuerez moyen.	Oui, mais cela n'est rien, Et de vous raccrocher vous trouverez moyen.
HORACE.	HORACE.
Il faut bien eſſayer par quelque intelligence De vaincre du jaloux l’exacte vigilance.	Il faut bien essayer par quelque intelligence De vaincre du jaloux l'exacte vigilance.
ANNOLTIIE.	ANNOLTIIE.
Cela vous eſt facile, & la fille apres tout Vous aime.	Cela vous est facile, et la fille après tout Vous aime.
TAAOT	TAOT
HORACE.	HORACE.
Aſſeurément.	Assurément.
ARNOLPHE.	ARNOLPHÉ.
Vous en viendrez à bout.	Vous en viendrez à bout.
HORACE.	HORACE.
le Iupere, HORACE.	le Jupère, HORACE.
ARNOLPHE.	ARNOLPHÉ.
Le grés vous a mis uir déroute, Mais cela ne doit pas vous eſtonner,	Le grès vous a mis uir déroute, Mais cela ne doit pas vous étonner,
HORACE.	HORACE.
Sans doute, Et i’ay compris d’abord que mon homme eſtoit là, Qui ſans ſe faire voir conduiſoit tout cela:	Sans doute, Et j'ai compris d'abord que mon homme était là, Qui sans se faire voir conduisait tout cela:
Mais ce qui m’a ſurpris & qui va vous ſurprendre, C'eſt vn autre incident que vous allez entendre, Vn trait hardy qu’a fait cette ieune beauté, Et qu’on n’attendroit point de ſa ſimplicité;	Mais ce qui m'a surpris et qui va vous surprendre, C'est un autre incident que vous allez entendre, Un trait hardi qu'a fait cette jeune beauté, Et qu'on n'attendrait point de sa simplicité;
Il le faut auoüer, l’amour eſt vn grand maiſtre, Ce qu’on ne fut iamais il nous enſeigne à l’eſtre.	Il le faut auoüer, l'amour est un grand maître, Ce qu'on ne fut jamais il nous enseigne à l'être.
Et ſouuent de nos mœurs l’abſolu changement Deuient par ſes leçons l’ouurage d’vn moment.	Et souvent de nos mœurs l'absolu changement Deuvient par ses leçons l'ouvrage d'un moment.
De la nature en nous il force les obſtacles, Et ſes effets ſoudains ont de l’air des miracles, D'vn auare à l’inſtant il fait vn liberal:	De la nature en nous il force les obstacles, Et ses effets soudains ont de l'air des miracles, D' auare à l'instant il fait un libéral:
Vn Vaillant d’vn Poltron, vn Ciuil d’vn Brutal.	Un Vaillant d'un Poltron, un Civil d'un Brutal.
Il rend agile à tout l’ame la plus peſante, Et donne de l’eſprit à la plus innocente:	Il rend agile à tout l'âme la plus pesante, Et donne de l'esprit à la plus innocente:
Ouy, ce dernier miracle éclatte dans Agnés, Car tranchant auec moy par ces termes exprés, Retirez-vous, mon ame aux viſites renonce, Ie ſçay tous vos diſcours:	Oui, ce dernier miracle éclate dans Agnès, Car tranchant avec moi par ces termes exprès, Retirez-vous, mon âme aux visites renonce, Je sais tous vos discours:
Et voilà ma reſponce.	Et voilà ma réponse.
Cette pierre ou ce grés dont vous vous eſtonniez, Auec vn mot de lettre eſt tombée à mes pieds, Et i'admire de voir cette lettre ajuſtée, Auec le ſens des mots;	Cette pierre ou ce grès dont vous vous étonniez, Avec un mot de lettre est tombée à mes pieds, Et j'admire de voir cette lettre ajustée, Avec le sens des mots;
Et la pierre iettée;	Et la pierre jetée;
D’vne telle action n’eſtes-vons pas ſurpris?	D'une telle action n'êtes-vons pas surpris?
L’amour ſçait-il pas l’art d’aiguiſer les eſprits?	L'Amour sait-il pas l'art d'aiguiser les esprits?
Et peut-on me nier que ſes flâmes puiſſantes, Ne faſſent dans vn cœur des choſes eſtonnantes?	Et peut-on me nier que ses flammes puissantes, Ne fassent dans un cœur des choses étonnantes?
Que dites-vous du tour, & de ce mot d’eſcrit?	Que dites-vous du tour, et de ce mot d'écrit?
Euh!	Euh!
n’admirez-vous point cette adreſſe d’eſprit?	n'admirez-vous point cette adresse d'esprit?
Trouuez-vous pas plaiſant de voir quel Perſonnage Ii ioue mon juroux dam todt ce badinage.	Trouvez-vous pas plaisant de voir quel Personnage Ji joue mon juroux dam todt ce badinage.
Dites,	Dites,
ARNOLPHE.	ARNOLPHÉ.
Oüy fort plaiſant,	Oui fort plaisant.
HORACE.	HORACE.
Arnolphe rit d’vn ris forcé.	Arnolphe rit d'une ris forcé.
Riez-en donc vn peu, Cét homme gendarmé d’abord contre mon feu, Qui chez luy ſe retranche, & de grés fait parade, Comme ſi i’y voulois entrer par eſcalade, Qui pour me repouſſer dans ſon bizarre effroy, Anime du dedans tous ſes gens contre moy, Et qu’abuſe à ſes yeux par ſa machine meſme, Celle qu’il veut tenir dans l’ignorance extréme:	Riez-en donc un peu, Cet homme gendarmé d'abord contre mon feu, Qui chez lui se retranche, et de grès fait parade, Comme si j'y voulais entrer par escalade, Qui pour me repousser dans son bizarre effroi, Anime du dedans tous ses gens contre moi, Et qu'abuse à ses yeux par sa machine même, Celle qu'il veut tenir dans l'ignorance extrême:
Pour moy ie vous l’auouë, encor que ſon retour En vn grand embalras jette Iey mon aſſour, Ie tiens cela plaiſant autant qu’on ſçauroit dire, Ie ne puis y ſonger ſans de bon cœur en rire.	Pour moi ici vous l'avoue, encor que son retour En un grand embalras jette Jei mon assour, Je tiens cela plaisant autant qu'on saurait dire, Je ne puis y songer sans de bon cœur en rire.
Et vous n’en riez pas aſſez à mon auis.	Et vous n'en riez pas assez à mon avis.
ARNOLPHE.	ARNOLPHÉ.
auec vn ris forcé.	avec un ris forcé.
Pardonnez-moy, i’en ris tout autant que ie puis.	Pardonnez-moi, j'en ris tout autant que tu puis.
HORACE.	HORACE.
Mais il faut qu’en amy ie vous montre la lettre.	Mais il faut qu'en ami ici vous montre la lettre.
Tout ce que ſon cœur ſent, ſa main a ſçeu l’y mettre:	Tout ce que son cœur sent, sa main a su l'y mettre:
Mais en termes touchans, & tous pleins de bonté, De tendreſſe innocente, & d’ingenuité, De la maniere enfin que la pure nature Exprime de l’amour la premiere bleſſure.	Mais en termes touchants, et tous pleins de bonté, De tendresse innocente, et d'ingénuité, De la manière enfin que la pure nature Exprime de l'amour la première blessure.
ARNOLPHE.	ARNOLPHÉ.
bas.	bas.
Voilà, friponne, à quoy l’eſcriture te fert, me contre mon denen l’ait t’en fut decouuert.	Voilà, friponne, à quoi l'écriture te sert, me contre mon den l'ait t'en fut découvert.
HORACE.	HORACE.
lit.	lit.
E veux vous eſcrire, & ie ſuis bien en peiI ne par où ie m'y prendray.	E veux vous écrire, et ainsi suis bien en péiI ne par où tu m'y prendrai.
I’ay des pensées que ie deſirerois que vous ſçeuſsiez;	J'ai des pensées que ici désirerais que vous sçeussiez;
mais ie ne ſçay comment faire pour vous les dire, & ie me deffie de mes paroles.	mais ici ne sais comment faire pour vous les dire, et ainsi me défie de mes paroles.
Comme ie commence à connoiſtre qu’on m’a touſiours tenuë dans l’ignorance, i’ay peur de mettre quelque choſe, qui ne ſoit pas bien, & d’en dire plus que ie ne deurois.	Comme grande commence à connaître qu'on m'a toujours tenue dans l'ignorance, j'ai peur de mettre quelque chose, qui ne soit pas bien, et d'en dire plus que Elle ne devrois.
En verité ie ne ſçay ce que vous m’auez fait;	En vérité ici ne sais ce que vous m'avez fait;
mais ie ſens que ie ſuis faſchée à mourir de ce qu’on me fait faire contre vous, que i’auray toutes les peines du monde à me paſſer de vous, & que ie ſerois bien aiſe d’eſtre à vous.	mais petit sens que je suis fâchée à mourir de ce qu'on me fait faire contre vous, que j'aurai toutes les peines du monde à me passer de vous, et que je serais bien aise d'être à vous.
Peut-eſtre qu’il y a du mal à dire cela;	Peut-être qu'il y a du mal à dire cela;
mais enfin ie ne puis m’empeſcher de le dire, & ie voudrois que cela ſe puſt faire, ſans qu’il y en euſt.	mais enfin ie ne puis m'empêcher de le dire, et un voudrais que cela se pût faire, sans qu'il y en eût.
On me dit fort, que tous les ieunes hommes ſont des trompeurs;	On me dit fort, que tous les jeunes hommes sont des trompeurs;
qu’il ne les faut point écouter, & que tout ce que vous me dites, n’eſt que pour m’abuſer;	qu'il ne les faut point écouter, et que tout ce que vous me dites, n'est que pour m'abuser;
mais ie vous aſſeure, que ie n’ay pù encore me figurer cela de vous;	mais ainsi vous assure, que ici n'ai puù encore me figurer cela de vous;
& ie ſuis ſi touchée de vos paroles, que ie ne ſçaurois croire qu'elles ſoient menteuſes.	et petit suis si touchée de vos paroles, que on ne saurais croire qu'elles soient menteuses.
Dites-moy franchement ce qui en eſt:	Dites-moi franchement ce qui en est:
car enfin, comme ie ſuis ſans malice, vous auriez le plus grand tort du monde, ſi vous me trompieZ.	car enfin, comme tu suis sans malice, vous auriez le plus grand tort du monde, si vous me trompiez.
Et ie penſe que i’en mourrois de déplaiſir.	Et ie pense que j'en mourrais de déplaisir.
Hom chienne.	Hom chienne.
ARNOLPHE.	ARNOLPHÉ.
HORACE.	HORACE.
Qu’auez-vous?	Qu'avez-vous?
ARNOLPHE.	ARNOLPHÉ.
Moy?	Moi?
rien;	rien;
c’eſt que ie touſſe.	c'est que personne tousse.
HORACE.	HORACE.
Auez-vous iamais veu, d’expreſſion plus douce, Malgré les ſoins maudits d’vn iniuſte pouuoir, Vn plus beau naturel peut-il ſe faire voir?	Avez-vous jamais vu, d'expression plus douce, Malgré les soins maudits d'un injuste pouvoir, Un plus beau naturel peut-il se faire voir?
Et n’eſt-ce pas ſans doute vn crime puniſſable, De gaſter meſchamment ce fons d’ame admirable?	Et n'est-ce pas sans doute un crime punissable, De gâter méchamment ce fonds d'âme admirable?
D’auoir dans l’ignorance & la ſtupidité, eo pirit voulu de cét amour eſtoufer la clarté?	D'avoir dans l'ignorance et la stupidité, évo pirit voulu de cet amour étouffer la clarté?
L'amour a commence d'en déchirer le voile, Et ſi par la faueur de quelque bonne eſtoile, Ie puis, comme i’eſpere, à ce franc animal, Ce traiſtrey ce bourreau, ce faquin, ce brutal.	L'amour a commence d'en déchirer le voile, Et si par la faveur de quelque bonne étoile, Je puis, comme j'espère, à ce franc animal, Ce traîtrei ce bourreau, ce faquin, ce brutal.
Adieu.	Adieu.
ARNOLPHE.	ARNOLPHÉ.
TONACL.	TONACL.
Comment ſi viſte?	Comment si vite?
ARNOLPHE.	ARNOLPHÉ.
Il m’eſt dans la pensée Venu tout maintenant vne affaire preſſée.	Il m'est dans la pensée Venu tout maintenant une affaire pressée.
HORACE.	HORACE.
Mais ne ſçauriez-vous point comme on la tient de prés, Qui dans cette maiſon pourroit auoir accés, I’en vſe ſans ſcrupule, & ce n’eſt pas merueille, Qu’on ſe puiſſe entre amis ſeruir à la pareille, Ie n’ay plus là dedans que gens pour m’obſeruer, Et ſeruante & valet que ie viens de trouuer, N’ont iamais de quelque air que ie m’y ſois pû prendre, Adoucy leur rudeſſe à me vouloir entendre, I’auois pour de tels coups certaine vieille en main, D’vn genie à vray dire au deſſus de l’humain, Elle m’a dans l’abord ſerui de bonne ſorte:	Mais ne sauriez-vous point comme on la tient de près, Qui dans cette maison pourrait avoir accès, J'en use sans scrupule, et ce n'est pas merveille, Qu'on se puisse entre amis servir à la pareille, Je n'ai plus là -dedans que gens pour m'observer, Et servante et valet que mille viens de trouver, N'ont jamais de quelque air que sans m'y sois pu prendre, Adouci leur rudesse à me vouloir entendre, J'avais pour de tels coups certaine vieille en main, D'un génie à vrai dire au dessus de l'humain, Elle m'a dans l'abord servi de bonne sorte:
muit depuis quatre iours la pauure femme eſt morte, Ne me pournez-vous point ouurn queſque moyen?	muit depuis quatre jours la pauvre femme est morte, Ne me pournez-vous point ouvrn quesque moyen?
ARNOLPHE.	ARNOLPHÉ.
Non vrayment, & ſans moy vous en trouuerez bien.	Non vraiment, et sans moi vous en trouverez bien.
HORACE.	HORACE.
Adieu donc.	Adieu donc.
Vous voyez ce que ie vous confie.	Vous voyez ce que je vous confie.
SCENE	SCÈNE
ARNOLPHE.	ARNOLPHÉ.
Omme il faut deuant lui que ie me mortifie, Quelle peine à cacher mon déplaiſir cuiſant.	Omme il faut devant lui que je me mortifie, Quelle peine à cacher mon déplaisir cuisant.
Quoy pour vne innocente, vn eſprit ſi preſent?	Quoi pour une innocente, un esprit si présent?
Elle a feint d’eſtre telle à mes yeux la traiſtreſſe;	Elle a feint êêtre telle à mes yeux la traîtresse;
Ou le diable à ſon ame a ſouflé cette adreſſe:	Ou le diable à son âme a soufflé cette adresse:
Enfin me voilà mort par ce funeſte eſcrit, Ie voy qu’il a le traiſtre empaumé ſon eſprit, Qu’à ma ſuppreſſion il s’eſt ancré chez elle, C iij Et c’eſt mon deſeſpoir, & ma peine mortelle, Ie ſouffre doublement dans le vol de ſon cœur, Et l’amour y pâtit auſſi bien que l’honneur.	Enfin me voilà mort par ce funeste écrit, Je vois qu'il a le traître empaumé son esprit, Qu'à ma suppression il s'est ancré chez elle, Ç mer Et c'est mon désespoir, et ma peine mortelle, Je souffre doublement dans le vol de son cœur, Et l'amour y pâtit aussi bien que l'honneur.
I’enrage de trouuer cette place vſurpée, Et i’enrage de voir ma prudence trompée.	J'enrage de trouver cette place usurpée, Et j'enrage de voir ma prudence trompée.
Ie ſçay que pour punir ſon amour libertin Ie n’ay qu’à laiſſer faire à ſon mauuais deſtin, Que ie ſeray vangé d’elle par elle-meſme:	Je sais que pour punir son amour libertin Je n'ai qu'à laisser faire à son mauvais destin, Que do seray vengé d'elle par elle-même:
Mais il eſt bien faſcheux de perdre ce qu’on aime.	Mais il est bien fâcheux de perdre ce qu'on aime.
Ciel!	Ciel!
puiſque pour vn choix i’ay tant Philoſophé, Faut-il de ſes appas m’eſtre ſi fort coëffé?	puisque pour un choix j'ai tant Philosophé, Faut-il de ses appas m'être si fort coëffé?
Elle n’a ni parens, ni ſupport, ni richeſſe, Elle trahit mes ſoins, mes bontez, ma tendreſſe, Et cependant ie l’aime, aprés ce laſche tour, Iuſqu’à ne me pouuoir paſſer de cét amour.	Elle n'a ni parents, ni support, ni richesse, Elle trahit mes soins, mes bontés, ma tendresse, Et cependant Je l'aime, après ce lâche tour, Jusqu'à ne me pouvoir passer de cet amour.
Sot, n’as-tu point de honte, ah ie creue, i’enrage, Et ie ſoufleterois mille fois mon viſage, Ie veux entrer vn peu;	Sot, n'as-tu point de honte, ah ie creue, j'enrage, Et ie souffleterais mille fois mon visage, Je veux entrer un peu;
mais ſeulement pour voir Quelle eſt ſa contenance aprés vn trait ſi noir.	mais seulement pour voir Quelle est sa contenance après un trait si noir.
Ciel!	Ciel!
faites que mon front ſoit exempt de diſgrace, Ou bien s’il eſt eſcrit, qu’il faille que i’y paſſe, Donnez-moy tout au moins pour de tels accidens, La conſtance qu’on voit à de certaines gens.	faites que mon front soit exempt de disgrâce, Ou bien s'il est écrit, qu'il faille que j'y passe, Donnez-moi tout au moins pour de tels accidents, La constance qu'on voit à de certaines gens.
Fin du troiſiéme Acte.	Fin du troisième Acte.
ACTE IV	ACTE IV
DCENE IREMIERE.	DCENE IREMIÈRE.
ARNOLPHE.	ARNOLPHÉ.
’AY peine, ie l’auouë, à demeurer en place, Et de mille ſoucis mon eſprit s’embaraſſe, A Pour pouuoir mettre vn ordre & dedans & dehors, Qui du godelureau rompe tous les efforts:	AY peine, je l'avoue, à demeurer en place, Et de mille soucis mon esprit s'embarrasse, A Pour pouvoir mettre un ordre et dedans et dehors, Qui du godelureau rompe tous les efforts:
De quel œil la traiſtreſſe a ſouſtenu ma veuë, De tout ce qu’elle a fait elle n’eſt point émeuë.	De quel œil la traîtresse a soutenue ma vue, De tout ce qu'elle a fait elle n'est point émue.
Et bien qu’elle me mette à deux doigts du treſpas, On diroit à la voir qu’elle n’y touche pas Plus en la regardant ie la voyois tranquile, Plus ie ſentois en moy s’eſchaufer vne bile, Et ces boüillants tranſports dont s’enflammoit mon cœur, Y ſembloient redoubler mon amoureuſe ardeur.	Et bien qu'elle me mette à deux doigts du trépas, On dirait à la voir qu'elle n'y touche pas Plus en la regardant je la voyais tranquille, Plus avoir sentais en moi s'échauffer une bile, Et ces boüillants transports dont s'enflammait mon cœur, Y semblaient redoubler mon amoureuse ardeur.
I'eſtois aigry, faſché, deſeſperé contre elle, Et cependant iamais ie ne la vis ſi belle;	J'étais aigri, fâché, désespéré contre elle, Et cependant jamais avoir ne la vis si belle;
lamais ſes yeux au miens n’ont paru ſi perçans, Iamais ie n’eus pour eux des deſirs ſi preſſans, Et ie ſens là dedans qu’il faudra que ie creue, Si de mon triſte ſort la diſgrace s’acheue.	lamais ses yeux au miens n'ont paru si perçans, Jamais été n'eus pour eux des désirs si pressants, Et nos sens là -dedans qu'il faudra que sans crève, Si de mon triste sort la disgrâce s'achève.
Quoy?	Quoi?
i’auray dirigé ſon education Auec tant de tendreſſe & de précaution?	j'aurai dirigé son éducation Avec tant de tendresse et de précaution?
Ie l’auray fait paſſer chez moy dés ſon enfance, Et i’en auray chery la plus tendre eſperance.	Je l'aurai fait passer chez moi dès son enfance, Et j'en aurai cheri la plus tendre espérance.
Mon cœur aura baſty ſur ſes attraits naiſſans, Et creu la mitonner pour moy durant treize ans.	Mon cœur aura bâti sur ses attraits naissants, Et cru la mitonner pour moi durant treize ans.
Afin qu’vn ieune fou dont elle s’amourache Me la vienne enleuer iuſque ſur la mouſtache, Lors qu’elle eſt auec moy mariée à demy.	Afin qu'un jeune fou dont elle s'amourache Me la vienne enlever jusque sur la moustache, Lors qu'elle est avec moi mariée à demi.
Non parbleu, non parbleu, petit ſot mon amy, Vous aurez beau tourner ou i’y pertiiay mes peines, Ou ne rendtay ma ioy, vos elperances vaines, Et de moy tout à fait vous ne vous rirez point.	Non parbleu, non parbleu, petit sot mon ami, Vous aurez beau tourner ou j'y pertiai mes peines, Ou ne rendai ma joi, vos élperances vaines, Et de moi tout à fait vous ne vous rirez point.
INII.	INII.
LE NOTAIRE, ARNOLPHE.	LE NOTAIRE, ARNOLPHÉE.
LE NOTIIRCE.	LE NOTIIRCE.
Hle voilà!	Hlè voilà!
boniour;	bonjour;
me voicy tout á point A Pour dreſſer le contract que vous ſouhaittez Tarres.	me voici tout § point A Pour dresser le contrat que vous souhaitez Tarres.
ARNOLPHE ſans le voir.	ARNOLPHE sans le voir.
Comment faire!	Comment faire!
LE NOTAIRE.	LE NOTAIRE.
Il le faut dans la forme ordinaire,	Il le faut dans la forme ordinaire,
ARNOLPHE ſans le voir.	ARNOLPHE sans le voir.
A mes précautions ie veux ſonger de prés,	À mes précautions apprendre veux songer de près,
LE NOTAIRE.	LE NOTAIRE.
Ie ne paneray rien contre vos mercits.	Je ne panerai rien contre vos mercits.
ARNOLPHE ſans le voir.	ARNOLPHE sans le voir.
Il ſe faut garantir de toutes les ſurpriſes.	Il se faut garantir de toutes les surprises.
LE NOTAIRE.	LE NOTAIRE.
Suffit qu’entre mes mains vos affaires ſoient miſes, a fle toue madiu ponit de poul diutle deçeu, Quittancer le Contract que vous n’ayez receu.	Suffit qu'entre mes mains vos affaires soient mises, a flè toue madiu ponit de poul diutle deçeu, Quittancer le Contract que vous n'ayez reçu.
ARNOLPHE ſans le voir.	ARNOLPHE sans le voir.
l’ay peur ſi ie vais faire éclater quelque choſe Que de cét incident par la ville on ne cauſe.	l'ai peur si ici vais faire éclater quelque chose Que de cet incident par la ville on ne cause.
LE NOTAIRE.	LE NOTAIRE.
Et bien il eſt aisé d’empeſcher cét éclat, Etronpeur eniceret rane voltle contract.	Et bien il est aisé d'empêcher cet éclat, Etronpeur eniceret rane voltle contract.
ARNOLPHE ſans le voir.	ARNOLPHE sans le voir.
Mais comment faudra-il qu’auec elle jen forte?	Mais comment faudra-il qu'avec elle jen forte?
LE NOTAIRE.	LE NOTAIRE.
Le doüaire ſe regle au bien qu’on vous apporte.	Le douaire se règle au bien qu'on vous apporte.
ARNOLPHE ſans le voir.	ARNOLPHE sans le voir.
Ie l’ayme, & cét amour eſt mon grand embarras.	Je l'aime, et cet amour est mon grand embarras.
LE NOTAIRE On peut auantager vne femme en ce cas.	LE NOTAIRE On peut avantager une femme en ce cas.
ARNOLPHE ſans le voir.	ARNOLPHE sans le voir.
Quel traitemenr luy faire en pareille auanture?	Quel traitemenr lui faire en pareille aventure?
LE NOTAIRE.	LE NOTAIRE.
Portire eit que le futur doit doüer la future Du tiers du dot qu'elle a, mais cét ordre n’eſt riem Et l’on va plus auant lors que l’on le veut bien.	Portire eit que le futur doit douer la future Du tiers du dot qu'elle a, mais cet ordre n'est rièm Et l'on va plus avant lors que l'on le veut bien.
Si.	Si.
ARNOLPHE ſans le voir	ARNOLPHE sans le voir
LE NOTAIRE.	LE NOTAIRE.
Arnolphe l’apperceuant.	Arnolphe l'apercevant.
Pour le preciput il les regarde enſemble, Ie dis que le futur peut comme bon luy ſemble Doüer la future.	Pour le préciput il les regarde ensemble, Je dis que le futur peut comme bon homme semble Douer la future.
ARNOLPHE l’ayant apperçeu.	ARNOLPHÉ l'ayant aperçu.
Eun.	Eun.
LE NOTAIRE.	LE NOTAIRE.
Il peut l’auantager Lors qu’il l’ayme beaucoup & qu’il veur l’obliger.	Il peut l'avantager Lors qu'il l'aime beaucoup et qu'il veut l'obliger.
Et cela par doüaire, ou préfix qu’on appelle, Qui demeure perdu par le treſpas d’icelle, Ou ſans retour, qui va de ladite à ſes hoirs, Ou Couſtumier, ſelon les differens vouloirs, Ou par donation dans le Contract formelle, Qu’on fait, ou pure & ſimple, ou qu’on fait mutuelle;	Et cela par douaire, ou préfix qu'on appelle, Qui demeure perdu par le trépas d'icelle, Ou sans retour, qui va de ladite à ses hoirs, Ou Coustumier, selon les différents vouloirs, Ou par donation dans le Contrat formelle, Qu'on fait, ou pure et simple, ou qu'on fait mutuelle;
Pourquoy hauſſer le dos?	Pourquoi hausser le dos?
eſt-ce qu’on parle en fat, Et que l’on ne ſçait pas les formes d’vn Contract?	est-ce qu'on parle en fat, Et que l'on ne sait pas les formes d'un Contrat?
Qui me les apprendra?	Qui me les apprendra?
perſonne;	personne;
ie preſume.	Ne presume.
Sçais-je pas qu’eſtant joints on eſt par la Couſtume, Communs en meubles, biens, immeubles & conqueſts, A moins que par vn Acte on y renonce exprés?	Sais-je pas qu'étant joints on est par la Coutume, Communs en meubles, biens, immeubles et conquêts, À moins que par un Acte on y renonce exprès?
Sçay-je pas que le tiers du bien de la future aamera am vommmlladie pou sss.	Sais-je pas que le tiers du bien de la future aamera am vommmlladie pou suss.
ARNOLPHE.	ARNOLPHÉ.
Oüy, c'eſt choſe ſeure, Vous ſçauez tout cela, mais qui vous en dit mot?	Oui, c'est chose sûre, Vous savez tout cela, mais qui vous en dit mot?
LE NOTAIRE.	LE NOTAIRE.
rous qui ii pretendez faire paſſer pour ſot, En me hauſſant l’eſpaule, & faiſant la grimace.	rous qui ji prétendez faire passer pour sot, En me haussant l'épaule, et faisant la grimace.
AEHAGLIIAE.	AEHAGLIIAE.
La peſte ſoit fait l’homme, & ſa chienne de face.	La peste soit fait l'homme, et sa chienne de face.
Adieu.	Adieu.
C’eſt le moyen de vous faire finir.	C'est le moyen de vous faire finir.
LE NOTAIRE.	LE NOTAIRE.
Pour dreſſer vn Contract m’a-t’on pas fait venir?	Pour dresser un Contrat m'a-t-on pas fait venir?
ARNOLPHE.	ARNOLPHÉ.
Ouy, ie vous ay mandé:	Oui, Seigneur vous ai mandé:
mais la choſe eſt remiſe, Et l’on vous mandera quand l’heure ſera priſe.	mais la chose est remise, Et l'on vous mandera quand l'heure sera prise.
rojenaſter Dlabie d nomme auec ſon entretien?	rojenâter Dlabie d nomme avec son entretien?
LE NOTAIRE.	LE NOTAIRE.
Ie penſe qu’il en tient, & ie croy penſer bien.	Je pense qu'il en tient, et je crois penser bien.
SCENE III.	SCÈNE III.
LE NOTAIRE, ALAIN, GEORGETTE, ARNOLPHE.	LE NOTAIRE, ALAIN, GEORGETTE, ARNOLPHÉ.
XVT LE NOTAIRE.	XVT LE NOTAIRE.
Eſtes-vous pas venu querir pour voſtre.	Êtes-vous pas venu quérir pour vôtre.
Maiſtre ?	Maître ?
Oüy.	Oui.
ALAIN.	ALAIN.
LE NOTAIRE.	LE NOTAIRE.
I’ignore pour qui vous le pouuez connoiſtre:	J'ignore pour qui vous le pouvez connaître:
Mais allez de ma part luy dire de ce pas Que c’eſt vn fou fieffé.	Mais allez de ma partyeux dire de ce pas Que c'est un fou fieffé.
GEORGETTE.	GEORGETTE.
Nous n’y manquerons pas.	Nous n'y manquerons pas.
C v	Ç vit
SCENE IV ALAIN, GEORGETTE, ARNOLPHE.	SCÈNE IV ALAIN, GEORGETTE, ARNOLPHE.
M ARNOLPHE.	M MRNOLPHÉ.
Approchez-vous, vous eſtes mes fidelles.	Approchez-vous, vous êtes mes fidèles.
Mes bons, mes vrays amis, & i’en ſçay des nouuelles.	Mes bons, mes vrais amis, et j'en sais des nouvelles.
Le Notaire.	Le Notaire.
ALAIN.	ALAIN.
ARNOLPHE.	ARNOLPHÉ.
Laiſſons, c’eſt pour quelqu’autre iour.	Laissons, c'est pour quelque autre jour.
On veut à mon honneur joüer d’vn mauuaîs tour:	On veut à mon honneur jouer d'vn mauvais tour:
Et quel affront pour vous mes enfans pourroit-c’eſtre, Si l’on auoit oſté l’honneur à voſtre Maiſtre?	Et quel affront pour vous mes enfants pourrait-ce être, Si l'on avait ôté l'honneur à votre Maître?
Vous n’oſeriez aprés paroiſtre en nul endroit, Et chacun vous voyant vous monſtreroit au doigt:	Vous n'oseriez après paraître en nul endroit, Et chacun vous voyant vous montrerait au doigt:
Donc puiſqu’autant que moy l’affaire vous regarde, Il faut de voſtre part faire vne telle garde Que ce galand ne puiſſe en aucune façon.	Donc puisqu'autant que moi l'affaire vous regarde, Il faut de votre part faire une telle garde Que ce galant ne puisse en aucune façon.
GEORGETTE.	GEORGETTE.
Vous nous auez tantoſt monſtré noſtre le çon.	Vous nous avez tantôt montré notre le çon.
ARNOLPHE.	ARNOLPHÉ.
Mais à ſes beaux diſcours gardez-bien de vous rendre.	Mais à ses beaux discours gardez-bien de vous rendre.
ALAIN.	ALAIN.
Oh vrayment.	Oh vraiment.
GEORGETTE.	GEORGETTE.
Nous ſçauons commen lauts en deffendre.	Nous sçauons commen lauts en défendre.
ARNOLPHE.	ARNOLPHÉ.
S’il venoit doucement.	S'il venait doucement.
Alain mon pauure cœur Par vn peu de ſecours ſoulage ma langueur.	Alain mon pauvre cœur Par un peu de secours soulage ma langueur.
ALAIN.	ALAIN.
Vous eſtes vn ſot.	Vous êtes un sot.
ARNOLPHE à Georgette.	ARNOLPHE à Georgette.
Bon.	Bon.
Georgette ma mignonne Tu me parois ſi douce, & ſi bonne perſonne.	Georgette ma mignonne Tu me parais si douce, et si bonne personne.
GEORGETIE.	GERGETIE.
Vous eſtes vn nigaut.	Vous êtes un nigaud.
MNNOLPHE -à Alain.	MNNOLPHÉ Alain.
Bon.	Bon.
Quel mal trouues-tu Dans vn denem hoſnente, & tout plen de vertu?	Quel mal trouves-tu Dans un denem hônente, et tout plen de vertu?
ALAIN.	ALAIN.
Vous eſtes vn fripon.	Vous êtes un fripon.
ARNOLPHE à Georgette.	ARNOLPHE à Georgette.
1 Fort bien.	1 Fort bien.
Ma mort eſt ſeure Si tu ne prens pitié des peines que j’endure.	Ma mort est sûre Si tu ne prends pitié des peines que j'endure.
GEORGETTE.	GEORGETTE.
Vous eſtes vn beneſt, vn impudent.	Vous êtes un benêt, un impudent.
ARNOLPHE.	ARNOLPHÉ.
Fort bien.	Fort bien.
Ie ne ſuis pas vn homme à vouloir rien pour rien, Ie ſçay quand on me ſert en garder la memoire:	Je ne suis pas un homme à vouloir rien pour rien, Je sais quand on me sert en garder la mémoire:
Cependant par auance, Alain voilà pour boire, Et vona pour t'auon, Gcorgette, vn cottillon, Ils tendent tous deux la main, & prennent l’argent.	Cependant par avance, Al voilà pour boire, Et von pour t'avon, Gcorgette, un cottillon, Ils tendent tous deux la main, et prennent l'argent.
Ce n’eſt de mes bien-faits qu’vn ſimple eſchãtillon, Toute la courtoiſie enfin dont ie vous preſſe, C’eſt que ie puiſſe voir voſtre belle Maiſtreſſe.	Ce n'est de mes bienfaits qu'un simple échantillon, Toute la courtoisie enfin dont ie vous presse, C'est que je puisse voir votre belle Maîtresse.
GEORGETTE le pouſſant.	GEORGETTE le poussant.
A d’autres.	À d'autres.
ARNOLPHE.	ARNOLPHÉ.
Bon cela.	Bon cela.
ALAIN le pouſſant.	ALAIN le poussant.
Hors d’icy.	Hors d'ici.
ALNOLPHE.	ÀLNOLPHÉ.
Bon.	Bon.
GHORGMHE le pouſſant.	GHORGMHE le poussant.
Mais toſt.	Mais tôt.
ANNOLTHE.	ANNOLTHÉ.
Bon.	Bon.
Hola, c’eſt aſſez.	Holà, c'est assez.
GEORGETTE.	GEORGETTE.
Fais-je pas comme il faut?	Fais-je pas comme il faut?
ALAIN.	ALAIN.
Eſt-ce de la façon que vous voulez l’entendre?	Est-ce de la façon que vous voulez l'entendre?
AAROBIIIE.	AAROBIIE.
Oüy, fort bien, hors l’argent qu’il ne falloit pas prendre.	Oui, fort bien, hors l'argent qu'il ne fallait pas prendre.
GEORGETTE.	GEORGETTE.
Nous ne nous ſommes pas ſouuenus de ce point.	Nous ne nous sommes pas souvenus de ce point.
ALAIN.	ALAIN.
Voulez-vous qu'a lilitant lous fecommnençions,	Voulez-vous qu'a litant lous fecommnençions,
ARNOLPHE.	ARNOLPHÉ.
Suffit, rentrez tous deux.	Suffit, rentrez tous deux.
Point.	Point.
ALAIN.	ALAIN.
Vous n’auez rien qu’à dire	Vous n'avez rien qu'à dire
ARNOLPHE.	ARNOLPHÉ.
Non, vous, dis-je, rentrez, puis que ie le deſire.	Non, non, dis-je, rentrez, puis que sans le désire.
Ie vous laiſſe l’argent, allez, ie vous rejoins, Ayez bien l’œil à tout, & ſecondez mes ſoins.	Je vous laisse l'argent, allez, je vous rejoins, Ayez bien l'œil à tout, et secondez mes soins.
O d Men V	Ô d Men V
ARNOLPHE.	ARNOLPHÉ.
E veux pour eſpion qui ſoit d’exacte veuë, Prendre le Sauetier du coin de noſtre ruë;	E veux pour espion qui soit d'exacte vue, Prendre le Savetier du coin de notre rue;
Dans la maiſon touſiours ie pretends la tenir, Y faire bonne garde, & ſur tout en bannir Vendeuſes de Ruban, Perruquieres, Coiffeuſes, Faiſeuſes de Mouchoirs, Gantieres, Reuendeuſes, Tous ces gẽs qui ſous main trauaillent chaque iour, A faire reüſſir les myſteres d’amour;	Dans la maison toujours avoir prétends la tenir, Y faire bonne garde, et sur tout en bannir Vendeuses de Ruban, Perruquières, Coiffeuses, Faiseuses de Mouchoirs, Gantes, Revendeuses, Tous ces gendres qui sous main travaillent chaque jour, À faire réussir les mystères d'amour;
Enfin i’ay veu le monde, & i’en ſçay les fineſſes, Il faudra que mon homme ait de grandes addreſſes, ormneffage ou Poulet de ſa part peut entrer.	Enfin j'ai vu le monde, et j'en sais les finesses, Il faudra que mon homme ait de grandes adresses, ormneffage ou Poulet de sa part peut entrer.
SCENE VI.	SCÈNE VI.
HORACE, ARNOLPHE.	HORACE, ARNOLPHÉE.
HORACE.	HORACE.
A place m'eſt heureuſe à vous y rencontrer, LIe viens de l’eſchapper bien belle ie vous iure, Au ſortir d’auec vous ſans preuoir l’auanture, Seule dans ſon balcon i’ay veu paroiſtre Agnés, Qui des arbres prochains prenoit vn peu le frais,	A place m'est heureuse à vous y rencontrer, LIe viens de l'échapper bien belle Je vous jure, Au sortir d'avec vous sans prévoir l'aventure, Seule dans son balcon j'ai vu paraître Agnès, Qui des arbres prochains prenait un peu le frais,
Aprés m’auoir fait ſigne, elle aſceu faire en ſorte Deſcendant au iardin de m’en ouurir la porte;	Après m'avoir fait signe, elle ascever faire en sorte Descendant au jardin de m'en ouvrir la porte;
Mais à peine tous deux dans ſa chambre eſtions nous, Qu'elle à ſur les degrez entendu ſon ialoux, Et tout ce qu’elle a pû dans vn tel acceſſoire, C’eſt de me renfermer dans vne grande armoire, Il eſt entré d’abord;	Mais à peine tous deux dans la chambre étions -nous, Qu'elle a sur les degré entendu son jaloux, Et tout ce qu'elle a pu dans un tel accessoire, C'est de me renfermer dans une grande armoire, Il est entré d'abord;
ie ne le voyois pas, Mais ie l’oyois marcher ſans rien dire à grands pas;	Ne ne le voyais pas, Mais ainsi l'oyais marcher sans rien dire à grands pas;
Pouſſant de temps en temps des ſoupirs pitoyables, Et donnant quelquefois de grands coups ſur les tables, Frapant vn petit chien qui pour luy s’émouuoit, Et iettant bruſquement les hardes qu’il trouuoit, Il a meſme caſſé d’vne main mutinée, Des vaſes dont la belle ornoit ſa cheminée, Et ſans doute il faut bien qu’à ce becque cornu, Du trait qu’elle a ioüé quelque iour ſoit venu, Enfin aprés cent tours ayant de la maniere, Sur ce qui n’en peut mais déchargé ſa colere, Mon ialoux inquiet ſans dire ſon ennuy, Eſt ſorty de la chambre, & moy de mon eſtuy, Nous n’auons point voulu de peur du perſonnage, Riſquer à nous tenir enſemble dauantage, C'eſtoit trop hazarder;	Poussant de temps en temps des soupirs pitoyables, Et donnant quelquefois de grands coups sur les tables, Frappant un petit chien qui pour lui s'émouuoit, Et jetant brusquement les hardes qu'il trouvait, Il a été cassé d'une main mutinée, Des vases dont la belle ornait sa cheminée, Et sans doute il faut bien qu'à ce bec cornu, Du trait qu'elle a joué quelque jour soit venu, Enfin après cent tours ayant de la manière, Sur ce qui n'en peut mais déchargé sa colère, Mon jaloux inquiet sans dire son ennui, Est sorti de la chambre, et moi de mon et, Mo y, et mo de peur du personnage, N' a nous tenir ensemble dauantage, C'estoit trop hazarder;
mais ie dois cette nuit, Dans ſa chambre vn peu tard m’introduire ſans bruit, En touſſant par trois fois ie me feray connoiſtre, Et ie dois au ſignal voir ouurir la feneſtre, Dont auec vne échelle, & ſecondé d’Agnes, Mon amour taſehera de me gagner l’accés, Comme à mon ſeul amy ie veux bien vous l’apprendre, L’allegreſſe du cœur s’augmente à la reſpandre, Et gouſtaſt-on cent fois vn bon-heur co parfait, On n’en eſt pas content ſi quelqu’vn ne le ſçait, Vous prendrez part ie penſe à l’heur de mes affaires Adieu ie vais ſonger aux choſes neceſſaires.	mais petit dois cette nuit, Dans sa chambre un peu tard m'introduire sans bruit, En toussant par trois fois ie me ferai connaître, Et ainsi dois au signal voir ouvrir la fenêtre, Dont apprîne échelle, et secondé d'Agnès, Mon amour tasehera de me gagner l'accès, Comme à mon seul amy ie veux bien vous l'apprendre, L'allégresse du cœur s'augmente à la répandre, Et goûtât-on cent fois un bonheur co parfait, On n'en est pas content si quelqu'un ne le sait, Vous prendrez part ie pense à l'heur de mes affaires Au ie vais songer aux ne vais.
SCENE VIL	SCÈNE VIL
ARNOLPHE.	ARNOLPHÉ.
Voy?	Vois?
l’aſtre qui s’obſtine à me deſeſperer,  Ne me donnera pas le temps de reſpirer, Coup ſur coup ie verray par leur intelligence, De mes ſoins vigilans confondre la prudence, Et ie ſeray la dupe en ma maturité, D’vne ieune innocente, & d’vn ieune euenté, En ſage Philoſophe on m’a veu vingt années, Contempler des maris les triſtes deſtinées, Et m’inſtruire auec ſoin de tous les accidens, Qui font dans le mal-heur tomber les plus prudens, Des diſgraces d’autruy profitant dans mon ame, I’ay cherché les moyens voulant prendre vne femme, De pouuoir garantir mon ftont de tous affronts, Et le tirer de pair d’auec les autres fronts, Pour ce noble deſſein i’ay creu mettre en pratique, Tout ce que peut trouuer l’humaine Politique, Et comme ſi du ſort il eſtoit arreſté, Que nul homme icy bas n’en ſeroit exempté, Aprés l’experience, & toutes les lumieres, Que i’ay pû m’acquerir ſur de telles matieres, Aprés vingtans & plus, de meditation, Pour me conduire en tout auec precaution, De tant d’autres maris i’aurois quitté la trace, Pour me trouuer aprés dans la meſme diſgrace.	l’astre qui s'obstine à me désespérer, Ne me donnera pas le temps de respirer, Coup sur coup homme verrai par leur intelligence, De mes soins vigilans confondre la prudence, Et ainsi serai la dupe en ma maturité, D'une jeune innocente, et d'un jeune éventé, En sage Philosophe on m'a vu part années, Contempler des maris les tes destinées, Et m'instruire avec soin de tous les accidents, Qui font dans le malheur tomber les plus prudents, Des disgrâces d'autrui profitant dans mon âme, Yay cherché les on voulant pr femme, De pouuoir garantir mon ftont de tous affronts, Et le tirer de a auec les autres fronts, Pour ce noble dessein ay creu m en pratique, Tout ce que peut trouuer humaine Politique, Et comme si du sort il estoit arresté, Que nul me bas en seroit exempté, Aprés expérience, et toutes les lumières, Que j'a y sur de telles mer, Aprés vingtans et plus, de méditation, Pour me conduire en j' a y, De tant autres m aurois quitté la trace, Pour me trouuer aprés dans la même disgrace.
Ah bourreau de deſtin vous en aurez menty, De l’obiet qu’on pourſuit, ie ſuis encor nañty, Si ſon cœur m’eſt volé par ce blondin funeſte, I'empeſcheray du moins qu’on s’empare du reſte Et cette nuit qu’on prend pour ce galand exploit, Ne ſe paſſera pas ſi doucement qu’on croit, Ce m’eſt quelque plaiſir parmy tant de triſteſſe, Que l’on me donne auis du piege qu’on me dreſſe.	Ah bourreau de destin vous en aurez menti, De l'objet qu'on poursuit, avec suis encor nañty, Si son cœur m'est volé par ce blondin funeste, J'empêcherai du moins qu'on s'empare du reste Et cette nuit qu'on prend pour ce galant exploit, Ne se passera pas si doucement qu'on croit, Ce m'est quelque plaisir parmi tant de tristesse, Que l'on me donne avis du piège qu'on me dresse.
Et que cét eſtourdy qui veut m’eſtre fatal, Faſſe ſonconfident de ſon propre Riual.	Et que cet étourdi qui veut m'être fatal, Fasse sonconfident de son propre Rival.
SCENE VIII.	SCÈNE VIII.
CHRISALDE, ARNOLPHE.	CHRISALDE, ARNOLPHÉE.
CHRISALDE.	CHRISALDE.
T bien, ſouperons-nous auant la promede?	T bien, souperons-nous avant la promède?
ARNOLPHE.	ARNOLPHÉ.
Aton, le neuille ce loll.	Atton, le neuille ce loll.
CHRISALDE.	CHRISALDE.
D'où vient cette boutade?	D'où vient cette boutade?
ARNOLPHE.	ARNOLPHÉ.
De grace excuſez-moy, i’ay quelqu’autre embarras.	De grâce excusez-moi, j'ai quelque autre embarras.
CHRIS’ALDE, Voſtre hymen reſolu ne ſe fera-t’il pas?	CHRIS'ALDE, Votre hymen résolu ne se fera-t-il pas?
ARNOLPHE.	ARNOLPHÉ.
C’eit trop sinquieter des afaires des autres.	C'it trop sinquiéter des afaires des autres.
CHRISALDE.	CHRISALDE.
Oh, oh, ſi bruſquement?	Oh, oh, si brusquement?
quels chagrins ſont les voſtres?	quels chagrins sont les vôtres?
Seroit-il point, compere, à voſtre paſſion, Aiilue queique peu detioulacion.	Serait-il point, compère, à votre passion, Ajilue queique peu détioulacion.
Ie le iurerois preſque à voir voſtre viſage.	Je le jurerais presque à voir votre visage.
ARNOLPHE.	ARNOLPHÉ.
Quoy qu’il m’arriue au moins auray-ie l’auantage, De ne pas reſſembler à de certaines gens, Qui ſouffrent doucement l’approche des galans.	Quo qu’il m'arrive au moins aurai-je l'avantage, De ne pas ressembler à de certaines gens, Qui souffrent doucement l'approche des galants.
CHRISALDE.	CHRISALDE.
C’eſt vn eſtrange fait qu’auec tant de lumieres.	C'est un étrange fait qu'avec tant de lumières.
Vous vous effarouchiez touſiours ſur ces matieres, Qu’en cela vous mettiez le ſouuerain bon-heur, Et ne conceuiez point au monde d’autre honneur, Eſtre auare, brutal, fourbe, meſchant, & laſche, N'eſt rien à voſtre auis auprés de cette tache, Et de quelque facon qu’on puiſſe auoir veſcu, On eſt homme d’honneur quand on n’eſt point cocu.	Vous vous effarouchiez toujours sur ces matières, Qu'en cela vous mettiez le souverain bonheur, Et ne conceviez point au monde d'autre honneur, Être avare, brutal, fourbe, méchant, et lâche, N'est rien à votre avis auprès de cette tache, Et de quelque façon qu'on puisse avoir vécu, On est homme d'honneur quand on n'est point cocu.
A le bien prendre au fond, pourquoy voulez vous croire, Que de ce cas fortuit dépende noſtre gloire?	À le bien prendre au fond, pourquoi voulez -vous croire, Que de ce cas fort dépende notre gloire?
Et qu’vne ame bien née ait à ſe reprocher, L’iniuſtice d’vn mal qu’on ne peut empeſcher?	Et qu'une âme bien née ait à se reprocher, L'injustice d'un mal qu'on ne peut empêcher?
Pourquoy voulez-vous, dis-ie en prenant vne fẽme, Qu’on ſoit digne à ſon choix de loüange ou de blaſme, Et qu’on s’aille former vn monſtre plein d’effroy, De l’afftont que nous fait ſon manquement de foy?	Pourquoi voulez-vous, dis-je en prenant une femme, Qu'on soit digne à son choix de louange ou de blâme, Et qu'on s'aille former un monstre plein d'effroi, De l'afftont que nous fait son manquement de foi?
Mettez-vous dans l’eſprit qu’on peut du cocuage, Se faire en galand homme vne plus douce image,	Mettez-vous dans l'esprit qu'on peut du cocuage, Se faire en galant homme une plus douce image,
Que des coups du hazard aucun n’eſtant garant, Cet accident de ſoy doit eſtre indifferend, Et qu’enfin tout le mal quoy que le monde gloſe, N’eſt que dans la facon de receuoir la choſeU-Gar-pour ſe bien conduire en ces difficultez.	Que des coups du hasard aucun n'étant garant, Cet accident de soi doit être indifférend, Et qu'enfin tout le mal quoi que le monde glose, N'est que dans la façon de recevoir la choseU-Gar-pour se bien conduire en ces difficultés.
Il y faut comme en tout fuïr les extremitez, N’imiter pas ces gens vn peu trop débonnaires Qui tirent vanité de ces ſortes d’affaires;	Il y faut comme en tout fuir les extrémités, N'imiter pas ces gens un peu trop débonnaires Qui tirent vanité de ces sortes d'affaires;
De leurs femmes toûjours vont citant les galans En font par tout l’éloge, & proſnent leurs talens.	De leurs femmes toujours vont citant les galants En font par tout l'éloge, et prônent leurs talents.
Teſmoignent auec eux d’eſtroites ſimpathies, Sont de tous leurs cadeaux, de toutes leurs parties:	Témoignent avec eux d'étroites sympathies, Sont de tous leurs cadeaux, de toutes leurs parties:
Et font qu’auec raiſon les gens ſont eſtonnez, De voir leur hardieſſe à montrer là leur nez Ce procedé ſans doute eſt tout à fait blâmable.	Et font qu'avec raison les gens sont étonnés, De voir leur hardiesse à montrer là leur nez Ce procédé sans doute est tout à fait blâmable.
Mais l’autre extrémité n’eſt pas moins condamnable, Si ie n’approune pas ces amis des galans, Ie ne ſuis pas auſſi pour ces gens turbulens, Dont l’imprudent chagrin qui tempeſte & qui gronde, Attire au bruit qu’il fait les yeux de tout le monde;	Mais l'autre extrémité n'est pas moins condamnable, Si tu n'approune pas ces amis des galants, Je ne suis pas aussi pour ces gens turbulents, Dont l'imprudent chagrin qui tempête et qui gronde, Attire au bruit qu'il fait les yeux de tout le monde;
Et qui par cét éclat ſemblent ne pas vouloir Qu’aucun puiſſe ignorer ce qu’ils peuuent auoir.	Et qui par cet éclat semblent ne pas vouloir Qu'aucun puisse ignorer ce qu'ils peuvent avoir.
Entre ces deux partis il en eſt vn honneſte, Où dans l’occaſion l’homme prudent s’arreſte, Et quand on le ſçait prendre on n’a point à rougir, Du pis dont vne lemne auec nous puiſſe agir.	Entre ces deux partis il en est un honnête, Où dans l'occasion l'homme prudent s'arrête, Et quand on le sait prendre on n'a point à rougir, Du pis dont une lemne mène nous puisse agir.
Quoy qu’on en puiſſe dire, enfin le cocuage Sous des traits moins affreux aisément s’enuiſage:	Quoi qu'on en puisse dire, enfin le cocuage Sous des traits moins affreux aisément s'envisage:
Et comme ie vous dis, toute l’habilité, Ne va qu’à le ſçauoir tourner du bon coſté.	Et comme ici vous dis, toute l'habileté, Ne va qu'à le savoir tourner du bon côté.
ARNOLPHE.	ARNOLPHÉ.
Aprés ce beau diſcours toute la confrerie, Doit vn remerciment à voſtre Seigneurie;	Après ce beau discours toute la confrérie, Doit un remerciment à votre Seigneurie;
Et quiconque voudra vous entendre parler, Montrera de la ioye à s’y voir enroller.	Et quiconque voudra vous entendre parler, Montrera de la joie à s'y voir enrôler.
CHRISALDE.	CHRISALDE.
Ie ne dis pas cela, car c’eſt ce que ie blaſme:	Je ne dis pas cela, car c'est ce que ici blâme:
Mais comme c’eſt le ſort qui nous donne vne femme, Ie dis que l’on doit faire ainſi qu’au jeu de dez, Où s’il ne vous vient pas ce que vous demandez.	Mais comme c'est le sort qui nous donne une femme, Je dis que l'on doit faire ainsi qu'au jeu de dés, Où s'il ne vous vient pas ce que vous demandez.
Il faut joüer d’adreſſe, & d’vne ame reduite, Corriger le hazard par la bonne conduite.	Il faut jouer d'adresse, et d'une âme réduite, Corriger le hasard par la bonne conduite.
ARNOLPHE.	ARNOLPHÉ.
C’eſt à dire dormir, & manger toûjours bien, Et ſe perſuader que tout cela n’eſt rien.	C'est -à -dire dormir, et manger toujours bien, Et se persuader que tout cela n'est rien.
CHRISALDE.	CHRISALDE.
Vous penſez-vous mocquer, mais à ne vous rien feindre, Dans le monde ie voy cent choſes plus à craindre, Et dont ie me ferois vn bien plus grand mal-heur, Que de cét accident qui vous fait tant de peur.	Vous pensez-vous moquer: mais à ne vous rien feindre, Dans le monde ici co cent choses plus à craindre, Et dont belle me ferais un bien plus grand malheur, Que de cet accident qui vous fait tant de peur.
Penſez-vous qu’à choiſir de deux choſes preſcrites, Ie n’aimaſſe pas mieux eſtre ce que vous dites, Que de me voir mari de ces femmes de bien, Dont la mauuaiſe humeur fait vn procés ſur rien.	Pensez-vous qu'à choisir de deux choses prescrites, Je n'aimasse pas mieux être ce que vous dites, Que de me voir mari de ces femmes de bien, Dont la mauvaise humeur fait un procès sur rien.
Ces dragons de vertu ces honneſtes Diableſſes, Se retranchant touſiours ſur leurs ſages proüeſſes, Qui pour vn petit tort qu’elles ne nous font pas, Prennent droit de traiter les gens de haut en bas, Et veulent ſur le pied de nous eſtre fidelles, Que nous ſoyons tenus à tout endurer d’elles:	Ces dragons de vertu ces honnêtes Diablesses, Se retranchant toujours sur leurs sages prousses, Qui pour un petit tort qu'elles ne nous font pas, Prennent droit de traiter les gens de haut en bas, Et veulent sur le pied de nous être fidelles, Que nous soyons tenus à tout endurer d'elles:
Encor vn coup Compere, apprenez qu’en effet, Le cocuage n’eſt que ce que l’on le fait, Qu’on peut le ſouhaiter pour de certaines cauſes, Et qu’il a ſes plaiſirs comme les autres choſes.	Encor un coup Compère, apprenez qu'en effet, Le cocuage n'est que ce que l'on le fait, Qu'on peut le souhaiter pour de certes causes, Et qu'il a ses plaisirs comme les autres choses.
ARNOLPHE.	ARNOLPHÉ.
Si vous eſtes d’humeur à vous en contenter?	Si vous êtes d'humeur à vous en contenter?
Quant à moy ce n’eſt pas la mienne d’en tâter:	Quant à moi ce n'est pas la mienne d'en tâter:
Et pluſtoſt que ſubir vne telle auanture.	Et plutôt que subir une telle aventure.
CHRISALDE.	CHRISALDE.
Mon Dieu ne jurez point de peur d’eſtre parjure;	Mon Dieu ne jurez point de peur d'être parjure;
or le foit l'a regle, vou loms ſont ſuperflus Et l’on ne prendra pas voſtre auis là deſſus.	or le soit l'a règle, vou loms sont superflus Et l'on ne prendra pas votre avis là -dessus.
ARNOLPHE.	ARNOLPHÉ.
Moy!	Moi!
ie ſerois cocu?	On serais cocu?
CHRISALDE.	CHRISALDE.
Vous voilà bien malade;	Vous voilà bien malade;
Mille gens le ſont bien ſans vous fuirt brtuade;	Mille gens le sont bien sans vous fuirt brtuade;
Qui de mine, de cœur, de biens & de maiſon, Ne feroient auec vous nulle comparaiſon.	Qui de mine, de cœur, de biens et de maison, Ne feraient avec vous nulle comparaison.
ARNOLPHE.	ARNOLPHÉ.
Et moy ie n’en voudrois auec eux faire aucune:	Et moi ici n'en voudrais aprè eux faire aucune:
Mais cette raillerie en vn mot m’importune.	Mais cette raillerie en un mot m'importune.
Briſons-là, s’il vous plaiſt.	Brisons-là, s'il vous plaît.
CHRISALDE.	CHRISALDE.
Vous eſtes en courroux, Nous en içaurolis la cauſe;	Vous êtes en courroux, Nous en iaurolis la cause;
Adieu louuenez-vous;	Adieu louvenez-vous;
Quoy que ſur ce ſuiet voſtre honneur vous inſpire, Que c’eſt eſtre à demy ce que l’on vient de dire:	Quo que sur ce sujet votre honneur vous inspire, Que c'est être à demi ce que l'on vient de dire:
Que de vouloir jurer qu’on ne le ſera pas.	Que de vouloir jurer qu'on ne le sera pas.
ARNOLPHE.	ARNOLPHÉ.
Moy!	Moi!
ie le jure encore, & ie vais de ce pas, Contre cét accident trouuer vn bon remede.	Ce le jure encore, et ainsi vais de ce pas, Contre cet accident trouver un bon remède.
SCENE IX.	SCÈNE IX.
ALAIN, GEORGETTE, ARNOLPHE.	ALAIN, GEORGETTE, ARNOLPHÉ.
ARNOLPHE.	ARNOLPHÉ.
Es amis, c’eſt icy que j’implore voſtre aide, M Ie ſuis édifié de voſtre affection;	Es amis, c'est ici que j'implore votre aide, M Ie suis édifié de votre affection;
Mais il faut qu’elle éclate en cette occaſion:	Mais il faut qu'elle éclate en cette occasion:
Et ſi vous m’y ſeruez ſelon ma confiance, Vous eſtes aſſeurez de voſtre recompenſe.	Et si vous m'y servez selon ma confiance, Vous êtes assurés de votre récompense.
L’homme que vous ſçauez, n’en faites point de bruit, Veut comme ie l'ay ſceu m’attraper cette nuit, Dans la chambre d’Agnés entrer par eſcalade, Mais il luy faut nous trois dreſſer vne embuſcade:	L'homme que vous savez, n'en faites point de bruit, Veut comme ie l'ai su m'attraper cette nuit, Dans la chambre d'Agnès entrer par escalade, Mais il lui faut nous trois dresser une embuscade:
Ie veux que vous preniez chacun vn bon baſton, Et quand il ſera prés du dernier eſchelon;	Je veux que vous preniez chacun vn bon bâton, Et quand il sera près du dernier échelon;
Car dans le temps qu’il faut i’ouuriray la feneſtre, Que tous deux à l’enuy vous me chargiez ce traître?	Car dans le temps qu'il faut j'ouvrirai la fenêtre, Que tous deux à l'envi vous me chargiez ce traître?
mlaro d’vn an dont lon dos garde le rouuciiir, Et qui lui puiſſe apprendre à n’y plus reuenir, Sans me nommer pourtant en aucune maniere, Ni faire aucun ſemblant que ie ſeray derriere.	mlaro d'Han dont lon dos garde le rouuciiir, Et qui lui puisse apprendre à n'y plus revenir, Sans me nommer pourtant en aucune manière, Ni faire aucun semblant que sans serai derrière.
Aurez-vous bien l’eſprit de ſeruir mon couroux?	Auriez-vous bien l'esprit de servir mon courroux?
ALAIN.	ALAIN.
S’il ne tient qu’à frapper, Monſieur, tout eſt à nous, Vous verrez, quand ie bas, ſi i’y vais de main-morte.	S'il ne tient qu'à frapper, Monsieur, tout est à nous, Vous verrez, quand ie bas, si j'y vais de main-morte.
GEORGETTE.	GEORGETTE.
La mieune, quoy qu’aux yeux, elle n’eſt pas ſi forte.	La mieune, quoi qu'aux yeux, elle n'est pas si forte.
N’en quitte pas ſa part à le bien eſtriller.	N'en quitte pas sa part à le bien étriller.
ARNOLPHE Rentrez-donc, & ſur tout gardez de babiller;	ARNOLPHE Rentrez-donc, et sur tout gardez de babiller;
Voilà pour le prochain vne leçon vtile, Et ſi tous les Maris qui ſont en cette Ville, De leurs Femmes ainſi receuoient le Galand, Le nombre des Cocus ne ſeroit pas ſi grand.	Voilà pour le prochain mieux leçon utile, Et si tous les Maris qui sont en cette Ville, De leurs Femmes ainsi recevaient le Galant, Le nombre des Cocus ne serait pas si grand.
Fin du quatriéme Acte.	Fin du quatrième Acte.
LCTEV	LCTEU
SCENE PREMIERE.	SCÈNE PREMIÈRE.
CIAT ALAIN, GEORGETTE, ARNOLPHE.	CIAT ALAIN, GEORGETTE, ARNOLPHE.
A OLPHE.	À OLPHÉ.
*T Raiſtres, qu’auez-vous fait par cette violence?	*T Raîtres, qu'avez-vous fait par cette violence?
ALAIN.	ALAIN.
Nous vous auons rendu, Monſieur, obeiſſance.	Nous vous avons rendu, Monsieur, obéissance.
ARNOLPHE.	ARNOLPHÉ.
De cette excuſe en vain vous voulez vous armer.	De cette excuse en vain vous voulez vous armer.
L’ordre eſtoit de le battre, & non de l’aſſommee;	L'ordre était de le battre, et non de l'assommée;
Et c’eſtoit ſur le dos, & non pas ſur la teſte, Que i’auois commandé qu’on fiſt choir la tempeſte.	Et c'était sur le dos, et non pas sur la tête, Que j'avais commandé qu'on fît choir la tempête.
Ciel!	Ciel!
dans quel accident me iette icy le ſort?	dans quel accident me jette ici le sort?
Et que puis-ie reſoudre à voir cet homme mort?	Et que puis-je résoudre à voir cet homme mort?
Rentrez dans la maiſon;	Rentrez dans la maison;
& gardez de rien dire De cet ordre innocent que i’ay pû vous preſcrire, Le iour s’en va paroiſtre, & ie vais conſulter Comment dans ce malheur ie me dois comporter Helas!	et gardez de rien dire De cet ordre innocent que j'ai pu vous prescrire, Le jour s'en va paraître, et notre vais consulter Comment dans ce malheur Dieux me dois comporter Hélas!
que deuiendray-ie?	que deviendrai-je?
& que dira le pere, Lors qu’inopinément il ſçaura cette affaire?	et que dira le père, Lors qu'inopinément il saura cette affaire?
SCENE II.	SCÈNE II.
HORACE, ARNOLPHE.	HORACE, ARNOLPHÉE.
MORACE.	MORACE.
L faut que i’aille vn peu reconnoiſtre qui e'eſt.	L faut que j'aille un peu reconnaître qui e'est.
ARNOLPHE.	ARNOLPHÉ.
Euſt-on iamais preueu.	Eût-on jamais prévu.
Qui va là?	Qui va là?
s’il vous plaiſt.	s'il vous plaît.
134 HORACE.	134 HORACE.
C’eſt vous, Seigneur Arnolphe.	C'est vous, Seigneur Arnolphe.
ARNOLPHE.	ARNOLPHÉ.
Ouy shlais touo, »s,	Oui shlais touo, »s,
n1 HORACE.	n1 HORACE.
C’eſt Horace.	C'est Horace.
Ie m'en allois chez vous, vous prier d’vne grace, Vous ſortez bien matin.	Je m'en allais chez vous, vous prier d'une grâce. Vous sortez bien matin.
ARNOLPHE bas.	ARNOLPHE bas.
Quelle confuſion !	Quelle confusion !
Eſt-ce vn enchantement?	Est-ce un enchantement?
eſt-ce vne illuſion?	est-ce une illusion?
HORACE.	HORACE.
HORACE.	HORACE.
I'eſtois, à dire vray, dans vne grande peine;	J'étais, à dire vrai, dans une grande peine;
Et ie benis du Ciel la bonté ſouueraine, Qui fait qu’à poinct nommé ie vous rencontre ainſi.	Et ici bénis du Ciel la bonté souveraine, Qui fait qu'à point nommé Dieux vous rencontre ainsi.
Ie viens vous auertir que tout a reüſſi, Et meſme beaucoup plus que ie n’euſſe osé dire;	Je viens vous avertir que tout a réussi, Et même beaucoup plus que ie j'eusse osé dire;
Et par vn incident qui deuoit tout deſtruire.	Et par un incident qui devait tout détruire.
Ie ne ſçay point par où l’on a pû ſoupçonner Cette aſſignation qu’on m’auoit ſçeu donner:	Je ne sais point par où l'on a pu soupçonner Cette assignation qu'on m'avait su donner:
Mais eſtant ſur le poinct d’atteindre à la feneſtte I’ay, contre mon eſpoir, veu quelques gens paroiſtre, Qui ſur moy bruſquement leuant chacun le bras M’ont fait manquer le pied & tomber iuſqu’en bas;	Mais étant sur le point d'atteindre à la fenêtte J'ai, contre mon espoir, vu quelques gens paraître, Qui sur moi brusquement levant chacun le bras M'ont fait manquer le pied et tomber jusqu'en bas;
Et ma cheute aux deſpens de quelque meurtriſſeure, De vingt coups de baſton m’a ſauué l’auanture.	Et ma chute aux dépens de quelque meurtrissure, De vingt coups de bâton m'a sauvé l'aventure.
Ces gens-là, dont eſtoit ie penſe mon jaloux, Ont imputé ma cheute à l’effort de leurs coups, Et comme la douleur vn aſſez long eſpace M’a fait ſans remuër demeurer ſur la place, Ils ont creu tout de bon qu’ils m’auoient aſſommé, Et chacun d’eux s’en eſt auſſi-toſt allarmé.	Ces gens-là, dont était imaires mon jaloux, Ont imputé ma chute à l'effort de leurs coups, Et comme la douleur un assez long espace M'a fait sans remuer demeurer sur la place, Ils ont cru tout de bon qu'ils m'avaient assommé, Et chacun d'eux s'en est aussitôt alarmé.
I’entendois tout leur bruit dans le profond ſilence, L’vn l’autre ils s’accuſoient de cette violence, Et ſans lumiere aucune en querellant le ſort, Sont venus doucement taſter ſi i’eſtois mort.	J'entendais tout leur bruit dans le profond silence, L'autre l'autre ils s'accusaient de cette violence, Et sans lumière aucune en querellant le sort, Sont venus doucement tâter si j'étais mort.
Ie vous laiſſe à penſer ſi dans la nuit obſeure, I’ay d’vn vray trépaſſé ſceu tenir la figure.	Je vous laisse à penser si dans la nuit obsure, J'ai d'une vrai trépassé su tenir la figure.
Ils ſe ſont retirez auec beaucoup d’effroy;	Ils se sont retirés avec beaucoup d'effroi;
Et comme ie ſongeois à me retirer moy, De cette feinte mort la ieune Agnes eſnieuë Auec empreſſement eſt deuers moy venuë:	Et comme ici songeais à me retirer moi, De cette feinte mort la jeune Agnès esnieuë Avec empressement est devers moi venue:
Car les diſcours qu’entr’eux ces gens auoient tenus, luſques à ſon oreille eſtoient d’abord venus, Et pendant tout ce trouble eſtant moins obſeruée, Mais me trouuant ſans mal elle a fait éclatter Vn tranſport difficile à bien repreſenter.	Car les discours qu'entr'eux ces gens avaient tenus, lusques à son oreille étaient d'abord venus, Et pendant tout ce trouble étant moins observée, Mais me trouvant sans mal elle a fait éclater Un transport difficile à bien représenter.
Que vous diray-ie?	Que vous dirai-je?
enfin cette aymable perſonne A ſuiuy les conſeils que ſon amour luy donne.	enfin cette aimable personne A suivi les conseils que son amour Rome donne.
N’a plus voulu ſonger à retourner chez ſoy, Et de tout ſon deſtin s’eſt commiſe à ma foy.	N'a plus voulu songer à retourner chez soi, Et de tout son destin s'est commise à ma foi.
Conſiderez vn peu par ce trait d’innocence Où l’expoſe d’vn fou la haute impertinence;	Considérez un peu par ce trait d'innocence Où l'expose d'un fou la haute impertinence;
Et quels faſcheux perils elle pourroit courir, Si i’eſtois maintenant homme à la moins cherir?	Et quels fâcheux périls elle pourrait courir, Si j'étais maintenant homme à la moins chérir?
Mais d’vn trop pur amour mon ame eſt embrazée.	Mais d'âme trop pur amour mon âme est embrasée.
I’aimerois mieux mourir que l’auoir abuſée.	J'aimerais mieux mourir que l'avoir abusée.
Ie luy vois des appas dignes d’vn autre ſort, Et rien ne m’en ſçauroit ſeparer que la mort.	Je crois vois des appas dignes d'un autre sort, Et rien ne m'en saurait séparer que la mort.
Ie preuoy là-deſſus l’emportement d’vn pere:	Je prévois là-dessus l'emportement d'un père:
Mais nous prendrons le temps d’apaiſer ſa colere.	Mais nous prendrons le temps d'apaiser sa colère.
A des charmes ſi doux ie me laiſſe emporter, Et dans la vie, enfin, il ſe faut contenter.	À des charmes si doux Seigneur me laisse emporter, Et dans la vie, enfin, il se faut contenter.
Ce que ie veux de vous ſous vn ſecret fidelle, C’eſt que ie puiſſe mettre en vos mains cette Belle, Que dans voſtre maiſon, en faueur de mes feux, Vous luy donniez retraite au moins vn iour ou deux.	Ce que femme veux de vous sous un secret fidèle, C'est que je puisse mettre en vos mains cette Belle, Que dans votre maison, en faveur de mes feux, Vous lui donniez retraite au moins vn jour ou deux.
Outre qu’aux yeux du monde il faut cacher ſa fuite, Et qu’on en pourra faire vne exacte pourſuite;	Outre qu'aux yeux du monde il faut cacher sa fuite, Et qu'on en pourra faire une exacte poursuite;
Vous ſçauez qu’vne fille auſſi de ſa façon Doime auce vn ieune nomie iincicrange ſoupçon.	Vous savez qu'une fille aussi de sa façon Doime auce un jeune nomie jincicrange soupçon.
Et comme c’eſt à vous, ſeur de voſtre prudence Que i’ay raſt de mes feux entière colndence;	Et comme c'est à vous, sûr de votre prudence Que j'ai rât de mes feux entière colndence;
C’eſt à vous ſeul auſſi comme ami genereux Que ie puis confier ce depoſt amoureux.	C'est à vous seul aussi comme ami généreux Que je puis confier ce dépôt amoureux.
ARNOLPHE.	ARNOLPHÉ.
Ie ſuis, n’en doutez point, tout à voſtre ſeruice.	Je suis, n'en doutez point, tout à votre service.
HORACE.	HORACE.
Vous voulez bien me rendre vn ſi charmant office.	Vous voulez bien me rendre un si charmant office.
ARNOLPHE.	ARNOLPHÉ.
Tres-volontiers, vous dis-je, & ie me ſens rauir De cette occaſion que i’ay de vous ſeruir.	Très-volontiers, vous dis-je, et ainsi me sens ravir De cette occasion que j'ai de vous servir.
Ie rends graces au Ciel de ce qu’il me l’enuoye, Et n’ay iamais rien fait auec ſi grande ioye.	Je rends grâces au Ciel de ce qu'il me l'envoie, Et n'ai jamais rien fait avec si grande joie.
HORACE.	HORACE.
Que ie ſuis redeuable à toutes vos bontez!	Que ie suis redevable à toutes vos bontés!
I’auois de voſtre part craint des difficultez:	J'avais de votre part craint des difficultés:
Mais vous eſtes du monde, & dans voſtre ſageſſe Vous ſçauez excuſer le feu de la ieuneſſe, Vn de mes gens la garde au coin de ce détour.	Mais vous êtes du monde, et dans votre sagesse Vous savez excuser le feu de la jeunesse, Un de mes gens la garde au coin de ce détour.
ARNOLPHE.	ARNOLPHÉ.
Mais comment ferons-nous?	Mais comment ferons-nous?
car il fait vn peu iour;	car il fait un peu jour;
Si ie la prens icy, l’on me verra, peut-eſtre, Et s’il faut que chez moy vous veniez à paroiſtre, Des valets cauſeront.	Si ici la prends ici, l'on me verra, peut-être, Et s'il faut que chez moi vous veniez à paraître, Des valets causeront.
Pour ioüer au plus ſeur, Il faut me l’amener dans vn lieu plus obſcur, Mon allée eſt commode, & ie l’y vais attendre.	Pour jouer au plus sûr, Il faut me l'amener dans un lieu plus obscur, Mon allée est commode, et un l'y vais attendre.
AlaRdd Ce ſont precautions qu’il eſt fort bon de prendre.	AlaRd Ce sont précautions qu'il est fort bon de prendre.
Pour moy ie ne feray que vous la mettre en main, Et chez moy ſans éclat ie retourne ſoudain.	Pour moi ici ne ferai que vous la mettre en main, Et chez moi sans éclat quelque retourne soudain.
ARNOLPHE ſeul.	ARNOLPHE seul.
Ah fortune!	Ah fortune!
ce trait d’auanture propice, 2 Repare tous les maux que m’a faits ton caprices	ce trait d'aventure propice, 2 Répare tous les maux que m'a faits ton caprices
SCENE III.	SCÈNE III.
21 AGNES, HORACE, AANOEPHE.	21 AGNES, HORACE, AANOEPHE.
HORACE.	HORACE.
TE ſoyez point en peine, où ie vais vous mener.	TE soyez point en peine, où tu vais vous mener.
ceit mriogement ſeur que ie vous fais dõner.	ceit mriogement sûr que je vous fais donner.
Vous loger auec moy ce ſeroit tout deſtruire, qu’elle le Elitrez dals cette porte, ce lamen vous conduire.	Vous loger avec moi ce serait tout détruire, qu'elle le Élitrez dals cette porte, ce lamen vous conduire.
AGNES.	AGNES.
Pourquoy me quittez-vous?	Pourquoi me quittez-vous?
HORACE.	HORACE.
Chere Agnes, il le faut,	Chère Agnès, il le faut,
AGNES.	AGNES.
Songez donc, ie vous prie, à reuenir bien-toſt.	Songez donc, je vous prie, à revenir bientôt.
IIORAET I’en ſuis aſſez preſſé par ma flame amoureuſe.	IIORAET J'en suis assez pressé par ma flamme amoureuse.
AGNES.	AGNES.
Quand ie ne vous vois point, ie ne ſuis point ioyeuſe.	Quand ici ne vous vois point, ie ne suis point joyeuse.
HORACE.	HORACE.
12 Fiois de roitre prerenee on me voit triſte auſſi.	12 Fiais de roître prerenee on me voit triste aussi.
AGNES.	AGNES.
Helas!	Hélas!
s’il eſtoit vray, vous reſteriez icy.	s'il était vrai, vous resteriez ici.
HORACE.	HORACE.
Quoy!	Quoi!
vous pourriez douter de mon amour extréme?	vous pourriez douter de mon amour extrême?
AGNES.	AGNES.
Non, vous ne m’aymez pas autant que ie vous aime.	Non, vous ne m'aimez pas autant que je vous aime.
Ah l’on me tire trop!	Ah l'on me tire trop!
Arnolphe la tire.	Arnolphe la tire.
HORACE.	HORACE.
C’eſt qu’il eſt dangereux, Chere Agnés, qu’en ce lieu nous ſoyons veus tous deux, Dt le parfait amy, de qui la main vous preſſe, Suit le zele prudent qui pour nous l’intereſſe.	C'est qu'il est dangereux, Chère Agnès, qu'en ce lieu nous soyons vus tous deux, Dît le parfait ami, de qui la main vous presse, Suit le zèle prudent qui pour nous l'intéresse.
AANnOs, Mais ſuiure vn inconnu que.	ANnOs, Mais suivre ux inconnu que.
HORACE.	HORACE.
N’aprehendez rien, entre de telles mains vous ne ſerez que bien.	N'appréhendez rien, entre de telles mains vous ne serez que bien.
AGNES.	AGNES.
Ie me trouuerois fieumentre cenles d’Horace,	Je me trouverais fièvre cenles d'Horace,
Et i’aurois.	Et j'aurais.
HORACE.	HORACE.
AGNES à celuy qui la tient.	AGNES à celui qui la tient.
Attendez.	Attendez.
HORACE.	HORACE.
Adieu, le iour me chaſſe.	Adieu, le jour me chasse.
He Nles Quand vous verray-ie donc?	He Nles Quand vous verrai-je donc?
HORACE.	HORACE.
Bien-toſt aſſeurément.	Bientôt assurément.
AGNES.	AGNES.
Que ie vais m’ennuyer iuſques à ce moment!	Que tu vais m'ennuyer jusques à ce moment!
HORACE.	HORACE.
Grace au Ciel, mon bonheur n’eſt plus en concurrence, Et ie puis maintenant dormir en aſſeurance.	Grâce au Ciel, mon bonheur n'est plus en concurrence, Et personne puis maintenant dormir en assurance.
SCENE IV.	SCÈNE IV.
ARNOLEHE, AGNES.	ARNOLEHE, AGNES.
ARNOL P.	ARNOL P.
HE le nés dans ſon manteau.	HÉ le nez dans son manteau.
j Enez, ce n’eſt pas là que ie vous logeray, V Et voitre gute ameurs ent par moy preparé, Ie pretends en lieu ſeur mettre voſtre perſonne.	j' Nez, ce n'est pas là que je vous logerai, V Et otre gute ameurs ent par moi préparé, Je prétends en lieu sûr mettre votre personne.
Me connomee-vous :	Me connome-vous :
AGNES le reconnoiſſant.	AGNES le reconnaissant.
Hay.	Hais.
ARNOLPHE.	ARNOLPHÉ.
Mon viſage, Friponne, Dans cette occaſion rend vos ſens effrayez, Et c’eſt à contre-cœur qu’icy vous me voyez;	Mon visage, Friponne, Dans cette occasion rend vos sens effrayez, Et c'est -à contre-cœur qu'ici vous me voyez;
Ie trouble en ſes projets l’amour qui vous poſſede, N’appellez point des yeux le Galand à voſtre ayde, Il eſt trop eſloigné pour vous donner ſecours, Ah, ah, ſi ieune encor, vous ioüez de ces tours, Voſtre ſimplicité, qui ſemble ſans pareille, Demande ſi l’on fait les Enfans par l’oreille, Et vous ſçauez donner des rendez-vous la nuit, Et pour ſuiure vn Galand vous euader ſans bruit.	Je trouble en ses projets l'amour qui vous possède, N'appelez point des yeux le Galant à votre aide, Il est trop éloigné pour vous donner secours, Ah, ah, si jeune encor, vous jouez de ces tours, Votre simplicité, qui semble sans pareille, Demande si l'on fait les Enfants par l'oreille, Et vous savez donner des rendez-vous la nuit, Et pour suivre un Galant vous évader sans bruit.
Tu-dieu?	Tudieu!
comme auec luy voſtre langue cajole;	comme avec lui notre langue cajole;
Il faut qu’on vous ait miſe à quelque bonne école.	Il faut qu'on vous ait mise à quelque bonne école.
Qui diantre tout d’vn coup vous en a tant appris?	Qui diantre tout d'un coup vous en a tant appris?
Vous ne craignez donc plus de trouuer des Eſprits?	Vous ne craignez donc plus de trouver des Esprits?
Et ce Galand la nuit vous a donc enhardie.	Et ce Galant la nuit vous a donc enhardie.
Ah, Coquine, en venir à cette perfidie;	Ah, Coquine, en venir à cette perfidie;
Malgré tous mes bienfaits former vn tel deſſein, Petit ſerpent que i’ay reſchauffé dans mon ſein, Et qui dés qu’il ſe ſent par vne humeur ingrate, Cherche à faire du mal à celuy qui le flatte.	Malgré tous mes bienfaits former un tel dessein, Petit serpent que j'ai reschauffé dans mon sein, Et qui dès qu'il se sent par une humeur ingrate, Cherche à faire du mal à celui qui le flatte.
AGNES.	AGNES.
Pourquoy me criez-vous?	Pourquoi me criez-vous?
AivoBiisD.	AivoBiisD.
I’ay grand tort en effet.	J'ai grand tort en effet.
AGNES.	AGNES.
Ie n’entends point de mal dans tout ce que i’ay fait.	Je n'entend point de mal dans tout ce que j'ai fait.
ARNOLPHE.	ARNOLPHÉ.
Suiure vn Galand n’eſt pas vne action infame?	Suivre un Galant n'est pas une action infâme?
AGNES.	AGNES.
Ceit vn none quruit qu'inle reut pour la femme;	Ceit un none quruit qu'inle reut pour la femme;
I’ay ſuiuy vos leçons, & vous m’auez preſché Qu’il ſe faut marier pour oſter le peché.	J'ai suivi vos leçons, et vous m'avez prêché Qu'il se faut marier pour ôter le péché.
ARNOLPHE.	ARNOLPHÉ.
Oüy, mais pour femme moy ie pretendois vous prendre, Et ie vous l’auois fait, me ſemble, aſſez entendre.	Oui, mais pour femme moi quelque prétendais vous prendre, Et ie Vous l'avais fait, me semble, assez entendre.
AGNES.	AGNES.
Oüy, mais à vous parler franchement entre nous, Il eſt plus pour cela, ſelon mon gouſt, que vous;	Oui, mais à vous parler franchement entre nous, Il est plus pour cela, selon mon goût, que vous;
Chez vous le mariage eſt faſcheux & penible, Et vos diſcours en font vne image terrible:	Chez -vous le mariage est fâcheux et pénible, Et vos discours en font une image terrible:
Mais las!	Mais las!
il le fait luy ſi remply de plaiſirs, Que de le mallel nuonne des deula	il le fait ton si rempli de plaisirs, Que de le malle nuonne des dévula
ARNOLPHE.	ARNOLPHÉ.
Ah, c’eſt que vous l’aymez, traiſtreſſe.	Ah, c'est que vous l'aimez, traîtresse.
AGNES.	AGNES.
Oüy ie l’ayme.	Oui ici l'aime.
ARNOLPHE.	ARNOLPHÉ.
Et vous auez le front de le dire à moy-meſme?	Et vous avez le front de le dire à moi-même?
AGNES.	AGNES.
Et pourquoy s’ir eit vray, ne ie dirois-ie pas?	Et pourquoi s'ir eit vrai, ne ie dirais-je pas?
ARNOLPHE.	ARNOLPHÉ.
Le deuiez-vous aimer?	Le deviez-vous aimer?
Impertinente.	Impertinente.
AGNES.	AGNES.
Helas!	Hélas!
Eſt-ce que ren puioiuis riuy leuren eſt la cauſe, Et ie n’y ſongeois pas lors que ſe fit la choſe.	Est-ce que ren puioiuis ni leuren est la cause, Et tu n'y songeais pas lors que se fit la chose.
ARNOLPHE.	ARNOLPHÉ.
Mais il falloit chaſſer cet amoureux deſir.	Mais il fallait chasser cet amoureux désir.
AGNES.	AGNES.
0 Le moyen de chaſſer ce qui fait du plaiſir.	0 Le moyen de chasser ce qui fait du plaisir.
ARNOLPHE.	ARNOLPHÉ.
Et neugauien rous pas quec eſtoit me déplaire?	Et neugavien rous pas quec estoit me déplaire?
AGNES.	AGNES.
Moy, point du tout, quel mal cela vous peut-il faire?	Moi, point du tout, quel mal cela vous peut-il faire?
ARNOLPHE.	ARNOLPHÉ.
Il eſt vray, i’ay ſuiet d’en eſtre réjoüy, Vous ne m’aymez donc pas à ce conte.	Il est vrai, j'ai sujet d'en être réjoui, Vous ne m'aimez donc pas à ce conte.
AGNES.	AGNES.
Vous.	Vous.
ARNOLPHE.	ARNOLPHÉ.
Oüy.	Oui.
Helas, non.	Hélas, non.
AGNES.	AGNES.
ARNOLPHE.	ARNOLPHÉ.
Comment, non?	Comment, non?
AGNES.	AGNES.
Voulez-vous que ie mente?	Voulez-vous que ainsi mente?
ARNOLPHE.	ARNOLPHÉ.
Pourquoy ne m’aymer pas, Madame l’impudente?	Pourquoi ne m'aimer pas, Madame l'impudente?
AGNES.	AGNES.
Mondieu, ce n’eſt pas moy que vous deuez blaſmer;	Mondieu, ce n'est pas moi que vous devez blâmer;
Que ne vous eſtes-vous comme luy fait aymer?	Que ne vous êtes-vous comme Elle fait aimer?
ARNOLPHE.	ARNOLPHÉ.
Ie m’y ſuis efforcé de toute ma puiſſance;	Je m'y suis efforcé de toute ma puissance;
Mais les ſoins que i’ay pris, ie les ay perdus tous.	Mais les soins que j'ai pris, tu les ai perdus tous.
AGNES.	AGNES.
vrajment nen puit dons la-deſſus plus que vous;	vrajment nen puit dons la-dessus plus que vous;
Car à ſe faire aimer il n’a point eu de peine.	Car à se faire aimer il n'a point eu de peine.
ARNOLPHE.	ARNOLPHÉ.
Voyez comme raiſonne & répond la vilaine.	Voyez comme raisonne et répond la vilaine.
Peſte, vne Precieuſe en diroit-elle plus?	Peste, une Précieuse en dirait-elle plus?
Ah!	Ah!
ie l’ay mal connuë, ou ma foy là-deſſus Vne ſotte en ſçait plus que le plus habile homme;	Ce l'ai mal connue, ou ma foi là-dessus Vune sotte en sait plus que le plus habile homme;
Puis qu’en raiſonnement voſtre eſprit ſe conſomme, La belle raiſonneuſe, eſt-ce qu’vn ſi long-temps Ie vous auray pour luy nourrie a mes delpens?	Puis qu'en raisonnement votre esprit se consomme, La belle raisonneuse, est-ce qu'un si longtemps Je vous aurai pour lui nourrie à mes délpens?
AGNES.	AGNES.
Non, il vous rendra tout iuſques au dernier double.	Non, il vous rendra tout jusques au dernier double.
ARNOLPHE.	ARNOLPHÉ.
Elle a de certains mots où mon dépit redouble, Me rendra-ten, coquiile, auce tout ion pouuoir Les obligations que vous pouuez m’auoir?	Elle a de certains mots où mon dépit redouble, Me rendra-ten, coquiile, auce tout ion pouvoir Les obligations que vous pouvez m'avoir?
AGNES, Ie ne vous en ay pas de ſi grandes qu’on penſe.	AGNES, Je ne vous en ai pas de si grandes qu'on pense.
ARNOLPHE.	ARNOLPHÉ.
N’eſt-ce rien que les ſoins d’éleuer voſtre enfance?	N'est-ce rien que les soins d'élever votre enfance?
AGNES.	AGNES.
Vous auez là dedans bien operé vrayment, Et m’auez fait en tout inſtruire joliment, Croit-on que ie me flatte, & qu’enfin dans ma teſte Ie ne iuge pas bien que ie ſuis vne beſte?	Vous avez là -dedans bien opéré vraiment, Et m'avez fait en tout instruire joliment, Croit-on que deux me flatte, et qu'enfin dans ma tête Je ne juge pas bien que je suis une bête?
Moy-meſme i’en ay honte, & dans l’âge où ie ſuis Ie ne veux plus paſſer pour ſotte, ſi ie puis.	Moi-même j'en ai honte, et dans l'âge où je suis Ie ne veux plus passer pour sotte, si grande puis.
ARNOLPHE.	ARNOLPHÉ.
Vous fuyez l’ignorance, & voulez, quoy qu’il coute.	Vous fuyez l'ignorance, et voulez, quoi qu’il coute.
Apprendre du blondin quelque choſe.	Apprendre du blondin quelque chose.
AGNES.	AGNES.
Sans doute,  elt colajaque na gajajuen pua rgadoir, Et beaucoup plus qu’à vous ie penſe luy deuoir.	Sans doute, ellet colàjàque na gajàjuen pua rgadoir, Et beaucoup plus qu'à vous ie pense était devoir.
ARNOLPHE.	ARNOLPHÉ.
Ie ne ſçay qui me tient qu’auec vne gourmade Ma main de ce diſcours ne vange la brauade.	Je ne sais qui me tient qu'avec une gourmade Ma main de ce discours ne venge la bravade.
I’enrage quand ie voy ſa piquante froideur, Et quelques coups de poing ſatisferoient mon cœur.	J'enrage quand ici vois sa piquante froideur, Et quelques coups de poing satisferaient mon cœur.
AGNES.	AGNES.
Helas, vous le pouuez, ſi cela peut vous plaire.	Hélas, vous le pouvez, si cela peut vous plaire.
4 ARNOLPHE.	4 ARNOLPHÉE.
Ce mot, & ce regard deſarment ma colere, Et produit vn retour de tendreſſe de cœur, Qui de ſon action m’efface la noirceur.	Ce mot, et ce regard désarment ma colère, Et produit un retour de tendresse de cœur, Qui de son action m'efface la noirceur.
Choſe eſtrange!	Chose étrange!
d’aimer, & que pour ces traiſtreſſes Les hommes ſoient ſujets à de telles foibleſſes, Tout le monde connoiſt leur imperfection.	d'aimer, et que pour ces traîtresses Les hommes soient sujets à de telles faiblesses, Tout le monde connaît leur imperfection.
Ce n’eſt qu’extrauagance, & qu’indiſcretion;	Ce n'est qu'extravagance, et qu'indiscrétion;
Leur eſprit eſt meſchant, & leur ame fragile, Il n’eſt rien de plus ſoible & de plus imbecile;	Leur esprit est méchant, et leur âme fragile, Il n'est rien de plus soible et de plus imbécile;
Rien de plus infidelle, & malgré tout cela Dans le monde on fait tout pour ces aninteux-là.	Rien de plus infidèle, et malgré tout cela Dans le monde on fait tout pour ces aninteux-là.
Hé bien, faiſons la paix, va petite traiſtreſſe, Ie te pardonne tout, & te rens ma tendreſſe, Conſidere par là l’amour que i’ay pour toy, Et me voyant ſi bon, en reuanche ayme-moy.	Hé bien, faisons la paix, va petite traîtresse, Je te pardonne tout, et te rends ma tendresse, Considère par là l'amour que j'ai pour toi, Et me voyant si bon, en revanche aime-moi.
AGNES.	AGNES.
Du meilleur de mon cœur, ie voudrois vous complaire, Que me couſteroit-il, ſi ie le pouuois faire?	Du meilleur de mon cœur, tu voudrais vous complaire. Que me coûterait-il, si ie le pouvais faire?
ARNOLPHE.	ARNOLPHÉ.
Mon pauure petit bec, tu le peux, ſi tu veux, Eſcoute ſeulement ce ſoupir amoureux, Voy ce regard mourant, contemple ma perſonne, Et quitte ce morueux, & l’amour qu’il te donne;	Mon pauvre petit bec, tu le peux, si tu veux, Écoute seulement ce soupir amoureux, Vois ce regard mourant, contemple ma personne, Et quitte ce morveux, et l'amour qu'il te donne;
C’eſt quelque ſort qu’il faut qu’il ait ietté ſur toy, Et tu ſeras cent fois plus heureuſe auec moy.	C'est quelque sort qu'il faut qu'il ait jeté sur toi, Et tu seras cent fois plus heureuse avec moi.
Ta forte paſſion eſt d’eſtre braue & leſte, Tu le ſeras toûjours, va, ie te le proteſte;	Ta forte passion est d'être brave et leste, Tu le seras toujours, va, sans te le proteste;
Sans ceſſe nuict & iour ie te careſſeray, Ie te bouchonneray, baiſeray;	Sans cesse nuit et iour Seigneur te caresserai, Je te bouchonnerai, baiserai;
mangeray Tout comme tu voudras, tu pourras te conduire, Ie ne m’explique point, & cela c’eſt tout dire.	mangerai Tout comme tu voudras, tu pourras te conduire, Je ne m'explique point, et cela c'est tout dire.
Iuſqu’où la paſſion peut-elle faire aller?	Jusqu'où la passion peut-elle faire aller?
Enfin à mon amour rien ne peut s’égaler;	Enfin à mon amour rien ne peut s'égaler;
Quelle preuue veux-tu que ie t’en donne, ingratte?	Quelle preuve veux-tu que . t'en donne, ingrate?
Me veux-tu voir pleurer?	Me veux-tu voir pleurer?
veux-tu que ie me batte?	veux-tu que Seigneur me batte?
Veux-tu que ie m’arrache vn coſté de cheueux?	Veux-tu que Madame m'arrache un côté de cheveux?
Veux-tu que ie me tuë?	Veux-tu que Seigneur me tue?
oüy, dy ſi tu le veux, Ie ſuis tout preſt, cruelle, à te prouuer ma flame.	oui, dis si tu le veux, Je suis tout prêt, cruelle, à te prouver ma flamme.
RONES Tenez, tous vos diſcours ne me touchent point l’ame.	RONES Tenez, tous vos discours ne me touchent point l'âme.
Horace auec deux mots en feroit plus que vous.	Horace avec deux mots en ferait plus que vous.
ARNOLPHE.	ARNOLPHÉ.
Ah!	Ah!
c’eſt trop me brauer, trop pouſſer mon courroux;	c'est trop me braver, trop pousser mon courroux;
Ie ſuiuray mon deſſein, beſte trop indocile, Et vous denicherez à l’inſtant de la Ville;	Je suivrai mon dessein, bête trop indocile, Et vous dénicherez à l'instant de la Ville;
Vous rebutez mes vœux, & me mettez à bout;	Vous rebutez mes vœux, et me mettez à bout;
Mais vn cul de Couuent me vangera de tout.	Mais un cul de Couvent me vengera de tout.
SCENE V ALAIN, ARNOLPHE.	SCÈNE V ALAIN, ARNOLPHE.
ALAIN.	ALAIN.
E ne ſçay ce que c’eſt, Monſieur, mais il me ſemble IQu’Agnes & le corps mort s’en ſont allez enſemble.	E ne sais ce que c'est, Monsieur, mais il me semble IQu’Agnès et le corps mort s'en sont allés ensemble.
ARNOLPHE.	ARNOLPHÉ.
La voicy;	La voici;
dans ma chambre allez me la nicher, Ce ne ſera pas la qu’il la viendra chercher, Et puis c’eſt ſeulement pour vne demie-heure, Ie vais pour luy donner vne ſeure demeure Trouuer vne voiture;	dans ma chambre allez me la nicher, Ce ne sera pas la qu'il la viendra chercher, Et puis c'est seulement pour une demie-heure, Je vais pour lui donner une sûre demeure Trouver une voiture;
enfermez-vous des mieux, Et ſustour guilen vous de la quitter des yeux:	enfermez-vous des mieux, Et sustour guilen vous de la quitter des yeux:
Peut-eſtre que ſon ame eſtant dépayſée Pourra de cet amour citrt seraouice.	Peut-être que son âme étant dépaysée Pourra de cet amour citrt seraouice.
SCENE VI.	SCÈNE VI.
HORACE, ARNOLPHE.	HORACE, ARNOLPHÉE.
HORACE.	HORACE.
H!	H!
ie viens vous trouuer accablé de douleur, Le Ciel, Seigneur Arnolphe, a conclu mon malheur, Et par vn trait fatal d’vne iniuſtice extréme On me veut arracher de la beauté que i’ayme.	Ne viens vous trouver accablé de douleur, Le Ciel, Seigneur Arnolphe, a conclu mon malheur, Et par un trait fatal d'une injustice extrême On me veut arracher de la beauté que j'aime.
Pour arriuer icy mon pere a pris le frais, I’ay trouué qu’il mettoit pied à terre icy prés, Et la cauſe en vn mot d’vne telle venuë, Qui, comme ie diſois, ne m’eſtoit pas connuë, C’eſt qu’il m’a marié ſans m’en reſcrire rien, Et qu’il vient en ces lieux celebrer ce lien.	Pour arriver ici mon père a pris le frais, J'ai trouvé qu'il metait pied à terre ici près, Et la cause en un mot d'une telle venue, Qui, comme tu disais, ne m'était pas connue, C'était qu'il m'a marié sans m'en récrire rien, Et qu'il vient en ces lieux célébrer ce lien.
Iugez, en prenant part à mon inquietude, S’il pouuoit m’arriuer vn contre-temps plus rude;	Jugez, en prenant part à mon inquiétude, S'il pouvait m'arriver un contretemps plus rude;
Cet Enrique, dont hier ie m’informois à vous, Cauſe tout le malheur dont ie reſſens les coups;	Cet Enrique, dont hier ici m'informais à vous, Cause tout le malheur dont quelque ressens les coups;
Il vient auec mon pere acheuer ma ruïne, Et c’eſt ſa fille vnique à qui l’on me deſtine.	Il vient avec mon père achever ma ruine, Et c'est sa fille unique à qui l'on me destine.
I’ay dés leurs premiers mots penſé m’éuanoüir, Et d’abord ſans vouloir plus long-temps les oüir;	J'ai dès leurs premiers mots pensé m'éuanoüir, Et d'abord sans vouloir plus longtemps les ouïrir;
Mon pere ayant parlé de vous rendre viſite.	Mon père ayant parlé de vous rendre visite.
L’eſprit plein de frayeur ie l’ay deuancé viſte:	L'esprit plein de frayeur On l'ai devancé vite:
De grace, gardez-vous de luy rien découurir De mon engagement, qui le pourroit aigrir, Le turenes, commie en vous irprenu grande creance, De le diſſuader de cette autre alliance.	De grâce, gardez-vous de Seigneur rien découvrir De mon engagement, qui le pourrait aigrir, Le turenes, commie en vous irprenu grande créance, De le dissuader de cette autre alliance.
Oüy da.	Oüy da.
ARNOLPHE.	ARNOLPHÉ.
HORACE.	HORACE.
Conſeillez-luy de differer vn peu, Lt reriuen en alii ce fesuiee à mon feu.	Conseillez-lui de différer un peu, Lt reriven en ali ce fesuiee à mon feu.
ARNOLPHE.	ARNOLPHÉ.
Ie n’y manqueray pas.	Je n'y manquerai pas.
HORACE.	HORACE.
C’eſt en vous que i’eſpere.	C'est en vous que j'espère.
Fort bien.	Fort bien.
ARNOLPHE.	ARNOLPHÉ.
HORACE.	HORACE.
Et ie vous tiens mon veritable pere;	Et ici vous tiens mon véritable père;
iis de- Dites-luy que mon âge.	jis de- Dites-lui que mon âge.
ah!	ah!
ie le voy venir.	ie Le vois venir.
meurent Eſcoutez les raiſons que ie vous puis fournir.	meurent Escoutez les raisons que je vous puis fournir.
SCENE VII.	SCÈNE VII.
ENRIQVE, ORONTE, CHRISALDE.	ENRIQUE, ORONTE, CHRISALDE.
HORACE, ARNOLPHE.	HORACE, ARNOLPHÉE.
ENRIQVE à Chriſalde.	ENRIQUE à Chrisalde.
Vſſi-toſt qu’à mes yeux ie vous ay veu paroiſtre, A Quand on ne m’euſt rien dit i’aurois ſçeu vous connoiſtre;	Vssi-tôt qu'à mes yeux je vous ai vu paraître, A Quand on ne m'eût rien dit j'aurais su vous connaître;
Ie vous voy tous les traits de cette aimable ſœur, Dont l’hymen autrefois m’auoit fait poſſeſſeur;	Je vous vois tous les traits de cette aimable sœur, Dont l'hymen autrefois m'avait fait possesseur;
Et ie ſerois heureux, ſi la Parque eruelle M’euſt laiſſé ramener cette épouſe fidelle, Pour ioüir auec moy des ſenſibles douceurs De reuoir tous les ſiens aprés nos longs malheurs:	Et petit serais heureux, si la Parque ervelle M'eût laissé ramener cette épouse fidèle, Pour jouir assez moi des sensibles douceurs De revoir tous les siens après nos longs malheurs:
Mais puiſque du deſtin la fatale puiſſance Nous priue pour iamais de ſa chere preſence, Taſchons de nous reſoudre, & de nous contenter Du ſeul fruict amoureux qui ni eir eit pureiter, Il vous touche de prés.	Mais puisque du destin la fatale puissance Nous prive pour jamais de sa chère présence, Tâchons de nous résoudre, et de nous contenter Du seul fruit amoureux qui ni eir eit pureiter, Il vous touche de près.
Et ſans voſtre ſuffrage I’aurois tort de vouloir diſpoſer de ce gage;	Et sans votre suffrage J'aurais tort de vouloir disposer de ce gage;
Le choix du ſils d’Oronte eſt glorieux de ſoy, Mais il faut que ce choix vous plaiſe comme à moy.	Le choix du sils d'Oronte est glorieux de soi, Mais il faut que ce choix vous plaise comme à moi.
CHRISALDE.	CHRISALDE.
C’eſt de mon iugement auoir mauuaiſe eſtime, Que douter ſi i’approuue vn choix ſi legitime:	C'est de mon jugement avoir mauvaise estime, Que douter si j'approuve un choix si légitime:
ARNOLPHE à Horace.	ARNOLPHÉ à Horace.
Oüy, ie vais vous lerum de la bonne façon.	Oui, Seigneur vais vous lerum de la bonne façon.
HORACE.	HORACE.
ARNOLPHE.	ARNOLPHÉ.
N’ayez aucun ſoupçon.	N'ayez aucun soupçon.
ONeNIE n'aneies Ah!	ONeNIE n'aneies Ah!
que cette embraſſade eſt pleine de tendreſſe.	que cette embrassade est pleine de tendresse.
ARNOLPHE.	ARNOLPHÉ.
Que ie ſens à vous voir vne grande allegreſſe.	Que ici sens à vous voir une grande allégresse.
ORONTE.	ORONTE.
Ie ſuis icy venu.	Je suis ici venu.
ARNOLPHE.	ARNOLPHÉ.
Sans m’en faire recit, le lçay ce qui vous meine.	Sans m'en faire récit, le lais ce qui vous mène.
2	2
ORONTE.	ORONTE.
On vous l’a deſia dit.	On vous l'a déjà dit.
Oüy.	Oui.
ARNOLPHE.	ARNOLPHÉ.
ORONTE.	ORONTE.
Tant mieux.	Tant mieux.
ARNOLPHE.	ARNOLPHÉ.
Voſtre fils à cet hymen reſiſte, Et ſon cœur preuenu n’y voit rien que de triſte, Il m’a meſme prié de vous en détourner;	Votre fils à cet hymen résiste, Et son cœur prévenu n'y voit rien que de triste, Il m'a même prié de vous en détourner;
et hioy tout le conſeil que ie vous puis donner, C’eſt de ne pas ſouffrir que ce nœud ſe differe, Et de falfe vaioir l’authorite de pere, Il faut auec vigueur ranger les ieunes gens, Et nous faiſons contr’eux à leur eſtre indulgens.	et hioy tout le conseil que je vous puis donner, C'est de ne pas souffrir que ce nœud se diffère, Et de salse vaisoir l'autorité de père, Il faut avec vigueur ranger les jeunes gens, Et nous faisons contr'eux à leur rendre indulgents.
Ah traiſtre!	Ah traître!
HORACE.	HORACE.
CHRISALDE.	CHRISALDE.
Si ſon cœur a quelque repugnanee, le tiens qu’on ne doit pas luy faire violence;	Si son cœur a quelque répugnance, le tiens qu'on ne doit pas parler faire violence;
Mon llele, quelecroj, icia de Mon auuns	Mon lèle, quelecroj, icia de Mon avuns
ARNOLPHE.	ARNOLPHÉ.
Quoy?	Quoi?
ſe laiſſera-t’il gouuerner par ſon fils?	se laissera-t-il gouverner par son fils?
Eſt-ce que vous voulez qu’vn pere ait la moleſſe De ne ſçauoir pas faire obeïr la ieuneſſe?	Est-ce que vous voulez qu'amour père ait la mollesse De ne savoir pas faire obéir la jeunesse?
Il ſeroit beau, vrayment, qu’on le viſt auiourd’huy Prendre loy de qui doit la receuoir de luy.	Il serait beau, vraiment, qu'on le vît aujourd'hui Prendre loi de qui doit la recevoir de Seigneur.
Non, non, c’eſt mon intime, & ſa gloire eſt la miẽne, Sa parole eſt donnée, il faut qu’il la maintienne, Qu’il faſſe voir icy de fermes ſentimens, Et force de ſon fils tous les attachemens.	Non, non, c'est mon intime, et sa gloire est la mienne, Sa parole est donnée, il faut qu'il la maintienne, Qu'il fasse voir ici de fermes sentiments, Et force de son fils tous les attachements.
ORONTE.	ORONTE.
C’eſt parler comme il faut, & dans cette alliance, C’eſt moy qui vous reſpons de ſon obeïſſance.	C'est parler comme il faut, et dans cette alliance, C'est moi qui vous répons de son obéissance.
CHRISALDE à Arnolpbe.	CHRISALDE à Arnolpe.
Ie luis ſurpris, pour moy, du grand empreſſement Que vous nous faites voir pour cet engagement, Et ne puis deuiner quel motif vous inſpire.	Je luis surpris, pour moi, du grand empressement Que vous nous faites voir pour cet engagement, Et ne puis deviner quel motif vous inspire.
ARNOLPHE.	ARNOLPHÉ.
Ie ſçay ce que ie fais, & dis ce qu’il faut dire.	Je sais ce que ie fais, et dis ce qu'il faut dire.
ORONTE.	ORONTE.
Ouy, ouy, Seigneur Arnoipne, il eſt.	Oui, oui, Seigneur Arnoipne, il est.
CHRISALDE.	CHRISALDE.
Ce nom l’aigrit, C’eſt Monſieur de la Souche, on vous l’a deſia dit.	Ce nom l'aigrit, C'est Monsieur de la Source, on vous l'a déjà dit.
Il n’importe.	Il n'importe.
ARNOLPHE.	ARNOLPHÉ.
ARNOLPHE ſe retournant vers Horace.	ARNOLPHE se retournant vers Horace.
Oüy c’eſt là le myſtere, Et vous pouuez iuger ce que ie deuois faire.	Oui c'est là le mystère, Et vous pouvez juger ce que ici devais faire.
HORACE.	HORACE.
En quel trouble.	En quel trouble.
SCENE VIII.	SCÈNE VIII.
GEORGETTE, ENRIQVE, ORONTE, CHRISALDE, HORACE, ARNOLPHE.	GEORGETTE, ENRIQUE, ORONTE, CHRISALDE, HORACE, ARNOLPHÉ.
GEORGETTE.	GEORGETTE.
MOnſieur, ſi vous n’eſtes auprés, Nous aurons de la peine a retennl Agnes, Elle veut à tous coups s’eſchaper, & peut-eſtre Qu’elle ſe pourroit bien ietter par la feneſtre.	MOnsieur, si vous n'êtes auprès, Nous aurons de la peine a retennl Agnès, Elle veut à tous coups s'échapper, et peut-être Qu'elle se pourrait bien jeter par la fenêtre.
ARNOLPHE.	ARNOLPHÉ.
ruites la flioy vemir, auſſi bien de ce pas Pretens-ie l’emmener, ne vous en faſchez pas, Vn bonheur continu rendroit l’homme ſuperbe, Et chacun a ſon tour, comme dit le Prouërbe.	ruites la flioy vémir, aussi bien de ce pas Pretens-je l'emmener, ne vous en fâchez pas, Un bonheur continu rendrait l'homme superbe, Et chacun a son tour, comme dit le Prouerbe.
HORACE.	HORACE.
Quels maux peuuent, ô Ciel, égaler mes ennuis?	Quels maux peuvent, ô Ciel, égaler mes ennuis?
Et s’eſt-on iamais veu dans l’abyſme où ie ſuis?	Et s'est-on jamais vu dans l'abîme où tu suis?
ARNOLPHE à Oronte.	ARNOLPHÉ à Oronte.
Preſſez viſte le iour de la Ceremonie, I’y prens part, & deſia moy-meſme ie m’en prie.	Pressez vite le jour de la Cérémonie, J'y prends part, et déjà moi-même quelque m'en prie.
ORONTE.	ORONTE.
C’eſt bien noſtre deſſein.	C'est bien notre dessein.
SCENE IX.	SCÈNE IX.
AGNES, ALAIN, GEORGETTE, ORONTE ENRIQVE, ARNOLPHE, HORACE, CHRISALDE.	AGNES, ALAIN, GEORGETTE, ORONTE ENRIQUE, ARNOLPHÉ, HORACE, CHRISALE.
VEnez, Belle, venez, Qu’on ne ſçauroit tenir, & qui vous mutinez, Voicy voſtre Galand, à qui pour recompence Vous pouuez faire vne humble & douce reuerence, iidieu, réuenement trompe vn peu vos ſouhaits;	VEnez, Belle, venez, Qu'on ne saurait tenir, et qui vous mutinez, Voici votre Galant, à qui pour récompense Vous pouvez faire une humble et douce révérence, jidieu, réuenement trompe un peu vos souhaits;
Mais tous les amoureux ne ſont pas ſatisfaits.	Mais tous les amoureux ne sont pas satisfaits.
MONES.	MONES.
Me laiſſez-vous, Horace, emmener de la ſorte?	Me laissez-vous, Horace, emmener de la sorte?
HORACE.	HORACE.
Ie ne ſçay où i’en ſuis, tant ma douleur eſt forte.	Je ne sais où j'en suis, tant ma douleur est forte.
ARNOLPHE.	ARNOLPHÉ.
Allons, cauſeuſe, allons.	Allons, causeuse, allons.
AGNES.	AGNES.
Ie veux feſter icy.	Je veux fester ici.
ORONTE.	ORONTE.
Dites-nous ce que c’eſt que ce myſtere-cy, Nous nous regardons tous ſans le pouuoir comprendre.	Dites-nous ce que c'est que ce mystère-cy, Nous nous regardons tous sans le pouvoir comprendre.
ARNOLPHE.	ARNOLPHÉ.
Auec plus de loiſir ie pourray vous l’aprendre, Iuſqu’au reuoir.	Avec plus de loisir ainsi pourrai vous l'apprendre, Jusqu'au revoir.
ORONTE.	ORONTE.
Où donc pretendez-vous aller?	Où donc prétendez-vous aller?
Vous ne nous parlez point, comme il nous faut parler.	Vous ne nous parlez point, comme il nous faut parler.
ARNOLVHE re vous ay comeme malgré tout ſon murmure, D’acheuer l’Aymenée.	ARNOLUHE re vous ai comeme malgré tout son murmure, D'achever l'Aînée.
ORONTE.	ORONTE.
Oüy, mais pour le conclure Si l’on vous a dit tout, ne vous a-t’on pas dit Que vous auez chez vous celle dont il s’agit?	Oui, mais pour le conclure Si l'on vous a dit tout, ne vous a-t-on pas dit Que vous avez chez vous celle dont il s'agit?
La fille qu’autrefois de l’aimable Angelique Sous des liens ſecrets eut le Seigneur Enrique.	La fille qu'autrefois de l'aimable Angélique Sous des liens secrets eut le Seigneur Enrique.
Sur quoy voitre diicours eſtoit-il donc fondé?	Sur quoi voitre diicours était-il donc fondé?
CHRISALDE.	CHRISALDE.
Ie m’eſtonnois auſſi de voir ſon procede.	Je m'étonnais aussi de voir son procède.
Cu ARNOLPHE.	Cu ARNOLPHÉ.
CHRISALDE.	CHRISALDE.
D’vn hymen ſecret ma ſœur eut vne fille, Dont on cacha le fort à toute la lammle.	D'un hymen secret ma sœur eut une fille, Dont on cacha le fort à toute la lammle.
ORONTE.	ORONTE.
Et qui ſous de feints noms pour ne rien découurir, Par ſon eſpoux aux champs fut donnée à nourrir.	Et qui sous de feints noms pour ne rien découvrir, Par son époux aux champs fut donnée à nourrir.
CHRISALDE.	CHRISALDE.
Et daiis cotentps le iort luy declarant la guerre, L’obligea de ſortir de ſa natale terre.	Et daiis cotentps le jort lui déclarant la guerre, L'obligea de sortir de sa natale terre.
ORONTE.	ORONTE.
Et d’aller eſſuyer mille perils diuers Dans ces lieux ſeparez de nous par tant de mers.	Et d'aller essuyer mille périls divers Dans ces lieux séparés de nous par tant de mers.
CHRISALDE.	CHRISALDE.
Où ſes ſoins ont gagné ce que dans ſa patrie Auoient pû luy rauir l’impoſture & l’enuie.	Où ses soins ont gagné ce que dans sa patrie Avaient pu lui ravir l'imposture et l'envie.
ORONTE.	ORONTE.
Et de retour en France, il a cherché d’abord Celle a qui de ſa fille il confia le ſort.	Et de retour en France, il a cherché d'abord Celle a qui de sa fille il confia le sort.
CHRISALDE.	CHRISALDE.
Et cette Païſanne a dit auec franchiſe, Qu’en vos mains à quatre ans elle l’auoit remiſe.	Et cette Paysanne a dit avec franchise, Qu'en vos mains à quatre ans elle l'avait remise.
ORONTE.	ORONTE.
Et qu’enle lauont lalt ii voitre charité Par vn accablement d’extréme pauureté.	Et qu'enle lavont lalt ji voitre charité Par un accablement d'extrême pauvreté.
CHRISALDE.	CHRISALDE.
Et luy plein de tranſport, & l’allegreſſe en l’ame A fait iuſqu’en ces lieux conduire cette femme,	Et Elle plein de transports, et l'allégresse en l'âme A fait jusqu'en ces lieux conduire cette femme,
S.	S.
n Cn le.	n Cn le.
Et vous allez, enfin, la voir venir ici Pour rendre aux yeux de tous ce myſtere éclairci.	Et vous allez, enfin, la voir venir ici Pour rendre aux yeux de tous ce mystère éclairci.
CHRISALDE.	CHRISALDE.
Ie deuine à peu prés quel eſt voſtre ſupplice, Mais le ſort en cela ne vous eſt que propice;	Je devine à peu prés quel est votre supplice, Mais le sort en cela ne vous est que propice;
Si n’eſtre point cocu vous ſemble vn ſi grand bien, Ne vous pomnt murleren ent le traj hioyen.	Si n'être point cocu vous semble un si grand bien, Ne vous pomnt murleren ent le traj àjoyen.
Oh!	Oh!
ARNOLPHE s’en allant tout tranſporté & ne pouuaei paner.	ARNOLPHE s'en allant tout transporté et ne pouuaei paner.
ORONTE.	ORONTE.
D’où vient qu’il s’enfuit ſans rien dire?	D'où vient qu'il s'enfuit sans rien dire?
HORACE.	HORACE.
Ah mon pere Vous ſçaurez pleinement ce ſurprenant myſtere.	Ah mon père Vous saurez pleinement ce surprenant mystère.
Le hazard en ces lieux auoit executé Ce que voſtre ſageſſe auoit premedité.	Le hasard en ces lieux avait exécuté Ce que votre sagesse avait prémédité.
I’eſtois par les doux nœuds d’vne ardeur mutuelle Engagé de parole auecque cette Belle;	J'étais par les doux nœuds d'une ardeur mutuelle Engagé de parole avec cette Belle;
Et c’eſt elle en vn mot que vous venez chercher, Et pour qui mon refus a penſé vous faſcher.	Et c'est elle en un mot que vous venez chercher, Et pour qui mon refus a pensé vous fâcher.
4 2 IQVE.	4 2 IQUE.
Ie n’en ay point douté d’abord que ie l’ay veuë, Et mon ame depuis n’a ceſſé d’eſtre eſmeuë.	Je n'en ai point douté d'abord que sans l'ai vue, Et mon âme depuis n'a cessé d'être émue.
Ah!	Ah!
ma fille, ie cede à des tranſports ſi doux.	ma fille, Madame cède à des transports si doux.
CHRISALDE.	CHRISALDE.
I’en ferois de bon cœur, mon frere, autant que vous.	J'en ferais de bon cœur, mon frère, autant que vous.
Mais ces lieux & cela ne s’accommodent gueres;	Mais ces lieux et cela ne s'accommodent guère;
Allons dans la maiſon débroüiller ces myſteres, Payer à noſtre amy ces ſoins officieux, Et rendre grace au Ciel qui fait tout pour le mieux.	Allons dans la maison débrouiller ces mystères, Payer à notre ami ses soins officieux, Et rendre grâce au Ciel qui fait tout pour le mieux.
