M.	M.
DC.	DC.
XXXVII.	XXXVII.
Auec Priuilege du Roy.	Avec Privilège du Roi.
Extraict du Priuilege du Roy.	Extrait du Privilège du Roi.
Ar grace & Priuilege du Roy donné à Paris, le 7.	Ar grâce et Privilège du Roi donné à Paris, le 7.
Feurier, 1637.	Février, 1637.
Signe, Par le Roy en ſon Conſeil.	Signe, Par le Roi en son Conseil.
DE MONSSEAVX, Il eſt permis à ANTHOINE DE SOMMAVILLE, Marchand Libraire à Paris, d’imprimer ou faire imprimer, vendre & diſtribuer vne piece de Theatre, intitulee, L’Heureux Naufrage Tragi-comedie, durant le temps & eſpace de neuf ans, à compter du iour qu’elle ſera acheuee d’imprimer.	DE MONSEAUX, Il est permis à ANTHOINE DE SOMMAVILE, Marchand Libraire à Paris, d'imprimer ou faire imprimer, vendre et distribuer une pièce de Théâtre, intitulée, L'Heureux Naufrage Tragi-comédie, durant le temps et espace de neuf ans, à compter du jour qu'elle sera achevue d'imprimer.
Et deffences ſont faictes à tous Imprimeurs, Libraires, & autres, de contrefaire ladite piece, ny en vendre ou expoſer en vente de contréfaicte, à peine de trois mil liures d’amende, de tous ſes deſpens, dommages & intereſts;	Et défenses sont faites à tous Imprimeurs, Libraires, et autres, de contrefaire ladite pièce, notre en vendre ou exposer en vente de contréfaicte, à peine de trois mille livres d'amende, de tous ses dépens, dommages et intérêts;
ainſi qu’il eſt plus amplement porté par leſdites Lettres qui ſont en vertu du preſent Extraict tenuës pour bien & deuëment ſignifiees, à ce qu’aucun n’en pretende cauſe d’ignorance.	ainsi qu'il est plus amplement porté par lesdites Lettres qui sont en vertu du présent Extrait tenues pour bien et duement signifie, à ce qu'aucun n'en prétende cause d'ignorance.
ACTEVRS.	ACTEURS.
CLEANDRE.	CLÉANDRE.
Prince d’Epire.	Prince d'Epire.
FLORONDE.	FLORONDE.
Princeſſe d’Epire.	Princesse d'Epire.
SALMACIS.	SALMACIS.
Reyne de Dalmatie.	Reine de Dalmatie.
CEPHALIE.	CÉPHALIE.
Sœur dela Reyne de Dalmatie DORISMOND.	Sœur déla Reine de Dalmatie DORISMOND.
Seruiteur de Cephalie.	Serviteur de Céphalie.
LITLVRLVA AVITVXXINSE TRAGI-COMEDIE.	LITLURLVA AVITUXINSE -TAGI-COMÉDIE.
AISIE INENVIIER SCENE PREMIERE.	ÀISIE INENVIER SCÈNE PREMIÈRE.
CLEANDRE ſur vn lict vert, en vne chambre bien paree.	CLÉANDRE sur un lit vert, en une chambre bien parée.
Mbres, noirs habitans du tenebreux Empire, Que i’apprenne de vous en quel lieu ie reſpire, Quoy le Soleil me ſuit iuſques dans les enfers?	Mèbres, noirs habitants du ténébreux Empire, Que j'apprenne de vous en quel lieu autre respire, Quoi le Soleil me suit jusques dans les enfers?
Et i'y ſuis ſans bourreaux, ſans flames, & ſans fers?	Et j'y suis sans bourreaux, sans flammes, et sans fers?
O Dieux!	Ô Dieux!
en cet état moy-meſme ie m’ignore, Il ſemble qu’en mon corps mon ame agiſſe encore, Mon eſprit n’est troublé d’aucun ſuiet d’effroy, Spectre, ombre, ny Demon, ne ſe preſente à moy;	en cet état moi-même ie m'ignore, Il semble qu'en mon corps mon âme agisse encore, Mon esprit n'est troublé d'aucun sujet d'effroi, Spectre, ombre, ni Demon, ne se présente à moi;
Et ſi l'Enfer eſt tel, l’Empire de la vie,	Et si l'Enfer est tel, l'Empire de la vie,
Sur celuy de la mort à des ſuiets d’enuie, Dieux!	Sur celui de la mort à des sujets d'envie, Dieux!
que mon œil ouuert deſſus tant de beautés S’égare doucement dans leurs diuerſités;	que mon œil ouvert dessus tant de beautés S'égare doucement dans leurs diversités;
Que l’art en ceſte chambre a produit de merueille!	Que l'art en cette chambre a produit de merveille!
Voit on à ces tableaux des peintures pareilles?	Voit on à ces tableaux des peintures pareilles?
Quel monarque charmé de cet ameublement Se ſouhaitteroit mieux, & plus ſuperbement, O doutes ſuperflus!	Quel monarque charmé de cet ameublement Se souhaiterait mieux, et plus superbement, Ô doutes superflus!
l’Empire des tenebres Offre à ſes habitans des obiets plus funebres, Tout me rit, & iamais le celeſte flambeau Ne parut à mes yeux, plus brillant, ny plus beau, Mais ô ſuperbes lieux, vous n’auez point Floronde, Cette riche deſpoüille eſt le butin de l’onde, Ie ne voys point icy paroiſtre ſes appas, Et ie ſuis aux Enfers, quand ie ne la voys pas:	l'Empire des ténèbres Offre à ses habitants des objets plus funèbres, Tout me rit, et jamais le céleste flambeau Ne parut à mes yeux, plus brillant, Seigneur plus beau, Mais ô superbes lieux, vous n'avez point Floronde, Cette riche dépouille est le butin de l'onde, Je ne vois point ici paraître ses appas, Et ie suis aux Enfers, quand ie ne la vois pas:
Ouy i’habite Demons vos infernales riues, Ou ſe cachent de moy vos ombres fugitifues?	Oui j'habite Demons vos infernales rives, Ou se cachent de moi vos ombres fugitifues?
Tenebreux habitants du Zoyaume des morts, Venés, redoutés vous ce foible, & palle corps;	Ténébreux habitants du Zoyaume des morts, Vensez, redoutez -vous ce faible, et pale corps;
Pluton, rends l’aſſeurance à ton peuple timide, Ie marche ſans deſſein deſſus les pas d'Alcide, Conduits moy ſeulement aux riues de cette eau, Ou l’ame de Floronde a paſſé le bateau, Le bien de la reuoir bornera mes conqueſtes, L'Epire en ma faueur t'eſtablira des Feſtes, Tes freres enuieront les honneurs de ton nom,	Pluton, rends l'assurance à ton peuple timide, Je marche sans dessein dessus les pas d'Alcide, Conduits moi seulement aux rives de cette eau, Ou l'âme de Floronde a passé le bateau, Le bien de la ruoir bornera mes conquêtes, L'Epire en ma faveur t'établira des Fêtes, Tes frères envieront les honneurs de ton nom,
Et Proſerpine vn iour égalera Iunon, Mais ô faux entretien dont mon eſprit s’abuſe, Triſte diſcours, d’vne ame interdite, & confuſe, L’Enfer n’eſt point ſuiet aux trauerſes d’amour, I'ignore en quel endroict ie reſpire le iour, A peine de mon nom le ſouuenir me reſte, I'ignore ou m’a ietté ce naufrage funeste;	Et Proserpine un jour égalera Iunon, Mais ô faux entretien dont mon esprit s'abuse, Triste discours, d'une âme interdite, et confuse, L'Enfer n'est point sujet aux traverses d'amour, J'ignore en quel endroit quelque respire le jour, À peine de mon nom le souvenir me reste, J'ignore ou m'a jeté ce naufrage funeste;
Quoy l’Empire des flots, ce perfide element, A retenu l’amante, & reietté l’amant!	Quoi l'Empire des flots, ce perfide élément, À retenu l'amante, et rejetté l'amant!
O Dieux!	Ô Dieux!
quelle aduanture, à mon repos fatale, De ce moite tombeau m’a mis en ce Dadale?	quelle aventure, à mon repos fatale, De ce moite tombeau m'a mis en ce Dadale?
Quelle Ariadne offerte en cette occaſion Dißipera ma crainte, & ma confuſion!	Quelle Ariadne offerte en cette occasion Dissipera ma crainte, et ma confusion!
Mais vn obiet charmant, ou Venus elle-meſme Vient éclaircir ma doute, en cette peine extreme, Telle faiſant briller ſes appas infinis Cette mere d’amour va baiſer Adonis;	Mais un objet charmant, ou Venus elle-même Vient éclaircir ma doute, en cette peine extrême, Telle faisant briller ses appas infinis Cette mère d'amour va baiser Adonis;
Et telle d’Orient tous les matins deualle L'Epouſe de Tithon, dans les bras de Cephale;	Et telle d'Orient tous les matins dévalle L'Épouse de Tithon, dans les bras de Céphale;
SCENE DEVXIESME.	SCÈNE DEUXIÈME.
SALMACIS, Reyne de Dalmatie, CEPHALIE ſa ſœur, LE MEDECIN,CLEANDRE,	SALMACIS, Reine de Dalmatie, CÉPHALIE sa sœur, LE MÉDECIN,CLEANDRE,
SALMACIS.	SALMACIS.
Celeste merueille, ô diuin changement!	Celtes merveille, ô divin changement!
OQui ne peut proceder que du Ciel ſeulement;	OQui ne peut procéder que du Ciel seulement;
Ma ſœur il voit le iour.	Ma sœur il voit le jour.
CEPHALIE.	CÉPHALIE.
Mon ame en eſt rauie, Nous auons veu ſa mort, & nous voyons ſa vie.	Mon âme en est ravie, Nous avons vu sa mort, et nous voyons sa vie.
LE MEDECIN.	LE MÉDECIN.
Puiſque dans ce peril les Dieux l’ont conſerué, A quelques grands exploicts ſon bras eſt reſerué Son front promet beaucoup, & croyés qu’vn courage:	Puisque dans ce péril les Dieux l'ont conservé, À quelques grands exploits son bras est réservé Son front promet beaucoup, et croyez qu'un courage:
Eſt capable de tout, s’il ſçait vaincre vn orage.	Est capable de tout, s'il sait vaincre un orage.
CLEANDRE.	CLÉANDRE.
Incertain en quels lieux mon œil voit la clarté, Dißipez mes ſoucys, adorable beauté, Habitay-ie des eaux les cauernes profondes, Uos yeux comme Soleils brillent ils dans les ondes, Eſt-ce vne illuſion qui ſe preſente à moy?	Incertain en quels lieux mon œil voit la clarté, Diompez mes soucis, adorable beauté, Habitai-je des eaux les cavernes profondes, Uos yeux comme Soleils brillent ils dans les ondes, Est-ce quelque illusion qui se présente à moi?
Eſt-ce quelque Nayade, ou Thetis que ie voy;	Est-ce quelque Nayade, ou Thétis que ie cy;
MoZeray-ie enquerir quelle eſt voſtre naiſſance, Pour regler mon reſpect, par cette cognoiſſance.	Mocérai-je enquérir quelle est votre naissance, Pour régler mon respect, par cette connaissance.
A LMACIS.	À LMACIS.
Ma ſœur vous l’apprendra;	Ma sœur vous l'apprendra;
mais il eſt à propos Pour voſtre allegement, & pour voſtre repos, Que ce lict ſerue encor à ces membres debiles Sur qui les flots ont faict des efforts inutiles;	mais il est à propos Pour votre allégement, et pour votre repos, Que ce lit serve encor à ces membres débiles Sur qui les flots ont fait des efforts inutiles;
Et vous, puis que le Ciel à conſerué ſes iours, A les faire durer, preſtés voſtre ſecours Employés y vos ſoings, & que la medecine 2 din ſuuuyyerjeeren un ene carves aliale.	Et vous, puis que le Ciel à conservé ses jours, À les faire durer, prêtes toujours secours Employés y vos soings, et que la médecine 2 din suuuyyerjeeren un ene carves aliale.
Qui rende à ce beau corps ſa premiere ſanté, Et faſſe de ſa vie vn eternelle eſté.	Qui rende à ce beau corps sa première santé, Et fasse de sa vie un éternelle été.
LE MEDECINs’en allant I'employray pour ſes iours le ſoing que i’ay des voſtres, Et les ſecrets du Ciel, ſeconderont les noſtres.	LE MÊDECINs'en allant J'emploierai pour ses jours le soin que j'ai des vôtres, Et les secrets du Ciel, seconderont les nôtres.
CLEANDRE.	CLÉANDRE.
Il faut reſter ingrat, apres tant de bien faicts, Et mon reſſentiment ne peut auoir d’effects, Qu’heureux ſera le iour, ou cette triſte vie Que vous me conſerués, pour vous ſera rauie Uous me verrés vn cœur, & ſans feinte, & ſans fard, Et cette occaſion ne peut venir que tard.	Il faut rester ingrat, après tant de bien faits, Et mon ressentiment ne peut avoir d'effects, Qu'heureux sera le jour, ou cette triste vie Que vous me conservez, pour vous sera ravie Uous me verriez un cœur, et sans feinte, et sans fard, Et cette occasion ne peut venir que tard.
SALMACIS, aſſiſe prés de luy, auec Cephalie.	SALMACIS, assise près de lui, avec Céphalie.
Je ne veux pour tout prix, qu’apprendre qui i’oblige, Et le viſible deüil dont voſtre eſprit s'afflige, A iij Inſtruite là deſſus, vous ſçaurés qui ie ſuis, Et ie partageray vos ſoings, & vos ennuys;	Je ne veux pour tout prix, qu'apprendre qui j'oblige, Et le visible deuil dont votre esprit s'afflige, A j Instruite là dessus, vous saurez qui ie suis, Et ie partagerai vos soings, et vos ennuis;
CLEANDRE.	CLÉANDRE.
Mon pays est Epire, ou depuis tant de luſtres, La race des Thaumans, en tant d’exploits illuſtres, A ce peuple guerrier fait reuerer ſes loix Et ſe rend redoutable à tous les autres Rois, Le vaillant Thaumaſis, ſucceſſeur de ces Princet Depuis long-temps deſia gouuerne ces Prouinces, Mais que ſa fille helas, par ſes attraits vainqueurs Bien plus abſolument y gouuernoit les cœurs, Floronde fut le nom de cet Ange viſible Qui charmoit le plus dur, & le plus inſenſible, L’amour, & le plaiſir des ames, & des yeux, Et l’abregé mortel des merueilles des Cieux, Sa beauté captiuoit tous les Princes d'Epire, Et i’oſay comme tel, entrer ſous ſon Empire, Ie la ſeruy long-temps, & mon amour enfin Plus par vn malheureux, que par vn bon destin, En ſon cœur innocent ſe donna de l’entree, Et me fiſt enuier de toute la contree;	Mon pays est Epire, ou depuis tant de lustres, La race des Thaumands, en tant d'exploits illustres, A ce peuple guerrier fait révérer ses lois Et se rend redoutable à tous les autres Rois, Le vaillant Thaumasis, successeur de ces Princet Depuis longtemps déjà gouverne ces Provinces, Mais que sa fille hélas, par ses attraits vainqueurs Bien plus absolument y gouvernait les cœurs, Floronde fut le nom de cet Ange visible Qui charmait le plus dur, et le plus insensible, Eamour, et le plaisir des ames, et des yeux, Et abregé mortel des merveilles des Cieux, Sa et captiuoit tous les Princes d'Epire, Et osai aut, re sous son Empire, Ie la servi long-temps, et ' amour enfin Plus par malheureux, que par bon des, En mo cœur innocent se donna de entrée, Et me fît envier de toute la contrée;
Certain inſtinct ſecret vnit les volontés, Et diſpoſe des vœux, des cœurs, des libertét Jl furprend la raiſon, et ſa ſeule puiſſance Des inclinations forme la difference e fort instinct ſans qui tous nos efforts ſont vains,	Certain instinct secret unit les volontés, Et dispose des vœux, des cœurs, des libertét Jl surprend la raison, et sa seule puissance Des inclinations forme la différence e fort instinct sans qui tous nos efforts sont vains,
IAIGLCONEDIL.	JAIGLCONEDIL.
Fist à ceſte Princeſſe agreer mes deſſeins, Et i'eus de ſon amour de ſi certaines marques, Que i'estouffay tout ſeul l’eſpoir de cent Monarques, Mais que i'ay de malheur?	Fît à cette Princesse agréer mes desseins, Et j'eus de son amour de si certaines marques, Que j'étouffai tout seul l'espoir de cent Monarques, Mais que j'ai de malheur?
et que l’ambition Fut vn contraire obſtacle à noſtre affection;	et que l'ambition Fut un contraire obstacle à notre affection;
Le pere, au plus puiſſant voüa ceſte Princeſſe, Et pour le Roy de Thrace, engagea ſa promeſſe;	Le père, au plus puissant voüa cette Princesse, Et pour le Roi de Thrace, engagea sa promesse;
Dieux!	Dieux!
que ne peut l’amour en de ieunes eſprits?	que ne peut l'amour en de jeunes esprits?
Floronde eut ſa grandeur, & ſon ſceptre a meſpris, Apres ma paßion, toute autre l’importune, Elle remet ſur moy le ſoing de ſa fortune, Et d’vn comman accord, noſtre fidelité, Sur vn traiſtre Element cherche la ſeureté;	Floronde eut sa grandeur, et son sceptre à mépris, Après ma passion, toute autre l'importune, Elle remet sur moi le soing de sa fortune, Et d'un comman accord, notre fidélité, Sur un traître Élément cherche la sûreté;
Neptune, qui voyoit ſes graces infinies Sous ce faits glorieux tout ſes ondes vnies, Le Ciel nous obligea d’vn fauorable aſpect, Æole à tous les vents impoſa le reſpect, De petits Alcyons, chantans venoient en trouppe, Se percher ſur le mats, & voller ſur la pouppe, Et ſix fois le Soleil nous ramenera le iour, Sans que nous cogneußions autre ennemy qu’amour:	Neptune, qui voyait ses grâces infinies Sous ce faits glorieux tout ses poupes unies, Le Ciel nous obligea d'un favorable aspect, Æole tous les vents imposa le respect, De petits Alcyons, chantans venoient en trouppe, Se percher sur le mats, et voller sur la pouppe, Et six fois le Soleil nous ramènera le iour, Sans que nous cogneussions autre ennemi amour:
Mais Neptune bien-toſt monstra ſon iutenpance, Des traicts qu’elle dardoit ce lâche Dieu s’offence, Parce qu'elle le bruſle, il la veut ſubmerger, Et des feux, par les eaux reſout de ſe vanger, Tous les vents mutinés ſortent à ſa priere,	Mais Neptune bientôt montra son jutenpance, Des traits qu'elle dardait ce lâche Dieu s'offense, Parce qu'elle le brûle, il la veut submerger, Et des feux, par les eaux résout de se venger, Tous les vents mutinés sortent à sa prière,
Vne épaiſſe vapeur nous cache la lumiere, L'orage, d’vn beau iour, faict vne obſcure nuict, L’air retentit par tout d’vn effroyable bruict, Il en ſort vn faux iour, mais qui nous eſt contraire, Et qu’il nous esblouyt plus qu’il ne nous eſclaire, D'vn choc impetueux, les vents, & les rochers, Font naiſtre la frayeur dans le ſein des rochers, L’air redouble ſes bruicts,& le vent ſon haleine, Ce fier Tyran des airs, faict cent mont d’vne pleine, Il rompt, deſchire, fend, cordes, voiles, & mats.	Une épaisse vapeur nous cache la lumière, L'orage, d'un beau jour, fait quelque obscure nuit, L'air retentit par tout d'un effroyable bruit, Il en sort un faux jour, mais qui nous est contraire, Et qu'il nous éblouit plus qu'il ne nous éclaire, D'un choc impétueux, les vents, et les rochers, Font naître la frayeur dans le sein des rochers, L'air redouble ses bruits,et le vent son haleine, Et fier Tyran des airs, faict cent mont d'une pleine, Il rompt, déchire, de, bruits, voiles, et et.
Et ce triſte vaiſſeau, ne ſe recognoiſt pas;	Et ce triste vaisseau, ne se reconnaît pas;
Le Pilote est confus, la ſcience, & l’vſage, Contre les grands dangers ſont vn foible aduantage, Le timon dans ſes mains, n’est plus qu’vn vain fardeau Il laiſſe au gré des vents regir noſtre vaiſſeau, Et ce triſte iouët d’vn ſi puiſſant orage, Contre le port enfin, va faire ſon naufrage;	Le Pilote est confus, la science, et l'usage, Contre les grands dangers sont un faible avantage, Le timon dans ses mains, n'est plus qu'à vain fardeau Il laisse au gré des vents régir notre vaisseau, Et ce triste joueût d'un si puissant orage, Contre le port enfin, va faire son naufrage;
L’amour, ce foible Dieu ne nous pût ſecourir Et i’ignore quel ſort m’empeſcha d’y perir:	L'amour, ce faible Dieu ne nous pût secourir Et j'ignore quel sort m'empêcha d'y périr:
Miais quelqu'heureux deſtin qui m'ayt itre de l’onde, Son ſecours m’outrageoit, s’il y laiſſa Floronde, Et ſi de ſa ſplendeur ce ieune astre eſt priué, Mes mains me rauiront ce qu’il m’a conſerué;	Miais quelqu'heureux destin qui m'ait itre de l'onde, Son secours m'outrageait, s'il y laissa Floronde, Et si de sa splendeur ce jeune astre est privé, Mes mains me raviront ce qu'il m'a conservé;
SALMACIS, ſe leuant.	SALMACIS, se levant.
O fatal accident!	Ô fatal accident!
ie plains voſtre infortune, Mais reſſentés la moins, puis qu'elle m'est commune, Vous Vous me verrés, Monſieur, partager auec vous, e qui vous est amer, et ce qui vous eſt doux, Adieu, prenez chez nous vne entiere puiſſance, Et ſçachez de ma Sœur mon nom, & ma naiſſance.	Ce plains votre infortune, Mais ressentez la moins, puis qu'elle m'est commune, Vous Vous me verrez, Monsieur, partager avec vous, eu qui vous est amer, et ce qui vous est doux, Adieu, prenez chez nous une entière puissance, Et sachez de ma Sœur mon nom, et ma naissance.
CEPHALIE.	CÉPHALIE.
Dalmatie est la terre, où vous pouſſa le ſort Et quelques habitants vous treuuerent au port, Palle, ſans mouuement, & froid ſur le riuage, Où vous fustes ietté par l'effort de l’orage, A vous voir on iugea de vostre qualité, Et la Reyne paſſant où vous fustes porté, Voſtre ſort la toucha, ſes eſprits s’altererent, Et de jes triſtes yeux quelques larmes tomberent, Elle embraſſa le ſoin de voſtre gueriſon, Et vous fist tranſporter par ceux de ſa maiſon.	Dalmatie est la terre, où vous poussa le sort Et quelques habitants vous trouvèrent au port, Palle, sans mouvement, et froid sur le rivage, Où vous fûtes jeté par l'effort de l'orage, À vous voir on jugea de votre qualité, Et la Reine passant où vous fûtes porté, Votre sort la toucha, ses esprits s'altérèrent, Et de jes tristes yeux quelques larmes tombèrent, Elle embrassa le soin de votre guérison, Et vous fît transporter par ceux de sa maison.
Et ceſte;	Et cette;
CLEANDRE.	CLÉANDRE.
CEPHALIE.	CÉPHALIE.
encor vn mot vous tirera de peine, Ma Sœur est de ces lieux l’Vnique ſouueraine, Et vous treuués ches elle vn azile aſſeuré contiu quelque danger, qui vous ſoit preparé.	encor mot vous tirera de peine, Ma Sœur est de ces lieux l'Unique souveraine, Et vous trouvez chez elle vn asile assuré contiv quelque danger, qui vous soit préparé.
CLEANDRE.	CLÉANDRE.
Si par l’intention ſon ſoing est eſtimable, Quel Dieu m’oblige plus, & m'eſt plus adorable!	Si par l'intention son soing est estimable, Quel Dieu m'oblige plus, et m'est plus adorable!
Mais helas qu'en effect elle a deſobligé ------ u.	Mais hélas qu'en effet elle a désobligé -- .
.	.
be- e Vn qui ne voit le iour que pour eſtre affligé Floronde ne vit plus, la cholere de l’onde N’aura pas épargnè ce miracle du monde, Floronde, triſte obiet des iniures du ſort, Que l’amour en ton cœur fiſt vn fatal effort, Que i’eus vne faueur à ton repos funeſte, Que mon amour te fut vne mortelle peste, Et que pour ton bon-heur, tu deuois deteſter Le cœur que ie t’offris, au lieu de l’accepter:	be-leur , tu ne voit le jour que pour être affligé Floronde ne vit plus, la colère de l'onde N'aura pas épargné ce miracle du monde, Floronde, triste objet des injures du sort, Que l'amour en ton cœur fît un fatal effort, Que j'eus une faveur à ton repos funeste, Que mon amour te fut été mortelle peste, Et que pour ton bonheur, tu devais détester Le cœur que je t'offris, au lieu de l'accepter:
Pour moy tu dedaignas l'éclat d’vn Diadeſme, Ie te fis meſpriſer tes parens, & toy-meſme, Et i'expoſay tes iours ſur vn traiſtre Element, Qui n’a pû reſpecter vn obiet ſi charmant;	Pour moi tu dédaignas l'éclat d'un Diadesme, Je te fis mépriser tes parents, et toi-même, Et j'exposai tes jours sur un traître Élement, Qui n'a pu respecter un objet si charmant;
Un mal-heureux deſtin m'a ſauué de l’orage, Et tes membres ſacrés ont aſſouuy ſa rage.	Un malheureux destin m'a sauvé de l'orage, Et tes membres sacrés ont assoui sa rage.
Ie vis, & tu n'es plus!	Je vis, et tu n'es plus!
ô trop lâches douleurs, De n’auoir pour ta mort que de honteuſes pleurs;	ô trop lâches douleurs, De n'avoir pour ta mort que de honteuses pleurs;
de fuies mion jang ingrai eu tes uevues veines?	de fuies myon jang ingrai eu tes évues veines?
Qu'entretenir ma honte, & que nourrir mes peines?	Qu'entretenir ma honte, et que nourrir mes peines?
Un vain reſpect du Ciel deſtourne mon treſpas, Et Cleandre peut-eſtre, ou Floronde n’eſt pas?	Un vain respect du Ciel détourne mon trépas, Et Clandre peut-être, ou Floronde n'est pas?
	
CEPHALIE.	CÉPHALIE.
Mille autres à la mort font des plaintes pareilles, Mais comme elle eſt ſans yeux, elle n’a point d’oreilles, Elle établit pour tous d’inuiolables loix, Et traicte egalement les beigers, & tes Rois;	Mille autres à la mort font des plaintes pareilles, Mais comme elle est sans yeux, elle n'a point d'oreilles, Elle établit pour tous d'inviolables lois, Et traite également les beigers, et tes Rois;
I'approuue que vos pleurs moüillent voſtre viſage, La raiſon quelquefois n'en deffend point l’vſage, Mais il faut l’eſcouter dans le pire mal-heur, Et le courage enfin doit vaincre la douleur.	J'approuve que vos pleurs mouillent votre visage, La raison quelquefois n'en défend point l'usage, Mais il faut l'écouter dans le pire malheur, Et le courage enfin doit vaincre la douleur.
CLEANDRE.	CLÉANDRE.
Las!	Las!
que peut le courage en pareille infortune, Le regret est commun d’vne perte commune, Mais qui perd vn obiet pourueu de tant d’attraits, Que doit il deſirer, que de ſe perdre apres?	que peut le courage en pareille infortune, Le regret est commun d'une perte commune, Mais qui perd un objet pourvu de tant d'attraits, Que doit il désirer, que de se perdre après?
Onde, mouuant cercueil, Element infidelle, Reiette au moins ſon corps, rends quelque choſe d'elle;	Onde, mouvant cercueil, Élément infidèle, Reine au moins son corps, rends quelque chose d'elle;
I'acheueray le cours de mon ſort malheureux Sur ce triſte debris de l’Empire amoureux.	J'achèverai le cours de mon sort malheureux Sur ce triste débris de l'Empire amoureux.
O ſenſible mal-heur!	Ô sensible malheur!
ſeuere destinee, Ciel qui me l’as rauie, & me l’auois donnee, Romps de mes tristes ans le déplorable cours, Acheue mes ennuys, en acheuant mes iours.	sévère destine, Ciel qui me l'as ravie, et me l'avais donnée, Romps de mes tristes ans le déplorable cours, Acheve mes ennuis, en achevant mes jours.
CEPHALIE.	CÉPHALIE.
Cest trop vous afſiger d'vn mat-peur ſans remede, Que le repos, Monſieur, à ces plaintes ſuccede Ce corps debile, & las, a beſoing de ſommeil, Et nous verrons la Reyne apres voſtre reſueil.	Cest trop vous affiger d'un mat-peur sans remède, Que le repos, Monsieur, à ces plaintes succède Ce corps débile, et las, a besoing de sommeil, Et nous verrons la Reine après votre réveil.
ſe mettant CLEANDRE, ſur ieiicIe donneray ce temps à mon inquietude, Beaucoup plus qu’au ſommeil, & qu'à ma laßitude, Mais que iugereZ vous, excuſes vn eſprit,	se mettant CLEANDRE, sur DieuiicIe donnerai ce temps à mon inquiétude, Beaucoup plus qu'au sommeil, et qu'à ma lassitude, Mais que jugerez -vous, excuses un esprit,
B ij Saiſy, confas, troublé, furieux, interdit, Jncapable de tout, en l’eſtat miſerable, Où l’a mis la rigueur de ſon ſort déplorable.	 Saisy, confas, troublé, furieux, interdit, Incapable de tout, en l'état misérable, Où l'a mis la rigueur de son sort déplorable.
tirant les riCEPHALIE, d'aux ſur luy.	tirant les riCEPHALIE, d'aux sur lui.
Pou.	Pou.
Sous plaindrons plustoſt, reposés ſeulement, Et croyez qu’on a ſoing de voſtre allegement.	Sous plaindrons plutôt, reposés seulement, Et croyez qu'on a soin de votre allégement.
SCENE TROISIESME.	SCÈNE -TROISIÈME.
CEPHALIE, DORISMOND, CLEANDRE,	CÉPHALIE, DORISMOND, CLÉANDRE,
entrant doucement DORISMOND, Epaiantbas VVis-ie voir cet obiet dont parle tout le monde, T St rimet reſpecté de la rage de l’onde, Qui cauſe tant de bruict, & tant d’étonnement?	entrant doucement DORISMOND, Épayantbas VVis-je voir cet objet dont parle tout le monde, T St rimet respecté de la rage de l'onde, Qui cause tant de bruit, et tant d'étonnement?
le repouſ.	le repous.
CETTIILETE, ſant.	CETTILETTE, sant.
Vous le verrés tantoſt il repoſe vn moment;	Vous le verrez tantôt il repose un moment;
DORISMOND.	DORISMOND.
Ie puis ſans l’eſueiller,	Je puis sans l'éveiller,
CEPHALIE.	CÉPHALIE.
S'eſt gliſſé ſous ſes yeux, non, le ſommeil à peine	S'est glissé sous ses yeux, non, le sommeil à peine
DORISMOND.	DORISMOND.
il plaiſt fort à la Reyne,	il plaît fort à la Reine,
CEPHALIE.	CÉPHALIE.
C’eſt le luſtre, la gloire, & l’honneur de la Cour, C’eſt le plus rare obiet, qui vid iamais le iour,	C'est le lustre, la gloire, et l'honneur de la Cour, C'est le plus rare objet, qui vit jamais le jour,
DORISMOND.	DORISMOND.
Vous en dittes beaucoup,	Vous en dites beaucoup,
CEPHALIE.	CÉPHALIE.
et tout eſt legitime, Ie le peints moindre encor, qu’il n’est en mon eſtime.	et tout est légitime, Je le peints moindre encor, qu'il n'est en mon estime.
DORISMOND.	DORISMOND.
N'eſt-ce point quelque Dieu?	N'est-ce point quelque Dieu?
CEPHALIE.	CÉPHALIE.
quand ie le peindrois tel, Ayant oaimu ta mori, n don eſtre immortel Seul, il s’eſt conſerué dans vn peril extréme, Et s’eſt treuué viuant, au ſein de la mort meſme.	quand deux le peindrais tel, Ayant oaimu ta mory, n éon être immortel Seul, il s'est conservé dans un péril extrême, Et s'est trouvé vivant, au sein de la mort même.
DORISMOND.	DORISMOND.
Si bien-tost la raiſon ne vous vient ſecourir, raignés cet immortel, il vous fera mourir;	Si bientôt la raison ne vous vient secourir, raignez cet immortel, il vous fera mourir;
Mais d’vne douce mort, qu’on prefere à la vie.	Mais d'une douce mort, qu'on préfère à la vie.
CEPHALIE.	CÉPHALIE.
Iugés, combien ſa veuë excitera d’enuie, Et dans quelle manie il vous reduiraibus, Puisque ſans l’auoir veu, vous en eſtes ialoux, Mais ſouffrés qu’il revoſe, & tantoſt	Jugez, combien sa vue excitera d'envie, Et dans quelle manie il vous réduiraibus, Puisque sans l'avoir vu, vous en êtes jaloux, Mais souffrez qu'il revose, et tantôt
DORISMOND.	DORISMOND.
te oum taue, N’ostés point à ce Dieu l’obiet de ſa Deeſſe, Reuere-t’il ſi peu vos attraits glorieux, Et pres de ſon Soleil peut-il fermer les yeux ?	te oum oie, N'ôtez point à ce Dieu l'objet de sa Déesse, Revère-t-il si peu vos attraits glorieux, Et pres de son Soleil peut-il fermer les yeux ?
CEPHALIE.	CÉPHALIE.
On ſouffre d’vn ialoux, il a droict de ſe plaindre, Ainſi que nous l'auons de ne nous point contraindre.	On souffre d'un jaloux, il a droit de se plaindre, Ainsi que nous l'avons de ne nous point contraindre.
MMais voyons ſi touſiours ileſt'en meſme poinct, Ou s’il prend du repos, luy qui n'en laiſſe point.	MAis voyons si toujours ilest'en même point, Ou s’il prend du repos, lui qui n'en laisse point.
ſe iettant à CLEANDRE, bas duiig C’eſt trop laiſſer Cleandre, aſſoupir ton courage En vn ſi beau ſuiet de fureur & de rage, Il eſt ſaiſon helas, de pleurer, de gemir De plaindre, de crier, et non pas de dormir;	se jetant à CLEANDRE, bas duiig C'est trop laisser Cléandre, assoupir ton courage En un si beau sujet de fureur et de rage, Il est saison hélas, de pleurer, de gémir De plaindre, de crier, et non pas de dormir;
Le repos t’est honteux, hors du ſein de Flaronde De celuy de la terre, ou de celuy de l’onde, Il faut, il faut mourir, & le ſecours du temps Ne peut remedier aux ennuys que tu ſens;	Le repos t'est honteux, hors du sein de Flaronde De celui de la terre, ou de celui de l'onde, Il faut, il faut mourir, et le secours du temps Ne peut remédier aux ennui que tu sens;
Quel fer en ce beſoing ſeconde mon enuie?	Quel fer en ce besoing seconde mon envie?
Quel poiſon, ou quel feu s’offre à m’oſter la vie?	Quel poison, ou quel feu s'offre à m'ôter la vie?
Floronde ne vit plus!	Floronde ne vit plus!
ô Ciel!	ô Ciel!
ô Dieux cruels:	ô Dieux cruels:
Inſenſibles Autheurs de nos vœux mutuels, Si pour larmes, ny cris, vous ne le pouuez rendre, Acheuez de la perdre, elle vit en Cleandre, Perdez, ce malheureux, frappés, tués, tonnés, AuanceZ le treſpas que vous me deſtinés, Que deſia ſous mes pas la terre n'eſt ouuerte;	Insensibles Auteurs de nos vœux mutuels, Si pour larmes, ni cris, vous ne le pouvez rendre, Achevez de la perdre, elle vit en Cléandre, Perdez, ce malheureux, frappez, tuez, tonnez, Avance le trépas que vous me destinez, Que déjà sous mes pas la terre n'est ouuerte;
* 3 Tout ept joura pounta tenure, & tout teſt pourma perte.	* 3 Tout épt joura pounta tenure, et tout test pourma perte.
HALIE.	HALIE.
C'est paſſer la douleur, & ſes iuſtes regrets ce vos ennuys ſoient grands, mais qu'ils ſoient plus ſecrets.	C'est passer la douleur, et ses justes regrets ce vos ennuis soient grands, mais qu'ils soient plus secrets.
Si vous deuez ſouffrir, ſouffreZ auec courage, Et que voſtre raiſon conſerue ſon vſas e 5 Sortons, voyons la Reyne vne heure ſeulement, Et donneZ quelque trefue à ce cruel tourment.	Si vous devez souffrir, souffrez a page, Et que votre raison conserve son usez e 5 Sortons, voyons la Reine grande heure seulement, Et donnez quelque trêve à ce cruel tourment.
IECEEIE SCENE PREMIERE.	IECEEIE SCÈNE PREMIÈRE.
CEPHALIE, LA NOVRRICE,	CEPHALIE, LA NOURRICE,
LA NOVRRICE.	LA NOURRICE.
Dieux!	Dieux!
que dites vous?	que dites -vous?
CEPHALIE.	CÉPHALIE.
Que ce Prince d'Epire.	Que ce Prince d'Epire.
D'vn inſenſible effort me met ſous ſon Empire, La Parque ſans effect à ſes iours aſſaillis Elle voit ſes efforts, & ſes deſſeins faillis, La mer l’a reſpecté, cet Element barbare Ne fut pas ſans pitié pour vn obiet ſi rare, It a maigre ie ourpit vents, l’onde, & le ſort, Pour me faire mourir, triomphé de la mort.	D'un insensible effort me met sous son Empire, La Parque sans effet à ses jours assaillis Elle voit ses efforts, et ses desseins faillis, La mer l'a respecté, cet Élement barbare Ne fut pas sans pitié pour un objet si rare, It a maigre ie ourpit us, l'onde, et le sort, Pour me faire mourir, triomphé de la mort.
LA NOVRRICE.	LA NOURRICE.
Madame, au nom dumtur, conſultés dauantage Sur ce triſte deſſein, où voſtre eſprit s'enge J.	Madame, au nom dumtur, consultés davantage Sur ce triste dessein, où votre esprit s'enge J.
v2 !	v2 !
Ie ne puis condamner vos inclinations, Et ie pourrois flatter vos ieunes paßions:	Je ne puis condamner vos inclinations, Et ici pourrais flatter vos jeunes passions:
Mais voſtre deſplaiſir me ſeroit trop ſenſible, Et ie vous promettrois vn ſecours impoßible;	Mais votre déplaisir me serait trop sensible, Et je vous promettrais un secours impossible;
Détournés cent malheurs;	Détournés cent malheurs;
étouffés ce ſerpent, Que deſia vous ſentés en voſtre ſein rampant, Que ce deſſein fatal en ſa naiſſance auorte, Et rompés voſtre chaiſne auant qu'ele ſoit forte, La Reyne a pour ce Prince;	étouffez ce serpent, Que déjà vous sentez en votre sein rampant, Que ce dessein fatal en sa naissance avorte, Et rompez votre chaîne avant qu'èle soit forte, La Reine a pour ce Prince;
CEPHALIE.	CÉPHALIE.
Hâ que m’apprenés vous?	Hâ que m'apprenezez -vous?
LA NOVRRICE.	LA NOURRICE.
Un tœur trop amoureux, & des yeux trop ialoux, Cette vifible ardeur à chaſque heure s’augmente, Et iamais paßion ne fut ſi vehemente.	Un tœur trop amoureux, et des yeux trop jaloux, Cette visible ardeur à chasque heure s'augmente, Et jamais passion ne fut si véhémente.
CEPHALIE.	CÉPHALIE.
La Reyne ayme Cleandre?	La Reine aime Clandre?
ô Dieux!	ô Dieux!
LA NOVRRICE.	LA NOURRICE.
plus que le iour, Et me vient d’engager à ſeruir ſon amour.	plus que le jour, Et me vient d'engager à servir son amour.
CEPHALIE.	CÉPHALIE.
O fatal accident, aduanture cruelle!	Ô fatal accident, aventure cruelle!
Vous m’annoncés la-mort auec ceſte nouuelle;	Vous m'annoncez la-mort avec cette nouvelle;
Que de ſa paßion le ſuccés ſera prompt, Que ne peut point l’amour le Diad ſme au front?	Que de sa passion le succès sera prompt, Que ne peut point l'amour le Diad sme au front?
́	
LA NOVRRICE.	LA NOURRICE.
Vous ſçaués ſes regrets pour certaine Floronde Qu'il croit eſtre immolee à la fureur de l’onde.	Vous savez ses regrets pour certaine Floronde Qu'il croit été immolée à la fureur de l'onde.
CEPHALIE.	CÉPHALIE.
Hé!	Hé!
qui ne les ſçait pas?	qui ne les sait pas?
LA NOVRRICE.	LA NOURRICE.
eſcoutés en deux mots.	écoutés en deux mots.
Ce que la Reyne a faict pour leur commun repos:	Ce que la Reine a fait pour leur commun repos:
Dans toutes les maiſons voiſines du riuage, On a cherché quelqu’vn eſchappé du naufrage, Qui corrompu par l’or, ce metail ſi charmant, De la mort de Floronde aſſeuraſt cet amant, Elle croit que ce Prince apres ceſte aſſeurance En perdra la memoire, en perdant l’eſperance, J’ay dans ceſte recherche employé mon effort, Tant qu'vn de ſes valets, qui croyoit qu’il fuſt mort, Eſchappé comme luy du courroux de Neptune, Et rauy de l’eſpoir d’vne grande fortune, S’offre de teſmoigner, que Floronde à ſes yeux Eſt tombee où l’orage eſtoit plus furieux, Et que ſi pas vn d’eux deut perdre la lumiere, Cette ieune beauté la perdit la premiere.	Dans toutes les maisons voisines du rivage, On a cherché quelqu'un échappé du naufrage, Qui corrompu par l'or, ce métail si charmant, De la mort de Floronde assurât cet amant, Elle croit que ce Prince après cette assurance En perdra la mémoire, en perdant l'espérance, J'ai dans cette recherche employé mon effort, Tant qu'un de ses valets, qui croyait qu'il fût mort, Échappé comme lui du courroux de Neptune, Et ravi de l'espoir d'une grande fortune, S'offre de témoigner, que Florde à ses yeux Est tombe où l'orage estoit plus furieux, Et que si pas eux deut perdre la lumière, Cette ieune beauté la perdit la première.
Ce triſte m'ſſager de naufrage, & de mort, Attend l’occaſion de faire ſon rapport, Et la Reyne l'effect de ce diſcours funeſte, Mais de ſa propre voix vous apprenatuidreſte, Puiſqu'elle vient à nous,	Ce triste m'ssager de naufrage, et de mort, Attend l'occasion de faire son rapport, Et la Reine l'effet de ce discours funeste, Mais de sa propre voix vous apprenatuidreste, Puisqu'elle vient à nous,
SCENE DEVXIESME.	SCÈNE DEUXIÈME.
SALMACIS, CEPHALIE, LA NOVRRICE, SAEMACTS.	SALMACIS, CÉPHALIE, LA NOURRICE, SAEMACTS.
HEureuſe es chere ſœur, Qu’au prix de mon deſtin ton ſort a de douceur, Que le Ciel à iamais t’exempte de la peine Que faict aux ieunes cœurs vne amour incertaine, Le mien languit eſclaue en des liens ſi forts, Que les briſer iamais excede mes efforts;	HEureuse es chère sœur, Qu'au prix de mon destin ton sort a de douceur, Que le Ciel à jamais t'exempte de la peine Que fait aux jeunes cœurs une amour incertaine, Le mien languit esclaue en des liens si forts, Que les briser jamais excède mes efforts;
Il n'eſt plus à propos de celer mon ſeruage, Et mon inquietude eſt peinte en mon viſage, Ce Prince reueré de l’Empire des flots, Qui conſerua ſes iours, ſans l’art des matelots, Tout palle & tout changé par l’effort de l’orage, Meſme en ce triſte état ébranla mon courage, A ſon corps tout ſoüillé, certain charme eſtoit ioinct.	Il n'est plus à propos de celer mon servage, Et mon inquiétude est peinte en mon visage, Ce Prince révéré de l'Empire des flots, Qui conserva ses jours, sans l'art des matelots, Tout palle et tout changé par l'effort de l'orage, Même en ce triste état ébranla mon courage, À son corps tout soüillé, certain charme était joint.
Et la mort ſur ſon front ne m'épouuanta point:	Et la mort sur son front ne m'épouvanta point:
S’il auoit des attraits en ce poinct deplorable, Que voit-on maintenant qui luy ſoit comparable?	S'il avait des attraits en ce point déplorable, Que voit-on maintenant qui lui soit comparable?
Et qui peut ſans enuie, ou ſans aueuglement, Nier à ce vainqueur le tiltre de charmani?	Et qui peut sans envie, ou sans aveuglement, Nier à ce vainqueur le titre de charmani?
	
C	Ç
CEPHALIE.	CÉPHALIE.
I'ignore de l’amour, & les traicts, & les flames, J'ignore le pouuoir de ce tyran des ames, Vim joit affection, amour, flame, ou deſir, Ie ne le vois iamais ſans beaucoup de plaifir.	J'ignore de l'amour, et les traits, et les flammes, J'ignore le pouvoir de ce tyran des âmes, Vim ait affection, amour, flamme, ou désir, Je ne le vois jamais sans beaucoup de plaisir.
SALMACIS.	SALMACIS.
La fristeſſe en ſes veux jemvie estre naturelle, Tant elle y prend d’éclat, et tant il la faict belle.	La fristesse en ses veux jemvie être naturelle, Tant elle y prend d'éclat, et tant il la fait belle.
CEPHALIE.	CÉPHALIE.
Ses pleurs ont des beautés, que certains ris n’ont pas, Et ſa melancholie a de charmans appas;	Ses pleurs ont des beautés, que certains ris n'ont pas, Et sa mélancolie a de charmants appas;
SALMACIS, Ton ſentiment m'oblige, & ie croy mon estime Par ton opinion encor plus legitime;	SALMACIS, Ton sentiment m'oblige, et je crois mon estime Par ton opinion encor plus légitime;
Employe à'm’acquerir ſes charmes ſans pareils, Tes ſoings industrieux, & tes ſages conſeils;	Emploie à'm'acquérir ses charmes sans pareils, Tes soins industrieux, et tes sages conseils;
Il s’en offre vn moyen:	Il s'en offre un moyen:
deſia toute l’Epire, Qui ſçait que dans ma Cour ce ieune Mars reſpire, Ne medite qu’horreur, que carnage, & qu’effroy, Si ie ne le remets dans les mains de ſon Roy.	déjà toute l'Epire, Qui sais que dans ma Cour ce jeune Mars respire, Ne médite qu'horreur, que carnage, et qu'effroi, Si ie ne g remets dans les mains de son Roi.
Par vn Ambaſſadeur arriué dans mes terres, luyfprus qu’on veut ſa perte, ou d’éternelles guerres.	Par un Ambassadeur arrivé dans mes terres, luyfprus qu'on veut sa perte, ou d'éternelles guerres.
J’ay faict pouruoir lara des viures qu’il y faut, Et ceſte triſte Ville attend vn rude aſſaut.	J'ai fait pourvoir lara des vivres qu'il y faut, Et cette triste Ville attend un rude assaut.
Or, voicy le moyen de m’acquerir Cleandre, Jl voit combien de ſoings i’employe à le deffendre, - A.	Or, voici le moyen de m'acquérir Clandre, Il voit combien de soings j'emploie à le défendre, - A.
œ-	œ-
Il me voit irriter de puiſſants Potentats, Et pour ſon interest hazarder mes Eſtats, Il voit entre ſes mains nos fortunes remiſes, Il preſide aux conſeils, aux ſoings, aux entrepriſes:	Il me voit irriter de puissants Potentats, Et pour son intérêt hasarder mes États, Il voit entre ses mains nos fortunes remises, Il preside aux conseils, aux soings, aux entreprises:
Ainſi i’ay ſans effort, & d’vn ſubtil lien, Treuué l’art d’attacher ſon intereſt au mien.	Ainsi j'ai sans effort, et d'H subtil lien, Treuué l'art d'attacher son intérêt au mien.
Il reſte d’effacer vne importune idee, Que ſon fidelle eſprit a ſi long-temps gardee:	Il reste d'effacer une importune idée, Que son fidèle esprit a si longtemps gardée:
Il regrette Floronde, & pleignant ſon deſtin Doute encor que les flots en ayent faict leur butin, Et moy, pour aſſeurer ſa croyance incertaine, Qui nous cauſe à tous deux vne ſi longue peine, Comme de tous effects les preſens ſont Autheurs, I'ay gaigné par argent vn de ſes ſeruiteurs, Dont les flots irrités n’ont épargné la vie Qu’affin qu’il pûst ſeruir mon amoureuſe enuie:	Il regrette Floronde, et pleignant son destin Doute encor que les flots en aient fait leur butin, Et moi, pour assurer sa croyance incertaine, Qui nous cause à tous deux une si longue peine, Comme de tous effets les présents sont Auteurs, J'a igné par argent un de ses serviteurs, Dont les flots irrités n'ont épargné la vie Qu'affin qu'il pût servir mon amoureuse envie:
Il luy doit teſmoigner, que Floronde n’eſt plus, Et flatte mon amour d’vne attente ſi chere Que ie croy poſſeder, parce que ie l’eſpere.	Il lui doit témoigner, que Floronde n'est plus, Et flatte mon amour d'une attente si chère Que je crois posséder, parce que personne l'espère.
O Ciel!	Ô Ciel!
ſois fauorable à mes iuſtes defirs, Fay naistre vn chaſte hymen, & d’innocens plaiſirs, Ainſi tous les mortels reuerent ta puiſſance, Et beniſſent touſiours ton immortelle eſſence;	sois favorable à mes justes désirs, Fa naître un chaste hymen, et d'innocents plaisirs, Ainsi tous les mortels révèrent ta puissance, Et bénissent toujours ton immortelle essence;
Voila ce beau vainqueur, Nourrice, de ce pas Qu' Loyſanor luy vienne annoncer ce treſpas.	Voilà ce beau vainqueur, Nourrice, de ce pas Qu' Loysanorblé vienne annoncer ce trépas.
SCENE TROISIESME, SALMACIS, CLEANDRE, CEPHALIE,	SCÈNE -TROISIÈME, SALMACIS, CLEANDRE, CÉPHALIE,
CEPHALIE.	CÉPHALIE.
Ve ſes charmes ſont doux!	Ve ses charmes sont doux!
CLEANDRE.	CLÉANDRE.
Jl faut donc, grande Reyne, Que mon malheur vous couste vne éternelle peine?	Il faut donc, grande Reine, Que mon malheur vous coûte une éternelle peine?
Quel ſort iniurieux, m'a faict mal à propos Uenir iuſques chés vous troubler voſtre repos?	Quel sort injurieux, m'a fait mal à propos Uenir jusques chez vous troubler votre repos?
Si i’auois pour vous plaire employé cette eſpee, Si pour vous cette main s’eſtoit veuë occupee, Et ſi i’auois, Madame, aux deſpens de mon ſang Entre vos ſeruiteurs merité quelque rang, Cette peine au beſoing pourroit m'eſtre accordee, Et vostre courtoiſie au moins ſeroit fondee, Mais qu'vn rebut des flots, qui n’a rien merité, Treuue un accueil ſi doux chés voſtre Majeſté, Abbaiſſe vos penſers iuſques à ſa miſere C’est perdre vos faueurs, pluſtoſt que de les faire, N’eſtoit-ce pas aſſés, que vos pieux efforts Euſſent rendu le iour a ce mal-heureux cor ps - 3 Sans me ſeruir encor contre vos amys meſmes, Et hazarder pour moy, iuſqu’à des Diadeſmes, Euités de l’Epire, & la rage, & l’horreur, Liurès ce mal-heureux à ſa iuſte fureur, Appaiſes de ſon Roy le courroux equitable, Sauués les innocents, & perdés le coupable, dat me joyto pus vonnt à vos propres deſpens Et ne détournés point le treſpas que i’attends,	Si j'avais pour vous plaire employé cette espee, Si pour vous cette main s'était vue occupée, Et si j'avais, Madame, aux dépens de mon sang Entre vos serviteurs mérité quelque rang, Cette peine au besoing pourrait m'-être accordée, Et votre courtoisie au moins serait fondée, Mais qu'un rebut des flots, qui n'a rien mérité, Treuve un il si doux chez votre Majesté, Abaisse vos pensers jusqu' à sa misère C'est perdre vos faveurs, plustost que de les urs, PLestoit-ce urs assés, que vos plu tôt Que de le iour a ce mal-heureux cor s - 3 Fa me servir encor contre vos amis mêmes, Et hazarder pour moi, iusqu’ des Diadesmes' Euités de Epire, et a rage, et horreur, y ce mal-ce pas asse fureur, Que de son Roy le urs équitable, Sa les innocents, et perdés si pou, r m joyto pus vonnt l' à ce dépens Et ne ure point le trépas que attends,
ALMACIS.	ÀLMACIS.
Eſt-ce que vostre cœur ſent de la violence En vn ſi beau ſuiet d’exercer ſa vaillance?	Est-ce que votre cœur sent de la violence En un si beau sujet d'exercer sa vaillance?
Toute la Dalmatie attend de vostre bras L’honneur de voir l’Epire, & ſa Couronne à bas;	Toute la Dalmatie attend de votre bras L'honneur de voir l'Epire, et sa Couronne à bas;
Et comme ſi deſia vos mains eſtoient laſſees Voſtre eſprit s'entretient de funestes penſees.	Et comme si déjà vos mains étaient lassées Votre esprit s'entretient de funestes pensées.
Uoyons à quoy le Ciel a deſtiné vos ans, Et mourons glorieux, ou viuons triomphans.	Uoyons à quoi le Ciel a destiné vos ans, Et mourons glorieux, ou vivons triomphants.
CLEANDRE.	CLÉANDRE.
ds lin felste momti ina vit est heſinee , Touſiours en butte au ſort, touſiours infortunee, Et l’horreur de la mort eſt plus chere à mes yeux, Que ne leur fut iamais la lumere nes Giena,	ds lin felstte momti ina vit est hesinee , Toujours en butte au sort, toujours infortunée, Et l'horreur de la mort est plus chère à mes yeux, Que ne leur fut jamais la lume nés Giena,
SALMACIS.	SALMACIS.
A qui n’eſpere rien, la mort eſt ſouhaitable;	À qui n'espère rien, la mort est souhaitable;
Mais de quelles grandeurs n'eſtes-vous point capable?	Mais de quelles grandeurs n'êtes-vous point capable?
CLEANDRE, Floronde ne vit plus, & ſa poſſeßion, Eſtoit le ſeul obiet de mon ambition.	CLEANDRE, Floronde ne vit plus, et sa passion, Était le seul objet de mon ambition.
SALMACIS.	SALMACIS.
Que vous pouuoit Floronde offrir qu’vne Couronne?	Que vous pouvait Floronde offrir qu'une Couronne?
Et qu'importe qu'vne autre, ou qu'eut vous la donne?	Et qu'importe qu'une autre, ou qu'eut vous la donne?
CLEANDRE, Elle s’offroit ſoy-meſme, & c’estoit me donner Tout ce qu’vn heureux ſort me pouuoit deſtiner.	CLEANDRE, Elle s'offrait soi-même, et c'était me donner Tout ce qu' Heureux sort me pouvait destiner.
SIEMIICIOS.	SIEMICIOS.
Donc aucune à vos yeux ne peut eſtre ſi belle, Et vous n’y treuués rien, de ce qui fut en elle?	Donc aucune à vos yeux ne peut être si belle, Et vous n'y trouvez rien, de ce qui fut en elle?
CLEANDRE.	CLÉANDRE.
Toutes ont pour mes yeux de trop dignes attraits, Maη tvurtς poui mom cuun om umutiles traits.	Toutes ont pour mes yeux de trop dignes attraits, Ma tvurtς pouy moment cuun om umiles traits.
SALMACIS.	SALMACIS.
Pour l’oublier ſi-toſt, ſa perte eſt trop recente, Mais la force du temps paſſera voſtre attente.	Pour l'oublier sitôt, sa perte est trop récente, Mais la force du temps passera votre attente.
CHEANDRV.	CHÉANDRU.
Auant que de former des deſſeins inconstants, Ie m'exempteray bien de la force du temps.	Avant que de former des desseins inconstants, Je m'exempterai bien de la force du temps.
SALMACIS.	SALMACIS.
La mort ſeule vous peut ſoustraire à ſon Empire.	La mort seule vous peut soustraire à son Empire.
SA –	SA 
CLEANDRE.	CLÉANDRE.
Et la mort eſt außi le ſeul bien ou i'aſpire.	Et la mort est aussi le seul bien ou j'aspire.
SALMACIS, ſas Ma ſœur, luy dois-ie, ouurir les ſecrets de mon ſein, Halnon, reſiſte, lâche, a ce honteux deſſein.	SALMACIS, sas Ma sœur, lui dois-je, ouvrir les secrets de mon sein, Halnon, résiste, lâche, à ce honteux dessein.
CEPHALIE.	CÉPHALIE.
Vous n’aués que trop dit, ſa froideur eſt extréme Et me touché (Madame) à l'égal de vous-meſme.	Vous n'avez que trop dit, sa froideur est extrême Et me touché (Madame) à l'égal de vous-même.
ALMACIS.	ÀLMACIS.
L’abſence change enfin les plus fermes amants, Et le temps reſoudra vos diuers ſentiments:	L'absence change enfin les plus fermes amants, Et le temps résoudra vos divers sentiments:
Cependant estimés que ie tire aduantage Et de voſtre preſence, & de voſtre courage, Et qu’auecques vos ſoings, et vos ſages conſeils, Ie meſpriſe l’Epire, & tous ſes appareils.	Cependant estimez que ainsi tire avantage Et de votre présence, et de votre courage, Et qu'avec vos soings, et vos sages conseils, Je méprise l'Epire, et tous ses appareils.
CLEANDRE, Pour n’estre pas ingrat, plus que pour ma deffence, J'employray tous mes ſoings, & toute ma puiſſance;	CLEANDRE, Pour n'être pas ingrat, plus que pour ma défense, J'emploierai tous mes soins, et toute ma puissance;
Ce cœur ne ſera lent, ny ces bras engourdis, Et ie mettray la peur au ſein des plus hardis.	Ce cœur ne sera lent, ni ces bras engourdis, Et ici mettrai la peur au sein des plus hardis.
SCENE QVATRIESME.	SCÈNE QUATRIÈME.
LA REYNE, CEPHALIE, CLEANDRE, LA NOVRRICE,	LA REINE, CÉPHALIE, CLEANDRE, LA NOURRICE,
LA NOVRRICE.	LA NOURRICE.
Onſieur, vn de vos gens, treuué ſur le riuage, IV TOù le Ciel comme vous le tira du naufrage, Demande à vous parler.	Onsieur, un de vos gens, trouvé sur le rivage, IV TOù le Ciel comme vous le tira du naufrage, Demande à vous parler.
CLEANDRE, O Dieux!	CLÉANDRE, Ô Dieux!
dois-ie eſperer, Qu'il me reſte quelqu’vn auec qui ſouſpiren?	dois-je espérer, Qu'il me reste quelqu' auec qui soupiren?
Que voſtre Maieſté ſouffre que ie le voye, le reuiens,	Que votre Majesté souffre que sans le voie, le reviens,
SALMACIS.	SALMACIS.
Non, qu’il entre.	Non, qu'il entre.
CLEANDRE.	CLÉANDRE.
Une ſecrette ioye Réueille en mon eſprit certain reſte d'eſpoir;	Une secrète joie Réueille en mon esprit certain reste d'espoir;
SCENE CINQVIESME.	SCÈNE CINQUIÈME.
qui eſt LA NOVRRICE, LISANOR, flosonde LA NOVRRICE.	qui est LA NOURRICE, LISANOR, flotonde LA NOURRICE.
Ntrés;	Ntrés;
CLEANDRE, rauy C’eſt toy mon cœur!	CLEANDRE, ravi C'est toi mon cœur!
ô Dieux!	ô Dieux!
te puis-ie voir?	te puis-je voir?
Quoy ie reuoy?	Quo ie revoi?
Iuy fait ſigne des yeux, & L'ISANOR, ſuy ſertant les mains Monſieur, que la rage de l’onde, Au lieu de me ſauuer, n’a reſpecté Floronde:	Jui fait signe des yeux, et L'ISANOR, suis sertant les mains Monsieur, que la rage de l'onde, Au lieu de me sauver, n'a respecté Floronde:
I'ay veu tomber, helas!	J'ai vu tomber, hélas!
dans ce traiſtre Element Au faux iour d’vn éclair, cet obiet ſi charmant;	dans ce traître Élément Au faux jour d'un éclair, cet objet si charmant;
Et vonue pour moy feuu ne fen pus tnpuede, Affin que vous ſçeußiés ceste triſte nouuelle.	Et veue pour moi feu ne sen pus tnpuede, Affin que vous sçeussiés cette triste nouvelle.
faiſant le CLEANDRE, uiſte Floronde ne vit plus?	faisant le CLEANDRE, uiste Floronde ne vit plus?
LYSANOR.	LYSANOR.
Je vis ce corps ſi beau Diſparoistre cent fois, & paroistre ſur l’eau, Poſſedant ce butin, les ondes glorieuſes Pouſſerent iuſqu’au Ciel leurs vagues furieuſes, D ij S'étendirent en l’air, & paſſerent leurs bords, De peur qu’elles auoient de perdre ce beau corps;	Je vis ce corps si beau Disparaître cent fois, et paraître sur l'eau, Possédant ce butin, les ondes glorieuses Poussèrent jusqu'au Ciel leurs vagues furieuses, D ij S'étendirent en l'air, et passèrent leurs bords, De peur qu'elles avaient de perdre ce beau corps;
Qu'en ce mouuant cercueil, n’eus-ie ma ſepulture, Quand le Ciel me fiſt voir ceſte triſte aduanture.	Qu'en ce mouvant cercueil, n'eus-je ma sépulture, Quand le Ciel me fît voir cette triste aventure.
CLEANDRE.	CLÉANDRE.
C’eſt, Prince infortuné, c’est apres ce diſcours, Qu’il t’est lâche et honteux de conſeruer tes iours, Souffrés mon deſeſpoir, & que mon corps, Madame, Tombe deſſous l’effort de cette heureuſe lame;	C'est, Prince infortuné, c'est après ce discours, Qu'il t'est lâche et honteux de conserver tes jours, Souffriez mon désespoir, et que mon corps, Madame, Tombe dessous l'effort de cette heureuse lame;
Otms mpejmemens!	Otms mpejmemens!
ô deſſeins ſuperflus!	ô desseins superflus!
De vouloir que ie viue, & Floronde n’eſt plus, O cruel accident!	De vouloir que personne vive, et Floronde n'est plus, Ô cruel accident!
ô fatale aduanture!	ô fatale aventure!
SALMACIS, Je la plains comme vous, & ie ſçay qu’elle est dure, Mais vous faictes paroiſtre vn cœur trop abatu, Monſtrès en vn grand mal, vne grande vertu;	SALMACIS, Je la plains comme vous, et apprendre sais qu'elle est dure, Mais vous faites paraître un cœur trop abattu, Monstrés en un grand mal, une grande vertu;
Tuuque tous ces uſfaurs, que uu tugo cous liure, Ne vous la peuuent rendre,& la faire reuiure, On ne repaſſe point le noir fleuue des morts, C’est là, que le Ciel meſme a borné ſes efforts.	Tuque tous ces usfaurs, que ju tugo cous livre, Ne vous la peuvent rendre,et la faire reuiure, On ne repasse point le noir fleuve des morts, C'est là, que le Ciel même a borné ses efforts.
CLEANDRE.	CLÉANDRE.
I'ay trop, i’ay trop veſcu, ſouffrés que l'Albanie Maccorde ce qu’icy voſtre pitié me nie, Mon ſupplice rendra ſes peuples ſatisfaits, It ma mort entre vous rétablira la paix:	J'ai trop, j'ai trop vécu, souffrés que l'Albanie Maccorde ce qu'ici votre pitié me nie, Mon supplice rendra ses peuples satisfaits, It ma mort entre vous rétablira la paix:
Floronde, vnique obiet de mes triſtes penſees Sur les ondes du Stix, ſi tu les as paſſees, Attend ce mal’heureux, i’y porteray mes pas, Et quelques iours au plus different mon trépas, Entend mes tristes cris, & la ferme aſſeurance, Que tu dois conſeruer de ma perſeuerance;	Floronde, unique objet de mes tristes pensées Sur les ondes du Stix, si tu les asse passe, Attend ce mal'heureux, j'y porterai mes pas, Et quelques jours au plus différent mon trépas, Entend mes tristes cris, et la ferme assurance, Que tu dois conserver de ma persévérance;
Iamais obiet que toy ne me pourra toucher, Ton nom me fut touſiours & ſera touſiours cher, I'ay tenté contre moy, ce que n’a pû l’orage, Alors que ie t’ay creuë immolee à ſa rag I'ay reietté priere, & conſeil, et raiſon, 3 Et i’ay cherché le fer, la flame, & le poiſon;	Jamais objet que toi ne me pourra toucher, Ton nom me fut toujours et sera toujours cher, J'ai tenté contre moi, ce que n'a pu l'orage, Alors que sans t'ai crue immolée à sa ragée J'ai rejette prière, et conseil, et raison, 3 Et j'ai cherché le fer, la flamme, et le poison;
Mais croyant m’obliger, on m’a caché ces armes, Accuſé mes ſouſpirs, & condamné mes larmes, Tay ireuut tous les Dieux, & tous les hommes ſourds, Et ma ſeule impuiſſance a conſerué mes iours;	Mais croyant m'obliger, on m'a caché ces armes, Accusé mes soupirs, et condamné mes larmes, Tais ireuut tous les Dieux, et tous les hommes sourds, Et ma seule impuissance a conservé mes jours;
YSANOR.	YSANOR.
Floronde vous entend, & ſon amour s’offence Que vous la ſouoçonniés de ſouffrir voſtre abſence, Elle eſt à vos coſtés, & Parques, ny trépas Ne peuuent l’empeſcher de marcher ſur vos pas, Croyés qu'elle eſt ſenſible à vos plaintes ameres Qu'elle a plaint comme vous, vos communes miſeres, Et qu'en l’itat qu’elle est, ces funeſtes propos Ne peuuent plus ſeruir qu'à troubier ſon repos.	Floronde vous entend, et son amour s'offense Que vous la souoçonniés de souffrir votre absence, Elle est à vos côtés, et Parques, ni trépas Ne peuvent l'empêcher de marcher sur vos pas, Croyez qu'elle est sensible à vos plaintes amères Qu'elle a plaint comme vous, vos communes misères, Et qu'en l'itat qu'elle est, ces funestes propos Ne peuvent plus servir qu'à trouvbier son repos.
Ei	Éi
CLEANDRE.	CLÉANDRE.
Que ie puiſſe, Madame, apres vn coup ſi rude Accorder quelque temps à mon inquietude, Donnés à ma douleur le reſte de ce iour, Que ſeul ie m’entretienne auecques mon amour, Ie ne tenteray rien contre ma triſte vie Uos trauaux, & vos ſoings, vous l’ont trop aſſeruie.	Que personne puisse, Madame, après un coup si rude Accorder quelque temps à mon inquiétude, Donnez à ma douleur le reste de ce jour, Que seul ie m'entretienne avec mon amour, Je ne tenterai rien contre ma triste vie Uos travaux, et vos soings, vous l'ont trop asservie.
Ie la veux reſpecter, parce qu’elle est à vous, Et voſtre ſeul ſuiet me ſauue de mes-coups, Mais ſouffrés qu’vn moment, en ce regret extréme, I'aille auec Lyſanor.	Je la veux respecter, parce qu'elle est à vous, Et votre seul sujet me sauve de mes-coups, Mais souffrez qu'H moment, en ce regret extrême, J'aille avec Lysanor.
SALMACIS.	SALMACIS.
Demeures icy meſme, Contre cet accident armés voſtre raiſon, Et ſoyés abſolu dans toute ma maiſon:	Demeures ici même, Contre cet accident armezez votre raison, Et soyez absolu dans toute ma maison:
la ſuyCEPHALIE, uan?	la suivCEPHALIE, uan?
Qe mon ejpon tp jomle, en ce mal que i'enduRien de ce que ie voy ne m’eſt d’heureux augu ré:	Que mon éjépon toi jomle, en ce mal que j'enduRien de ce que ici vois ne m'est d'heureux augu ré:
SCENE SIXIESME.	SCÈNE SIXIÈME.
LTSANOR, LI CLEANDRE, ſeuls.	LTSANOR, LI CLEANDRE, seuls.
l’embraſCLEANDRE, fant Eyne de mes deſirs, doux charme de mes ſens, NLa mort a reſpecté vos attraits innocens;	l'embrasCLEANDRE, fant Eyne de mes désirs, doux charme de mes sens, NLa mort a respecté vos attraits innocents;
Vous viués ma Deeſſe;	Vous vivez ma Déesse;
LYSANOR.	LYSANOR.
En cet excés de ioye, ſe doute que le comt, & que te vous renoye, Onde, ſois reueree, Aſtres ſoyés benis, Et qu'enfin vos destins, ſoient pour iamats vnis,	En cet excès de joie, se doute que le comt, et que te vous renvoie, On, sois révérée, Astres soyez bénis, Et qu'enfin vos destins, soient pour jamats unis,
CLEANDRE.	CLÉANDRE.
Que le ſort deſormais arme toute l'Epire, Qu'il expoſe à mon bras quelque choſe de pire;	Que le sort désormais arme toute l'Epire, Qu'il expose à mon bras quelque chose de pire;
Que n'exequuteray-ie auec ce beau ſecond, Et de quel ennemy ne pallira le front?	Que n'exéquuterai-je avec ce beau second, Et de quel ennemi ne pâta le front?
Mais ò diuin ſuiet de mes ſecrettes plaintes?	Mais diuin sujet de mes secrètes plaintes?
Quelle vaine raiſon vous oblige à ces feintes?	Quelle vaine raison vous oblige à ces feintes?
Quel important deſſein, quels ſuiets ſi ſecrets Nous font tromper la Reyne, & feindre ces regrets?	Quel important dessein, quels sujets si secrets Nous font tromper la Reine, et feindre ces regrets?
LYSANOR En deux mots ſeulemeut apprenés ce myſtere, La Reyne qui vous ayme a tramé cette affaire On a cherché quelqu’vn échappé du danger Qui de ce faux rapport la voulust obliger;	LYSANOR En deux mots seulemeut apprenés ce mystère, La Reine qui vous aime à tramé cette affaire On a cherché quelqu'un échappé du danger Qui de ce faux rapport la voulût obliger;
On ne treuua que moy, i'engageay mon ſeruice, des diæ- Et pour toüs ces preſens, ie luy rends cet office,	On ne trouva que moi, j'engageai mon service, des diæ- Et pour tendres ces présents, ie luy rends cet office,
C HaAAsnHs Mais nous luy conſeruons d’inutiles ennuys;	Ç HaAAsnHs Nous nous lui conservons d'inutiles ennuis;
LYSANOR.	LYSANOR.
Il m’eſtoit important de celer qui ie ſuis;	Il m'était important de celer qui tu suis;
Contre elle, & contre nous la guerre eſt declaree, Et voyant ſon amour, par moy deſeſperee, Affin de détourner ces mortels differends, Eue nous eup uures aux mains dt mes parens, Qu'importe, que la hayne, ou l’amour la poſſede, Puisque nos maux enfin ont treuué du remede.	Contre elle, et contre nous la guerre est déclarée, Et voyant son amour, par moi désespère, Affin de détourner ces mortels différends, Eue nous eup ouvres aux mains dût mes parents, Qu'importe, que la haine, ou l'amour la possède, Puisque nos maux enfin ont trouvé du remède.
CLEANDRE.	CLÉANDRE.
Quelle ioye eſt pareille à mon contentement?	Quelle joie est pareille à mon contentement?
LYSANOR, Souſpirés toutefois, feignés adroitement;	LYSANOR, Souspirez toutefois, feignez adroitement;
Mais voyons le Palais, & dans ces galeries Allons entretenir nos douces reſueries, Et ſi quelque rencontre interrompt nos propos, Souſpirons, plaignons nous, & pleurons à propos.	Mais voyons le Palais, et dans ces galeries Allons entretenir nos douces rêveries, Et si quelque rencontre interrompt nos propos, Souspirons, plaignons nous, et pleurons à propos.
LEOTE IIE SCENE PREMIERE SALMACIS, LYSANOR,	LEOTE IIE SCÈNE PREMIÈRE SALMACIS, LYSANOR,
SALMACIS, Onfeſſe, Lyſanor, que ce cœur inſenſible, Aux attraits de l’amour eſt bien inacceßible, Que careſſes, ny vœux ne le peuuent toucher, Et que ie perds du temps à combattre vn rocher;	SALMACIS, Onfesse, Lysanor, que ce cœur insensible, Aux attraits de l'amour est bien inaccesible, Que caresses, Seigneur vœux ne le peuvent toucher, Et que sans perds du temps à combattre un rocher;
LYSANOR.	LYSANOR.
I'ay ſondé ſon eſprit, & ie vous ay dépeinte, Le cœur navré du traict dont vous eſtes attainte, I'ay décrit vos ſouſpirs, & figuré vos pleurs Mais il n’eſt indulgent qu'à ſes propres douleurs, Floronde eſt l'entretien de toutes ſes penſees, Sur cet vnique obiet elles ſont exercees, Par ſa modeſte humeur il ſe deffend d’amour, --- - Mid- a d - Jl dit que pour vous plaire il quitteroit le iour, Qu’il vous ſouhaitte vn ſort égal à ſon enuie, Et qu’il eſt à vos ſoings obligé de ſa vie, Muis quuitendre des vœux de voſtre Majeſté Il deuoit eſtre exempt de cette vanité;	J'ai sonché son esprit, et ainsi vous ai dépeinte, Le cœur navré du traict dont vous êtes attainte, J'ai décrit vos soupirs, et figuré vos pleurs Mais il n'est indulgent qu'à ses propres douleurs, Floronde est l'entretien de toutes ses pensées, Sur cet seule objet elles sont exercées, Par sa modeste humeur il se défend d'amour, -- - - a - dit que pour vous plaire il quitteroit le iour, il vous souhaitte sort égal son envie, Et il est vos soings obligé de sa vie, Muis quuitendre des vœux de vôtre Majesté Il deuoit être exempt de cette vanité;
SALMACIS.	SALMACIS.
Cette ieune beaute dont h'ayma les tharmes Eut elle des appas dignes de tant de larmes?	Cette jeune beauté dont h'aima les tharmes Eut elle des appas dignes de tant de larmes?
LYSANOR.	LYSANOR.
Ie doutois qu’elle pûſt luy plaire ſeulement, Et ie voudrois ſeruir un obiet plus charmant?	Je doutais qu'elle puût été plaire seulement, Et tu voudrais servir un objet plus charmant?
Je croyois entendant ſes vœux, et ſes promeſſes, Que ſa dignité ſeule abtiroit ſes careſſes, Qu’il aymoit ſa grandeur, & que ſa paßion Tenoit moins de l’amour, que de l’ambition;	Je croyais entendant ses vœux, et ses promesses, Que sa dignité seule abtirait ses caresses, Qu'il aimait sa grandeur, et que sa passion Tenait moins de l'amour, que de l'ambition;
SALMACIS, L'amour qu'elle eut pour luy, fut-elle violente?	SALMACIS, L'amour qu'elle eut pour lui, fut-elle violente?
LTSANON, Extréme, incomparable, & pourtant innocente, Iamais par les appas d’vn diſcours ſuborneur Ce diſcret amoureux n’aſſaillit ſon honneur;	LTSANON, Extrême, incomparable, et pourtant innocente, Jamais par les appas d'H discours suborneur Ce discret amoureux n'assaillit son honneur;
CAEMACIS.	CAMACIS.
Trauaille constamment à mettre dans ſon ame Des diſpoſitions à receuoir ma flame;	Travaille constamment à mettre dans son âme Des dispositions à recevoir ma flamme;
Continué ardamment tes ſoings officieux, Figure mes ennuys, peints moy les pleurs aux yeux Et croy que tu t’acquiers vne amitié ſi forte, Que ie te ſeruirois en tout ce qui t'importe;	Continué ardamment tes soins officieux, Figure mes ennuis, peints moi les pleurs aux yeux Et crois que tu t'acquiers seulement amitié si forte, Que ie te servirais en tout ce qui t'importe;
Voila ce doux tyran, des yeux & des eſprits, Dieux!	Voilà ce doux tyran, des yeux et des esprits, Dieux!
que ce froid maintien me predit de meſpris;	que ce froid maintien me prédit de mépris;
SCENE DEVXIESME.	SCÈNE DEUXIÈME.
CLEANDRE, SALMACIS, LYSANOR, contiSALMACIS, nuë	CLEANDRE, SALMACIS, LYSANOR, contiSALMACIS, nue
TRefue, trefue Cleandre à ces douleurs ameres, I Penſons à détourner nos communes miſeres;	TRefue, trouve Cléanre à ces douleurs amères, I Pensons à détourner nos communes misères;
Eleuons nos penſees au deſſus de la mort, Faiſons troubler l'Enfer, & la Parque, & le ſort;	Eleuons nos pensées au dessus de la mort, Faisons troubler l'Enfer, et la Parque, et le sort;
Par les ſeuls appareils d’vne force infinie, Enuoyons la frayeur au camp de l’Albanie, Et ſignalons nos bras par de ſi grands exploicts Que tout le monde vn iour nous demande des loix.	Par les seuls appareils d'une force infinie, Envoyons la frayeur au camp de l'Albanie, Et signalons nos bras par de si grands exploits Que tout le monde un jour nous demande des lois.
CLEANDRE, triſte Quel Aſtre conduira le ſort d’vn miſerable?	CLEANDRE, triste Quel Astre conduira le sort d'Un misérable?
Et ne rougira pas de m’eſtre fauorable?	Et ne rougira pas de m'être favorable?
Le Ciel ſe plaiſt à voir tous mes deſſeins faillis, De ſes plus rudes traicts mes iours ſont aſſaillis, Jl m'a parens, et biens, & maiſtreſſe rauié,	Le Ciel se plaît à voir tous mes desseins faillis, De ses plus rudes traits mes jours sont assaillis, Jl m'a parents, et biens, et maîtresse ravié,
E n Et pour combler de maux, il me laiſſe la vie;	 Et pour combler de maux, il me laisse la vie;
Quel Aſtre en cet état, contre l’arrest des Cieux.	Quel Astre en cet état, contre l'arrêt des Cieux.
Peut ſeconder mon bras, & m'eſtre officieux?	Peut seconder mon bras, et m'être officieux?
SALMACIS.	SALMACIS.
Suiuons, ſuiuons le cours d’vne immortelle gloire, Et banniſſons des morts l’importune memaire, Etouſfes au beſoing ces ſouſpirs ſuperſius, Qu'importent ces regrets à celle qui n'eſt plus?	Suivons, suivons le cours d'une immortelle gloire, Et bannissons des morts l'importune mémaire, Étousfes au besoing ces soupirs supersius, Qu'importent ces regrets à celle qui n'est plus?
CLEANDRE, Comme ma perte helas!	CLÉANDRE, Comme ma perte hélas!
ma peine eſt ſans ſeconde, Mes regrets ceſſeroient, & i’oublirois Floronde?	ma peine est sans seconde, Mes regrets cesseraient, et j'oublirais Floronde?
O barbare deſſein!	Ô barbare dessein!
tu ſçais cher confident, Dernier bien qui me reste en ce triſte accident, Tu ſçays quelle vnion aſſembla nos deux ames, Tes yeux furent teſmoins de nos fidelles flames, Touseouro iu conpuemu emtiu uunis nos ſecrets Et tu pris touſiours part en tous nos interests;	tu sais cher confident, Dernier bien qui me reste en ce triste accident, Tu sçays quelle union assembla nos deux âmes, Tes yeux furent témoins de nos fidèles flammes, Touseouro ju conpuemu emtiu nis nos secrets Et tu pris toujours part en tous nos intérêts;
Conte de quels attraits Floronde fut pourueuë, Et combien ſa memoire eſt chere à qui l’a veuë;	Conte de quels attraits Floronde fut pourvue, Et combien sa mémoire est chère à qui l'a vue;
LYSANOR.	LYSANOR.
Si vous me permettés de parler librement, Chaſque maiſtreſſe eſt belle aux yeux de ſon amant, Mais pour moy qui la vis d’vn œil d’indifference, La moindre en mon eſtime eust eu la preference, Un autre euſt esté libre, où vous auez aymé, Et Floronde en vn mot, ne m’auroit pas charmé;	Si vous me permettez de parler librement, Châque maîtresse est belle aux yeux de son amant, Mais pour moi qui la vis d' œil d'indifférence, La moindre en mon estime eût eu la préférence, Un autre eût été libre, où vous avez aimé, Et Floronde en un mot, ne m'aurait pas charmé;
faiſant mine de CLEANDRE, uirer fon efsee.	faisant mine de CLEANDRE, uirer son efsee.
Souffrés qu’en la fureur dont mon ame est attainte Ie force du reſpect l’importune contrainte:	Souffrez qu'en la fureur dont mon âme est attainte Je force du respect l'importune contrainte:
Madame permettés;	Madame permettez;
CA MACIS.	CA MACIS.
Non, calmés ce courroux.	Non, calmez ce courroux.
CLEANDRE.	CLÉANDRE.
Le traistre eſt ſans reſpect, pour des charmes ſi doux?	Le traître est sans respect, pour des charmes si doux?
Tu vu ſans l’adorer ce Soleil d'Albanie?	Tu vu sans l'adorer ce Soleil d'Albanie?
Et ta confeßion à ſes attraits ſe nie.	Et ta confession à ses attraits se nie.
LYSANOR.	LYSANOR.
Il ne fut iamais charme égal à ſa beauté, Elle fut vn Soleil, vne diuinité, De la terre, & du Ciel, l’eſperance, & l’enuie, Et pour la poſſeder les Dieux vous l'ont rauie, Eſt-ce la comme il faut obliger vos amours, Et cet Eloge enfit r’aſſeure-t’il mes iours?	Il ne fut jamais charme égal à sa beauté, Elle fut un Soleil, une divinité, De la terre, et du Ciel, l'espérance, et l'envie, Et pour la posséder les Dieux vous l'ont ravie, Est-ce la comme il faut obliger vos amours, Et cet Éloge enfit rassure-t-il mes jours?
CLEANDRE.	CLÉANDRE.
Si tu ſçays de quel traict ſon ame fut bleſſee, Quel droict, & quel Empire, eus-ie ſur ſa penſee;	Si tu sais de quel trait son âme fut blessée, Quel droit, et quel Empire, eus-je sur sa pensée;
LYSANOR.	LYSANOR.
Sans deſſein de complaire à vostre paßion, Ie répondray ( Monſieur) de ſon affection;	Sans dessein de complaire à votre passion, Je répondrai ( Monsieur) de son affection;
J'ay ſceu combien pour vous ſon ardeur fut extréme, I'ay cogneu ſes ſecrets à l’égal d’elle-meſme, Et ie ne pais douter du ſenſible tourment	J'ai su combien pour vous son ardeur fut extrême, J'ai connu ses secrets à l'égal d'elle-même, Et tu ne pais douter du sensible tourment
E Qu eue ſouſſte aux enfers pour voſre eibignement.	 Quel eue souste aux enfers pour vos eibignement.
CLEANDRE.	CLÉANDRE.
Par quel barbare ſort m’eſt la clarté renduë, Quel Dieu m’a conſerué, lors que ie l’ay perduë, Alon eeque tu inmin dieumcre emtoinoumjon deuoir:	Par quel barbare sort m'est la clarté rendue, Quel Dieu m'a conservé, lors que jusqu'ai perdue, Alon eeque tu inmin dieumcre emtoinoumjon devoir:
Madame permettés la plainte au deſeſpoir.	Madame permettez la plainte au désespoir.
SALMACIS.	SALMACIS.
Enfin c’eſt trop cacher l’ennuy qui me poſſede, Cruel, comme ton mal, le mien eſt ſans remede, Suy, cher Cleandre, ſuy tes funestes deſſeins, Abandonne ta vie à tes barbares mains, Mais ne t’offence pas qu’vne Reyne importune, Suiue tuſqu'aux Enfers tes pas, & ta fortune, Le Ciel s’oppoſe en vain au deſſein que i’ay pris, Et la vie, ou la mort, vnira nos eſprits.	Enfin c'est trop cacher l'ennui qui me possède, Cruel, comme ton mal, le mien est sans remède, Sui, cher Cléandre, suis tes funestes desseins, Abandonne ta vie à tes barbares mains, Mais ne t'offense pas qu'une Reine importune, Suive telqu'aux Enfers tes pas, et ta fortune, Le Ciel s'oppose en vain au dessein que j'ai pris, Et la vie, ou la mort, vnira nos esprits.
CLEANDRE.	CLÉANDRE.
dd ton its muineurena teilt peine eſi tommune, Qu'à l’enuy tout le monde accroist leur infortune, Et mon malheur eſt tel, qu’en mon cruel tourment Vous treuués des ſuiets de diuertiſſement.	dès ton its muineurena teilt peine es jommune, Qu'à l'envi tout le monde accroît leur infortune, Et mon malheur est tel, qu'en mon cruel tourment Vous trouvez des sujets de divertissement.
SALMACIS.	SALMACIS.
Non, non, c’eſt trop douter d’vne amour trop viſible, Que Cleandre auoüeroit, s’il n'eſtoit inſenſible, Il ſçait, il ſçait l’ardeur qui m’embraſe le ſein, Et ſon aueuglement prouient de ſon deſſein.	Non, non, c'est trop douter d'une amour trop visible, Que Cléandre auoüeroit, s'il n'était insensible, Il sais, il sait l'ardeur qui m'embrase le sein, Et son aveuglement provient de son dessein.
CLEANDRE.	CLÉANDRE.
Triſte rebut des flots, trahy de la fortune, Qui par tout ſuis à charge, et par tout importune, Je ne me flatte point de ſentimens ſi faux, J'ignore toute choſe, excepté mes deffauts.	Triste rebut des flots, trahi de la fortune, Qui par tout suis à charge, et par tout importune, Je ne me flatte point de sentiments si faux, J'ignore toute chose, excepté mes défauts.
SALMACIS.	SALMACIS.
Sans obliger ma voix à parler de ma flame, Ly cruel ſur mon front les ſecrets de mon ame, Qu'a beſoing mon amour du ſecours de ma voix Mes yeux, et mes ſouſpirs, te l’ont dit tant de fois.	Sans obliger ma voix à parler de ma flamme, Ly cruel sur mon front les secrets de mon âme, Qu'a besoin mon amour du secours de ma voix Mes yeux, et mes soupirs, te l'ont dit tant de fois.
Quoy tu n’obſerues pas les traicts de mon viſage?	Quoi tu n'observes pas les traits de mon visage?
Cleandre ayant aymé, n’entend pas ce langage?	Clandre ayant aimé, n'entend pas ce langage?
S’il ne te ſuffit pas de ma confeßion, De Lyſanor, cruel, apprends ma paßion, Apprens la des effects;	S'il ne te suffit pas de ma confession, De Lysanor, cruel, apprends ma passion, Apprends la des effets;
mon ſceptre, ma Couronne, Mes biens, mes dignités, l'éclat qui m'enuironne, Et moy-meſme captiue en tes aymables nœuds, Ne ſuffirons-nous point à l’acquerir mes vœux?	mon sceptre, ma Couronne, Mes biens, mes dignités, l'éclat qui m'environne, Et moi-même captive en tes aimables nœuds, Ne suffirons-nous point à l'acquérir mes vœux?
O que d’vn traict fatal mon ame fut touchee, Quand ſur ton corps mourant, i’eus la veuë attachee, Tout ſoüillé du limon, dont tu fus emporté, Tu me rauis les ſens, le cœur, la liberté, Ton viſage tout palle eut d’inuincibles charmes, Ie creus qu'vn Dieu mouroit, & ie verſay des lar	Ô que d'un trait fatal mon âme fut touchée, Quand sur ton corps mourant, j'eus la vue attachée, Tout souillé du limon, dont tu fus emporté, Tu me ravis les sens, le cœur, la liberté, Ton visage tout pale eut d'invincibles charmes, Je crus qu'un Dieu mourait, et ie versai des lar
CLEANDRE.	CLÉANDRE.
Que ne puis-ie forcer cette fatalité, Qui faict de ma conſtance vne neceßité?	Que ne puis-je forcer cette fatalité, Qui fait de ma constance une necessité?
Du tenebreux manoir où Floronde reſpire, Son œil ſur ma raiſon conſerue ſon Empire!	Du ténébreux manoir où Floronde respire, Son œil sur ma raison conserve son Empire!
Ce ieune Astre d’Amour, touſiours à mes costés Fay briller en ces lieux ſes diuines clartés;	Ce jeune Astre d'Amour, toujours à mes côtés Fais briller en ces lieux ses divines clartés;
Par tout ceſte merueille à mes yeux ſe preſente, De moment en moment plus rare, & plus charmante, Elle ne fut iamais plus viſible à mes yeux Quand elle reſpiroit la lumiere des Cieux;	Par tout cette merveille à mes yeux se présente, De moment en moment plus rare, et plus charmante, Elle ne fut jamais plus visible à mes yeux Quand elle respirait la lumière des Cieux;
Floronde, beau Soleil des riues Eliſees, Où ſeront de mes pleurs tes cendres arrouſees?	Floronde, beau Soleil des rives Élisées, Où seront de mes pleurs tes cendres arrose?
Quels Glauques, quels Tritons, quelles Nymphes, quels Dieux, Conſeruent de ton corps le butin precieux?	Quels Glauques, quels Tritons, quelles Nymphes, quels Dieux, Conservent de ton corps le butin précieux?
Pardonnés, grande Reyne, au deüil qui me tranſ porte, Et ne combattés point vne amitié ſi forte, Vous profanés à tort d’adorables appas, Pour qui meſpriſe tout, & ne les gouſte pas,	Pardonnez, grande Reine, au deuil qui me trans porte, Et ne combattez point une amitié si forte, Vous profanez à tort d'adorables appas, Pour qui méprise tout, et ne les goûte pas,
SALMACIS.	SALMACIS.
Cleandre, i’attendray la fin de mon ſupplice De la force du temps, & de vostre Juſtice, Ce pendant vous deues au bien de mes trais  - -- - --- --- Accorder vos conſeils, & preſter voſtre bras, Voſtre propre intereſt vous ioinct à ma fortune, Et nous aurons la honte, ou la gloire commune, Sous le Prince d'Epire, vn camp de ieunes Mars, Tient la ville aßiegee, & couure nos ramparts, Conſultons du moyen de dißiper l’orage, Ou s’il y faut perir, faiſons vn beau naufrage;	Candre, j'attendrai la fin de mon supplice De la force du temps, et de votre Justice, Ce pendant vous devez au bien de mes trais - -à-dire -dire -- -- Accorder vos conseils, et prêter votre bras, Votre propre intérêt vous joint à ma fortune, Et nous aurons la honte, ou la gloire commune, Sous le Prince d'Epire, un camp de jeunes Mars, Tient la ville assiegee, et couvre nos remparts, Consultons du moyen de dissiper de dions, Ou s'il y faut périr, faisons un beau naufrage;
Que la victoire au moins couſte cher aux vainqueurs;	Que la victoire au moins coûte cher aux vainqueurs;
Et contre vn grand peril, faiſons voir des grands cœurs;	Et contre un grand péril, faisons voir des grands cœurs;
CLEANDRE, Je vis pour vous ſeruir, & mon obeyſſance Ne conſerue mes iours, que pour vostre deffence, Propoſons ſeulement vn genereux deſſein, Qui mette aux ennemis la frayeur dans le ſein.	CLEANDRE, Je vis pour vous servir, et mon obéissance Ne conserve mes jours, que pour votre défense, Proposons seulement un généreux dessein, Qui mette aux ennemis la frayeur dans le sein.
SCENE TROISIESME.	SCÈNE -TROISIÈME.
ſeul LYSANOR, Elle encherit ſur moy du prix d’vn Diadeſme, Du prix de ſa fortune, & du prix de ſoy-meſme Et ie ne puis qu’offrir à ſon ambition, Mon amour ſeulement eſt ma poſſeßion.	seul LYSANOR, Elle enchit sur moi du prix d'un Diadesme, Du prix de sa fortune, et du prix de soi-même Et sans ne puis qu'offrir à son ambition, Mon amour seulement est ma possession.
SCENE QVAT RIESME, CEPHALIE, LYSANOR,	SCÈNE QUAT RIESME, CEPHALIE, LYSANOR,
CEPHALIE.	CÉPHALIE.
Nfin cher Lyſanor, ny reſpect, ny contrainte, Ne peuuent plus cacher cette ſenſible atteinte, Jl te faut auoüer ce deſſein amoureux Puisque par ton ſecours tu le peux rendre heureux;	Nfin cher Lysanor, ni respect, ni contrainte, Ne peuvent plus cacher cette sensible atteinte, Jl te faut auoüer ce dessein amoureux Puisque par ton secours tu le peux rendre heureux;
LY SANOR, Quel eſt ce doux obiet des ſoings que ie dois prendre?	LI SANOR, Quel est ce doux objet des soins que ie sans prendre?
CETIALIE.	CETIALIE.
C’eſt, helas!	C'est, hélas!
ſans rougir puis-ie nommer Cleandre?	sans rougir puis-je nommer Cléandre?
C’eſt pour luy ſeul qu’amour me pouuoit arracher Que puems, & ule fouſpuos que ie ne puis cacher.	C'est pour deux seul qu'amour me pouvait arracher Que puems, et ule fouspuos que sans ne puis cacher.
LYSANOR.	LYSANOR.
On ne peut trop priſer ſon merite, & ſes graces, Des eſprits les plus froids il peut fondre les glaces, Et l’Epire voyoit ſes plus rares beautés Dom jes ajmubies tois rangertenrs ubentes.	On ne peut trop priser son mérite, et ses grâces, Des esprits les plus froids il peut fondre les glaces, Et l'Epire voyait ses plus rares beautés Dom jes ajémubies tois rangertenrs es.
CEPHALIE.	CÉPHALIE.
Floronde toutesfois eut toutes ſes careſſes, Et ſeule elle étouffa l'eſpoir de cent Princeſſes, Cut elle tant d’attraits à charmer ſa raiſon!	Floronde toutefois eut toutes ses caresses, Et seule elle étouffa l'espoir de cent Princesses, Cut elle tant d'attraits à charmer sa raison!
Et quelle, Lyſanor, ſuis-ie en comparaiſon?	Et quelle, Lysanor, suis-je en comparaison?
LYSANOR.	LYSANOR.
Telle qu’eſt le Soleil, ſur la moindre lumiere, Qui ſuiue de la nuict l’inégale courriere, Pour vous la peindre mieux;	Telle qu'est le Soleil, sur la moindre lumière, Qui suive de la nuit l'ingale courrière, Pour vous la peindre mieux;
vous ſçaués qu’à la Cour On repreſente en vers des Hiſtoires d’amour, La ieuneſſe nous porte à ces ieux de Theatre, Et ſur tous autrefois i’en estois Idolâtre;	vous savez qu'à la Cour On représente en vers des Histoires d'amour, La jeunesse nous porte à ces jeux de Théâtre, Et sur tous autrefois j'en étais Idolâtre;
Mon viſage en ce temps, & plus ieune & plus frais Sous les habits de fille auoit quelques attraits, Ie faiſois Amaranthe, ou Cloris, ou Syluie, Et de mes actions la Cour eſtoit rauie, Alors il me ſouuint que mille fois le Roy A faict comparaiſon de Floronde & de moy, Dieux!	Mon visage en ce temps, et plus jeune et plus frais Sous les habits de fille avait quelques attraits, Je faisais Amaranthe, ou Cloris, ou Syluie, Et de mes actions la Cour était ravie, Alors il me souvint que mille fois le Roi A fait comparaison de Floronde et de moi, Dieux!
diſoit-il a tous, la reſſemblance extrême.	disait-il a tous, la ressemblance extrême.
Voila ſon meſme geſte, & ſon viſage meſme;	Voilà son même geste, et son visage même;
Jugés par ce diſcours, quels furent ſes appas, Et puis qu'elle luy pleut, que ne ferés vous pas?	Jugez par ce discours, quels furent ses appas, Et puis qu'elle femme pleut, que ne ferez vous pas?
CEPHALIE.	CÉPHALIE.
Mon œil découure en toy d’aſſés douces merueilles, Et ie meure, ta grace a fort peu de pareilles, Plus on voit ton viſage, et plus il paroiſt beau, Chaſque inſtant y faict voir quelque charme nouueau, Ton geſte eſt agreable, et ta façon gentille, De toy nature eust faict vne fort belle fille, Et i’estime le choix de ce fidelle amant Si l’obiect de ſes vœux eſtoit außi charmant;	Mon œil découvre en toi d'assès douces merveilles, Et de meure, ta grâce a fort peu de pareilles, Plus on voit ton visage, et plus il paraît beau, Châque instant y fait voir quelque charme nouveau, Ton geste est agréable, et ta façon gentille, De toi nature eût fait une fort belle fille, Et j'estime le choix de ce fidèle amant Si l'objet de ses vœux était aussi charmant;
Mais, mon cher Lyſanor, il n’eſt pas impoßible Que ma fidelité le treuue vn iour ſenſible, Le temps ſur la memoire a des droicts abſolus, Il change les obiets qui la touchent le plus, Et le Ciel fauorable au beau nœud qui me lie, Peut où regna Floronde, établir Cephalie, Ne me refuſe point tes ſoings officieux, Et tu me ſeras cher à l'égal de mes yeux.	Mais, mon cher Lysanor, il n'est pas impossible Que ma fidélité le trouve un jour sensible, Le temps sur la mémoire a des droits absolus, Il change les objets qui la touchent le plus, Et le Ciel favorable au beau nœud qui me lie, Peut où régna Floronde, établir Céphalie, Ne me refuse point tes soins officieux, Et tu me seras cher à l'égal de mes yeux.
LISANOR, Noſtre propre intereſt à ce deuoir m’excite, Mais quoy que cet honneur excede ſon merite, Ie doute toutefois de cet heureux deſſein, Et que des traicts nouueaux puiſſent toucher ſon ſein, Pour luy la Reyne ſouffre vn ſemblable martyre, Elle offre à cet ingrat ſon throſne & ſon Empire, Mais elle a ſon eſprit aſſailli vainement, El ja Piotonae jeme y regne avjothment.	LISANOR, Notre propre intérêt à ce devoir m'excite, Mais quoi que cet honneur excède son mérite, Je doute toutefois de cet heureux dessein, Et que des traits nouveaux puissent toucher son sein, Pour lui a Reine souffre un semblable martyre, Elle offre à cet ingrat son trône et son Empire, Mais elle a son esprit assailli vainement, Él a Piotone me y règne avjothment.
CEPHALIE.	CÉPHALIE.
J'ay bien ſceu ſon amour, & le nœud qui l’engage, Iuſqu’icy m’a contrainte à celer mon ſeruage, Mais enfin ce tyran des ieunes volontés, Cet enfant qui preſide à tant de libertés, Me contraint de forcer vn ennuyeux ſilence, Le reſpect que i'auois cede à ſa violence;	J'ai bien su son amour, et le nœud qui l'engage, Jusqu'ici m'a contrainte à celer mon servage, Mais enfin ce tyran des jeunes volontés, Cet enfant qui préside à tant de libertés, Me contraint de forcer un ennuyeux silence, Le respect que j'avais cède à sa violence;
Dy luy ſecrettement les vœux que ie luy faicts, L’amour, de traits diuers, faict de diuers effects, Le rang, les dignités ſont ſes moindres amorces, Et de ſoy ſeulement il emprunte ſes forces;	Dis quelque secrètement les vœux que sans nous faits, L'amour, de traits divers, fait de divers effets, Le rang, les dignités sont ses moindres amorces, Et de soi seulement il emprunte ses forces;
Une ſecrette loy forme nos paßions, Paiui naiſire nos amours, & nos auerſions, Et le meſpris qu’il faict des offres de la Reyne, Ne deſeſpere pas mon attente incertaine;	Une secrète loi forme nos passions, Paivi notre nos amours, et nos aversions, Et le mépris qu'il fait des offres de la Reine, Ne désespère pas mon attente incertaine;
YSANOR.	YSANOR.
Déchargés ſur mes ſoings cet amoureux ſoucy, I'employray mes efforts:	Déchargez sur mes soins cet amoureux souci, J'emploirai mes efforts:
mais quelqu’vn vient icy.	mais quelqu'amour vient ici.
SCENE CINQVIESME.	SCÈNE CINQUIÈME.
CETHALIE, DORISMOND, LISANOR,	CETHALIE, DORISMOND, LISANOR,
CEPHALIE.	CÉPHALIE.
I'eux!	J'eux!
que cet importun a peu de complaiſance, La mort me ſeroit chere au prix de ſa preſence;	que cet importun a peu de complaisance, La mort me serait chère au prix de sa présence;
DCRFOMOND.	DCRFOMOND.
Aués vous relaſché ces meſpris rigoureux Dont vous deſeſperés tant d’eſprits amoureux?	Avez -vous relâché ces mépris rigoureux Dont vous desesperés tant d'esprits amoureux?
LEPHALIE, Aués vous corrigé cette importune enuie, Dont vous perſecutés le repos de ma vie?	LEPHALIE, Aez vous corrigé cette importune envie, Dont vous persécutez le repos de ma vie?
DORISMOND.	DORISMOND.
Quoy, ſeruir conſtamment voſtre rare beauté, Uous nuit, & paſſe en vous pour importunité!	Quoi, servir constamment votre rare beauté, Uous nuit, et passe en vous pour importunité!
CEPHALIE.	CÉPHALIE.
Sans me faire expliquer, vous me deuriés entendre, Voſtre plus doux ſeruice est de ne m’en point rendre,	Sans me faire expliquer, vous me devriez entendre, Votre plus doux service est de ne m'en point rendre,
DORISMOND.	DORISMOND.
C'eſt rendre en peu de mots mon ſoupçon éclaircy ---A.	C'est rendre en peu de mots mon soupçon éclairci -A.
CEPHALIE.	CÉPHALIE.
A qui veut qu'on s’explique il faut parler ainſi;	À qui veut qu'on s'explique il faut parler ainsi;
DORISMOND.	DORISMOND.
Dieux!	Dieux!
ce ieune etranger poſſede vn charme étrange!	ce jeune étranger possède un charme étrange!
CEPHALIE.	CÉPHALIE.
ſi peui veuucoup yon fauique voſtre humeur ſe change.	si peu vucoup ion favique votre humeur se change.
DORTSMOND, Il a bien ſur la voſtre obtenu cet effect.	DORTSMOND, Il a bien sur la vôtre obtenu cet effet.
CEPHALIE.	CÉPHALIE.
Il vous a faict ialoux, c’eſt tout ce qu’il a faict.	Il vous a fait jaloux, c'est tout ce qu'il a fait.
DORISMOND.	DORISMOND.
Nit pentaa tsbrantir te teur inatteſsiore.	Nit penta tsbrantir te teur inattessiore.
CEPHALIE.	CÉPHALIE.
A qui poſſede vn charme, il n'eſt rien d'impoßible.	À qui possède un charme, il n'est rien d'impocible.
DORISMOND.	DORISMOND.
Que faict ce doux aymant des beautés de ce lieu?	Que fait ce doux aimant des beautés de ce lieu?
CEPHALIE.	CÉPHALIE.
Peut eſtre qu’il m’attend, & ie le cherche adieu.	Peut être qu'il m'attend, et apprendre le cherche adieu.
ſeul.	seul.
DORISMOND, O ſeuere meſpris!	DORISMOND, Ô sévère mépris!
ô Ciel!	ô Ciel!
ô honte!	ô honte!
ô rage!	ô rage!
Capable d’animer le plus lâche courage, Quoy, ce ieune inſolent, ce vil rebut des flots, Vient iuſques à nos yeux troubler noſtre repos?	Capable d'animer le plus lâche courage, Quoi, ce jeune insolent, ce vil rebut des flots, Vient jusques à nos yeux troubler notre repos?
L'onde le reſpectoit à deſſein de nous nuire,	L'onde le respectait à dessein de nous nuire,
Jl ne s’eſt conſerué qu’affin de nous détruire D'vn malheur euident le traiſtre a proffité, Il a ce qu’il n’eut pas en ſa proſperité:	Il ne s'est conservé qu'affin de nous détruire D'un malheur évident le traître à proffité, Il a ce qu'il n'eut pas en sa prospérité:
Il est de tous les cœurs l’amour & les delices, Et de honteux dédains faict payer nos ſeruices, Epouſe pour ton bien l’interest de ces lieux, Et déliure la Cour de ce monſtre odieux, Fay triste Doriſmond, vn effort necéſſaire Contre l’enchantement de ce bel aduerſaire, Devn coup frappe cent cœurs enfermés dans ſor ſein, Et ne conſulte point en ce iuſte deſſein;	Il est de tous les cœurs l'amour et les délices, Et de honteux dédains fait payer nos services, Épouse pour ton bien l'intérêt de ces lieux, Et délivre la Cour de ce monstre odieux, Fais triste Dorismond, un effort necéssaire Contre l'enchantement de ce bel adversaire, Devn coup frappe cent cœurs enfermés dans sor sein, Et ne consulte point en ce juste dessein;
SCENE SIXIESME.	SCÈNE SIXIÈME.
CLEANDRE, DORTSMOND,	CLÉANDRE, DORTSMOND,
DORISMOND.	DORISMOND.
Onſieur, certain ſuiet, où l'honneur m’inte?	Onsieur, certain sujet, où l'honneur m'inte?
, Moblige à deſirer d’éprouuer vostre addreſſe, I’attends pour cet effect la faueur de vous voir Aux vieux murs du Palais, ſans ſuitte, & ſur le ſoir.	, Moblige à désirer d'éprouver votre adresse, J'attends pour cet effet la faveur de vous voir Aux vieux murs du Palais, sans suitte, et sur le soir.
CLEIEIVSNS.	CLEIEIVSNS.
Sans plus examiner icy ma conſcience, I'attends cette faueur auec impatience;	Sans plus examiner ici ma conscience, J'attends cette faveur avec impatience;
ſeul conCLEANDRE, jaue Quel outrage receu, quel mécontentement Porte ce Cauallier à ce reſſentiment?	seul conCLEANDRE, jave Quel outrage reçu, quel mécontentement Porte ce Cavallier à ce ressentiment?
Peut-il de quelque tort charger mon innocence?	Peut-il de quelque tort charger mon innocence?
Quelque ialoux ſoupçon ou ma faueur l’offence?	Quelque jaloux soupçon ou ma faveur l'offense?
I'empeſche ſes deſſeins, mais que mal à propos Ma grandeur l’incommode, & trouble ſon repos, Et qu’il ſçait mal où tend le cours de ma fortune, Alors qu’il est ialoux de ce qui m'importune:	J'empêche ses desseins, mais que mal à propos Ma grandeur l'incommode, et trouble son repos, Et qu'il sait mal où tend le cours de ma fortune, Alors qu'il est jaloux de ce qui m'importune:
Donnons luy toutefois ce diuertiſſement, Que l'aueugle periſſe en ſon aueuglement;	Donnons lui toutefois ce divertissement, Que l'aveugle périsse en son aveuglement;
SCENE SEPTIESME LYSANOR, CLEANDRE, luy frappant LYSANOR, faſteſpauie Y ſonge plus reſueur.	SCÈNE SEPTIÈME LYSANOR, CLEANDRE, Seigneur frappant LYSANOR, fastespavie Y songe plus rêveur.
CLEANDRE.	CLÉANDRE.
A ce coup ie dois prendre Et uaiſer quei'aienas, in ne ven peux ueſfendre, Et nous treuuant ſi ſeuls ie croy qu’en ſeureté Ie me puis diſpenſer à cette priuauté.	À ce coup grès dois prendre Et aiser quei'aimenas, in ne ven eux uffendre, Et nous trouvant si seuls je crois qu'en sûreté Je me puis dispenser à cette privauté.
le baiLYSANOR, fant Jmportun, fay donc toſt, & croy qu’on ne reſpire, Que d’acquerir ton cœur, & m’en oſter l’Empire, Tu charmes tout le monde, & de toute la Cour Tes yeux font ſans deſſein des victimes d’amour, Les miens ſont éblouys d’vne foule de Dames Qui veulent m’obliger à ſeconder leurs flames, on tu fatnde tu feejne à depuis vn moment Imploré mon ſecours pour ſon allegement.	le baiLYSANOR, fant Jmportun, fais donc tôt, et crois qu'on ne respire, Que d'acquérir ton cœur, et m'en ôter l'Empire, Tu charmes tout le monde, et de toute la Cour Tes yeux font sans dessein des victimes d'amour, Les miens sont éblouis d'une foule de Dames Qui veulent m'obliger à seconder leurs flammes, on tu fatnde tu feejne à depuis un moment Imploré mon secours pour son allégement.
CLEANDRE, riant.	CLEANDRE, riant.
Quel doit estre mon choix, en leur trouppe importune.	Quel doit être mon choix, en leur troupe importune.
LYSANOR.	LYSANOR.
Prens toui ſi in me crois, n'en rejuſes pas vne.	Prends toui si in me crois, n'en rejuses pas une.
CLEANDRE.	CLÉANDRE.
Ie poſſede tes yeux, & ces Astres charmants Uallent toute la Cour, et tous ſes ornements, I’ayme ces doux vainqueurs, et le reſte du monde Tenteroit ſans effect le deſſein de Floronde;	Je possède tes yeux, et ces Astres charmants Ualent toute la Cour, et tous ses ornements, J'aime ces doux vainqueurs, et le reste du monde Tenterait sans effet le dessein de Floronde;
Toy jeute as on iien qui pouuoit m'allather, Et toy ſeule as les traicts, qui me pouuoient toucher.	Toi jeute as on jien qui pouvait m'allather, Et toi seule as les traits, qui me pouvaient toucher.
YSANOR.	YSANOR.
Pour charmer toutefois nostre melancholie, Ei tu veux m’obliger feints d’aymer Cephalie, Et quand nous ſerons ſeuls, rions à ſes deſpens, Mais ſans paſſer la feinte, ou ie te le deffens.	Pour charmer toutefois notre mélancolie, Ei tu veux m'obliger feints d'aimer Céphalie, Et quand nous serons seuls, rions à ses dépens, Mais sans passer la feinte, ou ainsi te le défens.
CLEANDRE.	CLÉANDRE.
Ie ne puis refuſer, quoy que tu me propoſes, Et pour te diuertir i’oſeray toutes choſes, Uoy moy changer d’humeur & feindre adroictement;	Je ne puis refuser, quoi que tu me proposes, Et pour te divertir j'oserai toutes choses, Uoi moi changer d'humeur et feindre adroitement;
Mais donnons au conſeil vne heure ſeulement.	Mais donnons au conseil une heure seulement.
TACIEEIIEE SCENE PREMIERE.	TACIEIIE SCÈNE PREMIÈRE.
veſtu de CLEANTES ROY D’EPIRE, aueu chefs de ALCANDRE, ACHANTHE, guetta	vêtu de CLEANTES ROY D'EPIRE, aveu chefs de ALCANDRE, ACHANTHÉE, guetta
Uisque ſceptres, grandeur, rang, ny titres, ny marques, Sp Ne peuuent affranchir de la rigueur des Parques, Et que ces noires ſœurs, ſous leurs tragiques lois Rangent également les Bergers & les Rois, Ne vous conſommés point d’vne douleur amere, Conſerués nous le fils, ſi nous perdons le pere;	Uisque sceptres, grandeur, rang, ni titres, ni marques, Sp Ne peuvent affranchir de la rigueur des Parques, Et que ces noires sœurs, sous leurs tragiques lois Rangent également les Bergers et les Rois, Ne vous consommès point d'une douleur âme, Conservés nous le fils, si nous perdons le père;
Vn implacable Dieu qui n’eut iamais d’autels, Eut ce droict en partage entre les immortels, De pouuoir s’aſſouuir de ſang & de carna Et de ne diſtinguer les qualités ny l’aage, e, Ce ſceptre, que le Ciel vient de mettre en vos mains, Vous éleus beaucoup ſur les autres humains;	Un implacable Dieu qui n'eût jamais d'autels, Eut ce droit en partage entre les immortels, De pouvoir s'assouuir de sang et de carna Et de ne distinguer les qualités Seigneur l'âge, eu, Ce sceptre, que le Ciel vient de mettre en vos mains, Vous éleus beaucoup sur les autres humains;
Mais en ce noir ſeiour où toute ame deuale, D'vn throſne, & de plus bas la deſcente eſt égale, Et voſtre Maieſté ne s’exemptera pas Ou de nous deuancer ou de ſuiure nos pas, Donc forcés vos douleurs & que voſtre ame, Sire, Sur nous,& ſur vous meſme ayt vn egal Empire, Acquerez cette gloire entre les autres Rois D'eſtre l’obſeruateur de vos premieres lois.	Mais en ce noir séjour où toute âme deval, D' throsne, et de plus bas la descente est égale, Et votre Majesté ne s'exemptera pas Ou de nous devancer ou de suivre nos pas, Donc forcès vos douleurs et que votre âme, Sire, Sur nous, sur vous seulement ait un égal Empire, Acquerez cette gloire entre les autres Rois D'être l'observation de vos premières lois.
CLEANTES.	CLÉANTES.
Quoy, ie verrois ſans pleurs la mort qui nous ſepare, En ces occaſions la conſtance eſt barbare, L’onde a faict de ma ſœur ſon butin precieux, Mon pere l’a ſuiuie en ces funeſtes lieux, mi puumy veemmmvmeqemmuuuurmes, Et ma conſtance, helas!	Quoi, Seigneur verrais sans pleurs la mort qui nous sépare, En ces occasions la constance est barbare, L'onde a fait de ma sœur son butin précieux, Mon père l'a suivie en ces funestes lieux, mi puumi veemmmvmeqemmuuuurmes, Et ma constance, hélas!
ne rendroit pas les armes, O barbare conſeil!	ne rendrait pas les armes, Ô barbare conseil!
ô Ciel iniurieux!	ô Ciel injurieux!
Parque trop inhumaine, & trop ſeueres Dieux!	Parque trop inhumaine, et trop zé Dieux!
chef de ACHANTHE, guerre Vn Roy qui vit ſans ſoings en ſa natale riue, Dont la paix rend la vie, & la valeur oyſiue, Dont vn honteux repos tient les ſens enchantés, a ii	chef de ACHANTHÉ, guerre Un Roi qui vit sans soings en sa natale rive, Dont la paix rend la vie, et la valeur oisive, Dont un honteux repos tient les sens enchantés, a ji
Et que la mort ſurprend entre ces voluptés, Comme il meurt ſans lauriers, ſans gloire, & ſans eſtime, Rend à ſes ſucceſſeurs la pitié legitime, On le plaint iuſtement, ſa honte faict nos pleurs, Et ſa memoire ceſſe auecques nos douleurs;	Et que la mort surprend entre ces voluptés, Comme il meurt sans lauriers, sans gloire, et sans estime, Rend à ses successeurs la pitié légitime, On le plaint justement, sa honte fait nos pleurs, Et sa mémoire cesse avec nos douleurs;
Mais vn, dont la valeur n'a point eu d’heures calmes, Et qui meurt dans vn camp enuironné de palmes, Dire il fut vn grand Prince il a bien combattu, C’est le plus beau tribut qu’on doiue à ſa vertu, Telles de Thaumaſis furent les deſtinees, Jl meurt chargé d’honneurs, de palmes, et d’annees, C’eſt enuier ſon bien que de plaindre ſon ſort, Et l’on doit d’vn œil ſec voir vne illustre mort;	Mais un, dont la valeur n'a point eu d'heures calmes, Et qui meurt dans un camp environné de palmes, Dire il fut un grand Prince il a bien combattu, C'est le plus beau tribut qu'on doive à sa vertu, Telles de Thaumasis furent les destinées, Jl meurt chargé d'honneurs, de pâmes, et d'années, C'est envier son bien que de plaindre son sort, Et l'on doit d'un œil se voir une illustre mort;
Acheuons ſeulement le deſſein de ſes armes, Que le ſang des vaincus luy tienne lieu de larmes, Et que Jara détruicte,& ſes murs renuerſés Faſſent chercher vn iour où furent ſes foſſés.	Achevons seulement le dessein de ses armes, Que le sang des vaincus tu tienne lieu de larmes, Et que Jara détruite,et ses murs renversés Fassent chercher un jour où furent ses fossés.
CLEANTES.	CLÉANTES.
Tel eſtoit le deſſein de cet heureux Monarque, Qui du Royaume noir paſſe la triste barque, Telle eſt de ſon armee encor l’intention, Et telle est de ſon fils la iuſte paßion, Rendons noſtre valeur & ce ſiege celebre, Ne faiſons de Iara qu’vn Theatre funebre, deDes bras de Salmacis tirons ce rauiſſeur, Que ie dois immoler aux Manes de ma ſœur, Qu'à ſes plus fiers ſoldats mon bras ſoit redoutable, Et que l’innocent meure auecques le coupable;	Tel était le dessein de cet heureux Monarque, Qui du Royaume noir passe la triste barque, Telle est de son armée encor l'intention, Et telle est de son fils la juste passion, Rendons notre valeur et ce siège célèbre, Ne faisons de Jara qu'un Théâtre funèbre, deDes bras de Salmacis tirons ce ravisseur, Que ie dois immoler aux Manes de ma sœur, Qu'à ses plus fiers soldats mon bras soit redoutable, Et que l'innocent meure avec le coupable;
LYSANOR, Vas-tu donc mon ſoucy?	LYSANOR, Vas-tu donc mon souci?
SCENE DEVXIESME.	SCÈNE DEUXIÈME.
CLEANDRE, LYSANOR,	CLÉANDRE, LYSANOR,
CLEANDRE, Ie te dois annoncer Non ſans beaucoup de peine, (il le faut confeſſer) Une perte à tous deux également commune, deu on peus nenmer lu vonnt, & muuuaiſe fortune, Mais ſi tu veux ſçauoir ce ſenſible mal-heur, Diſpoſe ton amour à vaincre ta douleur.	CLEANDRE, Je te dois annoncer Non sans beaucoup de peine, (il le faut confesser) Une perte à tous deux également commune, dev on pus nenmer lu vonnt, et muaise fortune, Mais si tu veux savoir ce sensible malheur, Dispose ton amour à vaincre ta douleur.
YSANOR.	YSANOR.
Cette étroicte vnion de nos ieunes courages Qui m'oste à mes parens, qui m'expoſe aux naufras.	Cette étroite intion de nos jeunes courages Qui m'ôte à mes parents, qui m'expose aux naufras.
Qui m’a faict ſuiure icy ta fortune, & tes pas, elle autre paſsion ne vaintroit elle pass	Qui m'a fait suivre ici ta fortune, et tes pas, elle autre passion ne vaintrait -elle pass
CLEANDRE.	CLÉANDRE.
Ce Prince dont tu tiens le bien de la naiſſance, El t'a faict pour ma gloire exercer ta conſtance, Que ſert de prolonger des diſcours ſuperflus?	Ce Prince dont tu tiens le bien de la naissance, Él t'a fait pour ma gloire exercer ta constance, Que sert de prolonger des discours superflus?
LTSAICOR.	LTSAICOR.
Acheue donc mon cœur;	Achève donc mon cœur;
CLEANDRE.	CLÉANDRE.
Et bien il ne vit plus, Au poinct que l’Orient dißipoit les tenebres On a veu de ſa mort les appareils funebres, Vn de nos eſpions reuenu de ce pas Quand tu m’as rencontré m’apprenoit ſon trépas, Arriué plein de gloire à l'hyuer de ſon aage, Il ne pouuoit du Ciel ſouhaitter dauantage, Jl meurt craint, & chery des plus ingrats eſprits, Et la mort l’a pluſtoſt attendu que ſurpris.	Et bien il ne vit plus, Au point que l'Orient dissipoit les ténèbres On a vu de sa mort les appareils funèbres, Un de nos épions revenu de ce pas Quand tu m'as rencontré m'apprenait son trépas, Arrivé plein de gloire à l'hiver de son âge, Il ne pouvait du Ciel souhaiter davantage, Jl meurt craint, et chéri des plus ingrats esprits, Et la mort l'a plutôt attendu que surpris.
LISANOR, Atteinte iuſqu’au cœur, froide, l’ame troublée, Je ſents de tant d’ennuys ma fortune comblee, Que ce triſte rapport m’interdit à la fois Et l’vſage des ſens & celuy de la voix, Il est vray que ſes ans touchoient ſa ſepulture, Qu’il deuoit comme tous ce tribut à nature, Et qu’il tombe d’vn coup plus doux, qu’impetueux Außi Außi, ie voy ſa mort d’vn œil reſpectueux, Et ie n’accuſe point ces puiſſances ſuprèmes Qui n'épargnent grandeurs, ſceptres, ny Diademes;	LISANOR, Atteinte jusqu'au cœur, froide, l'âme troublée, Je sents de tant d'ennuyaient ma fortune comblée, Que ce triste rapport m'interdit à la fois Et l'usage des sens et celui de la voix, Il est vrai que ses ans touchaient sa sépulture, Qu'il devait comme tous ce tribut à nature, Et qu'il tombe d'un coup plus doux, qu'impétueux Aussi Seigneur, je vois sa mort d'un œil respectueux, Et ie n'accuse point ces puissances suprêmes Qui n'épargnent grandeurs, sceptres, ni Diadempres;
Ie n’accuſe que moy:	Je n'accuse que moi:
le plus fort déplaiſir, Dont, en cet accident, ie me ſente ſaiſir, C’eſt qu’il ait emporté ſur la riue Eliſee Une douleur, qu’enfin le temps euſt appaiſee, Cette iuste douleur, que ſa fille ait eſté Coupable du meſpris de ſon authorité:	le plus fort déplaisir, Dont, en cet accident, je me sente saisir, C'est qu'il ait emporté sur la rive Élisée Une douleur, qu'enfin le temps eût apaise, Cette juste douleur, que sa fille ait été Coupable du mépris de son autorité:
Vn iour à ſa fureur i'euſſe arraché les armes, Mais ſa minuuuy cemeppe mien mnms, Et ne me laiſſe point la ſatisfaction De l’auoir veu ſenſible à noſtre affection.	Un jour à sa fureur j'eusse arraché les armes, Mais sa minuuuy cemepe mien mennms, Et ne me laisse point la satisfaction De l'avoir vu sensible à notre affection.
SLEANDRE, La mort qui faict en nous tant de metamorphoſes, Luy faict voir aux Enfers la nature des choſes, Et là d’vn œil ſubtil qui perce iuſqu’à nous, Il découure vn ſuiet de calmer ſon courroux:	SLEANDRE, La mort qui fait en nous tant de métamorphoses, Lui fait voir aux Enfers la nature des choses, Et là d'un œil subtil qui perce jusqu'à nous, Il découvre un sujet de calmer son courroux:
Il voit la pureté qui preſide à nos flames, Jl cognoiſt de quels traicts l’amour touche nos ames, Et, comme il eſt exempt de toute paßion, Ne vous immole plus a ſon ambition;	Il voit la pureté qui préside à nos flammes, Il cognoist de quels traits l'amour touche nos âmes, Et, comme il est exempt de toute passion, Ne vous immole plus a son ambition;
Auec ce ſentiment reuerons ſa memoire Estimons ſes vertus & publions ſa gloire, Ne vous affligés point d’vn inutile ennuy, Mais qu'on remarque en vous quelque choſe de luy, Imités cette force & ce courage extréme Qui le rendirent ſeul comparable à ſoy-meſme.	Avec ce sentiment reverons sa mémoire Estimons ses vertus et publions sa gloire, Ne vous affligez point d'Hile ennui, Mais qu'on remarque en vous quelque chose de Seigneur, Imités cette force et ce courage extrême Qui le rendirent seul comparable à soi-même.
LYSANOR.	LYSANOR.
Le bien de voir ton ſort à mon destin vny Me rend ſeul ſupportable vn tourment infiny, Tu faicts toute ma force, & toute ma conſtance, El ma raiſon jans toy jeron jans remiente, Toy ſeul,	Le bien de voir ton sort à mon destin uni Me rend seul supportable un tourment infini, Tu faits toute ma force, et toute ma constance, Éla ma raison jans toi jeron jans remiente, Toi seul,
CLEANDRE.	CLÉANDRE.
N’acheue point, & pluſtoſt mon ſoucy, Meditons vn moyen de nous tirer d’icy, Tu ſçais les paßions qu’en cette Cour excite Le malheur qui me ſuit, pluſtoſt que mon merite, Et touſiours refuſant comme touſiours preſſé, Je crains vn triſte effect d’vn amour offencé, La Reyne peut enfin releuer ſon courage, Et d’vne extréme amour faire vne extréme rage;	N'achève point, et plutôt mon souci, Méditons un moyen de nous tirer d'ici, Tu sais les passions qu'en cette Cour excite Le malheur qui me suit, plutôt que mon mérite, Et toujours refusant comme toujours pressé, Je crains un triste effet d'un amour offensé, La Reine peut enfin releuer son courage, Et d'une extrême amour faire une extrême rage;
Ce ieune, & doux tyran de nostre liberté, D’enfant eſt vn Lyon, quand il eſt irrité, Puis qu’enfin le Demon, que l'Epire reuere, A faict tomber ſon ſceptre en la main de ton frere, Et que vos cœurs ſont ioincts d’vne étroicte amitié, Forçons nostre malheur, implorons ſa pitié En voicy le moyen;	Ce jeune, et doux tyran de notre liberté, D'enfant est un Lyon, quand il est irrité, Puis qu'enfin le Démon, que l'Epire révère, A fait tomber son sceptre en la main de ton frère, Et que vos cœurs sont joints d'une étroite amitié, Forçons notre malheur, implorons sa pitié En voici le moyen;
il faut prier la Reyne, De ſouffrir qu'vn duel tire elle, & nous de peine, Qu'elle enuoye vn heraut, & qu’il me ſoit permis D’appeller le plus fier du camp des ennemys, Qu'à l’autre le plus fort faſſe mordre la terre, Et que ce ſeul combat acheue cette guerre;	il faut prier la Reine, De souffrir qu'un duel tire elle, et nous de peine, Qu'elle envoie un héraut, et qu'il me soit permis D'appeler le plus fier du camp des ennemis, Qu'à l'autre le plus fort fasse mordre la terre, Et que ce seul combat achève cette guerre;
Ma priere obtiendra tout l’aueu qu’il nous faut, Et de ce feint appel tu ſeras le beraut;	Ma prière obtiendra tout l'aveu qu'il nous faut, Et de ce feint appel tu seras le beraut;
Tes yeux en ce beſoing te fourniront des larmes, Qui de la main du Roy feront tomber les armes, Tu ſeras à ce Prince auoüer nostre amour, Et nous nous tirerons de ce fatal ſeiour.	Tes yeux en ce besoing te fourniront des larmes, Qui de la main du Roi feront tomber les armes, Tu seras à ce Prince auoüer notre amour, Et nous nous tirerons de ce fatal séjour.
LYSANOR, Il ſuffit;	LYSANOR, Il suffit;
quelque effort dont ſon bras ie menace, fe feray ma douleur ſi digne de ſa grace, Qu'vn agreable effect ſuiura nostre deſſein Et que i’amolirois vn rocher en ſon ſein;	quelque effort dont son bras homme menace, se ferai ma douleur si digne de sa grâce, Qu'un agréable effet suivra notre dessein Et que j'amolirais un rocher en son sein;
Sus donc, exequutons cet aduis ſalutaire, Va diſpoſer la Reyne a cette heureuſe affaire, Et ſouffre que ie réue vne heure ſeulement, En attendant ſon ordre & ſon commandement.	Sus donc, exéquutons cet avis salutaire, Va disposer la Reine à cette heureuse affaire, Et souffre que sans réue une heure seulement, En attendant son ordre et son commandement.
LYSANOR, Donc ce vieillard affamé e HH Qui vit de ce qu’il engendre, D'vn Prince ſi renommé N'a faict qu’vn monceau de cendre;	LYSANOR, Donc ce vieillard affamé eût HQui vit de ce qu'il engendre, D' Homme si renommé N'a fait qu'un monceau de cendre;
Donc, on ne peut euiter Les auares mains des Parques, Et ny ſuiets, ny Monarques Ave teut pehuent tebsier.	Donc, on ne peut éviter Les avares mains des Parques, Et ni sujets, ni Monarques Ave teut phuent tebsier.
Mes yeux m’en vont fournir;	Mes yeux m'en vont fournir;
Dieux!	Dieux!
ne puis-ie vn moment, En ce comble d’ennuys ſouſpirer librement?	ne puis-je un moment, En ce comble d'ennuis soupirer librement?
Digne obiet de mes douleurs, Triſte autheur de ma naiſſance, Si deux fontaines de pleurs Peuuent lauer vne offence,	Digne objet de mes douleurs, Triste auteur de ma naissance, Si deux fontaines de pleurs Peuvent lauer une offense,
SCENE TROISIESME.	SCÈNE -TROISIÈME.
CETHALIE, LY SANOR,	CETHALIE, LI SANOR,
CEPHALIE.	CÉPHALIE.
S-tu, cher Lyſanor, ma paßion dépeinte?	S-tu, cher Lysanor, ma passion dépeinte?
ILEtably mon eſpoir ou confirmé ma crainte.	ILEtably mon espoir ou confirmé ma crainte.
Treuueray-ie ſon cœur acceßible à mes veux?	Treuverai-je son cœur accible à mes veux?
Et le rangerons-nous au deſſein que ie veux?	Et le rangerons-nous au dessein que je veux?
LYSANOR.	LYSANOR.
Dieux!	Dieux!
comme auec le temps toute choſe s’efface!	comme avec le temps toute chose s'efface!
Tel ſe ſent conſommer qui n'eſtoit que de glace, Tel ſe deſeſperoit qui vit enfin content, Et pour ces changemens il ne faut qu’vn inſtant.	Tel se sent consommer qui n'était que de glace, Tel se désespérait qui vit enfin content, Et pour ces changements il ne faut qu'un instant.
CEIIa IXsTue.	CEIIa IXsTue.
Que t’a faict eſperer cet obiet adorable?	Que t'a fait espérer cet objet adorable?
LYSANOR.	LYSANOR.
Qu’il ſeroit tout à vous;	Qu'il serait tout à vous;
CEPHALIE.	CÉPHALIE.
O diſcours fauorable!	Ô discours favorable!
Quoy, ton maistre eſt touché de ma fidelite?	Quoi, ton maître est touché de ma fidélité?
Ne me flattes tu point de trop de vanité?	Ne me flattes -tu point de trop de vanité?
YSANOR.	YSANOR.
Un moment l’a tiré de ſa melancholie, Son humeur s’eſt changee au nom de Cephalie;	Un moment l'a tiré de sa mélancolie, Son humeur s'est change au nom de Céphalie;
Quoy?	Quoi?
m’a-t’il reſpondu?	m'a-t-il répondu?
ce doux obiet d’amour Conſent que ſous ſes loix ie reſpire le iour?	ce doux objet d'amour Consent que sous ses lois On respire le jour?
Cede, (a t’il dit apres, ) importune memoire, D’vne qui ne vit plus, à ma nouuelle gloire, Cedes tristes regrets a mes nouueaux deſirs, Inutiles douleurs cedés à mes plaiſirs.	Cède, (a -t-il dit après, ) importune mémoire, D'une qui ne vit plus, à ma nouvelle gloire, Cédes tristes regrets à mes nouveaux désirs, Inutiles douleurs cédés à mes plaisirs.
CEPHALIE.	CÉPHALIE.
Doux & cher confident, ie dois à ton addreſſe L'heur de le voir ſenſible à l’ardeur qui le preſſe.	Doux et cher confident, ie dois à ton adresse L'heur de le voir sensible à l'ardeur qui le presse.
LTSANOR, I’ayderois mollement le pouuoir de vos traicts, Uous deués tout, Madame, à vos propres attraicts.	LTSANOR, J'aiderais mollement le pouvoir de vos traits, Uous devez tout, Madame, à vos propres attraits.
CEPHALIE.	CÉPHALIE.
Adieu, ſi par tes ſoings mon amour eſt contente, Je feray que tes biens paſſeront ton attente.	Adieu, si par tes soings mon amour est contente, Je ferai que tes biens passeront ton attente.
YSANOR ſeul.	YSANOR seul.
Quels biens me ſeroient chers, ſi riche à mes deſpens Elle tenoit de moy le ſeul bien que i’attens, O d’vne triste cauſe euenement viſible!	Quels biens me seraient chers, si riche à mes dépens Elle tenait de moi le seul bien que j'attends, Ô uvne triste cause événement visible!
Elle me veut du bien, quand ie luy ſuis nuïſible, Et ſon amour luy faict aueuglement preſſer Celle qui la recule au lieu de l’aduancer, Mais quelqu’vn vient icy.	Elle me veut du bien, quand ie lui suis nuissible, Et son amour avait fait aveuglement presser Celle qui la recule au lieu de l'avancer, Mais quelqu'un vient ici.
SCENE QVAT RIESME, SALMACIS, CLEANDRE, LYSANOR, SAEMACIS,	SCÈNE QUAT RIESME, SALMACIS, CLEANDRE, LYSANOR, SAEMACIS,
QUe ce deſſein m'affige, A quel conſentement ma priere m’oblige!	QUe ce dessein m'affige, À quel consentement ma prière m'oblige!
Sois à ma iuſte crainte vn peu plus indulgent, Par la longueur du ſiege ennuyons l’aßiegeant, I'ay faict munir Jara des viures neceyunts A rebuter l’eſpoir des plus fiers aduerſaires, Prenons aduis du temps;	Sois à ma juste crainte un peu plus indulgent, Par la longueur du siège ennuyons l'assiegeant, J'ai fait munir Jara des vivres neceyunts A rebuter l'espoir des plus fiers adversaires, Prenons avis du temps;
ne precipite pas Ce combat hazardeux qui ne nous preſſe pas,	ne précipite pas Ce combat hasardeux qui ne nous presse pas,
CLEANDRE.	CLÉANDRE.
Vous doutés iuſtement d'vn bras, & d’vne épee Que vos commandements n’ont iamais occupee, Mais ie veux qu’vn proſpere & prompt euenement, Reſolue en ma faueur ce douteux ſentiment;	Vous doutez justement d'une bras, et d'une épee Que vos commandements n'ont jamais occupe, Mais tu veux qu'un prospère et prompt événement, Résolue en ma faveur ce douteux sentiment;
Laiſſés moy remporter cette illustre victoire, Et ne dérobés point cette marque a ma gloire, Mon courage me donne aſſés de-vanité Pour attendre vn laurier de vostre Maieſté.	Laissez moi remporter cette illustre victoire, Et ne dérobez point cette marque à ma gloire, Mon courage me donne assez de-vanité Pour attendre un laurier de votre Majesté.
SALMACIS.	SALMACIS.
Uoy iuſqu’où ie voudrois contenter ton enuie, Si ie t’oblige meſme au hazard de ta vie, Mais ne la conte plus au nombre de tes biens, Et ſonge que ie t’ayme, & que tes iours ſont miens, Que cette occaſion t’oblige à les deffendre, Et dans tous tes deſſeins réponds moy de Cleandre.	Uoi jusqu'où tu voudrais contenter ton envie, Si tu t'oblige même au hasard de ta vie, Mais ne la conte plus au nombre de tes biens, Et songe que tu t'aime, et que tes jours sont miens, Que cette occasion t'oblige à les défendre, Et dans tous tes desseins réponds moi de Cléanre.
CLEANDRE.	CLÉANDRE.
Preparons au pluſtoſt cette illusire action;	Préparons au plustost cette illusire action;
Accepte Lyſanor cette commißion, Icy i’éprouueray ta prudence, et ton Zele Fay toy conduire au camp, où ta charge t’appelle, Et du camp des Soldats aux pauillons du Roy, Qui de cette action te preſcrira la loy.	Accepte Lysanor cette commivion, Ici i’éprouverai ta prudence, et ton Zèle Fais toi conduire au camp, où ta charge t'appelle, Et du camp des Soldats aux pavillons du Roy, Qui de cette action te prescrira la loi.
SALMACIS, Cleandre plûſt au Ciel (& tu me dois- bien croire,) Pûſſay-ie de mon ſceptre achepter ta victoire!	SALMACIS, Cléandre plût au Ciel (T tu me dois- bien croire,) Pussay-je de mon sceptre acheter ta victoire!
Si le ſort eſt pour toy, n’attens point qu’vn laurier Au retour du combat ceigne ce front guerrier, Eſpere vne plus digne, & plus riche couronne, Que Mars t'aura gaignee, & que l’amour te doune -- 1mM Et La mienne, mon pouuoir, mon ſceptre, mon état, Et moy-meſme, ſerois le prix de ce combat, Que mes vœux vne fois te treuuent acceßible, Force pour tant d’amour ce courage inſenſible, Et que ie doiue enfin quelque traict d’amitié, Sinon à ta iustice au moins à ta pitié.	Si le sort est pour toi, n'attends point qu' laurier Au retour du combat ce ce front guerrier, Espère une plus digne, et plus riche couronne, Que Mars t'aura gagnée, et que l'amour te doune -- Et La mienne, mon pouuoir, mon sceptre, mon état, Et moi-même, serois le prix de ce combat, Que mes vœux fois te treuuent accessible, Force pour tant amour ce courage insensible, Et que ie doiue enfin quelque traict amitié, Sinon ta iustice au moins ta pitié.
Qu'à quelque complaiſance vne Reyne t’excite Par ſa douleur au moins ſi ce n’eſt par merite;	Qu'à quelque complaisance une Reine t'excite Par sa douleur au moins si ce n'est par mérite;
Pourquoy me caches tu ces attraicts pretieux?	Pourquoi me caches -tu ces attraits prétieux?
Et pourquoy de mes pleurs détournes tu les yeux?	Et pourquoi de mes pleurs détournes -tu les yeux?
Voy de ta cruauté ces glorieuſes marques, Voy tonjommeu pouniey veſpomue ceni luonarques, Mais ton moindre deſſein eſt de me ſecourir, Et tu ne m’oſes voir depeur de me guerir.	Vois de ta cruauté ces glorieuses marques, Vois tonjommeu nie vespomue ceni luonarques, Mais ton moindre dessein est de me secourir, Et tu ne m'oses voir dépeur de me guérir.
CLEANDRE.	CLÉANDRE.
Qu'attend d'vn malheureux vostre douleur amere, Si meſme il ne peut rien pour ſa propre miſere?	Qu'attend d'un malheureux votre douleur âme, Si même il ne peut rien pour sa propre misère?
i El llelso Détache ton penſer du vain obiet des morts.	y llelso Détache ton penser du vain objet des morts.
CLEANDRE.	CLÉANDRE.
Ce pouuoir grande Reyne excede mes efforts.	Ce pouvoir grande Reine excède mes efforts.
ALMACIS.	ÀLMACIS.
Et bien, n’esteins iamais cette ardeur inſenſee Et que touſiours Floronde occupe ta penſee;	Et bien, n'éteins jamais cette ardeur insensée Et que toujours Floronde occupe ta pensée;
Je ne deſire point d’amollir ta rigueur, Conſerue luy tes vœux, ton eſprit, & ton cœur;	Je ne désire point d'amollir ta rigueur, Conserve femme tes vœux, ton esprit, et ton cœur;
Ayme la, mais cruel:	Aime la, mais cruel:
que pour le moins i’obtienne, Cette moitié de toy, qui ne peut eſtre ſienne, Qu’vne autre ayant l’eſprit, ie poſſede le corps, Ie ne t’oblige à vœux, careſſes, ny tranſports, Qu’aux froideurs ſi tu veux nulle ardeur ne ſuccede, Ne me poſſede point, mais que ie te poſſede, Souffre les qualités, & d’Eſpoux, & de Roy, Et ne me donne rien en receuant ma foy.	que pour le moins j'obtienne, Cette moitié de toi, qui ne peut être sienne, Qu'une autre ayant l'esprit, votre possède le corps, Je ne t'oblige à vœux, caresses, ni transports, Qu'aux froideurs si tu veux nulle ardeur ne succède, Ne me possède point, mais que Un te possède, Souffre les qualités, et d'Époux, et de Roi, Et ne me donne rien en recevant ma foi.
CLEANDRE.	CLÉANDRE.
Ceeſt trop vomn upfagerjie Out januu de l’onde (Mais lâche en quel danger expoſes tu Floronde?	Cepest trop vomn upfagerjie Out janu de l'onde (Mais lâche en quel danger exposes tu Floronde?
Ha change ce diſcours,	Ha change ce discours,
SALMACIS.	SALMACIS.
Acheue, que dis-tu?	Achève, que dis-tu?
MDHINE, Que ie dois rendre aux flots ce butin qu’ils ont eu, Et que le dois punir de fon ingraitinde, Cet indigne ſuiet de voſtre inquietude.	MDHINE, Que ainsi dois rendre aux flots ce butin qu'ils ont eu, Et que le dois punir de son ingraitinde, Cet indigne sujet de votre inquiétude.
SALMACIS.	SALMACIS.
Cruel, fay la ceſſer, & ne la punis pas.	Cruel, fais la cesser, et ne la punis pas.
CLEANDRE.	CLÉANDRE.
La ſeule mort le peut;	La seule mort le peut;
vos plus charmans appas, Voſtre ſceptre, vos biens, vos careſſes, vos larmes, Pour aſſaillir ma foy ſont d'inntiles armes, Et mes propres efforts le tenteroient en vain, Pan que teue eſt la loy de mon ſort inhumain.	vos plus charmants appas, Votre sceptre, vos biens, vos caresses, vos larmes, Pour assaillir ma foi sont d'inntiles armes, Et mes propres efforts le tenteraient en vain, Pan que tue est la loi de mon sort inhumain.
ALMACIS.	ÀLMACIS.
Va, Barbare, tyran des mouuemens de l’ame, Indigne, & lâche Autheur de ma cruelle flame, Monſtre, rocher mouuant, ſupplice de mes yeux, Homicide enchanteur des eſprits de ces lieux, Triomphe inſolemment de mon cruel martyre, Et meſpriſe vne Reyne eſclaue en ton Empire.	Va, Barbare, tyran des mouvements de l'âme, Indigne, et lâche Auteur de ma cruelle flamme, Montre, rocher mouvant, supplice de mes yeux, Homicide enchanteur des esprits de ces lieux, Triomphe insolemment de mon cruel martyre, Et méprise une Reine esclaue en ton Empire.
Sous quelque étroicte loy, qu’amour l’ayt ſceu ranger.	Sous quelque étroite loi, qu'amour l'ait su ranger.
Elles?	Elles?
La mort ce dernier mal, l’en ſçaura dégager:	La mort ce dernier mal, l'en saura dégager:
SCENE CINQVIESME, CEPTALIE, CLEANDRE,	SCÈNE CINQUIÈME, CEPTALIE, CLEANDRE,
CEPHALIE.	CÉPHALIE.
JOſtre froideur, Monſieur, excite ſa colere.	JOtre froideur, Monsieur, excite sa colère.
CLEANDRE, dilonos quee cofene neuure,que feure te reuere,	CLEANDRE, dilonos quee cofène neuvre,que fure te révère,
CEPHALIE.	CÉPHALIE.
Pleuſt au Ciel que te cœur auouaß ce propos;	Plût au Ciel que te cœur auouass ce propos;
CLEANDRE.	CLÉANDRE.
Et plûſt à vos beautés d’agreer mon repos,	Et pluût à vos beautés d'agréer mon repos,
nn l li an a A Mo Quoy, ie vous oſterois vn ſceptre, vn Diadeſme.	Un l li an a À Mo Quoi, je vous ôterais un sceptre, un Diadesme.
CLLANDNE.	CLLANDNE.
On me peut achepter au ſeul prix de ſoy-meſme.	On me peut achetter au seul prix de soi-même.
LEPHALIE.	LÉPHALIE.
La Reyne à vos deſirs s’offre ſoy-meſme außi;	La Reine à vos désirs s'offre soi-même aussi;
CLEANDRE, Un obiet plus charmant faict naiſtre mon ſoucy;	CLEANDRE, Un objet plus charmant fait naître mon souci;
CEPHAIIE.	CÉPHAIE.
Quel eſt-ce doux obiet?	Quel est-ce doux objet?
Floronde.	Floronde.
*	*
CLEANDRE, Cephalie;	CLÉANDRE, Céphalie;
L'amour ſuccede enfin à la melancolie, Floronde est ſatisfaicte apres vn long tourment Et ne s’oppoſe point à ce doux changement.	L'amour succède enfin à la mélancolie, Floronde est satisfaite après un long tourment Et ne s'oppose point à ce doux changement.
CET IAIIEIES Quoy, ie verrois leandre à mes vœux acceßible?	CET IAIIEIES Quoi, je verrais léandre à mes vœux accesible?
CEEANDRE.	CEANDRE.
Quels ſerments voulés vous d’vne ardeur ſi viſible,	Quels serments voulez vous d'une ardeur si visible,
CEPHALIE.	CÉPHALIE.
Au lieu de ces ſerments fay parler les effects, Et réponds ardamment aux vœux que ie te faicts.	Au lieu de ces serments fais parler les effets, Et réponds ardamment aux vœux que ie te faits.
CLEANDRE.	CLÉANDRE.
Adieu, ſi vostre cœur parle par vostre bouche, Et ſi ſans me flatter ma paßion vous touche, Uous verrés des effects d’vne fidelité Digne de ma conſtance, & de vostre beauté, Je reuiens de ce pas, certain deſir me preſſe Qui vous confirmera cette heureuſe promeſſe.	Adieu, si votre cœur parle par votre bouche, Et si sans me flatter ma passion vous touche, Uous verrez des effets d'une fidélité Digne de ma constance, et de votre beauté, Je reviens de ce pas, certain désir me presse Qui vous confirmera cette heureuse promesse.
in	in
SCENE SIXIESME.	SCÈNE SIXIÈME.
MALMACIS, CEYHALIE,	MALMACIS, CEYHALIE,
SALMACIS, Ueue ineſperée?	SALMACIS, Uue inespérée?
o ſenſiblé tourment!	ô sensiblé tourment!
I Que produira ma rage, & mon reſſentiment.	I Que produira ma rage, et mon ressentiment.
CEPHALIE.	CÉPHALIE.
ſurpriſe.	surprise.
Madame cette offenſe où l'amour m’a portée.	Madame cette offense où l'amour m'a portée.
SALMACIS.	SALMACIS.
Sorts, euite ma hayne, impudente, effrontée, O meſpris trop aueugle!	Sorts, évite ma haine, impudente, effrontée, Ô mépris trop aveugle!
ô honte!	ô honte!
ô deſeſpoir!	ô désespoir!
Jcy la patience excede mon pouuoir;	Ici la patience excède mon pouvoir;
Laiſſe icy ma raiſon ſuſpendre ton vſage, A tous ſes mouuements abandonne ma rage, Fauſſe fidelité, froideurs, meſpris, dédains, Venés contre ce traiſtre armer mes propres mains, Qu'à l'obiet de ſes vœux ma hayne le rauiſſe, Que de ſon lâche ſang ma fureur s’aſſouuiſſe, Et que ie faſſe voir à la poſterité Ce que peut vn amour iuſtement irrité.	Laisse ici ma raison suspendre ton usage, À tous ses mouvements abandonne ma rage, Fausse fidélité, froideurs, mépris, dédains, Venez contre ce traître armer mes propres mains, Qu'à l'objet de ses vœux ma haine le ravisse, Que de son lâche sang ma fureur s'assouuisse, Et que je fasse voir à la postérité , que peut un amour justement irrité.
ſ--m- G	s-m- G
SCENE SEPTIESME apoſté par AR GANT, AGYS, DAMIS, Beaimmosi	SCÈNE SEPTIÈME aposté par AR GANT, AGIS, DAMIS, Béaimosi
JOicy l'heure, & l’endroit preſcrit à nostre crime, Où la mort de nos mains attend vne victime, Que la beauté de l’or, ce metal precieux Eblouyt doucement les eſprits,& les yeux, Qu'elle excite de force & qu’vne arme doree, Du plus lâche poltron rend la main aſſeuree, Amys, qu’il ſoit d’abord rudement aſſailly, Vn cruel chaſtiment ſuiuroit ce coup failly.	JOici l'heure, et l'endroit prescrit à notre crime, Où la mort de nos mains attend quelque victime, Que la beauté de l'or, ce métal précieux Éblouit doucement les esprits,et les yeux, Qu'elle excite de force et qu'une armé dorée, Du plus lâche poltron rend la main assurée, Amis, qu'il soit d'abord rudement assailly, Vîn cruel châtiment suivrait ce coup failly.
DAMIS.	DAMIS.
St i’apperçoy quelqu’vn, approchons	St j'aperçois quelqu'un, approchons
ARGANT.	ARGANT.
C’est luy-meſme,	C'est autre-même,
Donnons,	Donnons,
SCENE HVICTIESME, CLEANDRE, ARGANT &cGLEANDRE,	SCÈNE HVICTIESME, CLEANDRE, ARGANT etcGLEANDRE,
Perfidie!	Perfidie!
ô trabiſon extréme!	ô trabison extrême!
au bras Si le Ciel aſſaßins conduit vn iuſte bras, Auut t'Enjer aſſemvte ne voux ſauntron pas,	au bras Si le Ciel assassins conduit un juste bras, Auut t'Enjer assemotte ne voux sauntron pas,
O Ciel, ô Dieux!	Ô Ciel, ô Dieux!
AGYS.	AGIS.
DAMIS.	DAMIS.
Je meurs, & l’infame auarice, euneporre n te erme a jenme ſuppuiee.	Je meurs, et l'infâme avarice, euneporre n te erme à jenme suppuiee.
ARGANT.	ARGANT.
Helas!	Hélas!
ce coup mortel est la punition D'vne ſi deteſtable, & ſi noire action.	ce coup mortel est la punition D'une si détestable, et si noire action.
CLEANDRE.	CLÉANDRE.
A la fin iuſte Ciel, ta ſupréme puiſſant y A de leur trahiſon ſauué mon innocence, O crime le plus noir que veit iamais le iouri Quoy, tant de lâcheté regne dans ceſte Cour?	À la fin juste Ciel, ta suprême puissant y A de leur trahison sauvé mon innocence, Ô crime le plus noir que veit iamais le iouri Quoy, tant de lâcheté regne dans ceste Cour?
Doriſmond Doriſmond traicte ainſi, mais i’apperçoy ce traiſtre, Que la crainte, & l’effroy font aſſés recognoiſtre.	Dorismond Dorismond traite ainsi, mais j'aperçois ce traître, Que la crainte, et l'effroi font assez reconnaître.
Vel conſeil dois-ie ſuiure!	Vel conseil dois-je suivre!
ô Dieux lil n'est pas muai inorle	ô Dieux lil n'est pas muai inorle
SCENE NEVFIESME.	SCÈNE NEUFIESME.
DORISMOND, CLEANDRE, DORISMOND.	DORISMOND, CLEANDRE, DORISMOND.
CLEANDRE.	CLÉANDRE.
A moy perfide, à moy;	À moi perfide, à moi;
DORISMOND, bleſſé.	DORISMOND, blessé.
Dure loy de mon ſort;	Dure loi de mon sort;
Le Ciel rend iuſtement mon entrepriſe veine, Et mon crime reçoit vne trop douce peine;	Le Ciel rend justement mon entreprise veine, Et mon crime reçoit trop douce peine;
Recueille heureux guerrier, les fruicts de ton amour, Toffede ces beaux yeux qui me couſtent le iour, Le ſort à ta valeur deſtinoit Cephalie, Et rien n’empeſche plus le beau nœud qui vous lie, je meurs, ie ne vis plus.	Recueille heureux guerrier, les fruits de ton amour, Toffede ces beaux yeux qui me coûtent le jour, Le sort à ta valeur destinait Cephalie, Et rien n'empêche plus le beau nœud qui vous lie, je meurs, elle ne vis plus.
CLEANDRE.	CLÉANDRE.
O Dieux!	Ô Dieux!
qu’entends-ie icy?	qu'entends-je ici?
Mon ſoupçon incertain eſt enfin éclaircy, Et ce ialoux charmé des yeux de cette belle A creu ſans fondement que ie bruſlois pour elle, Allons purger ce bras deuant ſa Maieſté, Et que toute la Cour ſçache ſa lâcheté.	Mon soupçon incertain est enfin éclairci, Et ce jaloux charmé des yeux de cette belle A cru sans fondement que je brûlais pour elle, Allons purger ce bras devant sa Majesté, Et que toute la Cour sa sa lâcheté.
vn poignard à la main SALMACIS, entre ca fune.	un poignard à la main SALMACIS, entre ca fune.
SER PIXIESME.	SER PIXIESME.
SALMACIS, LA NOVRRICE.	SALMACIS, LA NOURRICE.
JOicy mon cœur, voicy dequoy te ſatisfaire, V Quellieu cache ce traiſtre a ma iuste colere?	JOici mon cœur, voici dequoy te satisfaire, V Quelieu cache ce traître à ma juste colère?
Oublions tout reſpect des hommes, & des Dieux, La fureur qui me guide, & l’amour n’ont point d’yeux, C’eſt peu pour le toucher que ma propre Couronne!	Oublions tout respect des hommes, et des Dieux, La fureur qui me guide, et l'amour n'ont point d'yeux, C'est peu pour le toucher que ma propre Couronne!
Le ſuperbe meſpriſe à cauſe qu’on luy donne, Jl me fuit, & mes yeux, charmes de tant de Rois Luy ſemblent des captifs indignes de ſes Loix;	Le superbe méprise à cause qu'on lui donne, Jl me fuit, et mes yeux, charmes de tant de Rois Lui semblent des captifs indignes de ses Lois;
Ie luy ſuis odieuſe, épouuantable, horrible!	Ie Je suis odieuse, épouvantable, horrible!
O trop cruel affront!	Ô trop cruel affront!
ô meſpris trop ſenſible!	ô mépris trop sensible!
Mais ſi mes yeux n’ont pù, ma main le peut toucher Et ce qu’il me refuſe, il le faut arracher.	Mais si mes yeux n'ont pu, ma main le peut toucher Et ce qu'il me refuse, il le faut arracher.
LA N OVRRICE.	LA N OURICE.
Quoy, voulés vous ſoüiller d’vne action ſi lâche L’éclat d’vne vertu qui n’eut iamais de taſche?	Quoi, voulez -vous soüiller d'une action si lâche L'éclat d'une vertu qui n'eut jamais de tâche?
Liurés pluſtoſt ce traistre aux mains de l’aßiegeant, Que voſtre Maiesté le vange, en ſe vengeant, l coispss til rueile es ets jairates guenres, Qui troublent vos plaiſirs & menacent vos terres.	Livrez plutôt ce traître aux mains de l'assiegeant, Que votre Majesté le vengeant, en se vengeant, l oispss til rueile et es jairates guenres, Qui troublent vos plaisirs et menacent vos terres.
ALMACIS.	ÀLMACIS.
O timide conſeil non, non, vn ennemy Que d’autres ont vangé, n’eſt vange qu’à demy, Ma main doit à mon cœur ce meurtre qu’il reſpire, I’abandonne ma vie & mon ſceptre à l’Epire, Le rang, les dignités, les titres abſolus Ne me ſeront plus rien quand il ne ſera plus;	Ô timide conseil non, non, un ennemi Que d'autres ont vengé, n'est venge qu'à demi, Ma main doit à mon cœur ce meurtre qu'il respire, J'abandonne ma vie et mon sceptre à l'Epire, Le rang, les dignités, les titres absolus Ne me seront plus rien quand il ne sera plus;
Qu’alors vne effrontee, vne ſœur indiſcrette, Entretienne de pleurs ſa paßion ſecrette, Qu'elle aille ſur ſa tombe exalter jon pounoir;	Qu'alors une effronté, une sœur indiscrète, Entretienne de pleurs sa passion secrète, Qu'elle aille sur sa tombe exalter jon pounoir;
Mais le peux tu cruelle, offencer et le voir?	Mais le peux tu cruelle, offenser et le voir?
O barbare deſſein d’vne amour enragee;	Ô barbare dessein d'une amour enragée;
Qu'il me ſeroit amer d’en estre ainſi vangee!	Qu'il me serait amer d'en être ainsi venge!
I	I
SCENE VNZIESME.	SCÈNE VNZIESME.
CLEANDRE, SALMACIS, LA NOVRRICE,	CLEANDRE, SALMACIS, LA NOURRICE,
Adame, auec mon bras, le celeſte ſecours, NID'vn nombre d’aſſaßins a deliuré mes iours;	Adame, avec mon bras, le céleste secours, NID'un nombre d'assassins a délivré mes jours;
Sur vn appel ſecret dont i’ignorois la cauſe Ie cherchois Doriſmond, lors que la nuict s’eſt cloſe, Quand trois hommes armés pour leur commun malheur, Au deſſein de ma mort ont rencontré la leur;	Sur un appel secret dont j'ignorais la cause Je cherchais Dorismond, lors que la nuit s'est close, Quand trois hommes armés pour leur commun malheur, Au dessein de ma mort ont rencontré la leur;
Celle de Doriſmond a ſuiuy leurueguitir, Et la confeßion qu’en mourant il m'a faicte, M’apprend, que le ſuiet de ſon reſſentiment, Fut vn ialoux ſoupçon qu’il eut ſans fondement.	Celle de Dorismond a suivi leurueguitir, Et la confession qu'en mourant il m'a faite, M'apprend, que le sujet de son ressentiment, Fut un jaloux soupçon qu'il eut sans fondement.
LA REYNE.	LA REINE.
O ſigne trop certain de leur intelligence!	Ô signe trop certain de leur intelligence!
Heureuſe occaſion qui s’offre à ma vengeance!	Heureuse occasion qui s'offre à ma vengeance!
Quoy, pour prouuer ſa flame, & croiſtre nos trauaux, Il ſigne ſon amour du ſang de ſes riuaux, Et pour paroiſtre adroict, & couurir ſon offence, Il feint des attentats contre ſon innocence?	Quoi, pour prouver sa flamme, et croître nos travaux, Il signe son amour du sang de ses rivaux, Et pour paraître adroit, et couvrir son offense, Il feint des attentats contre son innocence?
C’eſt trop deliberer, le public intereſt Oblige la luſtice à preſſer ſon Arreſt;	C'est trop délibérer, le public intérêt Oblige la lustice à presser son Arrêt;
Sus qu'en vne priſon, les bras chargés de chaiſnes, Il s’aille preparer à ſes futures peines, Et ſi toſt que le Ciel r’amenera le iour, Q'on ſatis faſſe aux Lois de iuſtice, & d'amour.	Sus qu'en une prison, les bras chargés de chaînes, Il s'aille préparer à ses futures peines, Et si tôt que le Ciel ramènera le jour, QU'on satî fasse aux Lois de justice, et d'amour.
RCTE SCENE PREMIERE.	RCTE SCÈNE PREMIÈRE.
CLLANIES RCOTDEIIRE, ALCANDRE, ACHANTHE, LYSANOR,	CLANIES RCOTDEIRE, ALCANDRE, ACHANTHE, LYSANOR,
CLEANTES.	CLÉANTES.
Algré les mouuemens d’vne iuste colere, Qui destinoit Cleandre aux manes de mon pere, Puis qu’vn heureux deſtin te conſerue le iour, Que l’onde a reueré ta vie, & ton amour, Ie reſpecte comme elle vne amitié ſi rare, Que n’oſa deſ-vnir cet Element barbare, Ie ne m’oppoſe plus au cours de tes plaiſirs, Et me laiſſe toucher à tes moindres ſouſpirs;	Algré les mouvements d'une juste colère, Qui destinait Cléandre aux mânes de mon père, Puis qu'un heureux destin te conserve le jour, Que l'onde a révéré ta vie, et ton amour, Je respecte comme elle une amitié si rare, Que n'osa des-unir cet Élément barbare, Je ne m'oppose plus au cours de tes plaisirs, Et me laisse toucher à tes moindres souspirs;
Ta preſence, ma ſœur, a vaincu mes armees, .	Ta présence, ma sœur, a vaincu mes armées, .
V- -- - – -- Elle a lié mes mains iuſtement animees, Aux charmes de la Reyne acquis vn ſeruiteur, Et de ſon ennemy faict ſon adorateur, Mais ſans trop exalter les traicts de ſon viſage, Sans faire d’vne femme vne immortelle image, Sans peindre le Soleil esblouy de ſes yeux Sans luy dreſſer vn temple, & l'égaler aux Dieux:	V-là -m- - les -même, Elle a lié mes mains justement animées, Aux charmes de la Reine acquis un serviteur, Et de son ennemi fait son adorateur, Mais sans trop exalter les traits de son visage, Sans faire d'une femme une immortelle image, Sans peindre le Soleil ébloui de ses yeux Sans était dresser un temple, et l'égaler aux Dieux:
Fay moy de ſa beaute la naifue peinture, Et ne fay point à l’art ſurpaſſer la nature.	Fais -moi de sa beauté la y peinture, Et ne fais point à l'art surpasser la nature.
LYSANOR.	LYSANOR.
I’ay trop peu dit encor & vos yeux ſeulement Uous peuuent figurer vn obiet ſi charmant;	J'ai trop peu dit encor et vos yeux seulement Uous peuvent figurer un objet si charmant;
Il ſu ffira (Monſieur) ſans vſer d’autre addreſſe, Qu'a ma confuſion moy-meſme ie confeſſe, Que mes yeux ayant veu ſa diuine beauté, N'ont iamais ſans horreur mon miroir conſulté.	Il su fira (Monsieur) sans user d'autre adresse, Qu'a ma confusion moi-même ie confesse, Que mes yeux ayant vu sa divine beauté, N'ont jamais sans horreur mon miroir consulté.
CLEANTES.	CLÉANTES.
Il ſuffit, & qu'elle ait, ou n’ait point de pareille, I’adore aueuglement cette rare merueille, Et ſi ſon cœur conſent au deſſein que ie faicts, Vn hymen entre nous retablira la paix, Qu'elle apprenne de toy combien ie la reuere, Sois de ma paßion fidelle meſſagere, Et pour comble des biens, que ie puis receuoir, S’il ſe peut, obtiens moy le bon-heur de la voir;	Il suffit, et qu'elle ait, ou n'ait point de pareille, J'adore aveuglement cette rare merveille, Et si son cœur consent au dessein que vois faits, Venn hymen entre nous rétablira la paix, Qu'elle apprenne de toi combien ce la ruère, Sois de ma passion fidèle message, Et pour comble des biens, que ie sans recevoir, S'il se peut, obtiens moi le bonheur de la voir;
Qu'aux portes ſeulement ſa Maieſté conduite M'accorde cet honneur auec égale ſuite, Qu'Alcandre t’accompagne en l'exequution, De ces ſoings que tu prends, pour mon affection.	Qu'aux portes seulement sa Majesté conduite M'accorde cet honneur avec égale suite, Qu'Alcandre t'accompagne en l'exéquution, De ces soins que tu prends, pour mon affection.
Si mon eſpoir n’eſt vain, cette heureuſe iournee Bornera nos ennuys par vn double hymenee, Vos armes cederont à ſes moindres regards, Et de ce beau ſeiour l’amour chaſſera Mars.	Si mon espoir n'est vain, cette heureuse journe Bornera nos ennuis par un double hyménée, Vos armes céderont à ses moindres regards, Et de ce beau séjour l'amour chassera Mars.
SCENE DEVXIESMELE CAPITAINE DES GARDES, LES ARCHERS, LE BOVRREAV, CLEANDRE, CEPHALIE lié.	SCÈNE DEUIESMELE CAPITAINE DES GARDES, LES ARCHERS, LE BOURREAU, CLÉANDRE, CÉPHALIE lié.
à l'eſchaſfaut.	à l'eschasfaut.
CEPHALIE.	CÉPHALIE.
Iniſtres criminels d'vne homicide rage, N TCruels, meſlés mon ſang à ce triste carnage;	Inistres criminels d'une homicide rage, N CHruels, mêlés mon sang à ce triste carnage;
Ce ſpectacle odieux, ce tragique malheur, Eſt donc l’infame prix qu’on rend à la valeur?	Ce spectacle odieux, ce tragique malheur, Est donc l'infâme prix qu'on rend à la valeur?
Qisceirt ſau nontcuje a fa vitvire eſ deues:	Quisceirt sau nontcuje a fa vitvire ès deues:
l perd ſa vie helas!	l perd sa vie hélas!
pour l’auoir deffenduë?	pour l'avoir défendue?
La vertu parmy vous a des punitions?	La vertu parmi vous a des punitions?
Et la mort eſt le prix des belles actions?	Et la mort est le prix des belles actions?
LE CAPITAINE DES GARDES, La volonté des Rois par l'effect ſeul s’explique, On ſuit leur paßion, ou iuſte, ou tyrannique, Et touſiours un ſuiet ſe porte iuſtement A l’execution de leur commandement.	LE CAPITAINE DES GARDES, La volonté des Rois par l'effect seul s'explique, On suit leur passion, ou juste, ou tyrannique, Et toujours un sujet se porte justement A l'exécution de leur commandement.
CEPHALIE.	CÉPHALIE.
La Reyne ſuit l’aduis d’vne fureur extréme.	La Reine suit l'avis d'une fureur extrême.
Elle ſe faict ſeruir contre ſon repos meſme, La croire, est l’offenſer, luy plaire eſt la trahir Et ſon bon-heur dépend de luy deſobeyr.	Elle se fait servir contre son repos Seigneur, La croire, est l'offenser, Se plaire est la trahir Et son bonheur dépend de Seigneur désobéir.
CLEANDRE.	CLÉANDRE.
Puiſque pour me ſauuer toute raiſon eſt vaine Ne vous conſommís point d’vne inutile peine;	Puisque pour me sauver toute raison est vaine Ne vous consommís point d'une inutile peine;
Deux ennemys ſans yeux la fureur, & l’amour, Ont prononcé l’arreſt qui me priue du iour.	Deux ennemis sans yeux la fureur, et l'amour, Ont prononcé l'arrêt qui me prive du jour.
CEPHALIE.	CÉPHALIE.
Cruels, laiſſés calmer ſon aueugle colere, Accordés ſeulement vne heure à ma priere, Vne heure l’oſtera de ſon aueuglement, Et luy fera benir vostre retardement, Sauuant cet innoiem, conuejouerfances De ſa Maieſté meſme auront des recompenſes, Et rien à ſa fureur ne vous pourra cacher Si vous luy rauiſſés ce qu’elle a de plus cher.	Cruels, laissez calmer son aveugle colère, Accordez seulement heure à ma prière, heure ôtera de son aueuglement, Et lui fera bénir vôtre retardement, Sauuant cet innoiem, conuejouerfances De sa Maiesté même auront des recompenses, Et rien sa fureur ne vous pourra cacher Si vous lui rauissés ce elle a de plus cher.
LE CAP.	LE CAP.
DES GARDES.	DES GARDES.
Ma charge est d’obeyr, & ie ne puis ſans crime Differer cette mort, iniuſte, ou legitime, Nommer cette action, ſupplice, ou cruauté, Paſſe ma cognoiſſance & mon authorité.	Ma charge est d'obéir, et ainsi ne puis sans crime Différer cette mort, injuste, ou légitime, Nommer cette action, supplice, ou cruauté, Passe ma connaissance et mon autorité.
CEPHALIE.	CÉPHALIE.
L'âche, & honteux effort, que ſouffre l’innocence, Tyrannique deuoir, barbare obeyſſance, Quel Demon furieux preſide en cette Cour, Où de honteuſes morts ſont des effects d’amour, Et qu’eſt-ce que la Reyne en ſa hayne effectuë, Puis qu’aymant elle outrage, & que ſon amour tuë, L’onde l’a reueré, ce barbare Element Refuſa par reſpect d’eſtre ſon monument, Jl eſt de tous les cœurs l’eſpoir, & les delices Et dedans l’amour meſme il trouue des ſupplices:	L'âche, et honteux effort, que souffre l'innocence, Tyrannique devoir, barbare obéissance, Quel Démon furieux préside en cette Cour, Où de honteuses morts sont des effets d'amour, Et qu'est-ce que la Reine en sa haine effetue, Puis qu'aimant elle outrage, et que son amour tuë, L'onde l'a révéré, ce barbare Élément Refusa par respect d'être son amour, Jl est de tous me cœurs J'espoir, et les délices Et dedans l'amour même il trouve des supplices:
Pour ſon bon-heur helas!	Pour son bonheur hélas!
& pour noſtre repos, Que ne fui-il en proye à la ſureur des ſlots, Quelle fut la pitié qui luy rendit la vie, Puis qu’on ordonne apres qu’elle luy ſoit rauie.	et pour notre repos, Que ne fui-il en proie à la sûreur des slots, Quelle fut la pitié qui lui rendit la vie, Puis qu'on ordonne après qu'elle lui soit ravie.
a tiLE CAP.	a tiLE CAP.
DES GARDES, aac Madame permettés,	DES GARDES, aac Madame permettés,
CEPHALIE.	CÉPHALIE.
Donc mes pleurs, inhumains, Ne peuuent l’arracher à vos barbares mains, Bourreaux adioustés donc ma mort à ſon ſupplice, Sauués vn innocent ou qu’vne autre periſſe, Ne me refuſés point la faueur que ie veux, Frappés, & qu’vn ſeul coup en faſſe tomber deux;	Donc mes pleurs, inhumains, Ne peuvent l'arracher à vos barbares mains, Bourreaux ajoutés donc ma mort à son supplice, Sauvez un innocent ou qu'une autre périsse, Ne me refusés point la faveur que je veux, Frappés, et qu'un seul coup en fasse tomber deux;
Frappés, puis qu’à la mort mon amour ſeul l'expoſe, Et pour punir l’effect commencés par la cauſe, L.	Frappez, puis qu'à la mort mon amour seul l'expose, Et pour punir l'effet commencès par la cause, L.
ij Que deliberès vous;	ij Que deliberès vous;
non, non, tous vos efforts, veucti- Pretendent vainement de ſeparer nos corps, Si cette infame main n’en ſepare nos teſtes:	non, non, tous vos efforts, veucti- Prétendent vainement de séparer nos corps, Si cette infâme main n'en sépare nos têtes:
Cruel porte les coups les voila toutes prestes.	Cruel porte les coups les voilà toutes prêtes.
LEANDRE.	LÉANDRE.
Que ne puis-ie eſperer vne ſeconde mort Dont on recompenſaſt ce pitoyable effort, Par ces pieux tranſports vous obligés vn traistre, Et le plus criminel que le Ciel ait faict naiſtre, N’exigés point Madame vne confeßion Qui m’oſteroit l’honneur de vostre affiction, Et ſouffrés qu’en mourant ie conſerue la gloire, D'eſtre en vne ſi digne & ſi helle memoire.	Que ne puis-je espérer une seconde mort Dont on récompensât ce pitoyable effort, Par ces pieux transports vous obligez un traître, Et le plus criminel que le Ciel ait fait naître, N'exigez point Madame une confession Qui m'ôterait l'honneur de votre affiction, Et souffrez qu'en mourant ici conserve la gloire, D'être en une si digne et si helle mémoire.
SCENE TROISIESME, apportant vn billet de IV TAGE, la part de la Reyne.	SCÈNE -TROISIÈME, apportant un billet de IV TAGE, la part de la Reine.
A Maieſté m’enuoye auec commandement SDe monſtrer ce bil et au Prince ſeulement, Et quand i' l’aura leu, s’il demande la vie, ’ay charge d’empeſcher qu’elle luy ſoit raute,	À Majesté m'envoie avec commandement SDe montrer ce bil et au Prince seulement, Et quand j' aura lu, s'il demande la vie, aay charge d'empêcher qu'elle a soit raute,
CEPHALIE, Cleandre, à mes deſpens, contente ſon eſpoir, Et me conſerue au moins le bon-heur de te voir, Si tu n’es point ſenſible à ſon amour extréme Et ſi mes pleurs ſont vaïns ſois ſenſible à toy-meſme, Laiſſe toucher ton cœur d’vn deſir mutuel Et qu’il luy ſoit plus doux pour t’eſtre moins cruel.	CEPHALIE, Cléandre, à mes dépens, contente son espoir, Et me conserve au moins le bonheur de te voir, Si tu n'es point sensible à son amour extrême Et si mes pleurs sont vaïns sois sensible à toi-même, Laisse toucher ton cœur d'un désir mutuel Et qu'il lui soit plus doux pour t'être moins cruel.
ayaut leu, & deſchirant le LEANDRE, billet ditaubourreaa.	aiaut leu, et déchirant le LÉANDRE, billet ditaubourrea.
Accomply le deſſein que ta charge t’ordonne, Amour, plaintes, ſouſpirs, rang, dignités, Couronne, Et tout le monde enſemble aſſeruy ſous ma loy D'vn inutile effort attaqueroit ma foy, Madame, épargnés donc cette vaine deffence, Laiſſés de cet aſſaut triompher ma constance, Puis qu'il faut aſſouuir ſon aueugle courroux Et que viuant, ny mort, ie ne puis eſtre à vous.	Accompli le dessein que ta charge t'ordonne, Amour, plaintes, soupirs, rang, dignités, Couronne, Et tout le monde ensemble asservi sous ma loi D'un inutile effort attaquerait ma foi, Madame, épargnez donc cette vaine défense, Laissez de cet assaut triompher ma constance, Puis qu'il faut assouvir son aveugle courroux Et que vivant, ni mort, je ne puis être à vous.
L iij	 Lijà
L ARCHER.	 ARCHER.
O ſenſible putté;	Ô sensible puté;
CEPHALIE.	CÉPHALIE.
Barbare, quelles larmes Quelles affections, quelles plaintes, quels charmes, Obtiendroient quelque effect & te pourroient toucher Si ton propre ſalut meſme ne t'eſt pas cher, Et bien, fay contenter ton homicide enuie, Preſſe vne infame main contre ta propre vie, Tu receuras de ceux qui t’auroient regretté Deo mniur mureo puuues comte iu eruaute, Quelques rudes aſſauts que le mal-heur nous liure Qui deſire ſa mort eſt indigne de viure.	Barbare, quelles larmes Quelles affections, quelles plaintes, quels charmes, Obtiendraient quelque effet et te pourraient toucher Si ton propre salutîle ne t'est pas cher, Et bien, fais contenter ton homicide envie, Presse une infâme main contre ta propre vie, Tu recevras de ceux qui t'auraient regretté De mniur mureo puves compte ju ervaute, Quelques rudes assauts que le malheur nous livre Qui désire sa mort est indigne de vivre.
ſe tourCLEANDRE, nant Sus que tarde l'effect de cet iniuste arrest?	se tourCLEANDRE, nant Sus que tarde l'effet de cet injuste arrêt?
LE CAP.	LE CAP.
DES GARDES.	DES GARDES.
Voicy la Reyne, ô Dieux!	Voici la Reine, ô Dieux!
en quel état elle eſti	en quel état elle éti
SCENE ( SALMACIS, LA NOVRRICE, CLEANDRE, &c.	SCÈNE ( SALMACIS, LA NOURRICE, CLEANDRE, etc.
courant SALMACIS, farieuſe Rreſtés inhumains;	courant SALMACIS, farieuse Rrestés inhumains;
donc il n'eſt pas poßible, A ADe ſauuer vn barbare à ſoy-meſme inſenſible;	donc il n'est pas pouvible, A DE sauver un barbare à soi-même insensible;
Vn ingrat, qui n’eſt pas à ſes iours indulgent, Et qu’vn iuſte ſupplice oblige, en me vengeant, Donc, il ne ſuffit pas de tant de tyrannie, De mon repos troublé de ma raiſon bannie, Et tu m’aurois viuant cauſe peu de ſoucy Si ta mort, inhumain, ne m'en cauſoit außi;	Un ingrat, qui n'est pas à ses jours indulgent, Et qu'un juste supplice oblige, en me vengeant, Donc, il ne suffit pas de tant de tyrannie, De mon repos troublé de ma raison bannie, Et tu m'aurais vivant cause peu de souci Si ta mort, inhumain, ne m'en causait aussi;
Tu ſouffres ſans regret quand tu me deſoblige, Il t’eſt doux de mourir, parce que tu m'affliges, Ton ſupplice te plaiſt d’autant que ie le crains, Et tu meurs ſatisfaict pource que ie te plains:	Tu souffres sans regret quand tu me desoblige, Il t'est doux de mourir, parce que tu m'affliges, Ton supplice te plaît d'autant que ie un crains, Et tu meurs satisfait pource que sans te plains:
Quel tygre ſi cruel, quel monſtre ſi barbare Payeroit de ce prix vne amitié ſi rare, Et quel malheur me peint ſi difforme a tes yeux, Qu'en cette election la mort te plaiſe mieux?	Quel tigré si cruel, quel monstre si barbare Payerait de ce prix ton amitié si rare, Et quel malheur me peint si difforme à tes yeux, Qu'en cette élection la mort te plaise mieux?
CLEANDRE.	CLÉANDRE.
Ie ſçay trop de quel prix ſont vos aymables charmes, Et combien il eſt doux de leur rendre les armes, Ie ſçay combien de Rois enuieroient mon bon-heur Mais la loy de mon ſort m’ordonne cet honneur.	Je sais trop de quel prix sont vos aimables charmes, Et combien il est doux de leur rendre les armes, Je sais combien de Rois envieraient mon bonheur Mais la loi de mon sort m'ordonne cet honneur.
SALMACIS.	SALMACIS.
Eſt-ce que dans l’éclat ton courage s’eſtonne?	Est-ce que dans l'éclat ton courage s'étonne?
Crains tu de ſuccomber au fais d’vne Couronne?	Crains tu de succomber au fais d'une Couronne?
Pour tes timides pas vn troſne eſt il trop haut?	Pour tes timides pas un trône est il trop haut?
Et t’y plairois tu moins que ſur vn échaffaut?	Et t'y plairais -tu moins que sur un échaffaut?
La qualité de Roy peut-eſtre t’importune, Et tu crains les grands ſoings d’vne grande fortune, Et bien, pour eſtre tienne & pour ſuiure tes pas, Faut-il fouler aux pieds ce qui ne te plaiſt pas?	La qualité de Roi peut-être t'importune, Et tu crains les grands soins d'une grande fortune, Et bien, pour être tienne et pour suivre tes pas, Faut-il fouler aux pieds ce qui ne te plaît pas?
Faut-il ſacrifier à cet amour extréme Titres, poſſeßions, & ſceptre, & Diadeſme;	Faut-il sacrifier à cet amour extrême Titres, possesions, et sceptre, et Diadesme;
Banniray-ie pour toy, reſpect, honte, & deuoir?	Bannirai-je pour toi, respect, honte, et devoir?
Et faut il ſeulement perdre tout, pour t’auoir!	Et faut -il seulement perdre tout, pour t'avoir!
fe ſuis preſte a te ſuture en quelque ſolitude, Où t’on ſuperbe cœur ſouffre ma ſeruitude, Ou i’oſe dire enfin, on a receu ma foy J’appartiens à Cleandre, & Cleandre eſt à moy.	se suis prête a te suture en quelque solitude, Où t'on superbe cœur souffre ma servitude, Ou j'ose dire enfin, on a reçu ma foi J'appartiens à Clandre, et Cléandre est à moi.
CLEANDRE.	CLÉANDRE.
Pour prix de vos trauaux ordonnés grande Reyne, Qu'on rende mille fois ma mort plus inhumaine, Faictes Faictes qu’on ioigne au fer, la flame, & le poiſon, Et que ie ſouffre tout pour voſtre gueriſon, Car, pour me faire aymer autre obiet que Floronde, Vous employriés en vain l’effort de tout le monde, Les yeux de Cephalie ont des charmes ſi doux Qu'on est trop glorieux de mourir de leurs coups, I’ay trahy toutefois cette ieune merueille Luy voüant vne ardeur a la ſienne pareille, Ie faiſois de ſa peine vn diuertiſſement, Et voſtre ialouſie estoit ſans fondement, Donc, que differés vous de punir ce coupable?	Pour prix de vos travaux ordonnez grande Reine, Qu'on rende mille fois ma mort plus inhumaine, Faites Faictes qu'on joigne au fer, la flamme, et le poison, Et que sans souffre tout pour votre guérison, Car, pour me faire aimer autre objet que Floronde, Vous employriez en vain l'effort de tout le monde, Les yeux de Céphalie ont des charmes si doux Qu'on est trop glorieux de mourir de leurs coups, J'ai trahi toutefois cette jeune merveille Luy venant une ardeur a la sienne pareille, Je faisais de sa peine divertissement, Que si jalousie était sans fondement, Donc, que differés vous de punir ce coupable?
Qi fouſſre vne mon porrible, epouuentable, Et quand auec mes iours mes maux ſeront paſſés Qu'on die, il ayma trop, & n’ayma pas aſſés;	Qi foussre une mon porrible, épouventable, Et quand avec mes jours mes maux seront passés Qu'on die, il aima trop, et n'aima pas assez;
SALMACIS.	SALMACIS.
I'ay veu cruel, i’ay veu, quel ſoucy te tourmente?	J'ai vu cruel, j'ai vu, quel souci te tourmente?
Pourquoy déguiſes tu cette ardeur violente?	Pourquoi déguises -tu cette ardeur violente?
Pour couurir tes amours pourquoy mal à propos Des morts meſmes vas tu trauerſer le repos?	Pour couvrir tes amours pourquoi mal à propos Des morts mêmes vas tu traverser le repos?
Floronde fut l’obiect de ta melancholie, Mais tes ſoucys enfin naiſſent de Cephalie, A l’impudique ardeur qui cauſe von reuiment, Un lict est en obiet bien plus qu’vn monument, Si le Ciel à Floronde euſt conſerué la vie, I’aurois imprudemment trauerſe ton enuie, Tes ſouſpirs eſtoient deus à ſa fidelité,	Floronde fut l'objet de ta mélancolie, Mais tes soucis enfin naissent de Céphalie, A l'impudique ardeur qui cause von revient, Un lit est en objet bien plus qu'un monument, Si le Ciel à Floronde eût conservé la vie, J'aurois imprudemment traverse ton envie, Tes soupirs étaient dus à sa fidélité,
M Auant que d’estre grand mon feu fuſt auorté:	M Avant que d'être grand mon feu fût avorté:
Mais Floronde n’eſt plus:	Mais Floronde n'est plus:
& pour vne effrontee gardant Qui ne peut rien pour toy ma flame eſt reiettee, Songe helas!	et pour une effronté gardant Qui ne peut rien pour toi ma flamme est rejet, Songe hélas!
quelle erreur aueugle tes eſprits, Songe quel eſt l’obiet de tes lâches meſpris:	quelle erreur aveugle tes esprits, Songe quel est l'objet de tes lâches mépris:
Et ſi ie dois encor eſperer quelque place En ce cœur, qui pour moy n’est que marbre, & que glace, S’il peut eſtre ſenſible aux maux que i’ay ſoufferts Viens eſſuyer mes pleurs et qu’on briſe tes fers, Pour empeſcher ta mort fay ceſſer mon ſupplice, F'ar la Tadilce iuejme, culte la paibiee, Pour ne te perdre pas, Cleandre, ſauue moy, Fay viure, & tu viuras, fay grace, & la reçoy.	Et si ici dois encor espérer quelque place En ce cœur, qui pour moi n'est que marbre, et que glace, S'il peut être sensible aux maux que j'ai soufferts Viens essuyer mes pleurs et qu'on brise tes fers, Pour empêcher ta mort fais cesser mon supplice, S'ar la Tadilce iuejme, culte la paibie, Pour ne te perdre pas, Cleandre, sauue moi, Fais vivre, et tu vivras, fais grâce, et la reçoy,
CLEANDRE.	CLÉANDRE.
Enfin c’eſt trop cacher à l’ardeur qui vous preſſe, nnt feertt tmportunt ſpa ti faut que it tonfeſſe, Que voſtre Maieste m’accorde ſeulement Qu’en ce lieu Lyſanor reuiendra ſeurement, Mais Dieux!	Enfin c'est trop cacher à l'ardeur qui vous presse, naît feertt tombortunt spa ty faut que it tonfesse, Que votre Majest trop cade seulement Qu'en ce lieu Lysanor reviendra sûrement, Mais Dieux!
a quel effort ma crainte ſe diſpenſe?	à quel effort ma crainte se dispense?
SALMACIS.	SALMACIS.
Je te donne ſa vie, apprens moy ſon offence, Que ie ſouffre ſa peine, & periſſe, au moment Que i’auray de ſa faute aucun reſſentiment.	Je te donne sa vie, apprends moi son offense, Que tu souffre sa peine, et périsse, au moment Que j'aurai de sa faute aucun ressentiment.
CLEANDRE.	CLÉANDRE.
C’eſt trop deliberer:	C'est trop délibérer:
Lyſanor eſt Floronde	Lysanor est Floronde
Le Ciel en me ſauuant la retira de l’onde, Il ſçait bien que perdant cette chaſte beauté, En me rendant le iour, ce bras me l’euſt oſté, L’onde, malgré vos vœux eut du reſpect pour elle Et de ſa mort ſa voix m'annonça la nouuelle, Pour d’expreſſes raiſons, cet obiet plein d’appas, A voſtre Maieſté ne ſe declara pas, Elle apprit voſtre amour & redouta ſon pere, Qui pouuoit me priuer de ce bien, que i’eſpere, Elle eſt allee, enfin, trouuer ſon ſucceſſeur, Non pas en qualité de heraut, mais de ſœur, Et lors que i'eſperois ſon retour, & ma grace Et que le Roy rendiſt la paix à cette place, I'eus auec Doriſmond ce fatal differend, Pour vn ialoux ſoupçon qu’il m’apprit en mourant:	Le Ciel en me sauvant la retira de l'onde, Il sçait bien que perdant cette chaste beauté, En me rendant le jour, ce bras me l'eût ôté, L'onde, malgré vos vœux eut du respect pour elle Et de sa mort sa mort sa annonça la nouvelle, Pour d'expresses raisons, cet objet plein d'appas, À votre Majesté ne se déclara pas, Elle apprit vôtre amour et redouta son père, Qui pouvait me priver de ce bien, que j'espère, Elle est allé, enfin, trouver son successeur, Non pas en qualité de haut, mais de sœur, Et mais de esperois son retour, et ma grâce Et que la g rendît la paix ce place, eus auec Dorismond ce et différend, Pour ialoux soupçon il ma en mourant:
Floronde m’eſtant chere a l’égal de moy-meſme, Je ne l’ay point nommee en ce danger extréme, Uoyant tant de fureur, auecques tant d’amour, I'ay craint, que mon malheur ne luy couſtaſt le iour.	Floronde m'étant chère a l'égal de moi-même, Je ne l'ai point née en ce danger extrême, Uoyant tant de fureur, avec tant d'amour, J'ai craint, que mon malheur ne lui coût le jour.
SCENE CINQVIESME.	SCÈNE CINQUIÈME.
LYSANON, ET ALCANDRE, viennent.	LYSANON, ET ALCANDRE, viennent.
LYSANOR.	LYSANOR.
Uel tragique ſpectacle à mes yeux ſe preſente?	Vel tragique spectacle à mes yeux se présente?
EO ſiniſtre frayeur!	EO sinistre frayeur!
ô ſenſible épouuant.	ô sensible épouuant.
Dieux!	Dieux!
qu’est-ce que ie voy quels forfaicts inhumains, Liure cet innocent à vos barbares mains?	qu'est-ce que ici vois quels forfaits inhumains, Livre cet innocent à vos barbares mains?
Cleandre, quelle offenſe ou quelle aueugle rage Quand tout rit à nos vœux t’expoſe à cet outrage?	Clandre, quelle offense ou quelle aveugle rage Quand tout rit à nos vœux t'expose à cet outrage?
Madame, pardonnés à mes iustes tranſports, Et faictes qu’vn ſeul coup faſſe tomber deux corps.	Madame, pardonnez à mes justes transports, Et faites qu'un seul coup fasse tomber deux corps.
SALMACIS, Ie le dois pour vuime aux manes de Floronde Par luy cette Princeſſe eſt le butin de l’onde, Et cette belle fille eut de ſi doux appas, Qu'on péche autant que luy de ne la vanger pas.	SALMACIS, Je le dois pour venme aux mânes de Floronde Par lui cette Princesse est le butin de l'onde, Et cette belle fille eut de si doux appas, Qu'on pèche autant que tu de ne la venger pas.
LYSANOR.	LYSANOR.
Floronde voit le iour, & ie ſuis, grande Reyne, Ce malheureux obiet qui fis naistre ſa peine, Je ne demande point vn ſi ſanglant arreſt, Je veux cette victime au meſme état, qu’elle eſt, Ie ſuis, ie ſuis Pioronde,	Floronde voit le jour, et je suis, grande Reine, Ce malheureux objet qui fis naître sa peine, Je ne demande point un si sanglant arrêt, Je veux cette victime au même état, qu'elle est, Je suis, je suis Piorde,
SALMACIS.	SALMACIS.
Amoureuſe manie, Fureurs, aueuglement, contrainte, tyrannie, Cedes aux mouuements d’vne iuſte pitié Et ne trauerſes plus leur fidelle amitié;	Amoureuse manie, Fureurs, aveuglement, contrainte, tyrannie, Cédes aux mouvements d'une juste pitié Et ne traverses plus leur fidèle amitié;
C’eſt trop, parfaicts amants, faire durer vos peines, vue ius C’eſt trop vous affliger;	C'est trop, parfaits amants, faire durer vos peines, vue jus C'est trop vous affliger;
rompons, briſons ces chait nes, Triomphe du danger où tu t’es expoſé Par vn aueug ement que tu nous as cauſé, Gouſtes, belle Floronde, vn ſiecle de delices Que vos bras, ſoient ſes fers, vos baiſers ſes ſupplices, Et qu’en tous les endroicts qu’illumine le iour, On faſſe le recit d’vne ſi belle amour.	rompons, brisons ces chait nés, Triomphe du danger où tu t'es exposé Par un aveug ement que tu nous as causé, Gouttes, belle Floronde, Un siècle dé lices Que vos bras, soient ses fers, vos baisers ses supplices, Et qu'en tous les endroits qu'illumine le jour, On fasse le récit d'une si belle amour.
DEEAICDRE Que vostre Maieſté d’vn eſclaue diſpoſe Et pardonne aux effects d’vne ſi belle cauſe, Et vous, dont i’ay trahy le repos, & les vœux.	DEAICDRE Que votre Majesté d'un esclave dispose Et pardonne aux effets d'une si belle cause, Et vous, dont j'ai trahi le repos, et les vœux.
CEPHALIE.	CÉPHALIE.
C’eſt trop;	C'est trop;
puiſque tu vis, i’obtiens ce que ie veux;	puisque tu vis, j'obtiens ce que tu veux;
Que le Ciel pour iamais ioigne vos deſtinees, Et faſſe vn ſiecle entier de vos ieunes annees.	Que le Ciel pour jamais joigne vos destinées, Et fasse un siècle entier de vos jeunes années.
LYSANOR, à la Reyne.	LYSANOR, à la Reine.
Pour prix de tant de biens, i'apporte icy la paix, M.	Pour prix de tant de biens, j'apporte ici la paix, M.
iij Que les armes du Roy ne troubleront iamais, Par cet Ambaſſadeur, apprenés, grande Reyne, Quel miracle d’amour eſt autheur de ſa peine, Et s’il peut eſperer cet obiet amoureux Par ſa poſſeßion faictes vn Prince heureux.	ij à les armes du Roi ne troubleront jamais, Par cet Ambassadeur, apprenez, grande Reine, Quel miracle d'amour est auteur de sa peine, Et s'il peut espérer cet objet amoureux Par sa possession faites un Prince heureux.
ALCANDRE.	ÀLCANDRE.
D'vn inuiſible traict l’amour touche ſon ame, Des charmes incogneus ſont autheurs de ſa flame.	D'un invisible trait l'amour touche son âme, Des charmes inconnus sont auteurs de sa flamme.
Le bruit de vos vertus, & de voſtre beauté, Le rend adorateur de vostre Maieſté;	Le bruit de vos vertus, et de votre beauté, Le rend adorateur de votre Majesté;
e diſcours est ma charge, & ſon deſir extréme, Efuourenu le vuen de com paneriuy-meſme, Il m’a chargé ſur tout d’implorer ce bon-heur, Et proche de la ville il en attend l’honneur.	E discours est ma charge, et son désir extrême, Efuourenu le vuen de com panerivi-même, Il m'a chargé sur tout d'implorer ce bonheur, Et proche de la ville il en attend l'honneur.
SALMACIS.	SALMACIS.
C’eſt trop nous honnorer, tumoui ue de Monarque Eſt au peu que ie vaux, vne trop digne marque Je conſents toutefois au bon-heur de le voir Et de ce meſme pas ie le vais receuoir.	C'est trop nous honorer, tumoui ue de Monarque Est au peu que ie vaux, une trop digne marque Je consents toutefois au bonheur de le voir Et de ce même pas ici le vais recevoir.
CEPHALIE, ſeule.	CÉPHALIE, seule.
Enfin, vn heureux changement Faict d'vn long, & commun tourment, Une longue & commune ioye Le Ciel à ces amants a conſerué le iour, Et quelque aſſaut qu’il leur enuoye Rien ne mourra que mon amour.	Enfin, un heureux changement Fait d'un longue, et commun tourment, Une longue et commune joie Le Ciel à ces amants à conservé le jour, Et quelque assaut qu'il leur envoie Rien ne mourra que mon amour.
*4 4 Les armes dont ie l’ay dompté Sont celles, qui me l’ont oſte;	*4 4 Les armes dont ) l'ai dompté Sont celles, qui me l'ont ôte;
Quel eſt le fruict de ſes promeſſes?	Quel est le fruit de ses promesses?
Que qui veut m’obliger, proffite en me ſeruant Le confident à les careſſes, Et l'amante n'a que du vent.	Que qui veut m'obliger, proffite en me servant Le confident à les caresses, Et l'amante n'a que du vent.
Par les prieres, & par l’or Dont ie m’engageois Lyſanor, Ie ne pouuois trahir Floronde, Elle voyoit le iour, et le meſme accident Qui l’auroit faict perir dans l’onde, Euſt faict perir mon confident.	Par les prières, et par l'or Dont ie m'engageais Lysanor, Je ne pouvais trahir Floronde, Elle voyait le jour, et le même accident Qui l'aurait fait périr dans l'onde, Eut fait périr mon confident.
SCENE DERNIERE.	SCÈNE DERNIÈRE.
CLEANTES, Roy d’Epire, ACHANTHE, chef de guerre, SALMACIS, ALCANDRE, CLEANDRE.	CLEANTES, Roi d'Epire, ACHANTHE, chef de guerre, SALMACIS, ALCANDRE, CLEANDRE.
FLORONDE, LA NOVRRICE, LE CAP.	FLORONDE, LA NOURRICE, LE CAP.
DES GARDES.	DES GARDES.
LES ARCHERS, & des doipettes, les trompet- tes ayans ſonné de coſté, & d’autre.	LES ARCHERS, et des doipettes, les trompet- tes ayant sonné de côté, et d'autre.
CLEANTES, aborde la Reyne, & dit.	CLÉANTES, aborde la Reine, et dit.
Onfus, charmé, rauy, ſouffrés que mon ſilence De mon affection prouue la violence, Et que ces yeux vainqueurs eſpoir de mille Rois M’oſtant la liberté m’oſtent außi la voix:	Onfus, charmé, ravi, souffrés que mon silence De mon affection proue la violence, Et que ces yeux vainqueurs espoir de mille Rois M'ôtant la liberté m'ôtent auss la voix:
La paix chaſſe mes gens, & vos terres ſont calmes, Mais de vos ſeuls attraicts, elles tiennent leurs palmes, C u	La paix chasse mes gens, et vos terres sont calmes, Mais de vos seuls attraits, elles tiennent leurs palmes, Ç 
Eux Eux ſeuls nous ont vaincus, tout leur cede, & ces lieux N'ont point de force égale à celle de vos yeux.	Eux Eux seuls nous ont vaincus, tout leur cède, et ces lieux N'ont point de force égale à celle de vos yeux.
SALMACIS.	SALMACIS.
Vous reduiſés au poinct de n’oſer ſe deffendre, Et d’vne ſorte, ou d’autre, enfin il ſe faut rendre, A ma défaicte außi mon intereſt eſt ioinct, Et ma gloire dépend de ne repartir point, Mais quel eſt mon bon-heur, & quelle eſt ceste peine, Que vous prenés, Monſieur, pour vne indigne ReyMus.	Vous réduisez au point de n'oser se défendre, Et d'une sorte, ou d'autre, enfin il se faut rendre, À ma défaite aussi mon intérêt est joint, Et ma gloire dépend de ne repartir point, Mais quel est mon bonheur, et quelle est cette peine, Que vous prenezez, Monsieur, pour une indigne ReinMus.
Puis-ie trop eſtimer ce bien ineſperé?	Puis-je trop estimer ce bien inespéré?
Et trop benir le Ciel qui me l’a procuré?	Et trop bénir le Ciel qui me l'a procuré?
LEANTES.	LEANTES.
Je vous ſuis obligé du fauorable azyle, Que Cleandre, & ma ſœur ont eu dans cette vïlle, Vn proſpere ſuccés Couronne leurs amours Et ie conſents au nœud qui doit ioindre leurs iours:	Je vous suis obligé du favorable azyle, Que Clandre, et ma sœur ont eu dans cette ville, Un prospère succès Couronne leurs amours Et quelque consents au nœud qui doit joindre leurs jours:
Mais mon propre intereſt, plus que le leur m’ameine Implorer le ſuccés d’vne attente incertaine, Dieux!	Mais mon propre intérêt, plus que le leur m'amène Implorer le succès d'une attente incertaine, Dieux!
que iugerés vous de ma temerité?	que iugerés -vous de ma témérité?
I'oſe deſſous vos loix ranger ma liberté, Et ſouhaitter l'honneur d’vn heureux mariage, vn meſme ſort nos deux ſceptres engage.	J'ose dessous vos lois ranger ma liberté, Et souhaiter l'honneur d'un heureux mariage, un même sort nos deux sceptres engage.
A 4	A 4
SALMACIS.	SALMACIS.
Scachant vostre merite vn iugement bien ſain Ne doit point conſulter ſur vn ſi beau deſſein, I'accepte cet honneur, quoy que voſtre courage munuu prurenure s maonieur, on plus digne aduantage.	Scachant votre mérite un jugement bien sain Ne doit point consulter sur un si beau dessein, J'accepte cet honneur, quoi que votre courage munu prurenure s maonieur, on plus digne avantage.
CLEANTES.	CLÉANTES.
O fauorable iour ſur tous ceux de ma vie!	Ô favorable jour sur tous ceux de ma vie!
Que mon ſort eſt heureux!	Que mon sort est heureux!
FLORONDE, qui eſt Lyſanor.	FLORONDE, qui est Lysanor.
Que mon ame eſt rauie,	Que mon âme est ravie,
CLEANIES.	CLÉANIES.
Combien ie dois de vœux à l’amour de ma ſœur, Et que ie dois enfin, cherir ſon rauiſſeur!	Combien Prince dois de vœux à l'amour de ma sœur, Et que ie dois enfin, chérir son ravisseur!
CLEANDRE.	CLÉANDRE.
Quoy!	Quoi!
voſtre Maieſté me pardonne l’iniure.	votre Majesté me pardonne l'injure.
LLEANIEO.	LLEANIEO.
C’eſt trop, & ce bon-heur la paye auec vſure, Ie pardonne à l’amour, ce pecheur innocent Qui ſe punit aſſes luy meſme, en offençant.	C'est trop, et ce bonheur la paye avec usure, Je pardonne à l'amour, ce pécheur innocent Qui se punit assesil même, en offensant.
LE CAP.	LE CAP.
DES GARDES.	DES GARDES.
O diuin changement!	Ô divin changement!
LA NOVRRICE.	LA NOURRICE.
O fortune proſpere!	Ô fortune prospère!
SALMACIS.	SALMACIS.
Puis qu'vn bon-heur commun finit noſtre miſere, Venés prendre chés moy les titres abſolus ue le Ciel vous y donne & ne m'y laiſſe plus, Qu'vne eternelle paix faſſe tomber nos armes, Qu'on ne ſouſpire plus, qu’on banniſſe les larmes, Q Que de tous nos ennuys l’amour ſoit triomphant, Et que Mars ſoit vaincu par les mains d'vn enfant.	Puis qu'un bonheur commun finit notre misère, Venez prendre chez moi les titres absolus ue le Ciel vous y donne et ne m'y laisse plus, Qu' éternelle paix fasse tomber nos armes, Qu'on ne souspire plus, on bannisse les larmes, Que de tous nos ennuis amour soit triomphant, Et que Mars soit vaincu par les mains d' enfant.
IN.	IN.
