ICAL L.	ICAL L.
DE SAINIE RLINE.	DE SAINIE RLINE.
ACIE PREMIER.	ACIE PREMIER.
SOBSAREMIERE OLIBRE, CARAVSE, LVCILLE, PAGES, GARDES.	SOBSAREMIÈRE OLIBRE, CARAUSE, LUCILLE, PAGES, GARDES.
OLIBRE, NTRE tous les Heros je ſuis le magnanime, L L’effroi des étrangers, & des Gaules l’eſtime Le ſeul & ferme apui de l’Empire Romain, Qui peut donc reſiſter à ma puiſſante main?	ÔLIBRE, NTRE tous les Héros je suis le magnanime, L 'effroi des étrangers, et des Gaules l'estime Le seul et ferme appui de l'Empire Romain, Qui peut donc résister à ma puissante main?
Quel eſt le Souverain tant ſoit-il mémorable, Qui n’aïe ſenti l’effort de ce bras redoutable?	Quel est le Souverain tant soit-il mémorable, Qui n'aïe senti l'effort de ce bras redoutable?
Le Ciel, les Elemens, favoriſent ma voix, La Terre & les Enfers fléchiſſent ſous mes Loix!	Le Ciel, les Éléments, favorisent ma voix, La Terre et les Enfers fléchissent sous mes Lois!
e veux que les Démons même ſans reſiſtance, Me ſervent d’inſtrumens pour punir l’inſolence, Des Rois qui paſſeront les bornes du devoir:	e veux que les Démons même sans résistance, Me servent d'instruments pour punir l'insolence, Des Rois qui passeront les bornes du devoir:
Mal-heureux d’éprouver juſqu’où va mon pouvoir L’Aſtre qui mon bon-heur & ma gloire ſeconde, Parsourant tous les jours la sarriere du monds,	Malheureux d'éprouver jusqu'où va mon pouvoir L'Astre qui mon bonheur et ma gloire seconde, Parsourant tous les jours la sarrière du monds,
T E Ie al a d na N’éclairera jamais d’égal à ma valeur, C’eſt ce fer, c’eſt ce bras qui fait entrer la peur Iuſque dans les Palais des plus braves Monarques, Qui coupe quand il veut la tiſſure des Parques, Qui ſouvent fait couler des riviéres de ſang, Qui ne fit jamais rien indigne de ſon rang, Qui donne à qui lui plaît ou la mort ou la vieAuguſte & floriſſant en dépit de l’envie, Qui malgré les plus grands ennemis de ſon nom Fait par tout éclater ſa gloire & ſon renom, Qui donne quand il veut ou la paix ou la guerre.	TANT CE Qu' elle a d' a N'éclairera jamais d'égal à ma valeur, C'est ce fer, c'est ce bras qui fait entrer la peur Jusque dans les Palais des plus braves Monarques, Qui coupe quand il veut la tissure des Parques, Qui souvent fait couler des riviéres de sang, Qui ne fit jamais rien indigne de son rang, Qui donne à qui lui plaît ou la mort ou la vieAuguste et florissant en dépit de l'envie, Qui malgré les plus grands ennemis de son nom Fait par tout éclater sa gloire et son ren, Qui donne quand il veut ou la paix ou la guerre.
Qui peut faire trembler tout le Ciel & la Terre, Les Siécles avenir feront des monumens, Qui mettront les eſprits dans des étonnemens, Je veux faire graver tous mes faits heroïques, Mes Images ſeront dans les places puuiiques, Les plus hauts Potentats tiennent à grand honneur D’avoir rang dans ma Cour, & part à mon bonheur	Qui peut faire trembler tout le Ciel et la Terre, Les Siècles avenir feront des monuments, Qui mettront les esprits dans des étonnements, Je veux faire graver tous mes faits héroïques, Mes Images seront dans les places puviques, Les plus hauts Potentats tiennent à grand honneur D'avoir rang dans ma Cour, et part à mon bonheur
CARAUSE.	CARAUSE.
Illuſtre Préſident, redoutable Monarque, Qui des Conſuls Romains portés la noble marque vous qui Içaves joncner les campaghende corps Et pouvés renverſer les plus puiſſants efforts, Vous avés remporté tant de fois la victoire, Qu’on ne peut plus ternir l’éclat de vôtre gloire	Illustre Président, redoutable Monarque, Qui des Consuls Romains portés la noble marque vous qui Içaves joncner les campaghende corps Et pouvez renverser les plus puissants efforts, Vous avez remporté tant de fois la victoire, Qu'on ne peut plus ternir l'éclat de votre gloire
L'UCILLE.	L'UCILLE.
ous iuimontés, Olibre, en magnanimité, Tous les plus grands Heros qu’a vû l’antiquité, La fortune vous rit & par tout vous ſeconde, L’unique à redouter ſans pareil dans le monde, Vos inſignes vertus, & vos faits ſont ſi grands, uiis vous clevent prus que cous les conquerans, Olibre eſt le ſujet de plus hautes loüanges, Qui ſera célebré par les exploits étanges, Chacun admirera dans ſa proſperité, Voici quatre Seigneurs, illuſtres Perſonnages, Qui chargés de préſens lui rendront leur homages	ous iuimontés, Olibre, en magnanimité, Tous les plus grands Héros qu'a vu l'antiquité, La fortune vous rit et par tout vous seconde, L'unique à redouter sans pareil dans le monde, Vos insignes vertus, et vos faits sont si grands, uivis vous clèvent prus que cous les conquérants, Olibre est le sujet de plus hautes langes, Qui sera célebré par les exploits étanges, Chacun admirera dans sa prospérité, Voici quatre Seigneurs, illustres Personnages, Qui chargez de présents lui rendront leur homages
HILDERIC, LVCILLE, CARAUSE, GARDES.	HILDERIC, LUCILLE, CARAUSE, GARDES.
L CLEMENT.	 CLEMENT.
Invincible Guerrier, Qui dans les cnaps de Mars momomnes ſe Laurier, Aprés tant de beaux faits vôtre auguſte Perſonne, Mérite de porter cette noble Couronne.	Invincible Guerrier, Qui dans les caps de Mars Unes se Laurier, Après tant de beaux faits votre auguste Personne, Mérite de porter cette noble Couronne.
ALBAIN.	ÀLBAIN.
La Bretagne qui va ſans pair en dignité, Tienole la grandeur de vecle Majenss	La Bretagne qui va sans pair en dignité, Tienole la grandeur de vecle Majens
HILDERIC.	HILDERIC.
Illuſtre Souverain les peuples d’Auſtraſie, Vous conſacrẽt leur cœur, leur pouvoir & leur vie.	Illustre Souverain les peuples d'Autrasie, Vous consacrent leur cœur, leur pouvoir et leur vie.
CHARLES.	CHARLES.
L’Aquitaine ſoûmiſe à vos commandemens, A vôtre dignité dreſſe des monumens.	L'Aquitaine soumise à vos commandements, À votre dignité dresse des monuments.
OLIBRE.	OLIBRE.
Ces aimables reſpects, ces doux & nouveaux gages Me ſont de vôtre amour des parfaits témoignages, Par un vrai ſentiment d’honneur & de devoir, A tous vos interêts j’engage mon pouvoir, Ie ne veux être armé que pour vôtre défenſe, Ioüiſſés des honneurs dûs à vôtre naiſſance, Mon pouvoir, ma juſtice, & Roïale bonté, Sçauront recompenſer vôtre fidelité.	Ces aimables respects, ces doux et nouveaux gages Me sont de votre amour des parfaits témoignages, Par un vrai sentiment d'honneur et de devoir, À tous vos intérêts j'engage mon pouvoir, Je ne veux être armé que pour votre défense, Ioüissés des honneurs dus à votre naissance, Mon pouvoir, ma justice, et Roïale bonté, Sauront récompenser votre fidélité.
FELIX entre.	FELIX entre.
O!	Ô!
heureux Conquérant à qui tout rend hõmage De la Divinité la tres-parfaite Image, Tandis que vos ſujets donnent à vôtre Cour, Les gages plus certains de leur parfait amour;	heureux Conquérant à qui tout rend hommage De la Divinité la très-parfaite Image, Tandis que vos sujets donnent à votre Cour, Les gages plus certains de leur parfait amour;
La Saxe nation farouche & témeraire, Veut être le ſujet d’une juſte colére:	La Saxe nation farouche et témeraire, Veut être le sujet d'une juste colère:
’ai vû le grand orgueïl de ce peuple Germain, Qui veut quiter ce Joug de l’Empire Romain, Ils arment puiſſamment.	ai n ce grand orgueil de ce peuple Germain, Qui veut quit ce Joug de l'Empire Romain, Ils arment puissamment.
Le bruit de cette Guerre, Semble vous menacer come un coup de Tonnerre;	Le bruit de cette Guerre, Semble vous menacer come un coup de Tonnerre;
Tout le monde à vos loix n’eſt pas aſſujeti, Tandis que les Saxons formeront un apui.	Tout le monde à vos lois n'est pas assujet, Tandis que les Saxons formeront un appui.
OLIBRE.	OLIBRE.
Ma géneroſité, ma force, mon courage, Fera de ces Felons un horrible carnage, Il faut anéantir tout ce peuple mutin, Et faire de ſes biens un tres-riche butin, Allons vaillans Heros par l’effort de nos armes, Etouffer les Auteurs qui cauſent ces allarmes;	Ma générosité, ma force, mon courage, Féra de ces Félons un horrible carnage, Il faut anéantir tout ce peuple mutin, Et faire de ses biens un très -riche butin, Allons vaillants Héros par l'effort de nos armes, Éouffer les Auteurs qui causent ces alarmes;
Soldats préparés vous, exercés des efforts, Capables d’étonner ies eiprits les plus forts, Une grande beauté tient mon ame enchaînée, Je le veux aquiter par un ſaint Himenée:	Soldats préparés -vous, exercez des efforts, Capables d'étonner jes éjprits les plus forts, Une grande beauté tient mon âme enchaînée, Je le veux aquitter par un saint Hyménée:
Mais afin que le Ciel favoriſe nos vœux, Faiſons un ſolemnel Sacrifice à nos Dieux.	Mais afin que le Ciel favorise nos vœux, Faisons un solennel Sacrifice à nos Dieux.
SCERDIII	SCERDII
BEINE, THEOPHILE, BLONDE, REINE.	BEINE, THÉOPHILE, BLONDE, REINE.
Dorable Soleil, Jeſus Dieu de mon ame, HQui me brûlés le cœur d’une ſi vive flâme, Vous êtes mon bon-heur, ma joïe & mon époux, Mon cœur veut s’attacher totallement à vous, Mes paroles, mes vœux, mes ſoûpirs & mes larmes, Sont cauſés par vos feux, vôtre amour & vos charVous me poſſedés trop, vôtre fidelité Imes, Me baille inceſſamment des gages de bonté:	Dorable Soleil, Jésus Dieu de mon âme, HQui me brûlés le cœur d'une si vive flamme, Vous êtes mon bonheur, ma jouie et mon époux, Mon cœur veut s'attacher totallement à vous, Mes paroles, mes vœux, mes soupirs et mes larmes, Sont causés par vos feux, votre amour et vos charUous me possédés trop, votre fidélité Imes, Me baille incessamment des gages de bonté:
O benin Redempteur, qui m’avés retirée, Du pouvoir des Démons, auſquels j’étois livrée, Aprés avoir dompté ces Dragons furieux, Vous m’apellés au ſort du Roïaume des Cieux;	Ô bénin Rédempteur, qui m'avez retirée, Du pouvoir des Démons, auxquels j'étais livrée, Après avoir dompté ces Dragons furieux, Vous m'appelés au sort du Roïaume des Cieux;
Vous avés diſſipé mes ténebres funeſtes, Eclairant mon eſprit des lumiéres céleſtes, Vous m’avés découvert vôtre grande beauté, Vôtre Nom, vôtre Gloire, & parfaite bonté, Vous avés retiré mon corps de turpitude, Et deſtiné mon ame à la beatitude, Vous avés partagé vos tréſors avec mr Me donnant vôtre cœur, vôtre amour Vous avés ſur mon front gravé le carac.	Vous avez dissipé mes ténebres funestes, Eclairant mon esprit des lumières célestes, Vous m'avez découvert votre grande beauté, Votre Nom, votre Gloire, et parfaite bonté, Vous avez retiré mon corps de turpitude, Et destiné mon âme à la béatitude, Vous avez partagé vos trésors avec mr Me donnant votre cœur, votre amour Vous avez sur mon front gravé le carac.
Coi, Qui m’a donné le droit de vous nommer monPere, Vous m’avés engendrée une ſeconde fois, Par le ſouffle ſacré de vôtre ſainte voix, Je ſuis de tous vos biens legitime heritiére, J’eſpére aſſûrément la joüiſſance entiere, De vôtre grand Empire & de vôtre beauté, Et de participer à la Divinité:	Coi, Qui m'a donné le droit de vous nommer monPère, Vous m'avez engendrée une seconde fois, Par le souffle sacré de votre sainte voix, Je suis de tous vos biens légitime héritière, J'espère assurément la jouissance entière, De votre grand Empire et de votre beauté, Et de participer à la Divinité:
O mille fois heureux le ſort qui ma fait naître, Pour aimer le vrai bien, & pour vous reconnoître, O ma chere Nourrice aide de mon bon-heur, De m’avoir procuré ce bien & cét honneur, Tu m’as fait baptiſer, tu m’as donſie la riu, Quand à l’ame & le corps tu m’as tres-bien ſervie,	Ô mille fois heureux le sort qui ma fait naître, Pour aimer le vrai bien, et pour vous reconnoître, Ô a chère Nourrice aide de mon bon-heur, De avoir procuré ce bien et cét honneur, Tu as fait baptiser, tu as donsie la , Quand âme et le corps tu as très-bien servie,
BLONDE.	BLONDE.
Reine j’ai rencontré le Tréſor de la Foi, Je ne l’ai point caché, vous le tenés de moi, je ne priſe ni l’or, ni les biens de ce monde, A l’égal du vrai Dieu ſur qui mon cœur ſe fonde.	Reine j'ai rencontré le Trésor de la Foi, Je ne l'ai point caché, vous le tenez de moi, je ne prise ni l'or, ni les biens de ce monde, À l'égal du vrai Dieu sur qui mon cœur se fonde.
THEOPHILE.	THÉOPHILE.
La bonté, la vertu, l’honneur, la vérité, Sont les beaux ornemens de la fidelité, Nos eſprits éclairés de plus hautes lumiéres, Sont capables de voir les vérités premiéres, L’unité d’un vrai Dieu, ſes attributs divins, La vanité du monde & nos derniéres fins, Et nôtre Redempteur de Dieu le Fils unique, Qui prit un corps humain d’une Vierge pudique, Qui nous a rachetés par le prix de ſon Sang, En ſoûfrant une mort indigne de ſon rang, La grande charité qu’il nous a fait paroître, Nous doit ravir le cœur & nous oblige d’être, Conſacrés à lui ſeul d'unrcerproqueumour, Déſireux de le voir dans l’Eternel ſéjour.	La bonté, la vertu, l'honneur, la vérité, Sont les beaux ornements de la fidélité, Nos esprits éclairés de plus hautes lumières, Sont capables de voir les vérités premières, L'unité d'un vrai Dieu, ses attributs divins, La vanité du monde et nos dernières fins, Et notre Rédempteur de Dieu le Fils unique, Qui prit un corps humain d'une Vierge pudique, Qui nous a rachetés par le prix de son Sang, En soûfrant une mort indigne de son rang, La grande charité qu'il nous a fait rire, Nous doit sa le cœur et nous oblige être, Consacrés a lui seul d'ire, Désireux de , voir dans mEternel séjour.
BLONDE.	BLONDE.
Cét amour du Sauveur pour qui l’ame bien née, Eſt dans ſes mouvemens ſaintement obſtinée, Fait qu’elle veut ſoûfrir dans la Croix aujourd’huï Pour regner à jamais dans le Ciel avec lui;	Cet amour du Sauveur pour qui l'âme bien née, Est dans ses mouvements saintement obstinée, Fait qu'elle veut souffrir dans la Croix aujourd'huir Pour régner à jamais dans le Ciel avec lui;
Les Saints ont mépriſé les biens & les délices, Et ſe ſont conſacrés à des ſaints exercices, Ils ſe ſont expoſés aux plus cruels tourments, La Croix fut le plus doux de leurs contentemens	Les Saints ont méprisé les biens et les délices, Et se sont consacrés à des saints exercices, Ils se sont exposés aux plus cruels tourments, La Croix fut le plus doux de leurs contentements
THEOPHILE.	THÉOPHILE.
O génereuſe mort!	Ô gênereuse mort!
qui donne la victoire, Et fait recompenſer une éternelle Gloire:	qui donne la victoire, Et fait récompenser une éternelle Gloire:
O deſirable mort!	Ô désirable mort!
qui dans un ſeul moment, Nous couronne & nous fait vivre éternellement:	qui dans un seul moment, Nous couronne et nous fait vivre éternellement:
REINE.	REINE.
Si j’avois du bon-heur autant que je deſire, obtiendrois de JESUS la palme de martire, L’amour que j’ai pour lui me la fait deſirer, Connoiſſant mes pechés je ne l’oſe eſpèrer, Indigne que je ſuis d’une gloire ſi grande, Mon corps eſt trop impur pour une telle offrande;	Si j'avais du bonheur autant que je désire, obtiendrais de JESUS la palme de martyre, L'amour que j'ai pour lui me la fait désirer, Connaissant mes péchés je ne l'ose espèrer, Indigne que je suis d'une gloire si grande, Mon corps est trop impur pour une telle offrande;
Mais je mourai plûtôt que de perdre mon Dieu, en veux faire un ſerment ſolemnel en ce lieu, Cependant ſi j’avois un homme pour m’inſtruire.	Mais je mourai plutôt que de perdre mon Dieu, en veux faire un serment solennel en ce lieu, Cependant si j'avais un homme pour m'instruire.
THEOPHILE.	THÉOPHILE.
Nous avons un Prélat auquel il faut écrire.	Nous avons un Prélat auquel il faut écrire.
REINE.	REINE.
Allés lui témoigner par des humbles reſpects, Que je veux mériter ſes aimables aſpects.	Allez lui témoigner par des humbles respects, Que je veux mériter ses aimables aspects.
TEOIEIT	TEOIEIT
SCENE PREMIERE.	SCÈNE PREMIÈRE.
CHIDRD UDAMURTIS ORAMUSE, LUCILLE.	CHIDRD UDAMURTIS ORAMUSE, LUCILLE.
toute l’Armée.	toute l'Armée.
CLEMENT.	CLEMENT.
PRES avoir vielli ſi long-temps ſous les armes d Eye le puioi comol des loudumes allarmes, Dans les plus grãds hazards je ſuis ſorti vainqueur Je n’ai jamais ſoûfert deffaillance de cœur.	PRÈS avoir vielli si longtemps sous les armes dig Eye le puioi comol des loudumes alarmes, Dans les plus grands hasards je suis sorti vainqueur Je n'ai jamais souffert défaillance de cœur.
CARAUSE.	CARAUSE.
Heureuſe ocaſion d’exercer mon courage, En mettant dans les fers ce Saxon plein dé rage, Qui pour un juſte prix de ſa témerité, N’a loïer que la mort, où la captivité.	Heureuse ocasion d'exercer mon courage, En mettant dans les fers ce Saxon plein dé rage, Qui pour un juste prix de sa témerité, N'a loïer que la mort, où la captivité.
LUCILLE.	LUCILLE.
Je veux à vos soidats aprendre rexcreice, Et comme il faut agir d’extrement en malice, Aprenés combatans, braves enfans de Mars, Le moïen d’échaper dans les plus grands hazards.	Je veux à vos soidats apprendre rexcreice, Et comme il faut agir d'extrement en malice, Aprenez combattants, braves enfants de Mars, Le moïren d'échapper dans les plus grands hasards.
CLEMENT.	CLEMENT.
Saxon pour ſubjuguer ta malice enragée, Je mets nos eſcadrons en bataille rangée, C’eſt l’ordre qu’il nous faut tenir dans les combats Pour mettre au premier choe nos ennemis abas.	Saxon pour subjuguer ta malice enragée, Je mets nos escadrons en bataille rangée, C'est l'ordre qu'il nous faut tenir dans les combats Pour mettre au premier choeu nos ennemis abas.
SCENE II.	SCÈNE II.
ODAMAAIEMEIEEMACMMADES.	ODAMAIEMEIEMACMMADES.
OLIBRE.	OLIBRE.
E connois ô Clement ta géneroſité, La grandeur de ton cœur, & ta fidelité, e veux que dans ma Cour tu ſois le premier Prince, ieutenant Géneral dans toute la Province.	E connais ô Clément ta générosité, La grandeur de ton cœur, et ta fidélité, eu veux que dans ma Cour tu sois le premier Prince, jeutenant Général dans toute la Province.
a uaiua la le.	a aiva la le.
Toute ſorte de droits m’oblige aſſurément, De ſervir & d’aimer Olibre uniquement.	Toute sorte de droits m'oblige assurément, De servir et d'aimer Olibre uniquement.
OLIBRE.	OLIBRE.
Je ne t’aime pas ſeul, j’aime auſſi ta famille, Chacun me dit du bien de ta petite fille, I’eſtime ſon mérite, & j’aime ſa beauté, Sa grace, ſa ſageſſe, & ſa pudicité, nte puis Je pas la von e	Je ne t'aime pas seul, j'aime aussi ta famille, Chacun me dit du bien de ta petite fille, J'estime son mérite, et j'aime sa beauté, Sa grâce, sa sagesse, et sa pudicité, nte puis -je pas la von e
CLEMENT.	CLEMENT.
Oüi Seigneur à ce jour, Par mon ordre elle doit venir faire ſa Cour.	Oui Seigneur à ce jour, Par mon ordre elle doit venir faire sa Cour.
OLIBRE.	OLIBRE.
le ſens que mes eſprits ſont pleins d’émotions, Mon cœur eſt agité de palpitations, le n’oſe me tourner du côté de ſes charmes, Tout-beau r’aſſurons nousdans cesdouces alarmes.	le sens que mes esprits sont pleins d'émotions, Mon cœur est agité de palpitations, le n'ose me tourner du côté de ses charmes, Tout-beau rassurons nousdans cesdouces alarmes.
SCENE III.	SCÈNE III.
OLIBRE, REINE, CLEMENT, THEOPHILE, BLONDE, GARDES.	OLIBRE, REINE, CLEMENT, THÉOPHILE, BLONDE, GARDES.
OLIBRE.	OLIBRE.
Prochés ma Princeſſe & l’aimable Soleil, LAQui dans tout l’Univers n’avés point de pareil Je vous ai jour & nuit preſente en ma penſée, Vôtre Image en mon cœur eſt vivement tracée:	Prochez ma Princesse et l'aimable Soleil, LAnui dans tout l'Univers n'avez point de pareil Je vous ai jour et nuit présente en ma pensée, Votre Image en mon cœur est vivement tracée:
Venés aſtre Divin apaiſer cét ardeur, Que vos brillans raïons allument dans mon cœur, Je déſire ardemment le bien de vôtre grace, da allezicer luipece de votre ceusalce seenu;	Venez astre Divin apaiser cet ardeur, Que vos brillants raïons allument dans mon cœur, Je désire ardemment le bien de votre grâce, da allezicer luipèce de votre ceusalce seenu;
Recevés tout l’honneur & le contentement, Que peut faire eſpérer un tres-fidel amant.	Recevez tout l'honneur et le contentement, Que peut faire espérer un très-fidel amant.
REINE.	REINE.
Seigneur, tous mes reſpects, & mon obeïſſance, Dépendentmoinsde moi que d’une autre puiſſance y uuis dil grana amour à mon Pere Clement, Je n’ai d’autre déſir que ſon commandement, A vôtre bon plaiſir jé ne ſuis refractaire, Si la Foi du vrai Dieu m’ordonne le contraire.	Seigneur, tous mes respects, et mon obéissance, Dépendentmoinsde moi que dune autre puissance y uuis grana amour mo Pere Clement, Je ai que désir ' un commandement, A vôtre bon plaisir ne suis réfractaire, Si a Foi du vrai Dieu ordonne le y.
OLIBRE.	OLIBRE.
Reine tous ſes diſcours ſont pleins d’honnêteté, Des marques de candeur & de civilité, Des traits d’humilité, des ſignes de ſageſſe, Qui ſe font mériter l’effet de ma tendreſſe, Je jure ſur ma foi que je n’ai de déſir, Que pour te rendre riche, & te faire plaiſir, Accepte ce preſent comme un vrai témoignage, Que je veux contracter avec toi Mariage, Afin qu’étans unis par des vœux innocens, Nous puiſſions a nos Dieux preſenter de rencens.	Reine tous ses discours sont pleins d'honnêteté, Des marques de candeur et de civilité, Des traits d'humilité, des signes de sagesse, Qui se font mériter l'effet de ma tendresse, Je jure sur ma faite que je n'ai de désir, Que pour te rendre riche, et te faire plaisir, Accepte ce présent comme un vrai témoignage, Que je veux contracter avec toi Mariage, Afin qu'étant unis par des vœux innocents, Nous puissions à nos Dieux présenter de rencens.
REINE.	REINE.
Ah!	Ah!
Prince vôtre amour n’eſt pas bien légitime, Je n’y puis conſentir non plus qu’à vôtre crime, Ie ſuis toute à JESUS plus aimable que vous, Je ne veuxpoint changer ni prendre d’autre époux Et bien moins preſenter d’infames Sacrifices, Aux Dieux qui ne ſont point, ſi ce n’eſt en caprice, Ce ſont des incenſés, des figures de bois, Qui n’ont ni mouvement, ni ſentiment ni, voix, Des infames Démons toûjours dans la furie, Qui ſe font adorer d’un culte de latrie, Des ennemis de Dieu condamnés aux Enfers, Bannis du Firmament detenus dans les lers, J’adore le vrai Dieu qui ſeul eſt adorable, Jeſus le Roi du Ciel mon Sauveur tant aimable.	Prince votre amour n'est pas bien légitime, Je n'y puis consentir non plus qu'à votre crime, Je suis toute à JÉSUS plus aimable que vous, Je ne veuxpoint changer ni prendre d'autre époux Et bien moins présenter d'infâmes Sacrifices, Aux Dieux qui ne sont point, si ce n'est en caprice, Ce sont des incensez, des figures de bois, Qui n'ont ni mouvement, ni sentiment ni, voix, Des infâmes Démons toujours dans la furie, Qui se font adorer d'un culte de latrie, Des ennemis de Dieu condamnez aux Enfers, Bannis du Firmament es dans les lers, adore le vrai Au qui seul est adorable, Jesus le Roi du Ciel m Sauveur tant de.
OLIBRE.	OLIBRE.
O méchante parole!	Ô méchante parole!
qu’eſt-ce ce que j’entens?	qu'est-ce ce que j'entends?
Je ne puis écoûter ce diſcours plus long-temps, Mon eſprit eſt ſurpris de cette effronterie, Et ſe ſent tranſporté de certaine furie, Le reſpect de nos Dieux porte ma paſſion, A changer mon amour en indignation:	Je ne puis écouter ce discours plus longtemps, Mon esprit est surpris de cette effronterie, Et se sent transporté de certaine furie, Le respect de nos Dieux est ma passion, A changer mon amour en indignation:
Ce diſcours impudent, cette noire malice, Eſt digne de ſubir un rigoureux ſuplice, Je reſuë & ne croi pas qu’un eſprit ſi parfait, Puiſſe être l’inſtrument d’un ſi lâche forfait.	Ce discours impudent, cette noire malice, Est digne de subir un rigoureux suplice, Je résue et ne crois pas qu'un esprit si parfait, Puisse être l'instrument d'un si lâche forfait.
REINE.	REINE.
ai toûjours mépriſé les biens & les délices, l’ai conſacré mon cœur à des ſaints exercices, le renonce à vos Dieux tous pleins d’impureté, Midignes des ſoſſleurs de la Divinité.	ai toujours méprisé les biens et les délices, l'ai consacré mon cœur a des saints exercices, le renonce à vos Dieux tous pleins d'impreté, Midignes des sossleurs de la Divinité.
OLIBRE.	OLIBRE.
Je n’aurois jamais crû, qu’une lâcheté telle, Peuſſe trouver lieu, dans une ame ſi belle, Souverains Protecteurs de l’Empire Romain, Pouvès vous écouter le diſcours inhumain:	Je n'aurais jamais cru, qu'une lâcheté telle, Pusse trouver lieu, dans une âme si belle, Souverains Protecteurs de l'Empire Romain, Pouvès vous écouter le discours inhumain:
O!	Ô!
grand Dieu Jupiter, par ta haute puiſſance, Mets le Ciel tout en feu pour venger cette offence O!	grand Dieu Jupiter, par ta haute puissance, Mets le Ciel tout en feu pour venger cette offense Ô!
ingrate Beauté, tu ne mérite pas, Que je ſois plus long-temps charmé de tes apas;	ingrate Beauté, tu ne mérite pas, Que je sois plus longtemps charmé de tes appas;
Eſt-ce le ſentiment d’une amour réciproque, Pour change de mes feux par tout elle me choque Je vous prie humblemẽt, ô grands Dieux immortels Les deux genoux à bas devant vos ſaints Autels, Changés les ſentimens de cette ame obſtinée, Faites-moi parvenir à ſon doux Himenée;	Est-ce le sentiment d'une amour réciproque, Pour change de mes feux par tout elle me choque Je vous prie humblement, ô grands Dieux immortels Les deux genoux à bas devant vos saints Autels, Changez les sentiments de cette âme obstinée, Faites-moi parvenir à son doux Hyménée;
Et toi grand favori, magnanime Clement, Peux-tu voir mon eſprit ſoûfrir un tel tourment, Ennemi de nos Dieux, helas!	Et toi grand favori, magnanime Clément, Peux-tu voir mon esprit souffrir un tel tourment, Ennemi de nos Dieux, hélas!
mal-heureux Pere, Oſes-tu dans ton ſein nourir un tel vipére, Qu’elle confuſion, de voir que ton enfant, Tombe dans une Erreur indigne de ſon rang, Cette obſtination de ma fille m’afflige, Je la rengerai bien, mais la guerre m’oblige, De courir promptement au devant du Saxon, En ſuite je prendrai le temps & la ſaiſon.	malheureux Père, Oses-tu dans ton sein nourir un tel vipère, Qu'elle confusion, de voir que ton enfant, Tombe dans une Erreur indigne de son rang, Cette obstination de ma fille m'afflige, Je la rengerai bien, mais la guerre m'oblige, De courir promptement au devant du Saxon, En suite je prendrai le temps et la saison.
SCENE IV.	SCÈNE IV.
CLEMENT, REINE, THEOPHILE, BLONDE.	CLEMENT, REINE, THÉOPHILE, BLONDE.
FELIA, TERSE.	FELIA, TERSE.
CLEMENT.	CLEMENT.
A fille ô qu’eſt-ce ci, que venès vous de faire?	À fille ô qu'est-ce cy, que venez vous de faire?
IVIAh!	IVIAh!
vous parlés bien mal, il vaudroit mieux vous taire, Vous blaſphêmés les Dieux d’un diſcours imprudent, Sans craindre d’offencer Olibre Préſident, Cét Auguſte Seigneur qui n’a que des tendreſſes, Qui nous comble d’honneur, de biens & de richeſſes De qui dépend ma vie & ma proſperité, Qui promet tant de gloire à ma poſterité, Effacés ce peché par humble repentance, Recherchés les moïens de purger cette offence, Vous devés renoncer à la Religion, Qui révere Jeſus par ſuperſtition, Et que dés à preſent pour effacer le crime, Vous offriés à Venus une ſainte victime,	vous parlez bien mal, il vaudrait mieux vous taire, Vous blasphêmés les Dieux d'un discours imprudent, Sans craindre d'offenser Olibre Président, Cet Auguste Seigneur qui n'a que des tendresses, Qui nous comble d'honneur, de biens et de richesses Qui De dépend ma vie et ma prospérité, Qui promet tant de gloire à ma postérité, Éffacez ce péché par humble repentance, Recherchez les moïens de purger cette offense, Vous devez renoncer à la Religion, Qui révère Jésus par superstition, Et que d' à présent pour effacer le crime, Vous offriés Venus une sainte victime,
REINE.	REINE.
Je veux vivre & mourir ſouple à vos volontés, Remarqués vous en moi des incivilités, Ce n’eſt pas mon deſſein, mon tres-honoré Pere, D’atirer ſur mon front vôtre juſte colére, aime la verité, je déteſte l’erreur, Le culte des Démons me fait frem ir d’horreur, Ie cheris le vrai Dieu beaucoup plusque moi même, Vous ne pouvés donc point m’acuſerde blaſphême.	Je veux vivre et mourir souple à vos volontés, Remarquez -vous en moi des incivilités, Ce n'est pas mon dessein, mon très-honoré Père, D'atirer sur mon front votre juste colère, aime la vérité, je déteste l'erreur, Le culte des Démons me fait frém ir d'horreur, Je chéris le vrai Dieu beaucoup plusque moi -même, Vous ne pouvez donc point m'acuserde blâme.
CLEMENT.	CLEMENT.
O ma fille aujourd’hui r’apelle tes eſprits, Qui d’un faux ſentiment paroiſſent ſi ſurpris, Helas!	Ô ma fille aujourd'hui rappelle tes esprits, Qui d'un faux sentiment paraissent si surpris, Hélas!
te voudrois-tu déclarer ennemie, D’un pere à qui tu dois & le corps & la vie, Quitte ces ſentimens d’un eſprit criminel, Et ne rebute point cét avis paternel.	te voudrais-tu déclarer ennemie, D'un père à qui tu dois et le corps et la vie, Quitte ces sentiments d'un esprit criminel, Et ne rebute point cet avis paternel.
REINE.	REINE.
Le Ciel ſera témoin de ma juſte défence, Et que je vous promets fidelle obeïſſance, Je vous l’ai proteſté déja par pluſieurs fois, En ce que Dieu permet par ces tres-juſtes loix, je ne puis adorer Venus une lubrique, l’aime trop la vertu, je veux être pudique.	Le Ciel sera témoin de ma juste défense, Et que je vous promets fidèle obéissance, Je vous l'ai protesté déjà par plusieurs fois, En ce que Dieu permet par ces très-justes bon, je ne puis adorer Venus une lubrique, l'aime trop la vertu, je veux être pudique.
CLEMENT.	CLEMENT.
R’apelle tes eſprits, ma fille, encor un coup, Tu ne peux pas douter que je t’aime beaucoup, Ah!	R'appelle tes esprits, ma fille, encor un coup, Tu ne peux pas douter que je t'aime beaucoup, Ah!
pourquoi me tiens-tu ſi long-temps en cervelle Pourquoi me ſeras-tu maintenant ſi cruelle, Tu me feras changer mon amour en couroux, Je te ſerai cruel au lieu de t’être doux, Ton obſtination, ta criminelle envie, A ton Pere à la fin fera perdre la vie, Quertcće que tu pretens?	pourquoi me tiens-tu si longtemps en cervelle Pourquoi me seras-tu maintenant si cruelle, Tu me feras changer mon amour en courroux, Je te serai cruel au lieu de t'être doux, Ton obstination, ta criminelle envie, À ton Père à la fin fera perdre la vie, Quertce que tu prétends?
ne connois-tu pas bien En qu’el rang de mépris eſt le monde Chrétien, O quel aveuglement!	ne connais-tu pas bien En qu'elle rang de mépris est le monde Chrétien, Ô quel aveuglement!
mépriſer l’alliance, D’un Préſident Romain, helas!	mépriser l'alliance, D'un Président Romain, hélas!
qu’elle imprudence	qu'elle imprudence
REINE.	REINE.
Mon Pere permettés que j’aime uniquement, Celui qui me fera reine du Firmament.	Mon Père permettés que j'aime uniquement, Celui qui me fera reine du Firmament.
CLEMENT	CLEMENT
CLEMENT.	CLEMENT.
Je ſuis au deſeſpoir, helas mal-heureux Pere, Ma Fille eſt mon boureau déteſtable mégere;	Je suis au désespoir, hélas malheureux Père, Ma Fille est mon boureau détestable mégère;
Theophile aide moi, donne lui bon conſeil, Le mal-heur où je ſuis, n’eût jamais de pareil.	Théophile aide moi, donne lui bon conseil, Le malheur où je suis, n'eût jamais de pareil.
THEOPHILE.	THÉOPHILE.
Seigneur elle promet entiére obeïſſance, A vos commandemens quand ils ſont ſans offence;	Seigneur elle promet entierre obéissance, À vos commandements quand ils sont sans offense;
D’adorer des faux.	D'adorer des faux.
Dieux cela n’eſt point permis, Tels crimes font damner ceux qui les ont commis, Ondoit à JESUS ſeul un culte de latrie, Je veux le ſoûtenir au péril de ma vie.	Dieux cela n'est point permis, Tels crimes font damner ceux qui les ont commis, Ondait à JESUS seul un culte de latrie, Je veux le soutenir au péril de ma vie.
BLONDE.	BLONDE.
Ie poſſede l’honneur d’être en votre maiſon, e n’ai jamais apris à parler ſans raiſon, Ni vous déſobeïr à vôtre fille Reine, Je lui défere encor comme à ma ſouveraine, Ie l’ai toûjours portée à l’honneur du vrai bien, ai dû lui découvrir l’aveuglement Païen, ai dit la verité comme j’étois chargée, Et le droit naturel m’y tenoit obligée, Son eſprit tout Divin a crû la verité, Elle a vû les ſplendeurs de la Divinité.	Je possède l'honneur d'être en votre maison, eu n'ai jamais appris à parler sans raison, Ni vous désobeïr à votre fille Reine, Je lui défère encor comme à ma souveraine, Je l'ai toujours portée à l'honneur du vrai bien, ai dû lui découvrir l'aveuglement Païens, ai dit la vérité comme j'étais chargée, Et le droit naturel m'y tenait obligée, Son esprit tout Divin a cru la verité vu Elle la vu les splendeurs de la Divinité.
CLEMENT.	CLEMENT.
Vous m’avés donc trahi engence de vipére, e vous ferai ſentir l’effet de ma colére, Vous avés fait couler par un eſprit inaim, Dans le cœur de ma Fille un dangereux venin, Vous l’avés donc portée à vomir ce blaſphême:	Vous m'avez donc trahi engence de vipère, e vous ferai sentir l'effet de ma colère, Vous avez fait couler par un esprit inaim, Dans le cœur de ma Fille un dangereux venin, Vous l'avez donc portée à vomir ce blasphomme:
Quand vous avés oſé lui donner ce Baptême, Avortons des Enfers déloïaux ſerviteurs:	Quand vous avez osé lui donner ce Baptême, Avortons des Enfers déloïaux serviteurs:
Vous êtes de mon mal les perfides auteurs, Je ferai de vos corps de ſanglantes victimes, Aprochés criminels:	Vous êtes de mon mal les perfides auteurs, Je ferai de vos corps de sanglantes victimes, Aprochés criminels:
car de ma propre main, je vous enfoncerai ce poighard dans le ſein	car de ma propre main, je vous enfoncerai ce poighard dans le sein
FELIX.	FELIX.
Sire ne faites pas de tranſport témeraire, Il vaut mieux modérer ces élans de colére.	Sire ne faites pas de transport témeraire, Il vaut mieux modérer ces élans de colère.
SCENE V.	SCÈNE V.
CLEMENT, REINE, GARDES.	CLEMENT, REINE, GARDES.
CLEMENT.	CLEMENT.
TEs Enfans de la mort avortons des Enfers, OQu’ils ſoient mis en priſon, qu’ils ſoient charSes de fers , Et toi cruel enfant, il faut que tu périſſe, Sans tarder plus long-temps, ou que tu m’obeïſſe.	TEs Enfants de la mort avortons des Enfers, OÙils soient mis en prison, qu'ils soient charnées de fers , Et toi cruel enfant, il faut que tu périsse, Sans tarder plus longtemps, ou que tu m'obéisse.
REINE.	REINE.
O Seigneur Jeſus-Chriſt l’objet de mes amours, Je vous prie aidés-moi venés à mon ſecours.	Ô Seigneur Jésus-Christ l'objet de mes amours, Je vous prie aidez-moi venez à mon secours.
CLEMENT.	CLEMENT.
J’ai l’eſprit trop gêné, j’ai trop verſé de larmes, Je ſuis contraint d’uſer des effets de mes armes, je ſuis déterminé de te percer le flanc, Tu dégenere trop des vertus de mon ſang, Ifliete, qu’aujourd’hui je t’arrache la vie, Tu le mérite bien, car tu me l’as ravie,	J'ai l'esprit trop gêné, j'ai trop versé de larmes, Je suis contraint d'user des effets de mes armes, je suis déterminé de te percer le flanc, Tu dégénère trop des vertus de mon sang, Ifliète, qu'aujourd'hui je t'arrache la vie, Tu le mérite bien, car tu me l'as ravie,
REINE, en fuiant.	REINE, en fuyant.
Esus qui ſurmontés les Rois & les puiſſans, Soïés le deffenſeur des Chrêtiens innocens.	Esus qui surmontés les Rois et les puissants, Soïés le défenseur des Chrétiens innocents.
SCENE VI.	SCÈNE VI.
CLEMENT, PERSE, FELIX.	CLEMENT, PERSE, FELIX.
CLEMENT.	CLEMENT.
L’Homme infortuné:	L'Homme infortuné:
ô le mal-heureux Pere!	ô le malheureux Père!
QIl me faut donc mourir?	QIl me faut donc mourir?
ha!	ha!
je me deſeſpere, Mon mal eſt ſans pareil je ne fais que ſoûfrir, Il vaut mieux aujourd’hui pour une fois périr, Infidelle c’eſt toi qui m’arrache la vie, Je le merite bien de t’avoir mal nourrie, Je ſuis malade, helas!	je me désespère, Mon mal est sans pareil je ne fais que souffrir, Il vaut mieux aujourd'hui pour une fois périr, Infidèle c'est toi qui m'arrache la vie, Je le mérite bien de t'avoir mal nourrie, Je suis malade, hélas!
juſqu’à l’extrémite.	jusqu'à l'extrémite.
PERSE.	PERSE.
Vous avés grand beſoin Seigneur d’être aſſiſté, Repoſés vous un peu reprenés vôtre haleine, La cauſe de ce mal eſt vôtre Fille Reine.	Vous avez grand besoin Seigneur d'être assisté, Reposez -vous un peu reprenez votre haleine, La cause de ce mal est votre Fille Reine.
φσφπτ φτυτ ττ  M	φσφπτ Seigneur ττ M
ACTE TTE	ACTE TTE
SCENE PREMIERE.	SCÈNE PREMIÈRE.
SELZEDOTH, ASMODLE, MEGERE,	SELZEDOTH, ASMODLE, MÉGÈRE,
BELZEBUTH.	BÉLZEBUTH.
Mort aprochés vous!	Mort après vous!
ô mort, ô mort, ô mort, OLe mal-heureux deſſein de mon funeſte ſort.	ô mort, ô mort, ô mort, OLe malheureux dessein de mon funeste sort.
MEGERE.	MÉGÈRE.
O fureur, ô fureur, ô fureur infinie, 10 ſe brûle & je gémis, je ſuis dans la mante.	Ô fureur, ô fureur, ô fureur infinie, 10 se brûle et je gémis, je suis dans la mante.
à	à
ASMODE’E.	ASMODÉTÉ.
Au feu Démons au feu, je dis encor au feu.	Au feu Démons au feu, je dis encor au feu.
le conſumne enragéant, & bruſant dans ce neu.	le consumne enragéant, et brusant dans ce neu.
BELZEBUTH.	BÉLZEBUTH.
Aumeurtre, au meurtre, au meurtre, au ſuplice, au carnage, Je n’aſpire qu’au ſang, aux tourmens, à la rage, Cveux que jerts-eint m'auore mecnamiment, e ſuis égal à Dieu je le dis hautement.	Aumeurtre, au meurtre, au meurtre, au supplice, au carnage, Je n'aspire qu'au sang, aux tourments, à la rage, Cveux que jerts-eint m'auore mecnamiment, je suis égal à Dieu je le dis hautement.
ASMODE’E.	ASMODÉTÉ.
Il ne me reſte plus qu’une fille en la terre, Qui m’oſe reſiſter, & qui me fait la guerre, Voici les inſtrumens pour la faire périr, Comme ſon Jeſus-Chriſt lequel j’ai fait mourir, Contr’elle jarmerai tout le Ciel & la terre, je la veux ecraſer par un coup de tonnerre.	Il ne me reste plus qu'une fille en la terre, Qui m'ose résister, et qui me fait la guerre, Voici les instruments pour la faire périr, Comme son Jésus-Christ lequel j'ai fait mourir, Contr'elle jarmerai tout le Ciel et la terre, je la veux écraser par un coup de tonnerre.
RmMNPMMRNMNMNNMNVYIAMAMMMMNMNOU M CEDIMCnMMCDI AMan	RmMNPMMRNMNMNNMNVYIAMAMMMMNMNOU M CEDIMCnMMCDI CE
E CEREa*I.	E CEREa*I.
THEOPISTE, KILIE, GARDES, SOLDATS, OLIBRE, CLEMENT, LVCILLE, CARAVSE.	THÉPISTE, KILIE, GARDES, SOLDATS, OLIBRE, CLEMENT, LUCILLE, CARAUSE.
THEOPISTE.	THÉPISTE.
L'eſt juſte aujourd’hui d’aprocher des Autels, IEt de Sacrifier à nos Dieux immortels, Nous ſommes obligés d’honorer par juſtice, Le Monarque des Cieux qui nous eſt ſi propice, Lui que nous avons vû tant de fois rendre vain.	L'est juste aujourd'hui d'approcher des Autels, IEt de Sacrifier à nos Dieux immortels, Nous sommes obligez d'honorer par justice, Lé Parque des Cieux qui nous est si propice, Lui que nous avons vu tant de fois rendre vain.
L’effort des ennemis de l’Empire Romain, Implor ons les ſecours qui nous ſont néceſſaires, Pour plut heureuſement dompter nos adverſaires?	L'effort des ennemis de l'Empire Romain, Implor ons les secours qui nous sont nécessaires, Pour plut heureusement dompter nos adversaires?
Conſultons le deſſein ſur les évenemens, Des dencinsencreprisconcre les Mnemiano.	Consultons le dessein sur les événements, Des dencinsencreprisconcre les Mémiano.
OLIBRE.	OLIBRE.
J’ai reçû tant de bien & reconnu la grace, Du grand Dieu Jupiter, je punirai l’audace, De ceux qui par blaſpême & par témerité, Refuſent le reſpect à ſa Divinité, L Quiconque à d’autre Dieu preſente Sacrifice, Je lui ferai ſoûfrir un rigoureux ſuplice, je deſcends de mon i’rone, & fechis les genoux, Adorant Jupiter humblement avec vous.	J'ai reçu tant de bien et reconnu la grâce, Du grand Dieu Jupiter, je punirai l'audace, De ceux qui par blaspême et par témerité, Refusent le respect à sa Divinité, L Quiconque à d'autre Dieu présente Sacrifice, Je lui ferai souffrir un rigoureux supplice, je descends de mon j'one, et féchis les genoux, Adorant Jupiter humblement avec vous.
THEOPISTE.	THÉPISTE.
O grand Dieu Jupiter, recevés cette Hoſtie, Qu’à vôtre Majeſté le peuple ſacrifie, Je vous offre ce foïe, & ce cœur languiſſant, Pour gage aſſuré d’un amour innocent, Ce cœur, ces inteſtins, cette chair, ces entrailles, Ne ſont dûës qu’à vous ſeul ce grand Dieu des batailles:	Ô grand Dieu Jupiter, recevez cette Hostie, Qu'à votre Majesté le peuple sacrifie, Je vous offre ce foïe, et ce cœur languissant, Pour gage assuré d'un amour innocent, Ces cœur, ces intestins, cette chair, ces entrailles, Ne sont dûës qu'à vous seul ce grand Dieu des batailles:
Recherchons maintenant quel ſera le ſuccés, Des efforts ennemis dont nous craignons l’accés, Ce poulmon palpitant, ce cœur émû preſage, Des peuples ennemis un tres-ſanglant carnage.	Recherchons maintenant quel sera le succès, Des efforts ennemis dont nous craignons l'accès, Ce poulémon palpitant, ce cœur ému présage, Des peuples ennemis un très-sanglant carnage.
KILIE.	KILIE.
Sortés de vos Tombeaux, ſortés de vos manoirs Sortés Ombres ſortés, paroiſſés eſprits noirs, Vous qui vivés là-bas dans les champs Elizée, Venés, venés ici déclarer vos penſées, Cét angle, ce carreau, cedroit, ce rond parfait, Seront des ſignes feints propres pour cét effet, Vous qui ſçavés le ſort & les choſes futuręs, Dités nous hardiment toutes nos avantures, Ce Milan, ce Vaultour, ce Merle, ce Corbeau, Menace les Chrétiens d’un funeſte Tombeau, Le vol de cét Hibou, cét Aiglon, ce Choüette, Ne preſage aux mutins qu’une entière défaite.	Sortez de vos Tombeaux, sortés de vos manoirs Sortés Ombres sortés, paraissez esprits noirs, Vous qui vivez là-bas dans les champs Elizée, Venés, venez ici déclarer vos pensées, Cet angle, ce carreau, cedrait, ce rond parfait, Seront des signes feints propres pour cet effet, Vous qui savez le sort et les choses futurs, Dités nous hardiment toutes nos aventures, Ce Milan, ce Vaultour, ce Merle, ce Corbeau, Menace les Chrétiens d'un este Tombeau, Le vol de cet Hibou, cét Aiglon, ce Choüette, Lé presage aux mutins une entière défaite.
OLIBRE.	OLIBRE.
Nous avons la faveur du grand Dieu Jupiter, Il nous aime beaucoup nous n’en pouvons douter, Qu’on me faſſe ſçavoir ſi le Saxon aproche.	Nous avons la faveur du grand Dieu Jupiter, Il nous aime beaucoup nous n'en pouvons douter, Qu'on me fasse avoir si le Saxon approche.
IOIIO 21 21 FELIX.	JOIIO 21 21 FELIX.
Sa témeraire main deja ſes traits décoche, Olibre, les voici.	Sa témeraire main déjà ses traits décoche, Olibre, les voici.
OLIBRE.	OLIBRE.
C’eſt donc ce que j’entends, qus senereun dueniers ne perdes poit de temps, Ils ſont aſſés hardis pour donner ces allarmes, Ils s’en repentiront, cependant vîte au armes.	C'est donc ce que j'entends, qus sénéreux dueniers ne perdes poit de temps, Ils sont assez hardis pour donner ces alarmes, Ils s'en repentiront, cependant vite au armes.
LUCILLE.	LUCILLE.
La fortune mérite toûjours dans les combats, Nous allons bien-tôt voir nos ennemis à bas, Il faut ſe comporter ſi bien dans cette Guerre, Que tous nos ennemis baillent du nés en terre.	La fortune mérite toujours dans les combats, Nous allons bientôt voir nos ennemis à bas, Il faut se comporter si bien dans cette Guerre, Que tous nos ennemis baillent du nés en terre.
CARAUSE.	CARAUSE.
Ce n’eſt pas tant l’ardeur que la dexterité, Qui dans tous les combats fait la proſperité, Il ſaut uſer ici d’une grande ſoupleſſe, Et vaincre aſſurément par ruſe & par adreſſe, Aprés les premiers coups quand ils ſeront éparts, Ils ſeront enfermés par nous de toutes parts;	Ce n'est pas tant l'ardeur que la dextérité, Qui dans tous les combats fait la prospérité, Il saut user ici d'une grande souplesse, Et vaincre assurément par ruse et par adresse, Après les premiers coups quand ils seront éparts, Ils seront enfermés par nous de toutes parts;
en veux être le Chef j’en prendrai la conduite, Nous en verrons bien-tôt les effets & la ſuite.	en veux être le Chef j'en prendrai la conduite, Nous en verrons bientôt les effets et la suite.
SCENE III.	SCÈNE III.
SVNON, HILDEGASTE, ERENNIE, SOLDATS, ARME’ES.	SUNON, HILDÉGASTE, ERENIE, SOLDATS, ARME'ES.
SUNON, E parle à vous hardis & génereux Lions, Qui ſçavés renverſer les plus forts bataillons, Qui comme des Démons dans le choc des batailles, Arrachès aux mutins le cœur & les entrailles, Invincibles Soldats, illuſtres Allemans, Qui par tout l’Univers dreſſés, des monumens, Aprés avoir toûjours r’emporté la victoire, Voudriés vous aujourd’hui voir ternir vôtre gloire Faut-il que le Saxon & le Noble Germain, Deviennent les ſujets de l’Empire Romain?	SUNON, E parle à vous hardis et généreux Lions, Qui Savez renverser les plus forts bataillons, Qui comme des Démons dans le choc des batailles, Arrachés aux mutins le cœur et les entrailles, Invincibles Soldats, illustres Allemands, Qui par tout l'Univers dressés, des monuments, Après avoir toujours rapporté la victoire, Voudriez -vous aujourd'hui voir ternir votre gloire Faut-il que le Saxon et le Noble Germain, Deviennent les sujets de l'Empire Romains?
Qu’on jette dans les fers un peuple toûjours libre, Que nous ſoïons nommés les eſclaves d’Olibre:	Qu'on jette dans les fers un peuple toujours libre, Que nous soïons nommés les esclaves d'Olibre:
Vous qui dans les combats pire que des démons, ai vû ſouvent braver des eſprits rodomonts, Apellés ce tranſport & fureur marciale, Capable d’enlever leur Aigle Imperiale, Les débrits de l’Armée, & leurs triſtes lambeaux, Feront les ornemens de vos Arcs triomphaux, J’entrerai le premier, & la tête baiſſée, Nous allons bien-tôt voir leur force renverſée:	Vous qui dans les combats pire que des démons, ai vu souvent braver des esprits rodomonts, Apellés ce transport et fureur marciale, Capable d'enlever leur Aigle Impériale, Les débrits de l'Armée, et leurs tristes lambeaux, Feront les ornements de vos Arcs triomphaux, J'entrerai le premier, et la tête baissée, Nous allons bientôt voir leur force renversée:
Déja dans leur eſprit j’ai jetté la terreur, Et les ai fait trembler au bruit de ma fureur, Ils ſe ſont retirés aux premiéres allarmes, Nous leur avons fait peur par l’éclat de nos armes;	Déjà dans leur esprit j'ai jeté la terreur, Et les ai fait trembler au bruit de ma fureur, Ils se sont retirés aux premières alarmes, Nous leur avons fait peur par l'éclat de nos armes;
Je vai les attaquer juſques dedans leurs forts, INAGEDIE Et leur faire éprouver nos genereur efforts.	Je vais les attaquer jusques dedans leurs forts, INAGEDIE Et leur faire éprouver nos généreur efforts.
HI LDEGASTE.	HI LDEGASTE.
Agiſſons prudemment uſons d’un ſtratagéme, je crailis que contre notts ils n’en uſent de même.	Agissons prudemment usons d'un stratagème, je crailis que contre notts ils n'en usent de même.
ERENNIE.	ERENNIE.
Je ne puis plus tarder, allons enfans de Mars, Ataquer ces poltrons juſques dans leurs ramparts.	Je ne puis plus tarder, allons enfants de Mars, Ataquer ces poltrons jusques dans leurs remparts.
Sortés lâches ſortés, ſortés de la tanniére, Je vous deffie ici de paroître en lumiére, Voulés-vous par l’ennui d’une triſte langueur, Des Soldats animés refroidir la vigueur.	Sortez lâches sortés, sortés de la tannièvre, Je vous défie ici de paraître en lumièvre, Voulez-vous par l'ennui d'une triste langueur, Des Soldats animez refroidir la vigueur.
&χιφυγ νωγ κελιεδυκςυγ Μην θωυγ γυγιαπβγεαιAN MDLEEECEVE MARAMRMAA	etχιφυγ „ κελιεδυκςυγ § θωυγ AN MDLEECEUE MARAMRMAAAA
UNON.	UNON.
SCENE IV.	SCÈNE IV.
OLIBRE, SUNON, SABIN, ERENNIE.	OLIBRE, SUNON, SABIN, ERENIE.
OLIBRE.	OLIBRE.
Moi, Soldats à moi, tuë, tuë, maſſacre, égorge, LLHa Sunon je te tiens la poignard à la gorge, Soldatsc’eſt à ce coupque nous ſommes vainqueurs On connoîtra par tout la grandeur de nos cœurs, Jouïſſons aujourd’hui des fruits de la victoire, Rcencune nos eipiits d’uſe ngrande Gioire.	Moi, Soldats à moi, tue, tue, massacre, égorge, LLHa Sunon je te tiens la poignard à la gorge, Soldatsc'est à ce coupque nous sommes vainqueurs On connaîtra par tout la grandeur de nos cœurs, Jouissons aujourd'hui des fruits de la victoire, Rcencune nos eipiits d'use négrande Gioire.
SABIN.	SABIN.
Maintenant Radamante, vous vous verrés traités, Selon le grand pouvoir de vos témerités.	Maintenant Radamante, vous vous errez traités, Selon le grand pouvoir de vos témerités.
ERENNIE.	ERENNIE.
O mal-heureux deſtin!	Ô malheureux destin!
ta rage eſt aſſouvie, Pourquoi dans ce combat n’ai-je perdu la vie, aime mieux m’étouffer par un coup violent, Que ſoûfrir les affronts d’un vainqueur inſolent.	ta rage est assouvie, Pourquoi dans ce combat n'ai-je perdu la vie, aime mieux m'étouffer par un coup violent, Que souffrir les affronts d'un vainqueur insolent.
MICRAEV.	MICRAEU.
SCENE PREMIERE.	SCÈNE PREMIÈRE.
SAINT REVERIAN, SAINTE REINE, BLONDE.	SAINT REUERIAN, SAINTE REINE, BLONDE.
THEOPHILE.	THÉOPHILE.
SAINT REVERIAN.	SAINT REUERIAN.
Nge dont la vertu fait naître dans la Gaule, AADu culte du vrai Dieu la floriſſante écolle, Chaſſe l’aveuglement, & diſſipe l’erreur, Allume le déſir du vrai bien dans le cœur, Miniſtre du Tres-haut, Ambaſſadeur céleſte, Inſtrument du ſalut, le ſecours manifeſte, Du peuple élû de Dieu & des prédeſtinés, Qui ſeront dans le Ciel pour jamais couronnés, Aſſiſte fortement les conforte en la gloire, Et de leurs ennemis impetrer la victoire, Nous avons a combatre le monde & l’Enfer, Il nous faut ſurmonter tant le feu que le fer, Contre Jeſus-Chriſt ſeul le monde ſe revolte, je veux dans ces déſerts faire une ample récolte, Arborer dans ces lieux l’étendard de la Croix, Y prêcher Jeſus-Chriſt, & publier ſa Loi, En chaſſer les Démons avec l’Idolâtrie, Annoncer le vrai Dieu à ma chere patrie, Le Ciel m’a député l’Apôtre de ce lieu,  jummilcrurmon lung pour le gione de Diou.	Nge dont la vertu fait naître dans la Gaule, AADu culte du vrai Dieu la florissante écolle, Chasse l'aveuglement, et dissipe l'erreur, Allume le désir du vrai bien dans le cœur, Ministre du Très-haut, Ambassadeur céleste, Instrument du salut, le secours manifeste, Du peuple élu de Dieu et des prédestinez, Qui seront dans le Ciel pour jamais couronnés, Assiste fortement les conforteen la gloire, Et de les ennemis impétrer la victoire, Nous avons a combatre le monde et Enfer, Il nous faut surmonter ment le feu que le fer, Con Jesus-Christ seul le fo se revolte, la veux dansces déserts faire une ample récolte, Arborer dans ces lieux a de laCroix, Y re Jesus-Christ, et ou sa Loi, En chasser les Démons a çIdolâtrie, Annoncer le mo Dieu et l' Enfer patrie, Le Il a nous fApôtre de ce su, jummilcrurmon lung ter le tant de Diou'
REINE.	REINE.
L’Adorable Soleil clair raïon de ſa Grace, M’échauffe dans le cœur, & m’éclaire en la face Nous goûtons maintenant les prémices des fruits, Que cét Aſtre divin par ſa grace a produits.	L'Adorable Soleil clair raïon de sa Grâce, M'échauffe dans le cœur, et m'éclaire en la face Nous goûtons maintenant les prémices des fruits, Que cet Astre divin par sa grâce a produits.
SAINT REVERIAN.	SAINT REUERIAN.
v Ous aveumeprirema vencrabie nceme y Les délices du corps, & la gloire mondaine.	 Ô vumeprirema vencrabie nième y Les délices du corps, et la gloire mondaine.
REINE.	REINE.
O que j’ai de bon-heur de goûter tendrement, Qu’il n’eſt que Jeſus ſeul qui ſoit fidel Amant, Il me fait éprouver par dix mille carreſſes, Combien pour ſes amis ſon cœur a de tendreſſe, Quand je ſoûfre pour lui la perſecution, Il me rend le centruple en conſolation.	Ô que j'ai de bonheur de goûter tendrement, Qu'il n'est que Jésus seul qui soit fidel Amant, Il me fait éprouver par dix mille carresses, Combien pour ses amis son cœur a de tendresse, Quand je souffre pour lui la persécution, Il me rend le centruple en consolation.
SAINT REVERIAN.	SAINT REUERIAN.
Comme un riche fleuron vous ornés ſa Couronne, L’objet de ſes amours à qui ſeul il la donne, Heureuſe mille fois d’avoir un tel Epoux, Qui tranſporté d’amour ſe communique à vous, o llà done Mmpiime fui vous lon caraceere, Il doit vous poſſéder en qualité de Pere, Conſacrés vous à lui, & qu’un vœu ſolemnel, Vous uniſſe avec lui d’un amour éternel.	Comme un riche fleuron vous ornez sa Couronne, L'objet de ses amours à qui seul il la donne, Heureuse mille fois d'avoir un tel Époux, Qui transporté d'amour se communique à vous, ô llà done Mmpiime fui vous lon caraceere, Il doit vous posséder en qualité de Père, Consacrez vous à lui, et qu'un vœu solennel, Vous unisse avec lui d'un amour éternel.
REINE.	REINE.
Dieu qui brûlés mon cœur d’une ſi douce flâme, Je conſacre à vous ſeul ilon corps avee mon ame;	Dieu qui brûlés mon cœur d'une si douce flamme, Je consacre à vous seul il corps avée mon âme;
Je veux vivre & mourir dans la virginité, Soïës le protecteur de mon integrité, Je ſuis à la merci de vôtre Providence, jonnés-moi la vertu de la perſevérance.	Je veux vivre et mourir dans la virginité, Soïës le protecteur de mon integrité, Je suis à la merci de votre Providence, jonnez-moi la vertu de la persévérance.
SAINT REVERIAN.	SAINT REUERIAN.
Vierge ne doutés pas de ſa fidélité, ſera protecteur de vôtre pureté, ecevés par mes mains le ſecours de la grace, Qui vous donne le cœur & la force efficace, pour vaincre hardiment contre tous les efforts, Qui voudront prophaner vôtre ame & vôtre corps;	Vierge ne doutez pas de sa fidélité, sera protecteur de votre pureté, écevez par mes mains le secours de la grâce, Qui vous donne le cœur et la force efficace, pour vaincre hardiment contre tous les efforts, Qui voudront prophaner votre âme et votre corps;
joïés ferme en la foi remportés la victoire, Dieu vous a deſtinés à cette grande gloire, e vous fais ce préſent qui ne convient qu’à vous, C’eſt ce cœur embraſé de Jeſus vôtre époux, Quand vous le baiſerés vous ſerés enflâmée, et tout autant de fois vous ſerés animée.	jouez ferme en la foi remportés la victoire, Dieu vous a destinez à cette grande gloire, vous fais ce présent qui ne convient qu'à vous, C'est ce cœur embrasé de Jésus votre époux, Quand vous le baiserez vous serez enflammée, et tout autant de fois vous serez animée.
THEOPHILE.	THÉOPHILE.
Benit ſoit Jeſus-Chriſt qui dans l’affliction, Réjoüit nos eſprits de conſolation, Il nous a conſolée par l’heureuſe viſite, De vôtre Sainteté laquelle nous excite, Comme un digne Prélat à l’amour du vrai bien, ſtuenenure en tout lieu l’hõneur du nom Chrétien	Bénit soit Jésus-Christ qui dans l'affliction, Réjoüit nos esprits de consolation, Il nous a consolée par l'heureuse visite, De votre Sainteté laquelle nous excite, Comme un dès Prélat à l'amour du vrai bien, stuenure en tout lieu l'honneur du nom Chrétien
BLONDE.	BLONDE.
Je déſire par tout ſuivre ma fille Reine, e l’acompagnerai dans la mort dans la peine.	Je désire par tout suivre ma fille Reine, e 'acompagnerai dans la mort dans la peine.
SAINT REVERIAN.	SAINT REUERIAN.
O Blonde, ô Theophile, Apôtres de la Foi, ods cces des Dcioi la cenicunuonaim al, Vous planterés la foi par vôtre patience, Vôtre ſang épandu en ſera la ſemence;	Ô Blonde, ô Théophile, Apôtres de la Foi, ods cees des Dciai la cénicunuonaim al, Vous planterés la foi par votre patience, Votre sang épandu en sera la semence;
Dieu vous ſera préſent vous aurés ſon ſecours, Avec tous les efforts de ſes tendres amours:	Dieu vous sera présent vous aurez son secours, Avec tous les efforts de ses tendres amours:
28 Je vous confirmerai par l’huile du Saint Crême Qui vous animera comme un ſecond Baptême, Pour confeſſer la Foi, deffendans hardiment, Nôtre Religion ſans crainte du tourment:	28 Je vous confirmerai par l'huile du Saint Crême Qui vous animera comme un second Baptême, Pour confesser la Foi, défendant hardiment, Notre Religion sans crainte du tourment:
Recevés de Jeſus cette adorable Image, Qui de ſon grand amour vous ſervira de gage, Il ſera la terreur du dragon infernal, Et rompra les efforts de l’ennemi fatal, ’aloux de ton bon-heur, helas:	Recevez de Jésus cette adorable Image, Qui de son grand amour vous servira de gage, Il sera la terreur du dragon infernal, Et rompra les efforts de l'ennemi fatal, aloux de ton bon-heur, hélas:
fille Reine, ſe baiſe tes liens, & j’adore ta chaîne, Je les priſe bien fort & j’en fais plûtôt choix, Que des beaux ornemens & des Sceptres des Rois ’eſpere dans le Ciel te devoir bien-tôt ſuivre, T’aïant vû triompher je ne voudrois plus vivre, Adieu prédeſtinés, adieu mes chers amis;	fille Reine, se baise tes liens, et j'adore ta chaîne, Je les prise bien tôt et j'en fais plutôt choix, Que des beaux ornements et des Sceptres des Rois espere dans le Ciel te devoir bien-tôt suivre, aïant triompher je ne voudrois plus vivre, Adieu prédestinés, adieu mes chers amis;
Priés pour moi pecheurs, aimés vos ennemis, Vous avés le ſujet d’une gloire infinie, La rage des Tirans enfin ſera punie.	Priez pour moi pécheurs, aimez vos ennemis, Vous avez le sujet d'une gloire infinie, La rage des Tyrans enfin sera punie.
y aΝηνΝΝY NVεΝ N&UVNUY .	y aΝηνΝΝY NOtre NetUVNUY .
UYRNV Ko M 4 M νγy 30nClen?	VYRNV Ko M 4 M 30nClen?
Dex sen Messe SCENEII.	Dex sen Messe SCENEII.
REINE, THEOPHILE, BLONDE pauvres Chrétiens.	REINE, THÉOPHILE, BLONDE pauvres Chrétiens.
REINE.	REINE.
E te veux adorer ô vénerable cœur, Sur lequel eſt gravé le Nom du Redempteur, Je trouve en t’adorant ma joïe & mes délices, Quand je devrois ſoûfrii des rigoureun luplices, Je ne perdrai jamais l’amour de mon Epoux, Parce qu’il m’eſt trop bon, trop fidelle & trop doux, Je me donne à lui ſeul, je l’aime ſans reſerve,	E te veux adorer ô vénérable cœur, Sur lequel est gravé le Nom du Rédempteur, Je trouve en t'adorant ma jouie et mes délices, Quand je devrais souffri des rigoureun luplices, Je ne perdrai jamais l'amour de mon Époux, Parce qu'il m'est trop bon, trop fidèle et trop doux, Je me donne à lui seul, je l'aime sans réserve,
ne vis que par lui ſon pouvoir me conſerve, veut m’être conjoint inſéparablement, ue je priſe l’ardeur d’un ſi fidel Amant, m’a donné ſon Corps & ſon Sang pour un gage, le ſon plus tendre amour & parfait Mariage:	ne vis que par lui son pouvoir me conserve, veut m'être conjoint inséparablement, ue je prise ardeur un si fidel Amant, a donné son Corps et son Sang pour un gage, le son plus tendre amour et parfait Mariage:
quel plus tendre amouri que de mourir pour moĩ l'exempter de mes maux & les charger ſur ſoi, e ſerois ſans mentir grandement criminelle, je ne faiſois voir qu’à JESUS ſuis fidelle, trenonce à moi-même, & proteſte aujourd’hui, lue mon plus grand déſir eſt de mourir pour lui;	quel plus tendre amouri que de mourir pour moñ l'exempter de mes maux et les charger sur soi, e serois sans mentir grandement criminelle, je ne faisais voir qu'à JÉSUS suis fidèle, trenonce à moi-même, et proteste aujourd'hui, lue mon plus grand désir est de mourir pour lui;
emépriſe le monde & les biens de la terre;	emprise le monde et les biens de la terre;
em’en veux dépoüiller leur déclarant la guerre.	em’en veux dépoüiller leur déclarant la guerre.
ibrement je renonce à tous ces vains atours, laſpire à de plus ſaintes & ſolides amours, Jous mérités grand Roi de porter la Couronne, e n’en déſire point, voici je vous la donne, lar Perles & Carquans, fleurons & chaînes d’Ors joient dans le magaſin du céleſte Tréſor, le ſerai d’autant plus à mon Epoux aimable, Que dans la pauvreté je lui ſerai ſemblable.	ibrement je renonce à tous ces vains atours, laspire à de plus saintes et solides amours, Jous mérités grand Roi de porter la Couronne, e ut désire point, voici je vous la donne, lar Perles et Carquants, fleurons et chaînes d'Ors jaient dans le magasin du céleste Trésor, le serai d'autant plus à mon Époux aimable, Que dans la pauvreté je lui serai semblable.
BLONDE.	BLONDE.
Cet amour ſignale, ces graces, & ces bieil-faitg, Plaiſent à Jeſus-Chriſt comme à lui-même faits, Ce qu’on donne à ceux-ci, c’eſt à lui qu’on le donne Ces dons ſont conferés à ſa propre perſonne.	Cet amour signale, ces grâces, et ces bieil-fait, Plaisent à Jésus-Christ comme à lui-même faits, Ce qu'on donne à ceux-cy, c'est à lui qu'on le donne Ces dons sont conferés à sa propre personne.
CDOPHILE.	CDOPHILE.
Vous m’avés vû, dit-il, dans la nèceſſité, Tres-pauvres & languiſſants, vous m’avés aſſiſté, Quand j’ai ſoûfert la faim, la ſoif & la miſére, Vous m’avés ſecouru comme vôtre vrai frere.	Vous m'avez vu, dit-il, dans la nécessité, Tres-pauvres et languissants, vous m'avez assisté, Quand j'ai souffert la faim, la soif et la misère, Vous m'avez secouru comme votre vrai frère.
REINE.	REINE.
Il eſt vrai cher Epoux que de ma propre mait ’étanche vôtre ſoif, contente vôtre faim, Heureuſe de pouvoir aujourd’hui vous repaître Vous ſervir à genoux & vous faire connoître, Par mon ardent amour & mes humbles reſpects Qve je veux mériter vos aimables aſpects, prodio barle les preus mon Sauveui adorable, e les lave à ceux-ci pour vous être ſemblable.	Il est vrai cher Époux que de ma propre mait étanche votre soif, contente votre faim, Heureuse de pouvoir aujourd'hui vous répare Vous servir à genoux et vous faire connaître, Par mon ardent amour et mes humbles respects Qve je veux mériter vos aimables aspects, prodio barle les prus mon Sauveui adorable, les lave à ceux-cy pour vous être semblable.
BLONDE.	BLONDE.
Nôtre grand Roi Jeſus, par ſon humilité, Nous donna cét exemple, & doit être imité, Lui-même il à lavé les pieds à ſes Fidéles, Et de ſa Charité donné des loix nouvelles.	Notre grand Roi Jésus, par son humilité, Nous donna cet exemple, et doit être imité, Lui-même il lavé les pieds à ses Fidèles, Et de sa Charité donné des lois nouvelles.
REINE.	REINE.
Guériſſés cher Epoux, mon Dieu, mon Redempteur L’ulcere & le peché qui régne dans mon cœur, De vôtre ſaint ſecours je me ſens animée, Ie ſerai maintenant toute en vous tranformée, Pour me pouvoir unir à vous par l’Oraiſon, ’entre dans le cachot d’une obſcure priſon, Je me plaît dans ce lieu, là je ſerai ravie, D’être à mon cher Epoux ſaintement aſſervie, Là je pourai joüir du doux embraſſement, Et du baiſer ſacré de mon fidel Amant, Là je me collerai ſur ſa divine Face, Qui porte tant d’attraits & ſi pleine de grace, Là je pourai baiſer ces vénerables Pieds, Ces Bras & ces Genoux qui ſont Crucifiés, J’adererai ſon Chef ſi Saint & vénerable, Adoré dans les Cieux & ſon cœur charitable, nfin j’adorerai mille fois à genoux, 'ous les membres Sacrés de mon céleſte Epoux;	Guérissez cher Époux, mon Dieu, mon Rédempteur L'ulcere et le péché qui règne dans mon cœur, De votre saint secours je me sens animée, Je serai maintenant toute en vous tranformée, Pour me pouvoir unir à vous par l'Oraison, entre dans le cachot une obscure prison, Je me plaît dans ce lieu, je serai ravie, être mon cher Epoux saintement asservie, je pourai joüir du doux embrassement, Et du baiser sacré de mon fidel Amant, je me collerai sur sa divine Face, Qui porte tant attraits et si pleine de grace, je pourai baiser ces vénerables Pieds, Ces Bras et ces Genoux qui sont Crucifiés, adererai son Chef si Saint et vénerable, Adoré dans les Cieux et son cœur charitable, nfin adorerai mille fois genoux, ' les membres Sacrés de mon céleste Epoux;
l'eſt maintenantmon Dieu qu’ardamment je déſire 'erſer pour vous mon ſang, & ſoûfrir le martire, eprendrai la Houlette, & l’habit de Paſteurs, our braver la fureur de mes perſecuteurs.	l'est maintenantmon Dieu qu'ardamment je désire 'erser pour vous mon sang, et soûfrir le martyre, éprendrai la Houlette, et habit de Pasteurs, our braver la fureur de mes persécuteurs.
AYSENSPANUEVONSTEESPQ ME MELMANSEEMNAM SCENE III.	AYSENSPANUEVONSTEESPQ ME MELMANSEEMNAM SCÈNE III.
LIBRE, CLE'MENT, THEOPISIE, RILIE, PAGES.	LIBRE, CLÉMENT, THÉPISIE, RILIE, PAGES.
OLIBRE.	OLIBRE.
E ſuis ce proconſul qui de la gloire volle, Ecpuis le bout de l’un juſques à l’autre polle, tnfin j’ai Triomphé grace aux Dieux immortels, leur faut préparer derechef des Autels.	E suis ce proconsul qui de la gloire volle, Ecpuis le bout de l'un jusques à l'autre polle, tnfin j'ai Triomphé grâce aux Dieux immortels, leur faut préparer derechef des Autels.
THEOPISTE.	THÉPISTE.
S’il eſt vrai que nos Dieux nous ont été propices, Il leur faut preſenter des nouveaux Sacrifices, Permettés que je parle Auguſte Majeſté, Prenès les interêts de la Divinité, Nos Dieux lonc meprires, partotte om les uifence, Pourquoi ſuportés vous cét excés d’inſolence?	S'il est vrai que nos Dieux nous ont été propices, Il leur faut présenter des nouveaux Sacrifices, Permettés que je parle Auguste Majesté, Prenès les intérêts de la Divinité, Nos Dieux lonc méprires, partotte om les uifense, Pourquoi suportés vous cet excès d'insolence?
Ce mépris, ce blaſphême, & prophanation, Attirera ſur nous leur indignation.	Ce mépris, ce blasphême, et prophanation, Attirera sur nous leur indignation.
OLIBRE.	OLIBRE.
Qui ſont ces impudents, ces pervers, ces infames, e leur ferai ſentir & le feu & les flâmes.	Qui sont ces impudents, ces pervers, ces infâmes, e leur ferai sentir et le feu et les flammes.
KILIE.	KILIE.
C’eſt une horrible peſte à tout le genre humain, Des ennemis jurés de l’empire Romain, Les Diſciples de Chriſt, une ſecte nouvelle, Qui déclare à nos Dieux une guerre cruelle, Ils entrent hardiment dans les maiſons des Rois Séduiſent leurs ſujets par des nouvelles Loix, Ces rebelles eſprits propres à contredire, Font à tous mépriſer les Edits de l’Empire.	C'est une horrible peste à tout le genre humain, Des ennemis jurés de l'empire Romain, Les Disciples de Christ, une secte nouvelle, Qui déclare à nos Dieux une guerre cruelle, Ils entrent hardiment dans les maisons des Rois Séduisent leurs sujets par des nouvelles Lois, Ces rebelles esprits propres à contredire, Font à tous mépriser les Édits de l'Empire.
CLEMENT.	CLEMENT.
O deſaſtre!	Ô désastre!
ô regrets!	ô regrets!
ômon plus grand mal-heur C’eſt ici le ſujet de ma juſte douleur:	ômon plus grand malheur C'est ici le sujet de ma juste douleur:
Les Chrétiens ont ſéduit ma propre fille Reine.	Les Chrétiens ont séduit ma propre fille Reine.
Celle que j’eſpérois voir un jour Souveraine, en créve de dépit, elle a bù ce poiſon, ’en ſuis au deſeſpoir, elle eſt dans la priſon.	Celle que j'espérais voir un jour Souveraine, en crève de dépit, elle a bù ce poison, 'en suis au désespoir, elle est dans la prison.
OLIBRE.	OLIBRE.
Ha j’ai tant deſiré la prendre en Mariage, Ne me craint-elle point, eſt-elle ſi peu ſage?	Ha j'ai tant désiré la prendre en Mariage, Ne me craint-elle point, est-elle si peu sage?
Le droit & le devoir m’oblige de blâmer, Cette rare beauté, qui me force d’aimer, Celle de qui le Ciel me donnoit l’Himenée, Paroît dans cét erreur fortement obſtinée:	Le droit et le devoir m'oblige de blâmer, Cette rare beauté, qui me force d'aimer, Celle de qui le Ciel me donnait l'Hyménée, Paraît dans cet erreur fortement obstinée:
O que je ſuis confus!	Ô que je suis confus!
ô que je ſuis ſurpris!	ô que je suis surpris!
Je mourrai du tranſport qui trouble mes eſprits, Je l’abandonne aux coups, tout ce que je déſire, Eſt de la voir mourir, je ſuis prêt d’y ſouſcrire.	Je mourrai du transport qui trouble mes esprits, Je l'abandonne aux coups, tout ce que je désire, Est de la voir mourir, je suis prêt d'y souscrire.
THEOPISTE.	THÉPISTE.
Clement, c’eſt un effet de vôtre impunité, Que vôtre Fille ſoit dans l’infidelité, Illuſtre Préſident derechef je vous jure, Si vous ne puniſſés ſèverement l’injure, Faite au grand Jupiter, vous ſentirés un jour, L’effet de ſa colére au lieu de ſon amour.	Clément, c'est un effet de votre impunité, Que votre Fille soit dans l'infidélité, Illustre Président derechef je vous jure, Si vous ne punissez sévèrement l'injure, Faite au grand Jupiter, vous sentirez un jour, L'effet de sa colère au lieu de son amour.
OLIBRE.	OLIBRE.
Aſſemblons le Conſeil pour punir la malice, Et pour déliberer le genre de ſuplice, le ſervirai d’exemple à la poſterité, De zéle & de reſpect pour la Divinité.	Assemblons le Conseil pour punir la malice, Et pour délibérer le genre de suplice, le servirai d'exemple à la postérité, De zèle et de respect pour la Divinité.
33 aΝρרυχ lωy Νυγ ΜΝMy NUYV NυYV IANVEVVOY NVIN Cyne ae 6  re ( Mamaxs	33 aΝρרυχ li „ 7Mi NUYV NIU IANVEUVOY NVIN Cyne ae 6 re ( Amaxs
SCENE IV.	SCÈNE IV.
OLIBRE, CLEMENT, HILDERIC, CHARLES.	OLIBRE, CLEMENT, HILDERIC, CHARLES.
mtouen;	mtouen;
Curauſe, Lutine, Savin, Theopiſte, Kilie, Gardes.	Curause, Lutine, Savin, Théopiste, Kilie, Gardes.
OLIBRE.	OLIBRE.
Uguſte Sénateurs, vénerable Aſſemblée, (ATres -illuſtres Seigneurs géneraux de l’Armée Aprés avoir dompté les Saxons furieux, Aſſiſtés du ſecours & faveur de nos Dieux, Si nous les déſirons toûjours avoir propices, Il faut leur deffèrer des notables ſervices;	AUguste Sénateurs, vénérable Assemblée, (ATres -illustres Seigneurs géneraux de Armée Aprés avoir dompté les Saxons furieux, Assistés du secours et faveur de nos Dieux, Si nous les désirons toûjours avoir propices, Il faut leur deffèrer des notables services;
Céſar & le Sénat, & l’empire Romain, Pour le culte des Dieux m’ont mis la force en main, e ne puis ſans regret uſer de violence, Et forcer mon humeur portée à la clémence:	César et le Sénat, et l'empire Romain, Pour le culte des Dieux m'ont mis la force en main, ne puis sans regret user de violence, Et forcer mon humeur portée à la clémence:
Mais auſſi je ne puis gouverner ſagement, Si je laiſſe régner le vice impunément, Nosgrãds Dieux Souverains protecteurs de l’empire sont dans un tel mépris, l’oſerai-je bien e blaſphême, l’erreur & l’iréligion, Ja rêgner deſormais dans cette région;	Mais aussi je ne puis gouverner sagement, Si je laisse régner le vice impunément, Nosgrãds Dieux Souverains protecteurs de l'empire sont dans un tel mépris, l'oserai-je bien é blasphême, l'erreur et l'iréligion, Ja rêgner désormais dans cette région;
l eſt donc important d’uſer de diligence Q 111 qia our retrancher l’excés d’une telle inſolence, le vous ai convoqué pour hoiſir mouvement, Les iorells dobvier à ce comencemcie.	l est donc important d'user de diligence Q 111 our retrancher excés une telle insolence, le vous ai convoqué pour hoisir mouvement, Les iorells dobvier ce comencemcie.
CLEMENT.	CLEMENT.
Les Chrétiens ont ſéduit ma fille & ſa nourrice, ’en demande raiſon j’en veux avoir juſtice.	Les Chrétiens ont séduit ma fille et sa nourrice, en demande raison en veux avoir justice.
HILDERIC.	HILDERIC.
Q uor pouvons nous iourrir que les enfans des Rois, Soient ainſi dévoïës de nos anciennes Loix?	 Quor pouvons nous jourrir que les enfants des Rois, Soient ainsi dévoïës de nos anciennes Lois?
CHARLES.	CHARLES.
I’expoſerai mes biens & ma perſonne même, Pour arrêter le cours de ce nouveau blaſphême:	J'exposerai mes biens et ma personne même, Pour arrêter le cours de ce nouveau blâme:
Mais le grand Jupiter qui préſide aux combats Mettra par ſon pouvoir ſes ennemis à bas.	Mais le grand Jupiter qui préside aux combats Mettra par son pouvoir ses ennemis à bas.
A LBAIN.	À LBAIN.
Les Loix ne ſoûfrent pas qu’on prononce ſentence Contre qui que ce foit lans grande connoiſſance;	Les Lois ne soufrent pas qu'on prononce sentence Contre qui que ce soit lans grande connaissance;
Si le crime eſt énorme il le faut retrancher, Examinés plûtôt s’il eſt grand ou léger.	Si le crime est énorme il le faut retrancher, Examinez plutôt s'il est grand ou léger.
CARAUSE.	CARAUSE.
Le crime des Chrétiens ne ſoûfre point d’excuſe Il elt trop en forreur, Oolamdieme l'acuſe.	Le crime des Chrétiens ne souffre point d'excuse Il ellet trop en forreur, Oolamdième l'acuse.
LUCILLE.	LUCILLE.
Quand il ne ſeroit point l’interêt de nos Dieux, On doit exterminer tous les ſéditieux.	Quand il ne serait point l'intérêt de nos Dieux, On doit exterminer tous les séditieux.
SABIN.	SABIN.
Quoi, ferons nous ſoûfrir la mort à cette Reine je la veux proteger, je veux être en ſa peine, Reine digne d’amour, Reine dont la beauté, Participe aux ſplendeurs de la Divinité.	Quoi, ferons nous soupir la mort à cette Reine je la veux protéger, je veux être en sa peine, Reine digne d'amour, Reine dont la beauté, Participe aux splendeurs de la Divinité.
THEOPISTE.	THÉPISTE.
La ſecte des Chrétiens, cette engeance maudite Doit périr au plûtôt ainſi qu’elle mérite, Ces perfides felons, ennemis de nos Dieux, 35 Qui voulant s’élever juſqu’au deſſus des Cieux, Seront humiliés juſqu’au fond de l’abîme;	La secte des Chrétiens, cette engeance maudite Doit périr au plûtôt ainsi qu'elle mérite, Ces perfides félons, ennemis de nos Dieux, 35 Qui voulant s'élever jusqu'au dessus des Cieux, Seront humilités jusqu'au fond de l'abîme;
La raiſon veut qu’ils ſoient traités ſelon leur crime, Céſar & le Sénat les ont déja prererits, En voici les Arrêts nouvellement écrits.	La raison veut qu'ils soient traités selon leur crime, César et le Sénat les ont déjà prérerits, En voici les Arrêts nouvellement écrits.
KILIE.	KILIE.
Ces enfans de la mort, excrémens de la terre, A vos Divinités ont déclaré la guerre, quiconque les ſoûtiens d’un propice regard, Mérite d’encourir le couroux de Céſar.	Ces enfants de la mort, excréments de la terre, À vos Divinités ont déclaré la guerre, quiconque les soutiens d'un propice regard, Mérite d'encourir le courroux de César.
OLIBRE.	OLIBRE.
Tout conclu à la mort, tout conclu au carnage;	Tout conclu à la mort, tout conclu au carnage;
Qu’il ne faut épargner, ni le ſexe, ni l’âge, Ceſar l’a commandé par ſes juſtes Edits, Les Chrêtiens ſõt des Dieux, & des hommes maudits Mais ſur tout nous devons par amour & par haine, Réduire à ſon devoir la jeune fille Reine:	Qu'il ne faut épargner, ni le sexe, ni l'âge, César l'a commandé par ses justes Édits, Les Chrétiens sont des Dieux, et des hommes maudits Mais sur tout nous devons par amour et par haine, Réduire à son devoir la jeune fille Reine:
Commençons ſans tarder la perſécution, Theopiſte eſt chaige de rekccucion.	Commençons sans tarder la persécution, Théopiste est chaige de reccucion.
THEOPISTE prie à genoux.	THÉPISTE prie à genoux.
O grand Dieu Jupiter:	Ô grand Dieu Jupiter:
aidés je vous conjure, Celui qu’on a chargé de vanger vôtre injure.	aidez je vous conjure, Celui qu'on a chargé de venger votre injure.
ENTR'ACTE.	ENTR'ACTE.
Theopiſte & Kilie font changer la face du Theâtre, ut eſt couvert de noir parſemé de Croix & de larmes, tvec des inſcriptions, proſcriptions des chrétiens, maſſare des Chrétiens, & on plante des gibets, on porte ſur le heâtre tous les inſtrumens du ſuplice, les Diables y navaillent, & battent xilie.	Théopiste et Ôte font changer la face du Théâtre, ut est couvert de noir parsemé de Croix et de larmes, tvec des inscriptions, proscriptions des chrétiens, massare des Chrétiens, et on plante des gibets, on porte sur le heâtre tous les instruments du supplice, les Diables y navaillent, et battent xilie.
MMCRMV	MMCRMU
SCENE PREMIERE.	SCÈNE PREMIÈRE.
OLIBRE, HILDERIC, CHARLES, ALBAIN, SABIN, FELIX, PERSE.	OLIBRE, HILDERIC, CHARLES, ALBAIN, SABIN, FELIX, PERSE.
OLIBRE.	OLIBRE.
’Uſe à mon grand regret de la ſéverité, Contre mon naturel plein de bénignité, Mon eſprit agité de l’amour & la haine, Malgré les ſentimens aime la fille Reine, Je cheris ſes appas & ſa perfection, Je déteſte l’erreur de ſa Religion, ’adore ſa vertu, je condamne ſon crime, Je la tiens en mépris, je la tiens en eſtime.	Use à mon grand regret de la sévérité, Contre mon naturel plein de bénignité, Mon esprit agité de l'amour et la haine, Malgré les sentiments aime la fille Reine, Je chéris ses appas et sa perfection, Je déteste l'erreur de sa Religion, adore sa vertu, je condamne son crime, Je la tiens en mépris, je la tiens en estime.
HILDERIC.	HILDERIC.
Je connois cette fille accomplie en beauté, Qui gaigne auſſi le cœur à vôtre Majeſté, Elle porte en naiſſant le beau titre de Reine, La vertu lui promet celui de Souveraine, nu bonte de l’eſprit, la grace & le ſçavoir, Lui promet beaucoup plus qu’un immenſe pou voir	Je connais cette fille accomplie en beauté, Qui gagne aussi le cœur à votre Majesté, Elle porte en naissant le beau titre de Reine, La vertu lui promet celui de Souveraine, nu bonté de l'esprit, la grâce et le savoir, Lui promet beaucoup plus qu'un immense pou voir
CHARLES.	CHARLES.
Le Ciel veut lui donner pour un comble de gloire Un eſprit clair-voïant, une heureuſe mémoire, Des génereux deſſeins, des illuſtres déſirs, Une rare douceur un dégoût des plaiſirs, Un port majeſtueux, une agréable adreſſe, Un aimable entretien, une meure ſageſſe.	Le Ciel veut lui donner pour un comble de gloire Un esprit clair-voïant, une heureuse mémoire, Des génereux desseins, des illustres désirs, Une rare douceur un dégoût des plaisirs, Un port majestueux, une agréable adresse, Un aimable entretien, une meure sagesse.
ALBAIN.	ÀLBAIN.
Un chacun à l’envi lui montre de l’amour, Et recherche ſa grace en lui faiſant la cour, Il n’eſt rien que l’éclat d’une haute puiſſance, Qui puiſſe relever ſon illuſtre naiſſance, Ie ne puis contempler le clair flambeau des Cieux, Sans penſer aux raïons qui luiſent dans ſes yeux, Elle aime mieux mourir que de vivre impudique, Marque de la vertu de ſon ame Angelique.	Un chacun à l'envi lui montre de l'amour, Et recherche sa grâce en lui faisant la cour, Il n'est rien que l'éclat d'une haute puissance, Qui puisse relever son illustre naissance, Je ne puis contempler le clair flambeau des Cieux, Sans penser aux raïons qui luisent dans ses yeux, Elle aime mieux mourir que de vivre impudique, Marque de la vertu de son âme Angélique.
SABIN.	SABIN.
Pour gaigner un eſprit noble comme ſe ſien, Il laut etre prodigue & de gloire & de bien;	Pour gagner un esprit noble comme se sien, Il laut être prodigue et de gloire et de bien;
O qu’elle cruauté!	Ô qu'elle cruauté!
ô qu’elle noire envie!	ô qu'elle noire envie!
De vouloir attaquer ſon innocente vie.	De vouloir attaquer son innocente vie.
OLIBRE.	OLIBRE.
Faites paroître ici ce reluiſane obieir, Cét aſtre de beauté, ce flambeaux nompareil, Je le veux precedé, il eſt de reſiſtance, Qui ne céde à l’amour plus qu’à la violence.	Faites paraître ici ce reluisane obieir, Cet astre de beauté, ce flambeaux nompareil, Je veux le précédé, il est de résistance, Qui ne cède à l'amour plus qu'à la violence.
PERSE.	PERSE.
Vous verrés un Soleil dont l’avantageux ſort, Et les nobles vertus vous raviront d’abord, 2 Auprés de ſa clarté le Soleil paroît ſombre, ;	Vous verrez un Soleil dont l'avantageux sort, Et les nobles vertus vous raviront d'abord, 2 Auprès de sa clarté le Soleil paraît sombre, ;
A l’égard de ſon teint, tout autre n’eſt qu’un ombre.	À l'égard de son teint, tout autre n'est qu'un ombre.
SCENE II.	SCÈNE II.
OLIBRE, REINE, AGATON, HILDERI CAnO Charles, Albain, Carauſe, Lucille, Sabin, Eugene, Porfie, Clodian, Felix, Perſe.	OLIBRE, REINE, AGATON, HILDERI CAnOI Charles, Albain, Carause, Lucille, Sabin, Eugène, Porfie, Clodian, Félix, Perse.
y Enerable adorable raïon de la Divinité, V Maîtreſſe de nos cœurs, ſanspareille en beauté Qui faits aux grands eſprits admirer ſon Empire, C’eſt pour te poſſeder qu’ardamment je ſoûpire, Reine dont les appas ont ravi tous mes ſens, Veux-tu pas contenter mes déſirs innocens, Apaiſer cette ardeur, éteindre cette flâme, Qui me brûle le cœur & conſume mon ame, Ma gloire, mon pouvoir, & mes biens ſeront tiens Quand tu mépriſeras le parti des Chrétiens.	y Enerable adorable raïon de la Divinité, V Maîtresse de nos cœurs, sanspareille en beauté Qui faits aux grands esprits admirer son Empire, C'est pour te posséder qu'ardamment je soupire, Reine dont les appas ont ravi tous mes sens, Veux-tu pas contenter mes désirs innocents, Apaiser cette ardeur, éteindre cette flamme, Qui me brûle le cœur et consume Ma gloire, Mon pouvoir, mon pouvoir, et mes biens seront tiens Quand tu mépriseras le parti des Chrétiens.
REINE.	REINE.
Esus eſt mon Epoux, je l’aime & je l’honore, Lui ſeul eſt mon vrai Dieu, c’eſt lui ſeul que j’adore Il m’aime infiniment puis qu’il eſt mort pour moi, Et je mourrai plûtôt que lui fauſſer ma Foi.	Esus est mon Époux, je l'aime et je l'honore, Lui seul est mon vrai Dieu, c'est lui seul que j'adore Il m'aime infiniment puis qu'il est mort pour moi, Et je mourrai plutôt que lui fausser ma Foi.
OLIBRE.	OLIBRE.
I te Taut maintenant retracter cette envle, Renoncer à Jeſus ou bien perdre la vie;	I te Taut maintenant rétracter cette envle, Renoncer à Jésus ou bien perdre la vie;
Les ennemis des Dieux ſont en proſcription, Les gibets ſont plantés pour l’exécution.	Les ennemis des Dieux sont en proscription, Les gibets sont plantés pour l'exécution.
REINE.	REINE.
Les démons aujourd’hui ſous des viſages d’hommes Ont réduit les élûs en l’état où nous ſommes, Heureux ceux dont la mort a les jours terminés, Devant que d’avoir vû nos Autels prophanés:	Les démons aujourd'hui sous des visages d'hommes Ont réduit les élus en l'état où nous sommes, Heureux ceux dont la mort a les jours terminés, Devant que d'avoir vu nos Autels prophanés:
O Chrétiens dans l’état de ces cruels carnages, Relevés vos eſprits, redoublés vos courages, Sur des ſimples Brebis on voit fondre des Loups, Il nous faut ſurmonter leur rage & leur courroux, Ie ſuis prête à mourir fortement réſoluë, Je vois bien maintenant que mon heure eſt venuë, raut in que le vrai Dieu ſoit ainſi en mépris, Qu’on preſente l’encens à des malins eſprits.	Ô Chrétiens dans l'état de ces cruels carnages, Relevés vos esprits, redoublés vos courages, Sur des simples Brebis on voit fondre des Loups, Il nous faut surmonter leur rage et leur courroux, Je suis prête à mourir fortement résolue, Je vois bien maintenant que mon heure est venue, raut in que le vrai Dieu soit ainsi en mépris, Qu'on présente l'encens à des malins esprits.
OLIBRE.	OLIBRE.
Ton diſcours ſi léger, ta parolle volage, N’eſt rien qu’un foible élans de ton ſexe & ton âge, Fais paroître aujourd’hui le trait d’un ſage eſprit, Adore nos grands Dieux, renonce à Jeſus-Chriſt.	Ton discours si léger, ta parolle volage, est rien un foible élans de ton sexe et Ton âge, Dis cours aujourd’y lé trait un sage esprit, Ta nos grands Volage, Né Sus-Christ.
RLINE.	RLINE.
Je ſoûfrirai plûtôt les rigoureuſes flâmes, Que d’offencer jamais le Sauveur de nos ames,	Je souffrirai plutôt les rigoureuses flammes, Que d'offenser jamais le Sauveur de nos âmes,
OLTENE.	OLTENE.
Du moins puis que je t’aime & te fais tant la cour, Que je ſois avec lui l’objet de ton amour.	Du moins puis que je t'aime et te fais tant la cour, Que je sois avec lui l'objet de ton amour.
REINE.	REINE.
C’eſt l’effet d’une Epouſe & d’une Vierge ſage, De n’être en ſon amour ſi changeante & volage;	C'est l'effet d'une Épouse et d'une Vierge sage, De n'être en son amour si changeante et volage;
Jeſus eſt un tres-Saint & tres-fidel Epoux, De ma virginité infiniment jaloux, Il eſt l'ynique Fils procedant d’un ſeul Pere, Commeil eſt dans le temps né d’une Vierge Mere, Il doit avoir tout ſeul & mes ſoins, & mes vœux, Mon cœur & mon eſprit fonft brures par les ſeux	Jésus est un très-Saint et très-fidel Époux, De ma virginité infiniment jaloux, Il est l'ynique Fils procédant d'un seul Père, Commeil est dans le temps né d'une Vierge Mère, Il doit avoir tout seul et mes soins, et mes vœux, Mon cœur et mon esprit fonfait brures par les seux
OLIBRE.	OLIBRE.
Je vois bien maintenant à ta ſimple parole, Que tu as peu de ſens, que tu n’eſt qu’une folle Auſſi bien que ton Dieu lequel comme un vrai fol.	Je vois bien maintenant à ta simple parole, Que tu as peu de sens, que tu n'est qu'une folle Aussi bien que ton Dieu lequel comme un vrai fol.
A mieux aimé charger une Croix ſur ſon col, Et pouvant juſtement s’échaper & défendre, s'eit par ſes ennemis fait condamner & pendie.	À mieux aimé charger une Croix sur son col, Et pouvant justement s'échapper et défendre, s'eit par ses ennemis fait condamner et pendie.
REINE.	REINE.
Je ſuis comme un Soleil-reluiſant en clarté, Poſſede les honneurs de la Divinité;	Je suis comme un Soleil-reluisant en clarté, Possède les honneurs de la Divinité;
La Croix eſt un effet de ſa haute ſcience, JEsus veut y mourir par un trait de prudence:	La Croix est un effet de sa haute science, JEsus veut y mourir par un trait de prudence:
La Croix eſt le ſalut de tout le genre humain, La Croix va triompher de l’Empire Romain, La Croix eſt le ſujet des plus hautes loüanges, Et l’adorable objet que célebrent les Anges;	La Croix est le salut de tout le genre humain, La Croix va triompher de l'Empire Romain, La Croix est le sujet des plus hautes langes, Et l'adorable objet que célèbrent les Anges;
La Croix par un effort de ſes charmes vainqueurs, Mhellunce la lallon, e captive les ceeurs.	La Croix par un effort de ses charmes vainqueurs, Mhellunce la llon, eût captive les ceeurs.
Jeſus-Chriſt en la Croix ſera malgré l’envie, Reconnu le vrai Dieu ſeul Auteur de la vie.	Jésus-Christ en la Croix sera malgré l'envie, Reconnu le vrai Dieu seul Auteur de la vie.
OLIBRE.	OLIBRE.
Il ne nous eſt permis d’adorer un pendu, Dans l’empire Romain, Céſar l’a défendu;	Il ne nous est permis d'adorer un pendu, Dans l'empire Romain, César l'a défendu;
Etrange avettg femene , qu'enle runeite envie, De tenir un pendu pour l’Auteur de la vie:	Etrange avettg femene , qu'enle runeite envie, De tenir un pendu pour l'Auteur de la vie:
Ma fille écoûte-moi, ſois ſoûmiſe à nos Loix, Si tu ne veux mourir comme lui dans la Croix.	Ma fille écoute-moi, sois soumise à nos Lois, Si tu ne veux mourir comme lui dans la Croix.
REINE.	REINE.
De le ſuivre en la Croix, c’eſt ce que je déſire, je ne mérite pas la palme de Martire;	De le suivre en la Croix, c'est ce que je désire, je ne mérite pas la palme de Martyre;
Quand je devrois mourir mille fois chaque jour, e ne changerai pas l’objet de mon amour, li la faim, ni la ſoif, ni la tranchante lame, ſe pouront arracher Jeſus-Chriſt de mon ame:	Quand je devrais mourir mille fois chaque jour, ne changerai pas l'objet de mon amour, li la faim, ni la soif, ni la tranchante lame, se pourront arracher Jésus-Christ de mon âme:
Adore qui voudra l’infame Jupiter, Qui contre Jeſus-Chriſt ne pourra ſubſiſter, Divinités de bois, & de fer, & de pierre, Qui ne ſçavent oüir aucune humble priére;	Adore qui voudra l'infâme Jupiter, Qui contre Jésus-Christ ne pourra subsister, Divinités de bois, et de fer, et de pierre, Qui ne savent ouïr aucune humble prièvre;
Pour voir s’ils ſont muets, ſans force & mouvement, Ie les vais renverſer par terre hardiment.	Pour voir s'ils sont muets, sans force et mouvement, Je les vais renverser par terre hardiment.
OLIBRE.	OLIBRE.
Arrêtés-la Soldats, qu’elle ſoit attachée, A ce triſte poteau de mille coups touchée, e jure par nos Dieux, je la ferai mourir, en veux venir à bout quand j’y devrois périr.	Arrêtez-la Soldats, qu'elle soit attachée, À ce triste poteau de mille coups touchée, jure par nos Dieux, je la ferai mourir, en veux venir à bout quand j'y devrais périr.
AGATON.	AGATON.
Je ſuis auſſi Chrétien, ô mal-heureux Olibre!	Je suis aussi Chrétien, ô malheureux Olibre!
e lutb ertroncrer eni Dioils prtis irilitriiſeri qee di l'igre;	Je lutb ertroncrer eni Oïls prétis irilitriiseri qée di 'igre;
Ma Reine eſt innocente, ô dragon furieux!	Ma Reine est innocente, ô dragon furieux!
e te veux arracher de ma main les deux yeux.	Je te veux arracher de ma main les deux yeux.
HILDERIC.	HILDERIC.
Retenès cét Enfant, ce trop peu de ſageſſe, Vient du trop grand amour qu’il a pour ſa maîtreſſe	Retenès cet Enfant, ce trop peu de sagesse, Vient du trop grand amour qu'il a pour sa maîtresse
OLIBRE.	OLIBRE.
Frapés bourreaux frapés, redoublés vos efforts, Ne laiſſés ſans bleſſure aucun membre du corps.	Frappez bourreaux frappés, redoublés vos efforts, Ne laissés sans blessure aucun membre du corps.
REINE.	REINE.
Onibre j’aime mieux tes coups que tes careſſes, Ils ſont de mon Epoux les plus douces tendreſſes, leſus mon cher Epoux, mon Sauveur, mon vrai Dieu le vous adorerai, en tout temps, en tout lieu.	Onibre j'aime mieux tes coups que tes caresses, Ils sont de mon Époux les plus douces tendresses, lesus mon cher Époux, mon Sauveur, mon vrai Dieu le vous adorerai, en tout temps, en tout lieu.
OLIBRE.	OLIBRE.
Frapés plus fortement, ſur le ſeln, ſur la face:	Frapés plus fortement, sur le seln, sur la face:
REINE.	REINE.
Olibre je ne craint tes coups ni tes menaces, J’ai mis tout mon eſpoir en vous ſeul mon Epoux, e Plelas!	Olibre je ne craint tes coups ni tes menaces, J'ai mis tout mon espoir en vous seul mon Époux, é Las!
Iecoures-mor, cal je louire pour vous.	Jecoures-mór, cal je louire pour vous.
OLIBRE.	OLIBRE.
Qu’elle ſoit hautement en la Croix élevée, Par des griffes de fer fortement éprouvée;	Qu'elle soit hautement en la Croix élevée, Par des griffes de fer fortement éprouvée;
Qu’on lui brûle les flancs, qu’on aporte des feux, o Qu’on lui faſſe ſoûfrir des tourmens furieux.	Qu'on lui brûle les flancs, qu'on apporte des feux, ou Qu'on lui fasse souffrir des tourments furieux.
HILDERIC.	HILDERIC.
Reine dont les appas, le attraits & les charmes, Ont vaincu plus de Rois que l’effort de nos armes, Veux-tu perdre l’éclat de cette Majeité, Qui te fait ſurpaſſer les Rois en dignité.	Reine dont les appas, le attraits et les charmes, Ont vaincu plus de Rois que l'effort de nos armes, Veux-tu perdre l'éclat de cette Majité, Qui te fait surpasser les Rois en dignité.
CHARLES.	CHARLES.
Reine deſirés vous périr comme une folle, Tourquol le quittes-vous ee leſemnene Mrvole, Ceſſés de mépriſer la grandeur de nos Dieux, Adorés Jupiter ce Monarque des Cieux.	Reine désirez vous périr comme une folle, Tourquol le quittes-vous ce lesemnène Mrvole, Cessés de mépriser la grandeur de nos Dieux, Adorez Jupiter ce Monarque des Cieux.
ALBAIN.	ÀLBAIN.
Reine dont la beauté reluit comme un bel aſtre, Que je ſuis affligé quand je vois ton deſaſtre, Touché de la douleur & regret de tes maux, je verie demes yeux des pieurs à granlds ruineaux.	Reine dont la beauté reluit comme un bel astre, Que je suis affligé quand je vois ton désastre, Touché de la douleur et regret de tes maux, je vérie de yeux des pieurs à granlds ruinex.
CARAUSE.	CARAUSE.
Reine je ſuis armé pour ta juſte défence, Si tu veux à nos Dieux rendre l’obeïſſance.	Reine je suis armé pour ta juste défense, Si tu veux à nos Dieux rendre l'obéissance.
G1.	G1.
LUCILLE.	LUCILLE.
Toi qui peut t’élever d’un vol ambitieux, Dans les plus grands honneurs qui ſoſent deſſous les Cieux, Au lieu d’avoir égard à la grande Nobleſſe, Tu veux dégenerer du titre de Princeſſe;	Toi qui peut t'élever d'un vol ambitieux, Dans les plus grands honneurs qui sosent dessous les Cieux, Au lieu d'avoir égard à la grande Noblesse, Tu veux dégénérer du titre de Princesse;
Renonce à Jeſus-Chriſt, Reine conſerve-toi, Adore nos gralds Dleux, emorane notre Lol.	Renonce à Jésus-Christ, Reine conserve-toi, Adore nos gralds Dleux, émorane notre Lol.
SABIN.	SABIN.
O quel aveuglement!	Ô quel aveuglément!
quelle erreur te convie, De mépriſer ainſi les douceurs de la vie, Vouloir plûtôt ſoûfrir une ſanglante mort, Que déteſter l’Auteur de ſon funeſte ſort;	quelle erreur te convie, De mépriser ainsi les douceurs de la vie, Vouloir plutôt soufrir une sanglante mort, Que détester l'Auteur de son funeste sort;
Renonce à Jeſus-Chriſt qui t’expoſe au carnage, Adore Jupiter pour faire un trait de ſage, l'ourquoi te fondes-tu bur Jeſus ton Epoux, Qui pour te maintenir paroît ſi peu jaloux.	Renonce à Jésus-Christ qui t'expose au carnage, Adore Jupiter pour faire un trait de sage, l'ourquoi te fondes-tu bur Jésus ton Époux, Qui pour te maintenir paraît si peu jaloux.
EUGENIE.	EUGÉNIE.
Auguſte Deïté, vénerable Princeſſe, Teutrraguta poahle esui d'et condre jeunciie;	Auguste Dé, vénérable Princesse, Teutraguta pohle esvi d'et condre jeunciie;
On conſpire à te perdre, on conjure ta mort, Ton Dieu pour te ſauver ne fait aucun effort.	On conspire à te perdre, on conjure ta mort, Ton Dieu pour te sauver ne fait aucun effort.
REINE.	REINE.
Vos diſcours ſont mauvais, vôtre amour eſt funeſte Qui veut me ſeparer de mon amour céleſte, Vous m’êtes ennemis & trop injurieux, De me perſuader le culte des faux-Dieux, l’aime mieux expoſer aux ardeurs de la flâme, La beauté de mon corps que de perdre mon ame, ſvion Epoux pour le prix de ma fidelité, Me fera part aux dons de ſa Divinité, Si j’expoſe mon corps à la mort temporelle, Mon eſprit joüira de la vie éternelle.	Vos discours sont mauvais, votre amour est funeste Qui veut me séparer de mon amour céleste, Vous m'est ennemis et trop injurieux, De me persuader le culte des faux-Dieux, l'aime mieux exposer aux ardeurs de la flamme, La beauté de mon corps que de perdre mon âme, susion Époux pour le prix de ma fidélité, Me fera part aux dons de sa Divinité, Si j'expose mon corps à la mort temporelle, Mon esprit jouira de la vie éternelle.
OLIBRE.	OLIBRE.
Voïés les ſentimens d’un eſprit forcené, admire les élans de ce cœur obſtiné, Malgré les bons avis élle eſt plus endurcie, A mépriſer les Loix de l’empereur Decie, Cette ingrate & farouche aprés tant de mépris, A cauſé ce tranſport de haine à mes eſprits;	Voïés les sentiments d'un esprit forcené, admire les élans de ce cœur obstiné, Malgré les bons avis élle est plus endurcie, A mépriser les Lois de l'empereur Décie, Cette ingrate et farouche après tant de mépris, A causé ce transport de haine à mes esprits;
Ma collère eſt tres-juſte, elle m’eſt trop cruelle, D’avoir tant en horreur un Amant ſi fidéle:	Ma collère est très faute, elle m'est trop cruelle, D'avoir tant en horreur un Amant si fidèle:
Frapés boureaux frapes, mettés-la toute en ſans Appliqués lui des fers pour lui brûler les flancs.	Frappez boureaux frappes, mettés-la toute en sans Appliqués lui des fers pour lui brûler les flancs.
REINE.	REINE.
Secourés moi mon Dieu, ſoïés moi favorable, La rigueur des tourmens me ſera ſuportable, Je ne ſens aucun mal, je n’ai point de douleur, Mon Ange a de ce feu moderé la chaleur, E’sus mon cher Epoux de qui je ſuis chérie, M’a de tous mes ennuis en un inſtant guërie.	Secourez moi mon Dieu, soïés moi favorable, La rigueur des tourments me sera supportable, Je ne sens aucun mal, je n'ai point de douleur, Mon Ange a de ce feu modéré la chaleur, Esus mon cher Époux de qui je suis chérie, M'a de tous mes ennuis en un instant guérie.
OLIBRE.	OLIBRE.
Sorciére tu deviens par tes enchantemens, Ihſenſible aux douleurs des plus cruels tourmens, Tu ne ſens pas le feu mal-heureuſe incenſée, je veux voir ſi par l’eau tu ſeras offencée.	Sorciére tu deviens par tes enchantements, Ihensible aux douleurs des plus cruels tourments, Tu ne sens pas le feu malheureuse incensée, je veux voir si par l'eau tu seras offensée.
REINE.	REINE.
Celui qui des flambeaux peut éteindre l’ardeur, Peut auſſi bien des eaux modérer la froideur, J’entrerai dans cét eau m’yplongeant de moi même Afin qu’elle me ſoit comme un ſecond Baptême, Mon Epoux Tout-puiſſant du haut trône des Cieux, M’aide de ſon ſecours je le vois de mes yeux, Je dois vous adorer Divine Providence, Qui dans tous mes beſoins veilles pour ma deffence Mon tres-fidel Epoux Jeſus-Chriſt mon vrai Dieu, Qui preſervés mon corps contre l’ardeur du feu, Apellés-moi vers vous, je n’aime plus à vivre, Ie déſire mourir au plûtôt pour vous ſuivre, Et joüir dans le Ciel du vrai contentement, loſſedant la beaute de mon idel Amant.	Celui qui des flambeaux peut éteindre l'ardeur, Peut aussi bien des eaux modérer la froideur, J'entrerai dans cet eau m'yplongeant de moi même Afin qu'elle me soit comme un second Baptême, Mon Époux Tout-puissant du haut trône des Cieux, M’aide de son secours je le vois de mes yeux, Je dois vous adorer Divine Providence, Qui dans tous mes besoins veilles pour ma défense Mon très-fidel Acoux Jésus-Christ mon vrai Dieu, Qui préservez mon corps contre l'ardeur du feu, Apellés-moi de mes, je aime plus vivre, Je n' ai me plus à vous ivre, Et joüir dans le Ciel du vrai contentement, lossedant la beauté de mon idel Amant'
OLIBRE.	OLIBRE.
Je ſuis laſſé de voir tant de ſorcellerie, Je ne puis plus ſoûfrir une telle furie, dù fort vontentera toute ma paſſion, le deſtine demain pour l’execution.	Je suis lassé de voir tant de sorcellerie, Je ne puis plus souffrir une telle furie, dU fort vontentera toute ma passion, le destine demain pour l'exécution.
SCENE III.	SCÈNE III.
OLIBRE, EVGENIE, THEOPISTE.	OLIBRE, EUGÉNIE, THÉPISTE.
OLIBRE.	OLIBRE.
Ui je veux voir mourir cette beauté cruelle, ODont jadis les attraits me tenoient en cervelle le veux voir de mes yeux ternir ce grand éclat, Qui cauſe dans mon cœur un ſi ſanglant combat, Enfin tu périras digne objet de ma haine, rarec que trop Iong cemps cume eiens dans la gene.	Oui je veux voir mourir cette beauté cruelle, ODont jadis les attraits me tenaient en cervelle le veux voir de mes yeux ternir ce grand éclat, Qui cause dans mon cœur un si sanglant combat, Enfin tu périras digne objet de ma haine, rarec que trop Jong cemps cume eiens dans la gene.
EUGENIE.	EUGÉNIE.
Sire il ne ſera plus au monde de beauté, Sortable à la grandeur de vôtre Majeſté.	Sire il ne sera plus au monde de beauté, Sortable à la grandeur de votre Majesté.
OLIBRE.	OLIBRE.
Pourquoi me parle-tu d’un objet qui me tuë, Ma vertu ſous ſa Loi paroît être abbatuë, Je penſe encore un coup à cét objet ſi doux, L’amour fait un effort pour vaincre mon courroux La raiſon me canvaint, le devoir me ſurmonte, L’amour par ſes élans me fait rougir de honte, Mais malgré ce tranſport & le reſpect humain, Je vengerai les Dieux de l’empire Romain;	Pourquoi me parle-tu d'un objet qui me tue, Ma vertu sous sa Lois paraît être abattue, Je pense encore un coup à cet objet si doux, L'amour fait un effort pour vaincre mon courroux La raison me canvaint, le devoir me surmonte, L'amour par ses élans me fait rougir de honte, Mais malgré ce transport et le respect humain, Je venger les Dieux de l'empire Romain;
Amour déſordonné, malgré ta tirannie, Nous verrons aujourd’hui la malice punie, Ce zéle pour nos Dieux plein de ſéverité, Me rendra tres-fameux chés la poſterité:	Amour désordonné, malgré ta tyrannie, Nous verrons aujourd'hui la malice punie, Ce zèle pour nos Dieux plein de sévérité, Me rendra très-fameux chez la postérité:
Souveraine beauté faut-il que tu périſſe, Pourquoi te jette-tu dans un tel précipice?	Souveraine beauté faut-il que tu périsse, Pourquoi te jette-tu dans un tel précipice?
Pourquoi refuſe-tu le reſpect à nos Dieux?	Pourquoi refuse-tu le respect à nos Dieux?
Pourquoi m’arrache-tu les larmes de mes yeux?	Pourquoi m'arrache-tu les larmes de mes yeux?
Je fremis de regret te voïant dans la ruïne, Par un aveuglement ton eſprit ſe mutine;	Je frémis de regret te voïant dans la ruine, Par un aveuglement ton esprit se mutine;
Ie voudrois de bon cœur ſoûfrir la mort pour toi, arii de ce lauver des Mactxx od je ce volo, Mal-heureuſe beauté, pourquoi t’ai-je connuë, Pourquoi ſur ſes beaux yeux ai-je arrêté ma vûë.	Je voudrais de bon cœur soûfrir la mort pour toi, ari de ce laver des Mactx od je ce volo, Malheureuse beauté, pourquoi t'ai-je connue, Pourquoi sur ses beaux yeux ai-je arrêté ma vue.
THEOPISTE.	THÉPISTE.
Quels ètrangesdiſcours, quelle changeantehumeur cont-ce les ſentimens dignes d’un ſi grand cœur, L’interêt de nos Dieux, & leur juſte défence, Ne doit plus ſuporter une ſi grande offence, Il faut vaincre l’erreur de cette paſſion.	Quels Êtrangesdiscours, quelle changeantehumeur conteur-ce les sentiments dignes d'un si grand cœur, L'intérêt de nos Dieux, et leur juste défense, Ne doit plus supporter une si grande offense, Il faut vaincre l'erreur de cette passion.
OLIBRE.	OLIBRE.
Je t’ai déja commis cette éxecution, Les Dieux en ſont auteurs & le Pontife même, Doit prononcer l’Arrêt pour vanger ce blaſphême, Reçois pour cette fin mon glaive & mon pouvoir, Ma colére a paſſé les bornes du dévoir.	Je t'ai déjà commis cette éxecution, Les Dieux en sont auteurs et le Pontife même, Doit prononcer l'Arrêt pour venger ce blasphomme, Reçois pour cette fin mon glaive et mon pouvoir, Ma colère a passé les bornes du dévoir.
SCENE III.	SCÈNE III.
FELIA, TERSE, CLODIAN SABIN.	FELIA, TERSE, CLODIAN SABIN.
FELIX.	FELIX.
Stres du Firmament cachés vôtre lumiére, TASoleilpouvésvous bien la donner toute entiére Commentpouvés-vousvoir nos ſanglots & nos pleurs Sans rien diminuër de vos claires ſplendeurs?	Stres du Firmament cachez votre lumièvre, TASoleilpouvésvous bien la donner toute entiére Commentpouvés-vousvoir nos sanglots et nos pleurs Sans rien diminuer de vos claires splendeurs?
Ne contemplés-vous pas un ſpectacle tragique, Un objet plein d’horreur, une Vierge pudique, ’alouſe de l’honneur & de la pureté, Eprouver les rigueurs d’un Tiran irrité?	Ne contemplez-vous pas un spectacle tragique, Un objet plein d'horreur, une Vierge pudique, 'alouse de l'honneur et de la pureté, Éprouver les rigueurs d'un Tyran irrité?
Pourquoi ne couvres-vous vôtre front de nuages, Oſés-vous ſans fraïeur contempler ſes dommages, Voir couler de ſon corps, ſi pur, ſi ſaint, ſi beau, Des riviéres de ſang par la main d’un boureau, Une Auguſte Princeſſe, une Vierge ſoûfrante, Un Tiran ennemi d’une Fille innocente, Une Vierge tres-Sainte & parfaite en beauté, Un eſprit tout divin, un Ange en pureté, Vierge quant à ſon corps & d’une ame ſi pure, Qu’elle aime mieux mourir que ſoûfrir de ſoüillure Elle prend de ſon Dieu la deffence en ſa main, Contre tous les efforts de l’empire Romain, Que tous les Elemens, & le Ciel, & la Terre, Contr’elle ſoûlevés lui déclarent la guerre, Son cœur plus que viril ſoûtiendra contre tous, La gloire & le renom de JESUS ſon Epoux:	Pourquoi ne couvre-vous votre front de nuages, Usez-vous sans fraïeur contempler ses dommages, Voir couler de son corps, si pur, si saint, si beau, Des riviéres de sang par la main d'un boureau, Une Auguste Princesse, une Vierge souffrante, Un Tyran ennemi d'une Fille innocente, Une Vierge très-Sainte et parfaite en beauté, Un esprit tout divin, un Ange en pureté, Vierge quant à son corps et d'une âme si pauvre, Qu'elle aime mieux mourir que souffrir de soüillure Elle prend de son Dieu la deffence en sa main, Contre tous les efforts de empire Romain, Que tous les Elemens, et le Ciel, et la Terre, Contr’elle soûlevés lui déclarent la guerre, Son cœur plus que viril soûtiendra contre tous, La gloire et le renom de JESUS son Epoux:
Infame, criminel;	Infâme, criminel;
fol, de l’avoir frapée, Vierge digne d’honneur, Illuſtre en ſainteté, Je connois à preſent ta grande dignité;	fol, de l'avoir frappée, Vierge digne d'honneur, Illustre en sainteté, Je connais à présent ta grande dignité;
Reine je ſuis Chrétien, je connois l’innocence, De ton Dieu Jeſus-Chriſt j’adore ſa puiſſance, J’aime la verité, je proteſte la Foi, Je déſire ſoûfrir le martire avec toi :	Reine je suis Chrétien, je connais l'innocence, De ton Dieu Jésus-Christ j'adore sa puissance, J'aime la vérité, je proteste la Foi, Je désire souffrir le martyre avec toi :
Reine pardonne-moi cette grande inſolence, Obtient-moi de ton Dieu pardon de mes offences	Reine pardonne-moi cette grande insolence, Obtient-moi de ton Dieu pardon de mes offenses
PERSE.	PERSE.
Déteſtable forfait, quel lâche aveuglement, M’a porté dans l’excés d’un tel déreglement, Plus cruel qu’un Lion par un amour tres-libre, ’ai ſervi d’inſtrument aux volontés d’Olibre, Reine dont la vertu, la gloire & ſainteté, Les eſprits bien-heureux, égalle en dignité, Je gémis, mais trop tard, du regret de tes pertes, C’eſt de ma propre main que tu les as ſoûfertes, Je mérite les fers d’une noire priſon, D’avoir tant excedé les Loix de la raiſon, Par une cruauté qui n’eût jamais d’exemple, Sur toi du Saint Eſprit j’ai prophané ce Temple, De t’avoir fait ſoûfrir, & le fer, & le feu, Pour te faire quiter le reſpect de ton Dieu, De ton Dieu Tout-puiſſãt qui n’a pointde ſemblable Le Redempteur Jeſus ton Epoux tant aimable;	Détestable forfait, quel lâche aveuglement, M'a porté dans l'excès d'un tel dérèglement, Plus cruel qu'un Lion par un amour très -libre, aai servi d'instrument aux volontés d'Olibre, Reine dont la vertu, la gloire et sainteté, Les esprits bien-heureux, égale en dignité, Je gémis, mais trop tard, du regret de tes pertes, C'est de ma propre main que tu les as soûfertes, Je mérite les fers d'une noire prison, D'avoir tant excédé les Lois de la raison, Par une cruauté qui n'eût jamais exemple, Sur toi du ' Esprit ai prophané ce Temple, De avoir fait soûfrir, et le fer, et le feu, Pour te faire quiter le respect de ton Dieu, De ton Dieu Tout-puissãt qui a pointde semblable Le Redempteur Jesus ' Ex tant em;
J’ai combatu pour ceux qui n’ont rien de Divin.	J'ai combattu pour ceux qui n'ont rien de Divin.
Et contre le vrai Dieu j’ai vomi ce venin:	Et contre le vrai Dieu j'ai vomi ce venin:
De nos Divinités je connois l’impuiſſance, Ils n’ont rien de Divin qu’une vaine aparence, Des Dieux privés d’eſprit, de ſens & de raiſon, Qui n’ont ni mouvement, ni mains, ni voix, ni ſon, Des Dieux plus incenſés que les plus lourdes bêtes, Que nous voïons mugir quand on frape leur tête;	De nos Divinités je connais l'impuissance, Ils n'ont rien de Divin qu'une vaine apparence, Des Dieux privés d'esprit, de sens et de raison, Qui n'ont ni mouvement, ni mains, ni voix, ni son, Des Dieux plus incensés que les plus lourdes bêtes, Que nous voïons mugir quand on frappe leur tête;
Jne Fille a caſſé la tête à Jupiter, Et fait voir qu’un tel Dieu ne ſçauroit ſubſiſter:	June Fille a cassé la tête à Jupiter, Et fait voir qu'un tel Dieu ne saurait subsister:
Noble Divinté digne d’un grand empire, Tu nous as ce jourd’hui donné ſujet de riré;	Noble Divinté digne d'un grand empire, Tu nous as ce jourd'hui donné sujet de riré;
leſus-Chriſt au contraire à qui tout obeït, De ſon tres-grand pouvoir m’a convaincu l’eſprit?	lesus-Christ au contraire à qui tout obéir, De son très-grand pouvoir m'a convaincu l'esprit?
ll a de leurs travaux délivré les fidéles, Et leur a préparé des faveurs éternelles, e renõce auxfaux.	ll a de leurs travaux délivré les fidèles, Et leur a préparé des faveurs éternelles, e renonce auxfaux.
Dieux, jeveux mourir Chrétien Car je veux deſormais eſtimer le vrai bien, Malgré tous les Edits & défences d’Olibre, adorerai Jeſus d’une volonté libre.	Dieux, jeveux mourir Chrétien Car je veux désormais estimer le vrai bien, Malgré tous les Édits et défenses d'Olibre, adorerai Jésus d'une volonté libre.
CLODIAN.	CLODIAN.
Fauſſes Divinités, déteſtables attenteurs.	Fausses Divinités, détestables attenteurs.
e n’aurai plus pour vous des ſentimens flateurs, e n’écoûterai ph orant de diſcours frivoles, Qui m’on fait réputer pour des Dieux des Idoles, Des Idoles plûtôt des eſprits vicieux, lus digne des Enfers que du Trône des Cieux, Des démons deſtinés aux flâmes éternelles, uſte punition des ames criminelles:	eu n'aurai plus pour vous des sentiments flatteurs, est n'écouterai ph orant de discours frivoles, Qui m'on fait réputer pour des Dieux des Idoles, Des Idoles plutôt des esprits vicieux, lus digne des Enfers que du Trône des Cieux, Des démons destinés aux flammes éternelles, uste punition des âmes criminelles:
u contraire je ſçai que le Dieu des Chrétiens, aſpirant la vertu commande les vrais biens, n Dieu que pour les ſiens j’ai toûjours vû propice, Auteur de Sainteté qui condamne le viće, teine tu m’as apris par ta grande ferveur, ui te fait mépriſer les Rois & leur faveur, imer la pureté, oublier les injures, ſiſter le prochain, déteſter les ordures,	Ju contraire je sais que le Dieu des Chrétiens, aspirant la vertu commande les vrais biens, n Dieu que pour les siens j'ai toujours vu propice, Auteur de Sainteté qui condamne le vie, teine tu m'as appris par ta grande ferveur, ui te fait mépriser les Rois et leur faveur, imer la pureté, oublier les injures, sister le prochain, détester les ordures,
Que ton Dieu qui par tout a demeuré vainqueur, Dont tout ſeul ocuper l’enceinte de mon cœur Cette Religion ſans doute eſt véritable, Qui fait ſon Sectateur ſi bon, ſi charitable;	Que ton Dieu qui par tout a demeuré vainqueur, Dont tout seul ocuper l'enceinte de mon cœur Cette Religion sans doute est véritable, Qui fait son Sectateur si bon, si charitable;
Reine que j’ai d’horreur & de confuſion, D’avoir été l’Auteur de ton affliction, Quand tu m’as raconté les divines merveilles, ouvrois à même temps le cœur & les oreilles, ai tres-bien remarqué les ſolides raiſons, Quand je te viſitois ſeule dans les priſons, Mon eſprit convaincu des vérités ſublimes, Reconnoît maintenant & déteſte les crimes, Je connois, mais trop tard, l’excés de mon peche Ha que j’ai de remors!	Reine que j'ai d'horreur et de confusion, D'avoir été l'Auteur de ton affliction, Quand tu m'as raconté les divines merveilles, ouvrais à même temps le cœur et les oreilles, ai très-bien remarqué les solides raisons, Quand je te visitais seule dans les prisons, Mon esprit convaincu des vérités sublimes, Reconnoît maintenant et déteste les crimes, Je connois, mais trop tard, l'excès de mon pèche Ha que j'ai de remors!
ha que je ſuis fâché!	ha que je suis fâché!
D’avoir mis à la Croix une Vierge ſi belle, Qui n’a d’autre peché que d’avoir trop de zéle, Pour ſon fidel Epoux tant Céleſte & Divin, Le Roïaume duquel ne prenc' h jamais fin;	D'avoir mis à la Croix une Vierge si belle, Qui n'a d'autre péché que d'avoir trop de zèle, Pour son fidel Époux tant Céleste et Divin, Le Roïaume duquel ne prenc' autre jamais fin;
Douce Reine obtient-moi le pardon je te prie, Je mourrai combatant contre l’Idolâtrie, Piclao:	Douce Reine obtient-moi le pardon je te prie, Je mourrai combattant contre l'Idolâtrie, Piclao:
encore direoup, icoins pardonne-moi, Je veux aimer JESuS & mourir pour ſa Foi, Je renonce à Satan, ce beau Dieu de l’Empire Au nombre des elûs je veux mon nom écrire.	encore direoup, icoins pardonne-moi, Je veux aimer JESuS et mourir pour sa Foi, Je renonce à Satan, ce beau Dieu de l'Empire Au nombre des elûs je veux mon nom écrire.
SABIN.	SABIN.
Tranſporté de regret & de confuſion, ye déteſte l’erreur de ma préſomption, Reine que j’ai toûjours aimé comme moi-même, Je connois de ton Dieu la dignité ſupréme, I’ai nommé ta conduite & opiniâtreté, Contre-toi ſans raiſon je me ſuis irrité, Au contraire à preſent je priſe ta conſtance, Et te donne conſeil de la perſéverance, Jeſus eſt le vrai Dieu, nous en ſommes témoins, Et qu’il n’a pas manqué de t’aider par les foins, Pour ta protection il a fait des Miracles, Il a pour ta faveur fait parler des Oracles, e prends ta cauſe en main & défends ta pudeur, Le feu perd ſa vertu, l’eau quitte ſa froideur, Le feu, les Elémens, & toutes Créatures, Pour ne point t’offencer ont changé de nature;	Transporté de regret et de confusion, ie déteste l'erreur de ma présomption, Reine que j'ai toujours aimé comme moi-même, Je connais de ton Dieu la dignité suprême, J'ai nommé ta conduite et opiniâtre, Contre-toi sans raison je me suis irrité, Au contraire à présent je prise ta constance, Et te donne conseil de la persévérance, Jésus est le vrai Dieu, nous en sommes témoins, Et qu'il n'a pas manqué de t'aider par les foins, Pour ta protection il a fait des Miracles, Il a pour ta fa fait parler des Oracles, Il a pou en main et défends ta pudeur, Le feu perd sa vertu, eau et sa froideur, Le feu, les Ens, et me Créatures, Pour ne point offencer ont changé de nature;
Les Anges ſont témoins de ta fidélité, Et portent du reſpect à ta Virginité, Reine je t’aiderai d’un fidelle ſervice, Au lieu de lâchement te conduire at luprice;	Les Anges sont témoins de ta fidélité, Et portent du respect à ta Virginité, Reine je t'aiderai d'un fidèle service, Au lieu de lâchement te conduire at luprice;
On doit exécuter cette Vierge demain, Noun mouu du dorune les dimes a la Ilalil.	On doit exécuter cette Vierge demain, Noun mouvouvou dorune les dîmes à la Ilalil.
SCENE V.	SCÈNE V.
TIEUPISTE, REINE, FELIX, PERSE, CLODIAN, Sabin, Hilderic, Charles, Albain, Lucille, Carauſe, Eugene, Porfie, Soldats de l’Armée.	TIEUPISTE, REINE, FELIX, PERSE, CLODIAN, Sabin, Hildéric, Charles, Albain, Lucille, Carause, Eugène, Porfie, Soldats de l'Armée.
THEOPISTE.	THÉPISTE.
Ivine Majeſté, Souveraine puiſſance, IJA qui tous les mortels doivent obeïſſance.	Juine Majesté, Souveraine puissance, IJA qui tous les mortels doivent obéissance.
Noble Divinité, grand Roi du Firmament, Qui du Ciel gouvernés le monde ſagement, upiter qui lancés le tonnerre & la foudre, Réduiſés aujourd’hui vos ennemis en poudre, On mépriſe ici-bas le Monarque des Cieux, Mais il ſçait bien punir les cœurs audacieux, Il ſçait bien aux méchants ſuſciter des tempêtes, Préparant des carreaux pour foudroïer leurs têtes:	Noble Divinité, grand Roi du Firmament, Qui du Ciel gouvernés le monde sagement, upiter qui lancès le tonnerre et la foudre, Réduisez aujourd'hui vos ennemis en poudre, On méprise ici-bas le Monarque des Cieux, Mais il sait bien punir les cœurs audacieux, Il sait bien aux méchants susciter des tempêtes, Préparant des carreaux pour foudroïer leurs têtes:
Reine tu veux cauſer par ta Religion, Le trouble dans la Gaule & la rebellion, Offencer de nos Dieux la Majeſté ſuprême, Ils ne peuvent laiſſer impuni ton blaſphême;	Reine tu veux causer par ta Religion, Le trouble dans la Gaule et la rébellion, Offenser de nos Dieux la Majesté suprême, Ils ne peuvent laisser impuni ton blasphême;
Céſar par ſes Edits & le Sénat Romain, Qui reçoit tant de biens & ſecours de la main, De nos Dieux tous-puiſſants en ont pris la défence, Publiant des Edits pour vanger leur offence:	César par ses Édits et le Sénat Romain, Qui reçoit tant de biens et secours de la main, De nos Dieux tous-puissants en ont pris la défense, Publiant des Édits pour venger leur offense:
Reine je ſuis chargé de l’exécution, Olibre m’a donné cette commiſſion, Nous devons aujourd’hui te conduire au ſuplice, Toute-fois ſi tu veux que je te lois propice, Adore Jupiter, corrige ton délit, Déteſte ton erreur, renonce à Jeſus-Chriſt.	Reine je suis chargé de l'exécution, Olibre m'a donné cette commission, Nous devons aujourd'hui te conduire au suplice, Toute-fois si tu veux que je te lois propice, Adore Jupiter, corrige ton délit, Déteste ton erreur, renonce à Jésus-Christ.
REINE.	REINE.
Adorer les démons ce ſeroit un grand crime, Qui me feroit gémir avec eux dans l’abîme, Je déſire mourir en la Foi conſtamment, Et ſuivre Jeſus-Chriſt en ſon couronnement;	Adorer les démons ce serait un grand crime, Qui me ferait gémir avec eux dans l'abîme, Je désire mourir en la Foi constamment, Et suivre Jésus-Christ en son couronnement;
Dieu m’a fait tant de fois remporter la victoire, Il ne me reſte plus que joüir de ſa gloire, Jeſus-Chriſt mon Epoux toûjours victorieux, Par ſa voix me convie au Roïaume des Cieux.	Dieu m'a fait tant de fois remporter la victoire, Il ne me reste plus que jouir de sa gloire, Jésus-Christ mon Époux toujours victorieux, Par sa voix me convie au Roïaume des Cieux.
FELIA.	FELIA.
Reine je ſuis Chrétien.	Reine je suis Chrétien.
PERSE.	PERSE.
Et moi j’en dis de même	Et moi j'en dis de même
CLODIAN.	CLODIAN.
Je ſuis Chetien auin domies nous le Daptême.	Je suis Chetien auin domies nous le Daptême.
REINE.	REINE.
Je vous donne la paix combatés conſtamment, le vais vous préparer la gloire au Firmament.	Je vous donne la paix combatez constamment, le vais vous préparer la gloire au Firmament.
FELIX.	FELIX.
Frotts vottionis par la lort expier nôtre offence, Obtenés nous le don de la perſéverance.	Frots vottionis par la lort expier notre offense, Obtenés nous le don de la persévérance.
REINE.	REINE.
Vous ſerès Baptiſés de votre propre fang, Si la main du Tiran vous tranſperce le flanc.	Vous serez Baptisez de votre propre sang, Si la main du Tyran vous transperce le flanc.
THEOPISTE.	THÉPISTE.
Je ſerai le vangeur d’une telle malice, je vous ferai ſoûfrir un ſévere ſuplice, Qu’ils ſoi ent chargés de coups, qu’ils ſoient mis en priion, Vous avès donc perdu le ſang & la raiſon, Frapés Bourreaux frapés, ces ingrats, ces infames.	Je serai le vengeur d'une telle malice, je vous ferai souffrir un sévère suplice, Qu'ils soi ent chargez de coups, qu'ils soient mis en priion, Vous avez donc perdu le sang et la raison, Frappez Bourreaux frappez, ces ingrats, ces infâmes.
REINE.	REINE.
roques yeius Chriſt, ô génereuſes ames!	roques yéjus Christ, ô génereuses âmes!
CLODTAN.	CLODTAN.
Je vous aime ô JESUS!	Je vous aime ô JESUS!
je vous aime mon Dieu, Je veux vous adorer, en tout temps, en tout lieu.	je vous aime mon Dieu, Je veux vous adorer, en tout temps, en tout lieu.
SCENE VI.	SCÈNE VI.
MORT DE SAINTE REINE.	MORT DE SAINTE REINE.
THEOPISTE, REINE, SABIN, CHARLE SIe Albain, Lucille, Carauſe, Soldats.	THÉPISTE, REINE, SABIN, CHARLE SIe Albain, Lucille, Carausse, Soldats.
THEOPISTE.	THÉPISTE.
TOi qui les a ſéduits mal-heureuſe ſorciére, I Mérite-tu pas bien de mourir la premiére, Puiſque tu peux connoître le mal-heur de ton ſort, Ecoûte prononcer ta ſentence de mort.	TOi qui les a séduits malheureuse sorcière, I Mérite-tu pas bien de mourir la premièvre, Puisque tu peux connaître le malheur de ton sort, Écoute prononcer ta sentence de mort.
REINE.	REINE.
Je ne crains poin la mort, j’y ſuis trop réſoluë.	Je ne crains poin la mort, j'y suis trop résolue.
1 0117 THEOPISTE.	1 0117 THÉPISTE.
Fléchiſſés les genoux, Olibre vous ſaluë, Vû l’obſtination au mépris de nos Dieux, Monarques ſouverains de la terre & des Cieux, Pour reparation nous t’avons condamnée, Par la main d’un boureau ſoûfrir ta deſtinée.	Fléchissez les genoux, Olibre vous saluë, Vu l'obstination au mépris de nos Dieux, Monarques souverains de la terre et des Cieux, Pour réparation nous t'avons condamnée, Par la main d'un boureau souffrir ta destinée.
SABIN.	SABIN.
Qui pourra ſuporter que les enfans des Rois, Subiſſent ſans reſpect la rigueur de ces loix.	Qui pourra supporter que les enfants des Rois, Subissent sans respect la rigueur de ces lois.
Tourquoi permettons nousqu’une auguſte Princeſſe Soûfre devant nos-yeux une telle détreſſe?	Tourquoi permettons nousqu'une auguste Princesse Souffre devant nos-yeux une telle détresse?
Je la veux délivrer, elle n’en moura pas;	Je la veux délivrer, elle n'en moura pas;
Quand je dévrois aller avec elle au trépas.	Quand je dévrois aller avec elle au trépas.
CARAUSE.	CARAUSE.
Soldats préperés-vous, défendés l’innocence, Arrêtés des méchans la barbare licence,	Soldats préperés-vous, défendez l'innocence, Arrêtez des méchants la barbare licence,
LUCILLE.	LUCILLE.
Impudent hors d’ici déteſtable bourreau, De toucher ſur ce corps ſi celeite & ii beau.	Impudent hors d'ici détestable bourreau, De toucher sur ce corps si cègleite et ji beau.
THEOPISTE.	THÉPISTE.
Gardes défendés-moi de ce Peuple infidelle, éxecute l’arrêt contre une criminelle.	Gardes défendez-moi de ce Peuple infidèle, éxecute l'arrêt contre une criminelle.
REINE.	REINE.
Helas!	Hélas!
que faites-vous ennemis de mon bien?	que faites-vous ennemis de mon bien?
Je meurs en défendant l’honneur du nom Chrétien Vous voulés expoſer le ſalut de mon ame, Pour défendre mon corps d’une ſanglante lame;	Je meurs en défendant l'honneur du nom Chrétien Vous voulez exposer le salut de mon âme, Pour défendre mon corps d'une sanglante lame;
Vous avés entendu que Jeſus mon Amant, Par le ſon de ſa voix m’apelle au Firmament:	Vous avez entendu que Jésus mon Amant, Par le son de sa voix m'appelle au Firmament:
Quittés ces ſentimens, ma mort eſt glorieuſe, Vous ne connoiſſés pas combien j’en ſuis joïeuſe, Dieu me fait trop d’honneur, heureuſe mille fois;	Quittés ces sentiments, ma mort est glorieuse, Vous ne connaissez pas combien j'en suis joïeuse, Dieu me fait trop d'honneur, heureuse mille fois;
D’avoir ſuivi Jeſus au Trône de la Croix:	D'avoir suivi Jésus au Trône de la Croix:
aimontè ſur la Croix ce grand Trône de gloire:	aimont sur la Croix ce grand Trône de gloire:
Qui de vos ennemis emporte la victoire:	Qui de vos ennemis emporte la victoire:
La Croix qui fut jadis toute ma paſſion, M’eſt le plus grand ſecret de conſolation, Je m’en vais droit au Ciel où Jeſus me convie, Je priſe maintenant plus la mort que la vie;	La Croix qui fût jadis toute ma passion, M'est le plus grand secret de consolation, Je m'en vais droit au Ciel où Jésus me convie, Je prise maintenant plus la mort que la vie;
Mon Dieu dans le regret de mon indignite, Je me proſterne aux pieds de vôtre Majeſté:	Mon Dieu dans le regret de mon indignité, Je me prosterne aux pieds de votre Majesté:
Mon cœur eſt je l’avouë un abîme de vice, a vous prie hamblement vouloir m’être propice Pardonnant de bon cœur à tous mes ennemis:	Mon cœur est je l'avoue un abîme de vice, à vous prie hamblement vouloir m'être propice Pardonnant de bon cœur à tous mes ennemis:
le vous prie pour eux comme pour mes amis;	le vous prie pour eux comme pour mes amis;
Ne leur reputés pas mon bon-heur pour un crime Puniſſés-moi pour eux j’en ſerai la victime, Si vous êtes émûs lancés ſur moi vos traits, Leurs deſſeins ſont plûtôt des biensque des forfaits Puiſque tous les efforts me ſont ſi favorable, Pourquoi les voulés-vous réputer pour coupables?	Ne leur réputez pas mon bonheur pour un crime Punissez-moi pour eux j'en serai la victime, Si vous êtes émus lancez sur moi vos traits, Leurs desseins sont plutôt des biensque des forfaits Puisque tous les efforts me sont si favorable, Pourquoi les voulez-vous réputer pour coupables?
Leur tourmens m’ont aquis un Trône dans le Ciel, Et me feront joüir d’un bon-heur éternel :	Leur tourments m'ont aquis un Trône dans le Ciel, Et me feront jouir d'un bonheur éternel :
Seigneur, ſi vous m’aimés donnés moi cette grace, Et ne réputés pas leur pechè en audace;	Seigneur, si vous m'aimez donnez moi cette grâce, Et ne réputez pas leur pechè en audace;
Donnés à ce païs l’abondance & la paix, Soulagés ceux qui ſont trop chargés de leurs faix, Faites y proſpérer l’amour & la concorde, Exercès envers tous vôtre miſericorde, Secourés les Chrètiens en leurs néceſſités, Aidés les languiſſants en leurs infirmités, En ſoûmettant le col au tranchant d’une l’ame, Je mets entre vos mains mon corpsavee mon ame:	Donnez à ce pays l'abondance et la paix, Soulagés ceux qui sont trop chargés de leurs faix, Faites y prospérer l'amour et la concorde, Exercès envers tous votre miséricorde, Secourés les Chrètiens en leurs nécessités, Aidés les languissants en leurs infirmités, En soumettant le col au tranchant d'une l'âme, Je mets entre vos mains mon corpsave mon âme:
Qui t’arrête boureau?	Qui t'arrête boureau?
qu’as-tu?	qu'as-tu?
ne tarde plus, Enl mourant je dirai, je vous aime Jeſus.	ne tarde plus. Enl mourant je dirai, je vous aime Jésus.
Y ΙAN VUYV	Y AN VUYV
SCENE VII.	SCÈNE VII.
HILDERIC, CHARLES, ALBAIN, CARAUSE, Lucille, Sabin, Eugene, Porcie, Soldats.	HILDERIC, CHARLES, ALBAIN, CARAUSE, Lucille, Sabin, Eugène, Porcie, Soldats.
HILDERIC.	HILDERIC.
U’eſt-ce que nous voïons?	OÙ'est-ce que nous voïons?
ô miracle!	ô miracle!
ô miracle!	ô miracle!
Ne contemplés-vous pas ce merveilleux ſpectacle?	Ne contemplez-vous pas ce merveilleux spectacle?
Le Ciel ſe rend témoin de la grande vertu, t de la Sainteté de ce corps abatu;	Le Ciel se rend témoin de la grande vertu, t de la Sainteté de ce corps abattu;
« Ciel, les Elemens, les Hommes & les Anges, S’uniſſent aujourd’hui pour chanter ſes loüanges:	" Ciel, les Éléments, les Hommes et les Anges, S'unissent aujourd'hui pour chanter ses louanges:
La Terre fait jaillir une Fontaine d’eau, Le feu pour l’honorer allume ce flambeau;	La Terre fait jaillir une Fontaine d'eau, Le feu pour l'honorer allume ce flambeau;
Reine que ton mérite & que ta gloire eſt grande, Sans doute que l’ardeur de ton zéle commande, D’imiter tes vertus & d’embraſſer ta Foi, Proteſtant que ton Dieu Jeſus eſt un grand Roi.	Reine que ton mérite et que ta gloire est grande, Sans doute que l'ardeur de ton zèle commande, D'imiter tes vertus et d'embrasser ta Foi, Protestant que ton Dieu Jésus est un grand Roi.
CHARLES.	CHARLES.
Reine tous tes deſſeins ſont ſi pleins d’innocence, Que le Ciel t’en a dû cette reconnoiſſance;	Reine tous tes desseins sont si pleins d'innocence, Que le Ciel t'en a dû cette reconnaissance;
Soldats aprochés-vous, contemples aujourd’hui, Ce Miracle nouveau, ce prodige inoüi, Voïés les ſaintes eaux d’une vive fontaine, Le ſacré mouvement de votre sumnte rceme, Des ſalutaires eaux qui rendent la ſanté, Et guériſſent les corps de toute infirmité.	Soldats approchez-vous, contemples aujourd'hui, Ce Miracle nouveau, ce prodige infini, Voïés les saintes eaux d'une vive fontaine, Le sacré mouvement de votre sumnte rème, Des salutaires eaux qui rendent la santé, Et guérissent les corps de toute infirmité.
ALDAIN.	ÀLDAIN.
Je connois ton mérite, ô ma tres-chére Reîne?	Je connais ton mérite, ô ma très-chére Reine?
adore ton Saint Corps, & ton Chef, & ta Chaîne.	adore ton Saint Corps, et ton Chef, et ta Chaîne.
CARAUSE.	CARAUSE.
Ià Tortouina deertre la rerponreicion, Et mourant ſaintement pour la Religion, ’adore Jeſus-Chriſt dans ſon auguſte Temple, Remné ta Sainteté m’en a donné Texemple.	Jà Tortouina deertre la réponreicion, Et mourant sainte pour la Religion, 'adore Jésus-Christ dans son auguste Temple, Remné ta Sainteté m'en a donné Texemple.
LUCILLE.	LUCILLE.
Adorons le Saint Corps qui par ſa pureté, Fut le Temple Sacré de la Divinité.	Adorons le Saint Corps qui par sa pureté, Fut le Temple Sacré de la Divinité.
SABIN.	SABIN.
Faut-il que ce Saint Corps par la main d’un impie, Pour ſa Virginité ſoit privé de la vie;	Faut-il que ce Saint Corps par la main d'un impie, Pour sa Virginité soit privé de la vie;
Reine j’aime ton Dieu, j’en embraſſe la Foi, Je déſire mourir pour Jeſus avec toi, Ce génereux mépris du monde & de toi-méme, Ce bien parfait amour de la beauté ſuprême, ’aſpire avoir eſprit, par des nouvelles loix, Le mépris des plaiſirs & l’amour de la Croix,	Reine j'aime ton Dieu, j'en embrasse la Foi, Je désire mourir pour Jésus avec toi, Ce génereux mépris du monde et de toi-même, Ce bien parfait amour de la beauté suprême, aspire avoir esprit, par des nouvelles loix, Le mépris des plaisirs et amour de la Croix,
EUGENIE.	EUGÉNIE.
Tandis que le Soleil éclairera le monde, Ma bouche exaltera l’humilité profonde, a tile Remc ties-Sante d parfaite en Deaute, Qui veut ſoûfrir la mort pour la Virginité.	Tandis que le Soleil éclairera le monde, Ma bouche exaltera l'humilité profonde, a tile Remc ies-Sante d parfaite en Deaute, Qui veut souffrir la mort pour la Virginité.
ORCIE.	ORCIE.
Reine qui ce jourd’hui détruit l’Idolâtrie, Tu ſeras maintenant l’honneur de ta patrie, Tu mérite d’avoir tous les plus grands honneurs, Pour nous avoir aquis les céleſtes bon-heurs.	Reine qui ce jourd'hui détruit l'Idolâtrie, Tu seras maintenant l'honneur de ta patrie, Tu mérite d'avoir tous les plus grands honneurs, Pour nous avoir aquis les clestes bonheurs.
–	
HILDERIC.	HILDERIC.
Reine nous honorons ta memoire célebre, Par les humbles reſpects d’une pompe funébre, Pour joüir avec toi du Roïaume des Cieux, Nous quitonis potri jainla is je ettite tes faux-Dieux.	Reine nous honorons ta mémoire célèbre, Par les humbles respects d'une pompe funèbre, Pour jouir avec toi du Roïaume des Cieux, Nous quitonis podri jainla is je ettite tes faux-Dieux.
Fin de la Tragedie.	Fin de la Tragédie.
LES PERSONNAGES QVI PAROISSENT en la Trageale dt ohinte Reune.	LES PERSONNAGES QUI PAROISENT en la Tragale dt ohinte Reune.
PREMIERE BANDE.	PREMIÈRE BANDE.
SAINT REVERIAN, Evêque d’Autun.	SAINT REUERIAN, Évêque d'Autun.
SAINTE REINE.	SAINTE REINE.
SAINT THEOPHILE, Confident de Sainte Reine.	SAINT THÉOPHILE, Confident de Sainte Reine.
SAINTE BLONDE, Mere Nourrice de Sainte – Reine.	SAINTE BLONDE, Mère Nourrice de Sainte „ Reine.
AGATON, Page qui porte la robe de Sainte Reine.	AGATON, Page qui porte la robe de Sainte Reine.
EEualeu ye lollene.	EEualeu ie lollène.
Sainte Relnc.	Sainte Relnc.
HILDERIC, Prince d’Auſtraſie.	HILDERIC, Prince d'Autrasie.
ALBAIN, Roi de Bretagne.	ÀLBAIN, Roi de Bretagne.
CHARLES, Duc d’Aquitaine.	CHARLES, Duc d'Aquitaine.
CARAUSE, Géneral de l’Armée Romaine.	CARAUSE, Général de l'Armée Romaine.
QVATRIE'ME BANDE.	QUATRIE'ME BANDE.
BELZEBUTH, Démon.	BÉLZEBUTH, Démon.
ASMODE’E, Démon.	ASMODÉTÉ, Démon.
MEGERE, furie.	MÉGÈRE, furie.
DISPOSITION DO THEATRE.	DISPOSITION DO THÉÂTRE.
Moritaſgo.	Moritasgo.
3.	3.
A l’autre bout du Theâtre doivent être dreſſées ticis crtir, dont celle du milieu ſoit la plus forte, parceque Sainte Reine doit y etre atachée.	À l'autre bout du Théâtre doivent être dressées ticis crétir, dont celle du milieu soit la plus forte, parceque Sainte Reine doit y être atachée.
Et derriére ces trois Croix, trois arbres.	Et derrière ces trois Croix, trois arbres.
4.	4.
Parmi ces trois arbres, doit être une petite cel	Parmi ces trois arbres, doit être une petite cel
lule, qui ſera la rétraite & prlioirde gaite Reine.	lule, qui sera la rétraite et prlioirde gaîté Reine.
5.	5.
A côté de l’Idole de Jupiter, doit être une gueule d’Enfer d’où ſortiront les Démons.	À côté de l'Idole de Jupiter, doit être une gueule d'Enfer d'où sortiront les Démons.
6.	6.
Au milieu du Theâtre, doit être un Trône élevé de deux marches, & aux deux côtés doivent être deux autres chaires plus baſſes.	Au milieu du Théâtre, doit être un Trône élevé de deux marches, et aux deux côtés doivent être deux autres chaires plus basses.
7.	7.
La tapiſſerie doit avoir deux entrées, l’une du côté de la ſtatuë par où entrera Olibre & les ſiens, l’autre du côté des Croix par où entrera Sainte Reine.	La tapisserie doit avoir deux entrées, l'une du côté de la statue par où entrera Olibre et les siens, l'autre du côté des Croix par où entrera Sainte Reine.
Le Prince Sunon avec ſon Armée, paroît taim du cote des Sioin.	Le Prince Sunon avec son Armée, paraît taim du cote des Sioin.
Les Prêtres & les Démons paroîtront du côté de l’Idole.	Les Prêtres et les Démons paraîtront du côté de l'Idole.
8.	8.
Il faut obſerver que le Theâtre doit changer de face, entre le quatrieme & cinquiéme Acte, ſelon le deſſein ci-deſſus.	Il faut observer que le Théâtre doit changer de face, entre le quatrième et cinquième Acte, selon le dessein cy-dessus.
DESSEIN DE LA TRAGEDIE Pella sue eheenrere	DESSEIN DE LA TRAGÉDIE Pela sue eheenrere
Our abreger la preſente Tragedie, on peut en I retrancher les Scenes qui ſont les plus détaefrees , daris ferquelles Sallite Rceme ne paroît pas, & un bon nombre de Perſonnages.	Our abréger la présente Tragédie, on peut en I trancher les Scères qui sont les plus détaefrees , daris ferquelles Sallite Rème ne paraît pas, et un bon nombre de Personnages.
ACTE I.	ACTE I.
SCENE I.	SCÈNE I.
A.	A.
Sainte Reine s’entretient avec ſes Confidents, ſur le bon-heur de ſa vocation à la Foi.	Sainte Reine s'entretient avec ses Confidents, sur le bonheur de sa vocation à la Foi.
SCENE 2.	SCÈNE 2.
B.	B.
Olible demande à Clement ſa Fille en Mariage.	Olible demande à Clément sa Fille en Mariage.
SCENE 3.	SCÈNE 3.
C.	Ç.
Olibre recherche Sainte Reine en Mariage, & lui propoſe d’adorer les faux-Dieux, il en eſt rebuté.	Olibre recherche Sainte Reine en Mariage, et lui propose d'adorer les faux-Dieux, il en est rebuté.
SCENE 4.	SCÈNE 4.
D.	D.
Clement preſſe ſa Fille de conſentir aux volontés d’Olibre, mais la voïant conſtante, il fait mettre en priſon ſes Confidents.	Clément presse sa Fille de consentir aux volontés d'Olibre, mais la voïant constante, il fait mettre en prison ses Confidents.
OCENE J.	OCENE Y.
L.	L.
Clement tiaiporte de coiere contre Reine, la frape & la pourſuit vivement.	Clément tiaiporte de coière contre Reine, la frappe et la poursuit vivement.
SCENE 6.	SCÈNE 6.
F.	F.
Troublé de fâcherie, il en tombe malade.	Troublé de fâcherie, il en tombe malade.
ACTE II.	ACTE II.
SCENE I.	SCÈNE I.
G.	G.
Saint Réverian, Evêque d’Autun, viſite Sainte Reine dans la priſon, & la confirme en la Foi:	Saint Réverian, Évêque d'Autun, visite Sainte Reine dans la prison, et la confirme en la Foi:
Elle fait devant lui vœu de Virginite.	Elle fait devant lui vœu de Virginite.
SCENE 2.	SCÈNE 2.
H.	H.
Sainte Reine entre dans des nouvelles ferveurs, & ſe diſpoſe au Martire, baillant aux pauvrres ſes plus richés habits, & leur lavant Ies pieus, ce.	Sainte Reine entre dans des nouvelles ferveurs, et se dispose au Martyre, baillant aux pauvres ses plus richés habits, et leur lavant Jes pieus, ce.
ACTE III.	ACTE III.
SCENE I.	SCÈNE I.
I.	I.
Le Prêtre des faux-Dieux ſuſcite.	Le Prêtre des faux-Dieux suscite.
la perſécution contre les Chrétiens.	la persécution contre les Chrétiens.
SCENE 2.	SCÈNE 2.
K.	§.
Olibre tient Conſeil ſur ce ſujet, & fait publier les Edits de l’empereur Dece.	Olibre tient Conseil sur ce sujet, et fait publier les Édits de l'empereur Déce.
ENTR'ACTE.	ENTR'ACTE.
Le Tlleatre change de face, on preparc tous les inſtrumens, & de Martire, &c.	Le Tlleâtre change de face, on préparc tous les instruments, et de Martyre, etc.
ACTE IV.	ACTE IV.
SCENE I.	SCÈNE I.
L.	L.
Sabin, Conſeiller d’Olibre, parle en faveur de Sainte Reine, & excite à ſon amour.	Sabin, Conseiller d'Olibre, parle en faveur de Sainte Reine, et excite à son amour.
SCENE 2.	SCÈNE 2.
M.	M.
Olibre s’éforce de porter Sainte Réine à ſon amour, au culte des faux-Dieux:	Olibre s'efforce de porter Sainte Reine à son amour, au culte des faux-Dieux:
Elle les mépriſe, & ſoûtient l’honneur de la Croix, Olibre la fait fouetter, grater & bruler, &c.	Elle les méprise, et soutient l'honneur de la Croix, Olibre la fait fouetter, grater et brûler, etc.
SCENE 3.	SCÈNE 3.
N.	N.
Les Gardes Prétoriennes qui ont.	Les Gardes Prétoriennes qui ont.
mal-traitté Sainte Reine, ſe convertiſſent à la Foi.	maltraité Sainte Reine, se convertissent à la Foi.
ACTE V.	ACTE V.
ENE I.	ENE I.
Oi Saite reemne ert conduite devant le Pontife pour être condamnée.	Oi Saite remène ert conduite devant le Pontife pour être condamnée.
On entend la voix du Ciel qui l’apelle.	On entend la voix du Ciel qui l'appelle.
Deux Sergens ſe déclarent Chrétiens, & ſont mis en priſon.	Deux Sergents se déclarent Chrétiens, et sont mis en prison.
SCENE 2.	SCÈNE 2.
P.	P.
La ſentence de mort eſt prononcée contre Sainte Reine.	La sentence de mort est prononcée contre Sainte Reine.
Les Chrétiens s’efforcent de la délivrer:	Les Chrétiens s'efforcent de la délivrer:
Elle ſe diſpoſe à la mort priant pour ſes ennemis, &c.	Elle se dispose à la mort priant pour ses ennemis, etc.
SCENE 3.	SCÈNE 3.
Q.	Q.
Tous les aſſiſtans ſe convertiſſent voïant les Miracles, & font honneur au Corps de la Sainte Vierge.	Tous les assistants se convertissent voïant les Miracles, et font honneur au Corps de la Sainte Vierge.
OLIBRE, Préſident.	OLIBRE, Président.
FELIX, Sergent.	FELIX, Sergent.
