Extraict du Priuilege du Roy.	Extrait du Privilège du Roi.
M Ar grace & Priuilege du Roy donné à Paris, le 7.	M Ar grâce et Privilège du Roi donné à Paris, le 7.
Feurier, 1637.	Février, 1637.
Signé, Par le Roy en ſon Conſeil.	Signé, Par le Roi en son Conseil.
DE MONSSEAVX, Il eſt permis à ANTHOINE DE SOMMAVILLE, Marchand Libraire à Paris, d’imprimer ou faire imprimer, vendre & diſtribuer vne piece de Theatre, intitulee, La Pelerine Amoureuſe Tragi-comedie, durant le temps & eſpace de neuf ans, à compter du iour qu’elle ſera acheuee d’imprimer.	DE MONSEAUX, Il est permis à ANTHOINE DE SOMMAVILE, Marchand Libraire à Paris, d'imprimer ou faire imprimer, vendre et distribuer une pièce de Théâtre, intitulée, La Pélerine Amoureuse Tragi-comédie, durant le temps et espace de neuf ans, à compter du jour qu'elle sera achevue d'imprimer.
Et deffences ſont faictes à tous Imprimeurs, Libraires, & autres, de contrefaire ladite piece, ny en vendre ou expoſer en vente de contrefaicte, à peine de trois mil liures d’amende, de tous ſes deſpens, dommages & intereſts;	Et défenses sont faites à tous Imprimeurs, Libraires, et autres, de contrefaire ladite pièce, notre en vendre ou exposer en vente de contrefaite, à peine de trois mille livres d'amende, de tous ses dépens, dommages et intérêts;
ainſi qu’il eſt plus amplement porté par leſdites Lettres qui ſont en vertu du preſent Extraict tenuës pour bien & deuëment ſignifiees, à ce qu’aucun n’en pretende cauſe d’ignorance.	ainsi qu'il est plus amplement porté par lesdites Lettres qui sont en vertu du présent Extrait tenues pour bien et duement signifie, à ce qu'aucun n'en prétende cause d'ignorance.
Acheué d’imprimer pour la premiere fois, le 20.	Achevé d'imprimer pour la première fois, le 20.
Feurier, mil ſix cens trente ſept.	Février, mil six cens trente sept.
ACTEVRS.	ACTEURS.
LVCIDOR.	LUCIDOR.
ſeruiteur de Celie, CELIANTE.	serviteur de Celie, CÉLIANTE.
ſeruiteur de Celie, & frere de ILIDAN.	serviteur de Célie, et frère de ILIDAN.
ERASME.	ERASME.
ELIE.	ÉLIE.
Lucidor, valet de Lucidor, Pere de Celie.	Lucidor, valet de Lucidor, Père de Celie.
LA NOVRRICE.	LA NOURRICE.
de Celie.	de Célie.
LVCIDOR, ſousle amy de Celie.	LUCIDOR, soûle ami de Celie.
nom de Leandre.	nom de Léandre.
CLIDAMANT.	CLIDAMANT.
grand Preſtre.	grand Prêtre.
ANGEENQVE.	ANGENQUE.
CLORIMAND.	CLORIMAND.
FILENE.	SILÈNE.
Pellerine, & maiſtreſſe de Lucidor.	Pellerine, et maîtresse de Lucidor.
gentil homme d’Angelique.	gentil homme d'Angélique.
valet d’Eraſme.	valet d'Erâme.
LES ARCHERS.	LES ARCHERS.
TET LA NIIVE AMOVREVSE.	TET LA NIVE AMOUREUSE.
TRAGI-COMEDIE.	TRAGI-COMÉDIE.
AICTE L SCLNE IREMIENE LVCIDOR, CELIANTE, FILIDAN, valet de Lucidor.	ÀICTE SCLNE JREMIENE LUCIDOR, CELIANTE, FILIDAN, valet de Lucidor.
CELIANTE.	CELIANTE.
Ayme ſans deſeſpoir, & ſans melancholiez Le Ciel ordonnera des faueurs de Celie, A Jl doit ſeul diſpoſer du deſtin des humains, Tout hymen qui proſpere eſt vn nœud de ſes mains.	Aime sans désespoir, et sans melancholiez Le Ciel ordonnera des faveurs de Célie, A l doit seul disposer du destin des humains, Tout hymen qui prospère est un nœud de ses mains.
Jl veille deſſus nous;	Il veille dessus nous;
& l’extréme prudence Gist à n’attendre rien que de ſa prouidence.	et l'extrême prudence Gît à n'attendre rien que de sa providence.
CIDOR.	CIDOR.
Ainſi la deffiance excuſe nos deffauts Lors que nous aſpirons à des obiets trop hauts, Le Ciel te chang ra cette belle farouche!	Ainsi la défiance excuse nos défauts Lors que nous aspirons à des objets trop hauts, Le Ciel te chang ra cette belle farouche!
Et les Dieux de leur main la mettront dans ta couche, Ils t’ont fort en obiet, & ton contentement A leurs proſperités importe infiniment.	Et les Dieux de leur main la mettront dans ta couche, Ils t'ont fort en objet, et ton contentement À leurs prospérités importe infiniment.
Quel abus Celiante égale ta folie, Et quel ſoing ont les Dieux de toy, ny de Celie?	Quel abus Céliante égale ta folie, Et quel soing ont les Dieux de toi, Seigneur de Celie?
Jls donnent aux mortels auecques la clarté Un pouuoir abſolu deſſus leur volonté:	Ils donnent aux mortels auecques la clarté Un pouvoir absolu dessus leur volonté:
Tout ce qu’ils ont cree ſur la terre ou nous ſommes Tout ce qu’ils ont ſouſmis à l’appetit des hommes, N'eſt plus conſideré de leurs diuinités C’eſt a nous de pouruoir à nos neceßités:	Tout ce qu'ils ont cree sur la terre ou nous sommes Tout ce qu'ils ont sousmis à l'appétit des hommes, N'est plus considéré de leurs divinités C'est a nous de pourvoir à nos nécessités:
Voir les biens, & les maux, ſe ſeruir du tonnerre, Faire mouuoir les Cieux & ſouſtenir la terre, Entretenir la guerre entre les Elments, Et diſpoſer des prix comme des chaſtiments, C'eſt ie noble exercice où leur pouuoir s’applique Et non pas de regir les vœux d'vn frenetique, D’offrir à Geliante, ou Celie, ou Cloris, Qui veulent de leur main ſe choiſir des maris.	Voir les biens, et les maux, se servir du tonnerre, Faire mouvoir les Cieux et soutenir la terre, Entretenir la guerre entre les Éléments, Et disposer des prix comme des châtiments, C'est autre noble exercice où leur pouvoir s'applique Et non pas de régir les vœux d'un frénétique, D'offrir à Géliante, ou Célie, ou Cloris, Qui veulent de leur main se choisir des maris.
ELIANTE.	ÉLIANTE.
Crains les Dieux Lucidor & croy l’experience Si claire, & ſi contraire à ta vaine ſcience, Vn malheur ſi certain ſuit vn hymen forcé Que deſia ton deſſein n’eſt que trop auancé:	Crains les Dieux Lucidor et crois l'expérience Si claire, et si contraire à ta vaine science, Un malheur si certain suit un hymen forcé Que déjà ton dessein n'est que trop avancé:
Que ton cœur deuſt au Ciel ſoûmettre ſon enuie, Et Celie à ſon gré diſpoſer de ſa vie:	Que ton cœur dût au Ciel soumettre son envie, Et Celie à son gré disposer de sa vie:
Son aueugle parent au iour qui t'est preſcrit Te peut donner ſon corps, mais non pas ſon eſprit, Voyant à tes coſtés ceſte belle ennemie, Les yeux moüillés de pleurs, froide, palle, endormie, Meſpriſer tes ſouſpirs & ta fidelité, Et ne rien accorder qu’à l’importunité;	Son aveugle parent au jour qui t'est prescrit Te peut donner son corps, mais non pas son esprit, Voyant à tes côtés cette belle ennemie, Les yeux mouillés de pleurs, froide, pale, endormie, Mespriser tes soupirs et ta fidélité, Et ne rien accorder qu'à l'importunité;
Seras tu ſatisfaict de viure de la ſorte, Si tu ſçais les douceurs, qu’vn autre hymen apporte?	Seras tu satisfait de vivre de la sorte, Si tu sais les douceurs, qu'un autre hymen apporte?
Ha!	Ha!
que tu parleras d’vn eſprit plus raſſis!	que tu parleras d'un esprit plus rassis!
Et qu’vne ſeule fleur te vaudra de ſoucis!	Et qu'une seule fleur te vaudra de soucis!
IDOR.	JDOR.
Le plus fidelle aduis est ſuſpect en la bouche De qui nous entretient ſur vn faict qui le touche, Ma ruine feroit pour ton aduancement, A ij Et tu me parles moins en amy, qu’en amant;	Le plus fidèle avis est suspect en la bouche De qui nous entretient sur un fait qui le touche, Ma ruine ferait pour ton avancement, A j Et tu me parles moins en ami, qu'en amant;
M’ais toy-meſme, ſçachant cette humeur obstinee Qu’oppoſe cette belle au doux ioug d’hymenee, Tu dois craindre ce ſemble, & de la meſme loy Que tu me veux preſcrire, en faire vne pour toy.	M'ai toi-même, sachant cette humeur obstinée Qu'oppose cette belle au doux joug d'hyménée, Tu dois craindre ce semble, et de la même loi Que tu me veux prescrire, en faire une pour toi.
Es tu d’aage, de biens, ou d’humeur plus ſortable?	Es tu d'âge, de biens, ou d'humeur plus sortable?
Crois tu treuuer en elle vn eſprit plus traictable?	Crois -tu trouver en elle un esprit plus traitable?
Reſoudrois tu Celie à partager tes feux Quand meſme tes parens voudroient ce que tu veux?	Résoudrais -tu Célie à partager tes feux Quand der tes parents voudraient ce que tu veux?
CELIANTE.	CELIANTE.
I'ay peu de vanité, mais ſouffre que ie croye Qu'elle me receuroit auec beaucoup de ioye, Qu'elle verroit mes vœux d’vn œil plus ſatisfaict, Et que tu ſerois vain des biens qu’elle me faict.	J'ai peu de vanité, mais souffre que je croie Qu'elle me recevrait auec beaucoup de joie, Qu'elle verrait mes vœux d'un œil plus satisfait, Et que tu serais vain des biens qu'elle me fait.
LVCIDOR.	LUCIDOR.
Cette amour, Celiante, eſt vn choix legitime, Son diuin iugement éclatte en cette eſtime;	Cette amour, Céliante, est un choix légitime, Son divin jugement éclatte en cette estime;
Le Ciel quand tu naſquis tint ſes treſors ouuers, Et ſes rares appas charment tout l’Uniuers.	Le Ciel quand tu nasquis tint ses trésors ouverts, Et ses rares appas charment tout l'Univers.
CELIANTE.	CELIANTE.
Je ne me flatte point de creances ſi vaines, Il luffit que Celie est ſenſible à mes peines, Et qu’ayant le pouüoir de diſpoſer de ſoy, Eile en ordonneroit en fautur de ma jeye	Je ne me flatte point de créances si vaines, Il luffit que Celie est sensible à mes peines, Et qu'ayant le pouvoir de disposer de soi, Eile en ordonnerait en fautur de ma jeie
V CIDOR.	V CIDOR.
Adieu, cueille les fruicts d'vne ardeur ſi fidelle, Ioüy de ſon amour quand ie ioüyray d’elle, Que Celie en tes feux prend vne iuſte part.	Adieu, cueille les fruits d'une ardeur si fidèle, Ioui de son amour quand quelque jouirai d'elle, Que Célie en tes feux prend une juste part.
ALAAANAE, Sei elldico Tu te gauſſes trou tost!	ÀLANANAE, Sei elldico Tu te gausses trou tôt!
LVCIDOR.	LUCIDOR.
Tu te plaindras trop tard.	Tu te plaindras trop tard.
Au poinct que de mes maux on doit borner la cour.	Au point que de mes maux on doit borner la cour.
Il contiL’inſenſé cherche aux ſiens encor quelque reſource, Filidan, e ſuperbe riual ne de eſpere pas De poſſeder Celie, & la voir en mes bras, Son pere a prononcé l’arreſt irreuocable Qui donne à mes ſouhaits vn bien ſi delectable, Son pouuoir abandonne à mes ſoings amoureux;	Il contiL'insensé cherche aux siens encor quelque ressourse, Filidan, e superbe rival ne de espere pas De posséder Célie, et la voir en mes bras, Son père a prononcé l'arrêt irrévocable Qui donne à mes souhaits un bien si délectable, Son pouvoir abandonne à mes soin amoureux;
Ce treſor qui ynaroit des Mionarques neureux Toutefois Filidan il faut que ie confeſſe, Vn regret qui ſe ioint au deſſein que ie preſſé, Celie eſt adorable, il ſt vray, mais	Ce trésor qui ynarait des Mionarques neureux Toutefois Filidan il faut que deux confesse, Un regret qui se joint au dessein que je pressé, Célie est adorable, il st vrai, mais
FILIDAN.	FILIDAN.
Quoy, mais?	Quoi, mais?
LVCIDOR.	LUCIDOR.
Un ſecret reventir n'altere ſes attraicts;	Un secret réventir n'altère ses attraits;
Tous l’iy neat que ſa grace, & moy que ſa fortune, Elle n’eſt à mes yeux, qu’vne beauté commune, Ie regrette Angelique, & ma iuste douleur Me peint tous les obiets d’vne fauſſe couleur Qu'vn premier obiet charme!	Tous l'y neat que sa grâce, et moi que sa fortune, Elle n'est à mes yeux, qu'une beauté commune, Je regrette Angelique, et ma juste douleur Me peint tous les objets d'une fausse couleur Qu'un premier objet charme!
& que ſes moindres Tates Dans le cœur d’vn amant font de profondes traces?	et que ses moindres Tates Dans le cœur d'un amant font de profondes traces?
FILIDAN.	FILIDAN.
Quel eſt cette Angelique?	Quel est cette Angélique?
VCIDOR.	VCIDOR.
fie iquoy, ne ſçais tu pas?	fie ici, ne sais tu pas?
Quoy?	Quoi?
FILIDAN.	FILIDAN.
LVCIDOR.	LUCIDOR.
Que ma negligence a cauſé ſon trépas!	Que ma négligence a causé son trépas!
Qe vuy coupp te ſie de la pin veue ccre Que les mains de la mort ayent encore rauie,	Que vu coupp te sièie de la pin vue crècre Que les mains de la mort aient encore ravie,
FILIDAN.	FILIDAN.
Ie n'en ay rien appris.	Je n'en ai rien appris.
LVCIDOR.	LUCIDOR.
Ecoute en peu de mots Ce fatal accident qui trouble mon repos;	Écoute en peu de mots Ce fatal accident qui trouble mon repos;
Seiournant à Lyon, au logis de ma tante Ie vis, & i’admiray cette beauté naiſſante, Mes yeux furent charmés, & ſes moindres at traicts Furent à ma raiſon d’inéuitables traicts;	Sournant à Lyon, au logis de ma tante Je vis, et j'admirai cette beauté naissante, Mes yeux furent charmés, et ses moindres at traits Furent à ma raison d'inéuitables traits;
	
Là ce cœur conſentit à ſes premieres peines, La, ie ſouſmis ces bras à leurs premieres chaiſnes, Et là, ie recogn us pour la premiere fois Du tyran de nos ſens les redoutables lois.	Là ce cœur consentit à ses premières peines, La, ie sousmis ces bras à leurs premières chaînes, Et là, ie recognnus pour la première fois Du tyran de nos sens les redoutables lois.
Je tovchay Filidan cette ame de ma vie Je treuuay ſon deſir conforme à mon enuie, Nos bras de meſmes fers ſe virent arreſtés Et nos cœurs reſpiroient de meſmes voluptés;	Je trouvai Filidan cette âme de ma vie Je trouvai son désir conforme à mon envie, Nos bras de mêmes fers se virent arrêtez Et nos cœurs respiraient de mêmes voluptés;
Un deſſein mutuel obligea nos deux ames A n'eteindre iamais ces innocentes flames, Sa foy me fut donnee, & d’vn commun accord Je mis le changement au delà de ma mort, Enfin par vn aduis d’vne extréme importancę Ie fus reduit au poinct de perdre ſa preſence.	Un dessein mutuel obligea nos deux âmes À n'éteindre jamais ces innocentes flammes, Sa foi me fut donnée, et d'un commun accord Je mis le changement au delà de ma mort, Enfin par un avis d'une extrême importanc Je fus réduit au point de perdre sa présence.
Ie reuins à Florence obligé par ſerment De borner dans ſix mois ce triſte eſloignement;	Je revins à Florence obligé par serment De borner dans six mois ce triste éloignement;
Mais ce temps expiré, l'hyuer, & ma pareſſe Me firent differer l’effect de ma promeſſe, Et tans me figurer ſa triſteſſe, & ſes pleurs I'attendis la ſaiſon qui ſe pare des fleurs, Lors ie me diſpoſois a reuoir cette belle, Quand i’appris de ſa mort la fatale nouuelle;	Mais ce temps expiré, l'hiver, et ma paresse Me firent différer l'effet de ma promesse, Et tans me figurer sa tristesse, et ses pleurs J'attendis la saison qui se pare des fleurs, Lorsqu' ie me disposais a revoir cette belle, Quand j'appris de sa mort la fatale nouvelle;
Elle me ſoupçonna d’vn honteux changement, Et ſa perte ſuiuit vn ſi faux ſentiment.	Elle me soupçonna d'ins honteux changement, Et sa perte suiuit un si faux sentiment.
ILIDAN.	ILIDAN.
O Dieux!	Ô Dieux!
que dites-vous!	que dites-vous!
LVCIDOR.	LUCIDOR.
Apres ceſte infortune, La mort m’eſt deſirable, & Celie importuné, Et ie ſuys ſeulement la reſolution D’vn pere, qui m’immole a ſon intention.	Après cette infortune, La mort m'est désirable, et Celie importuné, Et iecluis seulement la résolution D'un père, qui m'immole a son intention.
SCENE DEVXIESME ERASME, LVCIDOR, FILIDAN,	SCÈNE DEUXIÈME ERASME, LUCIDOR, FILIDAN,
LVCIDOR.	LUCIDOR.
Mou proceue, Mtonfieur, ceite metancholie?	Mou proçue, Mtonfieur, ceite métancholie?
ERASME.	ERASME.
Joignés a mes ennuys vos ſouſpirs, & vos pleurs, Teſmoignons a l’enuy nos communes douleurs:	Joignez à mes ennui vos soupirs, et vos pleurs, Témoignons à l'envi nos communes douleurs:
AVSIBON.	AUSIBON.
Quel accident nouueau differe les delices Que ſon conſentement accorde a mes ſeruices, Quel malheur ſuruenu diuertit nos plaiſirs, Et quelle occaſion demande vos ſouſpirs?	Quel accident nouveau diffère les délices Que son consentement accorde à mes services, Quel malheur survenu divertit nos plaisirs, Et quelle occasion demande vos soupirs?
ERASME.	ERASME.
Pleurés, pleurés ſon mal, vne telle manie A d’auec ſon eſprit ſa raiſon deſ-vnie, Que ceux où l’amitié font vn pieux effort Font beaucoup pour ſon bien de ſouhaitter ſa mort.	Pleurez, pleurez son mal, une telle manie A d'avec son esprit sa raison des-unie, Que ceux où l'amitié font un pieux effort Font beaucoup pour son bien de souhaiter sa mort.
CIDOR.	CIDOR.
Quoy, Celie est troublee?	Quoi, Celie est troublée?
ERASME.	ERASME.
Ouy, mais de telle ſorte, Que tout remede eſt vain au mal qui la tranſporte, Vn Demon furieux poſſede ce beau corps Oui quriee Ileuetins jerbient de vains efforts, Heureux ſi ſeulement les Miniſtres des temples Peuuent remedier a ce mal ſans exemples.	Oui, mais de telle sorte, Que tout remède est vain au mal qui la transporte, Un Démon furieux possède ce beau corps Oui qurie Ileuetins jerbient de vains efforts, Heureux si seulement les Ministres des temples Peuvent remédier à ce mal sans exemples.
VCIDOR.	VCIDOR.
O ſenſible malheur!	Ô sensible malheur!
ERASME.	ERASME.
Ie vais à Clidamant Orand Preſtre de nos Dieux, découurir ſon tourment, Puiſque ſes actions font iuger que ſa peine Excede les efforts de la ſcience humaine.	Je vais à Clidamant Orand Prêtre de nos Dieux, découvrir son tourment, Puisque ses actions font juger que sa peine Excède les efforts de la science humaine.
ILIDAN.	ILIDAN.
Deſlors que ie la vis chocquer voſtre deſſein Ie ne la iugeay pas auoir l’eſprit trop ſain, Et ie rabattis fort, en cinq, ou ſix viſites De l’eſtime qu'on faict de ſes rares merites, Ie doute ſeulement ſi ſa preſomption Euſt eſté ſupportable à ma condition, Ie voudrois feu, pour feu, des larmes, pour des larmes, Ie voudrois triompher quand ie rendrois les armes, Voir rire, quand ie ris, voir ſouffrir en ſouffrant, Voir venir, quand i’irois, en fin prendre en m'offrant.	Deslors que venir la vis chocquer votre dessein Je ne la jugeai pas avoir l'esprit trop sain, Et jour rabattis fort, en cinq, ou six visites De l'estime qu'on fait de ses rares mérites, Je doute seulement si sa présomption Eût été supportable à ma condition, Je voudrais feu, des larmes, des larmes, pour des larmes, Je voudrais triompher quand quelque rendrais les armes, Voir rire, quand ieclis, quand souffrir en souffrant, Voir en, sou firois, en fin prendre en m'offrant.
IDOR.	JDOR.
Sçachant que l’intereſt & mon obeïſſance Ont ſeuls deſſus mes iours étably ſa puiſſance, Crois-tu que ſon amour m’importe infiniment Et m'as-tu veu pouſſer vn ſouſpir ſeulement, Mais elle vient a nous.	Sachant que l'intérêt et mon obéissance Ont seuls dessus mes jours établi sa puissance, Crois-tu que son amour m'importe infiniment Et m'as-tu vu pousser un soupir seulement, Mais elle vient à nous.
SCENE TROISIESME, CELIE, LA NOVRRICE, LVCIDOR, FILIDAN,	SCÈNE -TROISIÈME, CELIE, LA NOURRICE, LUCIDOR, FILIDAN,
EVcidor, ſi ma plainte, LA NOVRRICE, courant apres elle.	EUcidor, si ma plainte, LA NOURRICE, courant après elle.
Hé!	Hé!
Dieux, retenés la.	Dieux, retenez la.
CELIE, tenant Lucidor.	CELIE, tenant Lucidor.
Peut rendre vne ame attainte, Deliure de leurs mains ce miſerable corps Qui ne peut euiter leurs nuiſibles efforts, On me retient captiue, on me croit inſenſee Et tu voys, cher amant, ſi mon ame eſt bleſſee, Tu voys ſi i’extrauague & ſi mon iugement A iamais ſur mes ſens regné plus ſainment, Ma raiſon, diſent-ils, a perdu ſon vſage, Et ſans s’apperceuoir que leur pitié m'outrage, Ils cherchent vn remede a de vaines douleurs, Et forgent a leur gré le ſuiet de leurs pleurs.	Peut rendre une âme attainte, Délivre de leurs mains ce misérable corps Qui ne peut éviter leurs nuisibles efforts, On me retient captive, on me croit insensée Et tu vois, cher amant, si mon âme est blessée, Tu es si j'extravague et si mon jugement A iamais plu mes s' in plus ment, Ma raison, disent-ils, a perdu son usage, Et sans s'apercevoir que leur pitié moutrage, Ils cherchent un remède a de vaines douleurs, Et forgent à leur gré le sujet de leurs pleurs.
LVCIDOR.	LUCIDOR.
Ie ne puis, Filidan, deſſus quelle apparence, Fonder l’opinion de ſon extrauagance, Tout ce diſcours eſt ſain,	Je ne puis, Fidan, dessus quelle apparence, Fonder l'opinion de son extravagance, Tout ce discours est sain,
LA NOVRRICE.	LA NOURRICE.
Tla:	Tla:
que tes vons moments.	que tes vons moments.
Sont vne trefue courte a ſes cruels tourments.	Sont une trêve courte à ses cruels tourments.
CELIE.	CELIE.
On me croit inſenſee, et ma nourrice meſme Accorde ſa croyance a cette erreur extréme, Que me veulent ces gens?	On me croit insensée, et ma nourrice même Accorde sa croyance à cette erreur extrême, Que me veulent ces gens?
quel deſſein enuieux Peut obliger leur voix a dementir leurs yeux?	quel dessein envieux Peut obliger leur voix a démentir leurs yeux?
Depuis que i’ay paru ſur la terre, & ſur l’onde En ce char lumineux d’où i’eclaire le monde.	Depuis que j'ai paru sur la terre, et sur l'onde En ce char lumineux d'où j'eclaire le monde.
A t’on veu dans ces lieux par d’inégales loix Mon corps croiſtre, décroiſtre, & diuiſer les mois?	A -t-on vu dans ces lieux par d'inégales lois Mon corps croître, décroître, et diviser les mois?
Ay-ie voulu ſortir de la vaſte ceinture Où mon cours m'est preſcrit des mains de la nature, Ay-ie par imprudence expoſé l’Vniuers A voir la terre en flame, & mon char a l’enuers?	Ai-je voulu sortir de la vaste ceinture Où mon cours m'est prescrit des mains de la nature, Ai-je par imprudence exposé l'Univers A voir la terre en flamme, et mon char a l'envers?
Et bien?	Et bien?
LA NOVRRICE.	LA NOURRICE.
LVCIDOR.	LUCIDOR.
Las ce diſcours dißipe aſſés mes doutes;	Las ce discours dissipe assez mes doutes;
CELIE.	CELIE.
Je faicts les mois egaux par d’inégales routes, Et de tant de chemins, l’vn & l’autre ſentier Battu par mes cheuaux, ne faict qu’vn cercle entier, I'emprunte ma clarté des rayons de mon frere, Et ſi nous nous treuuons ſur vn meſme hemiſpheJl change ma lumiere en la couleur des Cieux, Et ma figure alors paroiſt ſeule a vos yeux, Nos ſeules deités au ſeiour ou nous ſommes Trauaillent ſans repos, pour le repos des hommes, Ce Dieu, dont chacun craint & reuere le nom, Demeure languiſſant dans les bras de Junon, Le Demon des combats, las du trauail des armes, Trouue au ſein de Uenus d’incomparables charmes, L’amour les tient oiſifs et pour nous ſeulement Il n’a point deſtiné de maistreſſe, & d’amant, Ie languis toutefois d’vne atteinte ſecrette La beauté d’vn chaſſeur preſide à ma défaite, Mais la neceſſité de pourſuiure mon cours Me deffend de le voir qu’vn moment tous les iours, Un baiſer dérobé ſur ſa bouche vermeille, Lors qu’en ſon ori(on tout le monde ſommeille Vn regard, vn adieu, ſont tout l’allegement Que ma condition permet à mon tourment.	Je faits les mois égaux par d'inégales routes, Et de tant de chemins, l'Honneur et l'autre sentier Battu par mes chevaux, ne fait qu'un cercle entier, J'emprunte ma clarté des rayons de mon frère, Et si nous nous trouvons sur un homme hémispheût été ma lumière en la couleur des Cieux, Et ma figure alors paraît re a vos yeux, Nos seules sont au seiour ou nous sommes à vos yeux, Nos se repos de hommes, Le Se, dont chacun craint et ère le a, Demeure languissant sans re bras de Pô, Pour Le re combats, las du trauail es hommes, Do au le de Uenus hom mes, Damour les tient oisifs etpour nous seulement Il cra point lie de maîtresse, et Dem,Ure languis toutefois d an secrette La beauté chasseur preside a ma défaite, Mais a necessité de poursuiure an cours Me défend de le voir moment tous les iours, Un as de sur sa bouche m, Lors buen son du le monde sommeille regard, adieu, et tout la Que ma condition permet mon tourment.
LVCIDOR.	LUCIDOR.
Dieux!	Dieux!
quelle impreßion trouble ſa fantaiſie!	quelle impression trouble sa fantaisie!
Et de quel genre helas!	Et de quel genre hélas!
est ceſte frenaiſie.	est cette frénaisie.
LA NOVRRICE.	LA NOURRICE.
Auons, entres Celie, ha!	Avons, entres Célie, ha!
mes efforts ſont vains, Preſtés voſtre aßiſtance à ces debiles mains.	mes efforts sont vains, Prêtez votre assistance à ces débiles mains.
CELIE.	CELIE.
Lucidor Quelle rage, inſenſés, porte voſtre inſolence A diuertir l’effect des rayons que ie lance?	Lucidor Quelle rage, insensés, porte votre insolence A diuertir l'effet des rayons que ie lance.
chappe, Orgueilleux Phaëtons, quel deſſein criminel Oppoſe vos efforts a cet ordre eternel?	chape, Orgueilleux Phaétons, quel dessein criminel Oppose vos efforts à cet ordre éternel?
L’orient a mon char ouure ſa large porte, Le bruict ceſſe par tout, & la lumiere est morte, Le Aſtres eſtonnés ſont en confuſion, Et la nature ſouffre a vostre occaſion, Voyés ces lieux obſcurs et cette plaine nuë Où les filles d’Atlas attendent ma venuë, Voulés vous contre l’ordre & contre la ſaiſon Tenir mon frere, & moy ſur vn meſme oriZon?	L'orient à mon char gure sa large porte, Le bruit cesse par tout, et la lumière est morte, Le Astres étonnés sont en confusion, Et la nature souffre a votre occasion, Voyez ces lieux obscurs et cette plaine nue Où les filles d'Atlas attendent ma venue, Voulés vous contre l'ordre et contre la saison Tenir mon frère, et moi sur un autre orizon?
S’eſtant J’ay vaincu leurs efforts & Diane outragee De leurs profanes mains enfin s'est dégagee, Suiuons les mouuements d’vne iuſte fureur, Et purgeons l’Uniuers de ces obiets d’horreur.	S'étant J'ai vaincu leurs efforts et Diane outragée De leurs profanes mains enfin s'est dégage, Suivons les mouvements d'une juste fureur, Et purgeons l'Univers de ces objets d'horreur.
Tirons de l’Ocean, & du ſein de la terre, Une matiere propre a forger vn tonnerre, Faiſons voir ces beaux lieux en rochers conuertis.	Tirons de l'Océan, et du sein de la terre, Une matière propre à forger un tonnerre, Faisons voir ces beaux lieux en rochers convertis.
Animons les ſuiets d’Æole, & de Thetis, Confondons ceſte pleine, & les pleines ſallees Rendons ces monts deſerts, ces Foreſts deſolees, El que pour tonte marque ilreſte dans ces lieux Celle de ce que peut vne fille des Dieux.	Animons les sujets d'Épole, et de Thétis, Confondons cette pleine, et les pleines sallées Rendons ces monts déserts, ces Forêts désolées, Él que pour tonte marque ilreste dans ces lieux Celle de ce que peut une fille des Dieux.
CIDOR.	CIDOR.
Que ceſte impreßion eſt forte en ſa penſee, Que ſon mal est puiſſant & ſa raiſon bleſſee.	Que cette impression est forte en sa pensée, Que son mal est puissant et sa raison blessée.
CELIE, à Lucidor.	CELIE, à Lucidor.
Quoy, iuſques dans ces lieux, tu veux ſuiure mes pas?	Quoi, jusque dans ces lieux, tu veux suivre mes pas?
Ce perilleux deſſein ne t’épouuante pas?	Ce périlleux dessein ne t'épouvante pas?
Es-tu de ces Titans dont l’audace effrontée A iuſques dans les Cieux l’arrogance portee?	Es-tu de ces Titans dont l'audace effrontée A jusque dans les Cieux l'arrogance portée?
Es-tu du ſang honteux de ce monſtre a cent mains Qui fiſt contre les Dieux ſoufleuer les humains, Celeſtes cytoyens puniſſés ce profane Uniſſés voſtre force à celle de Diune, Mais ces bras ſuffirout, & cet vnique effort Te liure temeraire, au pouuoir de la mort.	Es-tu du sang honteux de ce monstre à cent mains Qui fît contre les Dieux souffleuver les humains, Célestes citoyens punissés ce profane Unissés votre force à celle de Diune, Mais ces bras suffirout, et cet unique effort Te livre téméraire, au pouvoir de la mort.
LVCIDOR, s’enfuyant Adieu, ie cede aux coups,	LUCIDOR, s'enfuyant Adieu, tu cède aux coups,
FILIDAN, le ſuiuant, Ie renonce aux maistreſſes Qui traictent leurs amants de ſemblables careſſes.	FILIDAN, le suivant, Je renonce aux maîtresses Qui traitent leurs amants de semblables caresses.
SCENE QVATRIESME.	SCÈNE QUATRIÈME.
LA NOVRRICE, CELIE, ſeuls.	LA NOURRICE, CÉLIE, seuls.
LA NOVRRICE.	LA NOURRICE.
leux!	leux!
que vous feignés bien, i’admire vostre eſprit, D’obſeruer de tout poinct ce qui vous eſt preſcrit, eluy de qui feignant vous ſuiués la priere, Rencontre en ſa maistreſſe vne docte eſcoliere, Vos gestes m'estonnoient, & vous ne pouués mieux Paſſer pour inſenſee en l’eſtime des yeux, Voyant vostre action ſi facile, & ſi nuë I'ay douté, que feignans, vous l’eſtiès deuenuë.	que vous feignez bien, j'admire votre esprit, D'observer de tout point ce qui vous est prescrit, elleui de qui feignant vous suiués la prière, Rencontre en sa maîtresse une docte écolière, Vos gestes m'étonnaient, et vous ne pouvez mieux Passer pour insensée en l'estime des yeux, Voyant votre action si facile, et si nue J'ai douté, que feignants, vous l'étiez devenue.
CELIE.	CELIE.
Donne cette loüange et ces eſtonnements Au Demon qui regit les eſprits des amants, * V- –- Voy que mon Lucidor a de puiſſantes armes Priſe de ces effects le pouuoir de ſes charmes, Jl'ordonne à mes ſens cette honteuſe loy, Ie feints pour eſtre à luy de n’eſtre plus à moy, Et pour luy conpernonmom ejpru qu'u poſſede, Feindre que ie le perds eſt mon dernier remede.	Donne cette louange et ces étonnements Au Démon qui régit les esprits des amants, * V-int- Pour être mon Lucidor a de puissantes armes Prise de ces effets le pouvoir de ses charmes, Jlordonne à mes sens cette honteuse lois, Je feints pour avoir à lui de n'être plus à moi, Et pour un conpernonmom ejpru qu'u possède, Feindre que ie le perds est mon dernier de.
LA NOVRRICE.	LA NOURRICE.
Uous luy deués beaucoup, quel autre vous aymant.	Uous lui devez beaucoup, quel autre vous aimant.
Se fuſt à ſon deſſein porté ſi librement, Sous vn habit de peintre aux loix de vostre pere Auoir aſſuietti ce cœur qui vous reuere, Celie, à des Seigneurs de ſa condition Eſt-ce vn leger effect de leur affection?	Se fût à son dessein porté si librement, Sous un habit de peintre aux lois de votre père Auoir assuiétti ce cœur qui vous révère, Celie, à des Seigneurs de sa condition Est-ce un léger effet de leur affection?
L’eſpoir de releuer ſa conſtance abatuë, Et la difficulté de voir ce qui le tue, Luy firent propoſer ce penible deſſein Qui ne luy vaut encor qu’vn eſpoir incertain, On vous destine ailleurs, & ſi par cette ruſe, Jl n’obtient cet effect que chacun vous refuſe, Attendant qu’on apporte en ces lieux écartés Les titres de ſa race & de ſes digniles, Il flatte ſes deſirs d’vne eſperance vaine, Et verra Lucidor triompher de ſa peine, Lucidor inégal à ce parfaict amant, Et qui n’a rien de luy que le nom ſeulement.	L'espoir de relever sa constance abattue, Et la difficulté de voir ce qui le tue, Lui firent proposer ce pénible dessein Qui ne avait vaut encor qu'être espoir incertain, On vous destine ailleurs, et si par cette ruse, Jl n'obtient cet effet que chacun vous refuse, Attendant qu'on apporte en ces lieux écartés Les titres de sa race et de ses digniles, Il flatte ses désirs d'une espérance vaine, Et verra Lucidor triompher de sa peine, Lucidor ingal à ce parfait amant, Et qui n'arien de lui que le nom seulement.
CELIE.	CELIE.
I'eſpere vn rare effect de cette heureuſe feinte, Mais, tu cognois d’ailleurs le ſuiet de ma crainte, Lucidor m’a perduë́ & ſon ardent deſir M'a rendu cherement vn moment de plaiſir, Ma groſſeſſe en feignant peui-eſtre decouuerte, Et ce malheur extréme acheueroit ma perte.	J'espère un rare effet de cette heureuse feinte, Mais, tu connais d'ailleurs le sujet de ma crainte, Lucidor m'a perdue et son ardent désir M'a rendu chèrement un moment de plaisir, Ma grossesse en feignant peu-être découverte, Et ce malheur extréme achèverait ma perte.
LA NOVRRICE.	LA NOURRICE.
I’ay pourueu la deſſus & par bonne raiſon ’ay tous les Medecins bannis de la maiſon, Faict croire à vos parens qu’au mal qui vous poſſede Le Ciel peut ſeulement apporter du remede;	J'ai pourvu la dessus et par bonne raison aay tous les Médecins bannis de la maison, Fait croire à vos parents qu'au mal qui vous possède Le Ciel peut seulement apporter du remède;
Que vos ſens ſont troublés par de mauuais eſprits, Que des ſignes puiſſants me l’ont aſſés appris, Qu'vn regard vers le Ciel, vn mot, vne priere, Rend à vostre raiſon ſa liberté premiere, En vn mot ils m’ont creuë, & n’apprehendés point Que cet autre malheur à vos malheurs ſoit iomct.	Que vos sens sont troublés par de mauvais esprits, Que des signes puissants me l'ont assez appris, Qu'un regard vers le Ciel, un mot, une prière, Rend à votre raison sa liberté première, En un mot ils m'ont crue, et n'appréhendez point Que cet autre malheur à vos malheurs soit jomct.
SCENE CINC VIESME.	SCÈNE CINC VIESME.
LVCIDOR, ſous le nom de Leandre.	LUCIDOR, sous le nom de Léandre.
CELIE, LA NOVRRICE,	CELIE, LA NOURRICE,
CELIE.	CELIE.
Où vient à Lucidor cette melancholie:	Où vient à Lucidor cette mélancolie:
LEANDRE.	LÉANDRE.
De mon malheur extréme, adorable Celie, Avfais ne m'appelles point de ce nom bien-heureux, Qui ne peut que trahir nos deſſeins amoureux, Appellés moy Leandre;	De mon malheur extrême, adorable Celie, Avais ne m'appelles point de ce nom bienheureux, Qui ne peut que trahir nos desseins amoureux, Appellés moi Léandre;
CELIE.	CELIE.
Et bien, mais quelle crainte, Nous paroiſt de nouueau ſur ce viſage peinte?	Et bien, mais quelle crainte, Nous paraît de nouveau sur ce visage peinte?
Noſtre feinte ſuccede, & deſia vos riuaux Paroißent dégouſtés du fruict de leurs trauaux, Lucidor plaint ma peine, & ie croy qu’en ſon ame, La pitié deſormais agit plus que ſa flame.	Notre feinte succède, et déjà vos rivaux Paroissent dégoûtés du fruit de leurs travaux, Lucidor plaint ma peine, et un crois qu'en son âme, La pitié désormais agit plus que sa flamme.
LE’ANDRE.	LE'ANDRÉ.
I'engage ce que i’ayme, en mon propre malheur Et ce regret Madame, eſt ma pire douleur;	J'engage ce que j'aime, en mon propre malheur Et ce regret Madame, est ma pire douleur;
Si le Ciel outrageoit ma ſeule deſtinee Si ie voyois en moy ſa hayne terminee, Ses coups les plus peſants, & les plus furieux Seroient à mon amour des fignes glorieux, Ces Aſtres que i’adore et pour qui ie ſouſpire, Pourroient d’vn ſeul regard alleger mon martyre, Ie rirois le premier de ce déguiſement, Ie me peindrois moy-meſme auec ce veſtement, Parmy ces paſſetemps ie cherirois ma vie, Et ie verrois des Roys, & des Dieux ſans enuie.	Si le Ciel outrageait ma seule destinée Si on voyais en moi sa haine terminée, Ses coups les plus pesants, et les plus furieux Seraient à mon amour des fignes glorieux, Ces Astres que j'adore et pour qui était soupire, Pourraient d'à seul regard alléger mon martyre, Je rirais le premier de ce déguisement, Je me peindrais moi-même auec ce vêtement, Parmi ces passetemps ie chérirais ma vie, Et ie verrois ma Vie, et des Dieux sans envie.
Mais de voir que Celie ayt part à mes ennuis, De l’auoit expoſee au danger où te ſuis, De tacher ſon eſtime, & de la voir contraincte A la neceßité d’vne honteuſe feinte, C’est où i’ay des ſuiets de deteſter mon ſort, C’eſt là que la conſtance eſt vn barbare effort.	Mais de voir que Celie ait part à mes ennuis, De l'avait expose au danger où te suis, De tacher son estime, et de la voir contrainte A la necessité d'une honteuse feinte, C'est où j'ai des sujets de détester mon sort, C'est là que la constance est un barbare effort.
SELEL.	SELEL.
Te puis-ie commander?	Te puis-je commander?
LEANDRE.	LÉANDRE.
Auecques plus d’empire	Avecques plus d'empire
CELIE.	CELIE.
C’eſt aſſés, s’il est vray, fay, ce que ie deſire, Bannis ces vains reſpects vy plus ioyeuſement, Et fay de ma folie vn diuertiſſement, Attendant le retour de celuy qui t’apporte Ce qui r'amenera ton eſperance morte, Les titres de ta race & l'état de tes biens, Qui ioinaront les deſirs ue mes parens aux tiens.	C'est assez, s'il est vrai, fais, ce queris désire, Bannis ces vains respects vi plus ioyeusement, Et fais de ma folie Et diuertissement, Attendant le retour de celui qui t'apporte Ce qui ramènera ton espérance morte, Les titres de ta race et l'état de tes biens, Qui ioinaront les désirs ue mes parens aux tiens.
LEANDRE.	LÉANDRE.
Ie vous obeyray.	Je vous obéirai.
CELIE.	CELIE.
Tu verras ſi bien feindre, Que i'en mettray beaucoup en état de me plaindre.	Tu verras si bien feindre, Que j'en mettrai beaucoup en état de me plaindre.
INOIE II DCLAS ENCEMILNLS ERASME, CLIDAMANT, grand Preſtre.	INOIE II DCLAS ENCEMILNLS ERASME, CLIDAMANT, grand Prêtre.
Q Z a pali ERASME.	Q Z a pâli ERASME.
N ne peut ſans horreur voir ſes déreiglements, Son geſte, & ſes diſcours changent à tous moments, Tantoſt l’eſprit remis, l’œil riant, la voix ſaine, Elle dément nos yeux, rit de nous voir en peine, Et niant ſes diſcours ſçayt ſi bien conteſter Qu'elle met les plus ſains aux termes d’en douter:	N ne peut sans horreur voir ses dérèglements, Son geste, et ses discours changent à tous moments, Tantôt l'esprit remis, l'œil riant, la voix saine, Elle dément nos yeux, rit de nous voir en peine, Et niant ses discours sçayt si bien contester Qu'elle met les plus sains aux termes d'en douter:
Mais que ces bons momens ſont de peu de duree, Vn instant faict reuoir ſa raiſon alteree, Lors ſon geſte confus & l'horreur de ſes cris De crainte, & de pitié ſaiſiſſent les eſprits, -O- – A la voir l’œil ardent, les cheueux en deſordre Tordre tantoſt vn bras, & tantost le détordre, Se r'accourcir le corps, meurtrir ſon ſein de coups, Et ſauter furieuſe à la face de tous, Un homme eſt bien barbare & bien inacceßible, Si la pitié chés luy treuue vne ame inſenſible, Celeſte Medecin, eſpoir de ma maiſon, Si le Ciel peut encor rétablir ſa raiſon, Ses treſors ſont ouuerts à vos mains venerables, Seul vous pouués changer l’état des miſerables, Eſloignés de ſon corps cet eſprit inſolent Et calmés la fureur d’vn mal ſi violent.	Mais que ces bons momens sont de peu de durée, instant faict reuoir sa raison altérée, Lors son geste confus et l'horreur de ses cris De crainte, et de pitié saisissent les esprits, -Ô- A la voir ardent, les cheueux en désordre Tordre tantôt bras, et tantôt le détordre, Se accourcir le corps, meurtrir son sein de coups, Et sauter furieuse la face de tous, Un homme est bien barbare et bien Mai, Si la que ces lui treuue ons môme insensible, Sont De, peu de ma dure, Si Un In peut fait revoir sa raison, Ses Lors son geste confus et l' vénérables, Seul de ses changer état De crainte, Et de son pi cet saiinsolent Et les la fureur mal si ts,
CLIDAMANT.	CLIDAMANT.
Je ſerts les immortels, & ſi leur bonté m’ayde Eſperés de ſon mal l’infaillible remede, Nos crimes quelquesfois attirent ces malheurs, Et nos ſantés alors dependent de nos pleurs.	Je serts les immortels, et si leur bonté m'aide Espersés de son mal l'infaillible remède, Nos crimes quelquefois attirent ces malheurs, Et nos santés alors dépendent de nos pleurs.
SCENE DEVXIESMEACIDOR, FLOR, FILIDAN, E uierbe Re.	SCÈNE DEUXIESMEACIDOR, FLOR, FILIDAN, E uierbe Re.
Al que la vanité de ces folles conſtances I TVaut ſouuent, Filidan, de longues repentances!	Al que la vanité de ces folles constances I TUaut souvent, Filidan, de longues repentances!
On a promis Celie à mes vœux innocens Tandis que la raiſon en maiſtriſoit les ſens, Ie ne refuſois point qu’vn heureux mariage Ioigniſt à ſon deſtin ma fortune, et mon aage, Mais de la rechercher apres cet accident, Jl faut pour le pouuoir vn eſprit plus ardent, L’amour n’a pas ſi fort occupé ma penſee Que ie puiſſe en mon lict ſouffrir vne inſenſee, I'aurois veu de bon œil cet hymen reüßy Mais perdant la raiſon elle me perd außy.	On a promis Célie à mes vœux innocents Tandis que la raison en maîtrisait les sens, Je ne refusais point qu'un heureux mariage Joignît à son destin ma fortune, et mon aage, Mais de la rechercher après cet accident, Il faut pour le pouvoir un esprit plus ardent, L'amour n'a pas si fort occupé ma pensée Que je puisse en mon lit souffrir une insensée, J'aurais vu de bon œil cet hymen re m en la raison elle me perd aussy.
FILIDAN.	FILIDAN.
Penſés y meurement, folle, ou ſage, qu’importe Il faut conſiderer ce qu'elle vous apporte, Les plus fins en ce temps, épouſent les treſors, Et n’examinent point, ny l’eſprit, ny le corps, L’ayant, n’aurès vous pas quelque obiet qui vous plaiſe?	Pensez y meurement, folle, ou sage, qu'importe Il faut considérer ce qu'elle vous apporte, Les plus fins en ce temps, épousent les trésors, Et n'examinent point, ainsi l'esprit, ni le corps, L'ayant, n'aurès vous pas quelque objet qui vous plaise?
Vne femme enrichit et la maiſtreſſe baiſe, On ſe rit auiourd’huy des maris amoureux, Si leur femme estparfaicte, elle n’eſt pas pour eux.	Une femme enrichit et la maîtresse baise, On se rit aujourd'hui des maris amoureux, Si leur femme estparfaite, elle n'est pas pour eux.
Un amy plus courtois & l’obiect qui l'enflamme S’ils poſſedent le corps, d’autres poſſedent l’ame, Accommodés au temps vos inclinations, Et ne vous picqués point de vaines paßions.	Un ami plus courtois et l'objet qui l'enflamme S'ils possèdent le corps, d'autres possèdent l'âme, Accommodés au temps vos inclinations, Et ne vous piquez point de vaines passions.
CIDOR.	CIDOR.
Le reſpect, Filidan, qu’on doit à ce myſtere Doit retirer nos cœurs des autels de Cythé re, Rendre deſſus les ſens les eſprits abſolus Et nourrir la vertu chés les plus diſſolus, C’eſt là qu’vn long martyre accompagne les vices, Et que la continence établit les delices, Que le deſordre regne en des cœurs criminels, Et qu’on nourrit chés ſoy ſes bourreaux eternels Mille fois le Soleil est pally des carnages Que l’infidelité produit en des meſnages.	Le respect, Fidan, qu'on doit à ce mystère Doit retirer nos cœurs des autels de Cythé re, Rendre dessus les sens les esprits absolus Et nourrir la vertu chez les plus dissolus, C'est là qu'un long martyre accompagne les vices, Et que la continence établit les délices, Que le désordre règne en des cœurs criminels, Et qu'on nourrit chez soi ses bourreaux éternels Mille fois le Sol ont pally des carnages Que l'infidélité produit en des ménages.
Et ce malheur qui ſuit vn hymen vitieux N'épargnoit pas iadis les fils meſmes des Dieux, Alcide eust tout vaincu, s’il eust vaincu la flamme Qui contre ſes beaux iours fiſt attenter ſa femme, Et n’euſt pas rendu l’ame étouffé du poiſon, Si l’amour n’eust premier étouffe ſa raiſon.	Et ce malheur qui suit un hymen vitieux N'épargnait pas jadis les fils mêmes des Dieux, Alcide eût tout vaincu, s'il eût vaincu la flamme Qui contre ses beaux jours fit attenter sa femme, Et n'eût pas rendu l'âme étouffé du poison, Si l'amour n'eût premier étouffe sa raison.
FILIDAN.	FILIDAN.
Ces diſcours eſtoient bons au ſiecle d’Oriane, Aymer en lieux diuers c’estoit estre profane, Les plus doux changements eſtoient lors incogneus, Et le bon Amadis euſt rebuté Uenus, Mais ſes loix auiourd huy paſſent pour reſuerie De meſme que ſon ordre, & ſa cheualerie, La reſolution de ne changer iamais N'eſt plus que la vertu des hommes imparfaicts, On meſpriſe leurs vœux & cette reſiſtance Qu'on faict à leurs deſſeins établit leur conſtance:	Ces discours étaient bons au siècle d'Oriane, Aimer en lieux divers c'était être profane, Les plus doux changements étaient lors inconnus, Et le bon Amadis eût rebuté Uenus, Mais ses lois aujourd' hui passent pour rêverie De même que son ordre, et sa chalerie, La résolution de ne changer jamais N'est plus que la vertu des hommes imparfaits, On méprise leurs vœux et cette résistance Qu'on fait à leurs desseins établit leur constance:
D'amans ils ſont cenſeurs & par des titres faux Vantent vne vertu qui naiſt de leurs deffaux, Mais ie vole vn peu haut, retournons à Celie, Que ne peut à vos vœux permettre ſa folie, Ira-t’elle apres vous épier vos deſſeins, Et les iugera-t'elle ou profanes ou ſaincts?	D'amants ils sont censeurs et par des titres faux Vantent une vertu qui naît de leurs défauts, Mais venir vole un peu haut, retournons à Célie, Que ne peut à vos vœux permettre sa folie, Ira-t-elle après vous épier vos desseins, Et les jugera-t'-elle ou profanes ou saints?
Que de gens cheriroient vostre bonne fortune, Une femme d’eſprit eſt touſiours importune, Vne ialouſe humeur la triſne apres vos pas Qui luy faict voir ſouuent meſme ce qui n’eſt pas, Son adreſſe ſurprend l’ame la plus ſenſee Explique vos regards lit dans voſtre penſee.	Que de gens chériraient votre bonne fortune, Une femme d'esprit est toujours importune, Votre jalouse humeur la trisne après vos pas Qui lui fait voir souvent même ce qui n'est pas, Son adresse surprend l'âme la plus sensée Explique vos regards lit dans votre pensée.
Et faict ſur vos deſſeins tant d’importuns efforts, Qu'elle eſt inſupportable aux eſprits les plus forts, Celie eſt en état de ſouffrir toute choſe Sans en conſiderer, ny l’effect, ny la cauſe, done muiuu pamiuuee com em Migus curieux, Dont les ſubtilités doiuent tromper les yeux.	Et fait sur vos desseins tant d'importuns efforts, Qu'elle est insupportable aux esprits les plus forts, Celie est en état de souffrir toute chose Sans en considérer, Seigneur l'effet, ni la cause, done muiuu pamiuuee com em Migus curieux, Dont les subtilités doivent tromper les yeux.
CIDOR.	CIDOR.
Porte ailleurs tes aduis, ſans conſeil de perſonne Ie ſuiuray là deſſus ce que l’honneur m’ordonne, Si ſon mal peut ceſſer le moment incertain iu venuru te fens int renura mon ueſſein.	Porte ailleurs tes avis, sans conseil de personne Je suivrai là -dessus ce que l'honneur m'ordonne, Si son mal peut cesser le moment incertain ju venuru te sens int renura mon ouvessein.
Si non, ie romps mes fers, & iamais ma franchiſe Ne verra d’autres yeux triompher de ſa priſe.	Si non, Seigneur romps mes fers, et jamais ma franchise Ne verra d'autres yeux triompher de sa prise.
ILIDAN Rare, & prudent effect d’vn eſprit genereux, Qu'en fin ie recognois plus libre qu’amoureux!	ILIDAN Rare, et prudent effet d'un esprit généreux, Qu'en fin éclats reconnais plus libre qu'amoureux!
Ie ſondois à deſſein iuſqu’où l’auare flame Qu'allume l’intereſt pourroit porter voſtre ame, Cette ardeur eſt commune au reſte des humains, Elle aueugle les fens, l’or plaiſt de toutes mains, Et vous ſeul oppoſés de genereuſes forces Et de fermes deſſeins, à ces douces amorces, Vous preferés l'honneur.	Je sondais à dessein jusqu'où l'avare flamme Qu'allume l'intérêt pourrait porter votre âme, Cette ardeur est commune au reste des humains, Elle aveugle les sens, l'or plaît de toutes mains, Et vous seul opposés de généreuses forces Et de fermes desseins, à ces douces amorces, Vous préferez l'honneur.
Dij	Dij
SCENE TROISIESME.	SCÈNE -TROISIÈME.
ERASME, CLIDAMANT, LVCIDOR, FILIDAN, Casa leaatlla lo	ERASME, CLIDAMANT, LUCIDOR, FILIDAN, Cas leaatlla lo
P Erdés ce ſentiment Eraſme, aucun Demon n’excite ſon tourment, Et i’ay trop recogneu qu’vne pure manie Exerce en ce beau corps ſa rigueur infinie, Des mitux mt font iefmoins que ie plains vos douleurs Ils enva Et que i’acheterois ſa ſanté de mes pleurs.	 Prdez ce sentiment Erasme, aucun Démon n'excite son tourment, Et j'ai trop reconnu qu'une pure manie Exerce en ce beau corps sa rigueur infinie, Des mitux mont font iefmoins que je crains vos douleurs Ils enva Et que j'achèterais sa santé de mes pleurs.
ERASME, LVCIDOR, FILIDAN,	ERASME, LUCIDOR, FILIDAN,
ERASME.	ERASME.
O Pere infortuné, ſous quel Aſtre ſeuere Le Ciel a-t’il ourdy ta vie & ta miſere?	Ô Père infortuné, sous quel Astre sévère Le Ciel a-t-il ourdi ta vie et ta misère?
Ou dois-tu recourir ſi ce mal furieux Paſſe l’art des mortels, & le pouuoir des Dieux?	Ou dois-tu recourir si ce mal furieux Passe l'art des mortels, et le pouvoir des Dieux?
VCIDOR.	VCIDOR.
Que ſeruiront, MMonſieur, ces inutiles plaintes?	Que serviront, MMonsieur, ces inutiles plaintes?
Quoy?	Quoi?
voſtre eſprit ſe rend aux premieres atteintes?	votre esprit se rend aux premières atteintes?
Et dans vne perſonne où regne la vertu Un premier accident treuue vn cœur abatu?	Et dans une personne où règne la vertu Un premier accident trouve un cœur abattu?
Souffrés ſans murmurer cette douleur extréme, C’eſt ainſi que le Ciel careſſe ce qu’il ayme, Ce que ſa main prodigue accorde aux paßions Marque moins ſon amour que les afflictions.	Souffrez sans murmurer cette douleur extrême, C'est ainsi que le Ciel caresse ce qu'il aime, Ce que sa main prodigue accorde aux passions Marque moins son amour que les afflictions.
ERASME.	ERASME.
Si quelque eſpoir au moins adouciſſoit ma peine, Et que ſa gueriſon ou ſa mort fuſt certaine, Ie verrois Lucidor d’vn œil reſpectueux;	Si quelque espoir au moins adoucissait ma peine, Et que sa guérison ou sa mort fût certaine, Je verrais Ludor d'un œil respectueux;
Tomber ſur mes vieux ans ce coup impetueux Mais auec ce malheur, de voir tout ce que i’ayme Endurer ſans mourir, pire que la mort meſme, Une honteuſe marque en reste à ma maiſon, Qui faict contre le Ciel rebeller ma raiſon, Ie tente vainement pour ſoulager ſa peine Et le pouuoir celeſte, & la ſcience humaine, Tous remedes ſont vains, & mon ſoing impuiſſant, Ne cauſe point de criſe aux douleurs qu’elle ſent.	Tomber sur mes vieux ans ce coup impétueux Mais avec ce malheur, de voir tout ce que j'aime Endurer sans mourir, pire que la mort même, Une honteuse marque en reste à ma maison, Qui fait contre le Ciel rebeller ma raison, Je tente vainement pour soulager sa peine Et le pouvoir celeste, et la science humaine, Tous remèdes sont vains, et mon soing impuissant, Ne cause point de crise aux douleurs qu'elle sent.
LVCIDOR.	LUCIDOR.
Monſieur, puis qu’au rapport de ce ſainct perſons nage Vn Demon dans ſon corps n’exerce point ſa rage, Et qu’vn déreiglement ſi grand & ſi ſoudain N’eſt que le triste effect d’vn accident humain, Tentons contre ce mal vne derniere voye, Et ſouffrés ſeulement qu’vne fille la voye, Elle employe vn ſecret ſi rare, & ſi vanté Contre les accidens de cette qualité, Contre tous les effects de la melancholie Que i’eſpere beaucoup au von fens de Celie, Ce ſecret faict par tout publier ſon fenom, On m’en vient de parler.	Monsieur, puis qu'au rapport de ce saint persons nage Un Démon dans son corps n'exerce point sa rage, Et qu'un dérèglement si grand et si soudain N'est que le triste effet d'un accident humain, Tentons contre ce mal une dernière voie, Et souffrés seulement qu'une fille la voie, Elle emploie un secret si rare, et si vanté Contre les accidents de cette qualité, Contre tous les effets de la melancholie Que j'espère beaucoup au von sens de Celie, Ce secret fait par tout publier son fenom, On m'en vient de parler.
ERASME.	ERASME.
Jgnorés-vous ſon nom?	Ignorez-vous son nom?
LVCIDOR.	LUCIDOR.
C'eſt vne Pellerine, illuſtre de naiſſance, Dont les plus beaux eſprits vantent la cognoißan Qui ſe faict renommer ſans eſpoir d’interests, Et dont la charité débite les ſecrets, Mais il faut au pluſtoſt conſulter ſa ſcience, Car on dit que demain, elle part de Florence, Doriſe eſt ſon hoſteſſe;	C'est assez Pellerine, illustre de naissance, Dont les plus beaux esprits vantent la cognoissan Qui se fait renommer sans espoir d'intérêts, Et dont la charité débite les secrets, Mais il faut au plustost consulter sa science, Car on dit que demain, elle part de Florence, Dorise est son hôtesse;
ERASME.	ERASME.
O Dieux!	Ô Dieux!
qu’vn doux eſpoir Soulage ma douleur!	qu'un doux espoir Soulage ma douleur!
allons, courrons la voir.	allons, courrons la voir.
CIDOR.	CIDOR.
Sa curioſité, qui luy faict voir la ville Pourroit rendre, Monſieur, noſtre peine inutile, Filidan ira voir ſi l’on luy peut parler Et deſſus ſon rapport nous y pourrons aller, Cours, ne differe point.	Sa curiosité, qui avait fait voir la ville Pourrait rendre, Monsieur, notre peine inutile, Filidan ira voir si l'on lui peut parler Et dessus son rapport nous y pourrons aller, Cours, ne diffère point.
ERASME.	ERASME.
Uoyons de quelle ſorte Agira maintenant le mal qui la tranſporte.	OUoyons de quelle sorte Agira maintenant le mal qui la transporte.
SCENE QVATRIESME, CELIANTE, FILIDAN,	SCÈNE QUATRIÈME, CELIANTE, FILIDAN,
FILIDAN.	FILIDAN.
Allois vous annoncer vn heureux changement.	Allais vous annoncer un heureux changement.
Nii CELIANTE.	Ni CÉLIANTE.
FILIDAN.	FILIDAN.
Celie eſt a vous, haſtés-vous ſeulement.	Celie est a -vous, hâtez-vous seulement.
CELIANTE, Ne flatte point mon mal d’eſperances friuolles,	CELIANTE, Ne flatte point mon mal d'espérances frivoles,
FILIDAN.	FILIDAN.
Nton, non, ſi fes eſſects vou prouuent mes pârolles?	Nton, non, si fes ès vou prouuent mes pâtrolles?
CELIANTE.	CELIANTE.
Je voudrois t’adorer.	Je voudrais t'adorer.
FILIDAN.	FILIDAN.
Courés y de ce pas, Mon maiſtre à vos deſirs cede ſes doux appas, Filidan m'a-t’il dit, puis qu’vne ingratte amante Prefere à mes deſſeins l’amour de Celiante, Ie force en ſa faueur mon inclination, Et ie cede Celie à ſon affection, Je l’ayme froidement, & ne vis point en elle, Les graces qu’y remarque vn amant ſi fidelle, Son viſage n’a point les attraits que ie veux, Et mon ſeul intereſt luy procuroit mes vœux, Ie conſerue vn amy cedant cette maiſtreſſe De qui l’auerſion paroist en ſa tristeſſe, Et ie veux vniſſant ce couple de mes mains Prouuer que ma froideur égale ſes dédains, Voy, dit-il, Celiante.	Courez y de ce pas, Mon maître à vos désirs cede ses doux appas, Filidan m'a-t-il dit, puis qu'une ingratte amante Préfère à mes desseins l'amour de Céliante, Je force en sa faveur mon inclination, Et ie ce Celie à son affection, Je faime froidement, et ne vis point en elle, Les grâces qu'y remarque un amant si fidèle, Son visage n'a point les attraits que je veux, Et mon seul intérêt lui était mes vœux, Je conserve un ami cédant cette maîtresse De qui l'aversion par en a isse, Et ne veux vnissant ce coup de mes mains Ce que ma cou égale ce dédains, , dit-il, Cou.
CELIANTE.	CELIANTE.
O faueur immortelle!	Ô faveur immortelle!
FLIDAN.	FLIDAN.
Et porte à ce riual cette heureuſe nouuelle,	Et porte à ce rival cette heureuse nouvelle,
ELIANTE, ſeul.	ÉLIANTE, seul.
O ſenſible bon-heurupamiote meſſager, Ne m'épargne iamais ſi ie puis t’obliger.	Ô sensible bonheurupamiote messager, Ne m'épargne jamais si ici puis t'obliger.
LIDAN, s’en allant.	LIDAN, s'en allant.
Mon maiſtre eſt chés Celie.	Mon maître est chez Célie.
CELIANTE.	CELIANTE.
En ce bon-heur inſigne, Quel art me peut fournir on vijeoms ajjes digne, Auec quelle careſſe égale à mon deſir Pourray-ie recognoiſtre vn ſi rare plaiſir?	En ce bonheur insigne, Quel art me peut fournir on vioms ajes digne, Avec quelle caresse égale à mon désir Pourrai-je reconnaître mille si rare plaisir?
Loing, effects importuns de ma melancholie;	Loing, effets importuns de ma mélancolie;
Ceſſes triſtes ſouſpirs, ie poſſede Celie, Tary ſource de pleurs en ces yeux bien-heureux, Puis qu'vn ſi beau Soleil doit éclairer pour eux, Et mourés vains regrets en cette heureuſe bouche Puis qu’il eſt ordonné que la ſienne la touche;	Cesses tristes soupirs, Seigneur possède Celie, Tari source de pleurs en ces yeux bienheureux, Puis qu'un si beau Soleil doit éclairer pour eux, Et mourez vains regrets en cette heureuse bouche Puis qu'il est ordonné que la sienne la touche;
e mon propre riual conſent à mon repos, Et qu’il me cede un bien, mais qu’il ſort à propos!	Je mon propre rival consent à mon repos, Et qu'il me cède un bien, mais qu'il sort à propos!
SCENE CINQVIESME, LVCIDOR, CELIANTE,	SCÈNE CINQUIÈME, LUCIDOR, CELIANTE,
CELIANTE, l’embraſſant.	CELIANTE, l'embrassant.
Onſieur, quelque ſuiet, qui vous ſepare M ácue Ie chery mon bon-heur & la cauſe en eſt belle, Soit qu’vn plus rare obiet regne ſur vos eſprits, Que ma felicité naiſſe de vos meſpris, Et que quelque deffaut ou du corps, ou de l’ame Qui ne me paroist point éteigne vostre flame;	Onsieur, quelque sujet, qui vous sépare MÊME ácue Je chéri mon bonheur et la cause en est belle, Soit qu ' rare objet règne sur vos esprits, Que ma félicité naisse de vos mépris, Et que quelque défaut ou du corps, ou de l'âme Qui ne me paraît point éteigne votre flamme;
Soit que le ſeul deſſein d’obliger vn amant Qui ſe propoſe en vain de cacher ſon tourment, Retire de ce lieu voſtre amour innocente;	Soit que le seul dessein d'obliger un amant Qui se propose en vain de cacher son tourment, Retire de ce lieu votre amour innocente;
Vous r’animés l’eſpoir d’vne ame languiſſante, Et comblés de faueurs vn cœur recognoiſſant Qui bruſte de pronuer comvien i ies reſſent;	Vous animés espoir âme languissante, Et comblés de faueurs cœur recognoissant Qui bruste de pronuer comvien y Vous ressent;
LVCIDOR, eſtonné.	LUCIDOR, étonné.
Qu'amour (cher Celiante) eſt vn Dieu redoutable, La folie aux amants eſt preſque inéuitable,	Qu'amour (cher Céliante) est un Dieu redoutable, La folie aux amants est presque inévitable,
CELIANTE.	CELIANTE.
Il trouble les eſprits, confond les iugemens Dans les cœurs les plus ſains faict des déreiglemens, Et s’acquiert tant de droict ſur l’humaine franchiſe, Qu'vn mortel faict beaucoup s’il empeſche la priſe, Les Dieux ont eu pour vous vne extréme bonté Et dezager vas jtns de jon auinorne, Vostre condition eſt bien digne d’enuie, Quoy que m’y condamner ſeroit m’oſter la vie.	Il trouble les esprits, confond les jugements Dans les cœurs les plus sains fait des dérèglements, Et s'acquiert tant de droit sur l'humaine franchise, Qu'un mortel fait beaucoup s'il empêche la prise, Les Dieux ont eu pour vous une extrême bonté Et dezager vas jeuns de jon avinorne, Votre condition est bien digne d'envie, Quoi que m'y condamner ait m'ôter la vie.
LVCIDOR.	LUCIDOR.
O Dieux!	Ô Dieux!
vn mal commun a troublé leur raiſon!	Un mal commun a troublé leur raison!
Nous ſoignons, Celiante, à voſtre gueriſon.	Nous soignons, Céliante, à votre guérison.
CELIANTE, Que mon propre riual ayt reſolu ſon pere D’accorder à mes vœux le ſuccés que i’eſpere!	CELIANTE, Que mon propre rival ait résolu son père D'accorder à mes vœux le succès que j'espère!
Dieux que vous puis-ie offrir, qui ne ſoit au deſſous De mon affection & d’vn plaiſir ſi doux!	Dieux que vous puis-je offrir, qui ne soit au dessous De mon affection et d'un plaisir si doux!
LVCIDOR.	LUCIDOR.
S'il eſt vray- que l’amour naiſt de la reſſemblance On vous diſpute à tort cette heureuſe alliance, L'état eſt ſi pareil de Celie, & de vous	S'il est vrai- que l'amour naît de la ressemblance On vous dispute à tort cette heureuse alliance, L'état est si pareil de Célie, et de vous
E ij Qu'elle doit eſtre voſtre au iugement de tous, Entres, vous la verres.	 Ej Qu'elle doit être votre au jugement de tous, Entres, vous la verres.
CELIANT E, entrant.	CELIANT E, entrant.
Hâ!	Hâ!
Dieu, que ie periſſe Quand i’oubliray l’honneur d’vn ſi pieux office.	Dieu, que je périsse Quand j'oublirai l'honneur d'un si pieux office.
CIDOR.	CIDOR.
Quelle melancholie a troublé ſes eſprits?	Quelle mélancolie a troublé ses esprits?
Que s’est-il figuré, quand ce mal l’a-t'il pris?	Que s'est-il figuré, quand ce mal l'a-t'-il pris?
Qu’amour corrompt les ſens, vn ſi honteux marEſt vn tribut commun qu’on doit à ſon Empire, Et la neceßité de viure ſous ſa loy Me faict par leur exemple apprehender pour moy, Qu'on le verra ſurpris à l’abord de Celie!	Qu'amour corrompt les sens, un si honteux marEst un tribut commun qu'on doit à son Empire, Et la nécessité de vivre sous sa loi Me fait par leur exemple appréhender pour moi, Qu'on le verra surpris à l'abord de Célie!
I’ay, luy voulant parler, veu ſa face pallie, Ses beaux yeux demy-morts, & ſans ordre roulants Tantoſt moüillés de pleurs tantoſt étincelants, Et ſes bras animés d’vne rage ſi forte Que la peur de ſes coups m’a faict gaigner la porte, Chacun tremble à la voir & ce fidelle amant N’aura pas ſans frayeur ce diuertiſſement.	J'ai, même voulant parler, vu sa face pallie, Ses beaux yeux demi-morts, et sans ordre roulants Tantôt mouillés de pleurs tantôt étincelants, Et ses bras animés d'une rage si forte Que la peur de ses coups m'a fait gagner la porte, Chacun tremble à la voir et ce fidèle amant N'aura pas sans frayeur ce divertissement.
SCENE SIXIESME.	SCÈNE SIXIÈME.
TLIDIIOSvOIDOLe,	TLIDIIOSvOIDOLe,
FILIDAN.	FILIDAN.
E ſors de chés Doriſe, où cette Pelerine Qu'au ſecours de Celie, vn bon Astre destine, Sera dans vn moment vn deſir curieux Mà pavle a cayher tes temples de tes Mnas	E sors de chez Dorise, où cette Pèlerine Qu'au secours de Celie, un bon Astre destine, Sera dans un moment un désir curieux Mà Maule a caher tes temples de tes Mnas
LVCIDOR.	LUCIDOR.
Ce ſoir nous la verrons.	Ce soir nous la verrons.
FILIDAN.	FILIDAN.
Monſieur, ſi l’on peut rire Aux deſpens d’vn riual qui ſouffre vn vain martyre, Riés de Celiante, & cognoiſſés comment La croyance au deſir ſe ioinct facilement, I’ay treuué ce riual, l’œil mourant, letein bleſme, Ou pour le peindre mieux different de luy-meſme, Et qui, (ſi i’ay bien leu dans cet eſprit mal ſain) Meditoit ſur ſa vie vn funeste deſſein, R’animeZ, (ay-ie dit) toute voſtre eſperance, Vous paſſés en bon-heur les amours de Florence, Celie eſt en état de n’estre plus qu’à vous.	Monsieur, si l'on peut rire Aux dépens d'un riual qui souffre un vain martyre, Riz de Céliante, et connaissez comment La croyance au désir se joint facilement, J'ai trouvé ce rival, l'œil mourant, letein blême, Ou pour le peindre mieux différent de h-même, Et qui, (si j'ai bien lu dans cet esprit mal sain) Méditait sur sa vie un este dessein, Ranimez, (ai-je dit) toute votre espérance, Vous passez en bonheur les amours de Florence, Celie est en état de n'à vous mat de vous.
Souſpirés conſtamment pour vn obiet ſi doux.	Souspirez constamment pour un objet si doux.
Mon maiſtre vous la cede:	Mon maître vous la cède:
à ces mots il m’embraſſe, Son viſage eſt pourueu de ſa premiere grce, Il rit du faux eſpoir de ſon allegement Cependant que ie ry de ſon aueuglement, Iugés quelle ſurpriſe agite ſa penſee S’il entend maintenant cette fille inſenſee, Ie crains vn triſte effect de ſa fidelité Et luy meſme auec ſoy n’eſt pas en ſeureté.	à ces mots il m'embrasse, Son visage est pourvu de sa première grâce, Il rit du faux espoir de son allégement Cependant que je ri de son aveuglement, Jugez quelle surprise agite sa pensée S'il entend maintenant cette fille insensée, Je crains un triste effet de sa fidélité Et lui même auec soi n'est pas en sûreté.
IDOR.	JDOR.
Tu m'apprends le ſuiet de ſes vaines careſſes Il m’a tant repeté d’inutiles promeſſes, Et tant importuné d’vn long remerciement Qu'il est paſſe pour fol dedans mon ſentiment, Mlais on ouure, c'eſt luy.	Tu m'apprends le sujet de ses vaines caresses Il m'a tant répété d'inutiles promesses, Et tant importuné d'H long remerciement Qu'il est passe pour fol dedans mon sentiment, Mlais on ouvre, c'est Seigneur.
SCENE SEPTIESME.	SCÈNE SEPTIÈME.
CELIE, CELIANTE, LVCIDOR, FILIDAN, CELIE, frappant Celiante.	CELIE, CELIANTE, LUCIDOR, FILIDAN, CÉLIE, frappant Céliante.
Voy!	Voi!
tu parois encore?	tu parais encore?
Temeraire riual du chaſſeur que i’adore, Il faut en ta faueur, (amant audacieux) Par les coups de ma main guerir ceux de mes yeux, Mais il fuit, & deſia, ie paſſois les limites Qu'à mon char lumineux la nature a preſcrites.	Téméraire rival du chasseur que j'adore, Il faut en ta faveur, (amant audacieux) Par les coups de ma main guérir ceux de mes yeux, Mais il fuit, et déjà, ainsi passais les limites Qu'à mon char lumineux la nature a prescrites.
CELIANTE.	CELIANTE.
Monſieur, i’ay trop contrainct voſtre chaſte deſir, tre.	Monsieur, j'ai trop contraint votre chaste désir, tre.
Uous m’aués obligé d’vn trop rare plaiſir, Ie remets en vos mains cent ujmarrs maiſtreſſe Et ne m’oppoſe plus à l’ardeur qui vous preſſe.	Uous m'avez obligé d'oppose trop rare plaisir, Je remets en vos mains cent ujmarrs maîtresse Et ne m'oppose plus à l'ardeur qui vous presse.
LVCIDOR.	LUCIDOR.
Quoy?	Quoi?
vous aués nourry des deſirs incertains, Et la facilité refroidit vos deſſeins?	vous avez nourri des désirs incertains, Et la facilité refroidit vos desseins?
O Dieux quel tuangements	Ô Dieux quel tuangements
CELIANTE.	CELIANTE.
Ma raiſon eſt la voftre, Adieu, faictes vos ieux de l’interest d’vn autre, Ren daxerauu te vie temie upus tonfupon Et le moindre ennemy nuit dans l’occaſion.	Ma raison est la vôtre, Adieu, faites vos jeux de l'intérêt d'un autre, Ren daxerauv te vie témie upus tonfupon Et le moindre ennemi nuit dans l'occasion.
CIDOR.	CIDOR.
Ainſi, contre mes iours, ta libre humeur exciteDes deſſeins dangereux,ſi ie ne les euite, Ce riual offencé ne peut ſouhaitter moins Que de nous voir vn iour armés, & ſans témoins.	Ainsi, contre mes jours, ta libre humeur exciteDes desseins dangereux,si ie ne les évite, Ce rival offensé ne peut souhaiter moins Que de nous voir un jour armés, et sans témoins.
FILIDAN.	FILIDAN.
Je cognoy, Celiante, & ie ſçay qui ie picque, Ne craignés de ſa part, ny deſſein, ny practique, Un ſeul de mes regards mon ombre ſeulement Fera, s’il eſt beſoing trembler ce vain amant:	Je connais, Céliante, et Seigneur sais qui vois picque, Ne craignez de sa part, notre dessein, Seigneur practique, Un seul de mes regards mon ombre seulement Fera, s'il est besoin trembler ce vain amant:
Ce lâche m'apordant, ſi ſa fureur luy dure Aura toute la peur comme toute l’iniure, Mais il ne manque point de generoſité Si l'on croit ce qu’il dit.	Ce lâche m'appordant, si sa fureur Ah dure Aura toute la peur comme toute l'injure, Mais il ne manque point de générosité Si l'on croit ce qu'il dit.
VCIDOR.	VCIDOR.
Ny toy de vanité.	Ni toi de vanité.
TT T EIY SCENE PREMIERE LEANDRE, LA NOVRRICE.	TT T IIY SCÈNE PREMIÈRE LÉANDRE, LA NOURRICE.
A vinle LEANDRE.	À vinle LÉANDRE.
A, cours, & diuerty la ſenſible miſere Dont nous peut affliger cette Dame étrangere, Contt à teite peaute la jatisfaction Qu'eſperent deux amants de ſa diſcretion, Ouure luy nos ſecrets et que ta confidence A ſeruir nos amours oblige ſa prudence.	À, cours, et diverti la sensible misère Dont nous peut affliger cette Dame étrangère, Contât à teite peaute la jatisfaction Qu'espèrent deux amants de sa discrétion, Ouvre même nos secrets et que ta confidence A servir nos amours oblige sa prudence.
LA RRICE, Si ie treuue ſon cœur ſenſible à la pitié, Sa bonté ſeruira voſtre ardente amitié, Ie veux que par mes ſoings vostre intereſt la touche, Qu'elle confirme tout & parle par ma bouche, Mais il faut redouter autant que le trépas Qu'Eraſme nous preuienne.	LA RRICE, Si ici trouve son cœur sensible à la pitié, Sa bonté servira votre ardente amitié, Je veux que par mes soings votre intérêt la touche, Qu'elle confirme tout et parle par ma bouche, Mais il faut redouter autant que le trépas Qu'Erâme nous prévienne.
LEANDRE.	LÉANDRE.
Adieu, preſſe tes pas.	Adieu, presse tes pas.
SCENE DEVXIESME.	SCÈNE DEUXIÈME.
ANGEEIQ V E5 Perenne, CLORIMAND, gentilh.	ANGEIQ V U5 Pérenne, CLORIMAND, gentilh.
ſuiuans.	suivants.
ANGELIQVE, Out ce qu’offre à mes yeux cette ſuperbe Uille, Faict contre ma triſteſſe vn effort inutile.	ANGELIQUE, Ut ce qu'offre à mes yeux cette superbe Uille, Fait contre ma tristesse un effort inutile.
Ie confonds Clorimand, toutes ces raretés Er may qu’vn œil égal pour ces diuerſités Ces antiques debris, ces temples magnifiques, Ces toicts d’or, & d’aZur, ces ſuperbes portiques, Ces haut murs & ces tours, en qui l’art des hu mains A mis ſi pres du Ciel l’ouurage de leurs mains;	Je confonds Clorimand, toutes ces raretés Er mai qu'un œil égal pour ces diversités Ces antiques débris, ces temples magnifiques, Ces toits d'or, et d'aZur, ces superbes portiques, Ces haut murs et ces tours, en qui l'art des hu mains A mis si pres du Ciel l'ouvrage de leurs mains;
Dans le ſecret ennuy dont ie ſuis trauerſee, Ne peuuent vn moment diuertir ma penſee, Et tu la peux iuger aux mots, que ie confonds, Lors que tu m’entretiens & que ie te reſponds.	Dans le secret ennui dont je suis traverse, Ne peuvent un moment divertir ma pensée, Et tu la peux juger aux mots, que je confonds, Lors que tu m'entretiens et que sans te répond.
CLORIMAND.	CLORIMAND.
I'ay peu de part, Madame, en voſtre confidence, Mais vos yeux ont ſouuent trahy voſtre prudence, Jls m’ont par leur tristeſſe exprimé vos douleurs, Souuent deſauoüés ils ont lâché des pleurs, Et ietté ſans deſſein des regards dans les nuës Qui figuroient aſſés vos peines incogneuës;	J'ai peu de part, Madame, en votre confidence, Mais vos yeux ont souvent trahi votre prudence, Jls m'ont par leur tristesse exprimé vos douleurs, Souvent desauoüés ils ont lâché des pleurs, Et jeté sans dessein des regards dans les nues Qui figuraient assez vos peines inconnus;
Qui vous faict obſeruer cette diſcrete loy, Et qui doit partager vos maux, plustoſt que moy, Aués vous reſolu de conſommer voſtre aage Dans les longues erreurs de ce triſte voyage?	Qui vous fait observer cette discrète loi, Et qui doit partager vos maux, plutôt que moi, Avez vous résolu de consommer votre âge Dans les longues erreurs de ce triste voyage?
Sommes nous Pelerins des Enfers, ou des Cieux?	Sommes nous Pèlerins des Enfers, ou des Cieux?
Cherchons nous le chemin qui conduit en ces lieux?	Cherchons nous le chemin qui conduit en ces lieux?
Nve reuerres vous plus, ny Lyon, ny ce Pere Que la neceßisé de ce vœu deſeſpere?	Ne reuerres -vous plus, ni Lyon, ni ce Père Que la necessisé de ce vœu désespère?
Et qui de tant de pleurs arrouſa ce beau ſein Quand il vous veid portee à ce pieux deſſein?	Et qui de tant de pleurs arrousa ce beau sein Quand il vous vit portée à ce pieux dessein?
ANGELIQVE.	ANGELIQUE.
Que vous estes deceus & qu’vn pretexte honneſte Vous cache heureux vieillards vne bonteuſe queſte, Ie ne viſite point les temples de nos Dieux, Uers eux, nostre priere arriue de tous lieux Je ſuy d’aueugles feux dont mon ame eſt atteinte, Une profane ardeur prend le nom d’vne ſaincte.	Que vous êtes déçus et qu'autre prétexte honnête Vous cache heureux vieillards une bonteuse quête' Une ne visite point les temples de nos Dieux, Uers eux, notre prière arrive de tous lieux Je suis d'aveugles feux dont mon âme est atteinte, Une profane ardeur prend le nom d'une sainte.
Ie cherche;	Je cherche;
ODe eMEes Quoy, Madame,	ODe eUMEes Quoi, Madame,
ANGELI E.	ANGELY .
Entrons, i’ay trop parlé,	Entrons, j'ai trop parlé,
Acheués.	Achevez.
CLORIMAND,	CLORIMAND,
Mais, B E L Un remede à ce cœur deſole.	Mais, B E Un remède à ce cœur désole.
CLORIMAND.	CLORIMAND.
Dieux!	Dieux!
qu’elle a de peine, & que ce long ſilence, D'vne forte douleur prouue la violence!	qu'elle a de peine, et que ce long silence, D'une forte douleur proue la violence!
Entrons, il faut ſonder plus auant ſa langueur, Et tirer auec art ce ſecret de ſon cœur,	Entrons, il faut sonder plus avant sa langueur, Et tirer avec art ce secret de son cœur,
SCENE TROISIESME, FILIDAN, CLORIMAND, FILIDAN, le tire par les habits, comme n’entre.	SCÈNE -TROISIÈME, FILIDAN, CLORIMAND, FILIDAN, le tire par les habits, comme n'entre.
Onſieur, Monſieur, vn mot.	Onsieur, Monsieur, un mot.
CLORIMAND.	CLORIMAND.
Quoy,	Quoi,
FILIDAN.	FILIDAN.
ette Pelerine, Dont on vante par tout la ſcience diuine, Eſt-elle de retour?	Jette Pelerine, Dont on vante par tout la science divine, Est-elle de retour?
CLORIMAND.	CLORIMAND.
Ou	Ou
FILIDAN.	FILIDAN.
Puis-ie ſeulement De la part d’vn Seigneur luy parler vn moment?	Puis-je seulement De la part d'une Seigneur lui parler un moment?
CLORIMANEE Attend, ie le ſçauray.	CLORIMANE Attend, Elle le saurai.
I LIDAN, ſeul Dieux!	I LIDAN, seul Dieux!
Textreme fouts D’eſperer de ſon art la ſanté de Celie:	Textrême fouts D'espérer de son art la santé de Celie:
Que penſe proffiter cét amant importun, Quand il la veut guerir d’vn malheur ſi commun?	Que pense proffiter cet amant importun, Quand il la veut guérir d'un malheur si commun?
Croit-il remedier au mal qui la tourmente Et loger la ſageſſe en l’eſprit d’vne Amante?	Croit-il remédier au mal qui la tourmente Et loger la sagesse en l'esprit d'une Amante?
Mais la voila qui ſort:	Mais la voilà qui sort:
Dieux, l’agreable objet!	Dieux, l'agréable objet!
Quel eſprit peut tenir contre vn ſi beau ſujet?	Quel esprit peut tenir contre un si beau sujet?
SCENE QVATRIESME.	SCÈNE QUATRIÈME.
ANGELIQVE, CLORIMAND,	ANGELIQUE, CLORIMAND,
FILIDAN, FILIDAN, continue parlant à elle.	FILIDAN, FILIDAN, continue parlant à elle.
Spoir des affligés, merueille ſans ſeconde, LUray, mais libre Soleil, qui viſités le monde, Et qui ſans intereſt departés aux mortels Ce qu'ils n’obtiennent pas meſme aux pieds des autels, Qui ne deniés point, ny vvoſtre art, ny vos veilles A qui treuue le Ciel, ſans yeux, & ſans oreilles, Dont les prodigieux & charitables ſoings En mille endroicts diuers ſe ſont faict des teſmoings, D’incurables douleurs celeſte medecine Signales auiourd’huy cette vertu diuine, Qu'vne ieune beauté reclame à ſon ſecours Contre vn mal, dont vostre art peut arreſter le cours, Vne manie extréme a ſon ame ſaiſie, Et tout remede est vain à cette frenaiſie, Si vos ſecrets vantés par les plus enuieux lit jomnu puunos cris ont refuſé les Dieux.	Spoir des affligés, merveille sans seconde, LUray, mais libre Soleil, qui visités le monde, Et qui sans intérêt departés aux mortels Ce qu'ils n'obtiennent pas même aux pieds des autels, Qui ne denise point, ni vvostre art, ni vos veilles A qui àreuve le Ciel, sans yeux, et sans oreilles, Dont les prodigieux et charitables soings San mille ends divers se sont fait des témoin, Dincurables té celeste m Signales ô cette vertu in, D' in cv reclame s do secours Contre çmal, do vôtre urs peut arrêter acours, D' manie cette a son ame divine, Qu' tout cette est vain cette divine, Si vos secrets ans par les plus envieux lit son puunos cris ont refusé les Dieux.
ANGELIQVE.	ANGELIQUE.
Quelle eſt donc ceste belle?	Quelle est donc cette belle?
FILIDAN.	FILIDAN.
Vne ieune merueille Qui peut eſtre en ces lieux n’auroit point de pareille;	Une jeune merveille Qui peut être en ces lieux n'aurait point de pareille;
De doo uuuus uppuis ne enuermonent tes eſpriis, Et ſur tous les obiets ne r’emportoient le prix.	De do uvus uppuis ne enuermonent tes épriis, Et sur tous les objets ne rapportaient le prix.
ANGELIQVE, à Clorimand.	ANGELIQUE, à Clorimand.
Son eſprit eſt gentil, nommés nous cette belle.	Son esprit est gentil, nommez nous cette belle.
ILIDAN.	ILIDAN.
Celie, vnique eſpoir d'vn amant, ſi fidelle, Que voſtre charité s’exercera pour eux St vous eſtes ſenſible aux attmis amoureux.	Celie, unique espoir d'une amant, si fidèle, Que votre charité s'exercera pour eux St vous êtes sensible aux attis amoureux.
**	*
ANGELIQVE.	ANGELIQUE.
Vous nommés cet amant.	Vous nommez cet amant.
FILIDAN.	FILIDAN.
Lucidor, qui luy-meſme Implorera de vous cette faueur extréme;	Lucidor, qui lui-même Implorera de vous cette faveur extrême;
Qui m'enuoye en ſon nom, & qui ne met qu'en vous.	Qui m'envoie en son nom, et qui ne met qu'en vous.
Tout l’eſpoir qui luy reſte & qui nous reſte à tous.	Tout l'espoir qui fer reste et qui nous reste à tous.
ANGELIQVE.	ANGELIQUE.
Adieu, reuien ce ſoir, & r’apporte à ton maistre, Que pour luy ie peux tout.	Adieu, revien ce soir, et rapporte à ton maître, Que pour notre grande peux tout.
Ils'enva Elle continuë eſtant ſeule, Amant ingrat, & traiſtre, Mon mal eſtoit ſi grand, ſans que ta cruauté Fiſt mes ſoings artiſans de ta deſloyauté, Donc pouuant inhumain contenter ton enuie Je rendrois la ſanté qui m’oſteroit la vie, Je ſeruirois tes vœux contre mes interets Et pour vne riuale employrois des ſecrets, Mais que ie ſuis aueugle alors que ie ſouſpire, I'obtiens de mon deſſein la fin que ie deſire;	Ils'enva Elle continue étant seule, Amant ingrat, et traître, Mon mal était si grand, sans que ta cruauté Fît mes soins artisans de ta déloyauté, Donc pouvant inhumain contenter ton envie Je rendrais la santé qui m'ôterait la vie, Je servirais tes vœux contre mes intérêts Et pour une rivale employrais des secrets, Mais que je suis aveugle alors que sans soupire, J'obtiens de mon dessein la fin que sans désire;
Ce tyran de mes ſens tombe ſous mon pouuoir Ie pourray ſans rougir luy parler, & le voir, Enfin, heureux vieillard, il faut que ie confeſſe En cette extremité la douleur qui me preſſe, Mais auec cet eſpoir que ton ſage conſeil -v-	Ce tyran de mes sens tombe sous mon pouvoir Je pourrai sans rougir notre parler, et le voir, Enfin, heureux vieillard, il faut que sans confesse En cette extrémité la douleur qui me presse, Mais auec cet espoir que ton sage conseil -
Meura aidenenu fui mu vreſfeure on piemier appareil.	Meura aidenu fui mu verresfeure on piemier appareil.
CLORIMAND.	CLORIMAND.
I’auray receu le prix de ce peu de ſcience Qu'vn long étude a iointe à mon experience, Si quelque vtilité vous vient de mes aduis Qui n’ont iamais faict tort, à qui les a ſuiuis.	J'aurai reçu le prix de ce peu de science Qu'un long étude à jointe à mon expérience, Si quelque vtilité vous vient de mes avis Qui n'ont jamais fait tort, à qui les a suivis.
ANGELIQVE.	ANGELIQUE.
Sous vn pretexte ſainct, ie ſuy, dans ce voyage Les violents efforts d’vne amoureuſe rage, Florence doit borner ou combler mes malheurs Et ie treuue en ce lieu le ſuiet de mes pleurs, Lucidor, cet ingrat, qui reclame mon ayde Luy meſme m’a bleſſee & me doit du remede, Ie viuois à Lion dans les plus doux plaiſirs Que poſſede vn eſprit qui manque de deſirs, Mes ſens, & ma raiſon, ſous vne loy commune Entretenoient ma ioye, & ma bonne fortune, Aucune paßion ne trauerſoit mon bien, Et ie m’aymois alors, de quoy ie n’aymois rien, Mais que ma liberté fut bien-toſt aſſeruie Aux traicts que décocha ce tyran de ma vie!	Sous un prétexte saint, on suivie, dans ce voyage Les violents efforts d'une amoureuse rage, Florence doit borner ou combler mes malheurs Et ainsi trouve en ce lieu le sujet de mes pleurs, Lucidor, cet ingrat, qui réclame mon aide Luy même m'a blessée et me doit du remède, Je vivais à Lion dans les plus doux plaisirs Que possse un esprit qui manque de désirs, Mes sens, et ma raison, sous une loi commune Entretenaient ma joie, et ma bonne fortune, Aucune Aucun ne trauersoit mon bien, Et ie aymois alors, de ô ie mon bien, Mais que ma vie fut déç asseruie D'aimais rie décocha ce tyran , mais que!
Ie le vis chés Theante, & là ce beau vainqueur Sembla d’vn meſme coup perdre, & rauir vn cœur, Deux regards mutuels firent naiſtre deux flames, Deux regards mutuels aſſeruirent deux ames, Et l'amour eut ſi toſt captiué nos eſprits	Je le vis chez Théante, et là ce beau vainqueur Sembla d'âme coup perdre, et ravir un cœur, Deux regards mutuels firent naître deux flammes, Deux regards mutuels asservirent deux âmes, Et l'amour eut sitôt tôt capté nos esprits
Que luy-meſme ignora que le premier fut pris, I’attribuois au ſoing de noſtre deſtince Cette commune ardeur ſi forte, & ſi-toſt nee, Et ie n’oZois porter mes regards innocens Que ſur ce lâche autheur des ennuys que ie ſens, Ses yeux me répondoient, ſes modestes careſſes A mes ſainctes ardeurs confirmoient ſes promeſſes, Jl partageoit ma peine, où de tous les humains Il eſt le plus adroict en des hommages feints, Mais en combien d’eſprits peut regner la constance Quand l’obiet de leurs vœux n’eſt plus a leur deffence, Et que l’eſloignement efface les crayons De ce qui n’eſt plus veu parce que nous voyons:	Que était-même ignora que le premier fut pris, J'attribuais au soin de notre destince Cette commune ardeur si forte, et sitôt née, Et ieanoZois porter mes regards innocents Innocents sur ce lâche auteur des ennuis que sans sens, Ses yeux me répondaient, ses modestes caresses A mes saintes ardeurs confirmaient ses promesses, Jl partageoit ma peine, où de tous les humains Il est le plus adroit en des hommages feints, Mais en combien d'esprit peut régner la constance Quand l'objet de leurs vœux n'est plus a leur défense, Et que l'éloignement que l' crayons De ce quignest plus parce que nous voyons'
Au fort de nos amours vne affaire importante Eſloigna Lucidor du logis de ſa tante, Le cruel m’abandonne auec ce ſeul eſpoir Que i’aurois dans ſix mois le bien de le reuoir, Et qu’à ſon arriuee vn heureux mariage Nous produiroit les fruicts d’vn ennuyeux ſeruage, Iugés de mes ſouſpir, sil partit toutesfois, Et ſon dernier adieu m’osta l’ame,& la voix;	Au fort de nos amours ymaire importante Esloigna Lucidor du logis de sa tante, Le cruel m'abandonne avec ce seul espoir Que j'aurais dans six mois le bien de le revoir, Et qu'à son arrivée un heureux mariage Nous produirait les fruits d'un ennuyeux servage, Jugez de mes soupir, sil partit toutefois, Et son dernier adieu m'ôta l'âme, la voix;
Depuis i’ay veu des moys l’inégale courriere Six fois recommencer & finir ſa carriere, Auec moins de repos qu’elle qui court touſiours	Depuis j'ai vu des mois l'inégale courrière Six fois recommencer et finir sa carrière, Avec moins de repos qu'elle qui court toujours
Et qui n’oze manquer à diuiſer les iours, Mais ſix mois acheués n’ont point finy ma peine, Ie vis mon eſperance & ſa promeſſe vaine, Helas!	Et qui n'ose manquer à diviser les jours, Mais six mois achevez n'ont point fini ma peine, Je vis mon espérance et sa promesse vaine, Hélas!
combien alors m'écriay-ie, ô trépas Eſpoir des affligés, vien, puis qu’il ne vient pas.	combien alors m'écriai-je, ô trépas Espoir des affligés, vien, puis qu'il ne vient pas.
Que ie verſay de pleurs, que mes ſecrettes plaintes Offencerent du Ciel les loix iustes & ſainctes, Ma douleur chaſque iour accroiſſoit ſes efforts, Et de l’eſprit enfin paſſa iuſques au corps, Un cruel deſeſpoir ſaiſit mon cœur de ſorte Qu'en l’état où i’eſtois on me creut long-temps morMais ce bon-heur fut faux, ie reuins, & la mort Estoit d’intelligence auec mon mauuais ſort.	Que était versai de pleurs, que mes secrètes plaintes Offensèrent du Ciel les lois justes et sûtes, Ma leur chasque jour accroissait ses efforts, Et de l'esprit enfin passa jusques au corps, Un cruel désespoir saisit mon cœur de sorte Qu'en l'état où j'étais on me reut longtemps morMais ce bonheur fut faux, Seigneur revins, et la mort Était d'intelligence avec mon mauvais sort.
4 La loy de mes malheurs m’ordonne encor de viure, Enfin, i’ay feint vn vœu ie t’ay pris pour me ſuiure, Et i’ay ſceu dans ces lieux que l’ingrat que i’aymois Auoit rangé ſon cœur ſous de nouuelles loix, L’amour trouble les ſens de l’obiet qu’il adore, Pour elle, contre moy, ce barbare m'implore, Car ayant ſceu ſon mal i’ay ſemè les faux bruicts;	4 La loi de mes malheurs m'ordonne encor de vivre, Enfin, j'ai feint vœu tou te t'ai pris pour me suivre, Et j'ai su dans ces lieux que l'ingrat que j'aimais Avait rangé son cœur sous de nouvelles lois, L'amour trouble les sens de l'objet qu'il adore, Pour elle, contre moi, ce barbare m'implore, Car ayant sceu son mal j'ai semé les faux bruits;
De ce qui ne peuteſtre eſtant ce que ie ſuis;	De ce qui ne peutêtre étant ce que je suis;
Ie ne poſſede point cet art dont on me louë, le n’ay point de ſecrets, que ceux que ie t’aduouë, Mon deſſein eſt de voir cet infidelle amant Et de luy reprocher ce honteux changement.	Je ne possède point cet art dont on me loue, le n'ai point de secrets, que ceux que ie écloue, Mon dessein est de voir cet infidèle amant Et de lui reprocher ce honteux changement.
CLORIMAND.	CLORIMAND.
L’amour, excuſe tout;	L'amour, excuse tout;
l’experience et l’aage M’ont appris ce qu’il peut en vn ieune courage, Je tiens pour les amants, ſouffre leurs paßions Et ne condamne point leurs reſolutions, Ie n’ay contre vos maux qu’vn aduis ſalutaire L’impoßible preſcrit vn oubly neceſſaire, I'oublirois vn ingat qui changeroit de loy, Et n’aurois point de vœux, pour qui n’a point de I'excuſe toutesfois ceste ardeur indomptable, Une aueugle conſtance est au moins ſupportable.	l'expérience et l'âge M'ont appris ce qu'il peut en un jeune courage, Je tiens pour les amants, souffre leurs passions Et ne condamne point leurs résolutions, Je n'ai contre vos maux qu'un avis salutaire L'implible prescrit un oubli nécessaire, J'oublirais un ingat qui changerait de loi, Et n'aurais point de vœux, pour qui n'a point de J'excuse toutefois cette ardeur indomptable, Une aveugle constance est au moins supportable.
Mais vn iuſte meſpris ſeroit plus genereux Et vous feriés beaucoup pour ce cœur amoureux.	Mais un juste mépris serait plus généreux Et vous feriez beaucoup pour ce cœur amoureux.
ANGELIQVE.	ANGELIQUE.
I’ay contre cette flame à mon repos funeſte Imploré vainement la puiſſance celeſte, J'ay mes propres deſſeins moy-meſme combattus, Jay d’vn œil enuieux penetré ſes vertus, J’ay cherché des deffaux en ce bel homicide, Et n'en ay point treuué que le nom de perfide, Cherchant dequoy haïr ce glorieux amant Je voyois à mes vœux vn appas plus charmant, J'eſtois ingenieuſe à croiſtre mon martyre Et mon mal eſt de ceux que le remede empire.	J'ai contre cette flamme à mon repos funeste Imploré vainement la puissance celeste, J'ai mes propres desseins moi-même combattus, Jais d'un œil envieux penetré ses vertus, J'ai cherché des défauts en ce bel homicide, Et n'en ai point trouvé que le nom de perfide, Cherchant dequoy haïr ce glorieux amant Je voyais à mes vœux un appas plus charmant, J'étais ingénieuse à croître mon martyre Et mon mal est de ceux que le remède empire.
SCENE CINQVIESME.	SCÈNE CINQUIÈME.
Bl loo Ralgenlaa ſavns CLORIMAND.	Bl lo Ralgenla sauns CLORIMAND.
LA NOVRRICE.	LA NOURRICE.
A voila de retour, gloire de l’Uniuers, Evine ſource de biens, & de ſecrets diuers,	A voilà de retour, gloire de l'Univers, Évine source de biens, et de secrets divers,
ANGELIQ Que voulés vous de moy?	ANGELIQ Que voulez -vous de moi?
IE.	JE.
LA NOVRRICE.	LA NOURRICE.
Ce que voſtre prudence Ne ſçauroit dénier à noſtre confidence, Ie ne reclame point ces remedes puiſſants Dont vous rétabliſſés la miſon ſur les ſens, Une moindre faueur ſatisfaict nostre attente Moindre à voſtre reſpect, pour nous plus importante.	Ce que votre prudence Ne saurait dénier à notre confidence, Je ne réclame point ces remèdes puissants Dont vous rétablissés la mison sur les sens, Une moindre faveur satisfait notre attente Moindre à votre respect, pour nous plus importante.
Celie.	Celie.
LA PELERINE ANGELIO E.	LA PÈLERINE ANGELIO E.
On m’a parlé de cet obiet charmant,	On m'a parlé de cet objet charmant,
LA NOVRRICE, Elle m’enuoye.	LA NOURRICE, Elle m'envoie.
AMGDDIGVE, à Cioiinand.	AMGDDIGVE, à Cioiinand.
Allés, i’entre dans vn moment.	Allez, j'entre dans un moment.
LA NOVRRICE.	LA NOURRICE.
Elle m’enuoye à vous, & de ſa part, Madame, Si vous estes ſenſible à l’amoureuſe flame, I'implore à vos genoux vostre diſcretion En faueur de ſon ſexe, & de ſa paßion, Les autheurs de ſon estre, & de ſon dur martyre Se donnent ſur ſes vœux vn tyrannique Empire, Et veulent qu’on ſouſmette à leur authorité La plus libre action de noſtre volonté, Jls immolent Celie à la recherche auare De Lucidor charmant, incompamble, & mre, Mais ſon ſeul intereſt luy faict conſiderer Cette beauté, qu’vn autre eſt heureux d’adorer;	Elle m'envoie à vous, et de sa part, Madame, Si vous êtes sensible à l'amoureuse flamme, J'implore à vos genoux votre discrétion En faveur de son sexe, et de sa passion, Les auteurs de son être, et de son dur martyre Se donnent sur ses vœux un tyrannique Empire, Et veulent qu'on sousmette à leur autorité La plus libre action de notre volonté, Ils immolent Célie à la recherche avare De Lucidor mant, Ancompamble, et mère, Mais son seul intérêt lui le considérer Cette seule, çonsidérer est heureux d'elle;
Vn amant plus ſenſible & plus cher à Celie A faict naistre ſa flame, & fu meummolie, Et la neceßité d’accepter ſon riual Ne pouuoit s’éuiter que par un autre mal, En ce commun deſſein, ils ont deuancé l’heure Qu'il faut qu’amour triomphe, & que la honte meu –O	Un amant plus sensible et plus cher à Celie A fait naître sa flamme, et fu meumolie, Et la nécessité d'accepter son rivalu Ne pouvait s'éviter que par un autre mal, En ce commun dessein, ils ont devancé l'heure Qu'il faut qu'amour triomphe, et que la honte meu 
Deſia le triſte effect de leurs embraſſements Eſt viſible, Madame, à ces parfaicts amants, Et depuis quelques iours, cette honteuſe fille 4 Croyant qu’elle obſcurcit l’honneur de ſa famille, N'oZe auoüer vn mal, qu’elle fist par deſſein;	Déjà le triste effet de leurs embrassements Est visible, Madame, à ces parfaits amants, Et depuis quelques jours, cette honteuse fille 4 Croyant qu'elle obscurcit l'honneur de sa famille, N'oSe auoüer un mal, qu'elle fit par dessein;
Elle rompt ſes cheueux, elle meurtrit ſon ſein, Et d’vn mal neceſſaire a faict des penitences Qu'vne autre ne faict pas de ſes incontinences;	Elle rompt ses cheveux, elle meurtrit son sein, Et d'un mal nécessaire a fait des pénitences Qu'une autre ne fait pas de ses incontinences;
On preſſe toutefois la fatale vnion Qui contre ſes parens faict ſa rebellion, Elle peut éuiter qu’vn autre la poſſede, Et n’oZe en ce beſoing employer ce remede, En fin par mon aduis elle tente autrement Le moyen d’eſloigner cet importun amant, Et feint vne manie auec tant d’artifice, Qu’il est bien mal-ayſe qu’elle ne reüßiſſe;	On presse toutefois la fatale union Qui contre ses parents fait sa rébellion, Elle peut éviter qu'un autre la possède, Et n'oSe en ce besoin employer ce remède, En fin par mon avis elle tente autrement Le moyen d'éloigner cet importun amant, Et feint une manie avec tant d'artifice, Qu'il est bien mal-ayse qu'elle ne reüssisse;
Nous n’auons point iugé de remedes meilleurs Et bien toſt Lucidor aura deſſein ailleurs, Source de charité, dont toute ame eſt muie, De vous ſeule dépend ſon honneur, & ſa vie, Fauoriſés leur flame, et trauaillés pour eux En l’execution d’vn deſſein genereux, Cachés cet accident qui perdroit ſon eſtime, Quoy qu’il ſoit neceſſaire & ſa fin legitime, Et feignés que le mal qui trouble ſa raiſon Peut en ſa ſeule mort trouuer ſa gueriſon;	Nous n'avons point jugé de remèdes meilleurs Et bien tôt Lucidor aura dessein ailleurs, Source de charité, dont toute âme est muie, De vous seule dépend son honneur, et sa vie, Favorisez leur flamme, et travaillés pour eux En l'exécution d'un dessein généreux, Cachez cet accident qui perdrait son estime, Quoi qu'il soit nécessaire et sa fin légitime, Et feignez que le mal qui trouble sa raison Peut en sa seule mort trouver sa guérison;
D’autres en Lucidor cauſeront d’autres playes Et cette peine feinte en finira de vrayes.	D'autres en Lucidor causeront d'autres plaies Et cette peine feinte en finira de vraies.
ANGELIQVE, tout bas.	ANGELIQUE, tout bas.
O diſcours fauorable, heureuſe occaſion!	Ô discours favorable, heureuse occasion!
Où ie puis m’employer à ſa confuſion.	Où ici puis m'employer à sa confusion.
Ouy, ie vous promets tout, & voüe à cette belle Elle dit Ce qui dépend d'vne ame, & diſcrette, & fidelle.	Oui, Seigneur vous promets tout, et vue à cette belle Elle dit Ce qui dépend d'une âme, et discrette, et fidèle.
Ordonnés ſeulement et ne reſerués rien De tout ce que mes ſoings pourront pour voſtre bien, Voyons là de ce pas.	Ordonnez seulement et ne réservez rien De tout ce que mes soins pourront pour votre bien, Voyons là de ce pas.
I A OVRRICE.	I A OURICE.
O Dieux!	Ô Dieux!
de quel ſeruice Pourrons nous recognoiſtre vn ſi pieux office.	de quel service Pourrons nous reconnaître un si pieux office.
SCENI	SCENI
SCENE SIXIESME, ERMAMEEERERE,	SCÈNE SIXIÈME, ERMAMEERERE,
ERASME.	ERASME.
J'Eillés ſes actions & n’abandonnés point V Celle qu'vn mauuais ſort a reduite à ce point, Ie vais preſſer de vœux la puiſſance diuine Ohrrenenini terereur de telle Pelerine, Et deſſus nos autels répandre tant de pleurs Que ie rendray le Ciel ſenſible à mes douleurs,	J'Éillez ses actions et n'abandonnés point V Elle qu'un mauvais sort a réduite à ce point, Je vais presser de vœux la puissance divine Ohrrenenini terereur de telle Pelerine, Et dessus nos autels répandre tant de pleurs Que Que rendrai le Ciel sensible à mes douleurs,
LEANDRE.	LÉANDRE.
ſeul.	seul.
Ie ne la quitte point:	Je ne la quitte point:
puiſſant Dieu de Cythere Toy ſeul eſt mon recours, c’eſt en toy que i'eſpere, Sois touché de nos maux & romps tous les deſſeins Que font nos ennemis contre des vœux ſi ſains,	puissant Dieu de Cythère Toi seul est mon recours, c'est en toi que j'espère, Sois touché de nos maux et romps tous les desseins Que font nos ennemis contre des vœux si sains,
SCENE SEPTIESME, CELIE3DEMRE Pene	SCÈNE SEPTIÈME, CELIE3DEMRE Pene
LEANDRE, continue.	LÉANDRE, continue.
Elie, enfin des fleurs naiſtront de tãt d’épines L &n'auurt me uou ec que iu mt ueſtines, Et tous efforts ſont vains, ſi i’oppoſe ta loy Contre les accidens qui menacent ma foy.	Élie, enfin des fleurs naîtront de toits qui menaces L 'auurt me ou ec que ju mu uestines, Et tous efforts sont vains, si j'oppose ta loi Contre les accidents qui menacent ma foi.
CELIE.	CELIE.
Quoy que trame le Ciel & quoy qui doiue ſuiure 2Ceſſant de t’honnorer ie ceſſeray de viure, La menace, & le temps de ſuperbe vainqueur D’inutiles efforts aſſailliroient mon cœur, Mais ie voy ma nourrice auec cette etrangere, Qui peut ſeule auiourd'huy finir noſtre miſere.	Quoi que trame le Ciel et quoi qui doive suivre 2Cessant de t'honorer quel cesseray de vivre, La menace, et le temps de superbe vainqueur D'inutiles efforts assailliraient mon cœur, Mais je vois ma nourrice avec cette étrangère, Qui peut seule aujourd'hui finir notre misère.
SCENE HVICTIESME.	SCÈNE HVICTIESME.
LA NOVRRICE, CELIE, LEANDRE,ANGELNVE,	LA NOURRICE, CÉLIE, LÉANDRE,ANGELNVE,
LA NOVRRICE.	LA NOURRICE.
TOila cette beauté de qui vostre ſecours y Teul ſthtenracmin,e enonnenr, e tes tourox	TOila cette beauté de qui votre secours y Teul sthatenracmin, enonnenr, eût tes tourox
LEANDRE, Abordés la ſans crainte.	LÉANDRE, Abordez la sans crainte.
CELIE, à genoux.	CELIE, à genoux.
Illuſtre Pelerine, Eſpoir des affligés, celeſte Medecine;	Illustre Pélerine, Espoir des affligés, celeste Médecine;
Sous quel teint paroiſtn deuant voſtre vertu Le vice triomphant de ce cœur abbatu?	Sous quel teint paroistn devant votre vertu Le vice triomphant de ce cœur abattu?
De vains reſpects d’amour m’ont contrainte de rendre Ce que ceux de l’honneur m’obligeoient de deffendre, Mes parens ſont autheurs du mal que i’ay commis Ma vertu treuue en eux ſes plus grands ennemis.	De vains respects d'amour m'ont contrainte de rendre Ce que ceux de l'honneur m'obligeaient dé fendre, Mes parents sont autheurs du mal que j'ai commis Ma vertu trouve en eux ses plus grands ennemis.
Et par eux ma raiſon fut capable d’vn vice Dont depuis quatre mois ie porte le ſupplice, Ny l’eſpoir du plaiſir, ny la fragilité Ne m’ont point reſoluë à cette priuauté, La crainte ſeulement de perdre ce que i’ayme Diſpoſa mon honneur à cet effort extréme, Soleil, rompts ton ſilence, & ſi la verité Me fut en quelque obiet fay voir la verité.	Et par eux ma raison fut capable d'un vice Dont depuis quatre mois ie porte le supplice, Ni l'espoir du plaisir, ni la fragilité Ne m'ont point résolue à cette privauté, La crainte seulement de perdre ce que j'aime Disposa mon honneur à cet effort extrême, Soleil, rompts ton silence, et si la vérité Me fut en quelque objet fais voir la vérité.
ANGELIQVE.	ANGELIQUE.
N'excuſés point vn mal digne de nos loüanges L'amour est adorable en ſes effects étranges, Ce Dieu ſe faict cognoistre en l’excés ſeulement, Et ce n’est pas aymer que d’aymer froidement, Madame, de ma part employès ſans reſerue Tout ce qui vous auance & ce qui vous conſerue, Ie partage auec vous vostre pire douleur Et ſçauray bien cacher cet aymable malheur, Acheués ſeulement vostre feinte manie Trompés de vos parens l’aueugle tyrannie, Que vos ſens en diuorce auec voſtre raiſon Faſſent deſeſperer de voſtre gueriſon, Ie ioindray mes diſcours à leur vaine croyance Tant que voſtre importun cherche vne autre alliance, Tant qu’il vous laiſſe libre, & qu’vn destin plus doux, A vos chaſtes deſirs accorde vostre époux,	N'excusez point un mal digne de nos louanges L'amour est adorable en ses effets étranges, Ce Dieu se fait connaître en l'excès seulement, Et ce n'est pas aimer que d'aimer froidement, Madame, de ma part employés sans réserve Tout ce qui vous avance et ce qui vous conserve, Je partage après vous vôtre pire douleur Et sçauray bien cacher cet aimable malheur, Achevez seulement vôtre feinte manie Trompez de vos parents l'aveugle tyrannie, Que vos sens en divorce avec votre raison Fassent désespérer de votre guérison, Je joindrai mes discours à leur vaine croyance Tant que votre importun cherche autre alliance, Tant quil vous laisse libre, et Tan destin plus doux, A vos le désirs accorde , époux,
LEANDRE.	LÉANDRE.
Uoſtre pere reuient.	Uotre père revient.
CELIE.	CELIE.
O Dieux!	Ô Dieux!
de quelle ſorte Paroiſtmy-ie à ſes yeux?	de quelle sorte Paroistmy-je à ses yeux?
SCENE NEVFIESME.	SCÈNE NEUFIESME.
ERASME, CELIE, LEANDRE, LA NOVRRICE.	ERASME, CÉLIE, LÉANDRE, LA NOURRICE.
SOuffrés vous qu'elle ſorte.	SOuffrez -vous qu'elle sorte.
En ſes plus forts accés, rendés vous euident A qui paſſe en ce lieu, ce honteux accident?	En ses plus forts accès, rendez vous évident A qui passe en ce lieu, ce honteux accident?
INRaNE de ma On ne peut l’arreſter;	INRaNE de ma On ne peut l'arrêter;
& ſa courſe legere A chaſſé du logis cette belle étrangere, Qui dans vos déplaiſirs prend vne égale part, I iij Luqui cuue à ſon vien ſes veules, e ſon arf.	et sa course légère A chassé du logis cette belle étrangère, Qui dans vos déplaisirs prend quelque égale part, I ij Luqui cuve à son vien ses veules, eût son ars.
ERASME.	ERASME.
Hâ!	Hâ!
Madame, est-ce vous;	Madame, est-ce vous;
helas!	hélas!
pour tant de peine, Que vous pourray-ie offrir qu'vne volonté vaine?	pour tant de peine, Que vous pourrai-je offrir qu'une volonté vaine?
Mais vne autre eſperance y porte vos eſprits, La vertu trouue en ſoy ſon obiet, & ſon pris, Quels que ſoient ſes effects, quelque effort qu'elle eſſaye Elle ſe ſatisfaict & s’employant ſe paye.	Mais une autre espérance y porte vos esprits, La vertu trouve en soi son objet, et son pris, Quels que soient ses effets, quelque effort qu'elle essaye Elle se satisfait et s'employant se paye.
ANGELIQVE.	ANGELIQUE.
L’honneur de vous ſeruir m’eſt vn but glorieux, Mais ayant veu (Monfieur,) ſes tranſports furieux Je doute de mon art, & que quelque remede S’applique vtilement au mal qui la poſſede, I'employeray toutefois, et mon temps, & mes ſoings, Dont les effects diuers ont aſſés de teſmoings.	L'honneur de vous servir m'est un but glorieux, Mais ayant vu (Monfieur,) ses transports furieux Je doute de mon art, et que quelque remède S'applique utilement au mal qui la possède, J'emploierai toutefois, et mon temps, et mes soings, Dont les effets divers ont assez de témoings.
CELIE, contrefaiſant la folle.	CELIE, contrefaisant la folle.
Voyés großir ſous moy cette vapeur épaiſſe C’eſt le plus doux obiet dont mon œil ſe repaiſſe, I'ayme à voir dans les airs les foudres ſe former.	Voyez grossir sous moi cette vapeur épaisse C'est le plus doux objet dont mon œil se repaisse, J'aime à voir dans les airs les foudres se former.
Tomber ſur les mortels,& les deſanimer, A voir vn criminel au ſeul bruict du tonnerre Chercher à ſon ſalut vn azyle ſous terre, A voir ce feu fatal enflammer des vaiſſeaux, Et la flamme nager deſſus le ſein des eaux, Ie verrois d’vn meſme œil l’embraZement du monde Qu'vn ſimple tremblement d’vne feüille, ou d’vne onde;	Tomber sur les mortels,et les désanimer, A voir un criminel au seul bruit du tonnerre Chercher à son salut int asile sous terre, A voir ce feu fatal enflammer des vaisseaux, Et la flamme nager dessus le sein des eaux, Je verrais d'mêmerais d'embrasement du monde Qu'un tremblement tremblement d'une feüille, ou d'une onde;
Nature m’a preſcrit de trop ſeueres loix Geu jais laſſe enfin de diuiſer les mois, Mais mon ſort recognoiſt ſa puiſſance ſupréme.	Nature m'a prescrit de trop sévères lois Geu jais lasse enfin de diviser les mois, Mais mon sort reconnaît sa puissance suprême.
ERASML.	ERASML.
Voyés ſa frenaiſie.	Voyez sa frénaisie.
ANGELNVE, O Dieux!	ANGELNVE, Ô Dieux!
qu'elle eſt extréme.	qu'elle est extrême.
CELIE.	CELIE.
Uiuons où Jon pouuoir m’a voulu destiner Il commença mon cours, et le doit terminer, Vous qui vous oppoſés à cette loy fatale Et treuuès du deſordre en ma courſe inégale, Eſſayés vne fois ces glorieux trauaux, Et vous meſlés de l’art de regir mes cheuaux, Huu em tonu rronoue yueu juiſons peruerties Ces coſtaux deſolés, & ces plaines roties Mais, où parlay-ie, ou fuis-te, & qu'ept-ce que ie voy?	Uiuons où Jon pouvoir m'a voulu destiner Il commença mon cours, et le doit terminer, Vous qui vous opposez à cette loi fatale Et trouvez du désordre en ma course inégale, Essayés une fois ces glorieux travaux, Et vous mêlés de l'art de régir mes chevaux, Hu em tonu ronoue yvu juisons perverties Ces costaux désolés, et ces plaines rôties Mais, où parlai-je, ou fuis-je, ou fuis-ce que ie voy?
ERASME.	ERASME.
O mal-heur de mes iours!	Ô malheur de mes jours!
CELIE.	CELIE.
Je meurs, conduiſés-moy.	Je meurs, conduisez-moi.
ANGELI 2 VE, à Eraſme.	ANGELY 2 VE, à Erâme.
Adieu, ie vays reſuer ſur le remede vnique Qui puiſſe rétablir cet eſprit frenetique, meine.	Adieu, Seigneur vais rêver sur le remède unique Qui puisse rétablir cet esprit frénétique, mène.
Et s’il ne peut guerir vn mal ſi furieux, N'eſperés plus Monſieur, ſa ſanté que des Cieux	Et s'il ne peut guérir un mal si furieux, N'espérez plus Monsieur, sa santé que des Cieux
4	4
TNO TI  v DCLNNE IREMILNL	TNO TY v DCLNNE JREMILNL
ERASME, ſeul.	ERASME, seul.
Latté du doux eſpoir de reuoir en Celie Le bon ſens ſucceder à la melancholie, MnA Ua parent deſolé preſſer cette beauté Dont l’art officieux trauaille à ſa ſanté, Sollicite ardemment cette vnique reſource Qui peut de tes ennuys borner la longue courſe, Et ſi ſon art eſt vain, ſollicite les Dieux A tirer ton eſprit de ces funeſtes lieux, Et ce corps dépourueu de ſa vigueur premiere Meurt à chaſque moment ſans perdre la lumiere.	Latté du doux espoir de revoir en Célie Le bon sens succéder à la mélancolie, MnA Ua parent désolé presser cette beauté Dont l'art officieux travaille à sa santé, Sollicite ardemment cette unique résource Qui peut de tes ennuis borner la longue course, Et si son art est vain, sollicite les Dieux A tirer ton esprit de ces funestes lieux, Et ce corps dépourvu de sa vigueur première Meurt à chasque moment sans perdre la lumière.
SCENE DEVXIESME FILENE, ſeruiteur,	SCÈNE DEUXIÈME SILÈNE, serviteur,
EILLAVE, courant etlbe V s’addreſſe vos pas?	EILALVE, courant etlbe V 'adresse vos pas?
ERASME.	ERASME.
Uers cet obiet charmant, Qui m'a faict eſperer la fin de mon tourment.	Uers cet objet charmant, Qui m'a fait espérer la fin de mon tourment.
R’entre, veille auec ſoing cette fille inſenſee Qu’on ne peut retenir depuis qu’on l’a laiſſee,	R'entre, veille auec soin cette fille insensée Qu'on ne peut retenir depuis qu'on l'a laisse,
ILENE.	ILENE.
Voſtre voyage eſt faict, Celie eſt de bons ſens.	Votre voyage est fait, Celie est de bons sens.
ERASME.	ERASME.
Joins tu la raillerie aux ennuys que ie ſens?	Joins tu la raillerie aux ennuis que votre sens?
Cauſeur impertinent, lâche obiet de ma hayne, Si tu ne faicts ceſſer n’irrite point ma peine.	Causeur impertinent, lâche objet de ma haine, Si tu ne faits cesser n'irrite point ma peine.
LENE.	LENE.
Monſieur, puniſſés-moy, ſi l’effect me dément Sa raiſon ne doit rien au plus ſain iugement, Sa manie est vn tratct de la plus fuit aareſſe Que puiſſe à des eſprits inſpirer la ſageſſe;	Monsieur, punissez-moi, si l'effet me dément Sa raison ne doit rien au plus sain iugement, Sa manie est un tratct de la plus fuit aaresse Que puisse à des esprits inspirer la sagesse;
Je ne penetre point en ſon intention, Et ne puis deuiner où tend cette action.	Je ne pénètre point en son intention, Et ne puis deviner où tend cette action.
Mais dans peu vous ſçaurés, qu’elle eſt, et ſaine, et Et qu'elle a preuenu les droicts du mariage.	Mais dans peu vous saurez, qu'elle est, et saine, et Et qu'elle a prévenu les droits du mariage.
Que dis-tu?	Que dis-tu?
ENMSME.	ENMÊME.
ILENE, Que l’amour eſt vn puiſſant vainqueur, Et que Celie en tient ailleurs que dans le cœur.	ILENE, Que l'amour est un puissant vainqueur, Et que Celie en tient ailleurs que dans le cœur.
ERASME.	ERASME.
Laiſſés vous iuſtes Dieux ces fourbes impunies?	Laisez -vous justes Dieux ces fourbes impunies?
Ce traiſtre à ſon honneur porte ſes calomnies:	Ce traître à son honneur porte ses calomnies:
Impoſteur, as-tu veu dans ces déportemens Quelque action conforme à tes faux ſentimens?	Imposteur, as-tu vu dans ces déportements Quelque action conforme à tes faux sentiments?
TILEN L.	TILEN L.
Non, mais i’ay tout ouy.	Non, mais j'ai tout oui.
ERASME.	ERASME.
Comment	Comment
FILENE.	SILÈNE.
De cette ſorte, Le deſſein de la voir m’arreſtoit à ſa porte, Et ie la croyois eſtre en vn pareil état A celuy qu'elle a feint auant qu’on la quitaſt, Quand i’ay veu ſa raiſon reprendre ſon vſage	De cette sorte, Le dessein de la voir m'arrestoit à sa porte, Et tu la croyais être en un pareil état À celui qu'elle a feint avant qu'on la quitt, Quand j'ai vu sa raison reprendre son usage
Les roſes,& les lys renaiſtre en ſon viſage, Et d’vn ſouſris reiglé cette ieune beauté Blaſmer, & iuſtement, voſtre ſimplicité Nourrice, a t’elle dit, (elles eſtoient enſemble,) Voy, combien i’ay d’adreſſe, et quelle ie leur ſemble?	Les roses,et les lys renaître en son visage, Et d'un sousris reiglé cette jeune beauté Blâmer, et justement, votre simplicité Nourrice, a -t-elle dit, (elles étaient ensemble,) Vois, combien j'ai d'adresse, et quelle té leur semble?
Puis-ie auec plus de ſoing, & plus ſubtilement Seruir la paßion de ce fidelle amant?	Puis-je avec plus de soing, et plus subtilement Servir la passion de ce fidèle amant?
Que Lucidor me faſſe vne équitable plainte Qu’il doute deſormais ſi mon ame est atteinte, Qu'ayant de mon amour des ſignes ſi parfaicts, Il en demande encor de plus nares effects, Ay-ie rien reſerué de tous les teſmoignages Qui luy peuuent prouuer mes vœux, & mes hommages?	Que Lucidor me fasse une équitable plainte Qu'il doute désormais si mon âme est atteinte, Qu'ayant de mon amour des signes si parfaits, Il en demande encor de plus nares effets, Ai-je rien réservé de tous les témoignages Qui avait peuvent prouver mes vœux, et mes hommages?
Et de tout ce qui peut établir ſon bon-heur Ay-ie rien épargné, ny meſme mon honneur?	Et de tout ce qui peut établir son bonheur Ai-je rien épargné, ni mesme mon honneur?
I’ay ſouffert ſes baiſers, tu vois en ma groſſeſſe Le pitoyable effect de l’ardeur qui le preſſe, Et ie paſſe pour folle en l’eſtime de ceux Qui veulent partager nos eſprits, & nos feux, Je mets chacun en peine, à ces mots ſa Nourrice Dont le ſoing vigilant conduit cet artifice, Parlés vn peu plus bas, Celie, a t’elle dit Jl vaudroit mieux mourir que l’on nous entẽdiſt, Elle vient vers la porte et moy ie me retire Si confus, ſi ioyeux, & ſi preſſé de rire.	J'ai souffert ses baisers, tu vois en ma grossesse Le pitoyable effet de l'ardeur qui le presse, Et ie passe pour folle en l'estime de ceux Qui veulent partager nos esprits, et nos feux, Je mets chacun en peine, à ces mots sa Nourrice Dont le soing vigilant conduit cet artifice, Parlés un peu plus bas, Celie, a t'elle dit Jl vaudrait mieux mourir que l'on nous entendît, Elle vient vers la porte et moi -moi , et Si confus, si ju, et si té de rire.
Qu’ouurant vn peu pluſtoſt elle eust tout découuert;	Qu'ouvrant un peu plustost elle eût tout découvert;
Mais i'eſtois deſcendu deuant qu’elle euſt ouuert, Iugés de leur deſſein épargnés voſtre peine, Et ne reclamés plus vne aßiſtance vaine.	Mais j'étais descendu devant qu'elle eût ouvert, Jugés de leur dessein épargnez votre peine, Et ne réclamez plus une assistance vaine.
ERASME.	ERASME.
Comment te puis-ie croire & pourquoy Lucidor Qui la doit poſſeder,& la recherche encor, L'oblige-til a feindre vn ſi honteux martyre?	Comment te puis-je croire et pourquoi Lucidor Qui la doit posséder,et la recherche encor, L'oblige-til a feindre un si honteux martyre?
Et ſe differe-t'il vn bon-heur qu’il deſire?	Et se diffère-t'-il bonheur qu'il désire?
FILENE.	SILÈNE.
C’eſt où ie ſuis aueugle, écoutes toutefois Où l’or est en obiet les eſprits ſont adroicts.	C'est où tu suis aveugle, écoutes toutefois Où l'or est en objet les esprits sont adroits.
S'il ſçait de vos threſors l’inépuiſable ſource Cette feinte est vn rets qu’il tend à vostre bourſe, Car Celie en feignant rebute ſes amants, Luy-meſme ſemblera retracter ſes ſerments, Sans deſſein toütefois, ſinon que cette adreſſe Uous faſſe ſuppleer au mal de ſa maiſtreſſe, Diſpoſe voſtre eſprit a de nouueaux accords Et que vous luy vendiés au moins vn riche corps, Songés y meurement, et que cette folie Ne vous apporte plus tant de melancholie.	S'il sais de vos trésors l'inépuisable source Cette feinte est un rets D'il tend à votre bourse, Car Celie en feignant rebute ses amants, Lui-même semblera rétracter ses serments, Sans dessein toütefois, sinon que cette adresse Uous fasse suppléer au mal de sa maîtresse, Dispose votre esprit a de nouveaux accords Et que vous lui vendiez au moins un riche corps, Songez y meurement, et que cette folie Ne vous apporte plus tant de mélancolie.
ERASME.	ERASME.
O Dieux!	Ô Dieux!
que ne faict point ce metal triomphant Si contre ſes parens il faict faillir l’enfant, Ie croiray ton aduis, cours chés la Pelerine.	que ne fait point ce métal triomphant Si contre ses parents il fait faillir l'enfant, Je croirai ton avis, cours chez la Pelerine.
iij	jij
Luy dire.	Lui dire.
FILENE.	SILÈNE.
ERASME.	ERASME.
L’aſſeurer que i’ay la Medecine, Qui peut guerir Celie, & que ſa charité S'est acquiſe ſur moy beaucoup d’authorité, Mais que ie iuge en l’air ſur cette incertitudé Lucidor, qu’elle traicte auec ingratitude Qu'elle ne peut ſouffrir, et qui s’eſt touſiours plaint De la voir inſenſible autant qu’il eſt atteint, Eſt-il d’intelligence auec cette ruſee?	L'assurer que j'ai la Médecine, Qui peut guérir Celie, et que sa charité S'est acquise sur moi beaucoup d'autorité, Mais que sans juge en l'air sur cette incertitudé Lucidor, qu'elle traite avec ingratitude Qu'elle ne peut souffrir, et qui s'est toujours plaint De la voir insensible autant qu'il est atteint, Est-il est intelligence avec cette ruse?
Ont ils ſi finement ma croyance abuſee?	Ont ils si finement ma croyance abusée?
Et deſſous les faux noms de hayne, & de rigueur Cache-t’elle vn braZier qui conſomme ſon cœur?	Et dessous les faux noms de haine, et de rigueur Cache-t-elle un brasier qui consomme son cœur?
Qu'en ce temps malheureux l’amour a d’artifices!	Qu'en ce temps malheureux l'amour a d'artifices!
Qu'vn ſiecle à cet enfant a monstré de malices;	Qu'un siècle à cet enfant a montré de malices;
Nous le voyons iadis, ſainct, égal, ſimple, nu, Et ce Dieu maintenant m’eſt vn monſtre incognu;	Nous le voyons jadis, saint, égal, simple, nu, Et ce Dieu maintenant m'est un monstre inconnu;
Le meilleur naturel par ſon poiſon s’altere, Et de l’humeur du fils faict le fleau du pere.	Le meilleur naturel par son poison s'altère, Et de l'humeur du fils fait le fléau du père.
SCENE TROISIESME.	SCÈNE -TROISIÈME.
LVCIDOR, FILIDAN.	LUCIDOR, FILIDAN.
ERASME.	ERASME.
LVCIDOR.	LUCIDOR.
Llant chés la beauté par qui le Ciel faict 1Y voir Contre tant d'accidens ſon ſupréme pouuoir, I’ay ſceu d’vn de vos gens qu’elle auoit veu Celie, Monſieur, qu’ordonne-t’elle à ſa melancholie?	Llant chez la beauté par qui le Ciel fait 1Y voir Contre tant d'accidents son suprême pouvoir, J'ai su d'un de vos gens qu'elle avait vu Célie, Monsieur, qu'ordonne-t-elle à sa mélancolie?
ERASME.	ERASME.
Un peu de patience.	Un peu de patience.
EVCIDOR.	EUCIDOR.
Et promet ſa ſanté?	Et promet sa santé?
ERASME.	ERASME.
Ouy, dans ſix mois au plus.	Oui, dans six mois au plus.
VCIDOR.	VCIDOR.
Que faict cette beauté?	Que fait cette beauté?
ERASME Des reſolutions d’enrichir ce qu'elle ayme Et des vœux, pour l’autheur de ſa miſere meſme.	ERASME Des résolutions d'enrichir ce qu'elle aime Et des vœux, pour l'auteur de sa misère avait.
LVCIDOR.	LUCIDOR.
Il faut loüer le Ciel dans nos pires mal-heurs, Jl tire nostre bien du ſuiet de nos pleurs, Il cache ſa bonté deſſous vn front ſeuere, Et prouue ſon amour ſouuent par ſa cholere, Mans pour ie reuamer en te aerciglemenk Luy reſte-t’il encor aſſés de iugement?	Il faut louer le Ciel dans nos pires malheurs, Jlouvre notre bien du sujet de nos pleurs, Il cache sa bonté dessous un front sévère, Et prouve son amour souvent par sa cholère, Mans pour un revamer en te aerciglement Lui reste-t-il encor assez de jugement?
FILTDAN, entrant en la maiſon.	FILTDAN, entrant en la maison.
Je vais l’entretenir.	Je vais l'entretenir.
ERASME.	ERASME.
Sa douleur n’eſt pas telle Que voſtre propre foing ne puiſſe rien pour elle, Nous cherchons à ſon mal vn ſecours étranger.	Sa douleur n'est pas telle Que votre propre foing ne puisse rien pour elle, Nous cherchons à son mal un secours étranger.
Et vous ſeul Lucidor, la pouués ſoulager.	Et vous seul Lucidor, la pouvez soulager.
LVCIDOR.	LUCIDOR.
Qe puutie en ja ſaucunteptouuus mon enuie Le bien de ſa ſanté dépend-il de ma vie?	Qe puutie en ja saucunteptouuus mon envie Le bien de sa santé dépend-il de ma vie?
Dois-ie à ſa gueriſon, & mon temps, & mon bient Ordonnés ſeulement ie ne reſerue rien.	Dois-je à sa guérison, et mon temps, et mon bient Ordonnez seulement personne ne réserve rien.
ERASME.	ERASME.
Sa gueriſon dépend de ces ſeules parolles Celie, il faut ceſſer, nos feintes ſont friuoles, Et nous ne verrons pas voſtre auare parent Suppleer par les biens à ce mal apparent, Il a tout découuert, deux mots de ceſte ſorte.	Sa guérison dépend de ces seules paroles Celie, il faut cesser, nos feintes sont frivoles, Et nous ne verrons pas votre avare parent Suppleer par les biens à ce mal apparent, Il a tout découvert, deux mots de cette sorte.
Gueriront ſon eſprit d’vne douleur ſi forte.	Guériront son esprit d'une douleur si forte.
LVCIDOR	LUCIDOR
LVCIDOR.	LUCIDOR.
Eſloignés de chés vous cet eſprit furieux, Uous reſſentés deſia ce mal contagieux, A voir, ce que ie voy, ce poiſon frenetique uion fiuquumubord en fja sommunique, Ie ne la verray plus.	Éloignés de chez vous cet esprit furieux, Uous ressentez déjà ce mal contagieux, A voir, ce que je vois, ce poison frénétique uion fivquumbord en fia sommunique, Je ne la verrai plus.
ERASME.	ERASME.
Ie parle ſainement Et deſapprouue fort voſtre déportement, Le droict que vous prenés ſur l’eſprit de ma fille Touche ſenſiblement l’honneur de ma famille, De legitimes loix vous pouuoient accorder.	Je parle sainement Et desapprouve fort votre déportement, Le droit que vous prenez sur l'esprit de ma fille Touche sensiblement l'honneur de ma famille, De légitimes lois vous pouvaient accorder.
Le plaiſir de la voir & de la poſſeder, Sans preuenir le bien de cette ioüyſſance Par vne criminelle & honteuſe licence, Mais on ſouffre beaucoup de l’ardeur d’vn amant, L'hymencepure omi	Le plaisir de la voir et de la posséder, Sans prévenir le bien de cette ioüyssance Par une criminelle et honteuse licence, Mais on souffre beaucoup de l'ardeur d'un amant, L'hymencepure Lomi
VCIDOR.	VCIDOR.
Moy;	Moi;
ie l’ay poſſedee?	Il l'ai possédée?
Perdés ce ſentiment,	Perdez ce sentiment,
ERASME.	ERASME.
ô la feinte importune Elle meſme n’a pas celé ſon infortune, Elle m'a confeſſé que l’importunité Auoit tout obtenu de ſa facilité, Et qu’il n'est point d’honneur qui ne rendiſt les armes Au pouuoir infiny de vos aymables charmes, Deſia le triste effect qui ſuit cet action A ce crime d’amour ſert de punition, Et vous feignés encor.	ô la feinte importune Elle même n'a pas celé son infortune, Elle m'a confessé que l'importunité Avait tout obtenu de sa facilité, Et qu'il n'est point d'honneur qui ne rendît les mes Au pouvoir infini de vos aimables charmes, Déjà le triste effet qui suit cet action À ce crime d'amour sert de punition, Et vous feignez encor.
LVCIDOR.	LUCIDOR.
Ciel!	Ciel!
en cette aduanture De quel foudre peux tu punir cette impoſture:	en cette aventure De quel foudre peux -tu punir cette imposture:
I’ay gouuerné Celie & de nos priuautés Eſt procedé, Monſieur, ce que vous m’imputés!	J'ai gouverné Celie et de nos privautés Est procédé, Monsieur, ce que vous m'imputés!
Adreſſés autre part cette fourbe großiere, C’eſt à mon innocence vne indigne matiere Que Celie à ſon gré perde ou paſſe ſon temps Mais ne la faictes point faillir à mes deſpens, Ie n’ay loy, ny faueur en ſon ame vſurpee Et qui le ſoustiendra doit parer cette épee.	Aressez autre part cette fourbe grosière, C'est à mon innocence une indigne matière Que Celie à son gré perde ou passe son temps Mais ne la faites point faillir à mes dépens, Je n'ai loi, ni faveur en son âme usurpée Et qui le soutiendra doit parer cette épée.
ERASME.	ERASME.
Que reſoudray-ie en fin?	Que résoudrai-je en fin?
qu’en cette occaſion en cole-Ie voy d’incertitude & de confuſion;	qu'en cette occasion en cole-Ie vois d'incertitude et de confusion;
Je ſçauray toutefois l’autheur de ce deſaſtre, Elle n’a pas conceu par influence d’Aſtre, Uoyons la de ce pas.	Je saurai toutefois l'auteur de ce désastre, Elle n'a pas conçu par influence d'Astre, Uoyons la de ce pas.
SCENE ( VATRIESME.	SCÈNE ( VATRIESME.
ERASME, FILIDAN, EILID'AN, accourant tout échauffé.	ERASME, FILIDAN, EILID'AN, accourant tout échauffé.
Quest-ce?	Quest-ce?
Doux contentement!	Doux contentement!
ERASME.	ERASME.
ILIDAN, Ole doux plaiſir!	ILIDAN, Ole doux plaisir!
ERASME.	ERASME.
Dépeſche viſtement.	Dépêche vitement.
ILIDA at faut ats Mieuetins;	ILIDA at faut ats Mieuetins;
com appelles folie La douleur qui preſide en l’eſprit de Celie	com appelles folie La douleur qui préside en l'esprit de Celie
Comment?	Comment?
ERASME.	ERASME.
I ILIDAN.	I ILIDAN.
On remedie à ſon infirmité, P'ouurier qui luy faut trauaille à ſa ſanté,	On remédie à son infirmité, P'ouvrier qui lui faut travaille à sa santé,
ERASME.	ERASME.
Qui?	Qui?
dymoy tout.	dismoi tout.
FILIDAN.	FILIDAN.
O Dieux!	Ô Dieux!
i’entrois en eſperance De voir quelques effects de ſon extrauagance, Mais i’ay veu le contraire, & mille effects d’amour M'ont fourny de ſuiet de rire tout le iour.	j'entrais en espérance De voir quelques effets de son extravagance, Mais j'ai vu le contraire, et mille effets d'amour M'ont fourni de sujet de rire tout le jour.
J'ay par vne ouuerture apperceuë en ſa porte Recogneu clairement l’ardeur qui la tranſporte, Uoſtre peintre a cauſé ſes amoureux tourments, Que d’humides baiſers,& que d’embraſſements!	J'ai par une ouverture aperçue en sa porte Recgneu clairement l'ardeur qui la transporte, Uotre peintre a causé ses amoureux tourments, Que d'humides baisers,et que d'embrassements!
Ils euſſent à les voir enflammé de la glace Et la tentation m'a faict quitter la place, Ils ſe baiſent encor, allons y doucement, Et craignons de troubler leur diuertiſſement, Tâchons de les ſurprendre.	Ils eussent à les voir enflammé de la glace Et la tentation m'a fait quitter la place, Ils se baisent encor, allons y doucement, Et craignons de troubler leur divertissement, Tâchons de les surprendre.
ERASME, O Dieux!	ERASME, Ô Dieux!
de quelle rage Prendray-ie le deſſein de vanger cet outrage, Et quel aſſés capable & rigoureux tourment Immolera ce traistre à mon reſſentiment?	de quelle rage Prendrai-je le dessein de venger cet outrage, Et quel assez capable et rigoureux tourment Immolera ce traître à mon ressentiment?
SCENE CIN TIESME.	SCÈNE CIN TIESME.
a l lensisal.	à l ensisal.
E perds à la chercher, & mon temps, & ma Y peine, t'ay chés elle deux fois faict vne courſe vaine:	E perds à la chercher, et mon temps, et ma Y peine, t'ai chez elle deux fois fait une course vaine:
Je ne l’y trouue point, et ie n’estime pas Si toſt:	Je ne l'y trouve point, et Seigneur n'estime pas Si tôt:
mais la voila, le Ciel conduit mes pas.	mais la voilà, le Ciel conduit mes pas.
SCENE SIXIESME FILENE, ANGELIQVE, SEOAIMIINES	SCÈNE SIXIÈME SILÈNE, ANGELIQUE, SEOAIMIINES
FILENE.	SILÈNE.
E vous cherchois par tout:	E vous cherchais par tout:
noſtre malade est I telle Que vos meilleurs ſecrets ne peuuent rien pou estes On a cogneu ſon mal?	notre malade est I telle Que vos meilleurs secrets ne peuvent rien pou êtes On a connu son mal?
ANGELIQ E.	ANGELIQ .
Ne le puis-ie ſçauoir,	Ne le puis-je savoir,
FILENE.	SILÈNE.
C'iſt ce que les plus fins n’auroient pû conceuoir;	C'ist ce que les plus fins n'auraient pu concevoir;
Ce qui nous trouble tous, ce qui nous deſeſpere Que Celie, en vn mot, dans ſix mois ſera mere.	Ce qui nous trouble tous, ce qui nous désespère Que Celie, en un mot, dans six mois sera mère.
Du faict?	Du fait?
ANGELIQVE.	ANGELIQUE.
FILENE.	SILÈNE.
De Lucidor.	De Lucidor.
ANGELIQ E.	ANGELIQ .
Ouienx:	Ouvienx:
que me ats-tu?	que me ats-tu?
FILENE.	SILÈNE.
Ce ſubtil ſuborneur a trahy ſa vertu, Et Celie a faict part à mes propres oreilles De la confeßion de toutes ces merueilles, Elle ayme Lucidor, mais ſi diſcrettement Qu’aux yeux de ſes ialoux ſon amour ſe dément, Pour l’vn elle a des vœux, pour l’autre des promeſſes, Lucidor cependant a toutes ſes careſſes, Et tandis qu’à nos yeux vne feinte rigueur S’adreſſe à cet amant il poſſede ſon cœur, Ecoutés ce qui reſte et comment l’auarice Faict aux plus innocens employer l’artifice, Ce vice, qui ne naiſt que proche du trépas, A leur ieuneſſe meſme a ſemé des appas, Pour tirer plus de biens des parens de Celie Lucidor l’a portee à feindre la folie, C’eſt tout ce que ie ſçay, ſon pere cependant Qui ne le peut reſoudre en pareil accident, Filene, m’a-t’il dit;	Ce subtil suborneur a trahi sa vertu, Et Celie a fait part à mes propres oreilles De la confession de toutes ces merveilles, Elle aime Lucidor, mais si discrettement Qu'aux yeux de ses jaloux son amour se dément, Pour l'un elle a des vœux, pour l'autre des promesses, Lucidor cependant à toutes ses caresses, Et tandis qu'à nos yeux feinte rigueur S'adresse à cet amant il possède son cœur, Ecoutés ce qui reste et comment l'avarice Fait aux plus innocents employer l'artifice, Ce vice, qui ne vi que ce du trépas, A leur ieunesse même a semé des appas, Pour tirer plus de biens des parens de ç Lucidor a portée feindre la folie, est tout ce que ie sçay, son pr cependant Qui ne le peut ô en pareil che, Filene, ail dit;
cours épargner la peine De cet obiet charmant, dy que Celie eſt ſaine, Fay luy de ce qui touche,& ma vie, et mon bien Vne offre de ma part & ne reſerue rien.	cours épargner la peine De cet objet charmant, dis que Celie est saine, Fayblé de ce qui touche,et ma vie, et mon bien Venne offre de ma part et ne réserve rien.
ANGELIQVE.	ANGELIQUE.
Ils eny .	Ils eni .
Adieu qu’il viue heureux:	Adieu qu'il vive heureux:
ainſi mon eſperance En vn meſme moment naiſt, et meurt dans Florence, Ainſi le deſeſpoir, les pleurs, & le tourment Me reſtent pour faueurs de ce perfide amant, Celie ayme ce traiſtre & ceſte ame ruſee De tant de vains ſouſpirs a la mienne abuſee!	ainsi mon espérance En un même moment naît, et meurt dans Florence, Ainsi le désespoir, les pleurs, et le tourment Me restent pour faveurs de ce perfide amant, Célie aime ce traître et cette âme rusée De tant de vains soupirs à la mienne abuse!
Meurs déplorable amante vn effort genereux Finira les rigueurs de ton ſort malheureux, Peux-tu ſans lâcheté ſuruiure à l’infamie D’auoir aueuglement ſeruy ton ennemie?	Meurs déplorable amante un effort généreux Finira les rigueurs de ton sort malheureux, Peux-tu sans lâcheté surviure à l'infamie D'avoir aveuglement servi ton ennemie?
Peux-tu voir en ſes bras l’obiet de tes deſirs?	Peux-tu voir en ses bras l'objet de tes désirs?
Comparer ſans mourir, ta peine à leurs plaiſirs?	Comparer sans mourir, ta peine à leurs plaisirs?
Uoir qu'elle ait Lucidor toy ſes ſeules promeſſes Et faire vn temps de deuil, du temps de leurs careſſes?	Uoir qu'elle ait Lucidor toi ses seules promesses Et faire un temps de deuil, du temps de leurs caresses?
Sus dequoy s’armera mon deſſein furieux?	Sus dequoy s'armera mon dessein furieux?
Preuenés mes efforts, impitoyables Dieux, Vos traicts me ſeront doux, en ce deſſein funeſte, Apres ce que ie perds prenés ce qui me reste, Uos rigueurs m’ont rauy l’obiet de mon amour, Et n’eſperant plus rien ie dois perdre le iour.	Preuenés mes efforts, impitoyables Dieux, Vos traits me seront doux, en ce dessein funeste, Après ce que je perds prenés ce qui me reste, Uos rigueurs m'ont ra obiet de mon amour, Et n'espérant plus rien ie a perdre le jour.
CLORIMAND.	CLORIMAND.
Le temps, & la raiſon, contre voſtre cholere, Feront bien toſt, Madame, vn effort neceſſaire, Et l’eſprit le plus ſain ne peut qu’iniuſtement Condamner ces eſfects du premier mouuement,	Le temps, et la raison, contre votre cholère, Feront bien tôt, Madame, un effort nécessaire, Et l'esprit le plus sain ne peut qu'injustement Condamner ces esfects du premier mouvement,
ANGELIQVE, Non, non, ie veux mourir, de legeres atteintes En ces occaſions ne cauſent que des plaintes Mais vn malheur ſenſible au poinct oùie le ſents, Arme contre l’eſprit les plus timides ſens, Et le Ciel refuſant ſon ſecours à mes larmes Du fer,& du poiſon ie me ferois des armes, Le temps, et la raiſon n’ont point finy mes vœux, Et le deſſein que i’ay ne peut finir par eux, I’ayme ſeule ardemment,& de toutes les ames Capables de porier des cuaiſnes, & des flames, ’’ay ſeule de l’amour ſenty les vifs accés Seule aymé ſans reſerué, & ſeule dans l'excés.	ANGELIQUE, Non, non, je veux mourir, de légères atteintes En ces occasions ne causent que des plaintes Mais un malheur sensible au point oùie le sents, Arme contre l'esprit les plus timides sens, Et le Ciel refusant son secours à mes larmes Du fer, du poison et du pois des armes, Le temps, et la raison n'ont point fini mes vœux, Et le dessein que j'ai ne peut finir par eux, J'aime seule ardemmentes de toutes les âmes Capables de porier des cuines, et des flammes, et des ay et de l'amour senti les vifs acce Seule aimé sans reserué, et seule dans l'excés.
CLORIMAND.	CLORIMAND.
Uoyons ce Lucidor forçons tous ces obſtacles, L’amour est Dieu, Madame, et le Dieu des miracles, Faiſons à cet amant ſentir ſa lâcheté, Et voyons le rougir de ſa legereté, Vos ſouſpirs, & vos pleurs toucheront ſon courage, Et le remords enfin vous rendra ſon hommage, Jl eſt aueugle autant que vos attmits ſont doux, S’il faict comparaiſon de Celie, & de vous, Si nous touchons ſon cœur, par vne prompte fuite.	Uoyons ce Lucidor forçons tous ces obstacles, L'amour est Dieu, Madame, et le Dieu des miracles, Faisons à cet amant sentir sa lâcheté, Et voyons le rougir de sa légèreté, Vos soupirs, et vos pleurs toucheront son courage, Et le remords enfin vous rendra son hommage, Il est aveugle autant que vos attits sont doux, S'il fait comparaison de Célie, et de vous, Si nous touchons son cœur, par une prompte fuite.
Des parens de Celie éuités la pourſuite, Eſſayons ce moyen.	Des parents de Celie évités la poursuite, Essayons ce moyen.
ANGELIQVE.	ANGELIQUE.
C’eſt la ſeule action Ou ne peut conſentir, mon inclination, Le toucher par des pleurs!	C'est la seule action Ou ne peut consentir, mon inclination, Le toucher par des pleurs!
ſolliciter ſa grace:	solliciter sa grâce:
Le prier qu’il me prie, et qu’il me ſatisface!	Le prier qu'il me prie, et qu'il me satisface!
C’eſt trop de lâcheté, mon amour eſt parfaict Et tapuible de tout, ſinonde cet effect, Quittons cette odieuſe, & fatale demeure Et que l’on ſe diſpoſe à partir dans vne heure.	C'est trop de lâcheté, mon amour est parfait Et tapuible de tout, sinonde cet effet, Quittons cette odieuse, et fatale demeure Et que l'on se dispose à partir dans une heure.
CLORIMAND.	CLORIMAND.
O Dieux!	Ô Dieux!
diuertiſſes ſes funeſtes deſſeins Et dans cette fureur ſauués là de ſes mains.	divertisses ses funestes desseins Et dans cette fureur sauvez -là de ses mains.
SCENE SEPTIESME.	SCÈNE SEPTIÈME.
FILENE, ſeul.	SILÈNE, seul.
Ieux que de changements, chaſque inſtant Ay nous apporte!	Jeux que de changements, chasque instant Ai nous apporte!
Le peintre a trauaillé d’vne agreable ſorte, Un ſemblable meſtier ne me déplairoit pas, On attend la Iustice, il faut preſſer le pas.	Le peintre a travaillé d'une agréable sorte, Un semblable métier ne me déplairait pas, On attend la Justice, il faut presser le pas.
TACTE SCENE PREMIERE.	TACTE SCÈNE PREMIÈRE.
LILENE, auec Ies Archers,	LILENE, avec Jes Archers,
Il dit eſtant ſeul.	Il dit étant seul.
Que ie plains ſa diſgrace!	Que quelque plains sa disgrâce!
Quel valet ſi fidelle euſt moins faict en ſa place?	Quel valet si fidèle eût moins fait en sa place?
Et combien en ce ſiecle auroient perdu le iour Si l’on auoit puny tous les crimes d’amour?	Et combien en ce siècle auraient perdu le jour Si l'on avait puni tous les crimes d'amour?
L ij	 Léj
SCENE DEVXIESME.	SCÈNE DEUXIÈME.
CELIANTE, ſeul, leux!	CELIANTE, seul, leux!
quel déreiglement!	quel dérèglement!
quel deſordre incro12 yable, Que ſon geſte eſt confus, & ſa voix effroyable On m'a veu l’abordant, triſte, ſaiſi, ſurpris, Vne prompte frayeur a glacé mes eſprits, J'ay deteſté mon ſort, & ie n’ay pù ſans larmes U oirſon mal alterer la douceur de ſes charmes;	quel désordre incro12 yable, Que son geste est confus, et sa voix effroyable On m'a vu l'abordant, triste, saisi, surpris, Ute frayeur a glacé mes esprits, J'ai détesté mon sort, et un n'ai pu sans larmes V Uoirson mal altérer la douceur de ses charmes;
Ses yeux, ces doux autheurs des ennuys que ie ſents, Ont changé leurs attraits en regards menaçants, I'ay douté quelque temps de voir l’obiet que i’ayme Et cherché ſon viſage, en ſon viſage meſme;	Ses yeux, ces doux auteurs des ennuis que sans sents, Ont changé leurs attraits en regards menaçant, J'ai douté quelque temps de voir l'objet que j'aime Et cherché son visage, en son visage même;
Ses coups m’ont faict ſortir:	Ses coups m'ont fait sortir:
mais qu'eſt-ce que ie voy.	mais qu'est-ce que ie cy.
NRuels, ce traictement eſt le prix de ſa foy?	NRuels, ce traitement est le prix de sa foi?
Miniſtres inhumains des paßions d’vn pere Jniuſte en ſon deſſein, aueugle en ſa cholere, Qui dans l’auare ſoing dont il est combattu Ignore de Leandre & l’offre, & la vertu, Rendés cet innocentià ma iuſte priere, Ou que s’il doit mourir, ie meure la premiere, Si ie vis, nous viurons ſous de pareilles loix Jl ne m’a point rauy ce que ie luy donnois, Et l’on accuſe à tort l’innocent de mon crime, Que mon intention a rendu legitime.	Ministres inhumains des passions d'H pere Injuste en son dessein, aveugle en sa colère, Qui dans l'avare soing dont il est combattu Ignore de Léandre et l'offre, et la vertu, Rendez cet innocentià ma juste prière, Ou que s'il doit mourir, Seigneur meure la première, Si ici vis, nous vivrons sous de pareilles lois Jl ne a point rauy ce que ietaît donnais, Et l'on accuse à tort l'innocent de mon crime, Que mon intention a rendu légitime.
SCENE TROISIESME.	SCÈNE -TROISIÈME.
LES ARCHERS, tenants Leandre, CELIANTE, CELIE, ERASME, FILENE, LA NOVRRICE, CELIE, tirant Leandre des mains des Archers.	LES ARCHERS, tenants Léandre, CELIANTE, CELIE, ERASME, SILÈNE, LA NOURRICE, CÉLIE, tirant Léandre des mains des Archers.
ERASME.	ERASME.
Allés, ſes cris font vains.	Allz, ses cris font vains.
CELIANTE.	CELIANTE.
O Dieux!	Ô Dieux!
quel changement!	quel changement!
CELIE.	CELIE.
Non, i’auray de vos mains la mort, ou mon amant, l'vn des Sauue ta liberté, prouue par cette épee & la don-Qu’ailleurs, qu'à des tableaux ta main s’eſt occupee, Prouue que tu ſçays mieux, ſi tu le ſceus iamais, Deffaire vn ennemy, que faire des pourtraicts, Quoy, ton cœur ſe dément?	Non, j'aurai de vos mains la mort, ou mon amant, l'un des Sauve ta liberté, prouve par cette épee et la don-Qu'ailleurs, qu'à des tableaux ta main s'est occupe, Prouve que tu sçays mieux, si tu le sceus jamais, Défaire un ennemi, que faire des pourtraits, Quoi, ton cœur se dément?
& cette arme inutile N'eſt qu’vn honteux fardeau dans ta main immobile?	et cette arme inutile N'est qu'un honteux fardeau dans ta main immobile?
Tu rends ce ſeul moyen qui reſte à ta valeur, Contre ces inſolents, & contre ton malheur?	Tu rends ce seul moyen qui reste à ta valeur, Contre ces insolents, et contre ton malheur?
ERASME.	ERASME.
Fleau de mes derniers iours, fille aueugle, & ſans honte, Que l’honneur abandonne & que le vice dompte, De quel œil puis-ie voir tes geſtes inſolents?	Fleau de mes derniers jours, fille aveugle, et sans honte, Que l'honneur abandonne et que le vice dompte, De quel œil puis-je voir tes gestes insolents?
Et ſouffrir ces efforts honteux, & violents.	Et souffrir ces efforts honteux, et violents.
Traiſnés, n’attendés plus.	Traînez, n'attendez plus.
CELIE, à genoux.	CELIE, à genoux.
Que le ſainct nom de Pere Pour m’entendre vn moment force voſtre cholere, Jl est vray, i’ay failly, mais la neceßité De bannir vn riual feist ma facilité, Leandre n’eſt pas noble en voſtre cognoiſſance.	Que le saint nom de Père Pour m'entendre un moment force votre colère, Jl est vrai, j'ai failly, mais la necessité De bannir un rivalu fut ma facilité, Léandre n'est pas noble en votre connaissance.
Mais vn faux veſtement vous cache ſa naiſſance, Il est noble, et puiſſant, ma ſeule occaſion Faict ſon déguiſement, & ſa confuſion, L’eſpoir de gouuerner vne indigne maiſtreſſe La faict ſous ces habits déguiſer ſa nobleſſe, Jl a faict de ſon nom vn commun changement Lucidor eſt le nom de ce parfaict amant, L'Eſpagne eſt ſon païs, Valence fut ſa Ville, Et ſa projeßion n'eſt ny paſſe, ny vile.	Mais un faux vêtement vous cache sa naissance, Il est noble, et puissant, ma seule occasion Fait son déguisement, et sa confusion, L'espoir de gouverner une indigne maîtresse La fait sous ces habits déguiser sa noblesse, Il a fait de son nom un commun changement Lucidor est le nom de ce parfait amant, L'Espagne est son pays, Valence fut sa Ville, Et sa projession n'estime ni Seigneur, ni vile.
L’epee est ſon pinceau, des Princes, & des Roys, Se ſont veus obligès à ſes rares exploits.	L'épée est son pinceau, des Princes, et des Rois, Se sont ès obliges à ses rares exploits.
CELIANTE, eſtonné.	CELIANTE, étonné.
Ton nom eſt Lucidor?	Ton nom est Lucidor?
LEANDRE.	LÉANDRE.
Ouy, ſi dans ma memoire Il reste quelque éclat de ma premiere gloire, En autre occaſion i’ay paru d’autre rang, Et i’ay peint quelquesfois des campagnes de ſang;	Oui, si dans ma mémoire Il reste quelque éclat de ma première gloire, En autre occasion j'ai paru d'autre rang, Et j'ai peint quelquefois des campagnes de sang;
CELIANTE.	CELIANTE.
O Dieux!	Ô Dieux!
le vain eſprit!	le vain esprit!
& de quelle impudenie Il eſpere à mes yeux reparer ſon offence.	et de quelle impudénie Il espère à mes yeux réparer son offense.
LEANDRE.	LÉANDRE.
Vn iour la verité finira mes ennuys Et ton malheur alors, prouuera qui ie ſuis.	Un jour la vérité finira mes ennuis Et ton malheur alors, provera qui ie suis.
CELIANTE.	CELIANTE.
Ie crains fort ce danger!	Je crains fort ce danger!
ma rencontre importune Eſt vn fatal obſtacle à ta bonne fortune, Et ſçachant qui ie ſuis tu chercherois ailleurs Le titre neceſſaire à finir tes malheurs, Ualence eſt mon païs, Eucidor fut mon frere Et le Ciel a finy ſa vie, & ſa miſere, Tu deuois ſouhaitter pour ton contentement Vne ruſe meilleure, où mon eſloignement.	ma rencontre importune Est un fatal obstacle à ta bonne fortune, Et sachant qui ie suis tu chercherais ailleurs Le titre nécessaire à finir tes malheurs, Ualence est mon pays, Eucidor fut mon frère Et le Ciel a fini sa vie, et sa misère, Tu devais souhaiter pour ton contentement Une ruse meilleure, où mon éloignement.
LEANDRE.	LÉANDRE.
La pure verité cauſe mon aſſeurance Et ie n’emprunte rien d’vne vaine apparence, leonis eſt mon pere, & le Prince du iour A faict de ſes maïſons vingt fois le meſme tour, Depuis que dans BiZance vn rigoureux ſeruage Exerce ma conſtance, & conſomme mon aage, Enfin, et mon courage, & ma fidelité Ont faict au grand Seigneur ſigner ma liberté, I'ay voulu voir Florence, où les yeux de Madame Ont eſté les autheurs de ma pudique flame, Et la peine que i’eus de la voir librement Ma depuis faict reſmart a tt ueguifement.	La pure vérité cause mon assurance Et ainsi n'emprunte rien d'une vaine apparence, leonis est mon père, et le Prince du jour A fait de ses maïsons vingt fois le rés te, Depuis que dans Bizance un rigoureux servage Exerce ma constance, et consomme mon âge, Enfin, et mon courage, et ma fidélité Ont fait au grand Seigneur signer ma liberté, J'ai voulu voir Florence, où les yeux de Madame Ont été les auteurs de ma pudique flamme, Et la peine que j'eus de la voir librement Ma depuis faict résart a tt tueguifement.
:	:
I'ay pour charmer le temps, & pour me ſatisfaire En mes plus ieunes ans appris l’art de pourtraire, Et i’aymois par inſtinct cette condition Comme vn moyen futur à mon affection.	J'ai pour charmer le temps, et pour me satisfaire En mes plus jeunes ans appris l'art de pourtraire, Et j'aimais par instinct cette condition Comme un moyen futur à mon affection.
CELIANTE.	CELIANTE.
O Dieux!	Ô Dieux!
qu’ay-ie entendu, iadis vn ſort contraire Entre les mains des Turcs auoit liuré mon frere, Et le long déplaiſir de ne le reuoir pas Nous auoit ſeulement faict croire ſon trépas, Eſt-ce luy, que ie voy?	qu'ai-je entendu, jadis un sort contraire Entre les mains des Turcs avait livré mon frère, Et le long déplaisir de ne le revoir pas Nous avait seulement fait croire son trépas, Est-cefois, que sans vois?
LEANDRE.	LÉANDRE.
Chriſante, eſt nostre mere,	Chrysante, est notre mère,
CELIANTE.	CELIANTE.
C’eſt luy n’en doutons plus;	C'est notre n'en doutons plus;
que le Ciel m'eſt proſpere, Et qu’vn ſecret instinct me faict voir clairement Ce bien que ie retreuue en cet heureux moment.	que le Ciel m'est prospère, Et qu'un secret instinct me fait voir clairement Ce bien que notre retreuue en cet heureux moment.
LEANDRE.	LÉANDRE.
Et temps, a mes ennuys, durant ce long voyage Ont de mon ſouuenir effacé vostre image, Mais auec voſtre nom, vostre confeßion Eſtablit ma croyance, & mon affection.	Et temps, à mes ennuis, durant ce long voyage Ont de mon souvenir effacé votre image, Mais auec jours nom, votre confession Établit ma croyance, et mon affection.
CELIANTE.	CELIANTE.
O celeste rencontre!	Ô céleste rencontre!
ô diuine aduanture!	ô divine aventure!
Que de ioye en ce cœur excite ta nature, Nos vœux ſont exaucés, mon frere voit le iour.	Que de joie en ce cœur excite ta nature, Nos vœux sont exaucès, mon frère voit le jour.
Et le Ciet me te rend en cet heureux ſeiour,	Et le Ciet me te rend en cet heureux séjour,
ERASME.	ERASME.
O diuin changement!	Ô divin changement!
CELIANTE.	CELIANTE.
Accordés cette belle Aux ſainctes paßions d'vn amant ſi fidelle, C’eſt luy, n’en doutés plus, & ſa condition Le rend digne ma ſœur de ſon ambition, Ses biens, & ſon merite égalent ſa naiſſance, Et ſon chaſte deſſein, repare ſon offence.	Accordez cette belle Aux sainte passions d'un amant si fidèle, C'est lui, n'en doutés plus, et sa condition Le rend digne ma sœur de son ambition, Ses biens, et son mérite égalent sa naissance, Et son chaste dessein, répare son offense.
ERASME.	ERASME.
Ie ne conſerue point en ce bien ſans égal Plus de reſſentiment que ſon propre riual, D'vne commune voix beniſſés l’auanture Qui conſerue les iours, & repare l’iniure, Li vonnen eoo pruisins eomo moimcomorent les Cieux Aux Ar- Laiſſés regner la ioye, & la paix en ces lieux, Lucidor ſouffre aſſés, ſes flames ſont ſes peines Et les liens d’amour, ſeront ſes ſeules chaiſnes:	Je ne conserve point en ce bien sans égal Plus de ressentiment que son propre rival, D'une commune voix benissés l'aventure Qui conserve les jours, et répare l'injure, Li vonnen eoo pruisins eomo moimcomorent les Cieux Aux Ar- Laissés régner la joie, et la paix en ces lieux, Lucidor souffre assés, ses flammes sont ses peines Et les liens d'amour, seront ses seules chaînes:
CELIANTE Quels vœux ſuccederont au mauuais traictement D’vn frere iniurieux en ſon aueuglement:	CELIANTE Quels vœux succéderont au mauvais traitement D'vn frère injurieux en son aveuglement:
Quels ſeruices rendus quelles peines futures Uous pourront Lucidor reparer ces iniures, Si le reſſentiment d'vn cœur intereſſé N’excuſe les diſcours qui vous ont offencé.	Quels services rendus quelles peines futures Uous pourront Lucidor réparer ces injures, Si le ressentiment d'un cœur intéressé N'excuse les discours qui vous ont offensé.
LVCIDOR, ſous le nom de Leandre.	LUCIDOR, sous le nom de Léandre.
Partagés les plaiſirs que le Ciel nous enuoye, Je ne puis condamner la cauſe de ma ioye, Et i’excuſe ayſément vn aueugle courroux A qui ie ſuis tenu d’vn changement ſi doux, Que les proſperités ſuccedent aux ſupplices Oublions nos ennuys, & gouſtons nos delices, Enfin le Ciel Celie, eſt propice à mes vœux Et mes maux ſont ſuiuis de la fin que ie veux, Nous deuons à l’enuy cherir cet heureux frere e jaionujuo deſpens ceſſer nostre miſere.	Partagez les plaisirs que le Ciel nous envoie, Je ne puis condamner la cause de ma joie, Et j'excuse aisément un aveugle courroux A qui tu suis tenu d'un changement si doux, Que les prospérités succèdent aux supplices Oublions nos ennuis, et goûtons nos délices, Enfin le Ciel Célie, est propice à mes vœux Et mes maux sont suivis de la fin que je veux, Nous devons à l'envi chérir cet heureux propre é jaionujuo dépens cesser notre misère.
ELIE.	ÉLIE.
Que ie luy dois de vœux.	Que quelque grande dois de vœux.
ERASME.	ERASME.
Uoyons cette beauté, Qui voüoit ce matin ſa peïne à ta ſanté.	Uoyons cette beauté, Qui vienne ce matin sa péine à ta santé.
M ij	M ij
SCENE QVATRIESME.	SCÈNE QUATRIÈME.
CELIANTE, LEANDRE, ERASME, CELIE, LA NOVRRICE, FIL'ENE, ANGELIQVE, CLONIMAND.	CELIANTE, LÉANDRE, ERASME, CELIE, LA NOURRICE, FIL'ENE, ANGELIQUE, CLONIMAND.
ERASME, continue.	ERASME, continue.
Are,& pieuſe fille, heureuſe Pelerine, N Ioüy des longs honneurs que le Ciel te deſtine, Et poſſede cent ans vne proſperité Digne de ta naiſſance, & de ta charité, Nos maux ſont acheués, Lucidor & Celie Sont ſatisfaicts du ſort par le nœud qui les lie, Et nous te ſouhaittons vn ſeruage pareil Auant que cette nuict nous cache le Soleil.	Arre,et pieuse fille, heureuse Pèlerine, N Ioüy du sorts honneurs que le Ciel te destine, Et possède cent ans quelque prospérité Digne de ta naissance, et de ta charité, Nos maux sont achevés, Lucidor et Celie Sont satisfaits du sort par le nœud qui les lie, Et nous te souhaitons un servage pareil Avant que cette nuit nous cache le Soleil.
ANGELI E.	ANGELY .
Souhaittés vous pluſtost que cet eſprit volage Ne ſe repente pas de la foy qui l’engage, Craignés vn changement où preſſes ce trompeur, Celie en mon exemple a des ſuiets de peur, Et ce perfide autheur du feu qui me conſume De l’infidelité s’eſt faict vne couſtume, Geirit pau vil obiet d’vne parfaicte amour, Et le plus criminel qui reſpire le iour.	Souhaitez -vous plutôt que cet esprit volage Ne se repente pas de la foi qui l'engage, Craignès un changement où presses ce trompeur, Célie en mon exemple a des sujets de peur, Et ce perfide auteur du feu qui me consume De l'infidélité s'est fait une coutume, Geirit pau vil objet d'une parfaite amour, Et le plus criminel qui respire le jour.
LVCIDOR,ſous le nom de Leandre.	LUCIDOR,sous le nom de Léandre.
Le plus religieux, ne peut ſans iniuſtice S’il cognoiſt mon eſprit m’accuſer de ce vice, Et vous rendés à tort ſuſpect de trahiſon Une amour ſans exemple, & ſans comparaiſon;	Le plus religieux, ne peut sans injustice S'il connaît mon esprit m'accuser de ce vice, Et vous rendez à tort suspect de trahison Une amour sans exemple, et sans comparaison;
Celie à la premiere aſſeruy ma franchiſe 2 Ses beaux yeux ſont autheurs de ma premiere priEt ie perdray plustoſt le bien de la clarté Que le ferme deſſein de ſeruir ſa beauté.	Celie à la première asservi ma franchise 2 Ses beaux yeux sont auteurs de ma première priEt ie perdrai plutôt le bien de la clarté Que le ferme dessein de servir sa beauté.
ERTECM J'accuſe Lucidor;	ERTEC J'accuse Lucidor;
LEANDRE.	LÉANDRE.
Sans raiſon legitime,	Sans raison légitime,
JELIQ E.	JELIQ É.
La raiſon deffend donc, qu’on n’accuſe le crime, Qu'il paroiſſe à mes yeux & ce perfide amant Rougira de ma peine, & de ſon changement.	La raison défend donc, qu'on n'accuse le crime, Qu'il paraisse à mes yeux et ce perfide amant Rougira de ma peine, et de son changement.
LVCIDOR.	LUCIDOR.
Ie ſuys ce Lucidor, qui poſſede ma Dame, M iij	Je suis ce Lucidor, qui possède ma Dame, M jijà
AI GELIQ E.	AI GÉLIQ E.
Vn autre eſt le ſuiet du courroux qui m'enflamme, Me ſerois-ie abuſee à ce nom ſeulement?	Un autre est le sujet du courroux qui m'enflamme, Me serais-je abusée à ce nom seulement?
Dmiume iqu en toute eſpon fueceue à mon jour ment.	Disume iqu en toute espon fecue à mon jour ment.
ERASME.	ERASME.
Madame ray pour vous vne eſperance vaine Ou i’auray le bon-heur de vous tirer de peine.	Madame rai pour vous une espérance vaine Ou j'aurai le bonheur de vous tirer de peine.
CLORIMAND.	CLORIMAND.
Lè Ciel nous fauoriſe.	Lé Ciel nous favorise.
ERASME.	ERASME.
Un Seigneur de renom A commun auec luy ſon deſſein, et ſon nom, Mais ſon eſpoir eſt vain, et Celie est acquiſe A ce riual ſubtil meſme auant que promiſe, Son adreſſe eſt fatale aux vœux de ſes riuaux, Il s’eſt donné deſia le fruict de ſes trauaux, Et la neceßité de conioindre leurs ames Laiſſe le change libre au ſuiet de vos flames, Si vostre bien dépend de cet heureux vainqueur Employés tous nos ſoings, ſonderay-ie ſon cœur?	Un Seigneur de renom A commun homme même son dessein, et son nom, Mais son espoir est vain, et Celie est acquise A ce rival subtil même avant que promise, Son adresse est fatale aux vœux de ses rivaux, Il s'est donné déjà le fruit de ses travaux, Et la nécessité de conjoindre leurs âmes Laisse le change libre au sujet de vos flammes, Si votre bien dépend de cet heureux vainqueur Employés tous nos soings, sonderai-je son cœur?
Scauray-ie quel ſuiet cauſe ſon inconſtance, Et vous ſuffira-t’il de voir ſa repentance?	Saurai-je quel sujet cause son inconstance, Et vous suffira-t-il de voir sa repentance?
ANGELI E Puis-ie auoir le plaiſir de luy parler iey Prenés en ma faueur vn ſemblable ſoucy, Mais ſur tout, qu’il ignore, où tendra ſa venuë Je luy veux quelque temps parler comme incogneuë, Et ſans prouuer, combien, i’ay l’eſprit aſſailly, Voir ſi comme ſon cœur, ſa memoire a failly.	ANGELY E Puis-je avoir le plaisir de lui parler R Prenés en ma faveur un semblable souci, Mais sur tout, qu'il ignore, où tendra sa venue Je a veux quelque temps parler comme inconnue, Et sans prouver, combien, j'ai l'esprit assailly, Voir si comme son cœur, sa mémoire a failly.
ERASME Fiés moy ſeulement cette charge amoureuſe Et viues en l'eſpoir de viure plus neureuſe, Ie le voy, cachez vous.	ERASME Fiez moi seulement cette charge amoureuse Et vives en l'espoir de vivre plus neureuse, Je le vois, cachez vous.
ANGELIQ TE, Je vous deuray le tour, oi t'oviens par oos joings, ià ſin de mon amour.	ANGELIQ TE, Je vous devrai le tour, oi t'oviens par oos joings, ià sin de mon amour.
SCENE CINQVIESME.	SCÈNE CINQUIÈME.
LVCIDOR,FILIDAN,	LUCIDOR,FILIDAN,
FILIDAN, Nfin, vous poſſedés cette heureuſe franchiſe, EQue les yeux de Celie, ou ſes biens auoient Quelle autre deſormais, charmera vos eſprits Prendrés vous Celimene, Amaranthe, ou Cloris, A qui ſera l’honneur de voſtre ardeur nouuelle?	FILIDAN, Nfin, vous possédez cette heureuse franchise, ÉQue les yeux de Celie, ou ses biens avaient Quelle autre désormais, charmera vos esprits Prendrés vous Celimène, Amaranthe, ou Cloris, À qui sera l'honneur de votre ardeur nouvelle?
Prenés les toutes trois, vous aurés la plus belle, Celimene eſt charmante, & n’a que ce deffaut Qu'elle ſe communique vn peu plus qu’il ne faut, La reſerue est priſable en l’eſprit d’vne fille, Que vous ſemble de l’autre, Amaranthe eſt gentille, Son eſprit m’a paru dans quelque occaſion, I'y trouue toutefois de la confuſion, Cloris me plairoit mieux ſa grace est naturelle, Son eſprit eſtimable, & ſon humeur ſi belle, Que ſon doux entretien charme tous les eſprits, Elle ſçait des meilleurs le merite, & le prix, Meſme priſe des vers, blaſme, ou priſe vne vaine, Et certes en ce poinct ie la trouue vn peu vaine.	Prenez -les toutes trois, vous aurés la plus belle, Celimène est charmante, et n'a que ce défaut Qu'elle se communique un peu plus qu'il ne faut, La réserve est prisable en l'esprit d'une fille, Que vous semble de l'autre, Amaranthe est gent, Son esprit m'a paru dans quelque occasion, J'y trouve toutefois de la confusion, Coris me plairoit mieux sa grâce est naturelle, Son esprit estimable, et son humeur si belle, Que son doux entretien me tous les esprits, Elle avait des meilleurs le mérite, et le prix, Même prise des vers, blâme, ou prise des vers, Ou certes ou cepoinct ie la trouue en ce vaine.
LVCIDOR.	LUCIDOR.
Tu le prends vn peu haut.	Tu le prends un peu haut.
FILIDAN.	FILIDAN.
Je vays plus haut encor Car i’ay treuué des vers l’eſtimable threſor, Cet aymant des eſprits, cet art de plaire aux Dames D’enſorceler les cœurs, & d’enchanter les ames.	Je vais plus haut encor Car j'ai trouvé des vers l'estimable trésor, Cet aimant des esprits, cet art de plaire aux Dames Densorceler les cœurs, et d'enchanter les âmes.
VCIDOR.	VCIDOR.
omment:	omment:
tu faicts des vers?	tu faits des vers?
FILIDAN	FILIDAN
FILIDAN, Ouy, mais vers en effect, Qui ne dementent point l'eſtime qu’on en faict, Nobles, ſolides, forts, & non pas de ces rithmes Par qui mille ont acquis des noms illegitimes, Et paſſent pour autheurs en la commune voix De ceux qui de noſtre art n'ont iamau ſceu les loix.	FILIDAN, Oui, mais vers en effet, Qui ne démentent point l'estime qu'on en fait, Nobles, solides, forts, et non pas de ces rythmes Par qui mille ont acquis des noms illégitimes, Et passent pour auteurs en la commune voix De ceux qui de notre art n'ont jamau sceu les lois.
VCIDOR.	VCIDOR.
En ſemblable mestier, chacun s’eſtime maiſtre, Tous y ſont ignorame & pan enme erou t'eſtre Peu ſçauent en cet art reüßir comme il faut Et chacun l’vn de l’autre accuſe le deffaut.	En semblable métier, chacun s'estime maître, Tous y sont ignorme et pan enme erou t'être Peu pavent en cet art réussir comme il faut Et chacun l'un de l'autre accuse le défaut.
FILIDAN.	FILIDAN.
Le iugement eſt libre & le prix qu’on me nie, Ie ne l’attire point auecques tyrannie, Je ne pretends charmer les Dieux, ny les humains Je n'ay point arraché de lauriers de leurs mains Si l'on m'en voit porter on les met ſur ma teſte, Je les dois à mon style,& non à ma requeſte, J’ay peu de vanité:	Le jugement est libre et le prix qu'on me nie, Je ne l'attire point manques tyrannie, Je ne prétends charmer les Dieux, ni les humains Je n'ai point arraché de lauriers de leurs mains Si l'on m'en voit porter on les met sur ma tête, Je les dois à mon style,et non à ma requête, J'ai peu de vanité:
mais pour le moins ie croy Laiſſer de tant d’Autheurs quelque nombre apres mo Et me vognoiſtre aſſés en ce ſacré myſtere Pour oſer diſcoufir, ou cent ſe doiuent taire, Mes vers, comme beaucoup ne ſont point approuués Pour vn meſlange obſcur de termes releués, Dont le ſens eſt confus, et qui ne ſignifient Que la ſterilité de ceux qui verifient, Qui plaiſent toutefois & ſement des appas Au peuple admirateur de ce qu’il n’entend pas, D’autres parlent touſiours d’vne fleur, ou d’vn arbre Entretiennent vne onde interrogent du marbre, Et n’oZent haZarder leurs eſprits lents, et lourds Iuſqu’à l’expreßion ſolide diſcours, Ma muſe ne ſent point leur foibleſſe, & leur peine, Ie tire mes penſers d’vne meilleure vains:	mais pour le moins vertu cro Iser de tant d'Auteurs quelque nombre après mo Et me vognoistre assez en ce sacré mystère Pour oser discouffir, ou cent se doivent taire, Mes vers, comme beaucoup ne sont point approuvés Pour un mélange obscur de termes relevez, Dont le sens est confus, et qui ne signifient Que la stérilité de ceux qui vérifient, Qui plaisent toutefois et sèment des appas Au peuple admirateur de ce qu'il n'entend pas, autres parlent pas fleur, ou D' a Ute onde interrogent du marbre, Ou d'uN haZarder fleur esprits lents, et ou D'une aexpression solide discours, a te ne on point leur adresse, et leur peine, Ietiremes pensers d meilleure mar:
I'écry plus noblement, & ſans beaucoup reſuer Ce qui de ſoy languit ie le ſçay releuer Mes toers ont des peautes ſi neitemeni ecloſes, Que l’œil d’vn enfant meſme, y voit de belles choMais vous eſtimerés ces diſcours vn peu vains.	J'écri plus noblement, et sans beaucoup rêver Ce qui de soi languit était le sais relever Mes toers ont des peautes si neitemeni écloses, Que l'œil d'un enfant Seigneur, y voit de belles choMais vous estimerez ces discours un peu vains.
CIDOR.	CIDOR.
Autant, que le ſont ceux de tous les écriuains.	Autant, que le sont ceux de tous les écrivains.
Tous priſent leur ſçauoir tous eſtiment leurs voiles, Et tous penſent auoir le ſecret des merueilles, Mais fort peu, Filidan ſont au haut de ce mont Ou l’on n’arriue point, que le laurier au front,	Tous prisent leur savoir tous estiment leurs voiles, Et tous pensent avoir le secret des merveilles, Mais fort peu, Filidan sont au haut de ce mont Ou l'on n'arrive point, que le laurier au front,
LIDAN.	LIDAN.
J'eſpere toutefois l'honneur de vos ſuffrages Si vous examinés quelqu’vn de mes ouurages, Ma muſe en celuy-cy, blaſme la cruauté D’vne aymable, charmante, & diuine beauté, Mais la plus inſenſible & la plus dédaigneuſe Qui me pouuoit cauſer cette ardeur amoureuſe.	J'espère toutefois l'honneur de vos suffrages Si vous examinez quelqu'Un de mes ouvrages, Ma muse en celui-cy, blâme la cruauté D'une aimable, charmante, et divine beauté, Mais la plus insensible et la plus dédaigneuse Qui me pouvait causer cette ardeur amoureuse.
CIDOR.	CIDOR.
Tu faicts l’amour außi?	Tu faits l'amour aussi?
ILIDAN, Noſtre profeßion De tout temps eſt ſuiette à cette paßion, Dois-ie rien ignorer?	ILIDAN, Notre profession De tout temps est suite à cette passion, Dois-je rien ignorer?
& puis-ie, ſi ie n’ayme Sçauoir ce qu’en vn cœur peut vne ardeur extréme, cxpnimer te qu'amour a d'amer, & de doux Ce que dit vn amant, ce que penſe vn ialoux, Et de quelle façon on ſent naistre ces flames Qui troublent le repos, ot tonjommen les âmes.	et puis-je, si ici n'aime Savoir ce qu'en un cœur peut une ardeur extrême, cxpnimer te qu'amour a d'amer, et de doux Ce que dit un amant, ce que pense un jaloux, Et de quelle façon on sent ou notre flammes Qui troublent le repos, ô tonjommen les âmes.
CIDOR.	CIDOR.
Ton eſprit, Filidan, ſe meſle de deux arts Ou la ſageſſe eſt rare, & court de grands haZards, Ie crains pour ta raiſon vn peu de frenaiſie Mais c’eſt ton intereſt, voyons ta poëſie.	Ton esprit, Fidan, se mêle de deux arts Ou la sagesse est rare, et court de grands hasards, Je crains pour ta raison un peu de frénaisie Mais c'est ton intérêt, voyons ta poésie.
A DIANE.	À DIANE.
Ie prends conſeil de ma raiſon, Ie cherche du contrepoiſon, Au mal dont mon ame eſt atteinte, I'éuite l’éclat de vos yeux, Ie ne ſpay priere ſt jaincie, Dont ie n’aye cent fois importuné les Dieux.	Je prends conseil de ma raison, Je cherche du contrepoison, Au mal dont mon âme est atteinte, J'éuite clat de vos yeux, Je ne sais prière st jaincie, Dont apprendre n'aie cent fois importuné les Dieux.
Ie deteſte voſtre rigueur, Ie vous nomme iniuſte, & ſans cœur, Ma propre cholere m’eſtonne, Mais t’en tire on foible jecours, Celuy de malheureux me demeure touſiours.	Je déteste votre rigueur, Je vous nomme injuste, et sans cœur, Ma propre cholère m'étonne, Mais t'en tire on faible jecours, Celui de malheureux me demeure toujours.
Je ne puis déliurer mes ſens De la viue ardeur que ie ſents, Mes yeux n’adorent que les vostres Obeyſſant à mon courroux Jls ne treuueroient pas en d’autres Les celeſtes attraicts qu’il laiſſeroient en vous.	Je ne puis délivrer mes sens De la vive ardeur que pr sents, Mes yeux n'adorent que les vôtres Obéissant à mon courroux Ils ne trouveraient pas en d'autres Les célestes attraits qu'il laisseraient en vous.
Mais enfin apres tant de feux Qu’auray-ie pour fruict de mes vœux?	Mais enfin après tant de feux Qu'aurai-je pour fruit de mes vœux?
C’est trop eſtre ſourde à ma plainte, Je dois chercher ma gueriſon, Et ie puis bien forcer ma crainte Puis qu’il vous eſt permis de forcer ma raiſon.	C'est trop rien sourde à ma plainte, Je dois chercher ma guérison, Et personne puis bien forcer ma crainte Puis qu'il vous est permis de forcer ma raison.
La violence est mon recours Ce moyen mieux que mes diſcours, Vous prouuera que ie vous ayme Ie ſuis las, i’ay trop attendu, Et vous n’ignorés pas vous-meſme, Que ce que ie demande eſt vn bien qui m'est deu.	La violence est mon recours Ce moyen mieux que mes discours, Vous prouvera que je vous aime Je suis las, j'ai trop attendu, Et vous n'ignorez pas vous-même, Que ce que je demande est un bien qui m'est dev.
Mais à vostre diuin aſpect Quel inſolent, & ſans reſpect?	Mais à votre divin aspect Quel insolent, et sans respect?
Quoy, qu'eſloigné ie me propoſe Deuani cou mes vras ſont liés Mon teint paſle, ma bouche cloſe, Mon cœur reſpectueux, mes deſſeins oubliés.	Quoi, qu'éloigné entre me propose Devani cou mes vras sont liés Mon teint pâle, ma bouche close, Mon cœur respectueux, mes desseins oubliés.
ILIDAN.	ILIDAN.
Et bien?	Et bien?
qu’en iugés-vous?	qu'en jugez-vous?
LVCIDOR.	LUCIDOR.
Ie treuue en cet écrit Des ſuiets, ſans mentir d’admirer ton eſprit, La douceur du diſcours, la beauté des penſees Les rithmes, qui ny ſont ny foibles, ny forcees, Et la force du ſtyle, ont de ſi doux appas Que le plus grand cauſeur ne s’en deffendroit pas.	Je trouve en cet écrit Des sujets, sans mentir d'admirer ton esprit, La douceur du discours, la beauté des pensées Les rythmes, qui ni sont ici faibles, ni forcées, Et la force du style, ont de si doux appas Que le plus grand causeur ne s'en défendrait pas.
Qu’on voit d’eſprits diuers, & combien la nature Agit differemment en chaſque creature!	Qu'on voit d'esprits divers, et combien la nature Agit différemment en chasque créature!
Cent fois, pour exprimer vn amoureux tourment I’ay reclamé Phebus, & touſiours vainement En quelque ſolitude où mon chemin s’adreſſe Je ne treuue Helicon, Pegaſe, ny Zpermeſſe, Ie ne ſçay pour les vers, art, ny reigle, ny loy, Et toutes les neuf ſœurs ſont muetes pour moy.	Cent fois, pour exprimer un amoureux tourment J'ai réclamé Phebus, et toujours vainement En quelque solitude où mon chemin s'adresse Je ne trouve Hélicon, Pégase, Seigneur Zpermesse, Je ne sais pour les vers, art, ni regli, ni loi, Et toutes les neuf sœurs sont muetes pour moi.
ILIDAN.	ILIDAN.
Que vous aués de part, aux abus ordinaires, Lors que vous reclamès ces Dieux imâginaires, Ils ont eu dit credit:	Que vous avez de part, aux abus ordinaires, Lors que vous réclames ces Dieux imginaires, Ils ont eu dit crédit:
& dans noſtre art naiſſant Apollon nous eſtoit vn terme rauiſſant, Jnuoquer les neuf ſœurs, & parler d’Hypocrene C’eſtoit bien rencontrer & ſignaler ſa veine, Mais on laiſſe auiourd’huy ces fabuleux diſcours A la ſterilité des eſprits les plus lourds, Chacun eſt ſon Phœbus, ſa Muſe, & ſa Minerue Et la nature ſeule inſpire nostre verue, L’art de la Poëſie aiuste la beauté Mais nous naiſſons pourueus de cette qualité, Quand nature ſe taiſt, la ſcience eſt muete Le trauail de cent ans ne peut faire vn Poëte.	et dans notre art naissant Apollon nous était un terme ravissant, Inuoquer les neuf sœurs, et parler d'Hypocrène C'était bien rencontrer et signaler sa veine, Mais on laisse aujourd'hui ces fabuleux discours A la stérilité des esprits les plus lourds, Chacun est son Phœbus, sa M, et sa Inerve Et la nature seule inspire notre verve, L'art de la Poësie aime la beauté Mais nous naissons pourueus la beauté qualité, Quand nature se taît, la science est muet Le trauail de cent es ne peut mue Tte.
I - VCIDOR.	I a VCIDOR.
Je ſuy donc vainement, ce penible ſentier Et ie renonce enfin, à ce ſacre meſtier, Mais toy, qui de cet art poſſede les merueilles Continuë ardemment tes trauaux, & tes veilles, Et t'eRerte pour moy lors que mes paßions, Mendieront le ſecours de tes conceptions.	Je suis donc vainement, ce pénible sentier Et mille renonce enfin, à ce sacre métier, Mais toi, qui de cet art possède les merveilles Continue ardemment tes travaux, et tes veilles, Et t'éRerte pour moi lors que mes passions, Mendieront le secours de tes conceptions.
ILIDAN.	ILIDAN.
Obligés-moy, Monſieur, de cet honneur extréme Et ie ſçauray pour vous, me ſurpaſſer moy-meſme;	Obligez-moi, Monsieur, de cet honneur extrême Et ici saurai pour vous, me surpasser moi-même;
Commendés ſeulement?	Commendez seulement?
LVCIDOR.	LUCIDOR.
Mes pleurs, & des regrets, Qui me ſont importuns autant qu’ils ſont ſecrets, Employront ton eſprit:	Mes pleurs, et des regrets, Qui me sont importuns autant qu'ils sont secrets, Employront ton esprit:
la mort de cette belle Qui rendoit à mes vœux vne ardeur mutuelle, Et qui fut à Lyon la gloire des beautés Exerce en ma memoire encor de cruautés, Je t’ay dit nos amours, ſon nom fut Angelique Deuient ma faueur vn peu melancholique, Honore ſa memoire, et t’en va de ce pas Exprimer en mon nom, le deüil de ſon trépas, Figure ma tristeſſe auecques tant de charmes Qu'aux yeux des plus cruels elle arrache des larmes.	la mort de cette belle Qui rendait à mes vœux une ardeur mutuelle, Et qui fut à Lyon la gloire des beautés Exerce en ma mémoire encor de cruautés, Je t'ai dit nos amours, son nom fut Angélique Deuient ma faveur un peu mélancolique, Honore sa mémoire, et t'en va de ce pas Exprimer en mon nom, le deuil de son trépas, Figure ma tristesse avec tant de charmes Qu'aux yeux des plus cruels elle arrache des larmes.
FILIDAN.	FILIDAN.
peuisrequemonc neurerauieu, muu cependant Armés vous de raiſon contre cet accident.	peuisrequemonc neureravieu, mu cependant Armez -vous de raison contre cet accident.
CIDOR.	CIDOR.
Ceſſés, tristes penſees, tyran de mes delices, Ennemis de ma ioye autheurs de mes ſupplices, Ne me figurés plus ſes aymables attmits Sortés de ma memoire inutiles pourtnits, Angelique n’est plus on ne voit plus de tmces Sur ce triſte débris des beautés, & des gnaces La mort change ce corps:	Cessez, tristes pensées, tyran de mes délices, Ennemis de ma joie auteurs de mes supplices, Ne me figurés plus ses aimables attémits Sortés de ma mémoire inutiles pourtnits, Angelique n'est plus on ne voit plus de tmces Sur ce triste débris des beautés, et des gagnes La mort change ce corps:
ſon aueugle fureur Faict du throſne d’amour le ſeiour de l’horreur Elle rend ce qui meurt incapable de gloire, Et c’est perdre des vœux qu’adorer ſa memoire, Oublier Angelique, ô friuole diſcours!	son aveugle fureur Fait du trône d'amour le seiour de l'horreur Elle rend ce qui meurt incapable de gloire, Et c'est perdre des vœux qu'adorer sa mémoire, Oublier Angélique, ô frivole discours!
Que pluſtoſt de mes ans le Ciel borne le cours, Que le ci(eau fatal, coupe ma triſte trame, Pluſtoſt que morte au monde, elle meure en mon ame.	Que plutôt de mes ans le Ciel borne le cours, Que le ciapeau fatal, coupe ma triste trame, Plutôt que morte au monde, elle meure en mon âme.
CENE	CÈNE
SCENE SIXIESME.	SCÈNE SIXIÈME.
ERASME, LVCIDOR,	ERASME, LUCIDOR,
ERASME E vous treuue à propos.	ERASME E vous trouve à propos.
T LVCIDOR.	T LUCIDOR.
Non pas ſi vos ſoupçons Uous ont fait mediter de nouuelles leçons;	Non pas si vos soupçons Uous ont fait méditer de nouvelles leçons;
Le Ciel cognoiſt ma vie, il voit mon ame nuë Et ie ne reſponds point d’vne offence incognuë;	Le Ciel connaît ma vie, il voit mon âme nue Et je ne réponds point d'une offense inconnue;
ERASME.	ERASME.
Son ſçauoir, Lucidor, paſſe nos iugements, Et ie vous vais conter d’étranges changements, Daignez ſuiure mes pas;	Son sçauoir, Lucidor, passe nos jugements, Et je vous vais conter d'étranges changements, Daignez suivre mes pas;
vne fille estrangere Veut d'vn ſecret commun fin mpre miſere, Le Ciel luy faict tout voir, il parle par ſa voix,	une fille étrangère Veut d'un secret commun fin mépre misère, Le Ciel lui fait tout voir, il parle par sa voix,
VCIDOR.	VCIDOR.
Que peut-elle pour moy?	Que peut-elle pour moi?
voyons-là toutefois.	voyons-là toutefois.
SCENE SEPTIESME.	SCÈNE SEPTIÈME.
ANGELIQVE, CELIE, LEANDRE.	ANGELIQUE, CÉLIE, LÉANDRE.
CELIANTE, LA NOVRRICE, FILENE, CLORIMAND.	CELIANTE, LA NOURRICE, SILÈNE, CLORIMAND.
ANGELIQVE.	ANGELIQUE.
Onc encor par vos loix, ſeueres deſtinees UJe verray ce tyran de mes ieunes annees, Reſous, triſte Angelique, vn genereux départ, Le conſeil, qui nous ſert, n’eſt pas venu trop tard.	Onc encor par vos lois, sévères destinées UJe verrai ce tyran de mes jeunes années, Résous, triste Angélique, un généreux départ, Le conseil, qui nous sert, n'est pas venu trop tard.
& fiiuote penjee ro a fſelm amile s Que ie le voye vne heure, et que i’en ſouffre mille;	et fivote penjee ro à fselm amyle s Que personne le voie une heure, et que j'en souffre mille;
Rien ne me peut rauir l’honneur de luy parler, Ce Soleil me luira, fuſt-ce pour m’aueugler;	Rien ne me peut ravir l'honneur de lui parler, Ce Soleil me luira, fût-ce pour m'aveugler;
LELIE.	LELIE.
Eſperez de nos vœux;	Espérez de nos vœux;
& du pouuoir celeste:	et du pouuoir céleste:
Vne agreable fin, d’vne crainte funeſte.	Une agréable fin, d'une crainte funeste.
Quand vos rares attraits, n’auroient pas le pouuoir De remettre ſon cœur au chemin du deuoir;	Quand vos rares attraits, n'auraient pas le pouvoir De remettre son cœur au chemin du devoir;
ANGELIQVE.	ANGELIQUE.
Vien donc, perfide autheur, de mon cruel martyre, Uien combler mes ennuys, puis que ie le deſire, Vien criminel obiet de mes ſainctes amours Acheuer ton offence, en acheuant mes iours, Le voila cet ingrat, Dieux!	Viens donc, perfide auteur, de mon cruel martyre, Uien combler mes ennuis, puis que ie le désire, Viens criminel objet de mes sainte amours Achever ton offense, en achevant mes jours, Le voilà cet ingrat, Dieux!
en cette foibleſſe Perdray-ie la clarté de ioye, ou de triſteſſe?	en cette faiblesse Perdrai-je la clarté de joie, ou de tristesse?
SCENE HVICTIESME.	SCÈNE HVICTIESME.
ERASME, LVCIDOR, CELIE, LEANDRE, CELIANTE, ANGELIQVE, CLORIMAND.	ERASME, LUCIDOR, CELIE, LÉANDRE, CÉLIANTE, ANGELIQUE, CLORIMAND.
FILENE, LA NOVRRICE.	SILÈNE, LA NOURRICE.
ERAioM E,a Angenque.	ERAioM E,a Angénèque.
Onſeillé de vous voir, il s’en donne l’honneur Le voila, quel ſecret, importe à ſon bon-heur.	Onseillé de vous voir, il s'en donne l'honneur Le voilà, quel secret, importe à son bonheur.
ANGELIQVE.	ANGELIQUE.
Le Ciel m’a departy cet heureux priuilege Que ie cognois les maux, qu’il conſent que i'alleIl m’inſpire à quels gens, ie dois voüer mes ſoings, Et ſouuent c’eſt à ceux que ie cognois le moins, Tel heureux Caualier, receueZ vn remede Qu’il m’oblige d’offrir au mal qui vous poſſede.	Le Ciel m'a départi cet heureux privilège Que ie cagnais les maux, qu'il consent que j'alléIl m'inspire à quels gens, je dois voüer elle soings, Et souvent c'est à ceux que sans connais le moins, Tel heureux Cavalier, receueZ un remède Qu'il m'oblige d'offrir au mal qui vous posssede.
LVCIDOR, la regardant attentiuement.	LUCIDOR, la regardant attentivement.
Dieux!	Dieux!
qu’eſt-ce que ie voy?	qu'est-ce que ie cy?
ANGELIQ VE.	ANGELIQ VE.
Le plaiſir de changer A dégagé vos vœux d’vn obiet étranger, Ce cœur eſt inconſtant, et ce mal est le pire De ces vices honteux ſous qui l’honneur ſouſpire, Qui cauſent du deſordre en vn cœur abbatu, Et dans vn grand courage étouffent la vertu:	Le plaisir de changer A dégagé vos vœux d'un objet étranger, Ce cœur est inconstant, et ce mal est le pire De ces vices honteux sous qui l'honneur soupire, Qui causent du désordre en un cœur abattu, Et dans un grand courage étouffent la vertu:
Mais i’ay tant de ſecrets que cette maladie A pris vn mauuais cours, ſi ie n’y remedie, Son premier appareil eſt de voir que les Dieux Rompent tous les deſſeins d’vn amant vitieux, Et que tant de malheurs qui fuiuent l’inconſtanCe Ioignent voſtre intereſt à voſtre repentance, La honte d’oublier l’obiet qu’on a vanté Le prix que vous deués à ſa fidelité, L’affront d’auoir porté le titre de pariure L’honneur de reparer vne ſi lâche iniure, Et la neceßité de diuertir la mort De celle qui iadis gouuerna vostre ſort, Tous ces puiſſants reſpects obtiendront de vostre ame Un genereux effort contre vne vaine flame, Jl faut quitter Celie, & que vostre raiſon Reuoye auec reſpect ſa premiere priſon.	Mais j'ai tant de secrets que cette maladie A pris un mauvais cours, si beau n'y remèdie, Son premier appareil est de voir que les Dieux Rompent tous les desseins d'être amant vitieux, Et que tant de malheurs qui suivent l'inconstanCe Ioignent votre intérêt à votre repentance, La honte d'oublier l'objet qu'on a vanté Le prix que vous devez à sa fidélité, L'affront d'avoir porté le titre de parièrent L'honneur de réparer une si lâche injure, Et la ne de diuertir la mort De celle qui iadis gouuerna vôtre sort, Tous ces puissants respects obtiendront de vôtre âme Un généreux effort contre vaine flame, faut quitter Celie, et que vôtre raison Reuoye auec respect sa première prison:
CIDOR.	CIDOR.
O Dieux!	Ô Dieux!
il eſt trop vray, la mort ſur Angelique Redouta d’evercer ſon pouuoir tyrannique, Son bel œil voit le tour, ô charmes innocens!	il est trop vrai, la mort sur Angélique Redouta d'évercer son pouvoir tyrannique, Son bel œil voit le tour, ô charmes innocents!
O pretieux attraits qui rauiſſés mes ſens!	Ô prétieux attraits qui rauissés mes sens!
Prouués chaſtes vainqueurs par la fin de ma vie Comouen cetit rencontre à mon ame rauie, Vous viués ma Deeſſel ô Dieux!	Prouués chastes vainqueurs par la fin de ma vie Comouen cetit rencontre à mon âme ravie, Vous vivez ma Deessel ô Dieux!
en ce tranſport Auoueray-ie mes yeux d’vn fidelle rapport?	en ce transport Avouerai-je mes yeux d'un fidèle rapport?
CELIE.	CELIE.
O diuine aduanture!	Ô divine aventure!
ANGELIQVE.	ANGELIQUE.
Ouy, ie vis infidelle, Et mes yeux ſont teſmoings de ton ardeur nouuelle, Ouy, ie vis, pour confondre vn deſloyal amant Qui s’est au moindre effort rendu ſi lâchement, Mais l’amour te deffend quand ta faute m'irrite Par ton offence, ingrat, iuge de ton merite, Voyant ce que ie perds, mon eſprit eſt content	Oui, Se vis infidèle, Et mes yeux sont témoings de ton ardeur nouvelle, Oui, ie vis, pour confondre un déloyal amant Qui s'est au moindre effort rendu si lâchement, Mais l'amour te défend quand ta faute m'irrite Par ton offense, ingrat, juge de ton mérite, Voyant ce que ie perds, mon esprit est content
11O LA PELERINE Tu me plaiſois fidelle, & me plais inconstant, Je ne déguiſe point par vne vaine feinte L’ardente paßion dont mon ame eſt atteinte, Ma voix ouure mon cœur, & par vn faux meſpris Ie ne deſire point de toucher tes eſprits, Pour traicter froidement vn traiſtre, qui m’outraI'ay trop d’affection, & trop peu de courage, J'auray pour Lucidor vn reſpect eternel.	11O LA PÈLERINE -Tu me plaisais fidèle, et me plais inconstant, Je ne déguise point par une vaine feinte L'ardente passion dont mon âme est atteinte, Ma voix ouvre mon cœur, et par un faux mépris Je ne désire point de toucher tes esprits, Pour traite ment un traître, qui m'outraInela trop d'affection, et trop peu de courage, J'aurai pour Lucidor pour respect éternel.
L’innocent, s’il le faut priera le criminel, Si pour toy mon viſage eſt ſans trits, & ſans charmes J'ay des ſouſpirs encor, il me reſte des larmes, Ie conſents de prouuer iuſqu’où la paßion Peut reſoudre mon ſexe,& ma condition, Vn vœu, feint pour te voir, ce penible voyage, Ne ſont de mon amour qu’vn foible teſmoignage, Tire de cet ardeur de plus rares effects, Exige des efforts, qu’autre ne fiſt iamais, Excepte mon honneur, que ma foy te conſerue Et ce poinct reſerué ie n’ay point de reſerue, Paſſe au dernier effort, teints ces lieux de mon ſan Je baiſeray la main qui m'ouurira le flanc.	L'innocent, s'il le faut priera le criminel, Si pour toi mon visage est sans trits, et sans charmes J'ai des soupirs encor, il me reste des larmes, Je consents de prouver jusqu'où la passion Peut résoudre mon sexe, Seigneur condition, Vn Vœu, feint pour te voir, ce pénible voyage, Ne sont de mon amour qu'un faible témoignage, Tire de cet ardeur de plus rares effets, Exige des efforts, qu'autre ne fît jamais, Excepte mon honneur, que ma foi te conserve Et ce point de ie çay point de réserve, Où j' ai effort, teints ces lieux de mon san Ré baiseray la main qui m'ouurira le flanc.
LVCIDOR.	LUCIDOR.
Arbitres des mortels, grands, & ſeueres iuges Contre qui les pecheurs cherchent de vains refuges, Dont l’abſolu pouuoir diſpoſe de nos iours Dont le foudre eſt plus fort, que les plus fortes tours, Employés iustes Dieux, vostre puiſſance extréme.	Arbitres des mortels, grands, et sévères juges Contre qui les pécheurs cherchent de vains refuges, Dont l'absolu pouvoir dispose de nos jours Dont le foudre est plus fort, que les plus fortes tours, Employés iustes Dieux, votre puissance extrême.
A me faire ſouffrir vne peine de meſme, Si i’ay trahy, Madame, & ſi le changement M'eſt, & me fut iamais reproché iuſtement, Ie croyois voſtre mort, vne fauſſe aſſeurance D'vn malheur außi faux me priuoit d’eſperance, Le rapport d’vn amy, qui m’a iuré cent fois D’auoir veu ce beau corps, & ſans ame, & ſans voix, Depuis ſix mois, ou plus m’arreſte en cette Ville Et m'a faict eſtimer mon voyage inutile, Jugés ſi ce rapport eut de triſtes effects Par le nombre des vœux que te vous auois faicts, I'ay les meſmes ardeurs, vn meſme nœud me lie, L’intereſt m’obligeoit à rechercher Celie, Et quoy qu’il rende hommage à cet obiet charmant, (Elle m’excuſera) ie l’aymois froidement, Que deſſas moy mon crime attire le tonnerre Ou que pour m’abyſmer le Ciel ouure la terre, Si i'ay deſſein ailleurs, ſi i’ay trahy ma foy, Ei jeli cente ne voui pane ponr moy,	À me faire souffrir ainsi de même, Si j'ai trahi, Madame, et si le changement M'est, et me fut jamais reproché justement, Je croyais votre mort, vne fausse assurance D'un malheur aussi faux me privait d'espérance, Le rapport d'un ami, qui m'a juré cent fois D'avoir vu ce beau corps, et sans âme, et sans voix, Depuis six mois, ou plus m'arrête en cette Ville Et m'a fait estimer mon voyage inutile, Jugez si ce rapport eut de tristes effets Par le nombre des vœux que te vous a vais, ay les mêmes ardeurs, même nœud me si, intérêt j' a rechercher y, Et quoi il rende ma cet obiet charmant, lE excusera) ie aymois froidement, Que dessas moi mon crime attire le tonnerre Ou que pour abîmer le Ciel ouure la terre, Et sa dessein ailleurs, si ay trahi m foi' e jeli st ne voui pane ponr m,
GELIQVE.	GELIQUE.
Les ſix mois expirés, vne douleur ſi forte Saiſit tous mes eſprits, qu’on me creut long-temps morte, Et s’il faut accuſer cet vnique malheur Et non ton changement de ma longue douleur, Si tu plaignois ma mort, & ſi ie plais encore Comme ie plûs iadis, à tes yeux que i'adore, Ie ne puis rien entendre, & rien voir ſans meſpris, Et ie paſſe en bon-heur les plut rares eſprits.	Les six mois expirés, une douleur si forte Saisit tous mes esprits, qu'on me crut longtemps morte, Et s'il faut accuser cet unique malheur Et non ton changement de ma longue douleur, Si tu plaignais ma mort, et si tu sens encore Comme quelque plus jadis, à tes yeux que j'adore, Je ne puis rien entendre, et rien voir sans mépris, Et suis passe en bonheur les plut rares esprits.
CIDOR.	CIDOR.
La terre ne voit pas en la ſaiſon nouuelle, La lumiere du iour ſi brillante, & ſi belle, D'vn œil ſi ſatisfaict que ie voy vos appas, Que i'ay creus ſi long-temps le butin du trépas, Je reuoy ces beaux yeux, larmes, plaintes, deſaſtres, Eclypſés vains ennuys, à l’aſpect de ces Aſtres, Suy bien-heureux amant, ton amoureux deſſein, Quel reſpect te deffend de preſſer ce beau ſein?	La terre ne voit pas en la saison nouvelle, La lumière du jour si brillante, et si belle, D'un œil si satisfait que je vois vos appas, Que j'ai crus si longtemps le butin du trépas, Je revoi ces beaux yeux, larmes, plaintes, désastres, Eclypsés vains ennuis, à l'aspect de ces Astres, Sui bienheureux amant, ton amoureux dessein, Quel respect te défend de presser ce beau sein?
O bien-heureuſe erreur, qui dans cette aduanturer Donne à mes longs trauaux le fruict auec vſure.	Ô bienheureuse erreur, qui dans cette aventurer Donne à mes longs travaux le fruit avec usure.
SCEN	SCEN
SCENE NEVFIESME.	SCÈNE NEUFIESME.
On maiſtre ſe conſole& par cette action NVTJl ne teſmoigne pas beaucoup d’affliction Mes vers ont pour obiet vne douleur legere Qu'a-t’il de ſi commun auec cette étrangere?	On maître se consolelle par cette action NVTJl ne témoigne pas beaucoup d'affliction Mes vers ont pour objet une douleur légère Qu'a-t-il de si communeste cette étrangère?
Dieux:	Dieux:
que dt costte numeur les moments ſont diuers, Et que par ces baiſers vous démentés mes vers!	que dût côtte numeur les moments sont divers, Et que par ces baisers vous démentez mes vers!
Sont-ils faicts?	Sont-ils faits?
VCIDOR.	VCIDOR.
TILIDAN, Ten ay faict, pour un melancholique Qui laue de ſes pleurs le tombeau d'Angelique;	TILIDAN, Ten ai fait, pour un mélancolique Qui laue de ses pleurs le tombeau d'Angélique;
Et non pour vn eſprit qui paroist ſi content Et qui reſſent ſi peu ce qui l’affligeoit tant.	Et non pour un esprit qui paraît si content Et qui ressent si peu ce qui l'affligeait tant.
CIDOR.	CIDOR.
Tu voys, cher Filidan, les adorables charmes Que i’ay creus n’eſtre plus, et qui cauſoient mes larmes, Madame, ce trauail qu’il voüoit à mes pleurs Peut mieux que mes ſerments, vous prouuer mes douleurs, Voyés en quels diſcours cet eſprit eſtimable A figuré mon deüil.	Tu vois, cher Filidan, les adorables charmes Que j'ai creus n'être plus, et qui causaient mes larmes, Madame, ce travail qu'il voit à mes pleurs Peut mieux que mes serments, vous prover mes douleurs, Voyez en quels discours cet esprit estimable A iguré mon deuil.
FILIDAN.	FILIDAN.
O rencontre agreable!	Ô rencontre agréable!
Mort, horrible fleau des humains, Qui ſur les celestes ouurages Porte tes dangereuſes mains, Touſiours ſanglantes de carnages;	Mort, horrible fléau des humains, Qui sur les célestes ouvrages Porte tes dangereuses mains, Toujours sanglantes de carnages;
Fiere, & barbare deité:	Fête, et barbare deité:
Qui d’vne aueugle cruauté Deuores tout ce qui reſpire, Si tu ne peux, ny voir, ny guerir mon tourment, Accrois d’vn ſuiet ton empire, Rends la maiſtreſſe, ou prends l’amant.	Qui d'une aveugle cruauté Deuvores tout ce qui respire, Si tu ne peux, toujours voir, ni guerir mon tourment, Accrois d'un sujet ton empire, Rends la maîtresse, ou prends l'amant.
L’amour, ce tyran triomphant D'vn meſme traict bleſſa nos ames, Pour l’imiter en l’étouffant D’vn meſme traict étein nos flames, Angelique vit ſi ie vis, Ses beaux iours ne ſont pas rauis, Ma mort importe à ta victoire, Détache mon eſprit d’vn tronc de nerfs, & d’os, Tu trauailleras pour ta gloire, En trauaillant pour mon repos.	L'amour, ce tyran triomphant D'H mesme trait blessa nos âmes, Pour l'imiter en l'étouffant D'un même trait étein nos flammes, Angélique vit si tu vis, Ses beaux jours ne sont pas ravis, Ma mort importe à ta victoire, Détache mon esprit d'un tronc de nerfs, et d'os, Tu travailleras pour ta gloire, En travaillant pour mon repos.
Sois ſenſible à mes longs trauaux Attente ſur mes deſtinees, Eſt-ce pour prolonger mes maux, Que tu prolonges mes annees, Si ie ne meurs par ton ſecours Ma main peut de mes triſtes iours Acheuer la fatale trame Ie puis faire (à ta honte) vn gentrtuk effort, Et par le fer, ou par la flame, Auoil ta mort, maigre la morf.	Sois sensible à mes longs travaux Attente sur mes destinées, Est-ce pour prolonger mes maux, Que tu prolonges mes années, Si grands ne meurs par ton secours Ma main peut de mes tristes jours Achever la fatale trame Je puis faire (à ta honte) un gentrtuk effort, Et par le fer, ou par la flamme, Avoil ta mort, maigre la mors.
LVCIDOR, continue.	LUCIDOR, continue.
Quel eſprit Filidan, te peut aſſés louer?	Quel esprit Fidan, te peut assez louer?
INGELIQVE.	INGELIQUE.
Le ſien eſt eſtimable il le faut auoüer.	Le sien est estimable il le faut auoüer.
I VCIDOR.	I VCIDOR.
Puts que ue nos maineurs, naiſt enfin noſtre gloire Décry d’vn ſtile égal, le cours de noſtre hiſtoire, Alors que tu ſçauras quel heureux changement Aux deſirs de Celie accorde cet amant.	Pûts que êtes nos maineurs, naît enfin notre gloire Décri d'un style égal, le cours de notre histoire, Alors que tu sauras quel heureux changement Aux désirs de Célie accorde cet amant.
ERASME.	ERASME.
mune Pouſſons des cris aux Cieux!	mune Poussons des cris aux Cieux!
que d’vne voix comOn teſmoigne à l’enuy ſon heureuſe fortune, Etd'vne ardeur pareille allons dans les feſtins Ayer nos déplaiſirs, & benir nos deſtins.	que d'une voix comOn témoigne à l'envi son heureuse fortune, Éd'une ardeur pareille allons dans les festins Aïer nos déplaisirs, et bénir nos destins.
FIN.	FIN.
